"prv_code","city_code","area_code","dept_code","li_code","tbox_no","valid_ticket","agree_ticket","disagree_ticket","invalid_ticket","vote_ticket","votable_population","population","vote_to_votable","agree_to_votable"
"00","000","00","000","0000","0000","8067757","3936386","4131371","78108","8145865","19825468","23470633","41.09","19.86"
"63","000","00","000","0000","0000","1006037","533890","472147","8724","1014761","2155416","2562738","47.08","24.77"
"63","000","00","010","0000","0000","79903","43940","35963","669","80572","162964","196890","49.44","26.96"
"63","000","00","010","0002","0000","2017","1140","877","15","2032","4467","0","45.49","25.52"
"63","000","00","010","0002","0001","534","295","239","3","537","1074","0","50.00","27.47"
"63","000","00","010","0002","0002","496","274","222","3","499","1138","0","43.85","24.08"
"63","000","00","010","0002","0003","427","247","180","4","431","1083","0","39.80","22.81"
"63","000","00","010","0002","0004","560","324","236","5","565","1172","0","48.21","27.65"
"63","000","00","010","0003","0000","3400","1740","1660","16","3416","6468","0","52.81","26.90"
"63","000","00","010","0003","0005","673","348","325","6","679","1294","0","52.47","26.89"
"63","000","00","010","0003","0006","729","426","303","3","732","1334","0","54.87","31.93"
"63","000","00","010","0003","0007","661","329","332","3","664","1290","0","51.47","25.50"
"63","000","00","010","0003","0008","657","317","340","3","660","1215","0","54.32","26.09"
"63","000","00","010","0003","0009","680","320","360","1","681","1335","0","51.01","23.97"
"63","000","00","010","0004","0000","2929","1656","1273","20","2949","5723","0","51.53","28.94"
"63","000","00","010","0004","0010","597","300","297","6","603","1071","0","56.30","28.01"
"63","000","00","010","0004","0011","571","359","212","1","572","1149","0","49.78","31.24"
"63","000","00","010","0004","0012","564","297","267","2","566","1092","0","51.83","27.20"
"63","000","00","010","0004","0013","588","350","238","5","593","1142","0","51.93","30.65"
"63","000","00","010","0004","0014","609","350","259","6","615","1269","0","48.46","27.58"
"63","000","00","010","0005","0000","1995","1039","956","10","2005","3881","0","51.66","26.77"
"63","000","00","010","0005","0015","681","386","295","3","684","1319","0","51.86","29.26"
"63","000","00","010","0005","0016","662","323","339","3","665","1305","0","50.96","24.75"
"63","000","00","010","0005","0017","652","330","322","4","656","1257","0","52.19","26.25"
"63","000","00","010","0006","0000","2178","1199","979","10","2188","4281","0","51.11","28.01"
"63","000","00","010","0006","0018","512","289","223","2","514","1036","0","49.61","27.90"
"63","000","00","010","0006","0019","633","364","269","4","637","1203","0","52.95","30.26"
"63","000","00","010","0006","0020","487","234","253","3","490","969","0","50.57","24.15"
"63","000","00","010","0006","0021","546","312","234","1","547","1073","0","50.98","29.08"
"63","000","00","010","0007","0000","2052","1127","925","15","2067","4135","0","49.99","27.26"
"63","000","00","010","0007","0022","513","301","212","3","516","1031","0","50.05","29.19"
"63","000","00","010","0007","0023","529","291","238","4","533","1074","0","49.63","27.09"
"63","000","00","010","0007","0024","486","259","227","4","490","1013","0","48.37","25.57"
"63","000","00","010","0007","0025","524","276","248","4","528","1017","0","51.92","27.14"
"63","000","00","010","0008","0000","1884","1157","727","15","1899","3884","0","48.89","29.79"
"63","000","00","010","0008","0026","605","350","255","8","613","1239","0","49.48","28.25"
"63","000","00","010","0008","0027","625","397","228","3","628","1276","0","49.22","31.11"
"63","000","00","010","0008","0028","654","410","244","4","658","1369","0","48.06","29.95"
"63","000","00","010","0009","0000","1791","915","876","14","1805","3540","0","50.99","25.85"
"63","000","00","010","0009","0029","621","299","322","5","626","1176","0","53.23","25.43"
"63","000","00","010","0009","0030","590","311","279","4","594","1155","0","51.43","26.93"
"63","000","00","010","0009","0031","580","305","275","5","585","1209","0","48.39","25.23"
"63","000","00","010","0010","0000","1779","980","799","15","1794","3553","0","50.49","27.58"
"63","000","00","010","0010","0032","580","306","274","6","586","1167","0","50.21","26.22"
"63","000","00","010","0010","0033","658","353","305","6","664","1266","0","52.45","27.88"
"63","000","00","010","0010","0034","541","321","220","3","544","1120","0","48.57","28.66"
"63","000","00","010","0011","0000","3037","1729","1308","25","3062","6051","0","50.60","28.57"
"63","000","00","010","0011","0035","550","327","223","7","557","1044","0","53.35","31.32"
"63","000","00","010","0011","0036","507","267","240","4","511","1011","0","50.54","26.41"
"63","000","00","010","0011","0037","485","276","209","5","490","998","0","49.10","27.66"
"63","000","00","010","0011","0038","465","252","213","1","466","1000","0","46.60","25.20"
"63","000","00","010","0011","0039","514","328","186","4","518","989","0","52.38","33.16"
"63","000","00","010","0011","0040","516","279","237","4","520","1009","0","51.54","27.65"
"63","000","00","010","0012","0000","4263","2809","1454","38","4301","8377","0","51.34","33.53"
"63","000","00","010","0012","0041","631","513","118","4","635","1163","0","54.60","44.11"
"63","000","00","010","0012","0042","674","356","318","13","687","1294","0","53.09","27.51"
"63","000","00","010","0012","0043","609","355","254","3","612","1190","0","51.43","29.83"
"63","000","00","010","0012","0044","536","352","184","4","540","1164","0","46.39","30.24"
"63","000","00","010","0012","0045","619","484","135","4","623","1230","0","50.65","39.35"
"63","000","00","010","0012","0046","593","386","207","8","601","1192","0","50.42","32.38"
"63","000","00","010","0012","0047","601","363","238","2","603","1144","0","52.71","31.73"
"63","000","00","010","0013","0000","1179","584","595","2","1181","2184","0","54.08","26.74"
"63","000","00","010","0013","0048","589","319","270","1","590","1114","0","52.96","28.64"
"63","000","00","010","0013","0049","590","265","325","1","591","1070","0","55.23","24.77"
"63","000","00","010","0014","0000","1773","897","876","15","1788","3518","0","50.82","25.50"
"63","000","00","010","0014","0050","570","280","290","0","570","1140","0","50.00","24.56"
"63","000","00","010","0014","0051","608","319","289","5","613","1233","0","49.72","25.87"
"63","000","00","010","0014","0052","595","298","297","10","605","1145","0","52.84","26.03"
"63","000","00","010","0015","0000","2642","1488","1154","25","2667","5140","0","51.89","28.95"
"63","000","00","010","0015","0053","701","416","285","8","709","1332","0","53.23","31.23"
"63","000","00","010","0015","0054","643","405","238","5","648","1241","0","52.22","32.63"
"63","000","00","010","0015","0055","600","284","316","3","603","1169","0","51.58","24.29"
"63","000","00","010","0015","0056","698","383","315","9","707","1398","0","50.57","27.40"
"63","000","00","010","0016","0000","3790","1856","1934","24","3814","7351","0","51.88","25.25"
"63","000","00","010","0016","0057","570","286","284","2","572","1182","0","48.39","24.20"
"63","000","00","010","0016","0058","601","306","295","1","602","1153","0","52.21","26.54"
"63","000","00","010","0016","0059","635","328","307","4","639","1235","0","51.74","26.56"
"63","000","00","010","0016","0060","670","335","335","8","678","1246","0","54.41","26.89"
"63","000","00","010","0016","0061","644","286","358","4","648","1260","0","51.43","22.70"
"63","000","00","010","0016","0062","670","315","355","5","675","1275","0","52.94","24.71"
"63","000","00","010","0017","0000","2829","1676","1153","22","2851","5381","0","52.98","31.15"
"63","000","00","010","0017","0063","765","515","250","10","775","1412","0","54.89","36.47"
"63","000","00","010","0017","0064","651","366","285","3","654","1334","0","49.03","27.44"
"63","000","00","010","0017","0065","711","404","307","7","718","1327","0","54.11","30.44"
"63","000","00","010","0017","0066","702","391","311","2","704","1308","0","53.82","29.89"
"63","000","00","010","0018","0000","2740","1319","1421","24","2764","7162","0","38.59","18.42"
"63","000","00","010","0018","0085","582","299","283","6","588","1242","0","47.34","24.07"
"63","000","00","010","0018","0086","478","208","270","4","482","1045","0","46.12","19.90"
"63","000","00","010","0018","0087","527","225","302","4","531","1248","0","42.55","18.03"
"63","000","00","010","0018","0088","645","322","323","6","651","1381","0","47.14","23.32"
"63","000","00","010","0018","0089","508","265","243","4","512","2246","0","22.80","11.80"
"63","000","00","010","0019","0000","3313","1672","1641","38","3351","7230","0","46.35","23.13"
"63","000","00","010","0019","0070","673","342","331","7","680","1479","0","45.98","23.12"
"63","000","00","010","0019","0071","580","324","256","7","587","1242","0","47.26","26.09"
"63","000","00","010","0019","0072","591","303","288","9","600","1301","0","46.12","23.29"
"63","000","00","010","0019","0073","827","420","407","13","840","1709","0","49.15","24.58"
"63","000","00","010","0019","0074","642","283","359","2","644","1499","0","42.96","18.88"
"63","000","00","010","0020","0000","2275","1399","876","24","2299","4616","0","49.81","30.31"
"63","000","00","010","0020","0075","539","388","151","5","544","1135","0","47.93","34.19"
"63","000","00","010","0020","0076","557","329","228","8","565","1202","0","47.00","27.37"
"63","000","00","010","0020","0077","664","359","305","6","670","1190","0","56.30","30.17"
"63","000","00","010","0020","0078","515","323","192","5","520","1089","0","47.75","29.66"
"63","000","00","010","0021","0000","3965","2973","992","56","4021","7730","0","52.02","38.46"
"63","000","00","010","0021","0079","647","450","197","15","662","1274","0","51.96","35.32"
"63","000","00","010","0021","0080","760","648","112","12","772","1336","0","57.78","48.50"
"63","000","00","010","0021","0081","578","389","189","3","581","1124","0","51.69","34.61"
"63","000","00","010","0021","0082","572","472","100","8","580","1152","0","50.35","40.97"
"63","000","00","010","0021","0083","700","464","236","8","708","1386","0","51.08","33.48"
"63","000","00","010","0021","0084","708","550","158","10","718","1458","0","49.25","37.72"
"63","000","00","010","0022","0000","3378","1832","1546","20","3398","6959","0","48.83","26.33"
"63","000","00","010","0022","0090","581","286","295","2","583","1290","0","45.19","22.17"
"63","000","00","010","0022","0091","577","298","279","7","584","1152","0","50.69","25.87"
"63","000","00","010","0022","0092","539","285","254","2","541","1080","0","50.09","26.39"
"63","000","00","010","0022","0093","557","329","228","2","559","1185","0","47.17","27.76"
"63","000","00","010","0022","0094","541","300","241","4","545","1091","0","49.95","27.50"
"63","000","00","010","0022","0095","583","334","249","3","586","1161","0","50.47","28.77"
"63","000","00","010","0024","0000","3091","1548","1543","25","3116","6657","0","46.81","23.25"
"63","000","00","010","0024","0096","589","315","274","6","595","1353","0","43.98","23.28"
"63","000","00","010","0024","0097","678","328","350","7","685","1344","0","50.97","24.40"
"63","000","00","010","0024","0098","609","315","294","7","616","1291","0","47.71","24.40"
"63","000","00","010","0024","0099","636","295","341","2","638","1327","0","48.08","22.23"
"63","000","00","010","0024","0100","579","295","284","3","582","1342","0","43.37","21.98"
"63","000","00","010","0025","0000","2636","1496","1140","24","2660","5286","0","50.32","28.30"
"63","000","00","010","0025","0101","712","407","305","3","715","1345","0","53.16","30.26"
"63","000","00","010","0025","0102","653","381","272","5","658","1348","0","48.81","28.26"
"63","000","00","010","0025","0103","716","415","301","11","727","1417","0","51.31","29.29"
"63","000","00","010","0025","0104","555","293","262","5","560","1176","0","47.62","24.91"
"63","000","00","010","0026","0000","3465","1714","1751","26","3491","7611","0","45.87","22.52"
"63","000","00","010","0026","0105","508","262","246","1","509","1110","0","45.86","23.60"
"63","000","00","010","0026","0106","609","265","344","5","614","1318","0","46.59","20.11"
"63","000","00","010","0026","0107","555","290","265","5","560","1278","0","43.82","22.69"
"63","000","00","010","0026","0108","626","341","285","8","634","1385","0","45.78","24.62"
"63","000","00","010","0026","0109","636","279","357","5","641","1282","0","50.00","21.76"
"63","000","00","010","0026","0110","531","277","254","2","533","1238","0","43.05","22.37"
"63","000","00","010","0027","0000","1570","818","752","19","1589","3317","0","47.90","24.66"
"63","000","00","010","0027","0111","531","295","236","9","540","1207","0","44.74","24.44"
"63","000","00","010","0027","0112","569","291","278","7","576","1209","0","47.64","24.07"
"63","000","00","010","0027","0113","470","232","238","3","473","901","0","52.50","25.75"
"63","000","00","010","0028","0000","1407","687","720","15","1422","2882","0","49.34","23.84"
"63","000","00","010","0028","0114","417","186","231","3","420","924","0","45.45","20.13"
"63","000","00","010","0028","0115","475","237","238","6","481","991","0","48.54","23.92"
"63","000","00","010","0028","0116","515","264","251","6","521","967","0","53.88","27.30"
"63","000","00","010","0029","0000","1481","751","730","9","1490","3234","0","46.07","23.22"
"63","000","00","010","0029","0117","535","276","259","4","539","1128","0","47.78","24.47"
"63","000","00","010","0029","0118","475","246","229","3","478","1081","0","44.22","22.76"
"63","000","00","010","0029","0119","471","229","242","2","473","1025","0","46.15","22.34"
"63","000","00","010","0030","0000","2883","1476","1407","29","2912","5590","0","52.09","26.40"
"63","000","00","010","0030","0120","744","369","375","3","747","1466","0","50.95","25.17"
"63","000","00","010","0030","0121","763","392","371","14","777","1487","0","52.25","26.36"
"63","000","00","010","0030","0122","614","301","313","4","618","1178","0","52.46","25.55"
"63","000","00","010","0030","0123","762","414","348","8","770","1459","0","52.78","28.38"
"63","000","00","010","0031","0000","1329","750","579","14","1343","2642","0","50.83","28.39"
"63","000","00","010","0031","0124","712","400","312","6","718","1420","0","50.56","28.17"
"63","000","00","010","0031","0125","617","350","267","8","625","1222","0","51.15","28.64"
"63","000","00","010","0032","0000","1807","1012","795","18","1825","3714","0","49.14","27.25"
"63","000","00","010","0032","0126","643","381","262","10","653","1338","0","48.80","28.48"
"63","000","00","010","0032","0127","602","287","315","4","606","1284","0","47.20","22.35"
"63","000","00","010","0032","0128","562","344","218","4","566","1092","0","51.83","31.50"
"63","000","00","010","0033","0000","2510","1240","1270","21","2531","5206","0","48.62","23.82"
"63","000","00","010","0033","0129","617","276","341","8","625","1367","0","45.72","20.19"
"63","000","00","010","0033","0130","642","323","319","7","649","1199","0","54.13","26.94"
"63","000","00","010","0033","0131","625","322","303","6","631","1310","0","48.17","24.58"
"63","000","00","010","0033","0132","626","319","307","0","626","1330","0","47.07","23.98"
"63","000","00","010","0034","0000","1051","516","535","14","1065","2147","0","49.60","24.03"
"63","000","00","010","0034","0133","577","288","289","7","584","1185","0","49.28","24.30"
"63","000","00","010","0034","0134","474","228","246","7","481","962","0","50.00","23.70"
"63","000","00","010","0035","0000","1464","745","719","12","1476","3047","0","48.44","24.45"
"63","000","00","010","0035","0067","538","280","258","2","540","1065","0","50.70","26.29"
"63","000","00","010","0035","0068","447","232","215","8","455","933","0","48.77","24.87"
"63","000","00","010","0035","0069","479","233","246","2","481","1049","0","45.85","22.21"
"63","000","00","020","0000","0000","84280","47128","37152","744","85024","181747","210936","46.78","25.93"
"63","000","00","020","0001","0000","2112","1500","612","16","2128","4958","0","42.92","30.25"
"63","000","00","020","0001","0135","554","391","163","5","559","1035","0","54.01","37.78"
"63","000","00","020","0001","0136","535","380","155","9","544","2128","0","25.56","17.86"
"63","000","00","020","0001","0137","547","417","130","0","547","940","0","58.19","44.36"
"63","000","00","020","0001","0138","476","312","164","2","478","855","0","55.91","36.49"
"63","000","00","020","0002","0000","1963","1203","760","18","1981","3767","0","52.59","31.94"
"63","000","00","020","0002","0139","666","412","254","6","672","1261","0","53.29","32.67"
"63","000","00","020","0002","0140","662","404","258","7","669","1247","0","53.65","32.40"
"63","000","00","020","0002","0141","635","387","248","5","640","1259","0","50.83","30.74"
"63","000","00","020","0003","0000","1007","607","400","12","1019","2224","0","45.82","27.29"
"63","000","00","020","0003","0142","390","246","144","6","396","934","0","42.40","26.34"
"63","000","00","020","0003","0143","617","361","256","6","623","1290","0","48.29","27.98"
"63","000","00","020","0004","0000","1295","739","556","9","1304","2903","0","44.92","25.46"
"63","000","00","020","0004","0144","384","212","172","3","387","847","0","45.69","25.03"
"63","000","00","020","0004","0145","442","258","184","2","444","971","0","45.73","26.57"
"63","000","00","020","0004","0146","469","269","200","4","473","1085","0","43.59","24.79"
"63","000","00","020","0005","0000","1334","804","530","13","1347","2732","0","49.30","29.43"
"63","000","00","020","0005","0147","452","303","149","6","458","958","0","47.81","31.63"
"63","000","00","020","0005","0148","422","243","179","5","427","858","0","49.77","28.32"
"63","000","00","020","0005","0149","460","258","202","2","462","916","0","50.44","28.17"
"63","000","00","020","0006","0000","2172","1200","972","29","2201","4753","0","46.31","25.25"
"63","000","00","020","0006","0150","454","282","172","5","459","1056","0","43.47","26.70"
"63","000","00","020","0006","0151","605","341","264","7","612","1267","0","48.30","26.91"
"63","000","00","020","0006","0152","531","254","277","12","543","1082","0","50.18","23.48"
"63","000","00","020","0006","0153","582","323","259","5","587","1348","0","43.55","23.96"
"63","000","00","020","0007","0000","1993","1090","903","10","2003","4357","0","45.97","25.02"
"63","000","00","020","0007","0154","453","260","193","2","455","1002","0","45.41","25.95"
"63","000","00","020","0007","0155","575","326","249","3","578","1226","0","47.15","26.59"
"63","000","00","020","0007","0156","478","246","232","2","480","1108","0","43.32","22.20"
"63","000","00","020","0007","0157","487","258","229","3","490","1021","0","47.99","25.27"
"63","000","00","020","0008","0000","3057","1740","1317","26","3083","6335","0","48.67","27.47"
"63","000","00","020","0008","0158","539","310","229","8","547","1156","0","47.32","26.82"
"63","000","00","020","0008","0159","500","293","207","5","505","1055","0","47.87","27.77"
"63","000","00","020","0008","0160","508","302","206","2","510","1047","0","48.71","28.84"
"63","000","00","020","0008","0161","593","335","258","5","598","1113","0","53.73","30.10"
"63","000","00","020","0008","0162","489","289","200","1","490","1045","0","46.89","27.66"
"63","000","00","020","0008","0163","428","211","217","5","433","919","0","47.12","22.96"
"63","000","00","020","0009","0000","3915","2146","1769","31","3946","8511","0","46.36","25.21"
"63","000","00","020","0009","0164","634","298","336","4","638","1345","0","47.43","22.16"
"63","000","00","020","0009","0165","601","303","298","4","605","1242","0","48.71","24.40"
"63","000","00","020","0009","0166","542","304","238","3","545","1058","0","51.51","28.73"
"63","000","00","020","0009","0167","477","291","186","5","482","993","0","48.54","29.31"
"63","000","00","020","0009","0168","536","333","203","7","543","1156","0","46.97","28.81"
"63","000","00","020","0009","0169","521","292","229","4","525","1333","0","39.38","21.91"
"63","000","00","020","0009","0170","604","325","279","4","608","1384","0","43.93","23.48"
"63","000","00","020","0010","0000","1424","720","704","10","1434","3102","0","46.23","23.21"
"63","000","00","020","0010","0171","548","285","263","4","552","1129","0","48.89","25.24"
"63","000","00","020","0010","0172","390","202","188","4","394","918","0","42.92","22.00"
"63","000","00","020","0010","0173","486","233","253","2","488","1055","0","46.26","22.09"
"63","000","00","020","0011","0000","2017","996","1021","25","2042","4266","0","47.87","23.35"
"63","000","00","020","0011","0174","478","230","248","8","486","1085","0","44.79","21.20"
"63","000","00","020","0011","0175","531","259","272","2","533","1087","0","49.03","23.83"
"63","000","00","020","0011","0176","493","246","247","8","501","1026","0","48.83","23.98"
"63","000","00","020","0011","0177","515","261","254","7","522","1068","0","48.88","24.44"
"63","000","00","020","0012","0000","1479","795","684","9","1488","3106","0","47.91","25.60"
"63","000","00","020","0012","0178","468","253","215","2","470","1046","0","44.93","24.19"
"63","000","00","020","0012","0179","450","244","206","6","456","997","0","45.74","24.47"
"63","000","00","020","0012","0180","561","298","263","1","562","1063","0","52.87","28.03"
"63","000","00","020","0013","0000","1944","886","1058","17","1961","4081","0","48.05","21.71"
"63","000","00","020","0013","0181","474","228","246","4","478","960","0","49.79","23.75"
"63","000","00","020","0013","0182","537","228","309","3","540","1055","0","51.18","21.61"
"63","000","00","020","0013","0183","430","201","229","4","434","938","0","46.27","21.43"
"63","000","00","020","0013","0184","503","229","274","6","509","1128","0","45.12","20.30"
"63","000","00","020","0014","0000","1409","594","815","13","1422","3370","0","42.20","17.63"
"63","000","00","020","0014","0185","453","202","251","1","454","1114","0","40.75","18.13"
"63","000","00","020","0014","0186","418","182","236","7","425","1013","0","41.95","17.97"
"63","000","00","020","0014","0187","538","210","328","5","543","1243","0","43.68","16.89"
"63","000","00","020","0015","0000","1558","785","773","15","1573","3629","0","43.35","21.63"
"63","000","00","020","0015","0188","548","278","270","1","549","1203","0","45.64","23.11"
"63","000","00","020","0015","0189","453","266","187","7","460","1156","0","39.79","23.01"
"63","000","00","020","0015","0190","557","241","316","7","564","1270","0","44.41","18.98"
"63","000","00","020","0016","0000","2319","1117","1202","30","2349","4754","0","49.41","23.50"
"63","000","00","020","0016","0191","547","224","323","9","556","1135","0","48.99","19.74"
"63","000","00","020","0016","0192","585","278","307","10","595","1166","0","51.03","23.84"
"63","000","00","020","0016","0193","604","329","275","6","610","1203","0","50.71","27.35"
"63","000","00","020","0016","0194","583","286","297","5","588","1250","0","47.04","22.88"
"63","000","00","020","0017","0000","2120","1208","912","25","2145","4535","0","47.30","26.64"
"63","000","00","020","0017","0195","491","270","221","3","494","980","0","50.41","27.55"
"63","000","00","020","0017","0196","583","314","269","8","591","1180","0","50.08","26.61"
"63","000","00","020","0017","0197","520","315","205","9","529","1177","0","44.94","26.76"
"63","000","00","020","0017","0198","526","309","217","5","531","1198","0","44.32","25.79"
"63","000","00","020","0018","0000","1916","983","933","31","1947","4223","0","46.10","23.28"
"63","000","00","020","0018","0199","414","225","189","7","421","971","0","43.36","23.17"
"63","000","00","020","0018","0200","560","297","263","7","567","1165","0","48.67","25.49"
"63","000","00","020","0018","0201","506","248","258","8","514","1060","0","48.49","23.40"
"63","000","00","020","0018","0202","436","213","223","9","445","1027","0","43.33","20.74"
"63","000","00","020","0019","0000","1723","1099","624","23","1746","3723","0","46.90","29.52"
"63","000","00","020","0019","0203","422","274","148","3","425","1003","0","42.37","27.32"
"63","000","00","020","0019","0204","605","401","204","10","615","1334","0","46.10","30.06"
"63","000","00","020","0019","0205","696","424","272","10","706","1386","0","50.94","30.59"
"63","000","00","020","0020","0000","2831","1586","1245","16","2847","6147","0","46.32","25.80"
"63","000","00","020","0020","0206","447","245","202","2","449","1019","0","44.06","24.04"
"63","000","00","020","0020","0207","524","289","235","5","529","1121","0","47.19","25.78"
"63","000","00","020","0020","0208","438","240","198","0","438","965","0","45.39","24.87"
"63","000","00","020","0020","0209","509","298","211","5","514","1040","0","49.42","28.65"
"63","000","00","020","0020","0210","486","266","220","3","489","963","0","50.78","27.62"
"63","000","00","020","0020","0211","427","248","179","1","428","1039","0","41.19","23.87"
"63","000","00","020","0021","0000","880","471","409","6","886","1924","0","46.05","24.48"
"63","000","00","020","0021","0212","448","243","205","3","451","969","0","46.54","25.08"
"63","000","00","020","0021","0213","432","228","204","3","435","955","0","45.55","23.87"
"63","000","00","020","0022","0000","2530","1410","1120","21","2551","5536","0","46.08","25.47"
"63","000","00","020","0022","0214","427","216","211","6","433","1114","0","38.87","19.39"
"63","000","00","020","0022","0215","520","331","189","2","522","1067","0","48.92","31.02"
"63","000","00","020","0022","0216","492","259","233","3","495","1114","0","44.43","23.25"
"63","000","00","020","0022","0217","574","310","264","5","579","1133","0","51.10","27.36"
"63","000","00","020","0022","0218","517","294","223","5","522","1108","0","47.11","26.53"
"63","000","00","020","0023","0000","1951","990","961","17","1968","4245","0","46.36","23.32"
"63","000","00","020","0023","0219","468","238","230","4","472","1053","0","44.82","22.60"
"63","000","00","020","0023","0220","509","263","246","3","512","1041","0","49.18","25.26"
"63","000","00","020","0023","0221","452","232","220","9","461","1018","0","45.28","22.79"
"63","000","00","020","0023","0222","522","257","265","1","523","1133","0","46.16","22.68"
"63","000","00","020","0024","0000","1868","994","874","21","1889","3791","0","49.83","26.22"
"63","000","00","020","0024","0223","507","289","218","4","511","1004","0","50.90","28.78"
"63","000","00","020","0024","0224","411","203","208","1","412","836","0","49.28","24.28"
"63","000","00","020","0024","0225","434","224","210","9","443","874","0","50.69","25.63"
"63","000","00","020","0024","0226","516","278","238","7","523","1077","0","48.56","25.81"
"63","000","00","020","0025","0000","3058","1520","1538","29","3087","6724","0","45.91","22.61"
"63","000","00","020","0025","0227","492","252","240","4","496","1065","0","46.57","23.66"
"63","000","00","020","0025","0228","524","239","285","10","534","1152","0","46.35","20.75"
"63","000","00","020","0025","0229","473","249","224","4","477","1056","0","45.17","23.58"
"63","000","00","020","0025","0230","478","254","224","1","479","1047","0","45.75","24.26"
"63","000","00","020","0025","0231","533","248","285","5","538","1204","0","44.68","20.60"
"63","000","00","020","0025","0232","558","278","280","5","563","1200","0","46.92","23.17"
"63","000","00","020","0026","0000","2469","1222","1247","20","2489","5177","0","48.08","23.60"
"63","000","00","020","0026","0233","504","267","237","3","507","1073","0","47.25","24.88"
"63","000","00","020","0026","0234","571","262","309","5","576","1158","0","49.74","22.63"
"63","000","00","020","0026","0235","477","251","226","4","481","1006","0","47.81","24.95"
"63","000","00","020","0026","0236","415","194","221","3","418","937","0","44.61","20.70"
"63","000","00","020","0026","0237","502","248","254","5","507","1003","0","50.55","24.73"
"63","000","00","020","0027","0000","1519","802","717","9","1528","3445","0","44.35","23.28"
"63","000","00","020","0027","0238","452","246","206","2","454","1115","0","40.72","22.06"
"63","000","00","020","0027","0239","527","264","263","3","530","1151","0","46.05","22.94"
"63","000","00","020","0027","0240","540","292","248","4","544","1179","0","46.14","24.77"
"63","000","00","020","0028","0000","2045","1209","836","17","2062","4324","0","47.69","27.96"
"63","000","00","020","0028","0241","581","287","294","8","589","1168","0","50.43","24.57"
"63","000","00","020","0028","0242","519","307","212","1","520","1014","0","51.28","30.28"
"63","000","00","020","0028","0243","451","284","167","7","458","1042","0","43.95","27.26"
"63","000","00","020","0028","0244","494","331","163","1","495","1100","0","45.00","30.09"
"63","000","00","020","0029","0000","2549","1539","1010","18","2567","5572","0","46.07","27.62"
"63","000","00","020","0029","0245","460","275","185","1","461","1049","0","43.95","26.22"
"63","000","00","020","0029","0246","465","262","203","5","470","1036","0","45.37","25.29"
"63","000","00","020","0029","0247","528","319","209","5","533","1187","0","44.90","26.87"
"63","000","00","020","0029","0248","535","340","195","3","538","1064","0","50.56","31.95"
"63","000","00","020","0029","0249","561","343","218","4","565","1236","0","45.71","27.75"
"63","000","00","020","0030","0000","3538","2088","1450","37","3575","7503","0","47.65","27.83"
"63","000","00","020","0030","0250","540","310","230","0","540","1069","0","50.51","29.00"
"63","000","00","020","0030","0251","554","338","216","4","558","1083","0","51.52","31.21"
"63","000","00","020","0030","0252","531","317","214","6","537","1107","0","48.51","28.64"
"63","000","00","020","0030","0253","506","290","216","4","510","1093","0","46.66","26.53"
"63","000","00","020","0030","0254","493","260","233","8","501","1110","0","45.14","23.42"
"63","000","00","020","0030","0255","443","297","146","10","453","988","0","45.85","30.06"
"63","000","00","020","0030","0256","471","276","195","5","476","1053","0","45.20","26.21"
"63","000","00","020","0031","0000","2014","1160","854","17","2031","4453","0","45.61","26.05"
"63","000","00","020","0031","0257","519","310","209","6","525","1140","0","46.05","27.19"
"63","000","00","020","0031","0258","517","306","211","2","519","1157","0","44.86","26.45"
"63","000","00","020","0031","0259","496","286","210","3","499","1084","0","46.03","26.38"
"63","000","00","020","0031","0260","482","258","224","6","488","1072","0","45.52","24.07"
"63","000","00","020","0032","0000","2669","1676","993","21","2690","5784","0","46.51","28.98"
"63","000","00","020","0032","0261","579","413","166","5","584","1135","0","51.45","36.39"
"63","000","00","020","0032","0262","573","332","241","6","579","1144","0","50.61","29.02"
"63","000","00","020","0032","0263","476","284","192","5","481","1202","0","40.02","23.63"
"63","000","00","020","0032","0264","408","255","153","4","412","1005","0","41.00","25.37"
"63","000","00","020","0032","0265","633","392","241","1","634","1298","0","48.84","30.20"
"63","000","00","020","0033","0000","2739","1575","1164","19","2758","6519","0","42.31","24.16"
"63","000","00","020","0033","0266","354","201","153","2","356","861","0","41.35","23.34"
"63","000","00","020","0033","0267","437","249","188","4","441","1055","0","41.80","23.60"
"63","000","00","020","0033","0268","522","319","203","4","526","1206","0","43.62","26.45"
"63","000","00","020","0033","0269","453","249","204","3","456","1101","0","41.42","22.62"
"63","000","00","020","0033","0270","528","293","235","3","531","1261","0","42.11","23.24"
"63","000","00","020","0033","0271","445","264","181","3","448","1035","0","43.29","25.51"
"63","000","00","020","0034","0000","1915","1073","842","15","1930","3961","0","48.73","27.09"
"63","000","00","020","0034","0272","485","240","245","4","489","1027","0","47.61","23.37"
"63","000","00","020","0034","0273","449","275","174","1","450","996","0","45.18","27.61"
"63","000","00","020","0034","0274","522","270","252","4","526","1050","0","50.10","25.71"
"63","000","00","020","0034","0275","459","288","171","6","465","888","0","52.36","32.43"
"63","000","00","020","0035","0000","1472","863","609","16","1488","3292","0","45.20","26.22"
"63","000","00","020","0035","0276","441","252","189","3","444","1039","0","42.73","24.25"
"63","000","00","020","0035","0277","523","276","247","7","530","1122","0","47.24","24.60"
"63","000","00","020","0035","0278","508","335","173","6","514","1131","0","45.45","29.62"
"63","000","00","020","0036","0000","2935","1744","1191","19","2954","6033","0","48.96","28.91"
"63","000","00","020","0036","0279","631","349","282","4","635","1185","0","53.59","29.45"
"63","000","00","020","0036","0280","592","356","236","3","595","1151","0","51.69","30.93"
"63","000","00","020","0036","0281","597","357","240","5","602","1332","0","45.20","26.80"
"63","000","00","020","0036","0282","539","348","191","6","545","1113","0","48.97","31.27"
"63","000","00","020","0036","0283","576","334","242","1","577","1252","0","46.09","26.68"
"63","000","00","020","0037","0000","1328","732","596","9","1337","2713","0","49.28","26.98"
"63","000","00","020","0037","0284","450","260","190","0","450","849","0","53.00","30.62"
"63","000","00","020","0037","0285","462","225","237","4","466","948","0","49.16","23.73"
"63","000","00","020","0037","0286","416","247","169","5","421","916","0","45.96","26.97"
"63","000","00","020","0038","0000","1556","897","659","12","1568","3427","0","45.75","26.17"
"63","000","00","020","0038","0287","445","244","201","5","450","1169","0","38.49","20.87"
"63","000","00","020","0038","0288","546","314","232","4","550","1118","0","49.19","28.09"
"63","000","00","020","0038","0289","565","339","226","3","568","1140","0","49.82","29.74"
"63","000","00","020","0039","0000","2925","1713","1212","21","2946","5973","0","49.32","28.68"
"63","000","00","020","0039","0290","579","329","250","5","584","1196","0","48.83","27.51"
"63","000","00","020","0039","0291","599","348","251","4","603","1254","0","48.09","27.75"
"63","000","00","020","0039","0292","496","284","212","2","498","1025","0","48.59","27.71"
"63","000","00","020","0039","0293","619","385","234","5","624","1262","0","49.45","30.51"
"63","000","00","020","0039","0294","632","367","265","5","637","1236","0","51.54","29.69"
"63","000","00","020","0040","0000","1996","1168","828","9","2005","4141","0","48.42","28.21"
"63","000","00","020","0040","0295","539","306","233","2","541","1141","0","47.41","26.82"
"63","000","00","020","0040","0296","447","275","172","2","449","921","0","48.75","29.86"
"63","000","00","020","0040","0297","556","345","211","4","560","1111","0","50.41","31.05"
"63","000","00","020","0040","0298","454","242","212","1","455","968","0","47.00","25.00"
"63","000","00","020","0041","0000","736","484","252","13","749","1734","0","43.19","27.91"
"63","000","00","020","0041","0299","421","245","176","8","429","984","0","43.60","24.90"
"63","000","00","020","0041","0300","315","239","76","5","320","750","0","42.67","31.87"
"63","000","00","030","0000","0000","117158","66686","50472","975","118133","242869","296546","48.64","27.46"
"63","000","00","030","0001","0000","2298","1436","862","10","2308","4632","0","49.83","31.00"
"63","000","00","030","0001","0301","534","303","231","2","536","1147","0","46.73","26.42"
"63","000","00","030","0001","0302","510","314","196","4","514","1124","0","45.73","27.94"
"63","000","00","030","0001","0303","620","402","218","0","620","1156","0","53.63","34.78"
"63","000","00","030","0001","0304","634","417","217","4","638","1205","0","52.95","34.61"
"63","000","00","030","0002","0000","2180","1112","1068","7","2187","4304","0","50.81","25.84"
"63","000","00","030","0002","0305","734","382","352","2","736","1462","0","50.34","26.13"
"63","000","00","030","0002","0306","630","303","327","3","633","1294","0","48.92","23.42"
"63","000","00","030","0002","0307","816","427","389","2","818","1548","0","52.84","27.58"
"63","000","00","030","0003","0000","2628","1498","1130","19","2647","5471","0","48.38","27.38"
"63","000","00","030","0003","0308","722","411","311","6","728","1325","0","54.94","31.02"
"63","000","00","030","0003","0309","553","318","235","5","558","1250","0","44.64","25.44"
"63","000","00","030","0003","0310","687","374","313","4","691","1501","0","46.04","24.92"
"63","000","00","030","0003","0311","666","395","271","4","670","1395","0","48.03","28.32"
"63","000","00","030","0004","0000","3224","1715","1509","28","3252","6608","0","49.21","25.95"
"63","000","00","030","0004","0312","563","285","278","4","567","1171","0","48.42","24.34"
"63","000","00","030","0004","0313","617","313","304","5","622","1230","0","50.57","25.45"
"63","000","00","030","0004","0314","688","335","353","7","695","1442","0","48.20","23.23"
"63","000","00","030","0004","0315","644","387","257","7","651","1332","0","48.87","29.05"
"63","000","00","030","0004","0316","712","395","317","5","717","1433","0","50.03","27.56"
"63","000","00","030","0005","0000","1916","1019","897","12","1928","4212","0","45.77","24.19"
"63","000","00","030","0005","0317","512","254","258","5","517","1096","0","47.17","23.18"
"63","000","00","030","0005","0318","499","260","239","1","500","1118","0","44.72","23.26"
"63","000","00","030","0005","0319","492","281","211","3","495","1060","0","46.70","26.51"
"63","000","00","030","0005","0320","413","224","189","3","416","938","0","44.35","23.88"
"63","000","00","030","0006","0000","2463","1634","829","17","2480","4707","0","52.69","34.71"
"63","000","00","030","0006","0321","454","341","113","4","458","917","0","49.95","37.19"
"63","000","00","030","0006","0322","650","518","132","7","657","1232","0","53.33","42.05"
"63","000","00","030","0006","0323","673","447","226","2","675","1294","0","52.16","34.54"
"63","000","00","030","0006","0324","686","328","358","4","690","1264","0","54.59","25.95"
"63","000","00","030","0007","0000","2710","1443","1267","28","2738","5704","0","48.00","25.30"
"63","000","00","030","0007","0325","721","387","334","7","728","1514","0","48.08","25.56"
"63","000","00","030","0007","0326","684","364","320","7","691","1390","0","49.71","26.19"
"63","000","00","030","0007","0327","758","409","349","7","765","1556","0","49.16","26.29"
"63","000","00","030","0007","0328","547","283","264","7","554","1244","0","44.53","22.75"
"63","000","00","030","0008","0000","1351","680","671","18","1369","2713","0","50.46","25.06"
"63","000","00","030","0008","0329","623","324","299","9","632","1229","0","51.42","26.36"
"63","000","00","030","0008","0330","728","356","372","9","737","1484","0","49.66","23.99"
"63","000","00","030","0009","0000","1668","872","796","17","1685","3427","0","49.17","25.44"
"63","000","00","030","0009","0331","546","290","256","4","550","1148","0","47.91","25.26"
"63","000","00","030","0009","0332","600","308","292","5","605","1179","0","51.31","26.12"
"63","000","00","030","0009","0333","522","274","248","8","530","1100","0","48.18","24.91"
"63","000","00","030","0010","0000","2847","1545","1302","28","2875","6211","0","46.29","24.88"
"63","000","00","030","0010","0334","498","287","211","4","502","1198","0","41.90","23.96"
"63","000","00","030","0010","0335","671","355","316","1","672","1375","0","48.87","25.82"
"63","000","00","030","0010","0336","595","315","280","6","601","1218","0","49.34","25.86"
"63","000","00","030","0010","0337","534","277","257","9","543","1217","0","44.62","22.76"
"63","000","00","030","0010","0338","549","311","238","8","557","1203","0","46.30","25.85"
"63","000","00","030","0011","0000","2353","1312","1041","19","2372","4608","0","51.48","28.47"
"63","000","00","030","0011","0339","494","256","238","3","497","1053","0","47.20","24.31"
"63","000","00","030","0011","0340","652","348","304","7","659","1248","0","52.80","27.88"
"63","000","00","030","0011","0341","663","347","316","6","669","1254","0","53.35","27.67"
"63","000","00","030","0011","0342","544","361","183","3","547","1053","0","51.95","34.28"
"63","000","00","030","0012","0000","1917","1034","883","10","1927","4046","0","47.63","25.56"
"63","000","00","030","0012","0343","604","325","279","3","607","1305","0","46.51","24.90"
"63","000","00","030","0012","0344","691","362","329","3","694","1392","0","49.86","26.01"
"63","000","00","030","0012","0345","622","347","275","4","626","1349","0","46.40","25.72"
"63","000","00","030","0013","0000","1792","966","826","15","1807","3495","0","51.70","27.64"
"63","000","00","030","0013","0346","571","294","277","4","575","1134","0","50.71","25.93"
"63","000","00","030","0013","0347","629","341","288","6","635","1241","0","51.17","27.48"
"63","000","00","030","0013","0348","592","331","261","5","597","1120","0","53.30","29.55"
"63","000","00","030","0014","0000","2900","1596","1304","16","2916","6074","0","48.01","26.28"
"63","000","00","030","0014","0349","590","322","268","3","593","1185","0","50.04","27.17"
"63","000","00","030","0014","0350","579","369","210","4","583","1226","0","47.55","30.10"
"63","000","00","030","0014","0351","611","347","264","0","611","1198","0","51.00","28.96"
"63","000","00","030","0014","0352","561","273","288","3","564","1228","0","45.93","22.23"
"63","000","00","030","0014","0353","559","285","274","6","565","1237","0","45.68","23.04"
"63","000","00","030","0015","0000","2447","1293","1154","11","2458","6710","0","36.63","19.27"
"63","000","00","030","0015","0354","520","293","227","2","522","2719","0","19.20","10.78"
"63","000","00","030","0015","0355","600","309","291","2","602","1259","0","47.82","24.54"
"63","000","00","030","0015","0356","635","320","315","4","639","1287","0","49.65","24.86"
"63","000","00","030","0015","0357","692","371","321","3","695","1445","0","48.10","25.67"
"63","000","00","030","0016","0000","2357","1332","1025","15","2372","4806","0","49.35","27.72"
"63","000","00","030","0016","0358","522","333","189","3","525","1049","0","50.05","31.74"
"63","000","00","030","0016","0359","674","364","310","5","679","1290","0","52.64","28.22"
"63","000","00","030","0016","0360","567","325","242","2","569","1202","0","47.34","27.04"
"63","000","00","030","0016","0361","594","310","284","5","599","1265","0","47.35","24.51"
"63","000","00","030","0017","0000","2377","1269","1108","17","2394","5061","0","47.30","25.07"
"63","000","00","030","0017","0362","585","318","267","7","592","1302","0","45.47","24.42"
"63","000","00","030","0017","0363","577","316","261","3","580","1259","0","46.07","25.10"
"63","000","00","030","0017","0364","623","339","284","3","626","1317","0","47.53","25.74"
"63","000","00","030","0017","0365","592","296","296","4","596","1183","0","50.38","25.02"
"63","000","00","030","0018","0000","1433","805","628","8","1441","2977","0","48.40","27.04"
"63","000","00","030","0018","0366","465","252","213","2","467","963","0","48.49","26.17"
"63","000","00","030","0018","0367","484","275","209","5","489","965","0","50.67","28.50"
"63","000","00","030","0018","0368","484","278","206","1","485","1049","0","46.23","26.50"
"63","000","00","030","0019","0000","1468","824","644","14","1482","2987","0","49.61","27.59"
"63","000","00","030","0019","0369","743","439","304","8","751","1480","0","50.74","29.66"
"63","000","00","030","0019","0370","725","385","340","6","731","1507","0","48.51","25.55"
"63","000","00","030","0020","0000","1494","914","580","18","1512","3004","0","50.33","30.43"
"63","000","00","030","0020","0371","761","487","274","11","772","1491","0","51.78","32.66"
"63","000","00","030","0020","0372","733","427","306","7","740","1513","0","48.91","28.22"
"63","000","00","030","0021","0000","2365","1363","1002","15","2380","4627","0","51.44","29.46"
"63","000","00","030","0021","0373","503","299","204","3","506","1046","0","48.37","28.59"
"63","000","00","030","0021","0374","614","374","240","5","619","1115","0","55.52","33.54"
"63","000","00","030","0021","0375","618","335","283","4","622","1231","0","50.53","27.21"
"63","000","00","030","0021","0376","630","355","275","3","633","1235","0","51.26","28.74"
"63","000","00","030","0022","0000","2708","1566","1142","16","2724","5613","0","48.53","27.90"
"63","000","00","030","0022","0377","592","352","240","3","595","1322","0","45.01","26.63"
"63","000","00","030","0022","0378","742","418","324","6","748","1477","0","50.64","28.30"
"63","000","00","030","0022","0379","645","363","282","3","648","1373","0","47.20","26.44"
"63","000","00","030","0022","0380","729","433","296","4","733","1441","0","50.87","30.05"
"63","000","00","030","0023","0000","2885","1953","932","30","2915","5527","0","52.74","35.34"
"63","000","00","030","0023","0381","700","434","266","4","704","1329","0","52.97","32.66"
"63","000","00","030","0023","0382","684","453","231","12","696","1388","0","50.14","32.64"
"63","000","00","030","0023","0383","747","488","259","7","754","1411","0","53.44","34.59"
"63","000","00","030","0023","0384","754","578","176","7","761","1399","0","54.40","41.32"
"63","000","00","030","0026","0000","1476","830","646","9","1485","2947","0","50.39","28.16"
"63","000","00","030","0026","0385","767","424","343","3","770","1551","0","49.65","27.34"
"63","000","00","030","0026","0386","709","406","303","6","715","1396","0","51.22","29.08"
"63","000","00","030","0027","0000","1997","1106","891","17","2014","3937","0","51.16","28.09"
"63","000","00","030","0027","0387","739","421","318","1","740","1446","0","51.18","29.11"
"63","000","00","030","0027","0388","746","398","348","7","753","1365","0","55.16","29.16"
"63","000","00","030","0027","0389","512","287","225","9","521","1126","0","46.27","25.49"
"63","000","00","030","0028","0000","2758","1625","1133","23","2781","5409","0","51.41","30.04"
"63","000","00","030","0028","0390","712","413","299","6","718","1374","0","52.26","30.06"
"63","000","00","030","0028","0391","700","418","282","12","712","1398","0","50.93","29.90"
"63","000","00","030","0028","0392","675","403","272","4","679","1316","0","51.60","30.62"
"63","000","00","030","0028","0393","671","391","280","1","672","1321","0","50.87","29.60"
"63","000","00","030","0029","0000","1878","1111","767","16","1894","4245","0","44.62","26.17"
"63","000","00","030","0029","0394","638","355","283","4","642","1423","0","45.12","24.95"
"63","000","00","030","0029","0395","575","333","242","5","580","1399","0","41.46","23.80"
"63","000","00","030","0029","0396","665","423","242","7","672","1423","0","47.22","29.73"
"63","000","00","030","0030","0000","2075","1219","856","9","2084","4455","0","46.78","27.36"
"63","000","00","030","0030","0397","512","308","204","2","514","1155","0","44.50","26.67"
"63","000","00","030","0030","0398","521","307","214","1","522","1055","0","49.48","29.10"
"63","000","00","030","0030","0399","535","305","230","4","539","1149","0","46.91","26.54"
"63","000","00","030","0030","0400","507","299","208","2","509","1096","0","46.44","27.28"
"63","000","00","030","0031","0000","2486","1254","1232","19","2505","5249","0","47.72","23.89"
"63","000","00","030","0031","0401","620","302","318","4","624","1288","0","48.45","23.45"
"63","000","00","030","0031","0402","672","362","310","3","675","1358","0","49.71","26.66"
"63","000","00","030","0031","0403","630","322","308","8","638","1347","0","47.36","23.90"
"63","000","00","030","0031","0404","564","268","296","4","568","1256","0","45.22","21.34"
"63","000","00","030","0032","0000","2172","1211","961","37","2209","4590","0","48.13","26.38"
"63","000","00","030","0032","0405","528","311","217","7","535","1089","0","49.13","28.56"
"63","000","00","030","0032","0406","499","253","246","10","509","1011","0","50.35","25.02"
"63","000","00","030","0032","0407","568","321","247","9","577","1284","0","44.94","25.00"
"63","000","00","030","0032","0408","577","326","251","11","588","1206","0","48.76","27.03"
"63","000","00","030","0033","0000","1628","890","738","22","1650","3527","0","46.78","25.23"
"63","000","00","030","0033","0409","534","303","231","8","542","1261","0","42.98","24.03"
"63","000","00","030","0033","0410","573","310","263","7","580","1202","0","48.25","25.79"
"63","000","00","030","0033","0411","521","277","244","7","528","1064","0","49.62","26.03"
"63","000","00","030","0034","0000","1865","1171","694","22","1887","3732","0","50.56","31.38"
"63","000","00","030","0034","0412","567","356","211","6","573","1154","0","49.65","30.85"
"63","000","00","030","0034","0413","680","460","220","6","686","1375","0","49.89","33.45"
"63","000","00","030","0034","0414","618","355","263","10","628","1203","0","52.20","29.51"
"63","000","00","030","0035","0000","1786","1045","741","17","1803","3699","0","48.74","28.25"
"63","000","00","030","0035","0415","590","344","246","4","594","1240","0","47.90","27.74"
"63","000","00","030","0035","0416","598","366","232","9","607","1244","0","48.79","29.42"
"63","000","00","030","0035","0417","598","335","263","4","602","1215","0","49.55","27.57"
"63","000","00","030","0036","0000","2410","1455","955","15","2425","4899","0","49.50","29.70"
"63","000","00","030","0036","0418","673","369","304","3","676","1323","0","51.10","27.89"
"63","000","00","030","0036","0419","542","318","224","4","546","1103","0","49.50","28.83"
"63","000","00","030","0036","0420","638","413","225","6","644","1320","0","48.79","31.29"
"63","000","00","030","0036","0421","557","355","202","2","559","1153","0","48.48","30.79"
"63","000","00","030","0037","0000","3140","2250","890","20","3160","5848","0","54.04","38.47"
"63","000","00","030","0037","0422","632","517","115","5","637","1157","0","55.06","44.68"
"63","000","00","030","0037","0423","595","425","170","1","596","1064","0","56.02","39.94"
"63","000","00","030","0037","0424","608","421","187","5","613","1133","0","54.10","37.16"
"63","000","00","030","0037","0425","678","442","236","6","684","1271","0","53.82","34.78"
"63","000","00","030","0037","0426","627","445","182","3","630","1223","0","51.51","36.39"
"63","000","00","030","0038","0000","1552","869","683","10","1562","3137","0","49.79","27.70"
"63","000","00","030","0038","0427","716","380","336","5","721","1433","0","50.31","26.52"
"63","000","00","030","0038","0428","395","225","170","1","396","752","0","52.66","29.92"
"63","000","00","030","0038","0429","441","264","177","4","445","952","0","46.74","27.73"
"63","000","00","030","0039","0000","878","536","342","5","883","1729","0","51.07","31.00"
"63","000","00","030","0039","0430","437","274","163","1","438","900","0","48.67","30.44"
"63","000","00","030","0039","0431","441","262","179","4","445","829","0","53.68","31.60"
"63","000","00","030","0040","0000","3685","2038","1647","26","3711","7435","0","49.91","27.41"
"63","000","00","030","0040","0432","636","358","278","6","642","1325","0","48.45","27.02"
"63","000","00","030","0040","0433","667","376","291","2","669","1272","0","52.59","29.56"
"63","000","00","030","0040","0434","559","306","253","4","563","1129","0","49.87","27.10"
"63","000","00","030","0040","0435","591","337","254","6","597","1265","0","47.19","26.64"
"63","000","00","030","0040","0436","625","323","302","4","629","1228","0","51.22","26.30"
"63","000","00","030","0040","0437","607","338","269","4","611","1216","0","50.25","27.80"
"63","000","00","030","0041","0000","1848","999","849","13","1861","3529","0","52.73","28.31"
"63","000","00","030","0041","0438","612","315","297","7","619","1232","0","50.24","25.57"
"63","000","00","030","0041","0439","582","313","269","4","586","1083","0","54.11","28.90"
"63","000","00","030","0041","0440","654","371","283","2","656","1214","0","54.04","30.56"
"63","000","00","030","0043","0000","3648","2051","1597","28","3676","6961","0","52.81","29.46"
"63","000","00","030","0043","0441","795","429","366","4","799","1475","0","54.17","29.08"
"63","000","00","030","0043","0442","705","414","291","7","712","1387","0","51.33","29.85"
"63","000","00","030","0043","0443","708","395","313","7","715","1364","0","52.42","28.96"
"63","000","00","030","0043","0444","708","409","299","6","714","1407","0","50.75","29.07"
"63","000","00","030","0043","0445","732","404","328","4","736","1328","0","55.42","30.42"
"63","000","00","030","0044","0000","2336","1350","986","25","2361","4904","0","48.14","27.53"
"63","000","00","030","0044","0446","560","350","210","5","565","1238","0","45.64","28.27"
"63","000","00","030","0044","0447","595","352","243","8","603","1191","0","50.63","29.55"
"63","000","00","030","0044","0448","577","327","250","6","583","1232","0","47.32","26.54"
"63","000","00","030","0044","0449","604","321","283","6","610","1243","0","49.07","25.82"
"63","000","00","030","0046","0000","2103","1180","923","18","2121","4683","0","45.29","25.20"
"63","000","00","030","0046","0450","562","338","224","3","565","1277","0","44.24","26.47"
"63","000","00","030","0046","0451","503","264","239","3","506","1094","0","46.25","24.13"
"63","000","00","030","0046","0452","490","269","221","6","496","1019","0","48.68","26.40"
"63","000","00","030","0046","0453","548","309","239","6","554","1293","0","42.85","23.90"
"63","000","00","030","0047","0000","3207","1835","1372","30","3237","6467","0","50.05","28.37"
"63","000","00","030","0047","0454","672","360","312","6","678","1403","0","48.33","25.66"
"63","000","00","030","0047","0455","618","371","247","5","623","1308","0","47.63","28.36"
"63","000","00","030","0047","0456","629","374","255","11","640","1228","0","52.12","30.46"
"63","000","00","030","0047","0457","656","375","281","4","660","1247","0","52.93","30.07"
"63","000","00","030","0047","0458","632","355","277","4","636","1281","0","49.65","27.71"
"63","000","00","030","0048","0000","1871","1155","716","26","1897","3938","0","48.17","29.33"
"63","000","00","030","0048","0459","619","391","228","10","629","1357","0","46.35","28.81"
"63","000","00","030","0048","0460","624","374","250","8","632","1244","0","50.80","30.06"
"63","000","00","030","0048","0461","628","390","238","8","636","1337","0","47.57","29.17"
"63","000","00","030","0049","0000","1820","1033","787","12","1832","4048","0","45.26","25.52"
"63","000","00","030","0049","0462","610","335","275","3","613","1380","0","44.42","24.28"
"63","000","00","030","0049","0463","621","362","259","7","628","1304","0","48.16","27.76"
"63","000","00","030","0049","0464","589","336","253","2","591","1364","0","43.33","24.63"
"63","000","00","030","0050","0000","2267","1246","1021","24","2291","5023","0","45.61","24.81"
"63","000","00","030","0050","0465","505","279","226","5","510","1200","0","42.50","23.25"
"63","000","00","030","0050","0466","594","322","272","7","601","1336","0","44.99","24.10"
"63","000","00","030","0050","0467","568","321","247","5","573","1233","0","46.47","26.03"
"63","000","00","030","0050","0468","600","324","276","7","607","1254","0","48.41","25.84"
"63","000","00","030","0051","0000","2351","1264","1087","21","2372","5100","0","46.51","24.78"
"63","000","00","030","0051","0469","559","288","271","6","565","1255","0","45.02","22.95"
"63","000","00","030","0051","0470","656","336","320","5","661","1308","0","50.54","25.69"
"63","000","00","030","0051","0471","552","318","234","5","557","1232","0","45.21","25.81"
"63","000","00","030","0051","0472","584","322","262","5","589","1305","0","45.13","24.67"
"63","000","00","030","0052","0000","1764","1033","731","17","1781","3818","0","46.65","27.06"
"63","000","00","030","0052","0473","631","388","243","6","637","1303","0","48.89","29.78"
"63","000","00","030","0052","0474","576","345","231","7","583","1280","0","45.55","26.95"
"63","000","00","030","0052","0475","557","300","257","4","561","1235","0","45.43","24.29"
"63","000","00","030","0053","0000","2342","1242","1100","20","2362","4922","0","47.99","25.23"
"63","000","00","030","0053","0476","587","317","270","6","593","1205","0","49.21","26.31"
"63","000","00","030","0053","0477","554","310","244","5","559","1247","0","44.83","24.86"
"63","000","00","030","0053","0478","627","309","318","4","631","1201","0","52.54","25.73"
"63","000","00","030","0053","0479","574","306","268","5","579","1269","0","45.63","24.11"
"63","000","00","030","0054","0000","1570","885","685","17","1587","3473","0","45.70","25.48"
"63","000","00","030","0054","0480","550","292","258","4","554","1241","0","44.64","23.53"
"63","000","00","030","0054","0481","480","303","177","6","486","1142","0","42.56","26.53"
"63","000","00","030","0054","0482","540","290","250","7","547","1090","0","50.18","26.61"
"63","000","00","030","0055","0000","2442","1307","1135","15","2457","5221","0","47.06","25.03"
"63","000","00","030","0055","0483","566","280","286","3","569","1255","0","45.34","22.31"
"63","000","00","030","0055","0484","599","339","260","5","604","1275","0","47.37","26.59"
"63","000","00","030","0055","0485","659","375","284","3","662","1322","0","50.08","28.37"
"63","000","00","030","0055","0486","618","313","305","4","622","1369","0","45.43","22.86"
"63","000","00","030","0056","0000","3053","1734","1319","44","3097","6249","0","49.56","27.75"
"63","000","00","030","0056","0487","724","438","286","13","737","1392","0","52.95","31.47"
"63","000","00","030","0056","0488","553","283","270","5","558","1217","0","45.85","23.25"
"63","000","00","030","0056","0489","565","324","241","11","576","1233","0","46.72","26.28"
"63","000","00","030","0056","0490","577","339","238","10","587","1199","0","48.96","28.27"
"63","000","00","030","0056","0491","634","350","284","5","639","1208","0","52.90","28.97"
"63","000","00","030","0057","0000","969","581","388","10","979","2171","0","45.09","26.76"
"63","000","00","030","0057","0492","364","236","128","4","368","866","0","42.49","27.25"
"63","000","00","030","0057","0493","249","146","103","4","253","604","0","41.89","24.17"
"63","000","00","030","0057","0494","356","199","157","2","358","701","0","51.07","28.39"
"63","000","00","040","0000","0000","86346","42674","43672","718","87064","188193","219840","46.26","22.68"
"63","000","00","040","0001","0000","1271","608","663","11","1282","2806","0","45.69","21.67"
"63","000","00","040","0001","0495","658","326","332","5","663","1509","0","43.94","21.60"
"63","000","00","040","0001","0496","613","282","331","6","619","1297","0","47.73","21.74"
"63","000","00","040","0002","0000","1851","930","921","11","1862","4541","0","41.00","20.48"
"63","000","00","040","0002","0497","629","325","304","3","632","1571","0","40.23","20.69"
"63","000","00","040","0002","0498","625","307","318","3","628","1540","0","40.78","19.94"
"63","000","00","040","0002","0499","597","298","299","5","602","1430","0","42.10","20.84"
"63","000","00","040","0003","0000","1377","699","678","10","1387","3136","0","44.23","22.29"
"63","000","00","040","0003","0500","689","348","341","3","692","1538","0","44.99","22.63"
"63","000","00","040","0003","0501","688","351","337","7","695","1598","0","43.49","21.96"
"63","000","00","040","0004","0000","1827","845","982","10","1837","3798","0","48.37","22.25"
"63","000","00","040","0004","0502","607","250","357","2","609","1279","0","47.62","19.55"
"63","000","00","040","0004","0503","556","274","282","5","561","1123","0","49.96","24.40"
"63","000","00","040","0004","0504","664","321","343","3","667","1396","0","47.78","22.99"
"63","000","00","040","0005","0000","1006","536","470","8","1014","2307","0","43.95","23.23"
"63","000","00","040","0005","0505","437","224","213","4","441","1020","0","43.24","21.96"
"63","000","00","040","0005","0506","569","312","257","4","573","1287","0","44.52","24.24"
"63","000","00","040","0006","0000","2503","1213","1290","18","2521","5902","0","42.71","20.55"
"63","000","00","040","0006","0507","487","229","258","2","489","1110","0","44.05","20.63"
"63","000","00","040","0006","0508","534","257","277","5","539","1186","0","45.45","21.67"
"63","000","00","040","0006","0509","463","228","235","4","467","1142","0","40.89","19.96"
"63","000","00","040","0006","0510","439","234","205","3","442","1169","0","37.81","20.02"
"63","000","00","040","0006","0511","580","265","315","4","584","1295","0","45.10","20.46"
"63","000","00","040","0007","0000","1451","789","662","18","1469","3728","0","39.40","21.16"
"63","000","00","040","0007","0512","505","252","253","8","513","1263","0","40.62","19.95"
"63","000","00","040","0007","0513","502","269","233","3","505","1204","0","41.94","22.34"
"63","000","00","040","0007","0514","444","268","176","7","451","1261","0","35.77","21.25"
"63","000","00","040","0008","0000","2716","1204","1512","20","2736","5936","0","46.09","20.28"
"63","000","00","040","0008","0515","714","301","413","8","722","1470","0","49.12","20.48"
"63","000","00","040","0008","0516","704","329","375","4","708","1533","0","46.18","21.46"
"63","000","00","040","0008","0517","669","260","409","5","674","1503","0","44.84","17.30"
"63","000","00","040","0008","0518","629","314","315","3","632","1430","0","44.20","21.96"
"63","000","00","040","0009","0000","1486","711","775","12","1498","3471","0","43.16","20.48"
"63","000","00","040","0009","0519","481","248","233","8","489","1125","0","43.47","22.04"
"63","000","00","040","0009","0520","581","261","320","1","582","1195","0","48.70","21.84"
"63","000","00","040","0009","0521","424","202","222","3","427","1151","0","37.10","17.55"
"63","000","00","040","0010","0000","1773","855","918","21","1794","4310","0","41.62","19.84"
"63","000","00","040","0010","0522","499","207","292","6","505","1124","0","44.93","18.42"
"63","000","00","040","0010","0523","483","226","257","5","488","1202","0","40.60","18.80"
"63","000","00","040","0010","0524","447","239","208","6","453","1056","0","42.90","22.63"
"63","000","00","040","0010","0525","344","183","161","4","348","928","0","37.50","19.72"
"63","000","00","040","0011","0000","1948","1023","925","12","1960","4704","0","41.67","21.75"
"63","000","00","040","0011","0526","462","249","213","3","465","1208","0","38.49","20.61"
"63","000","00","040","0011","0527","451","245","206","4","455","1030","0","44.17","23.79"
"63","000","00","040","0011","0528","529","260","269","3","532","1227","0","43.36","21.19"
"63","000","00","040","0011","0529","506","269","237","2","508","1239","0","41.00","21.71"
"63","000","00","040","0012","0000","1555","727","828","12","1567","3587","0","43.69","20.27"
"63","000","00","040","0012","0530","473","216","257","1","474","1136","0","41.73","19.01"
"63","000","00","040","0012","0531","600","280","320","7","607","1288","0","47.13","21.74"
"63","000","00","040","0012","0532","482","231","251","4","486","1163","0","41.79","19.86"
"63","000","00","040","0013","0000","1552","1199","353","21","1573","3095","0","50.82","38.74"
"63","000","00","040","0013","0536","491","385","106","9","500","984","0","50.81","39.13"
"63","000","00","040","0013","0537","476","340","136","5","481","1081","0","44.50","31.45"
"63","000","00","040","0013","0538","585","474","111","7","592","1030","0","57.48","46.02"
"63","000","00","040","0014","0000","3701","2101","1600","30","3731","7456","0","50.04","28.18"
"63","000","00","040","0014","0539","673","367","306","6","679","1332","0","50.98","27.55"
"63","000","00","040","0014","0540","581","343","238","4","585","1154","0","50.69","29.72"
"63","000","00","040","0014","0541","590","313","277","6","596","1188","0","50.17","26.35"
"63","000","00","040","0014","0542","701","410","291","7","708","1363","0","51.94","30.08"
"63","000","00","040","0014","0543","501","307","194","2","503","1075","0","46.79","28.56"
"63","000","00","040","0014","0544","655","361","294","5","660","1344","0","49.11","26.86"
"63","000","00","040","0015","0000","2485","1249","1236","20","2505","5305","0","47.22","23.54"
"63","000","00","040","0015","0545","691","345","346","6","697","1379","0","50.54","25.02"
"63","000","00","040","0015","0546","682","317","365","3","685","1402","0","48.86","22.61"
"63","000","00","040","0015","0547","620","328","292","9","629","1329","0","47.33","24.68"
"63","000","00","040","0015","0548","492","259","233","2","494","1195","0","41.34","21.67"
"63","000","00","040","0016","0000","3828","1998","1830","23","3851","7732","0","49.81","25.84"
"63","000","00","040","0016","0549","621","342","279","5","626","1314","0","47.64","26.03"
"63","000","00","040","0016","0550","716","381","335","4","720","1494","0","48.19","25.50"
"63","000","00","040","0016","0551","803","412","391","8","811","1607","0","50.47","25.64"
"63","000","00","040","0016","0552","806","412","394","4","810","1612","0","50.25","25.56"
"63","000","00","040","0016","0553","882","451","431","2","884","1705","0","51.85","26.45"
"63","000","00","040","0017","0000","414","150","264","2","416","904","0","46.02","16.59"
"63","000","00","040","0017","0577","414","150","264","2","416","904","0","46.02","16.59"
"63","000","00","040","0018","0000","1946","864","1082","18","1964","4399","0","44.65","19.64"
"63","000","00","040","0018","0561","641","278","363","4","645","1516","0","42.55","18.34"
"63","000","00","040","0018","0562","660","273","387","11","671","1441","0","46.56","18.95"
"63","000","00","040","0018","0563","645","313","332","3","648","1442","0","44.94","21.71"
"63","000","00","040","0019","0000","1991","897","1094","26","2017","4267","0","47.27","21.02"
"63","000","00","040","0019","0533","613","303","310","10","623","1447","0","43.05","20.94"
"63","000","00","040","0019","0534","761","324","437","6","767","1498","0","51.20","21.63"
"63","000","00","040","0019","0535","617","270","347","10","627","1322","0","47.43","20.42"
"63","000","00","040","0020","0000","2108","864","1244","16","2124","4414","0","48.12","19.57"
"63","000","00","040","0020","0564","747","263","484","4","751","1503","0","49.97","17.50"
"63","000","00","040","0020","0565","679","289","390","5","684","1424","0","48.03","20.29"
"63","000","00","040","0020","0566","682","312","370","7","689","1487","0","46.33","20.98"
"63","000","00","040","0021","0000","2561","1198","1363","25","2586","5384","0","48.03","22.25"
"63","000","00","040","0021","0567","557","228","329","3","560","1281","0","43.72","17.80"
"63","000","00","040","0021","0568","704","314","390","6","710","1432","0","49.58","21.93"
"63","000","00","040","0021","0569","670","335","335","9","679","1363","0","49.82","24.58"
"63","000","00","040","0021","0570","630","321","309","7","637","1308","0","48.70","24.54"
"63","000","00","040","0022","0000","1860","838","1022","14","1874","4061","0","46.15","20.64"
"63","000","00","040","0022","0571","584","274","310","4","588","1207","0","48.72","22.70"
"63","000","00","040","0022","0572","620","264","356","5","625","1373","0","45.52","19.23"
"63","000","00","040","0022","0573","656","300","356","5","661","1481","0","44.63","20.26"
"63","000","00","040","0023","0000","1956","858","1098","16","1972","4318","0","45.67","19.87"
"63","000","00","040","0023","0574","687","292","395","4","691","1537","0","44.96","19.00"
"63","000","00","040","0023","0575","641","288","353","7","648","1382","0","46.89","20.84"
"63","000","00","040","0023","0576","628","278","350","5","633","1399","0","45.25","19.87"
"63","000","00","040","0024","0000","2333","1132","1201","22","2355","6616","0","35.60","17.11"
"63","000","00","040","0024","0578","503","221","282","6","509","1006","0","50.60","21.97"
"63","000","00","040","0024","0579","534","264","270","6","540","1144","0","47.20","23.08"
"63","000","00","040","0024","0580","625","314","311","3","628","1278","0","49.14","24.57"
"63","000","00","040","0024","0581","671","333","338","7","678","3188","0","21.27","10.45"
"63","000","00","040","0025","0000","3065","1385","1680","29","3094","6794","0","45.54","20.39"
"63","000","00","040","0025","0582","637","279","358","1","638","1305","0","48.89","21.38"
"63","000","00","040","0025","0583","688","308","380","3","691","1544","0","44.75","19.95"
"63","000","00","040","0025","0584","550","249","301","5","555","1265","0","43.87","19.68"
"63","000","00","040","0025","0585","580","260","320","11","591","1329","0","44.47","19.56"
"63","000","00","040","0025","0586","610","289","321","9","619","1351","0","45.82","21.39"
"63","000","00","040","0026","0000","1587","689","898","14","1601","3692","0","43.36","18.66"
"63","000","00","040","0026","0587","598","286","312","8","606","1322","0","45.84","21.63"
"63","000","00","040","0026","0588","426","183","243","4","430","1118","0","38.46","16.37"
"63","000","00","040","0026","0589","563","220","343","2","565","1252","0","45.13","17.57"
"63","000","00","040","0027","0000","3084","1408","1676","20","3104","6421","0","48.34","21.93"
"63","000","00","040","0027","0590","623","291","332","4","627","1340","0","46.79","21.72"
"63","000","00","040","0027","0591","621","295","326","4","625","1214","0","51.48","24.30"
"63","000","00","040","0027","0592","598","285","313","1","599","1275","0","46.98","22.35"
"63","000","00","040","0027","0593","650","288","362","7","657","1317","0","49.89","21.87"
"63","000","00","040","0027","0594","592","249","343","4","596","1275","0","46.75","19.53"
"63","000","00","040","0028","0000","2848","1446","1402","21","2869","5828","0","49.23","24.81"
"63","000","00","040","0028","0595","804","410","394","3","807","1584","0","50.95","25.88"
"63","000","00","040","0028","0596","681","349","332","5","686","1403","0","48.90","24.88"
"63","000","00","040","0028","0597","667","313","354","3","670","1364","0","49.12","22.95"
"63","000","00","040","0028","0598","696","374","322","10","706","1477","0","47.80","25.32"
"63","000","00","040","0029","0000","3107","1433","1674","21","3128","6371","0","49.10","22.49"
"63","000","00","040","0029","0599","621","309","312","6","627","1279","0","49.02","24.16"
"63","000","00","040","0029","0600","577","266","311","2","579","1280","0","45.23","20.78"
"63","000","00","040","0029","0601","656","255","401","0","656","1302","0","50.38","19.59"
"63","000","00","040","0029","0602","628","279","349","8","636","1232","0","51.62","22.65"
"63","000","00","040","0029","0603","625","324","301","5","630","1278","0","49.30","25.35"
"63","000","00","040","0030","0000","2257","947","1310","22","2279","4719","0","48.29","20.07"
"63","000","00","040","0030","0604","735","358","377","10","745","1540","0","48.38","23.25"
"63","000","00","040","0030","0605","794","302","492","5","799","1590","0","50.25","18.99"
"63","000","00","040","0030","0606","728","287","441","7","735","1589","0","46.26","18.06"
"63","000","00","040","0031","0000","2187","984","1203","12","2199","4380","0","50.21","22.47"
"63","000","00","040","0031","0607","744","341","403","6","750","1512","0","49.60","22.55"
"63","000","00","040","0031","0608","756","321","435","4","760","1451","0","52.38","22.12"
"63","000","00","040","0031","0609","687","322","365","2","689","1417","0","48.62","22.72"
"63","000","00","040","0032","0000","2159","1017","1142","14","2173","4589","0","47.35","22.16"
"63","000","00","040","0032","0610","749","350","399","9","758","1593","0","47.58","21.97"
"63","000","00","040","0032","0611","712","345","367","4","716","1514","0","47.29","22.79"
"63","000","00","040","0032","0612","698","322","376","1","699","1482","0","47.17","21.73"
"63","000","00","040","0033","0000","1467","706","761","7","1474","3031","0","48.63","23.29"
"63","000","00","040","0033","0613","549","288","261","1","550","1128","0","48.76","25.53"
"63","000","00","040","0033","0614","491","230","261","2","493","1012","0","48.72","22.73"
"63","000","00","040","0033","0615","427","188","239","4","431","891","0","48.37","21.10"
"63","000","00","040","0034","0000","2073","1073","1000","17","2090","4892","0","42.72","21.93"
"63","000","00","040","0034","0616","546","275","271","4","550","1292","0","42.57","21.28"
"63","000","00","040","0034","0617","539","290","249","7","546","1233","0","44.28","23.52"
"63","000","00","040","0034","0618","471","240","231","3","474","1138","0","41.65","21.09"
"63","000","00","040","0034","0619","517","268","249","3","520","1229","0","42.31","21.81"
"63","000","00","040","0035","0000","2239","1541","698","20","2259","4278","0","52.81","36.02"
"63","000","00","040","0035","0620","518","318","200","0","518","1020","0","50.78","31.18"
"63","000","00","040","0035","0621","557","358","199","6","563","1085","0","51.89","33.00"
"63","000","00","040","0035","0622","581","421","160","6","587","1025","0","57.27","41.07"
"63","000","00","040","0035","0623","583","444","139","8","591","1148","0","51.48","38.68"
"63","000","00","040","0036","0000","1861","863","998","14","1875","3885","0","48.26","22.21"
"63","000","00","040","0036","0624","618","293","325","3","621","1310","0","47.40","22.37"
"63","000","00","040","0036","0625","598","277","321","6","604","1240","0","48.71","22.34"
"63","000","00","040","0036","0626","645","293","352","5","650","1335","0","48.69","21.95"
"63","000","00","040","0037","0000","1309","670","639","12","1321","2772","0","47.66","24.17"
"63","000","00","040","0037","0627","417","231","186","0","417","920","0","45.33","25.11"
"63","000","00","040","0037","0628","419","210","209","8","427","894","0","47.76","23.49"
"63","000","00","040","0037","0629","473","229","244","4","477","958","0","49.79","23.90"
"63","000","00","040","0038","0000","1208","567","641","12","1220","2553","0","47.79","22.21"
"63","000","00","040","0038","0630","651","319","332","6","657","1354","0","48.52","23.56"
"63","000","00","040","0038","0631","557","248","309","6","563","1199","0","46.96","20.68"
"63","000","00","040","0039","0000","2485","1142","1343","26","2511","5215","0","48.15","21.90"
"63","000","00","040","0039","0632","620","275","345","7","627","1296","0","48.38","21.22"
"63","000","00","040","0039","0633","584","230","354","7","591","1294","0","45.67","17.77"
"63","000","00","040","0039","0634","596","311","285","6","602","1271","0","47.36","24.47"
"63","000","00","040","0039","0635","685","326","359","6","691","1354","0","51.03","24.08"
"63","000","00","040","0040","0000","1930","1095","835","28","1958","4000","0","48.95","27.38"
"63","000","00","040","0040","0636","645","381","264","6","651","1383","0","47.07","27.55"
"63","000","00","040","0040","0637","676","348","328","16","692","1372","0","50.44","25.36"
"63","000","00","040","0040","0638","609","366","243","6","615","1245","0","49.40","29.40"
"63","000","00","040","0041","0000","2898","1570","1328","26","2924","6417","0","45.57","24.47"
"63","000","00","040","0041","0554","490","246","244","1","491","1014","0","48.42","24.26"
"63","000","00","040","0041","0555","581","330","251","7","588","1269","0","46.34","26.00"
"63","000","00","040","0041","0556","538","291","247","4","542","1261","0","42.98","23.08"
"63","000","00","040","0041","0557","662","338","324","6","668","1449","0","46.10","23.33"
"63","000","00","040","0041","0558","627","365","262","8","635","1424","0","44.59","25.63"
"63","000","00","040","0042","0000","1083","650","433","7","1090","2179","0","50.02","29.83"
"63","000","00","040","0042","0559","593","380","213","2","595","1185","0","50.21","32.07"
"63","000","00","040","0042","0560","490","270","220","5","495","994","0","49.80","27.16"
"63","000","00","050","0000","0000","59181","32866","26315","507","59688","123767","153172","48.23","26.55"
"63","000","00","050","0001","0000","1193","607","586","13","1206","2569","0","46.94","23.63"
"63","000","00","050","0001","0720","418","221","197","5","423","837","0","50.54","26.40"
"63","000","00","050","0001","0721","427","216","211","5","432","920","0","46.96","23.48"
"63","000","00","050","0001","0722","348","170","178","3","351","812","0","43.23","20.94"
"63","000","00","050","0002","0000","893","590","303","7","900","2107","0","42.71","28.00"
"63","000","00","050","0002","0723","493","360","133","4","497","1034","0","48.07","34.82"
"63","000","00","050","0002","0724","400","230","170","3","403","1073","0","37.56","21.44"
"63","000","00","050","0003","0000","1113","594","519","7","1120","2181","0","51.35","27.24"
"63","000","00","050","0003","0725","631","324","307","5","636","1183","0","53.76","27.39"
"63","000","00","050","0003","0726","482","270","212","2","484","998","0","48.50","27.05"
"63","000","00","050","0004","0000","1888","1112","776","15","1903","4011","0","47.44","27.72"
"63","000","00","050","0004","0727","455","235","220","2","457","981","0","46.59","23.96"
"63","000","00","050","0004","0728","432","272","160","3","435","985","0","44.16","27.61"
"63","000","00","050","0004","0729","522","330","192","7","529","1136","0","46.57","29.05"
"63","000","00","050","0004","0730","479","275","204","3","482","909","0","53.03","30.25"
"63","000","00","050","0005","0000","1943","1140","803","15","1958","3802","0","51.50","29.98"
"63","000","00","050","0005","0731","517","301","216","7","524","990","0","52.93","30.40"
"63","000","00","050","0005","0732","460","255","205","3","463","940","0","49.26","27.13"
"63","000","00","050","0005","0733","536","334","202","3","539","989","0","54.50","33.77"
"63","000","00","050","0005","0734","430","250","180","2","432","883","0","48.92","28.31"
"63","000","00","050","0006","0000","2687","1457","1230","20","2707","5155","0","52.51","28.26"
"63","000","00","050","0006","0735","564","321","243","2","566","1073","0","52.75","29.92"
"63","000","00","050","0006","0736","535","299","236","6","541","1025","0","52.78","29.17"
"63","000","00","050","0006","0737","488","250","238","6","494","960","0","51.46","26.04"
"63","000","00","050","0006","0738","533","281","252","3","536","1025","0","52.29","27.41"
"63","000","00","050","0006","0739","567","306","261","3","570","1072","0","53.17","28.54"
"63","000","00","050","0007","0000","2486","1375","1111","27","2513","4893","0","51.36","28.10"
"63","000","00","050","0007","0740","645","384","261","6","651","1195","0","54.48","32.13"
"63","000","00","050","0007","0741","640","371","269","3","643","1283","0","50.12","28.92"
"63","000","00","050","0007","0742","578","296","282","6","584","1159","0","50.39","25.54"
"63","000","00","050","0007","0743","623","324","299","12","635","1256","0","50.56","25.80"
"63","000","00","050","0008","0000","1306","752","554","7","1313","2775","0","47.32","27.10"
"63","000","00","050","0008","0744","389","223","166","0","389","873","0","44.56","25.54"
"63","000","00","050","0008","0745","424","222","202","3","427","900","0","47.44","24.67"
"63","000","00","050","0008","0746","493","307","186","4","497","1002","0","49.60","30.64"
"63","000","00","050","0009","0000","2372","1344","1028","15","2387","4773","0","50.01","28.16"
"63","000","00","050","0009","0747","607","337","270","7","614","1259","0","48.77","26.77"
"63","000","00","050","0009","0748","692","404","288","3","695","1414","0","49.15","28.57"
"63","000","00","050","0009","0749","496","262","234","1","497","1022","0","48.63","25.64"
"63","000","00","050","0009","0750","577","341","236","4","581","1078","0","53.90","31.63"
"63","000","00","050","0010","0000","1766","1018","748","13","1779","3653","0","48.70","27.87"
"63","000","00","050","0010","0751","619","375","244","7","626","1300","0","48.15","28.85"
"63","000","00","050","0010","0752","560","309","251","2","562","1136","0","49.47","27.20"
"63","000","00","050","0010","0753","587","334","253","4","591","1217","0","48.56","27.44"
"63","000","00","050","0011","0000","2456","1286","1170","40","2496","5214","0","47.87","24.66"
"63","000","00","050","0011","0639","490","252","238","7","497","1113","0","44.65","22.64"
"63","000","00","050","0011","0640","488","266","222","8","496","1048","0","47.33","25.38"
"63","000","00","050","0011","0641","452","229","223","6","458","986","0","46.45","23.23"
"63","000","00","050","0011","0642","479","258","221","10","489","974","0","50.21","26.49"
"63","000","00","050","0011","0643","547","281","266","9","556","1093","0","50.87","25.71"
"63","000","00","050","0012","0000","1980","1072","908","17","1997","4177","0","47.81","25.66"
"63","000","00","050","0012","0644","584","309","275","6","590","1112","0","53.06","27.79"
"63","000","00","050","0012","0645","472","230","242","4","476","1050","0","45.33","21.90"
"63","000","00","050","0012","0646","498","311","187","5","503","1061","0","47.41","29.31"
"63","000","00","050","0012","0647","426","222","204","2","428","954","0","44.86","23.27"
"63","000","00","050","0013","0000","1327","701","626","15","1342","2906","0","46.18","24.12"
"63","000","00","050","0013","0648","494","257","237","6","500","995","0","50.25","25.83"
"63","000","00","050","0013","0649","428","213","215","9","437","987","0","44.28","21.58"
"63","000","00","050","0013","0650","405","231","174","0","405","924","0","43.83","25.00"
"63","000","00","050","0014","0000","2327","1336","991","32","2359","5486","0","43.00","24.35"
"63","000","00","050","0014","0651","490","293","197","5","495","1183","0","41.84","24.77"
"63","000","00","050","0014","0652","484","309","175","9","493","1210","0","40.74","25.54"
"63","000","00","050","0014","0653","474","261","213","9","483","1041","0","46.40","25.07"
"63","000","00","050","0014","0654","378","234","144","5","383","894","0","42.84","26.17"
"63","000","00","050","0014","0655","501","239","262","4","505","1158","0","43.61","20.64"
"63","000","00","050","0015","0000","1590","812","778","10","1600","3475","0","46.04","23.37"
"63","000","00","050","0015","0656","515","273","242","2","517","1169","0","44.23","23.35"
"63","000","00","050","0015","0657","549","281","268","6","555","1189","0","46.68","23.63"
"63","000","00","050","0015","0658","526","258","268","2","528","1117","0","47.27","23.10"
"63","000","00","050","0016","0000","1228","650","578","12","1240","2583","0","48.01","25.16"
"63","000","00","050","0016","0659","398","181","217","5","403","837","0","48.15","21.62"
"63","000","00","050","0016","0660","417","255","162","3","420","897","0","46.82","28.43"
"63","000","00","050","0016","0661","413","214","199","4","417","849","0","49.12","25.21"
"63","000","00","050","0017","0000","1119","674","445","12","1131","2153","0","52.53","31.31"
"63","000","00","050","0017","0662","594","361","233","6","600","1091","0","55.00","33.09"
"63","000","00","050","0017","0663","525","313","212","6","531","1062","0","50.00","29.47"
"63","000","00","050","0018","0000","1352","789","563","14","1366","2662","0","51.31","29.64"
"63","000","00","050","0018","0664","504","281","223","8","512","997","0","51.35","28.18"
"63","000","00","050","0018","0665","433","278","155","3","436","825","0","52.85","33.70"
"63","000","00","050","0018","0666","415","230","185","3","418","840","0","49.76","27.38"
"63","000","00","050","0019","0000","4416","2476","1940","28","4444","8918","0","49.83","27.76"
"63","000","00","050","0019","0667","607","348","259","4","611","1313","0","46.53","26.50"
"63","000","00","050","0019","0668","582","315","267","5","587","1213","0","48.39","25.97"
"63","000","00","050","0019","0669","727","407","320","4","731","1369","0","53.40","29.73"
"63","000","00","050","0019","0670","662","364","298","5","667","1276","0","52.27","28.53"
"63","000","00","050","0019","0671","641","380","261","1","642","1239","0","51.82","30.67"
"63","000","00","050","0019","0672","575","304","271","5","580","1172","0","49.49","25.94"
"63","000","00","050","0019","0673","622","358","264","4","626","1336","0","46.86","26.80"
"63","000","00","050","0020","0000","2029","1118","911","17","2046","4216","0","48.53","26.52"
"63","000","00","050","0020","0674","480","266","214","1","481","1020","0","47.16","26.08"
"63","000","00","050","0020","0675","501","301","200","4","505","1068","0","47.28","28.18"
"63","000","00","050","0020","0676","524","283","241","4","528","1060","0","49.81","26.70"
"63","000","00","050","0020","0677","524","268","256","8","532","1068","0","49.81","25.09"
"63","000","00","050","0021","0000","3275","1954","1321","27","3302","6851","0","48.20","28.52"
"63","000","00","050","0021","0678","523","294","229","6","529","1112","0","47.57","26.44"
"63","000","00","050","0021","0679","552","324","228","3","555","1175","0","47.23","27.57"
"63","000","00","050","0021","0680","563","317","246","4","567","1173","0","48.34","27.02"
"63","000","00","050","0021","0681","553","323","230","3","556","1188","0","46.80","27.19"
"63","000","00","050","0021","0682","560","376","184","0","560","1089","0","51.42","34.53"
"63","000","00","050","0021","0683","524","320","204","11","535","1114","0","48.03","28.73"
"63","000","00","050","0022","0000","562","333","229","5","567","1240","0","45.73","26.85"
"63","000","00","050","0022","0684","562","333","229","5","567","1240","0","45.73","26.85"
"63","000","00","050","0023","0000","1405","742","663","9","1414","3153","0","44.85","23.53"
"63","000","00","050","0023","0685","377","214","163","3","380","887","0","42.84","24.13"
"63","000","00","050","0023","0686","509","251","258","2","511","1077","0","47.45","23.31"
"63","000","00","050","0023","0687","519","277","242","4","523","1189","0","43.99","23.30"
"63","000","00","050","0024","0000","1073","581","492","7","1080","2719","0","39.72","21.37"
"63","000","00","050","0024","0688","336","195","141","4","340","901","0","37.74","21.64"
"63","000","00","050","0024","0689","374","191","183","2","376","856","0","43.93","22.31"
"63","000","00","050","0024","0690","363","195","168","1","364","962","0","37.84","20.27"
"63","000","00","050","0025","0000","1289","644","645","9","1298","2626","0","49.43","24.52"
"63","000","00","050","0025","0691","464","221","243","5","469","896","0","52.34","24.67"
"63","000","00","050","0025","0692","393","213","180","4","397","860","0","46.16","24.77"
"63","000","00","050","0025","0693","432","210","222","0","432","870","0","49.66","24.14"
"63","000","00","050","0026","0000","1911","1066","845","14","1925","4871","0","39.52","21.88"
"63","000","00","050","0026","0694","561","312","249","3","564","1140","0","49.47","27.37"
"63","000","00","050","0026","0695","422","271","151","2","424","1775","0","23.89","15.27"
"63","000","00","050","0026","0696","458","249","209","4","462","1002","0","46.11","24.85"
"63","000","00","050","0026","0697","470","234","236","5","475","954","0","49.79","24.53"
"63","000","00","050","0027","0000","1927","987","940","15","1942","3689","0","52.64","26.76"
"63","000","00","050","0027","0698","462","237","225","1","463","863","0","53.65","27.46"
"63","000","00","050","0027","0699","501","232","269","6","507","988","0","51.32","23.48"
"63","000","00","050","0027","0700","530","280","250","6","536","974","0","55.03","28.75"
"63","000","00","050","0027","0701","434","238","196","2","436","864","0","50.46","27.55"
"63","000","00","050","0028","0000","1505","902","603","15","1520","3113","0","48.83","28.98"
"63","000","00","050","0028","0702","499","280","219","4","503","1047","0","48.04","26.74"
"63","000","00","050","0028","0703","499","295","204","5","504","1005","0","50.15","29.35"
"63","000","00","050","0028","0704","507","327","180","6","513","1061","0","48.35","30.82"
"63","000","00","050","0029","0000","2303","1234","1069","14","2317","4517","0","51.30","27.32"
"63","000","00","050","0029","0705","590","335","255","6","596","1216","0","49.01","27.55"
"63","000","00","050","0029","0706","607","327","280","3","610","1188","0","51.35","27.53"
"63","000","00","050","0029","0707","474","243","231","2","476","930","0","51.18","26.13"
"63","000","00","050","0029","0708","632","329","303","3","635","1183","0","53.68","27.81"
"63","000","00","050","0030","0000","3073","1684","1389","27","3100","6282","0","49.35","26.81"
"63","000","00","050","0030","0709","681","361","320","5","686","1389","0","49.39","25.99"
"63","000","00","050","0030","0710","570","328","242","2","572","1238","0","46.20","26.49"
"63","000","00","050","0030","0711","683","371","312","5","688","1381","0","49.82","26.86"
"63","000","00","050","0030","0712","528","294","234","5","533","1050","0","50.76","28.00"
"63","000","00","050","0030","0713","611","330","281","10","621","1224","0","50.74","26.96"
"63","000","00","050","0031","0000","3387","1836","1551","29","3416","6997","0","48.82","26.24"
"63","000","00","050","0031","0714","497","283","214","3","500","1095","0","45.66","25.84"
"63","000","00","050","0031","0715","565","290","275","6","571","1158","0","49.31","25.04"
"63","000","00","050","0031","0716","565","313","252","10","575","1170","0","49.15","26.75"
"63","000","00","050","0031","0717","572","277","295","3","575","1096","0","52.46","25.27"
"63","000","00","050","0031","0718","536","307","229","3","539","1168","0","46.15","26.28"
"63","000","00","050","0031","0719","652","366","286","4","656","1310","0","50.08","27.94"
"63","000","00","060","0000","0000","47312","19799","27513","373","47685","103815","122719","45.93","19.07"
"63","000","00","060","0001","0000","1137","483","654","12","1149","2534","0","45.34","19.06"
"63","000","00","060","0001","0754","530","221","309","6","536","1207","0","44.41","18.31"
"63","000","00","060","0001","0755","607","262","345","6","613","1327","0","46.19","19.74"
"63","000","00","060","0002","0000","1219","510","709","10","1229","2790","0","44.05","18.28"
"63","000","00","060","0002","0756","493","213","280","3","496","1018","0","48.72","20.92"
"63","000","00","060","0002","0757","431","161","270","2","433","997","0","43.43","16.15"
"63","000","00","060","0002","0758","295","136","159","5","300","775","0","38.71","17.55"
"63","000","00","060","0003","0000","1739","742","997","12","1751","3999","0","43.79","18.55"
"63","000","00","060","0003","0759","583","243","340","6","589","1366","0","43.12","17.79"
"63","000","00","060","0003","0760","572","240","332","5","577","1269","0","45.47","18.91"
"63","000","00","060","0003","0761","584","259","325","1","585","1364","0","42.89","18.99"
"63","000","00","060","0004","0000","1418","576","842","31","1449","3039","0","47.68","18.95"
"63","000","00","060","0004","0762","454","191","263","6","460","969","0","47.47","19.71"
"63","000","00","060","0004","0763","461","191","270","11","472","926","0","50.97","20.63"
"63","000","00","060","0004","0764","503","194","309","14","517","1144","0","45.19","16.96"
"63","000","00","060","0005","0000","2041","796","1245","11","2052","4399","0","46.65","18.10"
"63","000","00","060","0005","0765","544","226","318","2","546","1146","0","47.64","19.72"
"63","000","00","060","0005","0766","407","151","256","1","408","970","0","42.06","15.57"
"63","000","00","060","0005","0767","516","189","327","4","520","1166","0","44.60","16.21"
"63","000","00","060","0005","0768","574","230","344","4","578","1117","0","51.75","20.59"
"63","000","00","060","0006","0000","1804","781","1023","10","1814","3812","0","47.59","20.49"
"63","000","00","060","0006","0769","595","306","289","2","597","1254","0","47.61","24.40"
"63","000","00","060","0006","0770","594","238","356","2","596","1307","0","45.60","18.21"
"63","000","00","060","0006","0771","615","237","378","6","621","1251","0","49.64","18.94"
"63","000","00","060","0007","0000","2180","976","1204","16","2196","4940","0","44.45","19.76"
"63","000","00","060","0007","0772","560","278","282","4","564","1235","0","45.67","22.51"
"63","000","00","060","0007","0773","502","212","290","3","505","1165","0","43.35","18.20"
"63","000","00","060","0007","0774","559","234","325","4","563","1243","0","45.29","18.83"
"63","000","00","060","0007","0775","559","252","307","5","564","1297","0","43.48","19.43"
"63","000","00","060","0008","0000","1949","838","1111","11","1960","4161","0","47.10","20.14"
"63","000","00","060","0008","0776","458","188","270","6","464","974","0","47.64","19.30"
"63","000","00","060","0008","0777","515","240","275","4","519","1129","0","45.97","21.26"
"63","000","00","060","0008","0778","464","196","268","1","465","942","0","49.36","20.81"
"63","000","00","060","0008","0779","512","214","298","0","512","1116","0","45.88","19.18"
"63","000","00","060","0009","0000","1816","707","1109","19","1835","3943","0","46.54","17.93"
"63","000","00","060","0009","0780","642","247","395","5","647","1338","0","48.36","18.46"
"63","000","00","060","0009","0781","570","244","326","6","576","1299","0","44.34","18.78"
"63","000","00","060","0009","0782","604","216","388","8","612","1306","0","46.86","16.54"
"63","000","00","060","0010","0000","1590","684","906","13","1603","3592","0","44.63","19.04"
"63","000","00","060","0010","0783","451","201","250","5","456","1082","0","42.14","18.58"
"63","000","00","060","0010","0784","568","266","302","1","569","1214","0","46.87","21.91"
"63","000","00","060","0010","0785","571","217","354","7","578","1296","0","44.60","16.74"
"63","000","00","060","0011","0000","3427","1483","1944","26","3453","7671","0","45.01","19.33"
"63","000","00","060","0011","0786","567","225","342","5","572","1340","0","42.69","16.79"
"63","000","00","060","0011","0787","540","249","291","3","543","1168","0","46.49","21.32"
"63","000","00","060","0011","0788","548","233","315","3","551","1259","0","43.76","18.51"
"63","000","00","060","0011","0789","668","281","387","8","676","1337","0","50.56","21.02"
"63","000","00","060","0011","0790","593","249","344","1","594","1357","0","43.77","18.35"
"63","000","00","060","0011","0791","511","246","265","6","517","1210","0","42.73","20.33"
"63","000","00","060","0012","0000","1536","640","896","15","1551","3376","0","45.94","18.96"
"63","000","00","060","0012","0792","553","217","336","5","558","1128","0","49.47","19.24"
"63","000","00","060","0012","0793","485","214","271","3","488","1097","0","44.48","19.51"
"63","000","00","060","0012","0794","498","209","289","7","505","1151","0","43.87","18.16"
"63","000","00","060","0013","0000","2490","1119","1371","12","2502","5223","0","47.90","21.42"
"63","000","00","060","0013","0795","617","272","345","2","619","1338","0","46.26","20.33"
"63","000","00","060","0013","0796","645","275","370","5","650","1305","0","49.81","21.07"
"63","000","00","060","0013","0797","633","288","345","4","637","1320","0","48.26","21.82"
"63","000","00","060","0013","0798","595","284","311","1","596","1260","0","47.30","22.54"
"63","000","00","060","0014","0000","985","383","602","6","991","2231","0","44.42","17.17"
"63","000","00","060","0014","0799","459","173","286","1","460","1080","0","42.59","16.02"
"63","000","00","060","0014","0800","526","210","316","5","531","1151","0","46.13","18.25"
"63","000","00","060","0015","0000","1413","547","866","10","1423","2898","0","49.10","18.88"
"63","000","00","060","0015","0801","630","236","394","5","635","1316","0","48.25","17.93"
"63","000","00","060","0015","0802","783","311","472","5","788","1582","0","49.81","19.66"
"63","000","00","060","0016","0000","1953","827","1126","14","1967","4213","0","46.69","19.63"
"63","000","00","060","0016","0803","486","205","281","5","491","1013","0","48.47","20.24"
"63","000","00","060","0016","0804","553","246","307","2","555","1206","0","46.02","20.40"
"63","000","00","060","0016","0805","440","185","255","4","444","935","0","47.49","19.79"
"63","000","00","060","0016","0806","474","191","283","3","477","1059","0","45.04","18.04"
"63","000","00","060","0017","0000","1000","357","643","7","1007","2305","0","43.69","15.49"
"63","000","00","060","0017","0807","547","202","345","4","551","1166","0","47.26","17.32"
"63","000","00","060","0017","0808","453","155","298","3","456","1139","0","40.04","13.61"
"63","000","00","060","0018","0000","1903","813","1090","13","1916","3894","0","49.20","20.88"
"63","000","00","060","0018","0809","629","268","361","3","632","1280","0","49.38","20.94"
"63","000","00","060","0018","0810","624","273","351","5","629","1272","0","49.45","21.46"
"63","000","00","060","0018","0811","650","272","378","5","655","1342","0","48.81","20.27"
"63","000","00","060","0019","0000","1419","564","855","15","1434","4063","0","35.29","13.88"
"63","000","00","060","0019","0812","470","186","284","5","475","959","0","49.53","19.40"
"63","000","00","060","0019","0813","460","189","271","6","466","2117","0","22.01","8.93"
"63","000","00","060","0019","0814","489","189","300","4","493","987","0","49.95","19.15"
"63","000","00","060","0020","0000","1805","721","1084","18","1823","4057","0","44.93","17.77"
"63","000","00","060","0020","0815","352","106","246","3","355","1012","0","35.08","10.47"
"63","000","00","060","0020","0816","460","190","270","3","463","1027","0","45.08","18.50"
"63","000","00","060","0020","0817","481","186","295","5","486","1062","0","45.76","17.51"
"63","000","00","060","0020","0818","512","239","273","7","519","956","0","54.29","25.00"
"63","000","00","060","0021","0000","2593","1024","1569","20","2613","5537","0","47.19","18.49"
"63","000","00","060","0021","0819","508","182","326","4","512","1115","0","45.92","16.32"
"63","000","00","060","0021","0820","550","243","307","2","552","1099","0","50.23","22.11"
"63","000","00","060","0021","0821","535","200","335","3","538","1120","0","48.04","17.86"
"63","000","00","060","0021","0822","525","210","315","6","531","1167","0","45.50","17.99"
"63","000","00","060","0021","0823","475","189","286","5","480","1036","0","46.33","18.24"
"63","000","00","060","0022","0000","3181","1328","1853","28","3209","6748","0","47.55","19.68"
"63","000","00","060","0022","0824","457","188","269","2","459","1011","0","45.40","18.60"
"63","000","00","060","0022","0825","437","162","275","5","442","974","0","45.38","16.63"
"63","000","00","060","0022","0826","571","272","299","4","575","1101","0","52.23","24.70"
"63","000","00","060","0022","0827","583","280","303","4","587","1235","0","47.53","22.67"
"63","000","00","060","0022","0828","601","246","355","7","608","1276","0","47.65","19.28"
"63","000","00","060","0022","0829","532","180","352","6","538","1151","0","46.74","15.64"
"63","000","00","060","0024","0000","2162","861","1301","11","2173","4953","0","43.87","17.38"
"63","000","00","060","0024","0830","522","193","329","0","522","1265","0","41.26","15.26"
"63","000","00","060","0024","0831","594","241","353","2","596","1345","0","44.31","17.92"
"63","000","00","060","0024","0832","494","208","286","3","497","1162","0","42.77","17.90"
"63","000","00","060","0024","0833","552","219","333","6","558","1181","0","47.25","18.54"
"63","000","00","060","0025","0000","2694","1273","1421","15","2709","5666","0","47.81","22.47"
"63","000","00","060","0025","0834","473","211","262","1","474","1080","0","43.89","19.54"
"63","000","00","060","0025","0835","559","267","292","6","565","1144","0","49.39","23.34"
"63","000","00","060","0025","0836","576","290","286","3","579","1122","0","51.60","25.85"
"63","000","00","060","0025","0837","541","267","274","2","543","1138","0","47.72","23.46"
"63","000","00","060","0025","0838","545","238","307","3","548","1182","0","46.36","20.14"
"63","000","00","060","0026","0000","1858","766","1092","18","1876","3771","0","49.75","20.31"
"63","000","00","060","0026","0839","632","232","400","8","640","1310","0","48.85","17.71"
"63","000","00","060","0026","0840","642","269","373","5","647","1300","0","49.77","20.69"
"63","000","00","060","0026","0841","584","265","319","5","589","1161","0","50.73","22.83"
"63","000","00","070","0000","0000","71347","36009","35338","728","72075","157078","179485","45.88","22.92"
"63","000","00","070","0001","0000","1951","1040","911","26","1977","4638","0","42.63","22.42"
"63","000","00","070","0001","0842","528","269","259","4","532","1159","0","45.90","23.21"
"63","000","00","070","0001","0843","481","301","180","13","494","1153","0","42.84","26.11"
"63","000","00","070","0001","0844","477","238","239","3","480","1195","0","40.17","19.92"
"63","000","00","070","0001","0845","465","232","233","6","471","1131","0","41.64","20.51"
"63","000","00","070","0002","0000","1117","610","507","17","1134","2831","0","40.06","21.55"
"63","000","00","070","0002","0846","397","211","186","6","403","906","0","44.48","23.29"
"63","000","00","070","0002","0847","388","197","191","6","394","972","0","40.53","20.27"
"63","000","00","070","0002","0848","332","202","130","5","337","953","0","35.36","21.20"
"63","000","00","070","0003","0000","1344","724","620","9","1353","3187","0","42.45","22.72"
"63","000","00","070","0003","0849","478","278","200","4","482","1096","0","43.98","25.36"
"63","000","00","070","0003","0850","460","237","223","2","462","1114","0","41.47","21.27"
"63","000","00","070","0003","0851","406","209","197","3","409","977","0","41.86","21.39"
"63","000","00","070","0004","0000","2700","1351","1349","36","2736","5920","0","46.22","22.82"
"63","000","00","070","0004","0852","536","254","282","5","541","1156","0","46.80","21.97"
"63","000","00","070","0004","0853","537","248","289","6","543","1157","0","46.93","21.43"
"63","000","00","070","0004","0854","563","299","264","8","571","1252","0","45.61","23.88"
"63","000","00","070","0004","0855","645","325","320","8","653","1423","0","45.89","22.84"
"63","000","00","070","0004","0856","419","225","194","9","428","932","0","45.92","24.14"
"63","000","00","070","0005","0000","2519","1133","1386","12","2531","5356","0","47.26","21.15"
"63","000","00","070","0005","0857","557","234","323","2","559","1295","0","43.17","18.07"
"63","000","00","070","0005","0858","593","261","332","2","595","1255","0","47.41","20.80"
"63","000","00","070","0005","0859","644","332","312","5","649","1383","0","46.93","24.01"
"63","000","00","070","0005","0860","725","306","419","3","728","1423","0","51.16","21.50"
"63","000","00","070","0006","0000","2252","1045","1207","19","2271","5124","0","44.32","20.39"
"63","000","00","070","0006","0861","599","312","287","4","603","1318","0","45.75","23.67"
"63","000","00","070","0006","0862","604","283","321","7","611","1329","0","45.97","21.29"
"63","000","00","070","0006","0863","499","207","292","5","504","1198","0","42.07","17.28"
"63","000","00","070","0006","0864","550","243","307","3","553","1279","0","43.24","19.00"
"63","000","00","070","0007","0000","1964","828","1136","26","1990","4299","0","46.29","19.26"
"63","000","00","070","0007","0865","461","189","272","7","468","1100","0","42.55","17.18"
"63","000","00","070","0007","0866","565","264","301","6","571","1170","0","48.80","22.56"
"63","000","00","070","0007","0867","431","173","258","9","440","1008","0","43.65","17.16"
"63","000","00","070","0007","0868","507","202","305","4","511","1021","0","50.05","19.78"
"63","000","00","070","0008","0000","1566","701","865","12","1578","3366","0","46.88","20.83"
"63","000","00","070","0008","0869","536","257","279","2","538","1219","0","44.13","21.08"
"63","000","00","070","0008","0870","498","227","271","5","503","985","0","51.07","23.05"
"63","000","00","070","0008","0871","532","217","315","5","537","1162","0","46.21","18.67"
"63","000","00","070","0009","0000","2027","962","1065","11","2038","4094","0","49.78","23.50"
"63","000","00","070","0009","0872","623","300","323","2","625","1188","0","52.61","25.25"
"63","000","00","070","0009","0873","510","253","257","5","515","1001","0","51.45","25.27"
"63","000","00","070","0009","0874","466","202","264","3","469","1041","0","45.05","19.40"
"63","000","00","070","0009","0875","428","207","221","1","429","864","0","49.65","23.96"
"63","000","00","070","0010","0000","1913","833","1080","22","1935","5354","0","36.14","15.56"
"63","000","00","070","0010","0876","555","227","328","5","560","2607","0","21.48","8.71"
"63","000","00","070","0010","0877","437","194","243","2","439","868","0","50.58","22.35"
"63","000","00","070","0010","0878","461","215","246","6","467","944","0","49.47","22.78"
"63","000","00","070","0010","0879","460","197","263","9","469","935","0","50.16","21.07"
"63","000","00","070","0011","0000","2821","1244","1577","23","2844","6064","0","46.90","20.51"
"63","000","00","070","0011","0897","432","173","259","3","435","994","0","43.76","17.40"
"63","000","00","070","0011","0898","593","254","339","5","598","1188","0","50.34","21.38"
"63","000","00","070","0011","0899","496","214","282","3","499","1047","0","47.66","20.44"
"63","000","00","070","0011","0900","656","283","373","9","665","1424","0","46.70","19.87"
"63","000","00","070","0011","0901","644","320","324","3","647","1411","0","45.85","22.68"
"63","000","00","070","0012","0000","1773","812","961","19","1792","3864","0","46.38","21.01"
"63","000","00","070","0012","0902","597","254","343","4","601","1315","0","45.70","19.32"
"63","000","00","070","0012","0903","614","272","342","10","624","1349","0","46.26","20.16"
"63","000","00","070","0012","0904","562","286","276","5","567","1200","0","47.25","23.83"
"63","000","00","070","0013","0000","1531","1161","370","8","1539","2993","0","51.42","38.79"
"63","000","00","070","0013","0960","385","241","144","4","389","946","0","41.12","25.48"
"63","000","00","070","0013","0961","518","402","116","3","521","925","0","56.32","43.46"
"63","000","00","070","0013","0962","628","518","110","1","629","1122","0","56.06","46.17"
"63","000","00","070","0014","0000","3763","2768","995","45","3808","7108","0","53.57","38.94"
"63","000","00","070","0014","0963","650","519","131","11","661","1152","0","57.38","45.05"
"63","000","00","070","0014","0964","631","471","160","7","638","1127","0","56.61","41.79"
"63","000","00","070","0014","0965","598","408","190","8","606","1181","0","51.31","34.55"
"63","000","00","070","0014","0966","647","475","172","11","658","1233","0","53.37","38.52"
"63","000","00","070","0014","0967","602","464","138","3","605","1179","0","51.31","39.36"
"63","000","00","070","0014","0968","635","431","204","5","640","1236","0","51.78","34.87"
"63","000","00","070","0015","0000","2202","993","1209","19","2221","4679","0","47.47","21.22"
"63","000","00","070","0015","0890","542","201","341","6","548","1159","0","47.28","17.34"
"63","000","00","070","0015","0891","547","255","292","2","549","1147","0","47.86","22.23"
"63","000","00","070","0015","0892","544","277","267","6","550","1261","0","43.62","21.97"
"63","000","00","070","0015","0893","569","260","309","5","574","1112","0","51.62","23.38"
"63","000","00","070","0016","0000","2479","957","1522","28","2507","5752","0","43.58","16.64"
"63","000","00","070","0016","0905","541","188","353","4","545","1294","0","42.12","14.53"
"63","000","00","070","0016","0906","463","184","279","7","470","1064","0","44.17","17.29"
"63","000","00","070","0016","0907","547","218","329","6","553","1172","0","47.18","18.60"
"63","000","00","070","0016","0908","474","194","280","4","478","1041","0","45.92","18.64"
"63","000","00","070","0016","0909","454","173","281","7","461","1181","0","39.03","14.65"
"63","000","00","070","0017","0000","1510","779","731","19","1529","3698","0","41.35","21.07"
"63","000","00","070","0017","0894","511","249","262","8","519","1181","0","43.95","21.08"
"63","000","00","070","0017","0895","512","283","229","4","516","1248","0","41.35","22.68"
"63","000","00","070","0017","0896","487","247","240","7","494","1269","0","38.93","19.46"
"63","000","00","070","0018","0000","3192","1523","1669","27","3219","7226","0","44.55","21.08"
"63","000","00","070","0018","0884","455","239","216","6","461","1190","0","38.74","20.08"
"63","000","00","070","0018","0885","569","265","304","4","573","1256","0","45.62","21.10"
"63","000","00","070","0018","0886","543","251","292","0","543","1146","0","47.38","21.90"
"63","000","00","070","0018","0887","630","303","327","5","635","1231","0","51.58","24.61"
"63","000","00","070","0018","0888","577","247","330","8","585","1275","0","45.88","19.37"
"63","000","00","070","0018","0889","418","218","200","4","422","1128","0","37.41","19.33"
"63","000","00","070","0019","0000","1895","803","1092","22","1917","4403","0","43.54","18.24"
"63","000","00","070","0019","0880","427","192","235","3","430","1013","0","42.45","18.95"
"63","000","00","070","0019","0881","529","221","308","9","538","1167","0","46.10","18.94"
"63","000","00","070","0019","0882","475","199","276","7","482","1092","0","44.14","18.22"
"63","000","00","070","0019","0883","464","191","273","3","467","1131","0","41.29","16.89"
"63","000","00","070","0020","0000","1449","670","779","12","1461","3103","0","47.08","21.59"
"63","000","00","070","0020","0918","447","216","231","2","449","996","0","45.08","21.69"
"63","000","00","070","0020","0919","487","218","269","4","491","1033","0","47.53","21.10"
"63","000","00","070","0020","0920","515","236","279","6","521","1074","0","48.51","21.97"
"63","000","00","070","0021","0000","2213","1327","886","27","2240","5228","0","42.85","25.38"
"63","000","00","070","0021","0969","451","247","204","5","456","1160","0","39.31","21.29"
"63","000","00","070","0021","0970","375","201","174","8","383","948","0","40.40","21.20"
"63","000","00","070","0021","0971","369","204","165","6","375","955","0","39.27","21.36"
"63","000","00","070","0021","0972","505","300","205","3","508","1146","0","44.33","26.18"
"63","000","00","070","0021","0973","513","375","138","5","518","1019","0","50.83","36.80"
"63","000","00","070","0022","0000","1750","764","986","13","1763","3813","0","46.24","20.04"
"63","000","00","070","0022","0921","574","239","335","6","580","1320","0","43.94","18.11"
"63","000","00","070","0022","0922","581","276","305","3","584","1197","0","48.79","23.06"
"63","000","00","070","0022","0923","595","249","346","4","599","1296","0","46.22","19.21"
"63","000","00","070","0023","0000","1311","524","787","13","1324","2802","0","47.25","18.70"
"63","000","00","070","0023","0928","610","249","361","10","620","1359","0","45.62","18.32"
"63","000","00","070","0023","0929","701","275","426","3","704","1443","0","48.79","19.06"
"63","000","00","070","0024","0000","2295","1003","1292","23","2318","5570","0","41.62","18.01"
"63","000","00","070","0024","0910","522","217","305","3","525","1117","0","47.00","19.43"
"63","000","00","070","0024","0911","468","193","275","6","474","1190","0","39.83","16.22"
"63","000","00","070","0024","0912","347","155","192","5","352","944","0","37.29","16.42"
"63","000","00","070","0024","0913","425","197","228","4","429","1119","0","38.34","17.61"
"63","000","00","070","0024","0914","533","241","292","5","538","1200","0","44.83","20.08"
"63","000","00","070","0025","0000","2097","986","1111","21","2118","4714","0","44.93","20.92"
"63","000","00","070","0025","0924","580","281","299","8","588","1197","0","49.12","23.48"
"63","000","00","070","0025","0925","553","278","275","5","558","1234","0","45.22","22.53"
"63","000","00","070","0025","0926","498","225","273","3","501","1197","0","41.85","18.80"
"63","000","00","070","0025","0927","466","202","264","5","471","1086","0","43.37","18.60"
"63","000","00","070","0026","0000","1683","797","886","24","1707","3631","0","47.01","21.95"
"63","000","00","070","0026","0915","507","241","266","11","518","1119","0","46.29","21.54"
"63","000","00","070","0026","0916","611","244","367","4","615","1335","0","46.07","18.28"
"63","000","00","070","0026","0917","565","312","253","9","574","1177","0","48.77","26.51"
"63","000","00","070","0027","0000","1341","647","694","5","1346","2752","0","48.91","23.51"
"63","000","00","070","0027","0937","497","235","262","2","499","1024","0","48.73","22.95"
"63","000","00","070","0027","0938","410","187","223","2","412","853","0","48.30","21.92"
"63","000","00","070","0027","0939","434","225","209","1","435","875","0","49.71","25.71"
"63","000","00","070","0028","0000","1770","792","978","16","1786","3985","0","44.82","19.87"
"63","000","00","070","0028","0934","630","287","343","6","636","1313","0","48.44","21.86"
"63","000","00","070","0028","0935","605","264","341","7","612","1357","0","45.10","19.45"
"63","000","00","070","0028","0936","535","241","294","3","538","1315","0","40.91","18.33"
"63","000","00","070","0029","0000","1483","658","825","20","1503","3075","0","48.88","21.40"
"63","000","00","070","0029","0940","503","215","288","5","508","1014","0","50.10","21.20"
"63","000","00","070","0029","0941","489","215","274","6","495","1011","0","48.96","21.27"
"63","000","00","070","0029","0942","491","228","263","9","500","1050","0","47.62","21.71"
"63","000","00","070","0030","0000","1946","950","996","17","1963","4233","0","46.37","22.44"
"63","000","00","070","0030","0930","464","208","256","7","471","1048","0","44.94","19.85"
"63","000","00","070","0030","0931","496","253","243","3","499","1159","0","43.05","21.83"
"63","000","00","070","0030","0932","472","238","234","3","475","1008","0","47.12","23.61"
"63","000","00","070","0030","0933","514","251","263","4","518","1018","0","50.88","24.66"
"63","000","00","070","0031","0000","1743","786","957","16","1759","3911","0","44.98","20.10"
"63","000","00","070","0031","0948","563","245","318","7","570","1243","0","45.86","19.71"
"63","000","00","070","0031","0949","644","311","333","4","648","1354","0","47.86","22.97"
"63","000","00","070","0031","0950","536","230","306","5","541","1314","0","41.17","17.50"
"63","000","00","070","0032","0000","2447","1107","1340","26","2473","5226","0","47.32","21.18"
"63","000","00","070","0032","0943","572","247","325","2","574","1147","0","50.04","21.53"
"63","000","00","070","0032","0944","410","191","219","9","419","944","0","44.39","20.23"
"63","000","00","070","0032","0945","518","235","283","6","524","1100","0","47.64","21.36"
"63","000","00","070","0032","0946","529","230","299","3","532","1124","0","47.33","20.46"
"63","000","00","070","0032","0947","418","204","214","6","424","911","0","46.54","22.39"
"63","000","00","070","0033","0000","2557","1612","945","27","2584","5167","0","50.01","31.20"
"63","000","00","070","0033","0951","423","226","197","7","430","990","0","43.43","22.83"
"63","000","00","070","0033","0952","507","282","225","3","510","998","0","51.10","28.26"
"63","000","00","070","0033","0953","658","518","140","7","665","1213","0","54.82","42.70"
"63","000","00","070","0033","0954","532","344","188","5","537","998","0","53.81","34.47"
"63","000","00","070","0033","0955","437","242","195","5","442","968","0","45.66","25.00"
"63","000","00","070","0034","0000","1955","1320","635","25","1980","4179","0","47.38","31.59"
"63","000","00","070","0034","0956","539","404","135","6","545","1034","0","52.71","39.07"
"63","000","00","070","0034","0957","545","393","152","1","546","1091","0","50.05","36.02"
"63","000","00","070","0034","0958","434","254","180","9","443","1038","0","42.68","24.47"
"63","000","00","070","0034","0959","437","269","168","9","446","1016","0","43.90","26.48"
"63","000","00","070","0035","0000","1456","954","502","25","1481","3097","0","47.82","30.80"
"63","000","00","070","0035","0974","494","320","174","12","506","1043","0","48.51","30.68"
"63","000","00","070","0035","0975","478","298","180","7","485","1019","0","47.60","29.24"
"63","000","00","070","0035","0976","484","336","148","6","490","1035","0","47.34","32.46"
"63","000","00","070","0036","0000","1332","845","487","18","1350","2636","0","51.21","32.06"
"63","000","00","070","0036","0977","683","447","236","3","686","1313","0","52.25","34.04"
"63","000","00","070","0036","0978","649","398","251","15","664","1323","0","50.19","30.08"
"63","000","00","080","0000","0000","106535","65650","40885","926","107461","222227","264975","48.36","29.54"
"63","000","00","080","0001","0000","2886","1575","1311","28","2914","6344","0","45.93","24.83"
"63","000","00","080","0001","0979","592","276","316","5","597","1316","0","45.36","20.97"
"63","000","00","080","0001","0980","548","314","234","4","552","1204","0","45.85","26.08"
"63","000","00","080","0001","0981","564","297","267","4","568","1204","0","47.18","24.67"
"63","000","00","080","0001","0982","665","387","278","9","674","1421","0","47.43","27.23"
"63","000","00","080","0001","0983","517","301","216","6","523","1199","0","43.62","25.10"
"63","000","00","080","0002","0000","2827","1833","994","15","2842","5987","0","47.47","30.62"
"63","000","00","080","0002","0984","734","467","267","5","739","1547","0","47.77","30.19"
"63","000","00","080","0002","0985","687","465","222","3","690","1500","0","46.00","31.00"
"63","000","00","080","0002","0986","670","436","234","4","674","1417","0","47.57","30.77"
"63","000","00","080","0002","0987","736","465","271","3","739","1523","0","48.52","30.53"
"63","000","00","080","0003","0000","2059","1164","895","10","2069","4219","0","49.04","27.59"
"63","000","00","080","0003","0988","708","403","305","3","711","1438","0","49.44","28.03"
"63","000","00","080","0003","0989","684","403","281","6","690","1374","0","50.22","29.33"
"63","000","00","080","0003","0990","667","358","309","1","668","1407","0","47.48","25.44"
"63","000","00","080","0004","0000","2632","1526","1106","26","2658","5431","0","48.94","28.10"
"63","000","00","080","0004","0991","620","364","256","6","626","1361","0","46.00","26.75"
"63","000","00","080","0004","0992","664","397","267","4","668","1352","0","49.41","29.36"
"63","000","00","080","0004","0993","671","393","278","9","680","1376","0","49.42","28.56"
"63","000","00","080","0004","0994","677","372","305","7","684","1342","0","50.97","27.72"
"63","000","00","080","0005","0000","2341","1421","920","27","2368","4675","0","50.65","30.40"
"63","000","00","080","0005","0995","565","338","227","7","572","1193","0","47.95","28.33"
"63","000","00","080","0005","0996","581","342","239","7","588","1239","0","47.46","27.60"
"63","000","00","080","0005","0997","643","402","241","7","650","1251","0","51.96","32.13"
"63","000","00","080","0005","0998","552","339","213","6","558","992","0","56.25","34.17"
"63","000","00","080","0006","0000","2371","1450","921","14","2385","4768","0","50.02","30.41"
"63","000","00","080","0006","0999","577","358","219","1","578","1168","0","49.49","30.65"
"63","000","00","080","0006","1000","519","325","194","5","524","1136","0","46.13","28.61"
"63","000","00","080","0006","1001","653","397","256","2","655","1238","0","52.91","32.07"
"63","000","00","080","0006","1002","622","370","252","6","628","1226","0","51.22","30.18"
"63","000","00","080","0007","0000","2328","1407","921","17","2345","4621","0","50.75","30.45"
"63","000","00","080","0007","1003","531","302","229","2","533","1098","0","48.54","27.50"
"63","000","00","080","0007","1004","579","334","245","8","587","1252","0","46.88","26.68"
"63","000","00","080","0007","1005","591","353","238","2","593","1157","0","51.25","30.51"
"63","000","00","080","0007","1006","627","418","209","5","632","1114","0","56.73","37.52"
"63","000","00","080","0008","0000","1869","1048","821","19","1888","3814","0","49.50","27.48"
"63","000","00","080","0008","1007","650","347","303","7","657","1284","0","51.17","27.02"
"63","000","00","080","0008","1008","597","351","246","7","604","1246","0","48.48","28.17"
"63","000","00","080","0008","1009","622","350","272","5","627","1284","0","48.83","27.26"
"63","000","00","080","0009","0000","3021","1874","1147","20","3041","6067","0","50.12","30.89"
"63","000","00","080","0009","1010","631","416","215","4","635","1284","0","49.45","32.40"
"63","000","00","080","0009","1011","599","374","225","5","604","1222","0","49.43","30.61"
"63","000","00","080","0009","1012","566","365","201","5","571","1170","0","48.80","31.20"
"63","000","00","080","0009","1013","605","333","272","1","606","1169","0","51.84","28.49"
"63","000","00","080","0009","1014","620","386","234","5","625","1222","0","51.15","31.59"
"63","000","00","080","0010","0000","2247","1300","947","29","2276","4515","0","50.41","28.79"
"63","000","00","080","0010","1015","528","284","244","6","534","1128","0","47.34","25.18"
"63","000","00","080","0010","1016","532","302","230","7","539","1099","0","49.04","27.48"
"63","000","00","080","0010","1017","620","362","258","6","626","1136","0","55.11","31.87"
"63","000","00","080","0010","1018","567","352","215","10","577","1152","0","50.09","30.56"
"63","000","00","080","0011","0000","1442","1017","425","16","1458","2826","0","51.59","35.99"
"63","000","00","080","0011","1019","708","456","252","10","718","1431","0","50.17","31.87"
"63","000","00","080","0011","1020","734","561","173","6","740","1395","0","53.05","40.22"
"63","000","00","080","0012","0000","1941","1186","755","15","1956","3978","0","49.17","29.81"
"63","000","00","080","0012","1021","571","326","245","8","579","1231","0","47.03","26.48"
"63","000","00","080","0012","1022","633","383","250","1","634","1338","0","47.38","28.62"
"63","000","00","080","0012","1023","737","477","260","6","743","1409","0","52.73","33.85"
"63","000","00","080","0013","0000","2126","1311","815","28","2154","4213","0","51.13","31.12"
"63","000","00","080","0013","1024","705","393","312","7","712","1453","0","49.00","27.05"
"63","000","00","080","0013","1025","671","448","223","13","684","1408","0","48.58","31.82"
"63","000","00","080","0013","1026","750","470","280","8","758","1352","0","56.07","34.76"
"63","000","00","080","0014","0000","1460","893","567","15","1475","3144","0","46.91","28.40"
"63","000","00","080","0014","1030","727","417","310","9","736","1655","0","44.47","25.20"
"63","000","00","080","0014","1031","733","476","257","6","739","1489","0","49.63","31.97"
"63","000","00","080","0015","0000","3109","2005","1104","20","3129","6323","0","49.49","31.71"
"63","000","00","080","0015","1032","672","437","235","3","675","1334","0","50.60","32.76"
"63","000","00","080","0015","1033","651","435","216","2","653","1261","0","51.78","34.50"
"63","000","00","080","0015","1034","590","353","237","5","595","1245","0","47.79","28.35"
"63","000","00","080","0015","1035","614","419","195","4","618","1236","0","50.00","33.90"
"63","000","00","080","0015","1036","582","361","221","6","588","1247","0","47.15","28.95"
"63","000","00","080","0016","0000","2406","1509","897","24","2430","5161","0","47.08","29.24"
"63","000","00","080","0016","1037","687","406","281","6","693","1505","0","46.05","26.98"
"63","000","00","080","0016","1038","680","426","254","7","687","1421","0","48.35","29.98"
"63","000","00","080","0016","1039","542","359","183","5","547","1260","0","43.41","28.49"
"63","000","00","080","0016","1040","497","318","179","6","503","975","0","51.59","32.62"
"63","000","00","080","0017","0000","2265","1521","744","17","2282","4630","0","49.29","32.85"
"63","000","00","080","0017","1041","603","405","198","2","605","1158","0","52.25","34.97"
"63","000","00","080","0017","1042","524","347","177","6","530","1110","0","47.75","31.26"
"63","000","00","080","0017","1043","489","332","157","4","493","1053","0","46.82","31.53"
"63","000","00","080","0017","1044","649","437","212","5","654","1309","0","49.96","33.38"
"63","000","00","080","0018","0000","2893","1871","1022","23","2916","5698","0","51.18","32.84"
"63","000","00","080","0018","1045","788","484","304","7","795","1581","0","50.28","30.61"
"63","000","00","080","0018","1046","650","446","204","5","655","1365","0","47.99","32.67"
"63","000","00","080","0018","1047","768","500","268","4","772","1429","0","54.02","34.99"
"63","000","00","080","0018","1048","687","441","246","7","694","1323","0","52.46","33.33"
"63","000","00","080","0019","0000","2300","1344","956","16","2316","4637","0","49.95","28.98"
"63","000","00","080","0019","1049","558","334","224","6","564","1106","0","50.99","30.20"
"63","000","00","080","0019","1050","554","324","230","6","560","1149","0","48.74","28.20"
"63","000","00","080","0019","1051","597","327","270","1","598","1208","0","49.50","27.07"
"63","000","00","080","0019","1052","591","359","232","3","594","1174","0","50.60","30.58"
"63","000","00","080","0020","0000","3256","2147","1109","22","3278","7009","0","46.77","30.63"
"63","000","00","080","0020","1053","529","367","162","4","533","1202","0","44.34","30.53"
"63","000","00","080","0020","1054","573","368","205","3","576","1206","0","47.76","30.51"
"63","000","00","080","0020","1055","581","376","205","2","583","1199","0","48.62","31.36"
"63","000","00","080","0020","1056","528","361","167","7","535","1095","0","48.86","32.97"
"63","000","00","080","0020","1057","514","335","179","2","516","1155","0","44.68","29.00"
"63","000","00","080","0020","1058","531","340","191","4","535","1152","0","46.44","29.51"
"63","000","00","080","0021","0000","1731","1046","685","20","1751","3527","0","49.65","29.66"
"63","000","00","080","0021","1059","554","339","215","6","560","1080","0","51.85","31.39"
"63","000","00","080","0021","1060","616","363","253","7","623","1199","0","51.96","30.28"
"63","000","00","080","0021","1061","561","344","217","7","568","1248","0","45.51","27.56"
"63","000","00","080","0022","0000","2710","1709","1001","23","2733","5643","0","48.43","30.29"
"63","000","00","080","0022","1062","588","400","188","4","592","1370","0","43.21","29.20"
"63","000","00","080","0022","1063","648","410","238","8","656","1407","0","46.62","29.14"
"63","000","00","080","0022","1064","729","419","310","4","733","1410","0","51.99","29.72"
"63","000","00","080","0022","1065","745","480","265","7","752","1456","0","51.65","32.97"
"63","000","00","080","0023","0000","2897","1910","987","40","2937","5797","0","50.66","32.95"
"63","000","00","080","0023","1066","573","360","213","7","580","1112","0","52.16","32.37"
"63","000","00","080","0023","1067","550","384","166","9","559","1128","0","49.56","34.04"
"63","000","00","080","0023","1068","567","365","202","10","577","1090","0","52.94","33.49"
"63","000","00","080","0023","1069","586","375","211","6","592","1183","0","50.04","31.70"
"63","000","00","080","0023","1070","621","426","195","8","629","1284","0","48.99","33.18"
"63","000","00","080","0024","0000","3793","2402","1391","39","3832","7631","0","50.22","31.48"
"63","000","00","080","0024","1071","627","361","266","5","632","1336","0","47.31","27.02"
"63","000","00","080","0024","1072","698","430","268","7","705","1268","0","55.60","33.91"
"63","000","00","080","0024","1073","630","444","186","6","636","1264","0","50.32","35.13"
"63","000","00","080","0024","1074","618","385","233","6","624","1283","0","48.64","30.01"
"63","000","00","080","0024","1075","639","432","207","8","647","1286","0","50.31","33.59"
"63","000","00","080","0024","1076","581","350","231","7","588","1194","0","49.25","29.31"
"63","000","00","080","0025","0000","1535","926","609","16","1551","3738","0","41.49","24.77"
"63","000","00","080","0025","1077","652","378","274","8","660","1661","0","39.74","22.76"
"63","000","00","080","0025","1078","589","363","226","7","596","1309","0","45.53","27.73"
"63","000","00","080","0025","1079","294","185","109","1","295","768","0","38.41","24.09"
"63","000","00","080","0026","0000","2793","1780","1013","22","2815","5826","0","48.32","30.55"
"63","000","00","080","0026","1080","685","405","280","4","689","1449","0","47.55","27.95"
"63","000","00","080","0026","1081","610","403","207","8","618","1429","0","43.25","28.20"
"63","000","00","080","0026","1082","775","500","275","3","778","1481","0","52.53","33.76"
"63","000","00","080","0026","1083","723","472","251","7","730","1467","0","49.76","32.17"
"63","000","00","080","0027","0000","3849","2552","1297","31","3880","7776","0","49.90","32.82"
"63","000","00","080","0027","1084","634","385","249","5","639","1263","0","50.59","30.48"
"63","000","00","080","0027","1085","670","430","240","5","675","1371","0","49.23","31.36"
"63","000","00","080","0027","1086","651","418","233","5","656","1330","0","49.32","31.43"
"63","000","00","080","0027","1087","558","389","169","6","564","1191","0","47.36","32.66"
"63","000","00","080","0027","1088","652","444","208","5","657","1255","0","52.35","35.38"
"63","000","00","080","0027","1089","684","486","198","5","689","1366","0","50.44","35.58"
"63","000","00","080","0028","0000","3453","1939","1514","33","3486","8867","0","39.31","21.87"
"63","000","00","080","0028","1090","617","357","260","5","622","2449","0","25.40","14.58"
"63","000","00","080","0028","1091","536","290","246","6","542","1226","0","44.21","23.65"
"63","000","00","080","0028","1092","516","285","231","5","521","1233","0","42.25","23.11"
"63","000","00","080","0028","1093","535","307","228","7","542","1307","0","41.47","23.49"
"63","000","00","080","0028","1094","614","349","265","4","618","1305","0","47.36","26.74"
"63","000","00","080","0028","1095","635","351","284","6","641","1347","0","47.59","26.06"
"63","000","00","080","0029","0000","2989","1776","1213","17","3006","6234","0","48.22","28.49"
"63","000","00","080","0029","1096","548","315","233","4","552","1142","0","48.34","27.58"
"63","000","00","080","0029","1097","589","345","244","4","593","1276","0","46.47","27.04"
"63","000","00","080","0029","1098","563","336","227","4","567","1165","0","48.67","28.84"
"63","000","00","080","0029","1099","544","323","221","4","548","1255","0","43.67","25.74"
"63","000","00","080","0029","1100","745","457","288","1","746","1396","0","53.44","32.74"
"63","000","00","080","0030","0000","3278","2097","1181","32","3310","7099","0","46.63","29.54"
"63","000","00","080","0030","1104","692","455","237","6","698","1464","0","47.68","31.08"
"63","000","00","080","0030","1105","635","411","224","8","643","1347","0","47.74","30.51"
"63","000","00","080","0030","1106","642","383","259","5","647","1404","0","46.08","27.28"
"63","000","00","080","0030","1107","649","398","251","9","658","1520","0","43.29","26.18"
"63","000","00","080","0030","1108","660","450","210","4","664","1364","0","48.68","32.99"
"63","000","00","080","0031","0000","2297","1463","834","16","2313","4662","0","49.61","31.38"
"63","000","00","080","0031","1109","571","362","209","4","575","1198","0","48.00","30.22"
"63","000","00","080","0031","1110","602","401","201","1","603","1136","0","53.08","35.30"
"63","000","00","080","0031","1111","542","317","225","5","547","1145","0","47.77","27.69"
"63","000","00","080","0031","1112","582","383","199","6","588","1183","0","49.70","32.38"
"63","000","00","080","0032","0000","2244","1323","921","21","2265","4648","0","48.73","28.46"
"63","000","00","080","0032","1117","523","316","207","4","527","1066","0","49.44","29.64"
"63","000","00","080","0032","1118","522","297","225","5","527","1143","0","46.11","25.98"
"63","000","00","080","0032","1119","621","361","260","7","628","1286","0","48.83","28.07"
"63","000","00","080","0032","1120","578","349","229","5","583","1153","0","50.56","30.27"
"63","000","00","080","0033","0000","3202","2025","1177","24","3226","6704","0","48.12","30.21"
"63","000","00","080","0033","1124","701","400","301","5","706","1412","0","50.00","28.33"
"63","000","00","080","0033","1125","581","367","214","1","582","1275","0","45.65","28.78"
"63","000","00","080","0033","1126","658","425","233","3","661","1427","0","46.32","29.78"
"63","000","00","080","0033","1127","706","461","245","11","717","1370","0","52.34","33.65"
"63","000","00","080","0033","1128","556","372","184","4","560","1220","0","45.90","30.49"
"63","000","00","080","0034","0000","2359","1391","968","14","2373","5050","0","46.99","27.54"
"63","000","00","080","0034","1134","503","253","250","5","508","1059","0","47.97","23.89"
"63","000","00","080","0034","1135","469","266","203","1","470","1018","0","46.17","26.13"
"63","000","00","080","0034","1136","452","286","166","1","453","989","0","45.80","28.92"
"63","000","00","080","0034","1137","423","291","132","3","426","994","0","42.86","29.28"
"63","000","00","080","0034","1138","512","295","217","4","516","990","0","52.12","29.80"
"63","000","00","080","0035","0000","3498","2055","1443","37","3535","7045","0","50.18","29.17"
"63","000","00","080","0035","1139","746","452","294","9","755","1437","0","52.54","31.45"
"63","000","00","080","0035","1140","726","429","297","5","731","1456","0","50.21","29.46"
"63","000","00","080","0035","1141","760","472","288","7","767","1462","0","52.46","32.28"
"63","000","00","080","0035","1142","680","374","306","7","687","1346","0","51.04","27.79"
"63","000","00","080","0035","1143","586","328","258","9","595","1344","0","44.27","24.40"
"63","000","00","080","0036","0000","1528","832","696","18","1546","3435","0","45.01","24.22"
"63","000","00","080","0036","1149","589","345","244","9","598","1267","0","47.20","27.23"
"63","000","00","080","0036","1150","611","371","240","2","613","1342","0","45.68","27.65"
"63","000","00","080","0036","1151","328","116","212","7","335","826","0","40.56","14.04"
"63","000","00","080","0037","0000","345","145","200","4","349","778","0","44.86","18.64"
"63","000","00","080","0037","1152","345","145","200","4","349","778","0","44.86","18.64"
"63","000","00","080","0038","0000","1899","1272","627","15","1914","3647","0","52.48","34.88"
"63","000","00","080","0038","1101","583","392","191","5","588","1060","0","55.47","36.98"
"63","000","00","080","0038","1102","687","447","240","5","692","1389","0","49.82","32.18"
"63","000","00","080","0038","1103","629","433","196","5","634","1198","0","52.92","36.14"
"63","000","00","080","0039","0000","2828","1743","1085","18","2846","6271","0","45.38","27.79"
"63","000","00","080","0039","1129","619","357","262","2","621","1252","0","49.60","28.51"
"63","000","00","080","0039","1130","576","359","217","7","583","1384","0","42.12","25.94"
"63","000","00","080","0039","1131","544","336","208","5","549","1208","0","45.45","27.81"
"63","000","00","080","0039","1132","515","338","177","1","516","1254","0","41.15","26.95"
"63","000","00","080","0039","1133","574","353","221","3","577","1173","0","49.19","30.09"
"63","000","00","080","0040","0000","3022","1792","1230","25","3047","6269","0","48.60","28.59"
"63","000","00","080","0040","1144","486","279","207","5","491","1042","0","47.12","26.78"
"63","000","00","080","0040","1145","567","335","232","6","573","1185","0","48.35","28.27"
"63","000","00","080","0040","1146","615","334","281","6","621","1305","0","47.59","25.59"
"63","000","00","080","0040","1147","673","408","265","2","675","1356","0","49.78","30.09"
"63","000","00","080","0040","1148","681","436","245","6","687","1381","0","49.75","31.57"
"63","000","00","080","0041","0000","2455","1443","1012","26","2481","5223","0","47.50","27.63"
"63","000","00","080","0041","1113","747","448","299","7","754","1534","0","49.15","29.20"
"63","000","00","080","0041","1114","549","308","241","7","556","1183","0","47.00","26.04"
"63","000","00","080","0041","1115","582","339","243","8","590","1252","0","47.12","27.08"
"63","000","00","080","0041","1116","577","348","229","4","581","1254","0","46.33","27.75"
"63","000","00","080","0042","0000","2148","1495","653","15","2163","4301","0","50.29","34.76"
"63","000","00","080","0042","1027","672","445","227","3","675","1359","0","49.67","32.74"
"63","000","00","080","0042","1028","748","517","231","3","751","1500","0","50.07","34.47"
"63","000","00","080","0042","1029","728","533","195","9","737","1442","0","51.11","36.96"
"63","000","00","080","0043","0000","1903","1132","771","19","1922","3996","0","48.10","28.33"
"63","000","00","080","0043","1121","614","370","244","7","621","1276","0","48.67","29.00"
"63","000","00","080","0043","1122","655","392","263","9","664","1354","0","49.04","28.95"
"63","000","00","080","0043","1123","634","370","264","3","637","1366","0","46.63","27.09"
"63","000","00","090","0000","0000","44523","23897","20626","371","44894","99364","117188","45.18","24.05"
"63","000","00","090","0001","0000","2179","1126","1053","8","2187","5637","0","38.80","19.98"
"63","000","00","090","0001","1153","428","184","244","2","430","1105","0","38.91","16.65"
"63","000","00","090","0001","1154","618","328","290","0","618","1427","0","43.31","22.99"
"63","000","00","090","0001","1155","540","289","251","3","543","1292","0","42.03","22.37"
"63","000","00","090","0001","1156","593","325","268","3","596","1813","0","32.87","17.93"
"63","000","00","090","0002","0000","1244","596","648","3","1247","3127","0","39.88","19.06"
"63","000","00","090","0002","1157","432","164","268","1","433","1028","0","42.12","15.95"
"63","000","00","090","0002","1158","441","231","210","0","441","1121","0","39.34","20.61"
"63","000","00","090","0002","1159","371","201","170","2","373","978","0","38.14","20.55"
"63","000","00","090","0003","0000","1475","708","767","13","1488","3300","0","45.09","21.45"
"63","000","00","090","0003","1165","464","246","218","2","466","989","0","47.12","24.87"
"63","000","00","090","0003","1166","527","235","292","5","532","1169","0","45.51","20.10"
"63","000","00","090","0003","1167","484","227","257","6","490","1142","0","42.91","19.88"
"63","000","00","090","0004","0000","2700","1457","1243","17","2717","6452","0","42.11","22.58"
"63","000","00","090","0004","1160","531","247","284","5","536","1291","0","41.52","19.13"
"63","000","00","090","0004","1161","502","287","215","1","503","1313","0","38.31","21.86"
"63","000","00","090","0004","1162","537","284","253","4","541","1293","0","41.84","21.96"
"63","000","00","090","0004","1163","552","316","236","2","554","1266","0","43.76","24.96"
"63","000","00","090","0004","1164","578","323","255","5","583","1289","0","45.23","25.06"
"63","000","00","090","0005","0000","2589","1334","1255","17","2606","6152","0","42.36","21.68"
"63","000","00","090","0005","1184","437","211","226","2","439","1238","0","35.46","17.04"
"63","000","00","090","0005","1185","584","315","269","2","586","1340","0","43.73","23.51"
"63","000","00","090","0005","1186","510","231","279","7","517","1184","0","43.67","19.51"
"63","000","00","090","0005","1187","546","308","238","4","550","1271","0","43.27","24.23"
"63","000","00","090","0005","1188","512","269","243","2","514","1119","0","45.93","24.04"
"63","000","00","090","0006","0000","1451","806","645","13","1464","3170","0","46.18","25.43"
"63","000","00","090","0006","1208","527","288","239","6","533","1126","0","47.34","25.58"
"63","000","00","090","0006","1209","500","278","222","3","503","1086","0","46.32","25.60"
"63","000","00","090","0006","1210","424","240","184","4","428","958","0","44.68","25.05"
"63","000","00","090","0007","0000","2309","1329","980","21","2330","4785","0","48.69","27.77"
"63","000","00","090","0007","1193","548","299","249","6","554","1204","0","46.01","24.83"
"63","000","00","090","0007","1194","496","298","198","3","499","1063","0","46.94","28.03"
"63","000","00","090","0007","1195","635","354","281","10","645","1280","0","50.39","27.66"
"63","000","00","090","0007","1196","630","378","252","2","632","1238","0","51.05","30.53"
"63","000","00","090","0008","0000","1781","776","1005","23","1804","4037","0","44.69","19.22"
"63","000","00","090","0008","1197","589","266","323","12","601","1305","0","46.05","20.38"
"63","000","00","090","0008","1198","618","270","348","4","622","1374","0","45.27","19.65"
"63","000","00","090","0008","1199","574","240","334","7","581","1358","0","42.78","17.67"
"63","000","00","090","0009","0000","1860","914","946","14","1874","4075","0","45.99","22.43"
"63","000","00","090","0009","1200","636","290","346","6","642","1445","0","44.43","20.07"
"63","000","00","090","0009","1201","612","319","293","3","615","1314","0","46.80","24.28"
"63","000","00","090","0009","1202","612","305","307","5","617","1316","0","46.88","23.18"
"63","000","00","090","0010","0000","2694","1398","1296","28","2722","5716","0","47.62","24.46"
"63","000","00","090","0010","1203","500","259","241","4","504","1052","0","47.91","24.62"
"63","000","00","090","0010","1204","578","304","274","7","585","1198","0","48.83","25.38"
"63","000","00","090","0010","1205","569","307","262","8","577","1211","0","47.65","25.35"
"63","000","00","090","0010","1206","517","257","260","5","522","1106","0","47.20","23.24"
"63","000","00","090","0010","1207","530","271","259","4","534","1149","0","46.48","23.59"
"63","000","00","090","0011","0000","3033","1738","1295","34","3067","6413","0","47.82","27.10"
"63","000","00","090","0011","1224","622","342","280","8","630","1402","0","44.94","24.39"
"63","000","00","090","0011","1225","661","398","263","6","667","1396","0","47.78","28.51"
"63","000","00","090","0011","1226","563","312","251","6","569","1139","0","49.96","27.39"
"63","000","00","090","0011","1227","638","392","246","9","647","1224","0","52.86","32.03"
"63","000","00","090","0011","1228","549","294","255","5","554","1252","0","44.25","23.48"
"63","000","00","090","0012","0000","1889","1076","813","14","1903","3623","0","52.53","29.70"
"63","000","00","090","0012","1214","547","307","240","4","551","1133","0","48.63","27.10"
"63","000","00","090","0012","1215","674","326","348","6","680","1209","0","56.24","26.96"
"63","000","00","090","0012","1216","668","443","225","4","672","1281","0","52.46","34.58"
"63","000","00","090","0013","0000","1860","1001","859","9","1869","3885","0","48.11","25.77"
"63","000","00","090","0013","1217","626","341","285","5","631","1340","0","47.09","25.45"
"63","000","00","090","0013","1218","593","332","261","1","594","1248","0","47.60","26.60"
"63","000","00","090","0013","1219","641","328","313","3","644","1297","0","49.65","25.29"
"63","000","00","090","0014","0000","2001","1031","970","19","2020","4544","0","44.45","22.69"
"63","000","00","090","0014","1220","462","249","213","0","462","1138","0","40.60","21.88"
"63","000","00","090","0014","1221","497","254","243","3","500","1141","0","43.82","22.26"
"63","000","00","090","0014","1222","512","258","254","4","516","1103","0","46.78","23.39"
"63","000","00","090","0014","1223","530","270","260","12","542","1162","0","46.64","23.24"
"63","000","00","090","0015","0000","2005","1105","900","19","2024","4274","0","47.36","25.85"
"63","000","00","090","0015","1211","697","423","274","7","704","1411","0","49.89","29.98"
"63","000","00","090","0015","1212","672","324","348","6","678","1488","0","45.56","21.77"
"63","000","00","090","0015","1213","636","358","278","6","642","1375","0","46.69","26.04"
"63","000","00","090","0016","0000","3013","1546","1467","26","3039","7580","0","40.09","20.40"
"63","000","00","090","0016","1178","481","228","253","6","487","1349","0","36.10","16.90"
"63","000","00","090","0016","1179","473","210","263","4","477","1297","0","36.78","16.19"
"63","000","00","090","0016","1180","511","264","247","3","514","1221","0","42.10","21.62"
"63","000","00","090","0016","1181","497","278","219","3","500","1185","0","42.19","23.46"
"63","000","00","090","0016","1182","485","272","213","3","488","1220","0","40.00","22.30"
"63","000","00","090","0016","1183","566","294","272","7","573","1308","0","43.81","22.48"
"63","000","00","090","0017","0000","3580","1859","1721","36","3616","7890","0","45.83","23.56"
"63","000","00","090","0017","1168","565","283","282","6","571","1435","0","39.79","19.72"
"63","000","00","090","0017","1169","597","299","298","8","605","1256","0","48.17","23.81"
"63","000","00","090","0017","1170","607","283","324","5","612","1279","0","47.85","22.13"
"63","000","00","090","0017","1171","648","336","312","7","655","1369","0","47.85","24.54"
"63","000","00","090","0017","1172","562","298","264","7","569","1331","0","42.75","22.39"
"63","000","00","090","0017","1173","601","360","241","3","604","1220","0","49.51","29.51"
"63","000","00","090","0018","0000","2389","1405","984","22","2411","5386","0","44.76","26.09"
"63","000","00","090","0018","1174","581","296","285","6","587","1395","0","42.08","21.22"
"63","000","00","090","0018","1175","694","490","204","8","702","1324","0","53.02","37.01"
"63","000","00","090","0018","1176","466","221","245","3","469","1266","0","37.05","17.46"
"63","000","00","090","0018","1177","648","398","250","5","653","1401","0","46.61","28.41"
"63","000","00","090","0019","0000","2361","1491","870","19","2380","4777","0","49.82","31.21"
"63","000","00","090","0019","1229","563","360","203","2","565","1114","0","50.72","32.32"
"63","000","00","090","0019","1230","509","315","194","3","512","994","0","51.51","31.69"
"63","000","00","090","0019","1231","708","451","257","10","718","1323","0","54.27","34.09"
"63","000","00","090","0019","1232","581","365","216","4","585","1346","0","43.46","27.12"
"63","000","00","090","0020","0000","2110","1201","909","16","2126","4541","0","46.82","26.45"
"63","000","00","090","0020","1189","478","266","212","5","483","1166","0","41.42","22.81"
"63","000","00","090","0020","1190","499","282","217","1","500","1122","0","44.56","25.13"
"63","000","00","090","0020","1191","568","326","242","4","572","1123","0","50.93","29.03"
"63","000","00","090","0020","1192","565","327","238","6","571","1130","0","50.53","28.94"
"63","000","00","100","0000","0000","107183","58760","48423","934","108117","232305","279598","46.54","25.29"
"63","000","00","100","0001","0000","2891","1455","1436","23","2914","6163","0","47.28","23.61"
"63","000","00","100","0001","1233","553","272","281","5","558","1205","0","46.31","22.57"
"63","000","00","100","0001","1234","530","269","261","3","533","1156","0","46.11","23.27"
"63","000","00","100","0001","1235","584","269","315","6","590","1251","0","47.16","21.50"
"63","000","00","100","0001","1236","588","322","266","6","594","1233","0","48.18","26.12"
"63","000","00","100","0001","1237","636","323","313","3","639","1318","0","48.48","24.51"
"63","000","00","100","0002","0000","3980","2226","1754","37","4017","8190","0","49.05","27.18"
"63","000","00","100","0002","1238","662","323","339","9","671","1315","0","51.03","24.56"
"63","000","00","100","0002","1239","723","399","324","7","730","1418","0","51.48","28.14"
"63","000","00","100","0002","1240","655","357","298","6","661","1367","0","48.35","26.12"
"63","000","00","100","0002","1241","645","337","308","4","649","1495","0","43.41","22.54"
"63","000","00","100","0002","1242","631","347","284","8","639","1324","0","48.26","26.21"
"63","000","00","100","0002","1243","664","463","201","3","667","1271","0","52.48","36.43"
"63","000","00","100","0003","0000","2753","1494","1259","27","2780","5644","0","49.26","26.47"
"63","000","00","100","0003","1244","636","351","285","8","644","1333","0","48.31","26.33"
"63","000","00","100","0003","1245","698","398","300","8","706","1414","0","49.93","28.15"
"63","000","00","100","0003","1246","691","338","353","4","695","1371","0","50.69","24.65"
"63","000","00","100","0003","1247","728","407","321","7","735","1526","0","48.17","26.67"
"63","000","00","100","0005","0000","2463","1313","1150","16","2479","5115","0","48.47","25.67"
"63","000","00","100","0005","1248","657","366","291","2","659","1302","0","50.61","28.11"
"63","000","00","100","0005","1249","609","330","279","7","616","1255","0","49.08","26.29"
"63","000","00","100","0005","1250","622","302","320","2","624","1331","0","46.88","22.69"
"63","000","00","100","0005","1251","575","315","260","5","580","1227","0","47.27","25.67"
"63","000","00","100","0006","0000","2131","1109","1022","11","2142","4642","0","46.14","23.89"
"63","000","00","100","0006","1252","697","366","331","2","699","1561","0","44.78","23.45"
"63","000","00","100","0006","1253","748","404","344","5","753","1528","0","49.28","26.44"
"63","000","00","100","0006","1254","686","339","347","4","690","1553","0","44.43","21.83"
"63","000","00","100","0007","0000","3759","2025","1734","34","3793","7960","0","47.65","25.44"
"63","000","00","100","0007","1255","538","294","244","10","548","1289","0","42.51","22.81"
"63","000","00","100","0007","1256","677","337","340","6","683","1435","0","47.60","23.48"
"63","000","00","100","0007","1257","564","312","252","4","568","1246","0","45.59","25.04"
"63","000","00","100","0007","1258","797","421","376","4","801","1553","0","51.58","27.11"
"63","000","00","100","0007","1259","606","357","249","3","609","1202","0","50.67","29.70"
"63","000","00","100","0007","1260","577","304","273","7","584","1235","0","47.29","24.62"
"63","000","00","100","0008","0000","3543","1881","1662","36","3579","7644","0","46.82","24.61"
"63","000","00","100","0008","1261","692","407","285","10","702","1480","0","47.43","27.50"
"63","000","00","100","0008","1262","737","407","330","12","749","1596","0","46.93","25.50"
"63","000","00","100","0008","1263","690","367","323","4","694","1459","0","47.57","25.15"
"63","000","00","100","0008","1264","711","348","363","7","718","1554","0","46.20","22.39"
"63","000","00","100","0008","1265","713","352","361","3","716","1555","0","46.05","22.64"
"63","000","00","100","0009","0000","2607","1486","1121","15","2622","5561","0","47.15","26.72"
"63","000","00","100","0009","1266","625","361","264","5","630","1287","0","48.95","28.05"
"63","000","00","100","0009","1267","557","294","263","3","560","1295","0","43.24","22.70"
"63","000","00","100","0009","1268","682","400","282","2","684","1402","0","48.79","28.53"
"63","000","00","100","0009","1269","743","431","312","5","748","1577","0","47.43","27.33"
"63","000","00","100","0010","0000","3657","2176","1481","35","3692","7099","0","52.01","30.65"
"63","000","00","100","0010","1270","874","485","389","7","881","1633","0","53.95","29.70"
"63","000","00","100","0010","1271","802","505","297","9","811","1559","0","52.02","32.39"
"63","000","00","100","0010","1272","782","431","351","5","787","1433","0","54.92","30.08"
"63","000","00","100","0010","1273","665","438","227","9","674","1356","0","49.71","32.30"
"63","000","00","100","0010","1274","534","317","217","5","539","1118","0","48.21","28.35"
"63","000","00","100","0011","0000","3336","1703","1633","24","3360","6865","0","48.94","24.81"
"63","000","00","100","0011","1275","694","350","344","8","702","1486","0","47.24","23.55"
"63","000","00","100","0011","1276","647","333","314","2","649","1325","0","48.98","25.13"
"63","000","00","100","0011","1277","737","385","352","4","741","1371","0","54.05","28.08"
"63","000","00","100","0011","1278","599","302","297","5","604","1350","0","44.74","22.37"
"63","000","00","100","0011","1279","659","333","326","5","664","1333","0","49.81","24.98"
"63","000","00","100","0012","0000","2214","1214","1000","16","2230","4641","0","48.05","26.16"
"63","000","00","100","0012","1280","729","384","345","6","735","1586","0","46.34","24.21"
"63","000","00","100","0012","1281","761","418","343","5","766","1515","0","50.56","27.59"
"63","000","00","100","0012","1282","724","412","312","5","729","1540","0","47.34","26.75"
"63","000","00","100","0013","0000","2127","1171","956","16","2143","4647","0","46.12","25.20"
"63","000","00","100","0013","1283","762","445","317","4","766","1629","0","47.02","27.32"
"63","000","00","100","0013","1284","648","342","306","5","653","1452","0","44.97","23.55"
"63","000","00","100","0013","1285","717","384","333","7","724","1566","0","46.23","24.52"
"63","000","00","100","0014","0000","2846","1489","1357","23","2869","5790","0","49.55","25.72"
"63","000","00","100","0014","1286","700","365","335","6","706","1430","0","49.37","25.52"
"63","000","00","100","0014","1287","776","445","331","7","783","1500","0","52.20","29.67"
"63","000","00","100","0014","1288","618","316","302","7","625","1374","0","45.49","23.00"
"63","000","00","100","0014","1289","752","363","389","3","755","1486","0","50.81","24.43"
"63","000","00","100","0015","0000","2906","1628","1278","23","2929","6061","0","48.33","26.86"
"63","000","00","100","0015","1290","176","51","125","1","177","430","0","41.16","11.86"
"63","000","00","100","0015","1291","780","422","358","3","783","1593","0","49.15","26.49"
"63","000","00","100","0015","1292","689","406","283","8","697","1366","0","51.02","29.72"
"63","000","00","100","0015","1293","686","425","261","5","691","1337","0","51.68","31.79"
"63","000","00","100","0015","1294","575","324","251","6","581","1335","0","43.52","24.27"
"63","000","00","100","0016","0000","2356","1460","896","25","2381","4880","0","48.79","29.92"
"63","000","00","100","0016","1295","632","342","290","6","638","1313","0","48.59","26.05"
"63","000","00","100","0016","1296","528","343","185","12","540","1077","0","50.14","31.85"
"63","000","00","100","0016","1297","556","378","178","5","561","1185","0","47.34","31.90"
"63","000","00","100","0016","1298","640","397","243","2","642","1305","0","49.20","30.42"
"63","000","00","100","0017","0000","3536","1985","1551","26","3562","7269","0","49.00","27.31"
"63","000","00","100","0017","1299","730","433","297","4","734","1532","0","47.91","28.26"
"63","000","00","100","0017","1300","743","416","327","6","749","1525","0","49.11","27.28"
"63","000","00","100","0017","1301","765","463","302","7","772","1585","0","48.71","29.21"
"63","000","00","100","0017","1302","621","302","319","6","627","1234","0","50.81","24.47"
"63","000","00","100","0017","1303","677","371","306","3","680","1393","0","48.82","26.63"
"63","000","00","100","0018","0000","2681","1593","1088","26","2707","5983","0","45.24","26.63"
"63","000","00","100","0018","1304","714","417","297","8","722","1509","0","47.85","27.63"
"63","000","00","100","0018","1305","578","345","233","6","584","1443","0","40.47","23.91"
"63","000","00","100","0018","1306","735","417","318","3","738","1526","0","48.36","27.33"
"63","000","00","100","0018","1307","654","414","240","9","663","1505","0","44.05","27.51"
"63","000","00","100","0019","0000","3388","1825","1563","30","3418","7104","0","48.11","25.69"
"63","000","00","100","0019","1308","694","364","330","12","706","1517","0","46.54","23.99"
"63","000","00","100","0019","1309","580","308","272","7","587","1306","0","44.95","23.58"
"63","000","00","100","0019","1310","647","311","336","3","650","1407","0","46.20","22.10"
"63","000","00","100","0019","1311","707","394","313","5","712","1372","0","51.90","28.72"
"63","000","00","100","0019","1312","760","448","312","3","763","1502","0","50.80","29.83"
"63","000","00","100","0020","0000","3419","2160","1259","42","3461","6596","0","52.47","32.75"
"63","000","00","100","0020","1313","753","515","238","11","764","1503","0","50.83","34.26"
"63","000","00","100","0020","1314","690","416","274","5","695","1333","0","52.14","31.21"
"63","000","00","100","0020","1315","663","409","254","8","671","1279","0","52.46","31.98"
"63","000","00","100","0020","1316","624","328","296","8","632","1206","0","52.40","27.20"
"63","000","00","100","0020","1317","689","492","197","10","699","1275","0","54.82","38.59"
"63","000","00","100","0021","0000","1947","1206","741","17","1964","3925","0","50.04","30.73"
"63","000","00","100","0021","1318","696","387","309","5","701","1448","0","48.41","26.73"
"63","000","00","100","0021","1319","620","401","219","4","624","1209","0","51.61","33.17"
"63","000","00","100","0021","1320","631","418","213","8","639","1268","0","50.39","32.97"
"63","000","00","100","0022","0000","3430","1785","1645","30","3460","8758","0","39.51","20.38"
"63","000","00","100","0022","1321","611","303","308","3","614","1473","0","41.68","20.57"
"63","000","00","100","0022","1322","601","341","260","5","606","1453","0","41.71","23.47"
"63","000","00","100","0022","1323","575","288","287","0","575","1433","0","40.13","20.10"
"63","000","00","100","0022","1324","558","263","295","5","563","1490","0","37.79","17.65"
"63","000","00","100","0022","1325","545","319","226","9","554","1433","0","38.66","22.26"
"63","000","00","100","0022","1326","540","271","269","8","548","1476","0","37.13","18.36"
"63","000","00","100","0023","0000","2951","1579","1372","25","2976","6861","0","43.38","23.01"
"63","000","00","100","0023","1327","608","312","296","9","617","1436","0","42.97","21.73"
"63","000","00","100","0023","1328","531","277","254","3","534","1243","0","42.96","22.28"
"63","000","00","100","0023","1329","603","327","276","6","609","1411","0","43.16","23.18"
"63","000","00","100","0023","1330","565","338","227","3","568","1354","0","41.95","24.96"
"63","000","00","100","0023","1331","644","325","319","4","648","1417","0","45.73","22.94"
"63","000","00","100","0024","0000","2902","1543","1359","21","2923","6927","0","42.20","22.28"
"63","000","00","100","0024","1332","568","302","266","4","572","1409","0","40.60","21.43"
"63","000","00","100","0024","1333","654","351","303","8","662","1556","0","42.54","22.56"
"63","000","00","100","0024","1334","560","274","286","3","563","1272","0","44.26","21.54"
"63","000","00","100","0024","1335","596","307","289","2","598","1420","0","42.11","21.62"
"63","000","00","100","0024","1336","524","309","215","4","528","1270","0","41.57","24.33"
"63","000","00","100","0025","0000","1799","989","810","13","1812","4037","0","44.88","24.50"
"63","000","00","100","0025","1337","566","301","265","1","567","1161","0","48.84","25.93"
"63","000","00","100","0025","1338","455","276","179","4","459","1129","0","40.66","24.45"
"63","000","00","100","0025","1339","494","300","194","3","497","1004","0","49.50","29.88"
"63","000","00","100","0025","1340","284","112","172","5","289","743","0","38.90","15.07"
"63","000","00","100","0026","0000","3310","1605","1705","28","3338","7466","0","44.71","21.50"
"63","000","00","100","0026","1341","618","237","381","5","623","1450","0","42.97","16.34"
"63","000","00","100","0026","1342","716","342","374","5","721","1617","0","44.59","21.15"
"63","000","00","100","0026","1343","628","265","363","9","637","1380","0","46.16","19.20"
"63","000","00","100","0026","1344","656","375","281","5","661","1440","0","45.90","26.04"
"63","000","00","100","0026","1345","692","386","306","4","696","1579","0","44.08","24.45"
"63","000","00","100","0027","0000","2935","1508","1427","30","2965","6099","0","48.61","24.73"
"63","000","00","100","0027","1346","624","264","360","6","630","1416","0","44.49","18.64"
"63","000","00","100","0027","1347","751","385","366","3","754","1483","0","50.84","25.96"
"63","000","00","100","0027","1348","724","412","312","11","735","1542","0","47.67","26.72"
"63","000","00","100","0027","1349","836","447","389","10","846","1658","0","51.03","26.96"
"63","000","00","100","0028","0000","1441","804","637","14","1455","3369","0","43.19","23.86"
"63","000","00","100","0028","1350","627","290","337","4","631","1424","0","44.31","20.37"
"63","000","00","100","0028","1351","537","340","197","5","542","1307","0","41.47","26.01"
"63","000","00","100","0028","1352","277","174","103","5","282","638","0","44.20","27.27"
"63","000","00","100","0029","0000","2739","1486","1253","16","2755","7424","0","37.11","20.02"
"63","000","00","100","0029","1353","658","339","319","3","661","1516","0","43.60","22.36"
"63","000","00","100","0029","1354","736","449","287","5","741","2870","0","25.82","15.64"
"63","000","00","100","0029","1355","647","368","279","4","651","1489","0","43.72","24.71"
"63","000","00","100","0029","1356","698","330","368","4","702","1549","0","45.32","21.30"
"63","000","00","100","0030","0000","2107","1085","1022","19","2126","4537","0","46.86","23.91"
"63","000","00","100","0030","1357","722","379","343","6","728","1553","0","46.88","24.40"
"63","000","00","100","0030","1358","705","337","368","10","715","1512","0","47.29","22.29"
"63","000","00","100","0030","1359","680","369","311","3","683","1472","0","46.40","25.07"
"63","000","00","100","0031","0000","2870","1501","1369","26","2896","6387","0","45.34","23.50"
"63","000","00","100","0031","1360","473","233","240","2","475","1117","0","42.52","20.86"
"63","000","00","100","0031","1361","556","299","257","4","560","1208","0","46.36","24.75"
"63","000","00","100","0031","1362","546","272","274","7","553","1224","0","45.18","22.22"
"63","000","00","100","0031","1363","663","358","305","7","670","1403","0","47.75","25.52"
"63","000","00","100","0031","1364","632","339","293","6","638","1435","0","44.46","23.62"
"63","000","00","100","0032","0000","2585","1509","1076","27","2612","5366","0","48.68","28.12"
"63","000","00","100","0032","1365","672","364","308","8","680","1397","0","48.68","26.06"
"63","000","00","100","0032","1366","625","386","239","6","631","1334","0","47.30","28.94"
"63","000","00","100","0032","1367","661","393","268","7","668","1346","0","49.63","29.20"
"63","000","00","100","0032","1368","627","366","261","6","633","1289","0","49.11","28.39"
"63","000","00","100","0033","0000","1950","1071","879","15","1965","4591","0","42.80","23.33"
"63","000","00","100","0033","1369","713","385","328","5","718","1624","0","44.21","23.71"
"63","000","00","100","0033","1370","655","370","285","4","659","1594","0","41.34","23.21"
"63","000","00","100","0033","1371","582","316","266","6","588","1373","0","42.83","23.02"
"63","000","00","100","0034","0000","3787","2127","1660","38","3825","8128","0","47.06","26.17"
"63","000","00","100","0034","1372","735","388","347","3","738","1635","0","45.14","23.73"
"63","000","00","100","0034","1373","762","434","328","8","770","1627","0","47.33","26.67"
"63","000","00","100","0034","1374","770","426","344","8","778","1611","0","48.29","26.44"
"63","000","00","100","0034","1375","771","441","330","12","783","1595","0","49.09","27.65"
"63","000","00","100","0034","1376","749","438","311","7","756","1660","0","45.54","26.39"
"63","000","00","100","0035","0000","3337","1927","1410","29","3366","7322","0","45.97","26.32"
"63","000","00","100","0035","1377","563","337","226","4","567","1223","0","46.36","27.56"
"63","000","00","100","0035","1378","613","348","265","7","620","1384","0","44.80","25.14"
"63","000","00","100","0035","1379","671","388","283","2","673","1436","0","46.87","27.02"
"63","000","00","100","0035","1380","735","399","336","11","746","1683","0","44.33","23.71"
"63","000","00","100","0035","1381","755","455","300","5","760","1596","0","47.62","28.51"
"63","000","00","100","0036","0000","1988","1015","973","15","2003","4501","0","44.50","22.55"
"63","000","00","100","0036","1382","688","339","349","7","695","1469","0","47.31","23.08"
"63","000","00","100","0036","1383","654","316","338","3","657","1596","0","41.17","19.80"
"63","000","00","100","0036","1384","646","360","286","5","651","1436","0","45.33","25.07"
"63","000","00","100","0037","0000","391","169","222","5","396","1126","0","35.17","15.01"
"63","000","00","100","0037","1385","391","169","222","5","396","1126","0","35.17","15.01"
"63","000","00","100","0038","0000","2279","1108","1171","28","2307","4994","0","46.20","22.19"
"63","000","00","100","0038","1386","642","292","350","5","647","1342","0","48.21","21.76"
"63","000","00","100","0038","1387","532","269","263","7","539","1196","0","45.07","22.49"
"63","000","00","100","0038","1388","569","274","295","12","581","1330","0","43.68","20.60"
"63","000","00","100","0038","1389","536","273","263","4","540","1126","0","47.96","24.25"
"63","000","00","100","0039","0000","3701","2118","1583","26","3727","7959","0","46.83","26.61"
"63","000","00","100","0039","1390","707","426","281","6","713","1516","0","47.03","28.10"
"63","000","00","100","0039","1391","783","422","361","2","785","1553","0","50.55","27.17"
"63","000","00","100","0039","1392","772","449","323","7","779","1683","0","46.29","26.68"
"63","000","00","100","0039","1393","766","452","314","6","772","1670","0","46.23","27.07"
"63","000","00","100","0039","1394","673","369","304","5","678","1537","0","44.11","24.01"
"63","000","00","100","0040","0000","2141","1232","909","27","2168","4674","0","46.38","26.36"
"63","000","00","100","0040","1395","723","429","294","11","734","1493","0","49.16","28.73"
"63","000","00","100","0040","1396","693","387","306","7","700","1531","0","45.72","25.28"
"63","000","00","100","0040","1397","725","416","309","9","734","1650","0","44.48","25.21"
"63","000","00","110","0000","0000","107939","50356","57583","944","108883","233253","274056","46.68","21.59"
"63","000","00","110","0001","0000","1547","672","875","13","1560","3285","0","47.49","20.46"
"63","000","00","110","0001","1398","512","211","301","6","518","1145","0","45.24","18.43"
"63","000","00","110","0001","1399","474","195","279","3","477","997","0","47.84","19.56"
"63","000","00","110","0001","1400","561","266","295","4","565","1143","0","49.43","23.27"
"63","000","00","110","0002","0000","1235","620","615","12","1247","2736","0","45.58","22.66"
"63","000","00","110","0002","1401","537","265","272","4","541","1227","0","44.09","21.60"
"63","000","00","110","0002","1402","698","355","343","8","706","1509","0","46.79","23.53"
"63","000","00","110","0003","0000","1137","549","588","14","1151","2482","0","46.37","22.12"
"63","000","00","110","0003","1403","450","238","212","6","456","1123","0","40.61","21.19"
"63","000","00","110","0003","1404","687","311","376","8","695","1359","0","51.14","22.88"
"63","000","00","110","0004","0000","1836","938","898","12","1848","5079","0","36.39","18.47"
"63","000","00","110","0004","1405","470","225","245","8","478","964","0","49.59","23.34"
"63","000","00","110","0004","1406","450","235","215","1","451","961","0","46.93","24.45"
"63","000","00","110","0004","1407","524","278","246","2","526","1044","0","50.38","26.63"
"63","000","00","110","0004","1408","392","200","192","1","393","2110","0","18.63","9.48"
"63","000","00","110","0005","0000","3378","1782","1596","22","3400","6507","0","52.25","27.39"
"63","000","00","110","0005","1409","606","358","248","4","610","1213","0","50.29","29.51"
"63","000","00","110","0005","1410","617","413","204","8","625","1222","0","51.15","33.80"
"63","000","00","110","0005","1411","605","304","301","3","608","1142","0","53.24","26.62"
"63","000","00","110","0005","1412","716","320","396","4","720","1421","0","50.67","22.52"
"63","000","00","110","0005","1413","834","387","447","3","837","1509","0","55.47","25.65"
"63","000","00","110","0006","0000","2597","1256","1341","19","2616","5295","0","49.41","23.72"
"63","000","00","110","0006","1414","601","331","270","3","604","1181","0","51.14","28.03"
"63","000","00","110","0006","1415","551","268","283","1","552","1241","0","44.48","21.60"
"63","000","00","110","0006","1416","778","376","402","6","784","1494","0","52.48","25.17"
"63","000","00","110","0006","1417","667","281","386","9","676","1379","0","49.02","20.38"
"63","000","00","110","0007","0000","3187","1500","1687","27","3214","6549","0","49.08","22.90"
"63","000","00","110","0007","1418","520","219","301","6","526","1118","0","47.05","19.59"
"63","000","00","110","0007","1419","678","292","386","4","682","1338","0","50.97","21.82"
"63","000","00","110","0007","1420","666","342","324","2","668","1387","0","48.16","24.66"
"63","000","00","110","0007","1421","753","374","379","9","762","1462","0","52.12","25.58"
"63","000","00","110","0007","1422","570","273","297","6","576","1244","0","46.30","21.95"
"63","000","00","110","0008","0000","2955","1249","1706","20","2975","6846","0","43.46","18.24"
"63","000","00","110","0008","1423","583","259","324","5","588","1350","0","43.56","19.19"
"63","000","00","110","0008","1424","552","211","341","6","558","1399","0","39.89","15.08"
"63","000","00","110","0008","1425","612","267","345","3","615","1422","0","43.25","18.78"
"63","000","00","110","0008","1426","558","220","338","2","560","1276","0","43.89","17.24"
"63","000","00","110","0008","1427","650","292","358","4","654","1399","0","46.75","20.87"
"63","000","00","110","0009","0000","2635","1128","1507","22","2657","5673","0","46.84","19.88"
"63","000","00","110","0009","1428","590","248","342","2","592","1346","0","43.98","18.42"
"63","000","00","110","0009","1429","634","258","376","4","638","1335","0","47.79","19.33"
"63","000","00","110","0009","1430","739","348","391","11","750","1489","0","50.37","23.37"
"63","000","00","110","0009","1431","672","274","398","5","677","1503","0","45.04","18.23"
"63","000","00","110","0010","0000","1737","699","1038","14","1751","3851","0","45.47","18.15"
"63","000","00","110","0010","1432","616","261","355","5","621","1349","0","46.03","19.35"
"63","000","00","110","0010","1433","626","232","394","6","632","1374","0","46.00","16.89"
"63","000","00","110","0010","1434","495","206","289","3","498","1128","0","44.15","18.26"
"63","000","00","110","0011","0000","2776","1177","1599","29","2805","5841","0","48.02","20.15"
"63","000","00","110","0011","1435","676","287","389","6","682","1459","0","46.74","19.67"
"63","000","00","110","0011","1436","692","278","414","12","704","1436","0","49.03","19.36"
"63","000","00","110","0011","1437","724","315","409","8","732","1493","0","49.03","21.10"
"63","000","00","110","0011","1438","684","297","387","3","687","1453","0","47.28","20.44"
"63","000","00","110","0012","0000","2190","1088","1102","13","2203","4783","0","46.06","22.75"
"63","000","00","110","0012","1439","500","253","247","3","503","1111","0","45.27","22.77"
"63","000","00","110","0012","1440","616","289","327","3","619","1342","0","46.13","21.54"
"63","000","00","110","0012","1441","543","268","275","4","547","1150","0","47.57","23.30"
"63","000","00","110","0012","1442","531","278","253","3","534","1180","0","45.25","23.56"
"63","000","00","110","0013","0000","2254","1110","1144","24","2278","5342","0","42.64","20.78"
"63","000","00","110","0013","1443","538","265","273","3","541","1252","0","43.21","21.17"
"63","000","00","110","0013","1444","478","208","270","5","483","1235","0","39.11","16.84"
"63","000","00","110","0013","1445","555","254","301","9","564","1422","0","39.66","17.86"
"63","000","00","110","0013","1446","683","383","300","7","690","1433","0","48.15","26.73"
"63","000","00","110","0014","0000","1987","939","1048","17","2004","4156","0","48.22","22.59"
"63","000","00","110","0014","1447","641","339","302","4","645","1373","0","46.98","24.69"
"63","000","00","110","0014","1448","650","296","354","11","661","1421","0","46.52","20.83"
"63","000","00","110","0014","1449","696","304","392","2","698","1362","0","51.25","22.32"
"63","000","00","110","0015","0000","2164","885","1279","28","2192","4679","0","46.85","18.91"
"63","000","00","110","0015","1450","543","219","324","7","550","1152","0","47.74","19.01"
"63","000","00","110","0015","1451","565","248","317","5","570","1210","0","47.11","20.50"
"63","000","00","110","0015","1452","612","260","352","8","620","1300","0","47.69","20.00"
"63","000","00","110","0015","1453","444","158","286","8","452","1017","0","44.44","15.54"
"63","000","00","110","0016","0000","2240","896","1344","21","2261","5082","0","44.49","17.63"
"63","000","00","110","0016","1454","573","223","350","9","582","1288","0","45.19","17.31"
"63","000","00","110","0016","1455","482","180","302","1","483","1182","0","40.86","15.23"
"63","000","00","110","0016","1456","606","232","374","6","612","1306","0","46.86","17.76"
"63","000","00","110","0016","1457","579","261","318","5","584","1306","0","44.72","19.98"
"63","000","00","110","0017","0000","2891","1358","1533","41","2932","6264","0","46.81","21.68"
"63","000","00","110","0017","1458","526","210","316","6","532","1195","0","44.52","17.57"
"63","000","00","110","0017","1459","585","238","347","11","596","1310","0","45.50","18.17"
"63","000","00","110","0017","1460","573","229","344","9","582","1274","0","45.68","17.97"
"63","000","00","110","0017","1461","569","375","194","6","575","1164","0","49.40","32.22"
"63","000","00","110","0017","1462","638","306","332","9","647","1321","0","48.98","23.16"
"63","000","00","110","0018","0000","1600","676","924","14","1614","3514","0","45.93","19.24"
"63","000","00","110","0018","1463","490","212","278","3","493","1063","0","46.38","19.94"
"63","000","00","110","0018","1464","571","228","343","7","578","1233","0","46.88","18.49"
"63","000","00","110","0018","1465","539","236","303","4","543","1218","0","44.58","19.38"
"63","000","00","110","0019","0000","2423","951","1472","26","2449","5517","0","44.39","17.24"
"63","000","00","110","0019","1466","603","239","364","4","607","1280","0","47.42","18.67"
"63","000","00","110","0019","1467","625","200","425","6","631","1437","0","43.91","13.92"
"63","000","00","110","0019","1468","609","303","306","7","616","1425","0","43.23","21.26"
"63","000","00","110","0019","1469","586","209","377","9","595","1375","0","43.27","15.20"
"63","000","00","110","0020","0000","3264","1254","2010","29","3293","7737","0","42.56","16.21"
"63","000","00","110","0020","1470","604","236","368","3","607","1295","0","46.87","18.22"
"63","000","00","110","0020","1471","497","173","324","8","505","1204","0","41.94","14.37"
"63","000","00","110","0020","1472","516","213","303","4","520","1262","0","41.20","16.88"
"63","000","00","110","0020","1473","613","211","402","4","617","1445","0","42.70","14.60"
"63","000","00","110","0020","1474","506","229","277","5","511","1281","0","39.89","17.88"
"63","000","00","110","0020","1475","528","192","336","5","533","1250","0","42.64","15.36"
"63","000","00","110","0021","0000","2761","1015","1746","25","2786","6210","0","44.86","16.34"
"63","000","00","110","0021","1476","483","206","277","2","485","1078","0","44.99","19.11"
"63","000","00","110","0021","1477","477","157","320","6","483","1148","0","42.07","13.68"
"63","000","00","110","0021","1478","606","205","401","5","611","1372","0","44.53","14.94"
"63","000","00","110","0021","1479","598","230","368","8","606","1360","0","44.56","16.91"
"63","000","00","110","0021","1480","597","217","380","4","601","1252","0","48.00","17.33"
"63","000","00","110","0022","0000","2681","1022","1659","27","2708","6117","0","44.27","16.71"
"63","000","00","110","0022","1481","516","193","323","5","521","1222","0","42.64","15.79"
"63","000","00","110","0022","1482","520","190","330","3","523","1213","0","43.12","15.66"
"63","000","00","110","0022","1483","566","224","342","8","574","1242","0","46.22","18.04"
"63","000","00","110","0022","1484","516","179","337","6","522","1153","0","45.27","15.52"
"63","000","00","110","0022","1485","563","236","327","5","568","1287","0","44.13","18.34"
"63","000","00","110","0023","0000","1891","490","1401","24","1915","4416","0","43.37","11.10"
"63","000","00","110","0023","1486","599","155","444","6","605","1415","0","42.76","10.95"
"63","000","00","110","0023","1487","631","166","465","9","640","1459","0","43.87","11.38"
"63","000","00","110","0023","1488","661","169","492","9","670","1542","0","43.45","10.96"
"63","000","00","110","0024","0000","2269","662","1607","22","2291","5424","0","42.24","12.21"
"63","000","00","110","0024","1489","477","150","327","5","482","1135","0","42.47","13.22"
"63","000","00","110","0024","1490","660","167","493","4","664","1550","0","42.84","10.77"
"63","000","00","110","0024","1491","553","159","394","6","559","1340","0","41.72","11.87"
"63","000","00","110","0024","1492","579","186","393","7","586","1399","0","41.89","13.30"
"63","000","00","110","0025","0000","1338","722","616","7","1345","2895","0","46.46","24.94"
"63","000","00","110","0025","1493","635","313","322","3","638","1446","0","44.12","21.65"
"63","000","00","110","0025","1494","703","409","294","4","707","1449","0","48.79","28.23"
"63","000","00","110","0026","0000","3094","1601","1493","28","3122","6048","0","51.62","26.47"
"63","000","00","110","0026","1495","681","359","322","3","684","1313","0","52.09","27.34"
"63","000","00","110","0026","1496","601","326","275","5","606","1205","0","50.29","27.05"
"63","000","00","110","0026","1497","675","351","324","8","683","1337","0","51.08","26.25"
"63","000","00","110","0026","1498","627","344","283","6","633","1209","0","52.36","28.45"
"63","000","00","110","0026","1499","510","221","289","6","516","984","0","52.44","22.46"
"63","000","00","110","0027","0000","1866","879","987","11","1877","3773","0","49.75","23.30"
"63","000","00","110","0027","1500","734","343","391","3","737","1315","0","56.05","26.08"
"63","000","00","110","0027","1501","541","270","271","4","545","1227","0","44.42","22.00"
"63","000","00","110","0027","1502","591","266","325","4","595","1231","0","48.33","21.61"
"63","000","00","110","0028","0000","2294","1073","1221","10","2304","4821","0","47.79","22.26"
"63","000","00","110","0028","1503","566","253","313","3","569","1220","0","46.64","20.74"
"63","000","00","110","0028","1504","534","223","311","2","536","1178","0","45.50","18.93"
"63","000","00","110","0028","1505","621","322","299","2","623","1283","0","48.56","25.10"
"63","000","00","110","0028","1506","573","275","298","3","576","1140","0","50.53","24.12"
"63","000","00","110","0029","0000","2127","1194","933","26","2153","4319","0","49.85","27.65"
"63","000","00","110","0029","1507","714","345","369","11","725","1478","0","49.05","23.34"
"63","000","00","110","0029","1508","666","327","339","3","669","1352","0","49.48","24.19"
"63","000","00","110","0029","1509","747","522","225","12","759","1489","0","50.97","35.06"
"63","000","00","110","0030","0000","2257","1415","842","16","2273","4739","0","47.96","29.86"
"63","000","00","110","0030","1510","578","401","177","5","583","1216","0","47.94","32.98"
"63","000","00","110","0030","1511","532","318","214","4","536","1133","0","47.31","28.07"
"63","000","00","110","0030","1512","610","383","227","1","611","1243","0","49.16","30.81"
"63","000","00","110","0030","1513","537","313","224","6","543","1147","0","47.34","27.29"
"63","000","00","110","0031","0000","3168","1597","1571","19","3187","6439","0","49.50","24.80"
"63","000","00","110","0031","1514","667","316","351","6","673","1360","0","49.49","23.24"
"63","000","00","110","0031","1515","674","352","322","7","681","1391","0","48.96","25.31"
"63","000","00","110","0031","1516","642","365","277","2","644","1291","0","49.88","28.27"
"63","000","00","110","0031","1517","567","273","294","1","568","1149","0","49.43","23.76"
"63","000","00","110","0031","1518","618","291","327","3","621","1248","0","49.76","23.32"
"63","000","00","110","0032","0000","2094","1193","901","26","2120","4371","0","48.50","27.29"
"63","000","00","110","0032","1519","700","453","247","3","703","1466","0","47.95","30.90"
"63","000","00","110","0032","1520","680","351","329","14","694","1391","0","49.89","25.23"
"63","000","00","110","0032","1521","714","389","325","9","723","1514","0","47.75","25.69"
"63","000","00","110","0033","0000","2349","1195","1154","17","2366","4881","0","48.47","24.48"
"63","000","00","110","0033","1522","596","308","288","5","601","1260","0","47.70","24.44"
"63","000","00","110","0033","1523","568","294","274","2","570","1229","0","46.38","23.92"
"63","000","00","110","0033","1524","585","289","296","7","592","1211","0","48.89","23.86"
"63","000","00","110","0033","1525","600","304","296","3","603","1181","0","51.06","25.74"
"63","000","00","110","0034","0000","3431","1706","1725","35","3466","7425","0","46.68","22.98"
"63","000","00","110","0034","1526","533","266","267","2","535","1202","0","44.51","22.13"
"63","000","00","110","0034","1527","549","257","292","9","558","1207","0","46.23","21.29"
"63","000","00","110","0034","1528","546","263","283","5","551","1160","0","47.50","22.67"
"63","000","00","110","0034","1529","673","317","356","7","680","1347","0","50.48","23.53"
"63","000","00","110","0034","1530","594","316","278","6","600","1373","0","43.70","23.02"
"63","000","00","110","0034","1531","536","287","249","6","542","1136","0","47.71","25.26"
"63","000","00","110","0035","0000","2682","1279","1403","17","2699","5452","0","49.50","23.46"
"63","000","00","110","0035","1532","655","327","328","4","659","1391","0","47.38","23.51"
"63","000","00","110","0035","1533","740","345","395","4","744","1458","0","51.03","23.66"
"63","000","00","110","0035","1534","730","355","375","5","735","1472","0","49.93","24.12"
"63","000","00","110","0035","1535","557","252","305","4","561","1131","0","49.60","22.28"
"63","000","00","110","0036","0000","2432","1227","1205","16","2448","5286","0","46.31","23.21"
"63","000","00","110","0036","1536","714","340","374","4","718","1502","0","47.80","22.64"
"63","000","00","110","0036","1537","557","262","295","4","561","1245","0","45.06","21.04"
"63","000","00","110","0036","1538","600","319","281","4","604","1256","0","48.09","25.40"
"63","000","00","110","0036","1539","561","306","255","4","565","1283","0","44.04","23.85"
"63","000","00","110","0037","0000","2114","1013","1101","13","2127","4413","0","48.20","22.95"
"63","000","00","110","0037","1540","795","355","440","3","798","1727","0","46.21","20.56"
"63","000","00","110","0037","1541","636","336","300","5","641","1262","0","50.79","26.62"
"63","000","00","110","0037","1542","683","322","361","5","688","1424","0","48.31","22.61"
"63","000","00","110","0038","0000","2070","1011","1059","15","2085","4299","0","48.50","23.52"
"63","000","00","110","0038","1543","696","343","353","7","703","1450","0","48.48","23.66"
"63","000","00","110","0038","1544","631","301","330","2","633","1323","0","47.85","22.75"
"63","000","00","110","0038","1545","743","367","376","6","749","1526","0","49.08","24.05"
"63","000","00","110","0039","0000","3005","1524","1481","27","3032","6370","0","47.60","23.92"
"63","000","00","110","0039","1546","625","324","301","5","630","1302","0","48.39","24.88"
"63","000","00","110","0039","1547","581","289","292","5","586","1185","0","49.45","24.39"
"63","000","00","110","0039","1548","589","296","293","4","593","1220","0","48.61","24.26"
"63","000","00","110","0039","1549","611","327","284","6","617","1300","0","47.46","25.15"
"63","000","00","110","0039","1550","599","288","311","7","606","1363","0","44.46","21.13"
"63","000","00","110","0040","0000","2801","1463","1338","28","2829","5880","0","48.11","24.88"
"63","000","00","110","0040","1551","686","370","316","6","692","1489","0","46.47","24.85"
"63","000","00","110","0040","1552","695","390","305","6","701","1472","0","47.62","26.49"
"63","000","00","110","0040","1553","696","343","353","9","705","1415","0","49.82","24.24"
"63","000","00","110","0040","1554","724","360","364","7","731","1504","0","48.60","23.94"
"63","000","00","110","0041","0000","3535","1798","1737","28","3563","7345","0","48.51","24.48"
"63","000","00","110","0041","1555","755","347","408","6","761","1592","0","47.80","21.80"
"63","000","00","110","0041","1556","675","370","305","10","685","1461","0","46.89","25.33"
"63","000","00","110","0041","1557","708","386","322","2","710","1480","0","47.97","26.08"
"63","000","00","110","0041","1558","766","354","412","6","772","1542","0","50.06","22.96"
"63","000","00","110","0041","1559","631","341","290","4","635","1270","0","50.00","26.85"
"63","000","00","110","0042","0000","2687","1376","1311","25","2712","5559","0","48.79","24.75"
"63","000","00","110","0042","1560","594","262","332","10","604","1191","0","50.71","22.00"
"63","000","00","110","0042","1561","688","367","321","4","692","1444","0","47.92","25.42"
"63","000","00","110","0042","1562","738","376","362","7","745","1485","0","50.17","25.32"
"63","000","00","110","0042","1563","667","371","296","4","671","1439","0","46.63","25.78"
"63","000","00","110","0043","0000","521","199","322","3","524","1083","0","48.38","18.37"
"63","000","00","110","0043","1564","521","199","322","3","524","1083","0","48.38","18.37"
"63","000","00","110","0044","0000","494","169","325","10","504","1228","0","41.04","13.76"
"63","000","00","110","0044","1565","494","169","325","10","504","1228","0","41.04","13.76"
"63","000","00","110","0045","0000","795","304","491","7","802","1668","0","48.08","18.23"
"63","000","00","110","0045","1566","393","157","236","4","397","840","0","47.26","18.69"
"63","000","00","110","0045","1567","402","147","255","3","405","828","0","48.91","17.75"
"63","000","00","110","0046","0000","1116","511","605","12","1128","2666","0","42.31","19.17"
"63","000","00","110","0046","1568","398","135","263","6","404","936","0","43.16","14.42"
"63","000","00","110","0046","1569","373","185","188","3","376","909","0","41.36","20.35"
"63","000","00","110","0046","1570","345","191","154","3","348","821","0","42.39","23.26"
"63","000","00","110","0047","0000","558","227","331","4","562","1421","0","39.55","15.97"
"63","000","00","110","0047","1571","327","130","197","2","329","889","0","37.01","14.62"
"63","000","00","110","0047","1572","231","97","134","2","233","532","0","43.80","18.23"
"63","000","00","110","0048","0000","550","156","394","5","555","1306","0","42.50","11.94"
"63","000","00","110","0048","1573","550","156","394","5","555","1306","0","42.50","11.94"
"63","000","00","110","0049","0000","566","230","336","6","572","1328","0","43.07","17.32"
"63","000","00","110","0049","1574","566","230","336","6","572","1328","0","43.07","17.32"
"63","000","00","110","0050","0000","1200","782","418","9","1209","2345","0","51.56","33.35"
"63","000","00","110","0050","1575","578","393","185","4","582","1144","0","50.87","34.35"
"63","000","00","110","0050","1576","622","389","233","5","627","1201","0","52.21","32.39"
"63","000","00","110","0051","0000","1160","596","564","9","1169","2508","0","46.61","23.76"
"63","000","00","110","0051","1577","625","335","290","6","631","1396","0","45.20","24.00"
"63","000","00","110","0051","1578","535","261","274","3","538","1112","0","48.38","23.47"
"63","000","00","120","0000","0000","94330","46125","48205","835","95165","207834","247333","45.79","22.19"
"63","000","00","120","0001","0000","1846","805","1041","12","1858","3704","0","50.16","21.73"
"63","000","00","120","0001","1579","599","273","326","6","605","1229","0","49.23","22.21"
"63","000","00","120","0001","1580","632","247","385","3","635","1241","0","51.17","19.90"
"63","000","00","120","0001","1581","615","285","330","3","618","1234","0","50.08","23.10"
"63","000","00","120","0002","0000","1704","754","950","11","1715","3685","0","46.54","20.46"
"63","000","00","120","0002","1582","526","231","295","3","529","1148","0","46.08","20.12"
"63","000","00","120","0002","1583","591","253","338","5","596","1285","0","46.38","19.69"
"63","000","00","120","0002","1584","587","270","317","3","590","1252","0","47.12","21.57"
"63","000","00","120","0003","0000","2141","963","1178","14","2155","4492","0","47.97","21.44"
"63","000","00","120","0003","1585","591","250","341","5","596","1166","0","51.11","21.44"
"63","000","00","120","0003","1586","674","304","370","1","675","1369","0","49.31","22.21"
"63","000","00","120","0003","1587","372","185","187","5","377","854","0","44.15","21.66"
"63","000","00","120","0003","1588","504","224","280","3","507","1103","0","45.97","20.31"
"63","000","00","120","0004","0000","2884","1408","1476","32","2916","5935","0","49.13","23.72"
"63","000","00","120","0004","1589","614","285","329","4","618","1227","0","50.37","23.23"
"63","000","00","120","0004","1590","557","284","273","10","567","1156","0","49.05","24.57"
"63","000","00","120","0004","1591","586","306","280","9","595","1220","0","48.77","25.08"
"63","000","00","120","0004","1592","578","283","295","3","581","1174","0","49.49","24.11"
"63","000","00","120","0004","1593","549","250","299","6","555","1158","0","47.93","21.59"
"63","000","00","120","0005","0000","2594","1312","1282","34","2628","6019","0","43.66","21.80"
"63","000","00","120","0005","1594","474","200","274","8","482","1256","0","38.38","15.92"
"63","000","00","120","0005","1595","496","270","226","8","504","1244","0","40.51","21.70"
"63","000","00","120","0005","1596","537","235","302","7","544","1181","0","46.06","19.90"
"63","000","00","120","0005","1597","532","289","243","6","538","1135","0","47.40","25.46"
"63","000","00","120","0005","1598","555","318","237","5","560","1203","0","46.55","26.43"
"63","000","00","120","0006","0000","3127","1567","1560","17","3144","6221","0","50.54","25.19"
"63","000","00","120","0006","1599","600","308","292","2","602","1323","0","45.50","23.28"
"63","000","00","120","0006","1600","690","349","341","2","692","1328","0","52.11","26.28"
"63","000","00","120","0006","1601","703","352","351","4","707","1358","0","52.06","25.92"
"63","000","00","120","0006","1602","604","265","339","5","609","1143","0","53.28","23.18"
"63","000","00","120","0006","1603","530","293","237","4","534","1069","0","49.95","27.41"
"63","000","00","120","0007","0000","3050","1516","1534","24","3074","6632","0","46.35","22.86"
"63","000","00","120","0007","1604","637","296","341","6","643","1376","0","46.73","21.51"
"63","000","00","120","0007","1605","568","288","280","3","571","1255","0","45.50","22.95"
"63","000","00","120","0007","1606","622","324","298","5","627","1414","0","44.34","22.91"
"63","000","00","120","0007","1607","651","330","321","4","655","1290","0","50.78","25.58"
"63","000","00","120","0007","1608","572","278","294","6","578","1297","0","44.56","21.43"
"63","000","00","120","0008","0000","2978","1560","1418","26","3004","6389","0","47.02","24.42"
"63","000","00","120","0008","1609","596","341","255","4","600","1231","0","48.74","27.70"
"63","000","00","120","0008","1610","602","301","301","11","613","1349","0","45.44","22.31"
"63","000","00","120","0008","1611","508","288","220","4","512","1200","0","42.67","24.00"
"63","000","00","120","0008","1612","655","298","357","4","659","1331","0","49.51","22.39"
"63","000","00","120","0008","1613","617","332","285","3","620","1278","0","48.51","25.98"
"63","000","00","120","0009","0000","3721","1805","1916","22","3743","7885","0","47.47","22.89"
"63","000","00","120","0009","1614","543","254","289","3","546","1137","0","48.02","22.34"
"63","000","00","120","0009","1615","607","275","332","3","610","1257","0","48.53","21.88"
"63","000","00","120","0009","1616","669","349","320","4","673","1461","0","46.06","23.89"
"63","000","00","120","0009","1617","685","330","355","6","691","1474","0","46.88","22.39"
"63","000","00","120","0009","1618","569","277","292","1","570","1285","0","44.36","21.56"
"63","000","00","120","0009","1619","648","320","328","5","653","1271","0","51.38","25.18"
"63","000","00","120","0010","0000","3259","1720","1539","20","3279","6840","0","47.94","25.15"
"63","000","00","120","0010","1620","606","302","304","9","615","1296","0","47.45","23.30"
"63","000","00","120","0010","1621","629","342","287","2","631","1270","0","49.69","26.93"
"63","000","00","120","0010","1622","667","398","269","2","669","1477","0","45.29","26.95"
"63","000","00","120","0010","1623","712","345","367","7","719","1482","0","48.52","23.28"
"63","000","00","120","0010","1624","645","333","312","0","645","1315","0","49.05","25.32"
"63","000","00","120","0011","0000","1977","1013","964","25","2002","4020","0","49.80","25.20"
"63","000","00","120","0011","1625","729","400","329","11","740","1451","0","51.00","27.57"
"63","000","00","120","0011","1626","672","314","358","8","680","1385","0","49.10","22.67"
"63","000","00","120","0011","1627","576","299","277","6","582","1184","0","49.16","25.25"
"63","000","00","120","0012","0000","1893","1028","865","14","1907","3773","0","50.54","27.25"
"63","000","00","120","0012","1628","538","285","253","3","541","1073","0","50.42","26.56"
"63","000","00","120","0012","1629","651","362","289","3","654","1206","0","54.23","30.02"
"63","000","00","120","0012","1630","704","381","323","8","712","1494","0","47.66","25.50"
"63","000","00","120","0013","0000","2797","1525","1272","23","2820","5623","0","50.15","27.12"
"63","000","00","120","0013","1631","591","334","257","5","596","1285","0","46.38","25.99"
"63","000","00","120","0013","1632","421","216","205","4","425","860","0","49.42","25.12"
"63","000","00","120","0013","1633","748","389","359","4","752","1247","0","60.30","31.19"
"63","000","00","120","0013","1634","509","290","219","6","515","1181","0","43.61","24.56"
"63","000","00","120","0013","1635","528","296","232","4","532","1050","0","50.67","28.19"
"63","000","00","120","0014","0000","1998","881","1117","19","2017","4216","0","47.84","20.90"
"63","000","00","120","0014","1636","635","273","362","2","637","1400","0","45.50","19.50"
"63","000","00","120","0014","1637","659","283","376","9","668","1403","0","47.61","20.17"
"63","000","00","120","0014","1638","704","325","379","8","712","1413","0","50.39","23.00"
"63","000","00","120","0015","0000","1839","782","1057","13","1852","3960","0","46.77","19.75"
"63","000","00","120","0015","1639","622","280","342","5","627","1330","0","47.14","21.05"
"63","000","00","120","0015","1640","615","266","349","3","618","1325","0","46.64","20.08"
"63","000","00","120","0015","1641","602","236","366","5","607","1305","0","46.51","18.08"
"63","000","00","120","0016","0000","2092","1022","1070","21","2113","4612","0","45.82","22.16"
"63","000","00","120","0016","1642","575","290","285","7","582","1188","0","48.99","24.41"
"63","000","00","120","0016","1643","545","251","294","9","554","1158","0","47.84","21.68"
"63","000","00","120","0016","1644","516","254","262","4","520","1172","0","44.37","21.67"
"63","000","00","120","0016","1645","456","227","229","1","457","1094","0","41.77","20.75"
"63","000","00","120","0017","0000","3619","1725","1894","34","3653","7578","0","48.21","22.76"
"63","000","00","120","0017","1646","566","325","241","6","572","1233","0","46.39","26.36"
"63","000","00","120","0017","1647","619","279","340","2","621","1268","0","48.97","22.00"
"63","000","00","120","0017","1648","644","304","340","8","652","1345","0","48.48","22.60"
"63","000","00","120","0017","1649","576","265","311","6","582","1219","0","47.74","21.74"
"63","000","00","120","0017","1650","636","283","353","7","643","1292","0","49.77","21.90"
"63","000","00","120","0017","1651","578","269","309","5","583","1221","0","47.75","22.03"
"63","000","00","120","0018","0000","2138","954","1184","21","2159","4729","0","45.65","20.17"
"63","000","00","120","0018","1652","588","291","297","4","592","1214","0","48.76","23.97"
"63","000","00","120","0018","1653","458","174","284","3","461","1114","0","41.38","15.62"
"63","000","00","120","0018","1654","461","208","253","5","466","1079","0","43.19","19.28"
"63","000","00","120","0018","1655","631","281","350","9","640","1322","0","48.41","21.26"
"63","000","00","120","0019","0000","933","347","586","8","941","1949","0","48.28","17.80"
"63","000","00","120","0019","1656","450","157","293","4","454","957","0","47.44","16.41"
"63","000","00","120","0019","1657","483","190","293","4","487","992","0","49.09","19.15"
"63","000","00","120","0020","0000","4451","2146","2305","27","4478","9427","0","47.50","22.76"
"63","000","00","120","0020","1658","797","358","439","8","805","1771","0","45.45","20.21"
"63","000","00","120","0020","1659","554","261","293","3","557","1186","0","46.96","22.01"
"63","000","00","120","0020","1660","628","321","307","2","630","1272","0","49.53","25.24"
"63","000","00","120","0020","1661","656","320","336","4","660","1418","0","46.54","22.57"
"63","000","00","120","0020","1662","569","286","283","3","572","1265","0","45.22","22.61"
"63","000","00","120","0020","1663","647","320","327","5","652","1273","0","51.22","25.14"
"63","000","00","120","0020","1664","600","280","320","2","602","1242","0","48.47","22.54"
"63","000","00","120","0021","0000","3365","1597","1768","48","3413","8533","0","40.00","18.72"
"63","000","00","120","0021","1665","423","186","237","7","430","2283","0","18.83","8.15"
"63","000","00","120","0021","1666","594","246","348","10","604","1292","0","46.75","19.04"
"63","000","00","120","0021","1667","741","362","379","13","754","1545","0","48.80","23.43"
"63","000","00","120","0021","1668","597","259","338","12","609","1335","0","45.62","19.40"
"63","000","00","120","0021","1669","492","210","282","5","497","1064","0","46.71","19.74"
"63","000","00","120","0021","1670","518","334","184","1","519","1014","0","51.18","32.94"
"63","000","00","120","0022","0000","3076","1404","1672","28","3104","7167","0","43.31","19.59"
"63","000","00","120","0022","1671","476","250","226","5","481","1163","0","41.36","21.50"
"63","000","00","120","0022","1672","585","250","335","2","587","1265","0","46.40","19.76"
"63","000","00","120","0022","1673","474","221","253","4","478","1052","0","45.44","21.01"
"63","000","00","120","0022","1674","464","198","266","7","471","1097","0","42.94","18.05"
"63","000","00","120","0022","1675","520","232","288","5","525","1265","0","41.50","18.34"
"63","000","00","120","0022","1676","557","253","304","5","562","1325","0","42.42","19.09"
"63","000","00","120","0023","0000","2213","1034","1179","17","2230","5324","0","41.89","19.42"
"63","000","00","120","0023","1677","594","252","342","7","601","1350","0","44.52","18.67"
"63","000","00","120","0023","1678","533","253","280","5","538","1246","0","43.18","20.30"
"63","000","00","120","0023","1679","549","251","298","2","551","1293","0","42.61","19.41"
"63","000","00","120","0023","1680","537","278","259","3","540","1435","0","37.63","19.37"
"63","000","00","120","0024","0000","2160","929","1231","29","2189","4700","0","46.57","19.77"
"63","000","00","120","0024","1681","545","228","317","8","553","1300","0","42.54","17.54"
"63","000","00","120","0024","1682","588","228","360","6","594","1275","0","46.59","17.88"
"63","000","00","120","0024","1683","418","180","238","8","426","918","0","46.41","19.61"
"63","000","00","120","0024","1684","609","293","316","7","616","1207","0","51.04","24.28"
"63","000","00","120","0025","0000","2613","1226","1387","21","2634","5643","0","46.68","21.73"
"63","000","00","120","0025","1685","486","211","275","5","491","1084","0","45.30","19.46"
"63","000","00","120","0025","1686","446","191","255","2","448","933","0","48.02","20.47"
"63","000","00","120","0025","1687","565","253","312","9","574","1158","0","49.57","21.85"
"63","000","00","120","0025","1688","541","267","274","3","544","1251","0","43.49","21.34"
"63","000","00","120","0025","1689","575","304","271","2","577","1217","0","47.41","24.98"
"63","000","00","120","0026","0000","1018","543","475","10","1028","2679","0","38.37","20.27"
"63","000","00","120","0026","1690","502","293","209","5","507","1300","0","39.00","22.54"
"63","000","00","120","0026","1691","516","250","266","5","521","1379","0","37.78","18.13"
"63","000","00","120","0027","0000","2355","1230","1125","17","2372","5695","0","41.65","21.60"
"63","000","00","120","0027","1692","479","267","212","1","480","1114","0","43.09","23.97"
"63","000","00","120","0027","1693","502","260","242","5","507","1136","0","44.63","22.89"
"63","000","00","120","0027","1694","461","233","228","5","466","1159","0","40.21","20.10"
"63","000","00","120","0027","1695","430","230","200","3","433","1124","0","38.52","20.46"
"63","000","00","120","0027","1696","483","240","243","3","486","1162","0","41.82","20.65"
"63","000","00","120","0028","0000","1541","714","827","8","1549","3547","0","43.67","20.13"
"63","000","00","120","0028","1697","427","183","244","2","429","970","0","44.23","18.87"
"63","000","00","120","0028","1698","535","268","267","2","537","1280","0","41.95","20.94"
"63","000","00","120","0028","1699","579","263","316","4","583","1297","0","44.95","20.28"
"63","000","00","120","0029","0000","2688","1415","1273","25","2713","5783","0","46.91","24.47"
"63","000","00","120","0029","1700","566","269","297","8","574","1337","0","42.93","20.12"
"63","000","00","120","0029","1701","682","428","254","7","689","1459","0","47.22","29.34"
"63","000","00","120","0029","1702","766","393","373","5","771","1538","0","50.13","25.55"
"63","000","00","120","0029","1703","674","325","349","5","679","1449","0","46.86","22.43"
"63","000","00","120","0030","0000","2082","1083","999","15","2097","4233","0","49.54","25.58"
"63","000","00","120","0030","1704","509","281","228","5","514","1063","0","48.35","26.43"
"63","000","00","120","0030","1705","723","371","352","3","726","1506","0","48.21","24.63"
"63","000","00","120","0030","1706","850","431","419","7","857","1664","0","51.50","25.90"
"63","000","00","120","0031","0000","2253","1162","1091","16","2269","5189","0","43.73","22.39"
"63","000","00","120","0031","1707","556","292","264","4","560","1297","0","43.18","22.51"
"63","000","00","120","0031","1708","499","237","262","6","505","1225","0","41.22","19.35"
"63","000","00","120","0031","1709","601","308","293","1","602","1308","0","46.02","23.55"
"63","000","00","120","0031","1710","597","325","272","5","602","1359","0","44.30","23.91"
"63","000","00","120","0032","0000","1230","643","587","18","1248","2834","0","44.04","22.69"
"63","000","00","120","0032","1711","553","298","255","10","563","1393","0","40.42","21.39"
"63","000","00","120","0032","1712","677","345","332","8","685","1441","0","47.54","23.94"
"63","000","00","120","0033","0000","1703","1138","565","16","1719","3518","0","48.86","32.35"
"63","000","00","120","0033","1713","548","363","185","3","551","1093","0","50.41","33.21"
"63","000","00","120","0033","1714","505","357","148","5","510","1073","0","47.53","33.27"
"63","000","00","120","0033","1715","650","418","232","8","658","1352","0","48.67","30.92"
"63","000","00","120","0034","0000","1487","757","730","8","1495","3811","0","39.23","19.86"
"63","000","00","120","0034","1716","501","283","218","3","504","1297","0","38.86","21.82"
"63","000","00","120","0034","1717","525","246","279","0","525","1322","0","39.71","18.61"
"63","000","00","120","0034","1718","461","228","233","5","466","1192","0","39.09","19.13"
"63","000","00","120","0035","0000","2062","1165","897","18","2080","4730","0","43.97","24.63"
"63","000","00","120","0035","1719","568","362","206","3","571","1178","0","48.47","30.73"
"63","000","00","120","0035","1720","498","276","222","3","501","1117","0","44.85","24.71"
"63","000","00","120","0035","1724","485","272","213","4","489","1179","0","41.48","23.07"
"63","000","00","120","0035","1725","511","255","256","8","519","1256","0","41.32","20.30"
"63","000","00","120","0036","0000","2392","1086","1306","19","2411","5227","0","46.13","20.78"
"63","000","00","120","0036","1721","516","201","315","6","522","1260","0","41.43","15.95"
"63","000","00","120","0036","1722","595","276","319","5","600","1373","0","43.70","20.10"
"63","000","00","120","0036","1723","616","295","321","5","621","1237","0","50.20","23.85"
"63","000","00","120","0036","1726","665","314","351","3","668","1357","0","49.23","23.14"
"63","000","00","120","0037","0000","2731","1211","1520","26","2757","6316","0","43.65","19.17"
"63","000","00","120","0037","1727","467","152","315","4","471","1120","0","42.05","13.57"
"63","000","00","120","0037","1728","533","209","324","6","539","1260","0","42.78","16.59"
"63","000","00","120","0037","1729","542","278","264","6","548","1301","0","42.12","21.37"
"63","000","00","120","0037","1730","593","276","317","4","597","1288","0","46.35","21.43"
"63","000","00","120","0037","1731","596","296","300","6","602","1347","0","44.69","21.97"
"63","000","00","120","0038","0000","4187","2063","2124","57","4244","9738","0","43.58","21.19"
"63","000","00","120","0038","1732","551","273","278","5","556","1326","0","41.93","20.59"
"63","000","00","120","0038","1733","589","312","277","3","592","1185","0","49.96","26.33"
"63","000","00","120","0038","1734","513","262","251","9","522","1165","0","44.81","22.49"
"63","000","00","120","0038","1735","465","232","233","5","470","1183","0","39.73","19.61"
"63","000","00","120","0038","1736","547","239","308","4","551","1190","0","46.30","20.08"
"63","000","00","120","0038","1737","527","244","283","5","532","1188","0","44.78","20.54"
"63","000","00","120","0038","1738","530","268","262","21","551","1286","0","42.85","20.84"
"63","000","00","120","0038","1739","465","233","232","5","470","1215","0","38.68","19.18"
"63","000","00","120","0039","0000","822","336","486","8","830","2119","0","39.17","15.86"
"63","000","00","120","0039","1740","260","106","154","4","264","534","0","49.44","19.85"
"63","000","00","120","0039","1741","562","230","332","4","566","1585","0","35.71","14.51"
"63","000","00","120","0040","0000","580","265","315","9","589","1446","0","40.73","18.33"
"63","000","00","120","0040","1742","298","127","171","4","302","780","0","38.72","16.28"
"63","000","00","120","0040","1743","282","138","144","5","287","666","0","43.09","20.72"
"63","000","00","120","0041","0000","415","145","270","2","417","1087","0","38.36","13.34"
"63","000","00","120","0041","1744","415","145","270","2","417","1087","0","38.36","13.34"
"63","000","00","120","0042","0000","316","146","170","3","319","826","0","38.62","17.68"
"63","000","00","120","0042","1745","316","146","170","3","319","826","0","38.62","17.68"
"65","000","00","000","0000","0000","1443145","725556","717589","13320","1456465","3427162","4021398","42.50","21.17"
"65","000","00","010","0000","0000","202849","95665","107184","1871","204720","466918","555551","43.84","20.49"
"65","000","00","010","0001","0000","699","392","307","6","705","1395","0","50.54","28.10"
"65","000","00","010","0001","0974","699","392","307","6","705","1395","0","50.54","28.10"
"65","000","00","010","0002","0000","557","266","291","5","562","1228","0","45.77","21.66"
"65","000","00","010","0002","0975","557","266","291","5","562","1228","0","45.77","21.66"
"65","000","00","010","0003","0000","422","212","210","1","423","838","0","50.48","25.30"
"65","000","00","010","0003","0976","422","212","210","1","423","838","0","50.48","25.30"
"65","000","00","010","0004","0000","465","191","274","7","472","1026","0","46.00","18.62"
"65","000","00","010","0004","0977","465","191","274","7","472","1026","0","46.00","18.62"
"65","000","00","010","0005","0000","828","485","343","7","835","1648","0","50.67","29.43"
"65","000","00","010","0005","0978","449","239","210","4","453","926","0","48.92","25.81"
"65","000","00","010","0005","0979","379","246","133","3","382","722","0","52.91","34.07"
"65","000","00","010","0006","0000","1911","938","973","18","1929","4525","0","42.63","20.73"
"65","000","00","010","0006","0980","565","272","293","6","571","1322","0","43.19","20.57"
"65","000","00","010","0006","0981","422","198","224","3","425","1007","0","42.20","19.66"
"65","000","00","010","0006","0982","429","216","213","4","433","961","0","45.06","22.48"
"65","000","00","010","0006","0983","495","252","243","5","500","1235","0","40.49","20.40"
"65","000","00","010","0007","0000","1140","532","608","11","1151","2846","0","40.44","18.69"
"65","000","00","010","0007","0984","624","288","336","5","629","1503","0","41.85","19.16"
"65","000","00","010","0007","0985","516","244","272","6","522","1343","0","38.87","18.17"
"65","000","00","010","0008","0000","2464","1208","1256","27","2491","8998","0","27.68","13.43"
"65","000","00","010","0008","0986","872","444","428","11","883","5431","0","16.26","8.18"
"65","000","00","010","0008","0987","587","284","303","11","598","1305","0","45.82","21.76"
"65","000","00","010","0008","0988","530","257","273","4","534","1157","0","46.15","22.21"
"65","000","00","010","0008","0989","475","223","252","1","476","1105","0","43.08","20.18"
"65","000","00","010","0009","0000","1731","749","982","18","1749","3907","0","44.77","19.17"
"65","000","00","010","0009","0990","672","293","379","7","679","1519","0","44.70","19.29"
"65","000","00","010","0009","0991","464","192","272","6","470","1105","0","42.53","17.38"
"65","000","00","010","0009","0992","595","264","331","5","600","1283","0","46.77","20.58"
"65","000","00","010","0010","0000","1875","860","1015","14","1889","4691","0","40.27","18.33"
"65","000","00","010","0010","0995","828","369","459","5","833","2219","0","37.54","16.63"
"65","000","00","010","0010","0996","507","239","268","4","511","1273","0","40.14","18.77"
"65","000","00","010","0010","0997","540","252","288","5","545","1199","0","45.45","21.02"
"65","000","00","010","0011","0000","2339","1337","1002","13","2352","4425","0","53.15","30.21"
"65","000","00","010","0011","0998","592","354","238","5","597","1091","0","54.72","32.45"
"65","000","00","010","0011","0999","586","322","264","4","590","1059","0","55.71","30.41"
"65","000","00","010","0011","1000","625","342","283","1","626","1200","0","52.17","28.50"
"65","000","00","010","0011","1001","536","319","217","3","539","1075","0","50.14","29.67"
"65","000","00","010","0012","0000","1150","507","643","10","1160","2471","0","46.94","20.52"
"65","000","00","010","0012","1002","595","261","334","4","599","1253","0","47.81","20.83"
"65","000","00","010","0012","1003","555","246","309","6","561","1218","0","46.06","20.20"
"65","000","00","010","0013","0000","1103","581","522","11","1114","2357","0","47.26","24.65"
"65","000","00","010","0013","1004","489","218","271","5","494","1117","0","44.23","19.52"
"65","000","00","010","0013","1005","614","363","251","6","620","1240","0","50.00","29.27"
"65","000","00","010","0014","0000","1799","1281","518","9","1808","3349","0","53.99","38.25"
"65","000","00","010","0014","1008","753","569","184","3","756","1332","0","56.76","42.72"
"65","000","00","010","0014","1009","555","433","122","5","560","977","0","57.32","44.32"
"65","000","00","010","0014","1010","491","279","212","1","492","1040","0","47.31","26.83"
"65","000","00","010","0015","0000","1228","615","613","7","1235","2463","0","50.14","24.97"
"65","000","00","010","0015","1011","566","259","307","3","569","1231","0","46.22","21.04"
"65","000","00","010","0015","1012","662","356","306","4","666","1232","0","54.06","28.90"
"65","000","00","010","0016","0000","1460","629","831","10","1470","3446","0","42.66","18.25"
"65","000","00","010","0016","1016","442","202","240","1","443","1041","0","42.56","19.40"
"65","000","00","010","0016","1017","479","199","280","3","482","1169","0","41.23","17.02"
"65","000","00","010","0016","1018","539","228","311","6","545","1236","0","44.09","18.45"
"65","000","00","010","0017","0000","1695","746","949","17","1712","4107","0","41.68","18.16"
"65","000","00","010","0017","1019","463","209","254","3","466","1149","0","40.56","18.19"
"65","000","00","010","0017","1020","373","159","214","8","381","983","0","38.76","16.17"
"65","000","00","010","0017","1021","326","129","197","2","328","795","0","41.26","16.23"
"65","000","00","010","0017","1022","533","249","284","4","537","1180","0","45.51","21.10"
"65","000","00","010","0018","0000","1142","596","546","9","1151","2304","0","49.96","25.87"
"65","000","00","010","0018","1023","570","305","265","4","574","1106","0","51.90","27.58"
"65","000","00","010","0018","1024","572","291","281","5","577","1198","0","48.16","24.29"
"65","000","00","010","0019","0000","1426","598","828","17","1443","3109","0","46.41","19.23"
"65","000","00","010","0019","1027","459","194","265","3","462","999","0","46.25","19.42"
"65","000","00","010","0019","1028","427","179","248","7","434","976","0","44.47","18.34"
"65","000","00","010","0019","1029","540","225","315","7","547","1134","0","48.24","19.84"
"65","000","00","010","0020","0000","1797","894","903","14","1811","3542","0","51.13","25.24"
"65","000","00","010","0020","1030","580","322","258","3","583","1124","0","51.87","28.65"
"65","000","00","010","0020","1031","596","274","322","9","605","1177","0","51.40","23.28"
"65","000","00","010","0020","1032","621","298","323","2","623","1241","0","50.20","24.01"
"65","000","00","010","0021","0000","1463","615","848","14","1477","3318","0","44.51","18.54"
"65","000","00","010","0021","1033","485","211","274","5","490","1048","0","46.76","20.13"
"65","000","00","010","0021","1034","592","248","344","4","596","1280","0","46.56","19.38"
"65","000","00","010","0021","1035","386","156","230","5","391","990","0","39.49","15.76"
"65","000","00","010","0022","0000","1664","797","867","16","1680","3648","0","46.05","21.85"
"65","000","00","010","0022","1036","506","248","258","6","512","1103","0","46.42","22.48"
"65","000","00","010","0022","1037","566","251","315","3","569","1266","0","44.94","19.83"
"65","000","00","010","0022","1038","592","298","294","7","599","1279","0","46.83","23.30"
"65","000","00","010","0023","0000","1406","586","820","10","1416","3487","0","40.61","16.81"
"65","000","00","010","0023","1039","482","197","285","6","488","1158","0","42.14","17.01"
"65","000","00","010","0023","1040","524","221","303","2","526","1235","0","42.59","17.89"
"65","000","00","010","0023","1041","400","168","232","2","402","1094","0","36.75","15.36"
"65","000","00","010","0024","0000","1866","1290","576","12","1878","3605","0","52.09","35.78"
"65","000","00","010","0024","1044","561","373","188","4","565","1094","0","51.65","34.10"
"65","000","00","010","0024","1045","759","582","177","2","761","1407","0","54.09","41.36"
"65","000","00","010","0024","1046","546","335","211","6","552","1104","0","50.00","30.34"
"65","000","00","010","0025","0000","1030","477","553","13","1043","2364","0","44.12","20.18"
"65","000","00","010","0025","1049","572","279","293","7","579","1280","0","45.23","21.80"
"65","000","00","010","0025","1050","458","198","260","6","464","1084","0","42.80","18.27"
"65","000","00","010","0026","0000","1080","528","552","13","1093","2555","0","42.78","20.67"
"65","000","00","010","0026","1051","517","260","257","9","526","1280","0","41.09","20.31"
"65","000","00","010","0026","1052","563","268","295","4","567","1275","0","44.47","21.02"
"65","000","00","010","0027","0000","929","394","535","10","939","1865","0","50.35","21.13"
"65","000","00","010","0027","1053","427","185","242","5","432","847","0","51.00","21.84"
"65","000","00","010","0027","1054","502","209","293","5","507","1018","0","49.80","20.53"
"65","000","00","010","0028","0000","2824","1392","1432","16","2840","6159","0","46.11","22.60"
"65","000","00","010","0028","1055","716","351","365","2","718","1626","0","44.16","21.59"
"65","000","00","010","0028","1056","610","280","330","1","611","1285","0","47.55","21.79"
"65","000","00","010","0028","1057","783","368","415","9","792","1678","0","47.20","21.93"
"65","000","00","010","0028","1058","715","393","322","4","719","1570","0","45.80","25.03"
"65","000","00","010","0029","0000","1931","762","1169","12","1943","4582","0","42.41","16.63"
"65","000","00","010","0029","1059","703","268","435","2","705","1580","0","44.62","16.96"
"65","000","00","010","0029","1060","518","219","299","5","523","1255","0","41.67","17.45"
"65","000","00","010","0029","1061","710","275","435","5","715","1747","0","40.93","15.74"
"65","000","00","010","0030","0000","1981","810","1171","14","1995","4774","0","41.79","16.97"
"65","000","00","010","0030","1062","680","292","388","3","683","1576","0","43.34","18.53"
"65","000","00","010","0030","1063","671","275","396","6","677","1611","0","42.02","17.07"
"65","000","00","010","0030","1064","630","243","387","5","635","1587","0","40.01","15.31"
"65","000","00","010","0031","0000","2424","1004","1420","21","2445","5675","0","43.08","17.69"
"65","000","00","010","0031","1065","452","196","256","4","456","1051","0","43.39","18.65"
"65","000","00","010","0031","1066","964","419","545","9","973","2203","0","44.17","19.02"
"65","000","00","010","0031","1067","392","157","235","3","395","1046","0","37.76","15.01"
"65","000","00","010","0031","1068","616","232","384","5","621","1375","0","45.16","16.87"
"65","000","00","010","0032","0000","1455","743","712","12","1467","3287","0","44.63","22.60"
"65","000","00","010","0032","1069","753","433","320","3","756","1671","0","45.24","25.91"
"65","000","00","010","0032","1070","702","310","392","9","711","1616","0","44.00","19.18"
"65","000","00","010","0033","0000","1983","956","1027","19","2002","4715","0","42.46","20.28"
"65","000","00","010","0033","1073","723","328","395","10","733","1735","0","42.25","18.90"
"65","000","00","010","0033","1074","554","219","335","4","558","1238","0","45.07","17.69"
"65","000","00","010","0033","1075","706","409","297","5","711","1742","0","40.82","23.48"
"65","000","00","010","0034","0000","1126","416","710","14","1140","2555","0","44.62","16.28"
"65","000","00","010","0034","1076","601","219","382","8","609","1351","0","45.08","16.21"
"65","000","00","010","0034","1077","525","197","328","6","531","1204","0","44.10","16.36"
"65","000","00","010","0035","0000","3166","1406","1760","25","3191","7107","0","44.90","19.78"
"65","000","00","010","0035","1078","761","249","512","6","767","1719","0","44.62","14.49"
"65","000","00","010","0035","1079","703","292","411","1","704","1678","0","41.95","17.40"
"65","000","00","010","0035","1080","833","430","403","9","842","1830","0","46.01","23.50"
"65","000","00","010","0035","1081","869","435","434","9","878","1880","0","46.70","23.14"
"65","000","00","010","0036","0000","1500","605","895","12","1512","3275","0","46.17","18.47"
"65","000","00","010","0036","1085","519","185","334","5","524","1100","0","47.64","16.82"
"65","000","00","010","0036","1086","502","212","290","3","505","1137","0","44.42","18.65"
"65","000","00","010","0036","1087","479","208","271","4","483","1038","0","46.53","20.04"
"65","000","00","010","0037","0000","2760","1421","1339","27","2787","6174","0","45.14","23.02"
"65","000","00","010","0037","1088","625","293","332","6","631","1601","0","39.41","18.30"
"65","000","00","010","0037","1089","683","329","354","3","686","1597","0","42.96","20.60"
"65","000","00","010","0037","1090","685","385","300","10","695","1462","0","47.54","26.33"
"65","000","00","010","0037","1091","767","414","353","8","775","1514","0","51.19","27.34"
"65","000","00","010","0038","0000","1121","394","727","16","1137","2666","0","42.65","14.78"
"65","000","00","010","0038","1095","326","112","214","10","336","818","0","41.08","13.69"
"65","000","00","010","0038","1096","369","122","247","2","371","819","0","45.30","14.90"
"65","000","00","010","0038","1097","426","160","266","4","430","1029","0","41.79","15.55"
"65","000","00","010","0039","0000","1822","766","1056","21","1843","4242","0","43.45","18.06"
"65","000","00","010","0039","1098","389","165","224","2","391","949","0","41.20","17.39"
"65","000","00","010","0039","1099","419","180","239","7","426","1051","0","40.53","17.13"
"65","000","00","010","0039","1100","398","170","228","8","406","985","0","41.22","17.26"
"65","000","00","010","0039","1101","616","251","365","4","620","1257","0","49.32","19.97"
"65","000","00","010","0040","0000","1299","537","762","9","1308","2962","0","44.16","18.13"
"65","000","00","010","0040","1102","564","224","340","2","566","1343","0","42.14","16.68"
"65","000","00","010","0040","1103","735","313","422","7","742","1619","0","45.83","19.33"
"65","000","00","010","0041","0000","1778","808","970","18","1796","4168","0","43.09","19.39"
"65","000","00","010","0041","1104","485","206","279","5","490","1164","0","42.10","17.70"
"65","000","00","010","0041","1105","621","296","325","5","626","1372","0","45.63","21.57"
"65","000","00","010","0041","1106","672","306","366","8","680","1632","0","41.67","18.75"
"65","000","00","010","0042","0000","1904","824","1080","15","1919","4391","0","43.70","18.77"
"65","000","00","010","0042","1107","625","258","367","3","628","1451","0","43.28","17.78"
"65","000","00","010","0042","1108","618","247","371","3","621","1462","0","42.48","16.89"
"65","000","00","010","0042","1109","661","319","342","9","670","1478","0","45.33","21.58"
"65","000","00","010","0043","0000","1430","619","811","14","1444","3044","0","47.44","20.34"
"65","000","00","010","0043","1112","730","285","445","5","735","1579","0","46.55","18.05"
"65","000","00","010","0043","1113","700","334","366","9","709","1465","0","48.40","22.80"
"65","000","00","010","0044","0000","4158","2040","2118","35","4193","9043","0","46.37","22.56"
"65","000","00","010","0044","1116","730","362","368","5","735","1597","0","46.02","22.67"
"65","000","00","010","0044","1117","696","292","404","12","708","1434","0","49.37","20.36"
"65","000","00","010","0044","1118","751","390","361","5","756","1661","0","45.51","23.48"
"65","000","00","010","0044","1119","730","365","365","5","735","1583","0","46.43","23.06"
"65","000","00","010","0044","1120","607","312","295","3","610","1403","0","43.48","22.24"
"65","000","00","010","0044","1121","644","319","325","5","649","1365","0","47.55","23.37"
"65","000","00","010","0045","0000","921","345","576","8","929","2150","0","43.21","16.05"
"65","000","00","010","0045","1122","460","157","303","5","465","1076","0","43.22","14.59"
"65","000","00","010","0045","1123","461","188","273","3","464","1074","0","43.20","17.50"
"65","000","00","010","0046","0000","1566","693","873","6","1572","3515","0","44.72","19.72"
"65","000","00","010","0046","1126","581","254","327","1","582","1245","0","46.75","20.40"
"65","000","00","010","0046","1127","442","197","245","3","445","1011","0","44.02","19.49"
"65","000","00","010","0046","1128","543","242","301","2","545","1259","0","43.29","19.22"
"65","000","00","010","0047","0000","1123","454","669","8","1131","2638","0","42.87","17.21"
"65","000","00","010","0047","1129","504","213","291","2","506","1235","0","40.97","17.25"
"65","000","00","010","0047","1130","619","241","378","6","625","1403","0","44.55","17.18"
"65","000","00","010","0048","0000","2071","845","1226","24","2095","5414","0","38.70","15.61"
"65","000","00","010","0048","1131","602","263","339","9","611","1703","0","35.88","15.44"
"65","000","00","010","0048","1132","708","268","440","8","716","1874","0","38.21","14.30"
"65","000","00","010","0048","1133","761","314","447","7","768","1837","0","41.81","17.09"
"65","000","00","010","0049","0000","533","257","276","6","539","1221","0","44.14","21.05"
"65","000","00","010","0049","1134","533","257","276","6","539","1221","0","44.14","21.05"
"65","000","00","010","0050","0000","2280","998","1282","24","2304","5318","0","43.32","18.77"
"65","000","00","010","0050","1135","645","292","353","8","653","1533","0","42.60","19.05"
"65","000","00","010","0050","1136","537","238","299","8","545","1222","0","44.60","19.48"
"65","000","00","010","0050","1137","536","230","306","6","542","1337","0","40.54","17.20"
"65","000","00","010","0050","1138","562","238","324","2","564","1226","0","46.00","19.41"
"65","000","00","010","0051","0000","1796","800","996","17","1813","3920","0","46.25","20.41"
"65","000","00","010","0051","1139","709","307","402","3","712","1489","0","47.82","20.62"
"65","000","00","010","0051","1140","450","194","256","5","455","926","0","49.14","20.95"
"65","000","00","010","0051","1141","637","299","338","9","646","1505","0","42.92","19.87"
"65","000","00","010","0052","0000","1677","680","997","22","1699","3731","0","45.54","18.23"
"65","000","00","010","0052","1142","402","137","265","5","407","907","0","44.87","15.10"
"65","000","00","010","0052","1143","550","232","318","5","555","1187","0","46.76","19.55"
"65","000","00","010","0052","1144","725","311","414","12","737","1637","0","45.02","19.00"
"65","000","00","010","0053","0000","1288","557","731","6","1294","2939","0","44.03","18.95"
"65","000","00","010","0053","1145","655","285","370","6","661","1435","0","46.06","19.86"
"65","000","00","010","0053","1146","633","272","361","0","633","1504","0","42.09","18.09"
"65","000","00","010","0054","0000","2389","1077","1312","18","2407","5578","0","43.15","19.31"
"65","000","00","010","0054","1147","595","281","314","4","599","1539","0","38.92","18.26"
"65","000","00","010","0054","1148","859","373","486","5","864","1872","0","46.15","19.93"
"65","000","00","010","0054","1149","689","333","356","6","695","1626","0","42.74","20.48"
"65","000","00","010","0054","1150","246","90","156","3","249","541","0","46.03","16.64"
"65","000","00","010","0055","0000","1190","501","689","12","1202","2572","0","46.73","19.48"
"65","000","00","010","0055","1153","666","285","381","7","673","1465","0","45.94","19.45"
"65","000","00","010","0055","1154","524","216","308","5","529","1107","0","47.79","19.51"
"65","000","00","010","0056","0000","1314","690","624","11","1325","2920","0","45.38","23.63"
"65","000","00","010","0056","1155","654","392","262","7","661","1382","0","47.83","28.36"
"65","000","00","010","0056","1156","660","298","362","4","664","1538","0","43.17","19.38"
"65","000","00","010","0057","0000","2943","1403","1540","19","2962","6417","0","46.16","21.86"
"65","000","00","010","0057","1159","476","217","259","4","480","1110","0","43.24","19.55"
"65","000","00","010","0057","1160","524","243","281","1","525","1169","0","44.91","20.79"
"65","000","00","010","0057","1161","511","198","313","4","515","1221","0","42.18","16.22"
"65","000","00","010","0057","1162","351","152","199","3","354","860","0","41.16","17.67"
"65","000","00","010","0057","1163","1081","593","488","7","1088","2057","0","52.89","28.83"
"65","000","00","010","0058","0000","1082","415","667","11","1093","2522","0","43.34","16.46"
"65","000","00","010","0058","1164","613","234","379","5","618","1441","0","42.89","16.24"
"65","000","00","010","0058","1165","469","181","288","6","475","1081","0","43.94","16.74"
"65","000","00","010","0059","0000","1886","831","1055","14","1900","4586","0","41.43","18.12"
"65","000","00","010","0059","1168","805","387","418","7","812","1920","0","42.29","20.16"
"65","000","00","010","0059","1169","509","207","302","3","512","1299","0","39.41","15.94"
"65","000","00","010","0059","1170","572","237","335","4","576","1367","0","42.14","17.34"
"65","000","00","010","0060","0000","1123","522","601","14","1137","2444","0","46.52","21.36"
"65","000","00","010","0060","1171","569","270","299","7","576","1272","0","45.28","21.23"
"65","000","00","010","0060","1172","554","252","302","7","561","1172","0","47.87","21.50"
"65","000","00","010","0061","0000","1783","782","1001","24","1807","3765","0","47.99","20.77"
"65","000","00","010","0061","1173","544","224","320","6","550","1210","0","45.45","18.51"
"65","000","00","010","0061","1174","589","245","344","4","593","1284","0","46.18","19.08"
"65","000","00","010","0061","1175","650","313","337","14","664","1271","0","52.24","24.63"
"65","000","00","010","0062","0000","1324","543","781","15","1339","3069","0","43.63","17.69"
"65","000","00","010","0062","1178","582","246","336","10","592","1417","0","41.78","17.36"
"65","000","00","010","0062","1179","742","297","445","5","747","1652","0","45.22","17.98"
"65","000","00","010","0063","0000","1583","690","893","12","1595","3525","0","45.25","19.57"
"65","000","00","010","0063","1180","787","326","461","5","792","1759","0","45.03","18.53"
"65","000","00","010","0063","1181","796","364","432","7","803","1766","0","45.47","20.61"
"65","000","00","010","0064","0000","1221","569","652","16","1237","3031","0","40.81","18.77"
"65","000","00","010","0064","1182","316","169","147","4","320","866","0","36.95","19.52"
"65","000","00","010","0064","1183","409","194","215","7","416","1055","0","39.43","18.39"
"65","000","00","010","0064","1184","496","206","290","5","501","1110","0","45.14","18.56"
"65","000","00","010","0065","0000","3227","1694","1533","25","3252","7123","0","45.65","23.78"
"65","000","00","010","0065","1185","733","408","325","11","744","1713","0","43.43","23.82"
"65","000","00","010","0065","1186","860","402","458","5","865","1836","0","47.11","21.90"
"65","000","00","010","0065","1187","752","406","346","5","757","1721","0","43.99","23.59"
"65","000","00","010","0065","1188","882","478","404","4","886","1853","0","47.81","25.80"
"65","000","00","010","0066","0000","1347","599","748","6","1353","3179","0","42.56","18.84"
"65","000","00","010","0066","1189","430","196","234","3","433","1016","0","42.62","19.29"
"65","000","00","010","0066","1190","465","189","276","1","466","1056","0","44.13","17.90"
"65","000","00","010","0066","1191","452","214","238","2","454","1107","0","41.01","19.33"
"65","000","00","010","0067","0000","1019","475","544","7","1026","2350","0","43.66","20.21"
"65","000","00","010","0067","1192","499","225","274","6","505","1193","0","42.33","18.86"
"65","000","00","010","0067","1193","520","250","270","1","521","1157","0","45.03","21.61"
"65","000","00","010","0068","0000","1764","741","1023","22","1786","3895","0","45.85","19.02"
"65","000","00","010","0068","1194","542","226","316","7","549","1202","0","45.67","18.80"
"65","000","00","010","0068","1195","673","323","350","8","681","1442","0","47.23","22.40"
"65","000","00","010","0068","1196","549","192","357","7","556","1251","0","44.44","15.35"
"65","000","00","010","0069","0000","1749","829","920","17","1766","3802","0","46.45","21.80"
"65","000","00","010","0069","1199","723","355","368","7","730","1581","0","46.17","22.45"
"65","000","00","010","0069","1200","555","250","305","4","559","1159","0","48.23","21.57"
"65","000","00","010","0069","1201","471","224","247","6","477","1062","0","44.92","21.09"
"65","000","00","010","0070","0000","1996","1075","921","26","2022","4141","0","48.83","25.96"
"65","000","00","010","0070","1204","739","380","359","10","749","1450","0","51.66","26.21"
"65","000","00","010","0070","1205","665","376","289","10","675","1381","0","48.88","27.23"
"65","000","00","010","0070","1206","592","319","273","6","598","1310","0","45.65","24.35"
"65","000","00","010","0071","0000","1467","818","649","10","1477","3382","0","43.67","24.19"
"65","000","00","010","0071","1207","776","426","350","4","780","1824","0","42.76","23.36"
"65","000","00","010","0071","1208","691","392","299","6","697","1558","0","44.74","25.16"
"65","000","00","010","0072","0000","1760","864","896","16","1776","3878","0","45.80","22.28"
"65","000","00","010","0072","1209","630","336","294","8","638","1477","0","43.20","22.75"
"65","000","00","010","0072","1210","616","297","319","6","622","1314","0","47.34","22.60"
"65","000","00","010","0072","1211","514","231","283","2","516","1087","0","47.47","21.25"
"65","000","00","010","0073","0000","1431","724","707","22","1453","3111","0","46.71","23.27"
"65","000","00","010","0073","1212","592","324","268","7","599","1383","0","43.31","23.43"
"65","000","00","010","0073","1213","839","400","439","15","854","1728","0","49.42","23.15"
"65","000","00","010","0074","0000","2036","969","1067","14","2050","4371","0","46.90","22.17"
"65","000","00","010","0074","1216","545","256","289","4","549","1178","0","46.60","21.73"
"65","000","00","010","0074","1217","710","346","364","3","713","1384","0","51.52","25.00"
"65","000","00","010","0074","1218","781","367","414","7","788","1809","0","43.56","20.29"
"65","000","00","010","0075","0000","1288","660","628","14","1302","3021","0","43.10","21.85"
"65","000","00","010","0075","1219","656","348","308","9","665","1528","0","43.52","22.77"
"65","000","00","010","0075","1220","632","312","320","5","637","1493","0","42.67","20.90"
"65","000","00","010","0076","0000","1514","749","765","4","1518","3064","0","49.54","24.45"
"65","000","00","010","0076","1221","777","384","393","3","780","1517","0","51.42","25.31"
"65","000","00","010","0076","1222","737","365","372","1","738","1547","0","47.71","23.59"
"65","000","00","010","0077","0000","1556","780","776","21","1577","3320","0","47.50","23.49"
"65","000","00","010","0077","1223","930","483","447","14","944","2020","0","46.73","23.91"
"65","000","00","010","0077","1224","626","297","329","7","633","1300","0","48.69","22.85"
"65","000","00","010","0078","0000","2630","1297","1333","21","2651","5909","0","44.86","21.95"
"65","000","00","010","0078","1225","792","396","396","9","801","1602","0","50.00","24.72"
"65","000","00","010","0078","1226","612","314","298","4","616","1482","0","41.57","21.19"
"65","000","00","010","0078","1227","607","300","307","5","612","1359","0","45.03","22.08"
"65","000","00","010","0078","1228","619","287","332","3","622","1466","0","42.43","19.58"
"65","000","00","010","0079","0000","1803","926","877","14","1817","4094","0","44.38","22.62"
"65","000","00","010","0079","1229","578","298","280","2","580","1426","0","40.67","20.90"
"65","000","00","010","0079","1230","620","328","292","9","629","1285","0","48.95","25.53"
"65","000","00","010","0079","1231","605","300","305","3","608","1383","0","43.96","21.69"
"65","000","00","010","0080","0000","3118","1591","1527","26","3144","7469","0","42.09","21.30"
"65","000","00","010","0080","1232","602","293","309","5","607","1527","0","39.75","19.19"
"65","000","00","010","0080","1233","611","315","296","4","615","1488","0","41.33","21.17"
"65","000","00","010","0080","1234","626","306","320","7","633","1488","0","42.54","20.56"
"65","000","00","010","0080","1235","622","320","302","5","627","1377","0","45.53","23.24"
"65","000","00","010","0080","1236","657","357","300","5","662","1589","0","41.66","22.47"
"65","000","00","010","0081","0000","1236","718","518","11","1247","2702","0","46.15","26.57"
"65","000","00","010","0081","1237","431","297","134","5","436","871","0","50.06","34.10"
"65","000","00","010","0081","1238","398","213","185","4","402","895","0","44.92","23.80"
"65","000","00","010","0081","1239","407","208","199","2","409","936","0","43.70","22.22"
"65","000","00","010","0082","0000","1401","796","605","14","1415","3281","0","43.13","24.26"
"65","000","00","010","0082","1240","796","477","319","8","804","1785","0","45.04","26.72"
"65","000","00","010","0082","1241","605","319","286","6","611","1496","0","40.84","21.32"
"65","000","00","010","0083","0000","1339","641","698","11","1350","3505","0","38.52","18.29"
"65","000","00","010","0083","1242","699","314","385","7","706","1743","0","40.50","18.01"
"65","000","00","010","0083","1243","640","327","313","4","644","1762","0","36.55","18.56"
"65","000","00","010","0084","0000","1703","845","858","21","1724","3734","0","46.17","22.63"
"65","000","00","010","0084","1247","576","273","303","4","580","1307","0","44.38","20.89"
"65","000","00","010","0084","1248","473","213","260","6","479","1112","0","43.08","19.15"
"65","000","00","010","0084","1249","654","359","295","11","665","1315","0","50.57","27.30"
"65","000","00","010","0085","0000","1032","468","564","17","1049","2257","0","46.48","20.74"
"65","000","00","010","0085","1250","516","247","269","10","526","1047","0","50.24","23.59"
"65","000","00","010","0085","1251","516","221","295","7","523","1210","0","43.22","18.26"
"65","000","00","010","0086","0000","2444","1210","1234","29","2473","6150","0","40.21","19.67"
"65","000","00","010","0086","1254","642","304","338","6","648","1816","0","35.68","16.74"
"65","000","00","010","0086","1255","404","176","228","5","409","961","0","42.56","18.31"
"65","000","00","010","0086","1256","708","328","380","10","718","1737","0","41.34","18.88"
"65","000","00","010","0086","1257","690","402","288","8","698","1636","0","42.67","24.57"
"65","000","00","010","0087","0000","3350","1809","1541","24","3374","6979","0","48.35","25.92"
"65","000","00","010","0087","1258","568","330","238","4","572","1139","0","50.22","28.97"
"65","000","00","010","0087","1259","725","371","354","9","734","1431","0","51.29","25.93"
"65","000","00","010","0087","1260","603","349","254","3","606","1356","0","44.69","25.74"
"65","000","00","010","0087","1261","687","334","353","5","692","1595","0","43.39","20.94"
"65","000","00","010","0087","1262","767","425","342","3","770","1458","0","52.81","29.15"
"65","000","00","010","0088","0000","1600","790","810","13","1613","3812","0","42.31","20.72"
"65","000","00","010","0088","1263","541","279","262","4","545","1346","0","40.49","20.73"
"65","000","00","010","0088","1264","488","244","244","4","492","1082","0","45.47","22.55"
"65","000","00","010","0088","1265","571","267","304","5","576","1384","0","41.62","19.29"
"65","000","00","010","0089","0000","1355","525","830","11","1366","3334","0","40.97","15.75"
"65","000","00","010","0089","1266","497","189","308","4","501","1218","0","41.13","15.52"
"65","000","00","010","0089","1267","408","158","250","5","413","1110","0","37.21","14.23"
"65","000","00","010","0089","1268","450","178","272","2","452","1006","0","44.93","17.69"
"65","000","00","010","0090","0000","1922","779","1143","16","1938","4625","0","41.90","16.84"
"65","000","00","010","0090","1269","607","251","356","5","612","1391","0","44.00","18.04"
"65","000","00","010","0090","1270","658","278","380","6","664","1542","0","43.06","18.03"
"65","000","00","010","0090","1271","657","250","407","5","662","1692","0","39.13","14.78"
"65","000","00","010","0091","0000","1437","585","852","7","1444","3700","0","39.03","15.81"
"65","000","00","010","0091","1272","451","177","274","4","455","1108","0","41.06","15.97"
"65","000","00","010","0091","1273","398","170","228","1","399","1087","0","36.71","15.64"
"65","000","00","010","0091","1274","588","238","350","2","590","1505","0","39.20","15.81"
"65","000","00","010","0092","0000","2501","1311","1190","23","2524","6074","0","41.55","21.58"
"65","000","00","010","0092","1278","435","189","246","9","444","1069","0","41.53","17.68"
"65","000","00","010","0092","1279","403","184","219","3","406","1003","0","40.48","18.34"
"65","000","00","010","0092","1280","420","206","214","5","425","1085","0","39.17","18.99"
"65","000","00","010","0092","1281","506","299","207","2","508","1216","0","41.78","24.59"
"65","000","00","010","0092","1282","737","433","304","4","741","1701","0","43.56","25.46"
"65","000","00","010","0093","0000","433","252","181","6","439","873","0","50.29","28.87"
"65","000","00","010","0093","1283","194","149","45","4","198","382","0","51.83","39.01"
"65","000","00","010","0093","1284","239","103","136","2","241","491","0","49.08","20.98"
"65","000","00","010","0094","0000","1472","673","799","12","1484","3466","0","42.82","19.42"
"65","000","00","010","0094","1285","465","210","255","4","469","1171","0","40.05","17.93"
"65","000","00","010","0094","1286","537","252","285","5","542","1184","0","45.78","21.28"
"65","000","00","010","0094","1287","470","211","259","3","473","1111","0","42.57","18.99"
"65","000","00","010","0095","0000","2648","1447","1201","20","2668","6234","0","42.80","23.21"
"65","000","00","010","0095","1288","426","250","176","5","431","966","0","44.62","25.88"
"65","000","00","010","0095","1289","477","184","293","2","479","1178","0","40.66","15.62"
"65","000","00","010","0095","1290","804","467","337","10","814","1919","0","42.42","24.34"
"65","000","00","010","0095","1291","941","546","395","3","944","2171","0","43.48","25.15"
"65","000","00","010","0096","0000","1781","767","1014","18","1799","4615","0","38.98","16.62"
"65","000","00","010","0096","1292","268","114","154","2","270","725","0","37.24","15.72"
"65","000","00","010","0096","1293","492","218","274","5","497","1306","0","38.06","16.69"
"65","000","00","010","0096","1294","472","219","253","2","474","1259","0","37.65","17.39"
"65","000","00","010","0096","1295","549","216","333","9","558","1325","0","42.11","16.30"
"65","000","00","010","0097","0000","1067","448","619","20","1087","2464","0","44.12","18.18"
"65","000","00","010","0097","1296","507","212","295","9","516","1161","0","44.44","18.26"
"65","000","00","010","0097","1297","560","236","324","11","571","1303","0","43.82","18.11"
"65","000","00","010","0098","0000","3334","1563","1771","34","3368","8523","0","39.52","18.34"
"65","000","00","010","0098","1298","489","214","275","10","499","1302","0","38.33","16.44"
"65","000","00","010","0098","1299","558","250","308","5","563","1449","0","38.85","17.25"
"65","000","00","010","0098","1300","522","244","278","3","525","1428","0","36.76","17.09"
"65","000","00","010","0098","1301","530","275","255","4","534","1493","0","35.77","18.42"
"65","000","00","010","0098","1302","652","310","342","6","658","1492","0","44.10","20.78"
"65","000","00","010","0098","1303","583","270","313","6","589","1359","0","43.34","19.87"
"65","000","00","010","0099","0000","2013","908","1105","21","2034","5148","0","39.51","17.64"
"65","000","00","010","0099","1308","670","299","371","8","678","1647","0","41.17","18.15"
"65","000","00","010","0099","1309","739","349","390","9","748","1803","0","41.49","19.36"
"65","000","00","010","0099","1310","604","260","344","4","608","1698","0","35.81","15.31"
"65","000","00","010","0100","0000","1290","603","687","17","1307","3079","0","42.45","19.58"
"65","000","00","010","0100","1319","618","295","323","10","628","1509","0","41.62","19.55"
"65","000","00","010","0100","1320","672","308","364","7","679","1570","0","43.25","19.62"
"65","000","00","010","0101","0000","1026","484","542","11","1037","2397","0","43.26","20.19"
"65","000","00","010","0101","0993","416","190","226","3","419","1000","0","41.90","19.00"
"65","000","00","010","0101","0994","610","294","316","8","618","1397","0","44.24","21.05"
"65","000","00","010","0102","0000","1653","725","928","17","1670","3742","0","44.63","19.37"
"65","000","00","010","0102","1013","484","216","268","6","490","1193","0","41.07","18.11"
"65","000","00","010","0102","1014","626","275","351","7","633","1380","0","45.87","19.93"
"65","000","00","010","0102","1015","543","234","309","4","547","1169","0","46.79","20.02"
"65","000","00","010","0103","0000","1191","599","592","5","1196","2692","0","44.43","22.25"
"65","000","00","010","0103","1042","665","330","335","2","667","1508","0","44.23","21.88"
"65","000","00","010","0103","1043","526","269","257","3","529","1184","0","44.68","22.72"
"65","000","00","010","0104","0000","1325","573","752","17","1342","2948","0","45.52","19.44"
"65","000","00","010","0104","1071","650","275","375","10","660","1482","0","44.53","18.56"
"65","000","00","010","0104","1072","675","298","377","7","682","1466","0","46.52","20.33"
"65","000","00","010","0105","0000","1292","567","725","6","1298","3027","0","42.88","18.73"
"65","000","00","010","0105","1092","416","172","244","2","418","1020","0","40.98","16.86"
"65","000","00","010","0105","1093","397","160","237","1","398","938","0","42.43","17.06"
"65","000","00","010","0105","1094","479","235","244","3","482","1069","0","45.09","21.98"
"65","000","00","010","0106","0000","1133","467","666","12","1145","2449","0","46.75","19.07"
"65","000","00","010","0106","1114","604","253","351","5","609","1286","0","47.36","19.67"
"65","000","00","010","0106","1115","529","214","315","7","536","1163","0","46.09","18.40"
"65","000","00","010","0107","0000","1001","477","524","11","1012","2040","0","49.61","23.38"
"65","000","00","010","0107","1151","481","209","272","3","484","1012","0","47.83","20.65"
"65","000","00","010","0107","1152","520","268","252","8","528","1028","0","51.36","26.07"
"65","000","00","010","0108","0000","1219","553","666","18","1237","2595","0","47.67","21.31"
"65","000","00","010","0108","1166","651","286","365","9","660","1481","0","44.56","19.31"
"65","000","00","010","0108","1167","568","267","301","9","577","1114","0","51.80","23.97"
"65","000","00","010","0109","0000","897","402","495","13","910","1940","0","46.91","20.72"
"65","000","00","010","0109","1197","424","171","253","5","429","946","0","45.35","18.08"
"65","000","00","010","0109","1198","473","231","242","8","481","994","0","48.39","23.24"
"65","000","00","010","0110","0000","1529","777","752","20","1549","3280","0","47.23","23.69"
"65","000","00","010","0110","1214","788","397","391","12","800","1610","0","49.69","24.66"
"65","000","00","010","0110","1215","741","380","361","8","749","1670","0","44.85","22.75"
"65","000","00","010","0111","0000","822","422","400","7","829","1789","0","46.34","23.59"
"65","000","00","010","0111","1252","469","241","228","3","472","968","0","48.76","24.90"
"65","000","00","010","0111","1253","353","181","172","4","357","821","0","43.48","22.05"
"65","000","00","010","0112","0000","1474","670","804","19","1493","3718","0","40.16","18.02"
"65","000","00","010","0112","1321","528","227","301","7","535","1358","0","39.40","16.72"
"65","000","00","010","0112","1322","370","169","201","5","375","935","0","40.11","18.07"
"65","000","00","010","0112","1323","576","274","302","7","583","1425","0","40.91","19.23"
"65","000","00","010","0113","0000","2168","1018","1150","23","2191","6055","0","36.18","16.81"
"65","000","00","010","0113","1304","578","260","318","3","581","1576","0","36.87","16.50"
"65","000","00","010","0113","1305","529","240","289","7","536","1426","0","37.59","16.83"
"65","000","00","010","0113","1306","546","261","285","5","551","1445","0","38.13","18.06"
"65","000","00","010","0113","1307","515","257","258","8","523","1608","0","32.52","15.98"
"65","000","00","010","0114","0000","1032","545","487","5","1037","2287","0","45.34","23.83"
"65","000","00","010","0114","1006","541","284","257","2","543","1267","0","42.86","22.42"
"65","000","00","010","0114","1007","491","261","230","3","494","1020","0","48.43","25.59"
"65","000","00","010","0115","0000","835","432","403","4","839","1772","0","47.35","24.38"
"65","000","00","010","0115","1025","465","243","222","3","468","996","0","46.99","24.40"
"65","000","00","010","0115","1026","370","189","181","1","371","776","0","47.81","24.36"
"65","000","00","010","0116","0000","1124","472","652","9","1133","2400","0","47.21","19.67"
"65","000","00","010","0116","1047","612","275","337","5","617","1257","0","49.09","21.88"
"65","000","00","010","0116","1048","512","197","315","4","516","1143","0","45.14","17.24"
"65","000","00","010","0117","0000","1234","487","747","13","1247","2973","0","41.94","16.38"
"65","000","00","010","0117","1082","453","184","269","2","455","1084","0","41.97","16.97"
"65","000","00","010","0117","1083","362","127","235","5","367","865","0","42.43","14.68"
"65","000","00","010","0117","1084","419","176","243","6","425","1024","0","41.50","17.19"
"65","000","00","010","0118","0000","953","419","534","16","969","2012","0","48.16","20.83"
"65","000","00","010","0118","1110","521","237","284","10","531","1114","0","47.67","21.27"
"65","000","00","010","0118","1111","432","182","250","6","438","898","0","48.78","20.27"
"65","000","00","010","0119","0000","1498","607","891","12","1510","3479","0","43.40","17.45"
"65","000","00","010","0119","1124","694","272","422","6","700","1651","0","42.40","16.47"
"65","000","00","010","0119","1125","804","335","469","6","810","1828","0","44.31","18.33"
"65","000","00","010","0120","0000","1435","622","813","16","1451","3379","0","42.94","18.41"
"65","000","00","010","0120","1157","626","275","351","9","635","1481","0","42.88","18.57"
"65","000","00","010","0120","1158","809","347","462","7","816","1898","0","42.99","18.28"
"65","000","00","010","0121","0000","1661","821","840","19","1680","3540","0","47.46","23.19"
"65","000","00","010","0121","1176","982","499","483","13","995","2040","0","48.77","24.46"
"65","000","00","010","0121","1177","679","322","357","6","685","1500","0","45.67","21.47"
"65","000","00","010","0122","0000","824","358","466","13","837","2026","0","41.31","17.67"
"65","000","00","010","0122","1202","371","161","210","9","380","970","0","39.18","16.60"
"65","000","00","010","0122","1203","453","197","256","4","457","1056","0","43.28","18.66"
"65","000","00","010","0123","0000","1581","729","852","14","1595","3585","0","44.49","20.33"
"65","000","00","010","0123","1244","532","256","276","3","535","1241","0","43.11","20.63"
"65","000","00","010","0123","1245","522","232","290","8","530","1170","0","45.30","19.83"
"65","000","00","010","0123","1246","527","241","286","3","530","1174","0","45.14","20.53"
"65","000","00","010","0124","0000","4709","2358","2351","41","4750","12217","0","38.88","19.30"
"65","000","00","010","0124","1311","625","324","301","6","631","1619","0","38.97","20.01"
"65","000","00","010","0124","1312","651","285","366","3","654","1640","0","39.88","17.38"
"65","000","00","010","0124","1313","545","253","292","5","550","1507","0","36.50","16.79"
"65","000","00","010","0124","1314","665","322","343","5","670","1576","0","42.51","20.43"
"65","000","00","010","0124","1315","640","329","311","5","645","1628","0","39.62","20.21"
"65","000","00","010","0124","1316","617","331","286","6","623","1622","0","38.41","20.41"
"65","000","00","010","0124","1317","546","298","248","5","551","1400","0","39.36","21.29"
"65","000","00","010","0124","1318","420","216","204","6","426","1225","0","34.78","17.63"
"65","000","00","010","0125","0000","1250","501","749","10","1260","3210","0","39.25","15.61"
"65","000","00","010","0125","1275","620","278","342","6","626","1572","0","39.82","17.68"
"65","000","00","010","0125","1276","630","223","407","4","634","1638","0","38.71","13.61"
"65","000","00","010","0126","0000","496","192","304","4","500","1091","0","45.83","17.60"
"65","000","00","010","0126","1277","496","192","304","4","500","1091","0","45.83","17.60"
"65","000","00","020","0000","0000","141849","60175","81674","1356","143205","330362","383135","43.35","18.21"
"65","000","00","020","0001","0000","2039","842","1197","16","2055","4726","0","43.48","17.82"
"65","000","00","020","0001","0729","604","268","336","2","606","1466","0","41.34","18.28"
"65","000","00","020","0001","0730","380","137","243","1","381","834","0","45.68","16.43"
"65","000","00","020","0001","0731","547","213","334","8","555","1279","0","43.39","16.65"
"65","000","00","020","0001","0732","508","224","284","5","513","1147","0","44.73","19.53"
"65","000","00","020","0002","0000","565","330","235","9","574","1436","0","39.97","22.98"
"65","000","00","020","0002","0736","565","330","235","9","574","1436","0","39.97","22.98"
"65","000","00","020","0003","0000","966","338","628","3","969","2322","0","41.73","14.56"
"65","000","00","020","0003","0737","520","185","335","2","522","1257","0","41.53","14.72"
"65","000","00","020","0003","0738","446","153","293","1","447","1065","0","41.97","14.37"
"65","000","00","020","0004","0000","444","172","272","4","448","904","0","49.56","19.03"
"65","000","00","020","0004","0739","444","172","272","4","448","904","0","49.56","19.03"
"65","000","00","020","0005","0000","1650","629","1021","15","1665","3568","0","46.66","17.63"
"65","000","00","020","0005","0742","937","384","553","8","945","1978","0","47.78","19.41"
"65","000","00","020","0005","0743","713","245","468","7","720","1590","0","45.28","15.41"
"65","000","00","020","0006","0000","176","62","114","2","178","351","0","50.71","17.66"
"65","000","00","020","0006","0744","176","62","114","2","178","351","0","50.71","17.66"
"65","000","00","020","0007","0000","2616","1255","1361","15","2631","5671","0","46.39","22.13"
"65","000","00","020","0007","0745","475","224","251","4","479","1008","0","47.52","22.22"
"65","000","00","020","0007","0746","494","198","296","6","500","1139","0","43.90","17.38"
"65","000","00","020","0007","0747","809","400","409","2","811","1729","0","46.91","23.13"
"65","000","00","020","0007","0748","838","433","405","3","841","1795","0","46.85","24.12"
"65","000","00","020","0008","0000","2171","968","1203","13","2184","4889","0","44.67","19.80"
"65","000","00","020","0008","0749","614","268","346","2","616","1341","0","45.94","19.99"
"65","000","00","020","0008","0750","578","263","315","4","582","1263","0","46.08","20.82"
"65","000","00","020","0008","0751","499","210","289","2","501","1131","0","44.30","18.57"
"65","000","00","020","0008","0752","480","227","253","5","485","1154","0","42.03","19.67"
"65","000","00","020","0009","0000","1314","541","773","15","1329","3007","0","44.20","17.99"
"65","000","00","020","0009","0755","677","263","414","8","685","1549","0","44.22","16.98"
"65","000","00","020","0009","0756","637","278","359","7","644","1458","0","44.17","19.07"
"65","000","00","020","0010","0000","2490","1186","1304","30","2520","8822","0","28.56","13.44"
"65","000","00","020","0010","0757","678","282","396","8","686","4754","0","14.43","5.93"
"65","000","00","020","0010","0758","523","247","276","7","530","1199","0","44.20","20.60"
"65","000","00","020","0010","0759","683","346","337","9","692","1456","0","47.53","23.76"
"65","000","00","020","0010","0760","606","311","295","6","612","1413","0","43.31","22.01"
"65","000","00","020","0011","0000","830","339","491","5","835","1860","0","44.89","18.23"
"65","000","00","020","0011","0761","462","191","271","3","465","1008","0","46.13","18.95"
"65","000","00","020","0011","0762","368","148","220","2","370","852","0","43.43","17.37"
"65","000","00","020","0012","0000","1500","658","842","14","1514","3239","0","46.74","20.31"
"65","000","00","020","0012","0763","675","311","364","7","682","1486","0","45.90","20.93"
"65","000","00","020","0012","0764","825","347","478","7","832","1753","0","47.46","19.79"
"65","000","00","020","0013","0000","1879","839","1040","30","1909","3937","0","48.49","21.31"
"65","000","00","020","0013","0765","578","249","329","7","585","1296","0","45.14","19.21"
"65","000","00","020","0013","0766","638","284","354","9","647","1403","0","46.12","20.24"
"65","000","00","020","0013","0767","663","306","357","14","677","1238","0","54.68","24.72"
"65","000","00","020","0014","0000","2719","1223","1496","26","2745","5711","0","48.07","21.41"
"65","000","00","020","0014","0768","922","418","504","5","927","1945","0","47.66","21.49"
"65","000","00","020","0014","0769","456","204","252","4","460","983","0","46.80","20.75"
"65","000","00","020","0014","0770","641","274","367","3","644","1409","0","45.71","19.45"
"65","000","00","020","0014","0771","700","327","373","14","714","1374","0","51.97","23.80"
"65","000","00","020","0015","0000","1536","641","895","17","1553","3667","0","42.35","17.48"
"65","000","00","020","0015","0772","531","234","297","5","536","1203","0","44.56","19.45"
"65","000","00","020","0015","0773","508","220","288","8","516","1239","0","41.65","17.76"
"65","000","00","020","0015","0774","497","187","310","4","501","1225","0","40.90","15.27"
"65","000","00","020","0016","0000","1467","621","846","13","1480","3107","0","47.63","19.99"
"65","000","00","020","0016","0775","674","294","380","7","681","1475","0","46.17","19.93"
"65","000","00","020","0016","0776","793","327","466","6","799","1632","0","48.96","20.04"
"65","000","00","020","0017","0000","2429","933","1496","22","2451","5458","0","44.91","17.09"
"65","000","00","020","0017","0777","592","227","365","9","601","1304","0","46.09","17.41"
"65","000","00","020","0017","0778","626","276","350","3","629","1262","0","49.84","21.87"
"65","000","00","020","0017","0779","616","219","397","5","621","1438","0","43.18","15.23"
"65","000","00","020","0017","0780","595","211","384","5","600","1454","0","41.27","14.51"
"65","000","00","020","0018","0000","2414","1042","1372","27","2441","5517","0","44.25","18.89"
"65","000","00","020","0018","0781","798","336","462","17","815","1689","0","48.25","19.89"
"65","000","00","020","0018","0782","885","415","470","5","890","2006","0","44.37","20.69"
"65","000","00","020","0018","0783","731","291","440","5","736","1822","0","40.40","15.97"
"65","000","00","020","0019","0000","1185","462","723","12","1197","2877","0","41.61","16.06"
"65","000","00","020","0019","0784","573","214","359","6","579","1432","0","40.43","14.94"
"65","000","00","020","0019","0785","612","248","364","6","618","1445","0","42.77","17.16"
"65","000","00","020","0020","0000","2793","1283","1510","20","2813","6525","0","43.11","19.66"
"65","000","00","020","0020","0786","604","298","306","8","612","1439","0","42.53","20.71"
"65","000","00","020","0020","0787","705","354","351","2","707","1694","0","41.74","20.90"
"65","000","00","020","0020","0788","726","309","417","5","731","1743","0","41.94","17.73"
"65","000","00","020","0020","0789","758","322","436","5","763","1649","0","46.27","19.53"
"65","000","00","020","0021","0000","1086","557","529","6","1092","2380","0","45.88","23.40"
"65","000","00","020","0021","0790","557","293","264","0","557","1186","0","46.96","24.70"
"65","000","00","020","0021","0791","529","264","265","6","535","1194","0","44.81","22.11"
"65","000","00","020","0022","0000","487","224","263","6","493","1288","0","38.28","17.39"
"65","000","00","020","0022","0792","487","224","263","6","493","1288","0","38.28","17.39"
"65","000","00","020","0023","0000","696","308","388","2","698","1582","0","44.12","19.47"
"65","000","00","020","0023","0793","696","308","388","2","698","1582","0","44.12","19.47"
"65","000","00","020","0024","0000","897","396","501","8","905","1982","0","45.66","19.98"
"65","000","00","020","0024","0794","504","214","290","5","509","1072","0","47.48","19.96"
"65","000","00","020","0024","0795","393","182","211","3","396","910","0","43.52","20.00"
"65","000","00","020","0025","0000","731","354","377","11","742","1664","0","44.59","21.27"
"65","000","00","020","0025","0796","731","354","377","11","742","1664","0","44.59","21.27"
"65","000","00","020","0026","0000","593","272","321","8","601","1261","0","47.66","21.57"
"65","000","00","020","0026","0797","593","272","321","8","601","1261","0","47.66","21.57"
"65","000","00","020","0027","0000","533","240","293","8","541","1289","0","41.97","18.62"
"65","000","00","020","0027","0798","533","240","293","8","541","1289","0","41.97","18.62"
"65","000","00","020","0028","0000","765","342","423","5","770","1819","0","42.33","18.80"
"65","000","00","020","0028","0799","765","342","423","5","770","1819","0","42.33","18.80"
"65","000","00","020","0029","0000","504","236","268","3","507","1130","0","44.87","20.88"
"65","000","00","020","0029","0800","504","236","268","3","507","1130","0","44.87","20.88"
"65","000","00","020","0030","0000","610","294","316","10","620","1363","0","45.49","21.57"
"65","000","00","020","0030","0801","610","294","316","10","620","1363","0","45.49","21.57"
"65","000","00","020","0031","0000","636","328","308","4","640","1483","0","43.16","22.12"
"65","000","00","020","0031","0802","636","328","308","4","640","1483","0","43.16","22.12"
"65","000","00","020","0032","0000","722","309","413","7","729","1785","0","40.84","17.31"
"65","000","00","020","0032","0803","347","150","197","4","351","879","0","39.93","17.06"
"65","000","00","020","0032","0804","375","159","216","3","378","906","0","41.72","17.55"
"65","000","00","020","0033","0000","711","315","396","8","719","1629","0","44.14","19.34"
"65","000","00","020","0033","0805","711","315","396","8","719","1629","0","44.14","19.34"
"65","000","00","020","0034","0000","511","220","291","5","516","1175","0","43.91","18.72"
"65","000","00","020","0034","0806","511","220","291","5","516","1175","0","43.91","18.72"
"65","000","00","020","0035","0000","538","242","296","4","542","1315","0","41.22","18.40"
"65","000","00","020","0035","0807","538","242","296","4","542","1315","0","41.22","18.40"
"65","000","00","020","0036","0000","611","284","327","5","616","1391","0","44.28","20.42"
"65","000","00","020","0036","0808","611","284","327","5","616","1391","0","44.28","20.42"
"65","000","00","020","0037","0000","555","263","292","3","558","1098","0","50.82","23.95"
"65","000","00","020","0037","0809","555","263","292","3","558","1098","0","50.82","23.95"
"65","000","00","020","0038","0000","927","451","476","3","930","2035","0","45.70","22.16"
"65","000","00","020","0038","0810","501","237","264","0","501","1070","0","46.82","22.15"
"65","000","00","020","0038","0811","426","214","212","3","429","965","0","44.46","22.18"
"65","000","00","020","0039","0000","1689","764","925","21","1710","3628","0","47.13","21.06"
"65","000","00","020","0039","0812","873","386","487","8","881","1889","0","46.64","20.43"
"65","000","00","020","0039","0813","816","378","438","13","829","1739","0","47.67","21.74"
"65","000","00","020","0040","0000","604","279","325","8","612","1275","0","48.00","21.88"
"65","000","00","020","0040","0814","604","279","325","8","612","1275","0","48.00","21.88"
"65","000","00","020","0041","0000","1083","479","604","10","1093","2448","0","44.65","19.57"
"65","000","00","020","0041","0815","611","269","342","6","617","1373","0","44.94","19.59"
"65","000","00","020","0041","0816","472","210","262","4","476","1075","0","44.28","19.53"
"65","000","00","020","0042","0000","1006","429","577","5","1011","2453","0","41.21","17.49"
"65","000","00","020","0042","0817","473","206","267","1","474","1172","0","40.44","17.58"
"65","000","00","020","0042","0818","533","223","310","4","537","1281","0","41.92","17.41"
"65","000","00","020","0043","0000","1139","577","562","10","1149","2406","0","47.76","23.98"
"65","000","00","020","0043","0819","536","263","273","8","544","1199","0","45.37","21.93"
"65","000","00","020","0043","0820","603","314","289","2","605","1207","0","50.12","26.01"
"65","000","00","020","0044","0000","1317","600","717","14","1331","3178","0","41.88","18.88"
"65","000","00","020","0044","0821","650","285","365","7","657","1629","0","40.33","17.50"
"65","000","00","020","0044","0822","667","315","352","7","674","1549","0","43.51","20.34"
"65","000","00","020","0045","0000","1647","633","1014","15","1662","3797","0","43.77","16.67"
"65","000","00","020","0045","0823","501","189","312","4","505","1145","0","44.10","16.51"
"65","000","00","020","0045","0824","607","207","400","4","611","1376","0","44.40","15.04"
"65","000","00","020","0045","0825","539","237","302","7","546","1276","0","42.79","18.57"
"65","000","00","020","0046","0000","641","218","423","11","652","1352","0","48.22","16.12"
"65","000","00","020","0046","0826","641","218","423","11","652","1352","0","48.22","16.12"
"65","000","00","020","0047","0000","466","209","257","2","468","1030","0","45.44","20.29"
"65","000","00","020","0047","0827","466","209","257","2","468","1030","0","45.44","20.29"
"65","000","00","020","0048","0000","774","320","454","8","782","1597","0","48.97","20.04"
"65","000","00","020","0048","0828","774","320","454","8","782","1597","0","48.97","20.04"
"65","000","00","020","0049","0000","802","362","440","5","807","1771","0","45.57","20.44"
"65","000","00","020","0049","0829","802","362","440","5","807","1771","0","45.57","20.44"
"65","000","00","020","0050","0000","695","279","416","8","703","1652","0","42.55","16.89"
"65","000","00","020","0050","0830","695","279","416","8","703","1652","0","42.55","16.89"
"65","000","00","020","0051","0000","955","407","548","5","960","2007","0","47.83","20.28"
"65","000","00","020","0051","0831","498","213","285","2","500","1046","0","47.80","20.36"
"65","000","00","020","0051","0832","457","194","263","3","460","961","0","47.87","20.19"
"65","000","00","020","0052","0000","686","267","419","5","691","1674","0","41.28","15.95"
"65","000","00","020","0052","0833","686","267","419","5","691","1674","0","41.28","15.95"
"65","000","00","020","0053","0000","396","203","193","3","399","855","0","46.67","23.74"
"65","000","00","020","0053","0834","396","203","193","3","399","855","0","46.67","23.74"
"65","000","00","020","0054","0000","634","291","343","8","642","1344","0","47.77","21.65"
"65","000","00","020","0054","0835","634","291","343","8","642","1344","0","47.77","21.65"
"65","000","00","020","0055","0000","681","303","378","3","684","1672","0","40.91","18.12"
"65","000","00","020","0055","0836","439","197","242","2","441","1007","0","43.79","19.56"
"65","000","00","020","0055","0837","242","106","136","1","243","665","0","36.54","15.94"
"65","000","00","020","0056","0000","820","339","481","7","827","1939","0","42.65","17.48"
"65","000","00","020","0056","0838","335","137","198","4","339","927","0","36.57","14.78"
"65","000","00","020","0056","0839","485","202","283","3","488","1012","0","48.22","19.96"
"65","000","00","020","0057","0000","886","382","504","6","892","2070","0","43.09","18.45"
"65","000","00","020","0057","0840","475","211","264","3","478","1035","0","46.18","20.39"
"65","000","00","020","0057","0841","411","171","240","3","414","1035","0","40.00","16.52"
"65","000","00","020","0058","0000","348","146","202","5","353","813","0","43.42","17.96"
"65","000","00","020","0058","0842","348","146","202","5","353","813","0","43.42","17.96"
"65","000","00","020","0059","0000","649","300","349","23","672","1385","0","48.52","21.66"
"65","000","00","020","0059","0843","649","300","349","23","672","1385","0","48.52","21.66"
"65","000","00","020","0060","0000","352","172","180","6","358","770","0","46.49","22.34"
"65","000","00","020","0060","0844","352","172","180","6","358","770","0","46.49","22.34"
"65","000","00","020","0061","0000","941","441","500","12","953","2229","0","42.75","19.78"
"65","000","00","020","0061","0845","450","185","265","6","456","1090","0","41.83","16.97"
"65","000","00","020","0061","0846","491","256","235","6","497","1139","0","43.63","22.48"
"65","000","00","020","0062","0000","818","346","472","10","828","1876","0","44.14","18.44"
"65","000","00","020","0062","0847","385","152","233","5","390","897","0","43.48","16.95"
"65","000","00","020","0062","0848","433","194","239","5","438","979","0","44.74","19.82"
"65","000","00","020","0063","0000","844","369","475","12","856","2003","0","42.74","18.42"
"65","000","00","020","0063","0849","498","201","297","6","504","1101","0","45.78","18.26"
"65","000","00","020","0063","0850","346","168","178","6","352","902","0","39.02","18.63"
"65","000","00","020","0064","0000","583","248","335","14","597","1436","0","41.57","17.27"
"65","000","00","020","0064","0851","583","248","335","14","597","1436","0","41.57","17.27"
"65","000","00","020","0065","0000","460","215","245","13","473","1039","0","45.52","20.69"
"65","000","00","020","0065","0852","460","215","245","13","473","1039","0","45.52","20.69"
"65","000","00","020","0066","0000","812","380","432","17","829","1775","0","46.70","21.41"
"65","000","00","020","0066","0853","346","145","201","11","357","850","0","42.00","17.06"
"65","000","00","020","0066","0854","466","235","231","6","472","925","0","51.03","25.41"
"65","000","00","020","0067","0000","800","315","485","13","813","2123","0","38.29","14.84"
"65","000","00","020","0067","0855","392","149","243","8","400","1062","0","37.66","14.03"
"65","000","00","020","0067","0856","408","166","242","5","413","1061","0","38.93","15.65"
"65","000","00","020","0068","0000","1264","544","720","15","1279","2926","0","43.71","18.59"
"65","000","00","020","0068","0857","597","252","345","7","604","1390","0","43.45","18.13"
"65","000","00","020","0068","0858","667","292","375","8","675","1536","0","43.95","19.01"
"65","000","00","020","0069","0000","682","306","376","5","687","1678","0","40.94","18.24"
"65","000","00","020","0069","0859","682","306","376","5","687","1678","0","40.94","18.24"
"65","000","00","020","0070","0000","469","201","268","5","474","1136","0","41.73","17.69"
"65","000","00","020","0070","0860","469","201","268","5","474","1136","0","41.73","17.69"
"65","000","00","020","0071","0000","721","300","421","8","729","1549","0","47.06","19.37"
"65","000","00","020","0071","0861","721","300","421","8","729","1549","0","47.06","19.37"
"65","000","00","020","0072","0000","1004","444","560","7","1011","2410","0","41.95","18.42"
"65","000","00","020","0072","0862","458","227","231","1","459","1160","0","39.57","19.57"
"65","000","00","020","0072","0863","546","217","329","6","552","1250","0","44.16","17.36"
"65","000","00","020","0073","0000","1175","476","699","20","1195","2698","0","44.29","17.64"
"65","000","00","020","0073","0864","568","230","338","13","581","1325","0","43.85","17.36"
"65","000","00","020","0073","0865","607","246","361","7","614","1373","0","44.72","17.92"
"65","000","00","020","0074","0000","720","340","380","6","726","1802","0","40.29","18.87"
"65","000","00","020","0074","0866","720","340","380","6","726","1802","0","40.29","18.87"
"65","000","00","020","0075","0000","815","328","487","3","818","1889","0","43.30","17.36"
"65","000","00","020","0075","0867","418","177","241","2","420","923","0","45.50","19.18"
"65","000","00","020","0075","0868","397","151","246","1","398","966","0","41.20","15.63"
"65","000","00","020","0076","0000","1784","690","1094","11","1795","4172","0","43.02","16.54"
"65","000","00","020","0076","0869","616","246","370","5","621","1498","0","41.46","16.42"
"65","000","00","020","0076","0870","602","210","392","5","607","1418","0","42.81","14.81"
"65","000","00","020","0076","0871","566","234","332","1","567","1256","0","45.14","18.63"
"65","000","00","020","0077","0000","1455","625","830","16","1471","3336","0","44.09","18.74"
"65","000","00","020","0077","0872","694","287","407","5","699","1597","0","43.77","17.97"
"65","000","00","020","0077","0873","761","338","423","11","772","1739","0","44.39","19.44"
"65","000","00","020","0078","0000","2039","812","1227","16","2055","4936","0","41.63","16.45"
"65","000","00","020","0078","0874","461","161","300","3","464","1238","0","37.48","13.00"
"65","000","00","020","0078","0875","529","215","314","6","535","1141","0","46.89","18.84"
"65","000","00","020","0078","0876","526","233","293","5","531","1230","0","43.17","18.94"
"65","000","00","020","0078","0877","523","203","320","2","525","1327","0","39.56","15.30"
"65","000","00","020","0079","0000","891","395","496","11","902","2027","0","44.50","19.49"
"65","000","00","020","0079","0878","480","223","257","7","487","1086","0","44.84","20.53"
"65","000","00","020","0079","0879","411","172","239","4","415","941","0","44.10","18.28"
"65","000","00","020","0080","0000","715","290","425","7","722","1631","0","44.27","17.78"
"65","000","00","020","0080","0880","715","290","425","7","722","1631","0","44.27","17.78"
"65","000","00","020","0081","0000","935","404","531","12","947","2145","0","44.15","18.83"
"65","000","00","020","0081","0881","429","178","251","4","433","1031","0","42.00","17.26"
"65","000","00","020","0081","0882","506","226","280","8","514","1114","0","46.14","20.29"
"65","000","00","020","0082","0000","1543","606","937","11","1554","3509","0","44.29","17.27"
"65","000","00","020","0082","0883","558","218","340","3","561","1208","0","46.44","18.05"
"65","000","00","020","0082","0884","457","194","263","2","459","1013","0","45.31","19.15"
"65","000","00","020","0082","0885","528","194","334","6","534","1288","0","41.46","15.06"
"65","000","00","020","0083","0000","1461","645","816","15","1476","3088","0","47.80","20.89"
"65","000","00","020","0083","0886","707","317","390","4","711","1550","0","45.87","20.45"
"65","000","00","020","0083","0887","754","328","426","11","765","1538","0","49.74","21.33"
"65","000","00","020","0084","0000","1169","479","690","16","1185","2545","0","46.56","18.82"
"65","000","00","020","0084","0888","658","244","414","12","670","1327","0","50.49","18.39"
"65","000","00","020","0084","0889","511","235","276","4","515","1218","0","42.28","19.29"
"65","000","00","020","0085","0000","1131","470","661","5","1136","2674","0","42.48","17.58"
"65","000","00","020","0085","0890","679","277","402","4","683","1583","0","43.15","17.50"
"65","000","00","020","0085","0891","452","193","259","1","453","1091","0","41.52","17.69"
"65","000","00","020","0086","0000","1500","614","886","7","1507","3267","0","46.13","18.79"
"65","000","00","020","0086","0892","743","301","442","4","747","1597","0","46.78","18.85"
"65","000","00","020","0086","0893","757","313","444","3","760","1670","0","45.51","18.74"
"65","000","00","020","0087","0000","1802","704","1098","24","1826","4360","0","41.88","16.15"
"65","000","00","020","0087","0896","610","261","349","11","621","1511","0","41.10","17.27"
"65","000","00","020","0087","0897","536","177","359","4","540","1298","0","41.60","13.64"
"65","000","00","020","0087","0898","656","266","390","9","665","1551","0","42.88","17.15"
"65","000","00","020","0088","0000","1237","475","762","14","1251","2861","0","43.73","16.60"
"65","000","00","020","0088","0904","578","235","343","9","587","1397","0","42.02","16.82"
"65","000","00","020","0088","0905","659","240","419","5","664","1464","0","45.36","16.39"
"65","000","00","020","0089","0000","2044","797","1247","23","2067","4596","0","44.97","17.34"
"65","000","00","020","0089","0913","624","216","408","3","627","1373","0","45.67","15.73"
"65","000","00","020","0089","0914","705","280","425","9","714","1633","0","43.72","17.15"
"65","000","00","020","0089","0915","715","301","414","11","726","1590","0","45.66","18.93"
"65","000","00","020","0090","0000","1900","668","1232","10","1910","4710","0","40.55","14.18"
"65","000","00","020","0090","0916","631","216","415","2","633","1574","0","40.22","13.72"
"65","000","00","020","0090","0917","630","224","406","5","635","1628","0","39.00","13.76"
"65","000","00","020","0090","0918","639","228","411","3","642","1508","0","42.57","15.12"
"65","000","00","020","0091","0000","1516","618","898","11","1527","3553","0","42.98","17.39"
"65","000","00","020","0091","0908","779","330","449","7","786","1917","0","41.00","17.21"
"65","000","00","020","0091","0909","737","288","449","4","741","1636","0","45.29","17.60"
"65","000","00","020","0092","0000","970","357","613","14","984","2263","0","43.48","15.78"
"65","000","00","020","0092","0899","518","219","299","7","525","1157","0","45.38","18.93"
"65","000","00","020","0092","0900","452","138","314","7","459","1106","0","41.50","12.48"
"65","000","00","020","0093","0000","3389","1405","1984","33","3422","7625","0","44.88","18.43"
"65","000","00","020","0093","0922","555","220","335","4","559","1166","0","47.94","18.87"
"65","000","00","020","0093","0923","716","277","439","12","728","1543","0","47.18","17.95"
"65","000","00","020","0093","0924","684","309","375","4","688","1585","0","43.41","19.50"
"65","000","00","020","0093","0925","677","281","396","3","680","1598","0","42.55","17.58"
"65","000","00","020","0093","0926","757","318","439","10","767","1733","0","44.26","18.35"
"65","000","00","020","0094","0000","1625","669","956","9","1634","3940","0","41.47","16.98"
"65","000","00","020","0094","0927","530","199","331","6","536","1289","0","41.58","15.44"
"65","000","00","020","0094","0928","556","231","325","2","558","1371","0","40.70","16.85"
"65","000","00","020","0094","0929","539","239","300","1","540","1280","0","42.19","18.67"
"65","000","00","020","0095","0000","1606","656","950","17","1623","3874","0","41.89","16.93"
"65","000","00","020","0095","0930","532","221","311","3","535","1267","0","42.23","17.44"
"65","000","00","020","0095","0931","562","224","338","6","568","1281","0","44.34","17.49"
"65","000","00","020","0095","0932","512","211","301","8","520","1326","0","39.22","15.91"
"65","000","00","020","0096","0000","1352","552","800","10","1362","3407","0","39.98","16.20"
"65","000","00","020","0096","0933","429","164","265","5","434","1035","0","41.93","15.85"
"65","000","00","020","0096","0934","348","133","215","1","349","986","0","35.40","13.49"
"65","000","00","020","0096","0935","575","255","320","4","579","1386","0","41.77","18.40"
"65","000","00","020","0097","0000","1016","443","573","12","1028","2802","0","36.69","15.81"
"65","000","00","020","0097","0936","523","232","291","9","532","1500","0","35.47","15.47"
"65","000","00","020","0097","0937","493","211","282","3","496","1302","0","38.10","16.21"
"65","000","00","020","0098","0000","862","303","559","7","869","1998","0","43.49","15.17"
"65","000","00","020","0098","0938","356","123","233","5","361","821","0","43.97","14.98"
"65","000","00","020","0098","0939","506","180","326","2","508","1177","0","43.16","15.29"
"65","000","00","020","0099","0000","931","372","559","12","943","2046","0","46.09","18.18"
"65","000","00","020","0099","0940","503","188","315","7","510","1032","0","49.42","18.22"
"65","000","00","020","0099","0941","428","184","244","5","433","1014","0","42.70","18.15"
"65","000","00","020","0100","0000","909","321","588","7","916","2029","0","45.15","15.82"
"65","000","00","020","0100","0942","409","135","274","2","411","933","0","44.05","14.47"
"65","000","00","020","0100","0943","500","186","314","5","505","1096","0","46.08","16.97"
"65","000","00","020","0101","0000","1381","537","844","21","1402","3070","0","45.67","17.49"
"65","000","00","020","0101","0944","625","246","379","10","635","1451","0","43.76","16.95"
"65","000","00","020","0101","0945","756","291","465","11","767","1619","0","47.37","17.97"
"65","000","00","020","0102","0000","931","376","555","6","937","2229","0","42.04","16.87"
"65","000","00","020","0102","0946","436","162","274","2","438","1050","0","41.71","15.43"
"65","000","00","020","0102","0947","495","214","281","4","499","1179","0","42.32","18.15"
"65","000","00","020","0103","0000","1821","726","1095","23","1844","4356","0","42.33","16.67"
"65","000","00","020","0103","0948","525","198","327","8","533","1287","0","41.41","15.38"
"65","000","00","020","0103","0949","633","243","390","8","641","1507","0","42.53","16.12"
"65","000","00","020","0103","0950","663","285","378","7","670","1562","0","42.89","18.25"
"65","000","00","020","0104","0000","1926","756","1170","17","1943","4540","0","42.80","16.65"
"65","000","00","020","0104","0958","558","219","339","4","562","1334","0","42.13","16.42"
"65","000","00","020","0104","0959","651","235","416","5","656","1653","0","39.69","14.22"
"65","000","00","020","0104","0960","717","302","415","8","725","1553","0","46.68","19.45"
"65","000","00","020","0105","0000","2469","1146","1323","15","2484","5713","0","43.48","20.06"
"65","000","00","020","0105","0953","722","292","430","8","730","1790","0","40.78","16.31"
"65","000","00","020","0105","0954","880","402","478","4","884","1886","0","46.87","21.31"
"65","000","00","020","0105","0955","867","452","415","3","870","2037","0","42.71","22.19"
"65","000","00","020","0106","0000","1142","492","650","16","1158","2882","0","40.18","17.07"
"65","000","00","020","0106","0951","549","230","319","4","553","1373","0","40.28","16.75"
"65","000","00","020","0106","0952","593","262","331","12","605","1509","0","40.09","17.36"
"65","000","00","020","0107","0000","683","278","405","3","686","1839","0","37.30","15.12"
"65","000","00","020","0107","0956","315","121","194","3","318","872","0","36.47","13.88"
"65","000","00","020","0107","0957","368","157","211","0","368","967","0","38.06","16.24"
"65","000","00","020","0108","0000","3121","1494","1627","21","3142","7294","0","43.08","20.48"
"65","000","00","020","0108","0961","447","208","239","5","452","1028","0","43.97","20.23"
"65","000","00","020","0108","0962","495","188","307","4","499","1240","0","40.24","15.16"
"65","000","00","020","0108","0963","565","278","287","6","571","1339","0","42.64","20.76"
"65","000","00","020","0108","0964","715","347","368","3","718","1724","0","41.65","20.13"
"65","000","00","020","0108","0965","899","473","426","3","902","1963","0","45.95","24.10"
"65","000","00","020","0109","0000","817","345","472","8","825","1740","0","47.41","19.83"
"65","000","00","020","0109","0740","415","182","233","2","417","936","0","44.55","19.44"
"65","000","00","020","0109","0741","402","163","239","6","408","804","0","50.75","20.27"
"65","000","00","020","0110","0000","1790","758","1032","17","1807","4013","0","45.03","18.89"
"65","000","00","020","0110","0733","625","227","398","3","628","1344","0","46.73","16.89"
"65","000","00","020","0110","0734","657","349","308","9","666","1389","0","47.95","25.13"
"65","000","00","020","0110","0735","508","182","326","5","513","1280","0","40.08","14.22"
"65","000","00","020","0111","0000","1566","716","850","12","1578","3686","0","42.81","19.42"
"65","000","00","020","0111","0753","791","338","453","5","796","1821","0","43.71","18.56"
"65","000","00","020","0111","0754","775","378","397","7","782","1865","0","41.93","20.27"
"65","000","00","020","0112","0000","1037","427","610","6","1043","2539","0","41.08","16.82"
"65","000","00","020","0112","0906","596","266","330","4","600","1332","0","45.05","19.97"
"65","000","00","020","0112","0907","441","161","280","2","443","1207","0","36.70","13.34"
"65","000","00","020","0113","0000","2245","821","1424","18","2263","5046","0","44.85","16.27"
"65","000","00","020","0113","0901","714","279","435","5","719","1748","0","41.13","15.96"
"65","000","00","020","0113","0902","638","240","398","4","642","1520","0","42.24","15.79"
"65","000","00","020","0113","0903","893","302","591","9","902","1778","0","50.73","16.99"
"65","000","00","020","0114","0000","1666","638","1028","10","1676","4437","0","37.77","14.38"
"65","000","00","020","0114","0919","531","201","330","3","534","1355","0","39.41","14.83"
"65","000","00","020","0114","0920","592","241","351","4","596","1620","0","36.79","14.88"
"65","000","00","020","0114","0921","543","196","347","3","546","1462","0","37.35","13.41"
"65","000","00","020","0115","0000","2064","784","1280","21","2085","5061","0","41.20","15.49"
"65","000","00","020","0115","0910","631","245","386","7","638","1589","0","40.15","15.42"
"65","000","00","020","0115","0911","727","288","439","6","733","1744","0","42.03","16.51"
"65","000","00","020","0115","0912","706","251","455","8","714","1728","0","41.32","14.53"
"65","000","00","020","0116","0000","1348","559","789","11","1359","2994","0","45.39","18.67"
"65","000","00","020","0116","0894","620","261","359","2","622","1325","0","46.94","19.70"
"65","000","00","020","0116","0895","728","298","430","9","737","1669","0","44.16","17.86"
"65","000","00","020","0117","0000","1355","505","850","11","1366","3293","0","41.48","15.34"
"65","000","00","020","0117","0966","657","230","427","7","664","1597","0","41.58","14.40"
"65","000","00","020","0117","0967","698","275","423","4","702","1696","0","41.39","16.21"
"65","000","00","020","0118","0000","1685","704","981","18","1703","3764","0","45.24","18.70"
"65","000","00","020","0118","0968","492","167","325","6","498","1063","0","46.85","15.71"
"65","000","00","020","0118","0969","615","256","359","10","625","1337","0","46.75","19.15"
"65","000","00","020","0118","0970","578","281","297","2","580","1364","0","42.52","20.60"
"65","000","00","020","0119","0000","1346","532","814","10","1356","3524","0","38.48","15.10"
"65","000","00","020","0119","0971","328","120","208","1","329","862","0","38.17","13.92"
"65","000","00","020","0119","0972","577","251","326","7","584","1521","0","38.40","16.50"
"65","000","00","020","0119","0973","441","161","280","2","443","1141","0","38.83","14.11"
"65","000","00","030","0000","0000","161842","92566","69276","1554","163396","355238","408654","46.00","26.06"
"65","000","00","030","0001","0000","2690","1384","1306","24","2714","6550","0","41.44","21.13"
"65","000","00","030","0001","1324","741","328","413","7","748","1906","0","39.24","17.21"
"65","000","00","030","0001","1325","679","376","303","7","686","1627","0","42.16","23.11"
"65","000","00","030","0001","1326","506","249","257","2","508","1165","0","43.61","21.37"
"65","000","00","030","0001","1327","764","431","333","8","772","1852","0","41.68","23.27"
"65","000","00","030","0002","0000","3637","1987","1650","29","3666","7974","0","45.97","24.92"
"65","000","00","030","0002","1376","660","291","369","4","664","1660","0","40.00","17.53"
"65","000","00","030","0002","1377","802","393","409","9","811","1796","0","45.16","21.88"
"65","000","00","030","0002","1378","561","319","242","3","564","1304","0","43.25","24.46"
"65","000","00","030","0002","1379","895","550","345","9","904","1889","0","47.86","29.12"
"65","000","00","030","0002","1380","719","434","285","4","723","1325","0","54.57","32.75"
"65","000","00","030","0003","0000","1703","847","856","20","1723","3796","0","45.39","22.31"
"65","000","00","030","0003","1381","559","256","303","7","566","1146","0","49.39","22.34"
"65","000","00","030","0003","1382","526","285","241","3","529","1242","0","42.59","22.95"
"65","000","00","030","0003","1383","618","306","312","10","628","1408","0","44.60","21.73"
"65","000","00","030","0004","0000","1410","745","665","8","1418","3469","0","40.88","21.48"
"65","000","00","030","0004","1384","459","265","194","2","461","1181","0","39.03","22.44"
"65","000","00","030","0004","1385","401","196","205","3","404","1003","0","40.28","19.54"
"65","000","00","030","0004","1386","550","284","266","3","553","1285","0","43.04","22.10"
"65","000","00","030","0005","0000","1354","697","657","13","1367","3452","0","39.60","20.19"
"65","000","00","030","0005","1387","692","360","332","5","697","1732","0","40.24","20.79"
"65","000","00","030","0005","1388","662","337","325","8","670","1720","0","38.95","19.59"
"65","000","00","030","0006","0000","1554","983","571","14","1568","3096","0","50.65","31.75"
"65","000","00","030","0006","1389","457","354","103","4","461","816","0","56.50","43.38"
"65","000","00","030","0006","1390","488","315","173","5","493","959","0","51.41","32.85"
"65","000","00","030","0006","1391","609","314","295","5","614","1321","0","46.48","23.77"
"65","000","00","030","0007","0000","1024","667","357","10","1034","2171","0","47.63","30.72"
"65","000","00","030","0007","1328","477","275","202","7","484","994","0","48.69","27.67"
"65","000","00","030","0007","1329","547","392","155","3","550","1177","0","46.73","33.31"
"65","000","00","030","0008","0000","2717","1654","1063","22","2739","5682","0","48.20","29.11"
"65","000","00","030","0008","1330","795","472","323","9","804","1659","0","48.46","28.45"
"65","000","00","030","0008","1331","580","417","163","6","586","1087","0","53.91","38.36"
"65","000","00","030","0008","1332","753","399","354","4","757","1672","0","45.28","23.86"
"65","000","00","030","0008","1333","589","366","223","3","592","1264","0","46.84","28.96"
"65","000","00","030","0009","0000","2515","1351","1164","28","2543","5265","0","48.30","25.66"
"65","000","00","030","0009","1334","925","530","395","10","935","1894","0","49.37","27.98"
"65","000","00","030","0009","1335","756","387","369","8","764","1629","0","46.90","23.76"
"65","000","00","030","0009","1336","834","434","400","10","844","1742","0","48.45","24.91"
"65","000","00","030","0010","0000","1506","805","701","17","1523","3312","0","45.98","24.31"
"65","000","00","030","0010","1342","821","422","399","6","827","1733","0","47.72","24.35"
"65","000","00","030","0010","1343","685","383","302","11","696","1579","0","44.08","24.26"
"65","000","00","030","0011","0000","1573","870","703","9","1582","3410","0","46.39","25.51"
"65","000","00","030","0011","1344","909","509","400","6","915","1936","0","47.26","26.29"
"65","000","00","030","0011","1345","664","361","303","3","667","1474","0","45.25","24.49"
"65","000","00","030","0012","0000","1796","953","843","14","1810","3887","0","46.57","24.52"
"65","000","00","030","0012","1346","570","282","288","6","576","1234","0","46.68","22.85"
"65","000","00","030","0012","1347","563","322","241","1","564","1224","0","46.08","26.31"
"65","000","00","030","0012","1348","663","349","314","7","670","1429","0","46.89","24.42"
"65","000","00","030","0013","0000","1683","863","820","18","1701","3709","0","45.86","23.27"
"65","000","00","030","0013","1349","841","463","378","10","851","1918","0","44.37","24.14"
"65","000","00","030","0013","1350","842","400","442","8","850","1791","0","47.46","22.33"
"65","000","00","030","0014","0000","1791","956","835","13","1804","3832","0","47.08","24.95"
"65","000","00","030","0014","1351","536","292","244","3","539","1144","0","47.12","25.52"
"65","000","00","030","0014","1352","630","335","295","4","634","1371","0","46.24","24.43"
"65","000","00","030","0014","1353","625","329","296","6","631","1317","0","47.91","24.98"
"65","000","00","030","0015","0000","1878","1024","854","12","1890","3903","0","48.42","26.24"
"65","000","00","030","0015","1354","720","461","259","3","723","1368","0","52.85","33.70"
"65","000","00","030","0015","1355","590","299","291","1","591","1286","0","45.96","23.25"
"65","000","00","030","0015","1356","568","264","304","8","576","1249","0","46.12","21.14"
"65","000","00","030","0016","0000","2126","1110","1016","22","2148","4460","0","48.16","24.89"
"65","000","00","030","0016","1357","639","330","309","6","645","1356","0","47.57","24.34"
"65","000","00","030","0016","1358","589","335","254","3","592","1266","0","46.76","26.46"
"65","000","00","030","0016","1359","898","445","453","13","911","1838","0","49.56","24.21"
"65","000","00","030","0017","0000","2073","1099","974","17","2090","4916","0","42.51","22.36"
"65","000","00","030","0017","1360","691","351","340","8","699","1767","0","39.56","19.86"
"65","000","00","030","0017","1361","711","416","295","6","717","1655","0","43.32","25.14"
"65","000","00","030","0017","1362","671","332","339","3","674","1494","0","45.11","22.22"
"65","000","00","030","0018","0000","1484","809","675","19","1503","3253","0","46.20","24.87"
"65","000","00","030","0018","1363","437","239","198","2","439","974","0","45.07","24.54"
"65","000","00","030","0018","1364","519","261","258","11","530","1123","0","47.20","23.24"
"65","000","00","030","0018","1365","528","309","219","6","534","1156","0","46.19","26.73"
"65","000","00","030","0019","0000","2092","1172","920","27","2119","4420","0","47.94","26.52"
"65","000","00","030","0019","1366","790","456","334","10","800","1761","0","45.43","25.89"
"65","000","00","030","0019","1367","816","432","384","10","826","1554","0","53.15","27.80"
"65","000","00","030","0019","1368","486","284","202","7","493","1105","0","44.62","25.70"
"65","000","00","030","0020","0000","1682","1067","615","17","1699","3265","0","52.04","32.68"
"65","000","00","030","0020","1534","706","427","279","7","713","1463","0","48.74","29.19"
"65","000","00","030","0020","1535","458","296","162","5","463","839","0","55.18","35.28"
"65","000","00","030","0020","1536","518","344","174","5","523","963","0","54.31","35.72"
"65","000","00","030","0021","0000","1408","804","604","9","1417","2767","0","51.21","29.06"
"65","000","00","030","0021","1537","655","353","302","7","662","1337","0","49.51","26.40"
"65","000","00","030","0021","1538","753","451","302","2","755","1430","0","52.80","31.54"
"65","000","00","030","0022","0000","2702","1757","945","27","2729","5289","0","51.60","33.22"
"65","000","00","030","0022","1542","943","623","320","13","956","1844","0","51.84","33.79"
"65","000","00","030","0022","1543","880","559","321","8","888","1796","0","49.44","31.12"
"65","000","00","030","0022","1544","879","575","304","6","885","1649","0","53.67","34.87"
"65","000","00","030","0023","0000","2086","1346","740","12","2098","3903","0","53.75","34.49"
"65","000","00","030","0023","1545","707","449","258","6","713","1335","0","53.41","33.63"
"65","000","00","030","0023","1546","627","428","199","4","631","1230","0","51.30","34.80"
"65","000","00","030","0023","1547","752","469","283","2","754","1338","0","56.35","35.05"
"65","000","00","030","0024","0000","1461","834","627","26","1487","3171","0","46.89","26.30"
"65","000","00","030","0024","1548","567","320","247","12","579","1159","0","49.96","27.61"
"65","000","00","030","0024","1549","329","213","116","4","333","811","0","41.06","26.26"
"65","000","00","030","0024","1550","565","301","264","10","575","1201","0","47.88","25.06"
"65","000","00","030","0025","0000","3308","1953","1355","24","3332","7115","0","46.83","27.45"
"65","000","00","030","0025","1369","834","495","339","2","836","1768","0","47.29","28.00"
"65","000","00","030","0025","1370","899","506","393","8","907","1899","0","47.76","26.65"
"65","000","00","030","0025","1371","732","445","287","9","741","1633","0","45.38","27.25"
"65","000","00","030","0025","1372","843","507","336","5","848","1815","0","46.72","27.93"
"65","000","00","030","0026","0000","2154","1258","896","17","2171","4499","0","48.26","27.96"
"65","000","00","030","0026","1373","699","400","299","5","704","1494","0","47.12","26.77"
"65","000","00","030","0026","1374","540","298","242","1","541","1184","0","45.69","25.17"
"65","000","00","030","0026","1375","915","560","355","11","926","1821","0","50.85","30.75"
"65","000","00","030","0027","0000","1860","1120","740","13","1873","4018","0","46.62","27.87"
"65","000","00","030","0027","1551","608","377","231","4","612","1308","0","46.79","28.82"
"65","000","00","030","0027","1552","586","329","257","4","590","1346","0","43.83","24.44"
"65","000","00","030","0027","1553","666","414","252","5","671","1364","0","49.19","30.35"
"65","000","00","030","0028","0000","1441","852","589","10","1451","3062","0","47.39","27.82"
"65","000","00","030","0028","1554","701","393","308","6","707","1456","0","48.56","26.99"
"65","000","00","030","0028","1555","740","459","281","4","744","1606","0","46.33","28.58"
"65","000","00","030","0029","0000","2071","1228","843","13","2084","4298","0","48.49","28.57"
"65","000","00","030","0029","1558","688","399","289","4","692","1501","0","46.10","26.58"
"65","000","00","030","0029","1559","612","370","242","1","613","1280","0","47.89","28.91"
"65","000","00","030","0029","1560","771","459","312","8","779","1517","0","51.35","30.26"
"65","000","00","030","0030","0000","2775","1771","1004","23","2798","5620","0","49.79","31.51"
"65","000","00","030","0030","1561","848","553","295","8","856","1667","0","51.35","33.17"
"65","000","00","030","0030","1562","872","561","311","4","876","1914","0","45.77","29.31"
"65","000","00","030","0030","1563","422","248","174","6","428","887","0","48.25","27.96"
"65","000","00","030","0030","1564","633","409","224","5","638","1152","0","55.38","35.50"
"65","000","00","030","0031","0000","2116","1450","666","27","2143","4436","0","48.31","32.69"
"65","000","00","030","0031","1565","747","528","219","5","752","1473","0","51.05","35.85"
"65","000","00","030","0031","1566","690","488","202","10","700","1543","0","45.37","31.63"
"65","000","00","030","0031","1567","679","434","245","12","691","1420","0","48.66","30.56"
"65","000","00","030","0032","0000","2030","1293","737","22","2052","4318","0","47.52","29.94"
"65","000","00","030","0032","1568","534","361","173","10","544","1116","0","48.75","32.35"
"65","000","00","030","0032","1569","782","474","308","11","793","1668","0","47.54","28.42"
"65","000","00","030","0032","1570","714","458","256","1","715","1534","0","46.61","29.86"
"65","000","00","030","0033","0000","1302","796","506","15","1317","2931","0","44.93","27.16"
"65","000","00","030","0033","1576","641","377","264","9","650","1467","0","44.31","25.70"
"65","000","00","030","0033","1577","661","419","242","6","667","1464","0","45.56","28.62"
"65","000","00","030","0034","0000","1251","820","431","12","1263","2614","0","48.32","31.37"
"65","000","00","030","0034","1399","557","371","186","4","561","1215","0","46.17","30.53"
"65","000","00","030","0034","1400","694","449","245","8","702","1399","0","50.18","32.09"
"65","000","00","030","0035","0000","2727","1755","972","32","2759","6686","0","41.27","26.25"
"65","000","00","030","0035","1401","574","388","186","5","579","1448","0","39.99","26.80"
"65","000","00","030","0035","1402","673","450","223","5","678","1563","0","43.38","28.79"
"65","000","00","030","0035","1403","838","517","321","13","851","1947","0","43.71","26.55"
"65","000","00","030","0035","1404","642","400","242","9","651","1728","0","37.67","23.15"
"65","000","00","030","0036","0000","1792","1350","442","21","1813","3818","0","47.49","35.36"
"65","000","00","030","0036","1405","545","443","102","8","553","1132","0","48.85","39.13"
"65","000","00","030","0036","1406","565","371","194","7","572","1346","0","42.50","27.56"
"65","000","00","030","0036","1407","682","536","146","6","688","1340","0","51.34","40.00"
"65","000","00","030","0037","0000","2009","1302","707","14","2023","4482","0","45.14","29.05"
"65","000","00","030","0037","1408","693","455","238","5","698","1589","0","43.93","28.63"
"65","000","00","030","0037","1409","705","482","223","4","709","1540","0","46.04","31.30"
"65","000","00","030","0037","1410","611","365","246","5","616","1353","0","45.53","26.98"
"65","000","00","030","0038","0000","1711","1113","598","19","1730","4171","0","41.48","26.68"
"65","000","00","030","0038","1411","668","427","241","6","674","1583","0","42.58","26.97"
"65","000","00","030","0038","1412","472","305","167","8","480","1235","0","38.87","24.70"
"65","000","00","030","0038","1413","571","381","190","5","576","1353","0","42.57","28.16"
"65","000","00","030","0039","0000","1905","1253","652","29","1934","3856","0","50.16","32.49"
"65","000","00","030","0039","1414","692","442","250","11","703","1374","0","51.16","32.17"
"65","000","00","030","0039","1415","634","412","222","11","645","1307","0","49.35","31.52"
"65","000","00","030","0039","1416","579","399","180","7","586","1175","0","49.87","33.96"
"65","000","00","030","0040","0000","1240","773","467","18","1258","2778","0","45.28","27.83"
"65","000","00","030","0040","1419","584","371","213","9","593","1303","0","45.51","28.47"
"65","000","00","030","0040","1420","656","402","254","9","665","1475","0","45.08","27.25"
"65","000","00","030","0041","0000","142","63","79","0","142","310","0","45.81","20.32"
"65","000","00","030","0041","1423","142","63","79","0","142","310","0","45.81","20.32"
"65","000","00","030","0042","0000","1893","1155","738","23","1916","4421","0","43.34","26.13"
"65","000","00","030","0042","1424","588","362","226","7","595","1407","0","42.29","25.73"
"65","000","00","030","0042","1425","666","412","254","4","670","1499","0","44.70","27.48"
"65","000","00","030","0042","1426","639","381","258","12","651","1515","0","42.97","25.15"
"65","000","00","030","0043","0000","961","548","413","14","975","2183","0","44.66","25.10"
"65","000","00","030","0043","1427","646","379","267","7","653","1416","0","46.12","26.77"
"65","000","00","030","0043","1428","315","169","146","7","322","767","0","41.98","22.03"
"65","000","00","030","0044","0000","1622","897","725","10","1632","6944","0","23.50","12.92"
"65","000","00","030","0044","1432","602","333","269","5","607","4669","0","13.00","7.13"
"65","000","00","030","0044","1433","487","259","228","1","488","1164","0","41.92","22.25"
"65","000","00","030","0044","1434","533","305","228","4","537","1111","0","48.33","27.45"
"65","000","00","030","0045","0000","2069","1218","851","22","2091","4423","0","47.28","27.54"
"65","000","00","030","0045","1441","782","529","253","6","788","1561","0","50.48","33.89"
"65","000","00","030","0045","1442","692","353","339","9","701","1526","0","45.94","23.13"
"65","000","00","030","0045","1443","595","336","259","7","602","1336","0","45.06","25.15"
"65","000","00","030","0046","0000","1905","1131","774","18","1923","3949","0","48.70","28.64"
"65","000","00","030","0046","1444","539","331","208","7","546","1030","0","53.01","32.14"
"65","000","00","030","0046","1445","782","425","357","8","790","1704","0","46.36","24.94"
"65","000","00","030","0046","1446","584","375","209","3","587","1215","0","48.31","30.86"
"65","000","00","030","0047","0000","2386","1493","893","21","2407","4885","0","49.27","30.56"
"65","000","00","030","0047","1447","557","341","216","5","562","1167","0","48.16","29.22"
"65","000","00","030","0047","1448","827","540","287","6","833","1779","0","46.82","30.35"
"65","000","00","030","0047","1449","555","342","213","4","559","959","0","58.29","35.66"
"65","000","00","030","0047","1450","447","270","177","6","453","980","0","46.22","27.55"
"65","000","00","030","0048","0000","1540","908","632","18","1558","3210","0","48.54","28.29"
"65","000","00","030","0048","1451","750","439","311","11","761","1579","0","48.20","27.80"
"65","000","00","030","0048","1452","790","469","321","7","797","1631","0","48.87","28.76"
"65","000","00","030","0049","0000","2374","1461","913","29","2403","5145","0","46.71","28.40"
"65","000","00","030","0049","1453","885","572","313","9","894","1905","0","46.93","30.03"
"65","000","00","030","0049","1454","730","447","283","10","740","1566","0","47.25","28.54"
"65","000","00","030","0049","1455","759","442","317","10","769","1674","0","45.94","26.40"
"65","000","00","030","0050","0000","2195","1333","862","25","2220","4350","0","51.03","30.64"
"65","000","00","030","0050","1456","443","269","174","6","449","898","0","50.00","29.96"
"65","000","00","030","0050","1457","634","430","204","5","639","1199","0","53.29","35.86"
"65","000","00","030","0050","1458","639","354","285","8","647","1298","0","49.85","27.27"
"65","000","00","030","0050","1459","479","280","199","6","485","955","0","50.79","29.32"
"65","000","00","030","0051","0000","1615","978","637","18","1633","3381","0","48.30","28.93"
"65","000","00","030","0051","1460","938","564","374","7","945","1932","0","48.91","29.19"
"65","000","00","030","0051","1461","677","414","263","11","688","1449","0","47.48","28.57"
"65","000","00","030","0052","0000","2112","1162","950","21","2133","4740","0","45.00","24.51"
"65","000","00","030","0052","1462","721","364","357","6","727","1540","0","47.21","23.64"
"65","000","00","030","0052","1463","627","367","260","7","634","1506","0","42.10","24.37"
"65","000","00","030","0052","1464","764","431","333","8","772","1694","0","45.57","25.44"
"65","000","00","030","0053","0000","947","576","371","11","958","1986","0","48.24","29.00"
"65","000","00","030","0053","1465","467","292","175","9","476","995","0","47.84","29.35"
"65","000","00","030","0053","1466","480","284","196","2","482","991","0","48.64","28.66"
"65","000","00","030","0054","0000","279","121","158","2","281","699","0","40.20","17.31"
"65","000","00","030","0054","1467","279","121","158","2","281","699","0","40.20","17.31"
"65","000","00","030","0055","0000","3452","1855","1597","24","3476","7243","0","47.99","25.61"
"65","000","00","030","0055","1468","641","284","357","4","645","1509","0","42.74","18.82"
"65","000","00","030","0055","1469","551","298","253","4","555","1168","0","47.52","25.51"
"65","000","00","030","0055","1470","572","356","216","4","576","1214","0","47.45","29.32"
"65","000","00","030","0055","1471","535","314","221","2","537","1077","0","49.86","29.16"
"65","000","00","030","0055","1472","319","164","155","2","321","626","0","51.28","26.20"
"65","000","00","030","0055","1473","834","439","395","8","842","1649","0","51.06","26.62"
"65","000","00","030","0056","0000","1084","476","608","4","1088","2221","0","48.99","21.43"
"65","000","00","030","0056","1474","524","230","294","2","526","1072","0","49.07","21.46"
"65","000","00","030","0056","1475","560","246","314","2","562","1149","0","48.91","21.41"
"65","000","00","030","0057","0000","2422","1204","1218","32","2454","5500","0","44.62","21.89"
"65","000","00","030","0057","1476","593","282","311","4","597","1288","0","46.35","21.89"
"65","000","00","030","0057","1477","682","306","376","14","696","1586","0","43.88","19.29"
"65","000","00","030","0057","1478","640","330","310","7","647","1446","0","44.74","22.82"
"65","000","00","030","0057","1479","507","286","221","7","514","1180","0","43.56","24.24"
"65","000","00","030","0058","0000","1107","543","564","14","1121","2534","0","44.24","21.43"
"65","000","00","030","0058","1480","642","332","310","7","649","1501","0","43.24","22.12"
"65","000","00","030","0058","1481","465","211","254","7","472","1033","0","45.69","20.43"
"65","000","00","030","0059","0000","2041","977","1064","19","2060","4552","0","45.25","21.46"
"65","000","00","030","0059","1482","628","307","321","3","631","1472","0","42.87","20.86"
"65","000","00","030","0059","1483","672","289","383","7","679","1531","0","44.35","18.88"
"65","000","00","030","0059","1484","741","381","360","9","750","1549","0","48.42","24.60"
"65","000","00","030","0060","0000","1474","740","734","13","1487","3544","0","41.96","20.88"
"65","000","00","030","0060","1485","698","357","341","5","703","1717","0","40.94","20.79"
"65","000","00","030","0060","1486","776","383","393","8","784","1827","0","42.91","20.96"
"65","000","00","030","0061","0000","1974","994","980","15","1989","4463","0","44.57","22.27"
"65","000","00","030","0061","1487","644","311","333","5","649","1392","0","46.62","22.34"
"65","000","00","030","0061","1488","674","347","327","6","680","1478","0","46.01","23.48"
"65","000","00","030","0061","1489","656","336","320","4","660","1593","0","41.43","21.09"
"65","000","00","030","0062","0000","1710","826","884","9","1719","4026","0","42.70","20.52"
"65","000","00","030","0062","1490","559","258","301","5","564","1213","0","46.50","21.27"
"65","000","00","030","0062","1491","607","324","283","4","611","1502","0","40.68","21.57"
"65","000","00","030","0062","1492","544","244","300","0","544","1311","0","41.50","18.61"
"65","000","00","030","0063","0000","977","557","420","11","988","2090","0","47.27","26.65"
"65","000","00","030","0063","1493","508","252","256","4","512","1121","0","45.67","22.48"
"65","000","00","030","0063","1494","469","305","164","7","476","969","0","49.12","31.48"
"65","000","00","030","0064","0000","1828","864","964","14","1842","3932","0","46.85","21.97"
"65","000","00","030","0064","1495","617","279","338","3","620","1246","0","49.76","22.39"
"65","000","00","030","0064","1496","586","297","289","6","592","1309","0","45.23","22.69"
"65","000","00","030","0064","1497","625","288","337","5","630","1377","0","45.75","20.92"
"65","000","00","030","0065","0000","1306","645","661","8","1314","2811","0","46.74","22.95"
"65","000","00","030","0065","1498","623","298","325","3","626","1324","0","47.28","22.51"
"65","000","00","030","0065","1499","683","347","336","5","688","1487","0","46.27","23.34"
"65","000","00","030","0066","0000","1857","869","988","15","1872","4374","0","42.80","19.87"
"65","000","00","030","0066","1500","631","312","319","7","638","1485","0","42.96","21.01"
"65","000","00","030","0066","1501","631","266","365","6","637","1525","0","41.77","17.44"
"65","000","00","030","0066","1502","595","291","304","2","597","1364","0","43.77","21.33"
"65","000","00","030","0067","0000","1823","946","877","19","1842","4038","0","45.62","23.43"
"65","000","00","030","0067","1503","628","309","319","5","633","1378","0","45.94","22.42"
"65","000","00","030","0067","1504","591","275","316","7","598","1441","0","41.50","19.08"
"65","000","00","030","0067","1505","604","362","242","7","611","1219","0","50.12","29.70"
"65","000","00","030","0068","0000","1750","900","850","24","1774","3746","0","47.36","24.03"
"65","000","00","030","0068","1506","831","439","392","13","844","1768","0","47.74","24.83"
"65","000","00","030","0068","1507","545","253","292","4","549","1137","0","48.28","22.25"
"65","000","00","030","0068","1508","374","208","166","7","381","841","0","45.30","24.73"
"65","000","00","030","0069","0000","1593","852","741","15","1608","3413","0","47.11","24.96"
"65","000","00","030","0069","1509","699","364","335","7","706","1505","0","46.91","24.19"
"65","000","00","030","0069","1510","894","488","406","8","902","1908","0","47.27","25.58"
"65","000","00","030","0070","0000","1952","1315","637","22","1974","3950","0","49.97","33.29"
"65","000","00","030","0070","1511","650","426","224","7","657","1394","0","47.13","30.56"
"65","000","00","030","0070","1512","556","308","248","9","565","1177","0","48.00","26.17"
"65","000","00","030","0070","1513","746","581","165","6","752","1379","0","54.53","42.13"
"65","000","00","030","0071","0000","1431","666","765","19","1450","3434","0","42.22","19.39"
"65","000","00","030","0071","1514","459","192","267","9","468","1043","0","44.87","18.41"
"65","000","00","030","0071","1515","463","207","256","5","468","1185","0","39.49","17.47"
"65","000","00","030","0071","1516","509","267","242","5","514","1206","0","42.62","22.14"
"65","000","00","030","0072","0000","1470","948","522","12","1482","3329","0","44.52","28.48"
"65","000","00","030","0072","1573","493","304","189","6","499","1122","0","44.47","27.09"
"65","000","00","030","0072","1574","491","313","178","5","496","1152","0","43.06","27.17"
"65","000","00","030","0072","1575","486","331","155","1","487","1055","0","46.16","31.37"
"65","000","00","030","0073","0000","2819","1621","1198","23","2842","5696","0","49.89","28.46"
"65","000","00","030","0073","1339","972","609","363","9","981","1975","0","49.67","30.84"
"65","000","00","030","0073","1340","860","473","387","7","867","1730","0","50.12","27.34"
"65","000","00","030","0073","1341","987","539","448","7","994","1991","0","49.92","27.07"
"65","000","00","030","0074","0000","863","558","305","13","876","1721","0","50.90","32.42"
"65","000","00","030","0074","1533","863","558","305","13","876","1721","0","50.90","32.42"
"65","000","00","030","0075","0000","1984","1236","748","25","2009","3886","0","51.70","31.81"
"65","000","00","030","0075","1539","570","365","205","5","575","1086","0","52.95","33.61"
"65","000","00","030","0075","1540","745","441","304","11","756","1443","0","52.39","30.56"
"65","000","00","030","0075","1541","669","430","239","9","678","1357","0","49.96","31.69"
"65","000","00","030","0076","0000","1195","664","531","10","1205","2405","0","50.10","27.61"
"65","000","00","030","0076","1556","646","341","305","8","654","1325","0","49.36","25.74"
"65","000","00","030","0076","1557","549","323","226","2","551","1080","0","51.02","29.91"
"65","000","00","030","0077","0000","1007","651","356","12","1019","2226","0","45.78","29.25"
"65","000","00","030","0077","1571","447","326","121","5","452","1062","0","42.56","30.70"
"65","000","00","030","0077","1572","560","325","235","7","567","1164","0","48.71","27.92"
"65","000","00","030","0078","0000","1248","776","472","21","1269","2756","0","46.04","28.16"
"65","000","00","030","0078","1417","625","359","266","12","637","1417","0","44.95","25.34"
"65","000","00","030","0078","1418","623","417","206","9","632","1339","0","47.20","31.14"
"65","000","00","030","0079","0000","941","565","376","6","947","1883","0","50.29","30.01"
"65","000","00","030","0079","1421","422","254","168","2","424","859","0","49.36","29.57"
"65","000","00","030","0079","1422","519","311","208","4","523","1024","0","51.07","30.37"
"65","000","00","030","0080","0000","1673","1096","577","18","1691","3773","0","44.82","29.05"
"65","000","00","030","0080","1429","628","398","230","4","632","1367","0","46.23","29.11"
"65","000","00","030","0080","1430","586","391","195","8","594","1399","0","42.46","27.95"
"65","000","00","030","0080","1431","459","307","152","6","465","1007","0","46.18","30.49"
"65","000","00","030","0081","0000","2657","1593","1064","12","2669","5825","0","45.82","27.35"
"65","000","00","030","0081","1435","660","384","276","3","663","1461","0","45.38","26.28"
"65","000","00","030","0081","1436","675","437","238","5","680","1506","0","45.15","29.02"
"65","000","00","030","0081","1437","628","357","271","1","629","1436","0","43.80","24.86"
"65","000","00","030","0081","1438","694","415","279","3","697","1422","0","49.02","29.18"
"65","000","00","030","0082","0000","1187","750","437","11","1198","2623","0","45.67","28.59"
"65","000","00","030","0082","1439","632","406","226","9","641","1345","0","47.66","30.19"
"65","000","00","030","0082","1440","555","344","211","2","557","1278","0","43.58","26.92"
"65","000","00","030","0083","0000","998","495","503","10","1008","2395","0","42.09","20.67"
"65","000","00","030","0083","1392","441","203","238","8","449","1007","0","44.59","20.16"
"65","000","00","030","0083","1393","557","292","265","2","559","1388","0","40.27","21.04"
"65","000","00","030","0084","0000","2044","1081","963","17","2061","4326","0","47.64","24.99"
"65","000","00","030","0084","1394","659","341","318","4","663","1428","0","46.43","23.88"
"65","000","00","030","0084","1395","619","272","347","4","623","1216","0","51.23","22.37"
"65","000","00","030","0084","1396","766","468","298","9","775","1682","0","46.08","27.82"
"65","000","00","030","0085","0000","1559","829","730","11","1570","3643","0","43.10","22.76"
"65","000","00","030","0085","1517","557","318","239","6","563","1304","0","43.17","24.39"
"65","000","00","030","0085","1518","424","203","221","1","425","1032","0","41.18","19.67"
"65","000","00","030","0085","1519","578","308","270","4","582","1307","0","44.53","23.57"
"65","000","00","030","0086","0000","1486","708","778","17","1503","3432","0","43.79","20.63"
"65","000","00","030","0086","1520","756","346","410","8","764","1751","0","43.63","19.76"
"65","000","00","030","0086","1521","730","362","368","9","739","1681","0","43.96","21.53"
"65","000","00","030","0087","0000","1174","617","557","10","1184","2486","0","47.63","24.82"
"65","000","00","030","0087","1522","573","296","277","3","576","1178","0","48.90","25.13"
"65","000","00","030","0087","1523","601","321","280","7","608","1308","0","46.48","24.54"
"65","000","00","030","0088","0000","1354","667","687","17","1371","3236","0","42.37","20.61"
"65","000","00","030","0088","1524","626","304","322","6","632","1443","0","43.80","21.07"
"65","000","00","030","0088","1525","728","363","365","11","739","1793","0","41.22","20.25"
"65","000","00","030","0089","0000","1506","735","771","11","1517","3862","0","39.28","19.03"
"65","000","00","030","0089","1526","440","213","227","1","441","1199","0","36.78","17.76"
"65","000","00","030","0089","1527","527","254","273","7","534","1339","0","39.88","18.97"
"65","000","00","030","0089","1528","539","268","271","3","542","1324","0","40.94","20.24"
"65","000","00","030","0090","0000","1455","698","757","14","1469","2946","0","49.86","23.69"
"65","000","00","030","0090","1529","741","325","416","7","748","1578","0","47.40","20.60"
"65","000","00","030","0090","1530","714","373","341","7","721","1368","0","52.70","27.27"
"65","000","00","030","0091","0000","1311","636","675","18","1329","2987","0","44.49","21.29"
"65","000","00","030","0091","1531","541","252","289","8","549","1233","0","44.53","20.44"
"65","000","00","030","0091","1532","770","384","386","10","780","1754","0","44.47","21.89"
"65","000","00","030","0092","0000","1281","838","443","17","1298","3087","0","42.05","27.15"
"65","000","00","030","0092","1397","669","442","227","6","675","1642","0","41.11","26.92"
"65","000","00","030","0092","1398","612","396","216","11","623","1445","0","43.11","27.40"
"65","000","00","030","0093","0000","1172","660","512","4","1176","2564","0","45.87","25.74"
"65","000","00","030","0093","1337","552","279","273","3","555","1190","0","46.64","23.45"
"65","000","00","030","0093","1338","620","381","239","1","621","1374","0","45.20","27.73"
"65","000","00","040","0000","0000","89006","54230","34776","776","89782","186020","217795","48.26","29.15"
"65","000","00","040","0001","0000","1366","812","554","13","1379","2917","0","47.27","27.84"
"65","000","00","040","0001","1588","695","391","304","9","704","1488","0","47.31","26.28"
"65","000","00","040","0001","1589","671","421","250","4","675","1429","0","47.24","29.46"
"65","000","00","040","0002","0000","1184","739","445","16","1200","2476","0","48.47","29.85"
"65","000","00","040","0002","1706","579","354","225","3","582","1187","0","49.03","29.82"
"65","000","00","040","0002","1707","605","385","220","13","618","1289","0","47.94","29.87"
"65","000","00","040","0003","0000","1554","981","573","21","1575","4502","0","34.98","21.79"
"65","000","00","040","0003","1597","768","500","268","13","781","1554","0","50.26","32.18"
"65","000","00","040","0003","1598","786","481","305","8","794","2948","0","26.93","16.32"
"65","000","00","040","0004","0000","1338","845","493","13","1351","2581","0","52.34","32.74"
"65","000","00","040","0004","1599","602","380","222","4","606","1196","0","50.67","31.77"
"65","000","00","040","0004","1600","736","465","271","9","745","1385","0","53.79","33.57"
"65","000","00","040","0005","0000","1229","723","506","11","1240","2419","0","51.26","29.89"
"65","000","00","040","0005","1704","630","374","256","5","635","1192","0","53.27","31.38"
"65","000","00","040","0005","1705","599","349","250","6","605","1227","0","49.31","28.44"
"65","000","00","040","0006","0000","1473","879","594","13","1486","2938","0","50.58","29.92"
"65","000","00","040","0006","1607","777","462","315","5","782","1501","0","52.10","30.78"
"65","000","00","040","0006","1608","696","417","279","8","704","1437","0","48.99","29.02"
"65","000","00","040","0007","0000","1241","747","494","8","1249","2396","0","52.13","31.18"
"65","000","00","040","0007","1609","654","406","248","2","656","1231","0","53.29","32.98"
"65","000","00","040","0007","1610","587","341","246","6","593","1165","0","50.90","29.27"
"65","000","00","040","0008","0000","1065","679","386","8","1073","2525","0","42.50","26.89"
"65","000","00","040","0008","1645","529","349","180","4","533","1230","0","43.33","28.37"
"65","000","00","040","0008","1646","536","330","206","4","540","1295","0","41.70","25.48"
"65","000","00","040","0009","0000","409","329","80","7","416","876","0","47.49","37.56"
"65","000","00","040","0009","1702","409","329","80","7","416","876","0","47.49","37.56"
"65","000","00","040","0010","0000","347","282","65","5","352","704","0","50.00","40.06"
"65","000","00","040","0010","1703","347","282","65","5","352","704","0","50.00","40.06"
"65","000","00","040","0011","0000","1978","1188","790","20","1998","4085","0","48.91","29.08"
"65","000","00","040","0011","1616","730","439","291","9","739","1460","0","50.62","30.07"
"65","000","00","040","0011","1617","640","399","241","5","645","1244","0","51.85","32.07"
"65","000","00","040","0011","1618","608","350","258","6","614","1381","0","44.46","25.34"
"65","000","00","040","0012","0000","1714","926","788","8","1722","3437","0","50.10","26.94"
"65","000","00","040","0012","1629","864","444","420","3","867","1708","0","50.76","26.00"
"65","000","00","040","0012","1630","850","482","368","5","855","1729","0","49.45","27.88"
"65","000","00","040","0013","0000","3051","1750","1301","27","3078","6137","0","50.15","28.52"
"65","000","00","040","0013","1686","745","364","381","6","751","1585","0","47.38","22.97"
"65","000","00","040","0013","1687","778","468","310","7","785","1539","0","51.01","30.41"
"65","000","00","040","0013","1688","791","471","320","3","794","1494","0","53.15","31.53"
"65","000","00","040","0013","1689","737","447","290","11","748","1519","0","49.24","29.43"
"65","000","00","040","0014","0000","2120","1180","940","19","2139","4473","0","47.82","26.38"
"65","000","00","040","0014","1683","745","422","323","5","750","1518","0","49.41","27.80"
"65","000","00","040","0014","1684","697","402","295","11","708","1477","0","47.94","27.22"
"65","000","00","040","0014","1685","678","356","322","3","681","1478","0","46.08","24.09"
"65","000","00","040","0015","0000","1874","1157","717","13","1887","3634","0","51.93","31.84"
"65","000","00","040","0015","1661","639","384","255","6","645","1213","0","53.17","31.66"
"65","000","00","040","0015","1662","547","337","210","2","549","1102","0","49.82","30.58"
"65","000","00","040","0015","1663","688","436","252","5","693","1319","0","52.54","33.06"
"65","000","00","040","0016","0000","1944","1208","736","10","1954","3986","0","49.02","30.31"
"65","000","00","040","0016","1622","633","410","223","4","637","1279","0","49.80","32.06"
"65","000","00","040","0016","1623","660","393","267","6","666","1308","0","50.92","30.05"
"65","000","00","040","0016","1624","651","405","246","0","651","1399","0","46.53","28.95"
"65","000","00","040","0017","0000","1837","1112","725","14","1851","3852","0","48.05","28.87"
"65","000","00","040","0017","1619","647","402","245","7","654","1325","0","49.36","30.34"
"65","000","00","040","0017","1620","711","446","265","4","715","1462","0","48.91","30.51"
"65","000","00","040","0017","1621","479","264","215","3","482","1065","0","45.26","24.79"
"65","000","00","040","0018","0000","1315","794","521","9","1324","2760","0","47.97","28.77"
"65","000","00","040","0018","1591","604","363","241","3","607","1248","0","48.64","29.09"
"65","000","00","040","0018","1592","711","431","280","6","717","1512","0","47.42","28.51"
"65","000","00","040","0019","0000","493","239","254","2","495","1091","0","45.37","21.91"
"65","000","00","040","0019","1590","493","239","254","2","495","1091","0","45.37","21.91"
"65","000","00","040","0020","0000","1523","879","644","11","1534","3358","0","45.68","26.18"
"65","000","00","040","0020","1625","764","475","289","6","770","1653","0","46.58","28.74"
"65","000","00","040","0020","1626","759","404","355","5","764","1705","0","44.81","23.70"
"65","000","00","040","0021","0000","1199","683","516","9","1208","2545","0","47.47","26.84"
"65","000","00","040","0021","1627","590","325","265","4","594","1259","0","47.18","25.81"
"65","000","00","040","0021","1628","609","358","251","5","614","1286","0","47.74","27.84"
"65","000","00","040","0022","0000","782","457","325","6","788","1702","0","46.30","26.85"
"65","000","00","040","0022","1712","373","232","141","3","376","855","0","43.98","27.13"
"65","000","00","040","0022","1713","409","225","184","3","412","847","0","48.64","26.56"
"65","000","00","040","0023","0000","1501","972","529","12","1513","3222","0","46.96","30.17"
"65","000","00","040","0023","1582","785","510","275","4","789","1691","0","46.66","30.16"
"65","000","00","040","0023","1583","716","462","254","8","724","1531","0","47.29","30.18"
"65","000","00","040","0024","0000","1764","1082","682","15","1779","3413","0","52.12","31.70"
"65","000","00","040","0024","1671","901","576","325","6","907","1726","0","52.55","33.37"
"65","000","00","040","0024","1672","863","506","357","9","872","1687","0","51.69","29.99"
"65","000","00","040","0025","0000","1649","1026","623","18","1667","3354","0","49.70","30.59"
"65","000","00","040","0025","1673","562","331","231","3","565","1124","0","50.27","29.45"
"65","000","00","040","0025","1674","543","340","203","11","554","1124","0","49.29","30.25"
"65","000","00","040","0025","1675","544","355","189","4","548","1106","0","49.55","32.10"
"65","000","00","040","0026","0000","1791","1086","705","13","1804","3469","0","52.00","31.31"
"65","000","00","040","0026","1666","615","399","216","5","620","1158","0","53.54","34.46"
"65","000","00","040","0026","1667","546","345","201","3","549","1137","0","48.28","30.34"
"65","000","00","040","0026","1668","630","342","288","5","635","1174","0","54.09","29.13"
"65","000","00","040","0027","0000","1275","738","537","7","1282","2623","0","48.88","28.14"
"65","000","00","040","0027","1669","614","339","275","3","617","1297","0","47.57","26.14"
"65","000","00","040","0027","1670","661","399","262","4","665","1326","0","50.15","30.09"
"65","000","00","040","0028","0000","1381","871","510","12","1393","2995","0","46.51","29.08"
"65","000","00","040","0028","1716","756","483","273","9","765","1605","0","47.66","30.09"
"65","000","00","040","0028","1717","625","388","237","3","628","1390","0","45.18","27.91"
"65","000","00","040","0029","0000","1115","663","452","19","1134","2205","0","51.43","30.07"
"65","000","00","040","0029","1714","595","362","233","10","605","1216","0","49.75","29.77"
"65","000","00","040","0029","1715","520","301","219","9","529","989","0","53.49","30.43"
"65","000","00","040","0030","0000","1977","1295","682","18","1995","3956","0","50.43","32.74"
"65","000","00","040","0030","1653","678","444","234","7","685","1326","0","51.66","33.48"
"65","000","00","040","0030","1654","626","403","223","4","630","1326","0","47.51","30.39"
"65","000","00","040","0030","1655","673","448","225","7","680","1304","0","52.15","34.36"
"65","000","00","040","0031","0000","2006","1315","691","21","2027","4105","0","49.38","32.03"
"65","000","00","040","0031","1649","475","311","164","4","479","989","0","48.43","31.45"
"65","000","00","040","0031","1650","508","342","166","3","511","997","0","51.25","34.30"
"65","000","00","040","0031","1651","549","366","183","11","560","1118","0","50.09","32.74"
"65","000","00","040","0031","1652","474","296","178","3","477","1001","0","47.65","29.57"
"65","000","00","040","0032","0000","1153","703","450","11","1164","2298","0","50.65","30.59"
"65","000","00","040","0032","1659","582","347","235","6","588","1158","0","50.78","29.97"
"65","000","00","040","0032","1660","571","356","215","5","576","1140","0","50.53","31.23"
"65","000","00","040","0033","0000","2027","1143","884","21","2048","4115","0","49.77","27.78"
"65","000","00","040","0033","1680","615","378","237","7","622","1309","0","47.52","28.88"
"65","000","00","040","0033","1681","688","383","305","7","695","1348","0","51.56","28.41"
"65","000","00","040","0033","1682","724","382","342","7","731","1458","0","50.14","26.20"
"65","000","00","040","0034","0000","1505","885","620","13","1518","3433","0","44.22","25.78"
"65","000","00","040","0034","1638","766","437","329","6","772","1669","0","46.26","26.18"
"65","000","00","040","0034","1639","739","448","291","7","746","1764","0","42.29","25.40"
"65","000","00","040","0035","0000","2060","1329","731","12","2072","4047","0","51.20","32.84"
"65","000","00","040","0035","1642","665","442","223","4","669","1297","0","51.58","34.08"
"65","000","00","040","0035","1643","756","498","258","5","761","1430","0","53.22","34.83"
"65","000","00","040","0035","1644","639","389","250","3","642","1320","0","48.64","29.47"
"65","000","00","040","0036","0000","713","440","273","5","718","1527","0","47.02","28.81"
"65","000","00","040","0036","1578","713","440","273","5","718","1527","0","47.02","28.81"
"65","000","00","040","0037","0000","1037","631","406","11","1048","2119","0","49.46","29.78"
"65","000","00","040","0037","1580","506","299","207","8","514","1041","0","49.38","28.72"
"65","000","00","040","0037","1581","531","332","199","3","534","1078","0","49.54","30.80"
"65","000","00","040","0038","0000","2203","1396","807","16","2219","4495","0","49.37","31.06"
"65","000","00","040","0038","1601","739","457","282","6","745","1473","0","50.58","31.03"
"65","000","00","040","0038","1602","684","443","241","3","687","1437","0","47.81","30.83"
"65","000","00","040","0038","1603","780","496","284","7","787","1585","0","49.65","31.29"
"65","000","00","040","0039","0000","1934","1263","671","22","1956","3718","0","52.61","33.97"
"65","000","00","040","0039","1604","678","432","246","7","685","1293","0","52.98","33.41"
"65","000","00","040","0039","1605","632","438","194","8","640","1201","0","53.29","36.47"
"65","000","00","040","0039","1606","624","393","231","7","631","1224","0","51.55","32.11"
"65","000","00","040","0040","0000","1226","749","477","9","1235","2845","0","43.41","26.33"
"65","000","00","040","0040","1647","619","383","236","4","623","1470","0","42.38","26.05"
"65","000","00","040","0040","1648","607","366","241","5","612","1375","0","44.51","26.62"
"65","000","00","040","0041","0000","383","276","107","5","388","809","0","47.96","34.12"
"65","000","00","040","0041","1701","383","276","107","5","388","809","0","47.96","34.12"
"65","000","00","040","0042","0000","444","321","123","3","447","907","0","49.28","35.39"
"65","000","00","040","0042","1700","444","321","123","3","447","907","0","49.28","35.39"
"65","000","00","040","0043","0000","911","565","346","5","916","1894","0","48.36","29.83"
"65","000","00","040","0043","1676","911","565","346","5","916","1894","0","48.36","29.83"
"65","000","00","040","0044","0000","1938","1156","782","21","1959","4232","0","46.29","27.32"
"65","000","00","040","0044","1677","708","414","294","5","713","1472","0","48.44","28.13"
"65","000","00","040","0044","1678","599","357","242","6","605","1293","0","46.79","27.61"
"65","000","00","040","0044","1679","631","385","246","10","641","1467","0","43.69","26.24"
"65","000","00","040","0045","0000","1016","618","398","7","1023","1996","0","51.25","30.96"
"65","000","00","040","0045","1718","534","315","219","4","538","1030","0","52.23","30.58"
"65","000","00","040","0045","1719","482","303","179","3","485","966","0","50.21","31.37"
"65","000","00","040","0046","0000","1907","1107","800","25","1932","3972","0","48.64","27.87"
"65","000","00","040","0046","1697","639","371","268","9","648","1347","0","48.11","27.54"
"65","000","00","040","0046","1698","612","338","274","9","621","1339","0","46.38","25.24"
"65","000","00","040","0046","1699","656","398","258","7","663","1286","0","51.56","30.95"
"65","000","00","040","0047","0000","2093","1246","847","24","2117","4293","0","49.31","29.02"
"65","000","00","040","0047","1613","754","436","318","13","767","1595","0","48.09","27.34"
"65","000","00","040","0047","1614","603","368","235","6","609","1193","0","51.05","30.85"
"65","000","00","040","0047","1615","736","442","294","5","741","1505","0","49.24","29.37"
"65","000","00","040","0048","0000","1327","771","556","7","1334","2797","0","47.69","27.57"
"65","000","00","040","0048","1611","624","367","257","5","629","1365","0","46.08","26.89"
"65","000","00","040","0048","1612","703","404","299","2","705","1432","0","49.23","28.21"
"65","000","00","040","0049","0000","1611","935","676","9","1620","3428","0","47.26","27.28"
"65","000","00","040","0049","1635","501","300","201","0","501","1082","0","46.30","27.73"
"65","000","00","040","0049","1636","535","310","225","4","539","1133","0","47.57","27.36"
"65","000","00","040","0049","1637","575","325","250","5","580","1213","0","47.82","26.79"
"65","000","00","040","0050","0000","1074","664","410","11","1085","2304","0","47.09","28.82"
"65","000","00","040","0050","1631","611","388","223","4","615","1240","0","49.60","31.29"
"65","000","00","040","0050","1632","463","276","187","7","470","1064","0","44.17","25.94"
"65","000","00","040","0051","0000","1518","1002","516","16","1534","3036","0","50.53","33.00"
"65","000","00","040","0051","1586","773","497","276","4","777","1504","0","51.66","33.05"
"65","000","00","040","0051","1587","745","505","240","12","757","1532","0","49.41","32.96"
"65","000","00","040","0052","0000","463","307","156","6","469","1031","0","45.49","29.78"
"65","000","00","040","0052","1579","463","307","156","6","469","1031","0","45.49","29.78"
"65","000","00","040","0053","0000","931","550","381","11","942","1963","0","47.99","28.02"
"65","000","00","040","0053","1595","505","283","222","6","511","1061","0","48.16","26.67"
"65","000","00","040","0053","1596","426","267","159","5","431","902","0","47.78","29.60"
"65","000","00","040","0054","0000","1291","806","485","9","1300","2764","0","47.03","29.16"
"65","000","00","040","0054","1593","626","390","236","1","627","1360","0","46.10","28.68"
"65","000","00","040","0054","1594","665","416","249","8","673","1404","0","47.93","29.63"
"65","000","00","040","0055","0000","1491","982","509","17","1508","3259","0","46.27","30.13"
"65","000","00","040","0055","1584","807","528","279","8","815","1714","0","47.55","30.81"
"65","000","00","040","0055","1585","684","454","230","9","693","1545","0","44.85","29.39"
"65","000","00","040","0056","0000","1645","1030","615","10","1655","3607","0","45.88","28.56"
"65","000","00","040","0056","1656","496","306","190","0","496","1158","0","42.83","26.42"
"65","000","00","040","0056","1657","539","348","191","5","544","1206","0","45.11","28.86"
"65","000","00","040","0056","1658","610","376","234","5","615","1243","0","49.48","30.25"
"65","000","00","040","0057","0000","1150","683","467","16","1166","2350","0","49.62","29.06"
"65","000","00","040","0057","1708","677","416","261","7","684","1355","0","50.48","30.70"
"65","000","00","040","0057","1709","473","267","206","9","482","995","0","48.44","26.83"
"65","000","00","040","0058","0000","901","490","411","7","908","1783","0","50.93","27.48"
"65","000","00","040","0058","1710","420","221","199","4","424","831","0","51.02","26.59"
"65","000","00","040","0058","1711","481","269","212","3","484","952","0","50.84","28.26"
"65","000","00","040","0059","0000","1150","692","458","17","1167","2527","0","46.18","27.38"
"65","000","00","040","0059","1640","545","329","216","7","552","1274","0","43.33","25.82"
"65","000","00","040","0059","1641","605","363","242","10","615","1253","0","49.08","28.97"
"65","000","00","040","0060","0000","1274","765","509","5","1279","2627","0","48.69","29.12"
"65","000","00","040","0060","1633","632","382","250","2","634","1349","0","47.00","28.32"
"65","000","00","040","0060","1634","642","383","259","3","645","1278","0","50.47","29.97"
"65","000","00","040","0061","0000","982","542","440","8","990","2095","0","47.26","25.87"
"65","000","00","040","0061","1664","493","275","218","4","497","1049","0","47.38","26.22"
"65","000","00","040","0061","1665","489","267","222","4","493","1046","0","47.13","25.53"
"65","000","00","040","0062","0000","4153","2546","1607","19","4172","9013","0","46.29","28.25"
"65","000","00","040","0062","1690","506","261","245","2","508","1184","0","42.91","22.04"
"65","000","00","040","0062","1691","622","374","248","2","624","1333","0","46.81","28.06"
"65","000","00","040","0062","1692","624","366","258","4","628","1296","0","48.46","28.24"
"65","000","00","040","0062","1693","524","339","185","2","526","1192","0","44.13","28.44"
"65","000","00","040","0062","1694","590","390","200","2","592","1303","0","45.43","29.93"
"65","000","00","040","0062","1695","700","457","243","4","704","1460","0","48.22","31.30"
"65","000","00","040","0062","1696","587","359","228","3","590","1245","0","47.39","28.84"
"65","000","00","050","0000","0000","144803","64996","79807","1313","146116","352098","422668","41.50","18.46"
"65","000","00","050","0001","0000","2121","920","1201","15","2136","4736","0","45.10","19.43"
"65","000","00","050","0001","0346","502","189","313","1","503","1101","0","45.69","17.17"
"65","000","00","050","0001","0347","575","250","325","5","580","1256","0","46.18","19.90"
"65","000","00","050","0001","0348","507","247","260","5","512","1099","0","46.59","22.47"
"65","000","00","050","0001","0349","537","234","303","4","541","1280","0","42.27","18.28"
"65","000","00","050","0002","0000","3582","1579","2003","31","3613","8383","0","43.10","18.84"
"65","000","00","050","0002","0373","576","184","392","4","580","1343","0","43.19","13.70"
"65","000","00","050","0002","0374","621","282","339","4","625","1470","0","42.52","19.18"
"65","000","00","050","0002","0375","578","296","282","2","580","1320","0","43.94","22.42"
"65","000","00","050","0002","0376","630","291","339","6","636","1495","0","42.54","19.46"
"65","000","00","050","0002","0377","549","243","306","4","553","1295","0","42.70","18.76"
"65","000","00","050","0002","0378","628","283","345","11","639","1460","0","43.77","19.38"
"65","000","00","050","0003","0000","558","251","307","5","563","1293","0","43.54","19.41"
"65","000","00","050","0003","0507","558","251","307","5","563","1293","0","43.54","19.41"
"65","000","00","050","0004","0000","1860","826","1034","13","1873","3916","0","47.83","21.09"
"65","000","00","050","0004","0350","588","243","345","6","594","1166","0","50.94","20.84"
"65","000","00","050","0004","0351","512","202","310","2","514","1165","0","44.12","17.34"
"65","000","00","050","0004","0352","760","381","379","5","765","1585","0","48.26","24.04"
"65","000","00","050","0005","0000","2018","950","1068","12","2030","4570","0","44.42","20.79"
"65","000","00","050","0005","0379","679","354","325","5","684","1438","0","47.57","24.62"
"65","000","00","050","0005","0380","569","262","307","3","572","1327","0","43.10","19.74"
"65","000","00","050","0005","0381","770","334","436","4","774","1805","0","42.88","18.50"
"65","000","00","050","0006","0000","1354","583","771","15","1369","3237","0","42.29","18.01"
"65","000","00","050","0006","0504","443","223","220","6","449","1112","0","40.38","20.05"
"65","000","00","050","0006","0505","447","175","272","2","449","1005","0","44.68","17.41"
"65","000","00","050","0006","0506","464","185","279","7","471","1120","0","42.05","16.52"
"65","000","00","050","0007","0000","2049","930","1119","22","2071","4625","0","44.78","20.11"
"65","000","00","050","0007","0356","781","367","414","9","790","1825","0","43.29","20.11"
"65","000","00","050","0007","0357","652","286","366","10","662","1384","0","47.83","20.66"
"65","000","00","050","0007","0358","616","277","339","3","619","1416","0","43.71","19.56"
"65","000","00","050","0008","0000","1739","795","944","12","1751","3906","0","44.83","20.35"
"65","000","00","050","0008","0436","585","261","324","4","589","1353","0","43.53","19.29"
"65","000","00","050","0008","0437","575","262","313","6","581","1320","0","44.02","19.85"
"65","000","00","050","0008","0438","579","272","307","2","581","1233","0","47.12","22.06"
"65","000","00","050","0009","0000","2786","1326","1460","18","2804","6314","0","44.41","21.00"
"65","000","00","050","0009","0562","450","157","293","3","453","1093","0","41.45","14.36"
"65","000","00","050","0009","0563","554","235","319","3","557","1334","0","41.75","17.62"
"65","000","00","050","0009","0564","592","367","225","5","597","1185","0","50.38","30.97"
"65","000","00","050","0009","0565","606","291","315","4","610","1356","0","44.99","21.46"
"65","000","00","050","0009","0566","584","276","308","3","587","1346","0","43.61","20.51"
"65","000","00","050","0010","0000","906","385","521","5","911","1879","0","48.48","20.49"
"65","000","00","050","0010","0359","458","203","255","2","460","941","0","48.88","21.57"
"65","000","00","050","0010","0360","448","182","266","3","451","938","0","48.08","19.40"
"65","000","00","050","0011","0000","2331","1044","1287","19","2350","5211","0","45.10","20.03"
"65","000","00","050","0011","0432","568","238","330","5","573","1177","0","48.68","20.22"
"65","000","00","050","0011","0433","535","218","317","3","538","1320","0","40.76","16.52"
"65","000","00","050","0011","0434","476","231","245","3","479","1176","0","40.73","19.64"
"65","000","00","050","0011","0435","752","357","395","8","760","1538","0","49.41","23.21"
"65","000","00","050","0012","0000","1024","437","587","6","1030","2744","0","37.54","15.93"
"65","000","00","050","0012","0581","486","216","270","4","490","1415","0","34.63","15.27"
"65","000","00","050","0012","0582","538","221","317","2","540","1329","0","40.63","16.63"
"65","000","00","050","0013","0000","1411","737","674","9","1420","2917","0","48.68","25.27"
"65","000","00","050","0013","0363","466","218","248","4","470","973","0","48.30","22.40"
"65","000","00","050","0013","0364","506","286","220","3","509","1021","0","49.85","28.01"
"65","000","00","050","0013","0365","439","233","206","2","441","923","0","47.78","25.24"
"65","000","00","050","0014","0000","1818","813","1005","17","1835","4028","0","45.56","20.18"
"65","000","00","050","0014","0443","643","300","343","4","647","1337","0","48.39","22.44"
"65","000","00","050","0014","0444","578","245","333","7","585","1343","0","43.56","18.24"
"65","000","00","050","0014","0445","597","268","329","6","603","1348","0","44.73","19.88"
"65","000","00","050","0015","0000","4310","1958","2352","29","4339","10595","0","40.95","18.48"
"65","000","00","050","0015","0611","484","192","292","5","489","1147","0","42.63","16.74"
"65","000","00","050","0015","0612","523","210","313","0","523","1127","0","46.41","18.63"
"65","000","00","050","0015","0613","654","289","365","7","661","1552","0","42.59","18.62"
"65","000","00","050","0015","0614","455","189","266","3","458","1069","0","42.84","17.68"
"65","000","00","050","0015","0615","427","185","242","2","429","1167","0","36.76","15.85"
"65","000","00","050","0015","0616","592","326","266","3","595","1407","0","42.29","23.17"
"65","000","00","050","0015","0617","582","316","266","4","586","1548","0","37.86","20.41"
"65","000","00","050","0015","0618","593","251","342","5","598","1578","0","37.90","15.91"
"65","000","00","050","0016","0000","1298","604","694","8","1306","5142","0","25.40","11.75"
"65","000","00","050","0016","0366","498","241","257","3","501","1100","0","45.55","21.91"
"65","000","00","050","0016","0367","800","363","437","5","805","4042","0","19.92","8.98"
"65","000","00","050","0017","0000","1564","599","965","19","1583","3896","0","40.63","15.37"
"65","000","00","050","0017","0446","521","206","315","6","527","1258","0","41.89","16.38"
"65","000","00","050","0017","0447","546","215","331","6","552","1393","0","39.63","15.43"
"65","000","00","050","0017","0448","497","178","319","7","504","1245","0","40.48","14.30"
"65","000","00","050","0018","0000","2027","793","1234","20","2047","5058","0","40.47","15.68"
"65","000","00","050","0018","0510","551","246","305","5","556","1328","0","41.87","18.52"
"65","000","00","050","0018","0511","562","196","366","4","566","1160","0","48.79","16.90"
"65","000","00","050","0018","0512","477","166","311","5","482","1287","0","37.45","12.90"
"65","000","00","050","0018","0513","437","185","252","6","443","1283","0","34.53","14.42"
"65","000","00","050","0019","0000","731","377","354","8","739","1553","0","47.59","24.28"
"65","000","00","050","0019","0368","731","377","354","8","739","1553","0","47.59","24.28"
"65","000","00","050","0020","0000","759","304","455","7","766","1903","0","40.25","15.97"
"65","000","00","050","0020","0469","382","144","238","1","383","967","0","39.61","14.89"
"65","000","00","050","0020","0470","377","160","217","6","383","936","0","40.92","17.09"
"65","000","00","050","0021","0000","2393","997","1396","30","2423","6057","0","40.00","16.46"
"65","000","00","050","0021","0544","584","260","324","9","593","1490","0","39.80","17.45"
"65","000","00","050","0021","0545","629","257","372","7","636","1596","0","39.85","16.10"
"65","000","00","050","0021","0546","595","215","380","7","602","1471","0","40.92","14.62"
"65","000","00","050","0021","0547","585","265","320","7","592","1500","0","39.47","17.67"
"65","000","00","050","0022","0000","668","285","383","5","673","1547","0","43.50","18.42"
"65","000","00","050","0022","0369","668","285","383","5","673","1547","0","43.50","18.42"
"65","000","00","050","0023","0000","2323","995","1328","26","2349","5390","0","43.58","18.46"
"65","000","00","050","0023","0471","536","236","300","8","544","1365","0","39.85","17.29"
"65","000","00","050","0023","0472","542","221","321","7","549","1369","0","40.10","16.14"
"65","000","00","050","0023","0473","646","294","352","7","653","1420","0","45.99","20.70"
"65","000","00","050","0023","0474","599","244","355","4","603","1236","0","48.79","19.74"
"65","000","00","050","0024","0000","853","366","487","12","865","2056","0","42.07","17.80"
"65","000","00","050","0024","0550","407","163","244","8","415","1010","0","41.09","16.14"
"65","000","00","050","0024","0551","446","203","243","4","450","1046","0","43.02","19.41"
"65","000","00","050","0025","0000","1982","826","1156","23","2005","4652","0","43.10","17.76"
"65","000","00","050","0025","0423","518","214","304","5","523","1163","0","44.97","18.40"
"65","000","00","050","0025","0424","484","198","286","7","491","1132","0","43.37","17.49"
"65","000","00","050","0025","0425","473","194","279","5","478","1173","0","40.75","16.54"
"65","000","00","050","0025","0426","507","220","287","6","513","1184","0","43.33","18.58"
"65","000","00","050","0026","0000","840","526","314","9","849","1674","0","50.72","31.42"
"65","000","00","050","0026","0439","395","215","180","2","397","811","0","48.95","26.51"
"65","000","00","050","0026","0440","445","311","134","7","452","863","0","52.38","36.04"
"65","000","00","050","0027","0000","1764","760","1004","26","1790","4664","0","38.38","16.30"
"65","000","00","050","0027","0570","396","165","231","8","404","1146","0","35.25","14.40"
"65","000","00","050","0027","0571","446","176","270","7","453","1091","0","41.52","16.13"
"65","000","00","050","0027","0572","458","206","252","6","464","1206","0","38.47","17.08"
"65","000","00","050","0027","0573","464","213","251","5","469","1221","0","38.41","17.44"
"65","000","00","050","0028","0000","937","385","552","9","946","2389","0","39.60","16.12"
"65","000","00","050","0028","0413","423","166","257","4","427","1153","0","37.03","14.40"
"65","000","00","050","0028","0414","514","219","295","5","519","1236","0","41.99","17.72"
"65","000","00","050","0029","0000","1047","498","549","4","1051","2305","0","45.60","21.61"
"65","000","00","050","0029","0441","540","262","278","3","543","1141","0","47.59","22.96"
"65","000","00","050","0029","0442","507","236","271","1","508","1164","0","43.64","20.27"
"65","000","00","050","0030","0000","1875","826","1049","22","1897","4652","0","40.78","17.76"
"65","000","00","050","0030","0400","434","206","228","5","439","1157","0","37.94","17.80"
"65","000","00","050","0030","0401","423","150","273","4","427","1032","0","41.38","14.53"
"65","000","00","050","0030","0402","509","215","294","7","516","1277","0","40.41","16.84"
"65","000","00","050","0030","0403","509","255","254","6","515","1186","0","43.42","21.50"
"65","000","00","050","0031","0000","1879","880","999","15","1894","4324","0","43.80","20.35"
"65","000","00","050","0031","0501","652","297","355","9","661","1478","0","44.72","20.09"
"65","000","00","050","0031","0502","638","315","323","3","641","1439","0","44.54","21.89"
"65","000","00","050","0031","0503","589","268","321","3","592","1407","0","42.08","19.05"
"65","000","00","050","0032","0000","1966","892","1074","21","1987","5143","0","38.64","17.34"
"65","000","00","050","0032","0586","435","172","263","5","440","1301","0","33.82","13.22"
"65","000","00","050","0032","0587","561","273","288","4","565","1355","0","41.70","20.15"
"65","000","00","050","0032","0588","485","201","284","9","494","1212","0","40.76","16.58"
"65","000","00","050","0032","0589","485","246","239","3","488","1275","0","38.27","19.29"
"65","000","00","050","0033","0000","1719","655","1064","20","1739","4178","0","41.62","15.68"
"65","000","00","050","0033","0391","487","187","300","7","494","1314","0","37.60","14.23"
"65","000","00","050","0033","0392","539","183","356","10","549","1354","0","40.55","13.52"
"65","000","00","050","0033","0393","693","285","408","3","696","1510","0","46.09","18.87"
"65","000","00","050","0034","0000","1248","507","741","10","1258","3266","0","38.52","15.52"
"65","000","00","050","0034","0495","339","146","193","3","342","982","0","34.83","14.87"
"65","000","00","050","0034","0496","442","197","245","3","445","1154","0","38.56","17.07"
"65","000","00","050","0034","0497","467","164","303","4","471","1130","0","41.68","14.51"
"65","000","00","050","0035","0000","1006","392","614","8","1014","2666","0","38.03","14.70"
"65","000","00","050","0035","0593","537","204","333","6","543","1348","0","40.28","15.13"
"65","000","00","050","0035","0594","469","188","281","2","471","1318","0","35.74","14.26"
"65","000","00","050","0036","0000","1486","583","903","10","1496","3422","0","43.72","17.04"
"65","000","00","050","0036","0370","446","141","305","2","448","1050","0","42.67","13.43"
"65","000","00","050","0036","0371","439","172","267","5","444","1037","0","42.82","16.59"
"65","000","00","050","0036","0372","601","270","331","3","604","1335","0","45.24","20.22"
"65","000","00","050","0037","0000","1486","602","884","11","1497","3451","0","43.38","17.44"
"65","000","00","050","0037","0455","470","179","291","3","473","1202","0","39.35","14.89"
"65","000","00","050","0037","0456","514","208","306","6","520","1157","0","44.94","17.98"
"65","000","00","050","0037","0457","502","215","287","2","504","1092","0","46.15","19.69"
"65","000","00","050","0038","0000","2231","956","1275","22","2253","6136","0","36.72","15.58"
"65","000","00","050","0038","0606","423","189","234","2","425","1263","0","33.65","14.96"
"65","000","00","050","0038","0607","452","187","265","3","455","1198","0","37.98","15.61"
"65","000","00","050","0038","0608","457","199","258","5","462","1292","0","35.76","15.40"
"65","000","00","050","0038","0609","368","124","244","7","375","1161","0","32.30","10.68"
"65","000","00","050","0038","0610","531","257","274","5","536","1222","0","43.86","21.03"
"65","000","00","050","0039","0000","1623","698","925","16","1639","3692","0","44.39","18.91"
"65","000","00","050","0039","0427","566","275","291","6","572","1210","0","47.27","22.73"
"65","000","00","050","0039","0428","517","190","327","5","522","1220","0","42.79","15.57"
"65","000","00","050","0039","0429","540","233","307","5","545","1262","0","43.19","18.46"
"65","000","00","050","0040","0000","772","337","435","3","775","1701","0","45.56","19.81"
"65","000","00","050","0040","0516","262","136","126","0","262","631","0","41.52","21.55"
"65","000","00","050","0040","0517","510","201","309","3","513","1070","0","47.94","18.79"
"65","000","00","050","0041","0000","1345","640","705","10","1355","3835","0","35.33","16.69"
"65","000","00","050","0041","0601","474","236","238","4","478","1327","0","36.02","17.78"
"65","000","00","050","0041","0602","448","197","251","4","452","1264","0","35.76","15.59"
"65","000","00","050","0041","0603","423","207","216","2","425","1244","0","34.16","16.64"
"65","000","00","050","0042","0000","841","334","507","9","850","2341","0","36.31","14.27"
"65","000","00","050","0042","0421","417","170","247","3","420","1134","0","37.04","14.99"
"65","000","00","050","0042","0422","424","164","260","6","430","1207","0","35.63","13.59"
"65","000","00","050","0043","0000","2909","1385","1524","29","2938","7720","0","38.06","17.94"
"65","000","00","050","0043","0518","527","230","297","1","528","1368","0","38.60","16.81"
"65","000","00","050","0043","0519","493","238","255","5","498","1377","0","36.17","17.28"
"65","000","00","050","0043","0520","513","229","284","6","519","1377","0","37.69","16.63"
"65","000","00","050","0043","0521","486","204","282","6","492","1260","0","39.05","16.19"
"65","000","00","050","0043","0522","496","267","229","9","505","1301","0","38.82","20.52"
"65","000","00","050","0043","0523","394","217","177","2","396","1037","0","38.19","20.93"
"65","000","00","050","0044","0000","1426","626","800","13","1439","4165","0","34.55","15.03"
"65","000","00","050","0044","0595","456","195","261","6","462","1390","0","33.24","14.03"
"65","000","00","050","0044","0596","479","204","275","3","482","1377","0","35.00","14.81"
"65","000","00","050","0044","0597","491","227","264","4","495","1398","0","35.41","16.24"
"65","000","00","050","0045","0000","1892","799","1093","34","1926","4667","0","41.27","17.12"
"65","000","00","050","0045","0417","534","235","299","7","541","1208","0","44.78","19.45"
"65","000","00","050","0045","0418","527","221","306","12","539","1241","0","43.43","17.81"
"65","000","00","050","0045","0419","464","185","279","10","474","1211","0","39.14","15.28"
"65","000","00","050","0045","0420","367","158","209","5","372","1007","0","36.94","15.69"
"65","000","00","050","0046","0000","1495","641","854","18","1513","4014","0","37.69","15.97"
"65","000","00","050","0046","0524","475","197","278","8","483","1300","0","37.15","15.15"
"65","000","00","050","0046","0525","490","220","270","5","495","1405","0","35.23","15.66"
"65","000","00","050","0046","0526","530","224","306","5","535","1309","0","40.87","17.11"
"65","000","00","050","0047","0000","1496","536","960","9","1505","3807","0","39.53","14.08"
"65","000","00","050","0047","0394","489","170","319","4","493","1264","0","39.00","13.45"
"65","000","00","050","0047","0395","479","171","308","1","480","1242","0","38.65","13.77"
"65","000","00","050","0047","0396","528","195","333","4","532","1301","0","40.89","14.99"
"65","000","00","050","0048","0000","3798","1875","1923","32","3830","9790","0","39.12","19.15"
"65","000","00","050","0048","0529","688","370","318","2","690","1613","0","42.78","22.94"
"65","000","00","050","0048","0530","591","300","291","8","599","1416","0","42.30","21.19"
"65","000","00","050","0048","0531","473","225","248","2","475","1379","0","34.45","16.32"
"65","000","00","050","0048","0532","522","256","266","4","526","1398","0","37.63","18.31"
"65","000","00","050","0048","0533","527","245","282","10","537","1322","0","40.62","18.53"
"65","000","00","050","0048","0534","500","253","247","4","504","1349","0","37.36","18.75"
"65","000","00","050","0048","0535","497","226","271","2","499","1313","0","38.00","17.21"
"65","000","00","050","0049","0000","858","340","518","5","863","2188","0","39.44","15.54"
"65","000","00","050","0049","0415","402","168","234","3","405","1043","0","38.83","16.11"
"65","000","00","050","0049","0416","456","172","284","2","458","1145","0","40.00","15.02"
"65","000","00","050","0050","0000","3410","1627","1783","28","3438","8555","0","40.19","19.02"
"65","000","00","050","0050","0538","594","246","348","10","604","1441","0","41.92","17.07"
"65","000","00","050","0050","0539","591","320","271","1","592","1445","0","40.97","22.15"
"65","000","00","050","0050","0540","532","215","317","5","537","1433","0","37.47","15.00"
"65","000","00","050","0050","0541","581","274","307","3","584","1467","0","39.81","18.68"
"65","000","00","050","0050","0542","550","285","265","6","556","1413","0","39.35","20.17"
"65","000","00","050","0050","0543","562","287","275","3","565","1356","0","41.67","21.17"
"65","000","00","050","0051","0000","1128","516","612","7","1135","2558","0","44.37","20.17"
"65","000","00","050","0051","0430","540","236","304","3","543","1229","0","44.18","19.20"
"65","000","00","050","0051","0431","588","280","308","4","592","1329","0","44.54","21.07"
"65","000","00","050","0052","0000","1707","762","945","18","1725","4343","0","39.72","17.55"
"65","000","00","050","0052","0492","625","258","367","6","631","1641","0","38.45","15.72"
"65","000","00","050","0052","0493","679","331","348","9","688","1673","0","41.12","19.78"
"65","000","00","050","0052","0494","403","173","230","3","406","1029","0","39.46","16.81"
"65","000","00","050","0053","0000","4529","2053","2476","40","4569","11108","0","41.13","18.48"
"65","000","00","050","0053","0485","952","471","481","8","960","2419","0","39.69","19.47"
"65","000","00","050","0053","0486","432","174","258","2","434","1169","0","37.13","14.88"
"65","000","00","050","0053","0487","513","241","272","3","516","1314","0","39.27","18.34"
"65","000","00","050","0053","0488","715","305","410","7","722","1625","0","44.43","18.77"
"65","000","00","050","0053","0489","611","273","338","5","616","1424","0","43.26","19.17"
"65","000","00","050","0053","0490","624","278","346","7","631","1491","0","42.32","18.65"
"65","000","00","050","0053","0491","682","311","371","8","690","1666","0","41.42","18.67"
"65","000","00","050","0054","0000","3015","1306","1709","23","3038","7280","0","41.73","17.94"
"65","000","00","050","0054","0475","606","266","340","3","609","1481","0","41.12","17.96"
"65","000","00","050","0054","0476","611","237","374","7","618","1414","0","43.71","16.76"
"65","000","00","050","0054","0477","603","265","338","7","610","1463","0","41.70","18.11"
"65","000","00","050","0054","0478","628","282","346","3","631","1448","0","43.58","19.48"
"65","000","00","050","0054","0479","567","256","311","3","570","1474","0","38.67","17.37"
"65","000","00","050","0055","0000","1462","598","864","20","1482","4090","0","36.23","14.62"
"65","000","00","050","0055","0567","482","198","284","6","488","1399","0","34.88","14.15"
"65","000","00","050","0055","0568","483","194","289","6","489","1304","0","37.50","14.88"
"65","000","00","050","0055","0569","497","206","291","8","505","1387","0","36.41","14.85"
"65","000","00","050","0056","0000","950","418","532","8","958","2178","0","43.99","19.19"
"65","000","00","050","0056","0560","468","230","238","6","474","1097","0","43.21","20.97"
"65","000","00","050","0056","0561","482","188","294","2","484","1081","0","44.77","17.39"
"65","000","00","050","0057","0000","1345","588","757","13","1358","3219","0","42.19","18.27"
"65","000","00","050","0057","0449","382","142","240","4","386","1064","0","36.28","13.35"
"65","000","00","050","0057","0450","538","242","296","2","540","1165","0","46.35","20.77"
"65","000","00","050","0057","0451","425","204","221","7","432","990","0","43.64","20.61"
"65","000","00","050","0058","0000","1193","404","789","12","1205","3118","0","38.65","12.96"
"65","000","00","050","0058","0452","422","143","279","6","428","1098","0","38.98","13.02"
"65","000","00","050","0058","0453","367","132","235","1","368","1004","0","36.65","13.15"
"65","000","00","050","0058","0454","404","129","275","5","409","1016","0","40.26","12.70"
"65","000","00","050","0059","0000","1850","858","992","25","1875","4308","0","43.52","19.92"
"65","000","00","050","0059","0498","605","280","325","15","620","1497","0","41.42","18.70"
"65","000","00","050","0059","0499","625","259","366","5","630","1366","0","46.12","18.96"
"65","000","00","050","0059","0500","620","319","301","5","625","1445","0","43.25","22.08"
"65","000","00","050","0060","0000","2092","1047","1045","19","2111","4287","0","49.24","24.42"
"65","000","00","050","0060","0353","699","372","327","9","708","1469","0","48.20","25.32"
"65","000","00","050","0060","0354","720","358","362","5","725","1480","0","48.99","24.19"
"65","000","00","050","0060","0355","673","317","356","5","678","1338","0","50.67","23.69"
"65","000","00","050","0061","0000","1273","480","793","8","1281","3271","0","39.16","14.67"
"65","000","00","050","0061","0410","419","151","268","3","422","1076","0","39.22","14.03"
"65","000","00","050","0061","0411","421","167","254","3","424","1060","0","40.00","15.75"
"65","000","00","050","0061","0412","433","162","271","2","435","1135","0","38.33","14.27"
"65","000","00","050","0062","0000","2461","1134","1327","27","2488","5316","0","46.80","21.33"
"65","000","00","050","0062","0465","622","310","312","9","631","1367","0","46.16","22.68"
"65","000","00","050","0062","0466","555","248","307","5","560","1240","0","45.16","20.00"
"65","000","00","050","0062","0467","621","278","343","7","628","1381","0","45.47","20.13"
"65","000","00","050","0062","0468","663","298","365","6","669","1328","0","50.38","22.44"
"65","000","00","050","0063","0000","1372","618","754","11","1383","3181","0","43.48","19.43"
"65","000","00","050","0063","0407","410","158","252","2","412","1004","0","41.04","15.74"
"65","000","00","050","0063","0408","452","193","259","6","458","1044","0","43.87","18.49"
"65","000","00","050","0063","0409","510","267","243","3","513","1133","0","45.28","23.57"
"65","000","00","050","0064","0000","2970","1472","1498","13","2983","7008","0","42.57","21.00"
"65","000","00","050","0064","0386","817","441","376","1","818","1912","0","42.78","23.06"
"65","000","00","050","0064","0387","491","222","269","4","495","1275","0","38.82","17.41"
"65","000","00","050","0064","0388","653","329","324","3","656","1417","0","46.29","23.22"
"65","000","00","050","0064","0389","514","231","283","3","517","1211","0","42.69","19.08"
"65","000","00","050","0064","0390","495","249","246","2","497","1193","0","41.66","20.87"
"65","000","00","050","0065","0000","1435","721","714","12","1447","2960","0","48.89","24.36"
"65","000","00","050","0065","0361","707","354","353","9","716","1451","0","49.35","24.40"
"65","000","00","050","0065","0362","728","367","361","3","731","1509","0","48.44","24.32"
"65","000","00","050","0066","0000","1271","556","715","13","1284","3234","0","39.70","17.19"
"65","000","00","050","0066","0557","423","206","217","5","428","1024","0","41.80","20.12"
"65","000","00","050","0066","0558","400","152","248","6","406","1046","0","38.81","14.53"
"65","000","00","050","0066","0559","448","198","250","2","450","1164","0","38.66","17.01"
"65","000","00","050","0067","0000","769","335","434","13","782","2075","0","37.69","16.14"
"65","000","00","050","0067","0548","379","150","229","3","382","1079","0","35.40","13.90"
"65","000","00","050","0067","0549","390","185","205","10","400","996","0","40.16","18.57"
"65","000","00","050","0068","0000","996","426","570","8","1004","2274","0","44.15","18.73"
"65","000","00","050","0068","0514","438","187","251","5","443","1141","0","38.83","16.39"
"65","000","00","050","0068","0515","558","239","319","3","561","1133","0","49.51","21.09"
"65","000","00","050","0069","0000","1275","671","604","13","1288","2720","0","47.35","24.67"
"65","000","00","050","0069","0555","610","297","313","4","614","1352","0","45.41","21.97"
"65","000","00","050","0069","0556","665","374","291","9","674","1368","0","49.27","27.34"
"65","000","00","050","0070","0000","2308","1016","1292","20","2328","5875","0","39.63","17.29"
"65","000","00","050","0070","0574","568","251","317","4","572","1453","0","39.37","17.27"
"65","000","00","050","0070","0575","563","240","323","4","567","1462","0","38.78","16.42"
"65","000","00","050","0070","0576","579","267","312","5","584","1460","0","40.00","18.29"
"65","000","00","050","0070","0577","598","258","340","7","605","1500","0","40.33","17.20"
"65","000","00","050","0071","0000","1608","702","906","13","1621","4416","0","36.71","15.90"
"65","000","00","050","0071","0583","535","229","306","6","541","1454","0","37.21","15.75"
"65","000","00","050","0071","0584","580","251","329","5","585","1517","0","38.56","16.55"
"65","000","00","050","0071","0585","493","222","271","2","495","1445","0","34.26","15.36"
"65","000","00","050","0072","0000","2275","990","1285","23","2298","5247","0","43.80","18.87"
"65","000","00","050","0072","0382","546","246","300","8","554","1319","0","42.00","18.65"
"65","000","00","050","0072","0383","632","274","358","6","638","1326","0","48.11","20.66"
"65","000","00","050","0072","0384","527","206","321","3","530","1238","0","42.81","16.64"
"65","000","00","050","0072","0385","570","264","306","6","576","1364","0","42.23","19.35"
"65","000","00","050","0073","0000","1350","587","763","8","1358","3272","0","41.50","17.94"
"65","000","00","050","0073","0404","463","204","259","3","466","1161","0","40.14","17.57"
"65","000","00","050","0073","0405","395","152","243","3","398","983","0","40.49","15.46"
"65","000","00","050","0073","0406","492","231","261","2","494","1128","0","43.79","20.48"
"65","000","00","050","0074","0000","1658","798","860","17","1675","3858","0","43.42","20.68"
"65","000","00","050","0074","0397","538","266","272","9","547","1233","0","44.36","21.57"
"65","000","00","050","0074","0398","556","247","309","1","557","1361","0","40.93","18.15"
"65","000","00","050","0074","0399","564","285","279","7","571","1264","0","45.17","22.55"
"65","000","00","050","0075","0000","3249","1627","1622","32","3281","7749","0","42.34","21.00"
"65","000","00","050","0075","0480","702","365","337","7","709","1510","0","46.95","24.17"
"65","000","00","050","0075","0481","629","323","306","6","635","1529","0","41.53","21.12"
"65","000","00","050","0075","0482","669","330","339","10","679","1635","0","41.53","20.18"
"65","000","00","050","0075","0483","643","326","317","4","647","1641","0","39.43","19.87"
"65","000","00","050","0075","0484","606","283","323","5","611","1434","0","42.61","19.74"
"65","000","00","050","0076","0000","4171","2092","2079","27","4198","9967","0","42.12","20.99"
"65","000","00","050","0076","0458","730","323","407","4","734","1697","0","43.25","19.03"
"65","000","00","050","0076","0459","573","262","311","5","578","1418","0","40.76","18.48"
"65","000","00","050","0076","0460","644","335","309","5","649","1434","0","45.26","23.36"
"65","000","00","050","0076","0461","568","316","252","2","570","1397","0","40.80","22.62"
"65","000","00","050","0076","0462","547","280","267","6","553","1274","0","43.41","21.98"
"65","000","00","050","0076","0463","572","288","284","2","574","1387","0","41.38","20.76"
"65","000","00","050","0076","0464","537","288","249","3","540","1360","0","39.71","21.18"
"65","000","00","050","0077","0000","958","439","519","14","972","2206","0","44.06","19.90"
"65","000","00","050","0077","0508","458","210","248","7","465","1079","0","43.10","19.46"
"65","000","00","050","0077","0509","500","229","271","7","507","1127","0","44.99","20.32"
"65","000","00","050","0078","0000","1452","675","777","8","1460","3404","0","42.89","19.83"
"65","000","00","050","0078","0552","489","190","299","1","490","1153","0","42.50","16.48"
"65","000","00","050","0078","0553","466","239","227","3","469","1058","0","44.33","22.59"
"65","000","00","050","0078","0554","497","246","251","4","501","1193","0","41.99","20.62"
"65","000","00","050","0079","0000","797","386","411","7","804","1990","0","40.40","19.40"
"65","000","00","050","0079","0536","429","211","218","3","432","1076","0","40.15","19.61"
"65","000","00","050","0079","0537","368","175","193","4","372","914","0","40.70","19.15"
"65","000","00","050","0080","0000","857","412","445","5","862","2133","0","40.41","19.32"
"65","000","00","050","0080","0527","432","216","216","4","436","1098","0","39.71","19.67"
"65","000","00","050","0080","0528","425","196","229","1","426","1035","0","41.16","18.94"
"65","000","00","050","0081","0000","1326","589","737","14","1340","3307","0","40.52","17.81"
"65","000","00","050","0081","0578","434","198","236","6","440","1043","0","42.19","18.98"
"65","000","00","050","0081","0579","480","211","269","2","482","1181","0","40.81","17.87"
"65","000","00","050","0081","0580","412","180","232","6","418","1083","0","38.60","16.62"
"65","000","00","050","0082","0000","1529","734","795","20","1549","3548","0","43.66","20.69"
"65","000","00","050","0082","0590","482","223","259","8","490","1179","0","41.56","18.91"
"65","000","00","050","0082","0591","471","256","215","6","477","1029","0","46.36","24.88"
"65","000","00","050","0082","0592","576","255","321","6","582","1340","0","43.43","19.03"
"65","000","00","050","0083","0000","1456","662","794","18","1474","3815","0","38.64","17.35"
"65","000","00","050","0083","0598","458","194","264","4","462","1268","0","36.44","15.30"
"65","000","00","050","0083","0599","507","223","284","8","515","1266","0","40.68","17.61"
"65","000","00","050","0083","0600","491","245","246","6","497","1281","0","38.80","19.13"
"65","000","00","050","0084","0000","902","344","558","5","907","2430","0","37.33","14.16"
"65","000","00","050","0084","0604","493","185","308","4","497","1231","0","40.37","15.03"
"65","000","00","050","0084","0605","409","159","250","1","410","1199","0","34.20","13.26"
"65","000","00","060","0000","0000","122740","76576","46164","1074","123814","265823","301768","46.58","28.81"
"65","000","00","060","0001","0000","1411","952","459","17","1428","2846","0","50.18","33.45"
"65","000","00","060","0001","2178","743","488","255","7","750","1426","0","52.59","34.22"
"65","000","00","060","0001","2179","668","464","204","10","678","1420","0","47.75","32.68"
"65","000","00","060","0002","0000","1681","1072","609","18","1699","3541","0","47.98","30.27"
"65","000","00","060","0002","2180","626","420","206","4","630","1329","0","47.40","31.60"
"65","000","00","060","0002","2181","491","304","187","5","496","1034","0","47.97","29.40"
"65","000","00","060","0002","2182","564","348","216","9","573","1178","0","48.64","29.54"
"65","000","00","060","0003","0000","1601","977","624","6","1607","3306","0","48.61","29.55"
"65","000","00","060","0003","2183","490","310","180","4","494","1047","0","47.18","29.61"
"65","000","00","060","0003","2184","587","354","233","1","588","1153","0","51.00","30.70"
"65","000","00","060","0003","2185","524","313","211","1","525","1106","0","47.47","28.30"
"65","000","00","060","0004","0000","1837","1138","699","14","1851","3497","0","52.93","32.54"
"65","000","00","060","0004","2186","526","301","225","5","531","1015","0","52.32","29.66"
"65","000","00","060","0004","2187","664","424","240","5","669","1251","0","53.48","33.89"
"65","000","00","060","0004","2188","647","413","234","4","651","1231","0","52.88","33.55"
"65","000","00","060","0005","0000","2483","1601","882","24","2507","4908","0","51.08","32.62"
"65","000","00","060","0005","2189","546","353","193","7","553","1117","0","49.51","31.60"
"65","000","00","060","0005","2190","674","443","231","4","678","1239","0","54.72","35.75"
"65","000","00","060","0005","2191","668","427","241","10","678","1293","0","52.44","33.02"
"65","000","00","060","0005","2192","595","378","217","3","598","1259","0","47.50","30.02"
"65","000","00","060","0006","0000","2529","1576","953","25","2554","4879","0","52.35","32.30"
"65","000","00","060","0006","2195","905","587","318","11","916","1685","0","54.36","34.84"
"65","000","00","060","0006","2196","554","374","180","4","558","1109","0","50.32","33.72"
"65","000","00","060","0006","2197","538","313","225","5","543","1027","0","52.87","30.48"
"65","000","00","060","0006","2198","532","302","230","5","537","1058","0","50.76","28.54"
"65","000","00","060","0007","0000","2457","1621","836","26","2483","4940","0","50.26","32.81"
"65","000","00","060","0007","2204","655","415","240","4","659","1268","0","51.97","32.73"
"65","000","00","060","0007","2205","567","392","175","8","575","1229","0","46.79","31.90"
"65","000","00","060","0007","2206","618","413","205","4","622","1196","0","52.01","34.53"
"65","000","00","060","0007","2207","617","401","216","10","627","1247","0","50.28","32.16"
"65","000","00","060","0008","0000","2991","1740","1251","26","3017","6086","0","49.57","28.59"
"65","000","00","060","0008","2208","453","271","182","2","455","971","0","46.86","27.91"
"65","000","00","060","0008","2209","1234","749","485","13","1247","2367","0","52.68","31.64"
"65","000","00","060","0008","2210","592","323","269","4","596","1283","0","46.45","25.18"
"65","000","00","060","0008","2211","712","397","315","7","719","1465","0","49.08","27.10"
"65","000","00","060","0009","0000","1074","746","328","10","1084","2525","0","42.93","29.54"
"65","000","00","060","0009","2212","552","364","188","3","555","1355","0","40.96","26.86"
"65","000","00","060","0009","2213","522","382","140","7","529","1170","0","45.21","32.65"
"65","000","00","060","0010","0000","1414","1146","268","11","1425","2477","0","57.53","46.27"
"65","000","00","060","0010","2214","733","605","128","8","741","1250","0","59.28","48.40"
"65","000","00","060","0010","2215","681","541","140","3","684","1227","0","55.75","44.09"
"65","000","00","060","0011","0000","1279","822","457","9","1288","2805","0","45.92","29.30"
"65","000","00","060","0011","2216","429","252","177","5","434","882","0","49.21","28.57"
"65","000","00","060","0011","2217","443","298","145","1","444","1009","0","44.00","29.53"
"65","000","00","060","0011","2218","407","272","135","3","410","914","0","44.86","29.76"
"65","000","00","060","0012","0000","577","334","243","6","583","1541","0","37.83","21.67"
"65","000","00","060","0012","2221","577","334","243","6","583","1541","0","37.83","21.67"
"65","000","00","060","0013","0000","1283","632","651","5","1288","2878","0","44.75","21.96"
"65","000","00","060","0013","2222","656","332","324","4","660","1460","0","45.21","22.74"
"65","000","00","060","0013","2223","627","300","327","1","628","1418","0","44.29","21.16"
"65","000","00","060","0014","0000","3369","2040","1329","27","3396","8098","0","41.94","25.19"
"65","000","00","060","0014","2224","644","413","231","5","649","1338","0","48.51","30.87"
"65","000","00","060","0014","2225","551","344","207","6","557","1317","0","42.29","26.12"
"65","000","00","060","0014","2226","440","224","216","2","442","1268","0","34.86","17.67"
"65","000","00","060","0014","2227","536","317","219","4","540","1382","0","39.07","22.94"
"65","000","00","060","0014","2228","575","340","235","5","580","1401","0","41.40","24.27"
"65","000","00","060","0014","2229","623","402","221","5","628","1392","0","45.11","28.88"
"65","000","00","060","0015","0000","1991","1141","850","13","2004","4606","0","43.51","24.77"
"65","000","00","060","0015","2235","507","305","202","1","508","1107","0","45.89","27.55"
"65","000","00","060","0015","2236","518","308","210","3","521","1192","0","43.71","25.84"
"65","000","00","060","0015","2237","445","238","207","1","446","1126","0","39.61","21.14"
"65","000","00","060","0015","2238","521","290","231","8","529","1181","0","44.79","24.56"
"65","000","00","060","0016","0000","4955","3052","1903","41","4996","11616","0","43.01","26.27"
"65","000","00","060","0016","2246","549","329","220","5","554","1259","0","44.00","26.13"
"65","000","00","060","0016","2247","541","315","226","4","545","1277","0","42.68","24.67"
"65","000","00","060","0016","2248","551","342","209","6","557","1322","0","42.13","25.87"
"65","000","00","060","0016","2249","548","329","219","4","552","1299","0","42.49","25.33"
"65","000","00","060","0016","2250","536","314","222","7","543","1242","0","43.72","25.28"
"65","000","00","060","0016","2251","532","353","179","2","534","1242","0","43.00","28.42"
"65","000","00","060","0016","2252","510","310","200","4","514","1307","0","39.33","23.72"
"65","000","00","060","0016","2253","591","390","201","3","594","1310","0","45.34","29.77"
"65","000","00","060","0016","2254","597","370","227","6","603","1358","0","44.40","27.25"
"65","000","00","060","0017","0000","2216","1224","992","22","2238","5492","0","40.75","22.29"
"65","000","00","060","0017","2259","571","321","250","6","577","1324","0","43.58","24.24"
"65","000","00","060","0017","2260","568","327","241","4","572","1328","0","43.07","24.62"
"65","000","00","060","0017","2261","591","328","263","8","599","1461","0","41.00","22.45"
"65","000","00","060","0017","2262","486","248","238","4","490","1379","0","35.53","17.98"
"65","000","00","060","0018","0000","2114","1180","934","20","2134","5146","0","41.47","22.93"
"65","000","00","060","0018","2271","518","284","234","6","524","1359","0","38.56","20.90"
"65","000","00","060","0018","2272","452","248","204","2","454","1145","0","39.65","21.66"
"65","000","00","060","0018","2273","624","384","240","6","630","1442","0","43.69","26.63"
"65","000","00","060","0018","2274","520","264","256","6","526","1200","0","43.83","22.00"
"65","000","00","060","0019","0000","1983","1037","946","17","2000","5288","0","37.82","19.61"
"65","000","00","060","0019","2283","509","255","254","3","512","1438","0","35.61","17.73"
"65","000","00","060","0019","2284","464","232","232","6","470","1232","0","38.15","18.83"
"65","000","00","060","0019","2285","525","289","236","3","528","1307","0","40.40","22.11"
"65","000","00","060","0019","2286","485","261","224","5","490","1311","0","37.38","19.91"
"65","000","00","060","0020","0000","2371","1525","846","12","2383","5383","0","44.27","28.33"
"65","000","00","060","0020","2287","512","324","188","1","513","1151","0","44.57","28.15"
"65","000","00","060","0020","2288","576","368","208","5","581","1311","0","44.32","28.07"
"65","000","00","060","0020","2289","563","350","213","3","566","1291","0","43.84","27.11"
"65","000","00","060","0020","2290","720","483","237","3","723","1630","0","44.36","29.63"
"65","000","00","060","0021","0000","375","99","276","7","382","928","0","41.16","10.67"
"65","000","00","060","0021","2295","375","99","276","7","382","928","0","41.16","10.67"
"65","000","00","060","0022","0000","2082","1282","800","17","2099","4705","0","44.61","27.25"
"65","000","00","060","0022","2302","479","306","173","5","484","1147","0","42.20","26.68"
"65","000","00","060","0022","2303","538","317","221","1","539","1274","0","42.31","24.88"
"65","000","00","060","0022","2304","492","269","223","6","498","1173","0","42.46","22.93"
"65","000","00","060","0022","2305","573","390","183","5","578","1111","0","52.03","35.10"
"65","000","00","060","0023","0000","1965","1166","799","21","1986","4714","0","42.13","24.73"
"65","000","00","060","0023","2306","597","371","226","7","604","1449","0","41.68","25.60"
"65","000","00","060","0023","2307","818","537","281","8","826","1912","0","43.20","28.09"
"65","000","00","060","0023","2308","550","258","292","6","556","1353","0","41.09","19.07"
"65","000","00","060","0024","0000","252","107","145","3","255","726","0","35.12","14.74"
"65","000","00","060","0024","2309","252","107","145","3","255","726","0","35.12","14.74"
"65","000","00","060","0025","0000","1388","704","684","9","1397","2813","0","49.66","25.03"
"65","000","00","060","0025","2310","282","125","157","1","283","562","0","50.36","22.24"
"65","000","00","060","0025","2311","398","209","189","3","401","879","0","45.62","23.78"
"65","000","00","060","0025","2312","500","284","216","4","504","927","0","54.37","30.64"
"65","000","00","060","0025","2313","208","86","122","1","209","445","0","46.97","19.33"
"65","000","00","060","0026","0000","942","449","493","9","951","2253","0","42.21","19.93"
"65","000","00","060","0026","2314","483","195","288","5","488","1100","0","44.36","17.73"
"65","000","00","060","0026","2315","459","254","205","4","463","1153","0","40.16","22.03"
"65","000","00","060","0027","0000","634","297","337","6","640","1598","0","40.05","18.59"
"65","000","00","060","0027","2316","634","297","337","6","640","1598","0","40.05","18.59"
"65","000","00","060","0028","0000","496","189","307","8","504","1264","0","39.87","14.95"
"65","000","00","060","0028","2317","496","189","307","8","504","1264","0","39.87","14.95"
"65","000","00","060","0029","0000","512","196","316","4","516","1196","0","43.14","16.39"
"65","000","00","060","0029","2318","147","38","109","2","149","431","0","34.57","8.82"
"65","000","00","060","0029","2319","365","158","207","2","367","765","0","47.97","20.65"
"65","000","00","060","0030","0000","2064","1192","872","15","2079","4825","0","43.09","24.70"
"65","000","00","060","0030","2298","602","337","265","7","609","1361","0","44.75","24.76"
"65","000","00","060","0030","2299","491","281","210","2","493","1168","0","42.21","24.06"
"65","000","00","060","0030","2300","442","277","165","3","445","1029","0","43.25","26.92"
"65","000","00","060","0030","2301","529","297","232","3","532","1267","0","41.99","23.44"
"65","000","00","060","0031","0000","758","380","378","3","761","1629","0","46.72","23.33"
"65","000","00","060","0031","2105","758","380","378","3","761","1629","0","46.72","23.33"
"65","000","00","060","0032","0000","1079","670","409","5","1084","2137","0","50.73","31.35"
"65","000","00","060","0032","2106","483","325","158","2","485","858","0","56.53","37.88"
"65","000","00","060","0032","2107","596","345","251","3","599","1279","0","46.83","26.97"
"65","000","00","060","0033","0000","1027","587","440","9","1036","2320","0","44.66","25.30"
"65","000","00","060","0033","2108","472","257","215","5","477","1098","0","43.44","23.41"
"65","000","00","060","0033","2109","555","330","225","4","559","1222","0","45.74","27.00"
"65","000","00","060","0034","0000","731","475","256","10","741","1575","0","47.05","30.16"
"65","000","00","060","0034","2110","731","475","256","10","741","1575","0","47.05","30.16"
"65","000","00","060","0035","0000","412","193","219","5","417","782","0","53.32","24.68"
"65","000","00","060","0035","2111","412","193","219","5","417","782","0","53.32","24.68"
"65","000","00","060","0036","0000","1130","605","525","7","1137","2230","0","50.99","27.13"
"65","000","00","060","0036","2112","632","319","313","2","634","1280","0","49.53","24.92"
"65","000","00","060","0036","2113","498","286","212","5","503","950","0","52.95","30.11"
"65","000","00","060","0037","0000","2403","1570","833","21","2424","6858","0","35.35","22.89"
"65","000","00","060","0037","2114","592","391","201","7","599","1221","0","49.06","32.02"
"65","000","00","060","0037","2115","712","482","230","6","718","3419","0","21.00","14.10"
"65","000","00","060","0037","2116","663","439","224","4","667","1257","0","53.06","34.92"
"65","000","00","060","0037","2117","436","258","178","4","440","961","0","45.79","26.85"
"65","000","00","060","0038","0000","2618","1678","940","30","2648","5204","0","50.88","32.24"
"65","000","00","060","0038","2118","420","265","155","11","431","898","0","48.00","29.51"
"65","000","00","060","0038","2119","924","674","250","7","931","1598","0","58.26","42.18"
"65","000","00","060","0038","2120","635","361","274","3","638","1327","0","48.08","27.20"
"65","000","00","060","0038","2121","639","378","261","9","648","1381","0","46.92","27.37"
"65","000","00","060","0039","0000","1085","641","444","7","1092","2418","0","45.16","26.51"
"65","000","00","060","0039","2122","546","331","215","4","550","1223","0","44.97","27.06"
"65","000","00","060","0039","2123","539","310","229","3","542","1195","0","45.36","25.94"
"65","000","00","060","0040","0000","3675","2416","1259","38","3713","8055","0","46.10","29.99"
"65","000","00","060","0040","2124","541","324","217","5","546","1251","0","43.65","25.90"
"65","000","00","060","0040","2125","632","390","242","10","642","1271","0","50.51","30.68"
"65","000","00","060","0040","2126","641","398","243","3","644","1432","0","44.97","27.79"
"65","000","00","060","0040","2127","676","493","183","8","684","1477","0","46.31","33.38"
"65","000","00","060","0040","2128","615","403","212","7","622","1382","0","45.01","29.16"
"65","000","00","060","0040","2129","570","408","162","5","575","1242","0","46.30","32.85"
"65","000","00","060","0041","0000","3333","2097","1236","27","3360","6910","0","48.63","30.35"
"65","000","00","060","0041","2130","530","336","194","3","533","1119","0","47.63","30.03"
"65","000","00","060","0041","2131","601","365","236","4","605","1189","0","50.88","30.70"
"65","000","00","060","0041","2132","517","326","191","4","521","1134","0","45.94","28.75"
"65","000","00","060","0041","2133","541","334","207","5","546","1106","0","49.37","30.20"
"65","000","00","060","0041","2134","602","421","181","7","609","1192","0","51.09","35.32"
"65","000","00","060","0041","2135","542","315","227","4","546","1170","0","46.67","26.92"
"65","000","00","060","0042","0000","1744","1165","579","19","1763","3647","0","48.34","31.94"
"65","000","00","060","0042","2138","569","380","189","6","575","1114","0","51.62","34.11"
"65","000","00","060","0042","2139","226","147","79","3","229","507","0","45.17","28.99"
"65","000","00","060","0042","2140","447","293","154","1","448","938","0","47.76","31.24"
"65","000","00","060","0042","2141","502","345","157","9","511","1088","0","46.97","31.71"
"65","000","00","060","0043","0000","1155","742","413","4","1159","2185","0","53.04","33.96"
"65","000","00","060","0043","2142","625","419","206","0","625","1105","0","56.56","37.92"
"65","000","00","060","0043","2143","530","323","207","4","534","1080","0","49.44","29.91"
"65","000","00","060","0044","0000","2614","1689","925","32","2646","5458","0","48.48","30.95"
"65","000","00","060","0044","2144","720","427","293","9","729","1416","0","51.48","30.16"
"65","000","00","060","0044","2145","609","372","237","4","613","1353","0","45.31","27.49"
"65","000","00","060","0044","2146","709","485","224","13","722","1336","0","54.04","36.30"
"65","000","00","060","0044","2147","576","405","171","6","582","1353","0","43.02","29.93"
"65","000","00","060","0045","0000","1874","1279","595","18","1892","3832","0","49.37","33.38"
"65","000","00","060","0045","2148","621","420","201","6","627","1247","0","50.28","33.68"
"65","000","00","060","0045","2149","607","415","192","3","610","1201","0","50.79","34.55"
"65","000","00","060","0045","2150","646","444","202","9","655","1384","0","47.33","32.08"
"65","000","00","060","0046","0000","934","633","301","3","937","1791","0","52.32","35.34"
"65","000","00","060","0046","2151","476","317","159","2","478","919","0","52.01","34.49"
"65","000","00","060","0046","2152","458","316","142","1","459","872","0","52.64","36.24"
"65","000","00","060","0047","0000","1644","1094","550","19","1663","3376","0","49.26","32.41"
"65","000","00","060","0047","2155","411","277","134","4","415","922","0","45.01","30.04"
"65","000","00","060","0047","2156","538","365","173","6","544","1082","0","50.28","33.73"
"65","000","00","060","0047","2157","695","452","243","9","704","1372","0","51.31","32.94"
"65","000","00","060","0048","0000","1411","892","519","9","1420","2847","0","49.88","31.33"
"65","000","00","060","0048","2158","725","450","275","4","729","1420","0","51.34","31.69"
"65","000","00","060","0048","2159","686","442","244","5","691","1427","0","48.42","30.97"
"65","000","00","060","0049","0000","1573","1002","571","15","1588","3469","0","45.78","28.88"
"65","000","00","060","0049","2160","496","325","171","4","500","1183","0","42.27","27.47"
"65","000","00","060","0049","2161","631","411","220","6","637","1283","0","49.65","32.03"
"65","000","00","060","0049","2162","446","266","180","5","451","1003","0","44.97","26.52"
"65","000","00","060","0050","0000","1684","1075","609","8","1692","3294","0","51.37","32.64"
"65","000","00","060","0050","2163","581","384","197","4","585","1113","0","52.56","34.50"
"65","000","00","060","0050","2164","510","319","191","3","513","1035","0","49.57","30.82"
"65","000","00","060","0050","2165","593","372","221","1","594","1146","0","51.83","32.46"
"65","000","00","060","0051","0000","1837","1299","538","12","1849","3726","0","49.62","34.86"
"65","000","00","060","0051","2166","704","492","212","6","710","1277","0","55.60","38.53"
"65","000","00","060","0051","2167","615","438","177","4","619","1282","0","48.28","34.17"
"65","000","00","060","0051","2168","518","369","149","2","520","1167","0","44.56","31.62"
"65","000","00","060","0052","0000","2327","1603","724","18","2345","4191","0","55.95","38.25"
"65","000","00","060","0052","2169","471","339","132","3","474","872","0","54.36","38.88"
"65","000","00","060","0052","2170","1070","714","356","8","1078","1924","0","56.03","37.11"
"65","000","00","060","0052","2171","786","550","236","7","793","1395","0","56.85","39.43"
"65","000","00","060","0053","0000","548","362","186","16","564","1240","0","45.48","29.19"
"65","000","00","060","0053","2172","247","163","84","7","254","573","0","44.33","28.45"
"65","000","00","060","0053","2173","301","199","102","9","310","667","0","46.48","29.84"
"65","000","00","060","0054","0000","2867","1921","946","22","2889","5278","0","54.74","36.40"
"65","000","00","060","0054","2174","777","511","266","7","784","1436","0","54.60","35.58"
"65","000","00","060","0054","2175","637","439","198","6","643","1195","0","53.81","36.74"
"65","000","00","060","0054","2176","764","508","256","7","771","1403","0","54.95","36.21"
"65","000","00","060","0054","2177","689","463","226","2","691","1244","0","55.55","37.22"
"65","000","00","060","0055","0000","1470","999","471","4","1474","3130","0","47.09","31.92"
"65","000","00","060","0055","2266","801","534","267","4","805","1707","0","47.16","31.28"
"65","000","00","060","0055","2267","669","465","204","0","669","1423","0","47.01","32.68"
"65","000","00","060","0056","0000","3092","1834","1258","32","3124","7029","0","44.44","26.09"
"65","000","00","060","0056","2230","780","485","295","8","788","1612","0","48.88","30.09"
"65","000","00","060","0056","2231","582","333","249","5","587","1376","0","42.66","24.20"
"65","000","00","060","0056","2232","600","344","256","6","606","1368","0","44.30","25.15"
"65","000","00","060","0056","2233","586","361","225","9","595","1328","0","44.80","27.18"
"65","000","00","060","0056","2234","544","311","233","4","548","1345","0","40.74","23.12"
"65","000","00","060","0057","0000","2026","1403","623","26","2052","4302","0","47.70","32.61"
"65","000","00","060","0057","2291","578","410","168","5","583","1226","0","47.55","33.44"
"65","000","00","060","0057","2292","574","409","165","6","580","1283","0","45.21","31.88"
"65","000","00","060","0057","2293","493","335","158","9","502","1032","0","48.64","32.46"
"65","000","00","060","0057","2294","381","249","132","6","387","761","0","50.85","32.72"
"65","000","00","060","0058","0000","3227","2031","1196","21","3248","6458","0","50.29","31.45"
"65","000","00","060","0058","2199","746","506","240","4","750","1341","0","55.93","37.73"
"65","000","00","060","0058","2200","599","314","285","6","605","1330","0","45.49","23.61"
"65","000","00","060","0058","2201","337","185","152","4","341","889","0","38.36","20.81"
"65","000","00","060","0058","2202","771","523","248","1","772","1413","0","54.64","37.01"
"65","000","00","060","0058","2203","774","503","271","6","780","1485","0","52.53","33.87"
"65","000","00","060","0059","0000","1661","1085","576","12","1673","3305","0","50.62","32.83"
"65","000","00","060","0059","2268","591","371","220","5","596","1133","0","52.60","32.74"
"65","000","00","060","0059","2269","584","396","188","5","589","1178","0","50.00","33.62"
"65","000","00","060","0059","2270","486","318","168","2","488","994","0","49.09","31.99"
"65","000","00","060","0060","0000","4461","3006","1455","44","4505","10096","0","44.62","29.77"
"65","000","00","060","0060","2275","672","408","264","4","676","1451","0","46.59","28.12"
"65","000","00","060","0060","2276","541","355","186","1","542","1170","0","46.32","30.34"
"65","000","00","060","0060","2277","521","355","166","6","527","1235","0","42.67","28.74"
"65","000","00","060","0060","2278","500","370","130","5","505","1262","0","40.02","29.32"
"65","000","00","060","0060","2279","449","316","133","6","455","1030","0","44.17","30.68"
"65","000","00","060","0060","2280","411","281","130","8","419","1123","0","37.31","25.02"
"65","000","00","060","0060","2281","621","414","207","6","627","1161","0","54.01","35.66"
"65","000","00","060","0060","2282","746","507","239","8","754","1664","0","45.31","30.47"
"65","000","00","060","0061","0000","1386","967","419","13","1399","2786","0","50.22","34.71"
"65","000","00","060","0061","2153","684","479","205","5","689","1436","0","47.98","33.36"
"65","000","00","060","0061","2154","702","488","214","8","710","1350","0","52.59","36.15"
"65","000","00","060","0062","0000","1194","726","468","8","1202","2930","0","41.02","24.78"
"65","000","00","060","0062","2193","556","305","251","3","559","1430","0","39.09","21.33"
"65","000","00","060","0062","2194","638","421","217","5","643","1500","0","42.87","28.07"
"65","000","00","060","0063","0000","1134","692","442","14","1148","2466","0","46.55","28.06"
"65","000","00","060","0063","2219","565","343","222","6","571","1244","0","45.90","27.57"
"65","000","00","060","0063","2220","569","349","220","8","577","1222","0","47.22","28.56"
"65","000","00","060","0064","0000","2259","1403","856","21","2280","4853","0","46.98","28.91"
"65","000","00","060","0064","2255","524","324","200","5","529","1202","0","44.01","26.96"
"65","000","00","060","0064","2256","530","312","218","4","534","1151","0","46.39","27.11"
"65","000","00","060","0064","2257","629","428","201","7","636","1313","0","48.44","32.60"
"65","000","00","060","0064","2258","576","339","237","5","581","1187","0","48.95","28.56"
"65","000","00","060","0065","0000","1227","779","448","8","1235","2304","0","53.60","33.81"
"65","000","00","060","0065","2136","632","385","247","2","634","1178","0","53.82","32.68"
"65","000","00","060","0065","2137","595","394","201","6","601","1126","0","53.37","34.99"
"65","000","00","060","0066","0000","1655","1077","578","17","1672","3718","0","44.97","28.97"
"65","000","00","060","0066","2239","563","395","168","6","569","1296","0","43.90","30.48"
"65","000","00","060","0066","2240","583","375","208","8","591","1276","0","46.32","29.39"
"65","000","00","060","0066","2241","509","307","202","3","512","1146","0","44.68","26.79"
"65","000","00","060","0067","0000","2191","1302","889","19","2210","4949","0","44.66","26.31"
"65","000","00","060","0067","2242","513","312","201","4","517","1278","0","40.45","24.41"
"65","000","00","060","0067","2243","621","394","227","2","623","1230","0","50.65","32.03"
"65","000","00","060","0067","2244","562","328","234","9","571","1299","0","43.96","25.25"
"65","000","00","060","0067","2245","495","268","227","4","499","1142","0","43.70","23.47"
"65","000","00","060","0068","0000","1665","1172","493","14","1679","3614","0","46.46","32.43"
"65","000","00","060","0068","2263","335","235","100","3","338","799","0","42.30","29.41"
"65","000","00","060","0068","2264","613","422","191","5","618","1213","0","50.95","34.79"
"65","000","00","060","0068","2265","717","515","202","6","723","1602","0","45.13","32.15"
"65","000","00","060","0069","0000","1303","795","508","16","1319","2551","0","51.71","31.16"
"65","000","00","060","0069","2296","541","327","214","8","549","1042","0","52.69","31.38"
"65","000","00","060","0069","2297","762","468","294","8","770","1509","0","51.03","31.01"
"65","000","00","070","0000","0000","61503","28162","33341","517","62020","152907","182668","40.56","18.42"
"65","000","00","070","0001","0000","1392","585","807","9","1401","3594","0","38.98","16.28"
"65","000","00","070","0001","1726","675","277","398","7","682","1939","0","35.17","14.29"
"65","000","00","070","0001","1727","717","308","409","2","719","1655","0","43.44","18.61"
"65","000","00","070","0002","0000","1334","625","709","19","1353","3437","0","39.37","18.18"
"65","000","00","070","0002","1723","417","188","229","5","422","1105","0","38.19","17.01"
"65","000","00","070","0002","1724","411","194","217","7","418","1093","0","38.24","17.75"
"65","000","00","070","0002","1725","506","243","263","7","513","1239","0","41.40","19.61"
"65","000","00","070","0003","0000","1568","675","893","12","1580","4203","0","37.59","16.06"
"65","000","00","070","0003","1720","435","190","245","3","438","1189","0","36.84","15.98"
"65","000","00","070","0003","1721","513","236","277","5","518","1351","0","38.34","17.47"
"65","000","00","070","0003","1722","620","249","371","4","624","1663","0","37.52","14.97"
"65","000","00","070","0004","0000","1327","526","801","15","1342","3354","0","40.01","15.68"
"65","000","00","070","0004","1749","453","180","273","6","459","1041","0","44.09","17.29"
"65","000","00","070","0004","1750","426","159","267","6","432","1133","0","38.13","14.03"
"65","000","00","070","0004","1751","448","187","261","3","451","1180","0","38.22","15.85"
"65","000","00","070","0005","0000","2352","1084","1268","22","2374","5473","0","43.38","19.81"
"65","000","00","070","0005","1745","626","254","372","7","633","1476","0","42.89","17.21"
"65","000","00","070","0005","1746","689","352","337","6","695","1500","0","46.33","23.47"
"65","000","00","070","0005","1747","602","288","314","7","609","1443","0","42.20","19.96"
"65","000","00","070","0005","1748","435","190","245","2","437","1054","0","41.46","18.03"
"65","000","00","070","0006","0000","1549","665","884","14","1563","4463","0","35.02","14.90"
"65","000","00","070","0006","1739","537","178","359","6","543","2105","0","25.80","8.46"
"65","000","00","070","0006","1740","392","202","190","4","396","870","0","45.52","23.22"
"65","000","00","070","0006","1741","620","285","335","4","624","1488","0","41.94","19.15"
"65","000","00","070","0007","0000","1551","610","941","10","1561","4406","0","35.43","13.84"
"65","000","00","070","0007","1730","575","210","365","4","579","1428","0","40.55","14.71"
"65","000","00","070","0007","1731","508","193","315","1","509","1439","0","35.37","13.41"
"65","000","00","070","0007","1732","468","207","261","5","473","1539","0","30.73","13.45"
"65","000","00","070","0008","0000","1490","726","764","11","1501","3190","0","47.05","22.76"
"65","000","00","070","0008","1758","393","202","191","5","398","883","0","45.07","22.88"
"65","000","00","070","0008","1759","646","302","344","3","649","1314","0","49.39","22.98"
"65","000","00","070","0008","1760","451","222","229","3","454","993","0","45.72","22.36"
"65","000","00","070","0009","0000","2098","1015","1083","16","2114","4496","0","47.02","22.58"
"65","000","00","070","0009","1763","668","333","335","4","672","1381","0","48.66","24.11"
"65","000","00","070","0009","1764","751","369","382","4","755","1580","0","47.78","23.35"
"65","000","00","070","0009","1765","679","313","366","8","687","1535","0","44.76","20.39"
"65","000","00","070","0010","0000","1627","747","880","9","1636","3699","0","44.23","20.19"
"65","000","00","070","0010","1773","515","202","313","3","518","1189","0","43.57","16.99"
"65","000","00","070","0010","1774","580","282","298","2","582","1306","0","44.56","21.59"
"65","000","00","070","0010","1775","532","263","269","4","536","1204","0","44.52","21.84"
"65","000","00","070","0011","0000","1217","645","572","11","1228","2937","0","41.81","21.96"
"65","000","00","070","0011","1769","693","373","320","6","699","1698","0","41.17","21.97"
"65","000","00","070","0011","1770","524","272","252","5","529","1239","0","42.70","21.95"
"65","000","00","070","0012","0000","586","237","349","5","591","1506","0","39.24","15.74"
"65","000","00","070","0012","1776","586","237","349","5","591","1506","0","39.24","15.74"
"65","000","00","070","0013","0000","443","221","222","3","446","1073","0","41.57","20.60"
"65","000","00","070","0013","1777","443","221","222","3","446","1073","0","41.57","20.60"
"65","000","00","070","0014","0000","1317","665","652","6","1323","3130","0","42.27","21.25"
"65","000","00","070","0014","1792","677","355","322","3","680","1495","0","45.48","23.75"
"65","000","00","070","0014","1793","640","310","330","3","643","1635","0","39.33","18.96"
"65","000","00","070","0015","0000","1342","552","790","12","1354","3345","0","40.48","16.50"
"65","000","00","070","0015","1782","505","240","265","1","506","1218","0","41.54","19.70"
"65","000","00","070","0015","1783","424","168","256","3","427","1087","0","39.28","15.46"
"65","000","00","070","0015","1784","413","144","269","8","421","1040","0","40.48","13.85"
"65","000","00","070","0016","0000","1550","651","899","17","1567","4373","0","35.83","14.89"
"65","000","00","070","0016","1789","547","212","335","5","552","1502","0","36.75","14.11"
"65","000","00","070","0016","1790","518","230","288","4","522","1432","0","36.45","16.06"
"65","000","00","070","0016","1791","485","209","276","8","493","1439","0","34.26","14.52"
"65","000","00","070","0017","0000","1821","824","997","12","1833","4657","0","39.36","17.69"
"65","000","00","070","0017","1779","639","315","324","5","644","1718","0","37.49","18.34"
"65","000","00","070","0017","1780","589","223","366","5","594","1506","0","39.44","14.81"
"65","000","00","070","0017","1781","593","286","307","2","595","1433","0","41.52","19.96"
"65","000","00","070","0018","0000","1098","456","642","14","1112","2876","0","38.66","15.86"
"65","000","00","070","0018","1805","647","267","380","7","654","1634","0","40.02","16.34"
"65","000","00","070","0018","1806","451","189","262","7","458","1242","0","36.88","15.22"
"65","000","00","070","0019","0000","1989","941","1048","11","2000","5229","0","38.25","18.00"
"65","000","00","070","0019","1801","498","232","266","2","500","1284","0","38.94","18.07"
"65","000","00","070","0019","1802","448","208","240","1","449","1236","0","36.33","16.83"
"65","000","00","070","0019","1803","478","227","251","4","482","1378","0","34.98","16.47"
"65","000","00","070","0019","1804","565","274","291","4","569","1331","0","42.75","20.59"
"65","000","00","070","0020","0000","1774","787","987","17","1791","4435","0","40.38","17.75"
"65","000","00","070","0020","1798","768","304","464","6","774","1881","0","41.15","16.16"
"65","000","00","070","0020","1799","653","302","351","7","660","1685","0","39.17","17.92"
"65","000","00","070","0020","1800","353","181","172","4","357","869","0","41.08","20.83"
"65","000","00","070","0021","0000","630","281","349","4","634","1769","0","35.84","15.88"
"65","000","00","070","0021","1814","630","281","349","4","634","1769","0","35.84","15.88"
"65","000","00","070","0022","0000","605","185","420","1","606","1494","0","40.56","12.38"
"65","000","00","070","0022","1828","605","185","420","1","606","1494","0","40.56","12.38"
"65","000","00","070","0023","0000","638","222","416","9","647","1602","0","40.39","13.86"
"65","000","00","070","0023","1820","638","222","416","9","647","1602","0","40.39","13.86"
"65","000","00","070","0024","0000","5266","2887","2379","28","5294","12321","0","42.97","23.43"
"65","000","00","070","0024","1821","723","332","391","7","730","1661","0","43.95","19.99"
"65","000","00","070","0024","1822","703","369","334","2","705","1589","0","44.37","23.22"
"65","000","00","070","0024","1823","866","492","374","4","870","1818","0","47.85","27.06"
"65","000","00","070","0024","1824","808","462","346","3","811","1807","0","44.88","25.57"
"65","000","00","070","0024","1825","784","468","316","2","786","1741","0","45.15","26.88"
"65","000","00","070","0024","1826","706","389","317","5","711","1890","0","37.62","20.58"
"65","000","00","070","0024","1827","676","375","301","5","681","1815","0","37.52","20.66"
"65","000","00","070","0025","0000","788","266","522","8","796","1967","0","40.47","13.52"
"65","000","00","070","0025","1829","360","135","225","2","362","926","0","39.09","14.58"
"65","000","00","070","0025","1830","428","131","297","6","434","1041","0","41.69","12.58"
"65","000","00","070","0026","0000","3496","1915","1581","24","3520","8030","0","43.84","23.85"
"65","000","00","070","0026","1815","557","212","345","5","562","1414","0","39.75","14.99"
"65","000","00","070","0026","1816","730","405","325","4","734","1769","0","41.49","22.89"
"65","000","00","070","0026","1817","781","453","328","3","784","1718","0","45.63","26.37"
"65","000","00","070","0026","1818","831","475","356","8","839","1722","0","48.72","27.58"
"65","000","00","070","0026","1819","597","370","227","4","601","1407","0","42.71","26.30"
"65","000","00","070","0027","0000","428","207","221","2","430","853","0","50.41","24.27"
"65","000","00","070","0027","1778","428","207","221","2","430","853","0","50.41","24.27"
"65","000","00","070","0028","0000","1534","719","815","9","1543","3833","0","40.26","18.76"
"65","000","00","070","0028","1752","579","291","288","0","579","1521","0","38.07","19.13"
"65","000","00","070","0028","1753","483","224","259","5","488","1147","0","42.55","19.53"
"65","000","00","070","0028","1754","472","204","268","4","476","1165","0","40.86","17.51"
"65","000","00","070","0029","0000","1326","639","687","14","1340","3184","0","42.09","20.07"
"65","000","00","070","0029","1766","395","215","180","3","398","1021","0","38.98","21.06"
"65","000","00","070","0029","1767","519","240","279","8","527","1182","0","44.59","20.30"
"65","000","00","070","0029","1768","412","184","228","3","415","981","0","42.30","18.76"
"65","000","00","070","0030","0000","1500","698","802","22","1522","3145","0","48.39","22.19"
"65","000","00","070","0030","1761","734","351","383","13","747","1619","0","46.14","21.68"
"65","000","00","070","0030","1762","766","347","419","9","775","1526","0","50.79","22.74"
"65","000","00","070","0031","0000","1360","574","786","6","1366","3600","0","37.94","15.94"
"65","000","00","070","0031","1733","465","185","280","1","466","1168","0","39.90","15.84"
"65","000","00","070","0031","1734","434","183","251","2","436","1301","0","33.51","14.07"
"65","000","00","070","0031","1735","461","206","255","3","464","1131","0","41.03","18.21"
"65","000","00","070","0032","0000","1468","606","862","18","1486","3906","0","38.04","15.51"
"65","000","00","070","0032","1736","450","196","254","7","457","1224","0","37.34","16.01"
"65","000","00","070","0032","1737","537","215","322","6","543","1374","0","39.52","15.65"
"65","000","00","070","0032","1738","481","195","286","5","486","1308","0","37.16","14.91"
"65","000","00","070","0033","0000","1817","766","1051","17","1834","5086","0","36.06","15.06"
"65","000","00","070","0033","1785","406","175","231","2","408","1134","0","35.98","15.43"
"65","000","00","070","0033","1786","397","197","200","5","402","1201","0","33.47","16.40"
"65","000","00","070","0033","1787","455","183","272","7","462","1264","0","36.55","14.48"
"65","000","00","070","0033","1788","559","211","348","3","562","1487","0","37.79","14.19"
"65","000","00","070","0034","0000","1841","853","988","21","1862","4401","0","42.31","19.38"
"65","000","00","070","0034","1742","600","268","332","6","606","1397","0","43.38","19.18"
"65","000","00","070","0034","1743","619","283","336","11","630","1455","0","43.30","19.45"
"65","000","00","070","0034","1744","622","302","320","4","626","1549","0","40.41","19.50"
"65","000","00","070","0035","0000","1876","820","1056","15","1891","5096","0","37.11","16.09"
"65","000","00","070","0035","1807","428","174","254","3","431","1320","0","32.65","13.18"
"65","000","00","070","0035","1808","601","244","357","5","606","1594","0","38.02","15.31"
"65","000","00","070","0035","1809","405","210","195","4","409","1062","0","38.51","19.77"
"65","000","00","070","0035","1810","442","192","250","3","445","1120","0","39.73","17.14"
"65","000","00","070","0036","0000","1830","791","1039","27","1857","4640","0","40.02","17.05"
"65","000","00","070","0036","1811","645","281","364","7","652","1604","0","40.65","17.52"
"65","000","00","070","0036","1812","626","297","329","8","634","1501","0","42.24","19.79"
"65","000","00","070","0036","1813","559","213","346","12","571","1535","0","37.20","13.88"
"65","000","00","070","0037","0000","1245","582","663","12","1257","2790","0","45.05","20.86"
"65","000","00","070","0037","1771","644","278","366","7","651","1461","0","44.56","19.03"
"65","000","00","070","0037","1772","601","304","297","5","606","1329","0","45.60","22.87"
"65","000","00","070","0038","0000","1108","548","560","9","1117","3019","0","37.00","18.15"
"65","000","00","070","0038","1794","568","273","295","3","571","1594","0","35.82","17.13"
"65","000","00","070","0038","1795","540","275","265","6","546","1425","0","38.32","19.30"
"65","000","00","070","0039","0000","859","362","497","6","865","2412","0","35.86","15.01"
"65","000","00","070","0039","1796","413","185","228","2","415","1168","0","35.53","15.84"
"65","000","00","070","0039","1797","446","177","269","4","450","1244","0","36.17","14.23"
"65","000","00","070","0040","0000","1030","480","550","14","1044","2578","0","40.50","18.62"
"65","000","00","070","0040","1755","515","228","287","2","517","1260","0","41.03","18.10"
"65","000","00","070","0040","1756","515","252","263","12","527","1318","0","39.98","19.12"
"65","000","00","070","0041","0000","613","189","424","1","614","1430","0","42.94","13.22"
"65","000","00","070","0041","1757","613","189","424","1","614","1430","0","42.94","13.22"
"65","000","00","070","0042","0000","820","335","485","5","825","1875","0","44.00","17.87"
"65","000","00","070","0042","1728","294","114","180","3","297","737","0","40.30","15.47"
"65","000","00","070","0042","1729","526","221","305","2","528","1138","0","46.40","19.42"
"65","000","00","080","0000","0000","28931","13362","15569","250","29181","73981","88131","39.44","18.06"
"65","000","00","080","0001","0000","442","189","253","4","446","946","0","47.15","19.98"
"65","000","00","080","0001","1832","442","189","253","4","446","946","0","47.15","19.98"
"65","000","00","080","0002","0000","867","410","457","1","868","1968","0","44.11","20.83"
"65","000","00","080","0002","1836","451","222","229","0","451","978","0","46.11","22.70"
"65","000","00","080","0002","1837","416","188","228","1","417","990","0","42.12","18.99"
"65","000","00","080","0003","0000","2135","963","1172","15","2150","4997","0","43.03","19.27"
"65","000","00","080","0003","1839","756","332","424","9","765","1745","0","43.84","19.03"
"65","000","00","080","0003","1840","699","315","384","2","701","1634","0","42.90","19.28"
"65","000","00","080","0003","1841","680","316","364","4","684","1618","0","42.27","19.53"
"65","000","00","080","0004","0000","1473","753","720","21","1494","3748","0","39.86","20.09"
"65","000","00","080","0004","1833","433","213","220","10","443","967","0","45.81","22.03"
"65","000","00","080","0004","1834","501","246","255","5","506","1447","0","34.97","17.00"
"65","000","00","080","0004","1835","539","294","245","6","545","1334","0","40.85","22.04"
"65","000","00","080","0005","0000","464","193","271","3","467","940","0","49.68","20.53"
"65","000","00","080","0005","1838","464","193","271","3","467","940","0","49.68","20.53"
"65","000","00","080","0006","0000","241","109","132","0","241","518","0","46.53","21.04"
"65","000","00","080","0006","1831","241","109","132","0","241","518","0","46.53","21.04"
"65","000","00","080","0007","0000","636","271","365","2","638","1386","0","46.03","19.55"
"65","000","00","080","0007","1860","636","271","365","2","638","1386","0","46.03","19.55"
"65","000","00","080","0008","0000","2840","1316","1524","25","2865","7317","0","39.16","17.99"
"65","000","00","080","0008","1861","537","268","269","4","541","1292","0","41.87","20.74"
"65","000","00","080","0008","1862","529","249","280","2","531","1341","0","39.60","18.57"
"65","000","00","080","0008","1863","448","199","249","0","448","1229","0","36.45","16.19"
"65","000","00","080","0008","1864","450","224","226","4","454","1334","0","34.03","16.79"
"65","000","00","080","0008","1865","445","192","253","9","454","1027","0","44.21","18.70"
"65","000","00","080","0008","1866","431","184","247","6","437","1094","0","39.95","16.82"
"65","000","00","080","0009","0000","1320","550","770","9","1329","3154","0","42.14","17.44"
"65","000","00","080","0009","1857","390","186","204","3","393","884","0","44.46","21.04"
"65","000","00","080","0009","1858","592","223","369","5","597","1324","0","45.09","16.84"
"65","000","00","080","0009","1859","338","141","197","1","339","946","0","35.84","14.90"
"65","000","00","080","0010","0000","2932","1351","1581","37","2969","7755","0","38.28","17.42"
"65","000","00","080","0010","1852","676","317","359","8","684","1700","0","40.24","18.65"
"65","000","00","080","0010","1853","683","321","362","7","690","1670","0","41.32","19.22"
"65","000","00","080","0010","1854","514","246","268","2","516","1471","0","35.08","16.72"
"65","000","00","080","0010","1855","492","232","260","8","500","1295","0","38.61","17.92"
"65","000","00","080","0010","1856","567","235","332","12","579","1619","0","35.76","14.52"
"65","000","00","080","0011","0000","2662","1203","1459","17","2679","7334","0","36.53","16.40"
"65","000","00","080","0011","1847","533","230","303","1","534","1635","0","32.66","14.07"
"65","000","00","080","0011","1848","566","289","277","3","569","1547","0","36.78","18.68"
"65","000","00","080","0011","1849","467","220","247","2","469","1284","0","36.53","17.13"
"65","000","00","080","0011","1850","474","200","274","4","478","1279","0","37.37","15.64"
"65","000","00","080","0011","1851","622","264","358","7","629","1589","0","39.58","16.61"
"65","000","00","080","0012","0000","375","166","209","6","381","836","0","45.57","19.86"
"65","000","00","080","0012","1846","375","166","209","6","381","836","0","45.57","19.86"
"65","000","00","080","0013","0000","149","67","82","1","150","250","0","60.00","26.80"
"65","000","00","080","0013","1886","149","67","82","1","150","250","0","60.00","26.80"
"65","000","00","080","0014","0000","1875","923","952","15","1890","4527","0","41.75","20.39"
"65","000","00","080","0014","1879","582","262","320","6","588","1478","0","39.78","17.73"
"65","000","00","080","0014","1880","717","371","346","4","721","1698","0","42.46","21.85"
"65","000","00","080","0014","1881","576","290","286","5","581","1351","0","43.01","21.47"
"65","000","00","080","0015","0000","1750","826","924","22","1772","4996","0","35.47","16.53"
"65","000","00","080","0015","1873","523","246","277","4","527","1466","0","35.95","16.78"
"65","000","00","080","0015","1874","598","288","310","13","611","1714","0","35.65","16.80"
"65","000","00","080","0015","1875","629","292","337","5","634","1816","0","34.91","16.08"
"65","000","00","080","0016","0000","1476","704","772","11","1487","3896","0","38.17","18.07"
"65","000","00","080","0016","1876","522","244","278","3","525","1338","0","39.24","18.24"
"65","000","00","080","0016","1877","519","256","263","3","522","1282","0","40.72","19.97"
"65","000","00","080","0016","1878","435","204","231","5","440","1276","0","34.48","15.99"
"65","000","00","080","0017","0000","1706","817","889","22","1728","4275","0","40.42","19.11"
"65","000","00","080","0017","1867","612","287","325","7","619","1529","0","40.48","18.77"
"65","000","00","080","0017","1868","615","295","320","10","625","1496","0","41.78","19.72"
"65","000","00","080","0017","1869","479","235","244","5","484","1250","0","38.72","18.80"
"65","000","00","080","0018","0000","1829","882","947","11","1840","5088","0","36.16","17.33"
"65","000","00","080","0018","1882","525","237","288","5","530","1346","0","39.38","17.61"
"65","000","00","080","0018","1883","476","213","263","2","478","1250","0","38.24","17.04"
"65","000","00","080","0018","1884","483","258","225","1","484","1298","0","37.29","19.88"
"65","000","00","080","0018","1885","345","174","171","3","348","1194","0","29.15","14.57"
"65","000","00","080","0019","0000","1450","647","803","10","1460","3878","0","37.65","16.68"
"65","000","00","080","0019","1870","566","255","311","6","572","1510","0","37.88","16.89"
"65","000","00","080","0019","1871","448","198","250","1","449","1143","0","39.28","17.32"
"65","000","00","080","0019","1872","436","194","242","3","439","1225","0","35.84","15.84"
"65","000","00","080","0020","0000","2309","1022","1287","18","2327","6172","0","37.70","16.56"
"65","000","00","080","0020","1842","614","266","348","7","621","1544","0","40.22","17.23"
"65","000","00","080","0020","1843","576","241","335","4","580","1538","0","37.71","15.67"
"65","000","00","080","0020","1844","529","233","296","3","532","1496","0","35.56","15.57"
"65","000","00","080","0020","1845","590","282","308","4","594","1594","0","37.26","17.69"
"65","000","00","090","0000","0000","36210","17985","18225","320","36530","96164","116549","37.99","18.70"
"65","000","00","090","0001","0000","161","72","89","3","164","285","0","57.54","25.26"
"65","000","00","090","0001","2033","161","72","89","3","164","285","0","57.54","25.26"
"65","000","00","090","0002","0000","229","100","129","1","230","575","0","40.00","17.39"
"65","000","00","090","0002","2034","229","100","129","1","230","575","0","40.00","17.39"
"65","000","00","090","0003","0000","1350","684","666","15","1365","3542","0","38.54","19.31"
"65","000","00","090","0003","2035","388","201","187","4","392","991","0","39.56","20.28"
"65","000","00","090","0003","2036","477","253","224","5","482","1214","0","39.70","20.84"
"65","000","00","090","0003","2037","485","230","255","6","491","1337","0","36.72","17.20"
"65","000","00","090","0004","0000","1066","591","475","8","1074","3013","0","35.65","19.62"
"65","000","00","090","0004","2038","521","311","210","4","525","1465","0","35.84","21.23"
"65","000","00","090","0004","2039","545","280","265","4","549","1548","0","35.47","18.09"
"65","000","00","090","0005","0000","367","122","245","1","368","1027","0","35.83","11.88"
"65","000","00","090","0005","2040","367","122","245","1","368","1027","0","35.83","11.88"
"65","000","00","090","0006","0000","2549","1147","1402","26","2575","6463","0","39.84","17.75"
"65","000","00","090","0006","2041","539","234","305","4","543","1332","0","40.77","17.57"
"65","000","00","090","0006","2042","417","187","230","2","419","1094","0","38.30","17.09"
"65","000","00","090","0006","2043","508","249","259","8","516","1310","0","39.39","19.01"
"65","000","00","090","0006","2044","487","190","297","3","490","1218","0","40.23","15.60"
"65","000","00","090","0006","2045","598","287","311","9","607","1509","0","40.23","19.02"
"65","000","00","090","0007","0000","1912","938","974","22","1934","5237","0","36.93","17.91"
"65","000","00","090","0007","2069","495","243","252","3","498","1421","0","35.05","17.10"
"65","000","00","090","0007","2070","436","204","232","10","446","1229","0","36.29","16.60"
"65","000","00","090","0007","2071","478","233","245","5","483","1251","0","38.61","18.63"
"65","000","00","090","0007","2072","503","258","245","4","507","1336","0","37.95","19.31"
"65","000","00","090","0008","0000","3070","1463","1607","31","3101","8816","0","35.17","16.59"
"65","000","00","090","0008","2046","505","239","266","7","512","1461","0","35.04","16.36"
"65","000","00","090","0008","2047","452","207","245","6","458","1340","0","34.18","15.45"
"65","000","00","090","0008","2048","517","270","247","4","521","1432","0","36.38","18.85"
"65","000","00","090","0008","2049","550","243","307","7","557","1547","0","36.01","15.71"
"65","000","00","090","0008","2050","458","198","260","4","462","1420","0","32.54","13.94"
"65","000","00","090","0008","2051","588","306","282","3","591","1616","0","36.57","18.94"
"65","000","00","090","0009","0000","3092","1582","1510","36","3128","8410","0","37.19","18.81"
"65","000","00","090","0009","2052","480","184","296","6","486","1558","0","31.19","11.81"
"65","000","00","090","0009","2053","608","322","286","8","616","1793","0","34.36","17.96"
"65","000","00","090","0009","2054","661","344","317","11","672","1768","0","38.01","19.46"
"65","000","00","090","0009","2055","635","358","277","7","642","1584","0","40.53","22.60"
"65","000","00","090","0009","2056","708","374","334","4","712","1707","0","41.71","21.91"
"65","000","00","090","0010","0000","1347","716","631","10","1357","3676","0","36.92","19.48"
"65","000","00","090","0010","2084","363","165","198","3","366","1155","0","31.69","14.29"
"65","000","00","090","0010","2085","420","197","223","5","425","1163","0","36.54","16.94"
"65","000","00","090","0010","2086","564","354","210","2","566","1358","0","41.68","26.07"
"65","000","00","090","0011","0000","839","450","389","13","852","2111","0","40.36","21.32"
"65","000","00","090","0011","2087","416","223","193","5","421","1100","0","38.27","20.27"
"65","000","00","090","0011","2088","423","227","196","8","431","1011","0","42.63","22.45"
"65","000","00","090","0012","0000","384","144","240","2","386","1045","0","36.94","13.78"
"65","000","00","090","0012","2089","384","144","240","2","386","1045","0","36.94","13.78"
"65","000","00","090","0013","0000","174","65","109","6","180","486","0","37.04","13.37"
"65","000","00","090","0013","2090","174","65","109","6","180","486","0","37.04","13.37"
"65","000","00","090","0014","0000","232","106","126","4","236","794","0","29.72","13.35"
"65","000","00","090","0014","2091","232","106","126","4","236","794","0","29.72","13.35"
"65","000","00","090","0015","0000","280","93","187","2","282","632","0","44.62","14.72"
"65","000","00","090","0015","2092","280","93","187","2","282","632","0","44.62","14.72"
"65","000","00","090","0016","0000","217","72","145","1","218","683","0","31.92","10.54"
"65","000","00","090","0016","2093","217","72","145","1","218","683","0","31.92","10.54"
"65","000","00","090","0017","0000","870","358","512","9","879","2123","0","41.40","16.86"
"65","000","00","090","0017","2097","294","125","169","2","296","772","0","38.34","16.19"
"65","000","00","090","0017","2098","576","233","343","7","583","1351","0","43.15","17.25"
"65","000","00","090","0018","0000","591","237","354","3","594","1375","0","43.20","17.24"
"65","000","00","090","0018","2096","591","237","354","3","594","1375","0","43.20","17.24"
"65","000","00","090","0019","0000","987","461","526","9","996","2733","0","36.44","16.87"
"65","000","00","090","0019","2099","514","250","264","7","521","1397","0","37.29","17.90"
"65","000","00","090","0019","2100","473","211","262","2","475","1336","0","35.55","15.79"
"65","000","00","090","0020","0000","395","158","237","5","400","860","0","46.51","18.37"
"65","000","00","090","0020","2101","395","158","237","5","400","860","0","46.51","18.37"
"65","000","00","090","0021","0000","449","156","293","8","457","1294","0","35.32","12.06"
"65","000","00","090","0021","2104","449","156","293","8","457","1294","0","35.32","12.06"
"65","000","00","090","0022","0000","642","242","400","2","644","1870","0","34.44","12.94"
"65","000","00","090","0022","2102","250","69","181","1","251","732","0","34.29","9.43"
"65","000","00","090","0022","2103","392","173","219","1","393","1138","0","34.53","15.20"
"65","000","00","090","0023","0000","2010","911","1099","7","2017","6055","0","33.31","15.05"
"65","000","00","090","0023","2077","533","232","301","3","536","1521","0","35.24","15.25"
"65","000","00","090","0023","2078","511","242","269","3","514","1464","0","35.11","16.53"
"65","000","00","090","0023","2079","553","245","308","0","553","1548","0","35.72","15.83"
"65","000","00","090","0023","2080","413","192","221","1","414","1522","0","27.20","12.61"
"65","000","00","090","0024","0000","2330","1186","1144","15","2345","6654","0","35.24","17.82"
"65","000","00","090","0024","2073","545","250","295","1","546","1619","0","33.72","15.44"
"65","000","00","090","0024","2074","534","281","253","4","538","1739","0","30.94","16.16"
"65","000","00","090","0024","2075","540","288","252","5","545","1559","0","34.96","18.47"
"65","000","00","090","0024","2076","711","367","344","5","716","1737","0","41.22","21.13"
"65","000","00","090","0025","0000","1582","726","856","17","1599","4616","0","34.64","15.73"
"65","000","00","090","0025","2081","538","240","298","5","543","1567","0","34.65","15.32"
"65","000","00","090","0025","2082","518","266","252","7","525","1541","0","34.07","17.26"
"65","000","00","090","0025","2083","526","220","306","5","531","1508","0","35.21","14.59"
"65","000","00","090","0026","0000","1204","667","537","10","1214","3228","0","37.61","20.66"
"65","000","00","090","0026","2094","607","347","260","6","613","1596","0","38.41","21.74"
"65","000","00","090","0026","2095","597","320","277","4","601","1632","0","36.83","19.61"
"65","000","00","090","0027","0000","5483","3186","2297","33","5516","12581","0","43.84","25.32"
"65","000","00","090","0027","2061","656","355","301","8","664","1644","0","40.39","21.59"
"65","000","00","090","0027","2062","575","312","263","1","576","1487","0","38.74","20.98"
"65","000","00","090","0027","2063","802","483","319","3","805","1798","0","44.77","26.86"
"65","000","00","090","0027","2064","793","438","355","8","801","1605","0","49.91","27.29"
"65","000","00","090","0027","2065","648","381","267","2","650","1549","0","41.96","24.60"
"65","000","00","090","0027","2066","693","423","270","2","695","1533","0","45.34","27.59"
"65","000","00","090","0027","2067","658","426","232","3","661","1495","0","44.21","28.49"
"65","000","00","090","0027","2068","658","368","290","6","664","1470","0","45.17","25.03"
"65","000","00","090","0028","0000","2398","1352","1046","21","2419","5980","0","40.45","22.61"
"65","000","00","090","0028","2057","666","386","280","5","671","1602","0","41.89","24.09"
"65","000","00","090","0028","2058","682","381","301","8","690","1523","0","45.31","25.02"
"65","000","00","090","0028","2059","574","316","258","4","578","1410","0","40.99","22.41"
"65","000","00","090","0028","2060","476","269","207","4","480","1445","0","33.22","18.62"
"65","000","00","100","0000","0000","63247","33477","29770","580","63827","158577","184450","40.25","21.11"
"65","000","00","100","0001","0000","194","67","127","3","197","557","0","35.37","12.03"
"65","000","00","100","0001","0032","194","67","127","3","197","557","0","35.37","12.03"
"65","000","00","100","0002","0000","321","119","202","6","327","994","0","32.90","11.97"
"65","000","00","100","0002","0033","321","119","202","6","327","994","0","32.90","11.97"
"65","000","00","100","0003","0000","476","228","248","8","484","1447","0","33.45","15.76"
"65","000","00","100","0003","0034","476","228","248","8","484","1447","0","33.45","15.76"
"65","000","00","100","0004","0000","569","253","316","5","574","1510","0","38.01","16.75"
"65","000","00","100","0004","0035","569","253","316","5","574","1510","0","38.01","16.75"
"65","000","00","100","0005","0000","342","173","169","0","342","973","0","35.15","17.78"
"65","000","00","100","0005","0036","342","173","169","0","342","973","0","35.15","17.78"
"65","000","00","100","0006","0000","802","398","404","11","813","2422","0","33.57","16.43"
"65","000","00","100","0006","0038","396","200","196","6","402","1117","0","35.99","17.91"
"65","000","00","100","0006","0039","406","198","208","5","411","1305","0","31.49","15.17"
"65","000","00","100","0007","0000","320","151","169","10","330","803","0","41.10","18.80"
"65","000","00","100","0007","0037","320","151","169","10","330","803","0","41.10","18.80"
"65","000","00","100","0008","0000","6101","3532","2569","47","6148","17538","0","35.06","20.14"
"65","000","00","100","0008","0071","851","483","368","7","858","2045","0","41.96","23.62"
"65","000","00","100","0008","0072","595","353","242","7","602","2304","0","26.13","15.32"
"65","000","00","100","0008","0073","471","262","209","3","474","1275","0","37.18","20.55"
"65","000","00","100","0008","0074","553","292","261","6","559","1448","0","38.60","20.17"
"65","000","00","100","0008","0075","676","385","291","4","680","2254","0","30.17","17.08"
"65","000","00","100","0008","0076","621","369","252","5","626","1883","0","33.24","19.60"
"65","000","00","100","0008","0077","562","311","251","2","564","1442","0","39.11","21.57"
"65","000","00","100","0008","0078","879","536","343","7","886","2402","0","36.89","22.31"
"65","000","00","100","0008","0079","893","541","352","6","899","2485","0","36.18","21.77"
"65","000","00","100","0009","0000","578","280","298","5","583","1616","0","36.08","17.33"
"65","000","00","100","0009","0080","578","280","298","5","583","1616","0","36.08","17.33"
"65","000","00","100","0010","0000","2526","1380","1146","21","2547","6573","0","38.75","20.99"
"65","000","00","100","0010","0090","517","255","262","9","526","1383","0","38.03","18.44"
"65","000","00","100","0010","0091","691","414","277","4","695","1742","0","39.90","23.77"
"65","000","00","100","0010","0092","590","317","273","6","596","1575","0","37.84","20.13"
"65","000","00","100","0010","0093","728","394","334","2","730","1873","0","38.97","21.04"
"65","000","00","100","0011","0000","1979","955","1024","26","2005","5098","0","39.33","18.73"
"65","000","00","100","0011","0081","549","257","292","4","553","1445","0","38.27","17.79"
"65","000","00","100","0011","0082","466","249","217","6","472","1149","0","41.08","21.67"
"65","000","00","100","0011","0083","466","218","248","5","471","1207","0","39.02","18.06"
"65","000","00","100","0011","0084","498","231","267","11","509","1297","0","39.24","17.81"
"65","000","00","100","0012","0000","3657","2039","1618","29","3686","9067","0","40.65","22.49"
"65","000","00","100","0012","0106","748","410","338","5","753","1908","0","39.47","21.49"
"65","000","00","100","0012","0107","510","258","252","5","515","1358","0","37.92","19.00"
"65","000","00","100","0012","0108","945","525","420","12","957","2153","0","44.45","24.38"
"65","000","00","100","0012","0109","742","428","314","3","745","1837","0","40.56","23.30"
"65","000","00","100","0012","0110","712","418","294","4","716","1811","0","39.54","23.08"
"65","000","00","100","0013","0000","742","278","464","9","751","1974","0","38.04","14.08"
"65","000","00","100","0013","0040","422","176","246","5","427","1136","0","37.59","15.49"
"65","000","00","100","0013","0041","320","102","218","4","324","838","0","38.66","12.17"
"65","000","00","100","0014","0000","403","166","237","3","406","1054","0","38.52","15.75"
"65","000","00","100","0014","0042","403","166","237","3","406","1054","0","38.52","15.75"
"65","000","00","100","0015","0000","545","263","282","9","554","1361","0","40.71","19.32"
"65","000","00","100","0015","0043","545","263","282","9","554","1361","0","40.71","19.32"
"65","000","00","100","0016","0000","545","265","280","3","548","1263","0","43.39","20.98"
"65","000","00","100","0016","0044","545","265","280","3","548","1263","0","43.39","20.98"
"65","000","00","100","0017","0000","3078","1733","1345","29","3107","6369","0","48.78","27.21"
"65","000","00","100","0017","0045","873","491","382","11","884","1797","0","49.19","27.32"
"65","000","00","100","0017","0046","505","264","241","2","507","1021","0","49.66","25.86"
"65","000","00","100","0017","0047","487","285","202","5","492","1016","0","48.43","28.05"
"65","000","00","100","0017","0048","625","347","278","4","629","1241","0","50.68","27.96"
"65","000","00","100","0017","0049","588","346","242","7","595","1294","0","45.98","26.74"
"65","000","00","100","0018","0000","2560","1405","1155","30","2590","5639","0","45.93","24.92"
"65","000","00","100","0018","0050","538","286","252","4","542","1302","0","41.63","21.97"
"65","000","00","100","0018","0051","635","384","251","10","645","1240","0","52.02","30.97"
"65","000","00","100","0018","0052","635","324","311","12","647","1418","0","45.63","22.85"
"65","000","00","100","0018","0053","752","411","341","4","756","1679","0","45.03","24.48"
"65","000","00","100","0019","0000","2762","1407","1355","15","2777","6465","0","42.95","21.76"
"65","000","00","100","0019","0057","780","402","378","6","786","1819","0","43.21","22.10"
"65","000","00","100","0019","0058","566","249","317","1","567","1252","0","45.29","19.89"
"65","000","00","100","0019","0059","686","348","338","7","693","1570","0","44.14","22.17"
"65","000","00","100","0019","0060","730","408","322","1","731","1824","0","40.08","22.37"
"65","000","00","100","0020","0000","2573","1388","1185","23","2596","6014","0","43.17","23.08"
"65","000","00","100","0020","0061","632","325","307","3","635","1474","0","43.08","22.05"
"65","000","00","100","0020","0062","667","355","312","5","672","1626","0","41.33","21.83"
"65","000","00","100","0020","0063","537","321","216","6","543","1327","0","40.92","24.19"
"65","000","00","100","0020","0064","737","387","350","9","746","1587","0","47.01","24.39"
"65","000","00","100","0021","0000","4066","2291","1775","36","4102","10029","0","40.90","22.84"
"65","000","00","100","0021","0065","743","447","296","5","748","1824","0","41.01","24.51"
"65","000","00","100","0021","0066","786","422","364","7","793","1862","0","42.59","22.66"
"65","000","00","100","0021","0067","674","394","280","7","681","1788","0","38.09","22.04"
"65","000","00","100","0021","0068","698","348","350","6","704","1653","0","42.59","21.05"
"65","000","00","100","0021","0069","625","363","262","5","630","1381","0","45.62","26.29"
"65","000","00","100","0021","0070","540","317","223","6","546","1521","0","35.90","20.84"
"65","000","00","100","0022","0000","2296","1248","1048","17","2313","5542","0","41.74","22.52"
"65","000","00","100","0022","0111","552","324","228","4","556","1280","0","43.44","25.31"
"65","000","00","100","0022","0112","411","232","179","3","414","981","0","42.20","23.65"
"65","000","00","100","0022","0113","555","274","281","6","561","1209","0","46.40","22.66"
"65","000","00","100","0022","0114","341","186","155","2","343","958","0","35.80","19.42"
"65","000","00","100","0022","0115","437","232","205","2","439","1114","0","39.41","20.83"
"65","000","00","100","0023","0000","1391","679","712","23","1414","3650","0","38.74","18.60"
"65","000","00","100","0023","0123","463","211","252","6","469","1305","0","35.94","16.17"
"65","000","00","100","0023","0124","484","237","247","10","494","1284","0","38.47","18.46"
"65","000","00","100","0023","0125","444","231","213","7","451","1061","0","42.51","21.77"
"65","000","00","100","0024","0000","612","287","325","5","617","1326","0","46.53","21.64"
"65","000","00","100","0024","0126","612","287","325","5","617","1326","0","46.53","21.64"
"65","000","00","100","0025","0000","422","184","238","3","425","1068","0","39.79","17.23"
"65","000","00","100","0025","0127","422","184","238","3","425","1068","0","39.79","17.23"
"65","000","00","100","0026","0000","307","122","185","3","310","682","0","45.45","17.89"
"65","000","00","100","0026","0128","307","122","185","3","310","682","0","45.45","17.89"
"65","000","00","100","0027","0000","518","231","287","4","522","1339","0","38.98","17.25"
"65","000","00","100","0027","0129","518","231","287","4","522","1339","0","38.98","17.25"
"65","000","00","100","0028","0000","394","187","207","6","400","804","0","49.75","23.26"
"65","000","00","100","0028","0130","394","187","207","6","400","804","0","49.75","23.26"
"65","000","00","100","0029","0000","315","140","175","8","323","624","0","51.76","22.44"
"65","000","00","100","0029","0131","315","140","175","8","323","624","0","51.76","22.44"
"65","000","00","100","0030","0000","185","88","97","1","186","396","0","46.97","22.22"
"65","000","00","100","0030","0132","185","88","97","1","186","396","0","46.97","22.22"
"65","000","00","100","0031","0000","663","372","291","9","672","1587","0","42.34","23.44"
"65","000","00","100","0031","0133","663","372","291","9","672","1587","0","42.34","23.44"
"65","000","00","100","0032","0000","2037","1127","910","22","2059","4932","0","41.75","22.85"
"65","000","00","100","0032","0134","670","398","272","3","673","1590","0","42.33","25.03"
"65","000","00","100","0032","0135","780","423","357","11","791","1743","0","45.38","24.27"
"65","000","00","100","0032","0136","587","306","281","8","595","1599","0","37.21","19.14"
"65","000","00","100","0033","0000","1590","864","726","9","1599","4158","0","38.46","20.78"
"65","000","00","100","0033","0137","603","315","288","4","607","1668","0","36.39","18.88"
"65","000","00","100","0033","0138","567","283","284","5","572","1410","0","40.57","20.07"
"65","000","00","100","0033","0139","420","266","154","0","420","1080","0","38.89","24.63"
"65","000","00","100","0034","0000","1347","589","758","16","1363","3658","0","37.26","16.10"
"65","000","00","100","0034","0094","477","218","259","3","480","1250","0","38.40","17.44"
"65","000","00","100","0034","0095","354","153","201","6","360","1050","0","34.29","14.57"
"65","000","00","100","0034","0096","516","218","298","7","523","1358","0","38.51","16.05"
"65","000","00","100","0035","0000","2941","1495","1446","19","2960","7974","0","37.12","18.75"
"65","000","00","100","0035","0097","588","262","326","2","590","1563","0","37.75","16.76"
"65","000","00","100","0035","0098","560","282","278","8","568","1551","0","36.62","18.18"
"65","000","00","100","0035","0099","508","282","226","2","510","1485","0","34.34","18.99"
"65","000","00","100","0035","0100","377","210","167","2","379","927","0","40.88","22.65"
"65","000","00","100","0035","0101","418","184","234","3","421","1200","0","35.08","15.33"
"65","000","00","100","0035","0102","490","275","215","2","492","1248","0","39.42","22.04"
"65","000","00","100","0036","0000","1763","915","848","9","1772","4269","0","41.51","21.43"
"65","000","00","100","0036","0103","630","296","334","1","631","1450","0","43.52","20.41"
"65","000","00","100","0036","0104","541","289","252","4","545","1384","0","39.38","20.88"
"65","000","00","100","0036","0105","592","330","262","4","596","1435","0","41.53","23.00"
"65","000","00","100","0037","0000","1636","933","703","20","1656","4169","0","39.72","22.38"
"65","000","00","100","0037","0087","612","329","283","5","617","1519","0","40.62","21.66"
"65","000","00","100","0037","0088","543","324","219","8","551","1402","0","39.30","23.11"
"65","000","00","100","0037","0089","481","280","201","7","488","1248","0","39.10","22.44"
"65","000","00","100","0038","0000","963","520","443","3","966","2486","0","38.86","20.92"
"65","000","00","100","0038","0085","514","269","245","2","516","1279","0","40.34","21.03"
"65","000","00","100","0038","0086","449","251","198","1","450","1207","0","37.28","20.80"
"65","000","00","100","0039","0000","1924","960","964","17","1941","4221","0","45.98","22.74"
"65","000","00","100","0039","0054","552","244","308","9","561","1200","0","46.75","20.33"
"65","000","00","100","0039","0055","736","375","361","7","743","1527","0","48.66","24.56"
"65","000","00","100","0039","0056","636","341","295","1","637","1494","0","42.64","22.82"
"65","000","00","100","0040","0000","1413","698","715","15","1428","3477","0","41.07","20.07"
"65","000","00","100","0040","0116","385","193","192","6","391","1022","0","38.26","18.88"
"65","000","00","100","0040","0117","534","267","267","3","537","1289","0","41.66","20.71"
"65","000","00","100","0040","0118","494","238","256","6","500","1166","0","42.88","20.41"
"65","000","00","100","0041","0000","1573","868","705","12","1585","4251","0","37.29","20.42"
"65","000","00","100","0041","0119","318","187","131","4","322","948","0","33.97","19.73"
"65","000","00","100","0041","0120","504","275","229","5","509","1141","0","44.61","24.10"
"65","000","00","100","0041","0121","370","193","177","0","370","1062","0","34.84","18.17"
"65","000","00","100","0041","0122","381","213","168","3","384","1100","0","34.91","19.36"
"65","000","00","100","0042","0000","3818","2199","1619","31","3849","9198","0","41.85","23.91"
"65","000","00","100","0042","0140","644","349","295","6","650","1432","0","45.39","24.37"
"65","000","00","100","0042","0141","592","282","310","4","596","1387","0","42.97","20.33"
"65","000","00","100","0042","0142","739","373","366","7","746","2001","0","37.28","18.64"
"65","000","00","100","0042","0143","591","342","249","5","596","1432","0","41.62","23.88"
"65","000","00","100","0042","0144","729","503","226","4","733","1809","0","40.52","27.81"
"65","000","00","100","0042","0145","523","350","173","5","528","1137","0","46.44","30.78"
"65","000","00","110","0000","0000","74963","40650","34313","712","75675","179909","205551","42.06","22.59"
"65","000","00","110","0001","0000","528","286","242","4","532","1238","0","42.97","23.10"
"65","000","00","110","0001","2501","528","286","242","4","532","1238","0","42.97","23.10"
"65","000","00","110","0002","0000","450","210","240","2","452","980","0","46.12","21.43"
"65","000","00","110","0002","2502","450","210","240","2","452","980","0","46.12","21.43"
"65","000","00","110","0003","0000","1865","1084","781","15","1880","4239","0","44.35","25.57"
"65","000","00","110","0003","2503","584","346","238","5","589","1387","0","42.47","24.95"
"65","000","00","110","0003","2504","683","408","275","5","688","1409","0","48.83","28.96"
"65","000","00","110","0003","2505","598","330","268","5","603","1443","0","41.79","22.87"
"65","000","00","110","0004","0000","146","73","73","1","147","320","0","45.94","22.81"
"65","000","00","110","0004","2508","146","73","73","1","147","320","0","45.94","22.81"
"65","000","00","110","0005","0000","1243","649","594","10","1253","2889","0","43.37","22.46"
"65","000","00","110","0005","2544","678","356","322","3","681","1525","0","44.66","23.34"
"65","000","00","110","0005","2545","565","293","272","7","572","1364","0","41.94","21.48"
"65","000","00","110","0006","0000","1414","687","727","11","1425","4888","0","29.15","14.05"
"65","000","00","110","0006","2516","283","133","150","5","288","1897","0","15.18","7.01"
"65","000","00","110","0006","2517","598","294","304","2","600","1577","0","38.05","18.64"
"65","000","00","110","0006","2518","533","260","273","4","537","1414","0","37.98","18.39"
"65","000","00","110","0007","0000","1956","1002","954","17","1973","4758","0","41.47","21.06"
"65","000","00","110","0007","2509","686","338","348","9","695","1562","0","44.49","21.64"
"65","000","00","110","0007","2510","645","326","319","3","648","1629","0","39.78","20.01"
"65","000","00","110","0007","2511","625","338","287","5","630","1567","0","40.20","21.57"
"65","000","00","110","0008","0000","3165","1767","1398","26","3191","6286","0","50.76","28.11"
"65","000","00","110","0008","2522","691","382","309","5","696","1459","0","47.70","26.18"
"65","000","00","110","0008","2523","772","429","343","6","778","1586","0","49.05","27.05"
"65","000","00","110","0008","2524","855","483","372","5","860","1666","0","51.62","28.99"
"65","000","00","110","0008","2525","847","473","374","10","857","1575","0","54.41","30.03"
"65","000","00","110","0009","0000","1379","685","694","12","1391","3956","0","35.16","17.32"
"65","000","00","110","0009","2535","492","239","253","4","496","1359","0","36.50","17.59"
"65","000","00","110","0009","2536","452","230","222","2","454","1362","0","33.33","16.89"
"65","000","00","110","0009","2537","435","216","219","6","441","1235","0","35.71","17.49"
"65","000","00","110","0010","0000","632","296","336","7","639","1489","0","42.91","19.88"
"65","000","00","110","0010","2549","632","296","336","7","639","1489","0","42.91","19.88"
"65","000","00","110","0011","0000","546","271","275","5","551","1494","0","36.88","18.14"
"65","000","00","110","0011","2550","546","271","275","5","551","1494","0","36.88","18.14"
"65","000","00","110","0012","0000","1660","842","818","28","1688","4194","0","40.25","20.08"
"65","000","00","110","0012","2552","523","233","290","8","531","1297","0","40.94","17.96"
"65","000","00","110","0012","2553","617","327","290","14","631","1623","0","38.88","20.15"
"65","000","00","110","0012","2554","520","282","238","6","526","1274","0","41.29","22.14"
"65","000","00","110","0013","0000","936","457","479","6","942","2101","0","44.84","21.75"
"65","000","00","110","0013","2557","555","265","290","3","558","1310","0","42.60","20.23"
"65","000","00","110","0013","2558","381","192","189","3","384","791","0","48.55","24.27"
"65","000","00","110","0014","0000","2110","1081","1029","19","2129","5478","0","38.86","19.73"
"65","000","00","110","0014","2559","501","286","215","5","506","1245","0","40.64","22.97"
"65","000","00","110","0014","2560","507","245","262","3","510","1316","0","38.75","18.62"
"65","000","00","110","0014","2561","562","275","287","3","565","1603","0","35.25","17.16"
"65","000","00","110","0014","2562","540","275","265","8","548","1314","0","41.70","20.93"
"65","000","00","110","0015","0000","1593","816","777","15","1608","4648","0","34.60","17.56"
"65","000","00","110","0015","2563","419","225","194","10","429","1486","0","28.87","15.14"
"65","000","00","110","0015","2564","544","249","295","2","546","1553","0","35.16","16.03"
"65","000","00","110","0015","2565","630","342","288","3","633","1609","0","39.34","21.26"
"65","000","00","110","0016","0000","618","320","298","15","633","1479","0","42.80","21.64"
"65","000","00","110","0016","2566","618","320","298","15","633","1479","0","42.80","21.64"
"65","000","00","110","0017","0000","341","146","195","1","342","921","0","37.13","15.85"
"65","000","00","110","0017","2567","341","146","195","1","342","921","0","37.13","15.85"
"65","000","00","110","0018","0000","764","354","410","11","775","1990","0","38.94","17.79"
"65","000","00","110","0018","2575","764","354","410","11","775","1990","0","38.94","17.79"
"65","000","00","110","0019","0000","1717","777","940","18","1735","4527","0","38.33","17.16"
"65","000","00","110","0019","2569","659","286","373","3","662","1665","0","39.76","17.18"
"65","000","00","110","0019","2570","512","240","272","8","520","1472","0","35.33","16.30"
"65","000","00","110","0019","2571","546","251","295","7","553","1390","0","39.78","18.06"
"65","000","00","110","0020","0000","2405","1258","1147","24","2429","5282","0","45.99","23.82"
"65","000","00","110","0020","2609","655","369","286","7","662","1484","0","44.61","24.87"
"65","000","00","110","0020","2610","662","361","301","4","666","1313","0","50.72","27.49"
"65","000","00","110","0020","2611","602","288","314","7","609","1313","0","46.38","21.93"
"65","000","00","110","0020","2612","486","240","246","6","492","1172","0","41.98","20.48"
"65","000","00","110","0021","0000","1596","834","762","19","1615","3974","0","40.64","20.99"
"65","000","00","110","0021","2532","524","278","246","7","531","1227","0","43.28","22.66"
"65","000","00","110","0021","2533","535","254","281","7","542","1399","0","38.74","18.16"
"65","000","00","110","0021","2534","537","302","235","5","542","1348","0","40.21","22.40"
"65","000","00","110","0022","0000","1822","985","837","28","1850","4272","0","43.31","23.06"
"65","000","00","110","0022","2616","628","351","277","8","636","1457","0","43.65","24.09"
"65","000","00","110","0022","2617","570","314","256","10","580","1380","0","42.03","22.75"
"65","000","00","110","0022","2618","624","320","304","10","634","1435","0","44.18","22.30"
"65","000","00","110","0023","0000","210","110","100","8","218","542","0","40.22","20.30"
"65","000","00","110","0023","2551","210","110","100","8","218","542","0","40.22","20.30"
"65","000","00","110","0024","0000","1539","881","658","20","1559","3388","0","46.02","26.00"
"65","000","00","110","0024","2619","726","417","309","13","739","1745","0","42.35","23.90"
"65","000","00","110","0024","2620","813","464","349","7","820","1643","0","49.91","28.24"
"65","000","00","110","0025","0000","1324","803","521","14","1338","2728","0","49.05","29.44"
"65","000","00","110","0025","2621","607","411","196","6","613","1312","0","46.72","31.33"
"65","000","00","110","0025","2622","717","392","325","8","725","1416","0","51.20","27.68"
"65","000","00","110","0026","0000","2721","1381","1340","31","2752","7130","0","38.60","19.37"
"65","000","00","110","0026","2587","537","254","283","8","545","1408","0","38.71","18.04"
"65","000","00","110","0026","2588","501","256","245","6","507","1368","0","37.06","18.71"
"65","000","00","110","0026","2589","534","293","241","2","536","1460","0","36.71","20.07"
"65","000","00","110","0026","2590","552","266","286","7","559","1386","0","40.33","19.19"
"65","000","00","110","0026","2591","597","312","285","8","605","1508","0","40.12","20.69"
"65","000","00","110","0027","0000","2477","1439","1038","23","2500","5589","0","44.73","25.75"
"65","000","00","110","0027","2599","632","343","289","8","640","1388","0","46.11","24.71"
"65","000","00","110","0027","2600","555","316","239","3","558","1396","0","39.97","22.64"
"65","000","00","110","0027","2601","650","342","308","9","659","1429","0","46.12","23.93"
"65","000","00","110","0027","2602","640","438","202","3","643","1376","0","46.73","31.83"
"65","000","00","110","0028","0000","739","409","330","8","747","1675","0","44.60","24.42"
"65","000","00","110","0028","2500","739","409","330","8","747","1675","0","44.60","24.42"
"65","000","00","110","0029","0000","2442","1387","1055","18","2460","6767","0","36.35","20.50"
"65","000","00","110","0029","2581","631","328","303","4","635","1700","0","37.35","19.29"
"65","000","00","110","0029","2582","613","361","252","2","615","1655","0","37.16","21.81"
"65","000","00","110","0029","2583","649","372","277","8","657","1720","0","38.20","21.63"
"65","000","00","110","0029","2584","549","326","223","4","553","1692","0","32.68","19.27"
"65","000","00","110","0030","0000","2937","1642","1295","20","2957","7500","0","39.43","21.89"
"65","000","00","110","0030","2576","551","306","245","3","554","1416","0","39.12","21.61"
"65","000","00","110","0030","2577","586","321","265","5","591","1547","0","38.20","20.75"
"65","000","00","110","0030","2578","583","358","225","2","585","1512","0","38.69","23.68"
"65","000","00","110","0030","2579","601","313","288","3","604","1468","0","41.14","21.32"
"65","000","00","110","0030","2580","616","344","272","7","623","1557","0","40.01","22.09"
"65","000","00","110","0031","0000","2140","1165","975","26","2166","5118","0","42.32","22.76"
"65","000","00","110","0031","2526","714","379","335","8","722","1683","0","42.90","22.52"
"65","000","00","110","0031","2527","648","339","309","6","654","1716","0","38.11","19.76"
"65","000","00","110","0031","2528","778","447","331","12","790","1719","0","45.96","26.00"
"65","000","00","110","0032","0000","1728","916","812","11","1739","4130","0","42.11","22.18"
"65","000","00","110","0032","2529","577","269","308","4","581","1534","0","37.87","17.54"
"65","000","00","110","0032","2530","655","366","289","3","658","1554","0","42.34","23.55"
"65","000","00","110","0032","2531","496","281","215","4","500","1042","0","47.98","26.97"
"65","000","00","110","0033","0000","1931","1022","909","20","1951","4841","0","40.30","21.11"
"65","000","00","110","0033","2572","628","342","286","7","635","1600","0","39.69","21.38"
"65","000","00","110","0033","2573","647","343","304","9","656","1660","0","39.52","20.66"
"65","000","00","110","0033","2574","656","337","319","4","660","1581","0","41.75","21.32"
"65","000","00","110","0034","0000","1129","581","548","14","1143","2985","0","38.29","19.46"
"65","000","00","110","0034","2592","609","290","319","7","616","1514","0","40.69","19.15"
"65","000","00","110","0034","2593","520","291","229","7","527","1471","0","35.83","19.78"
"65","000","00","110","0035","0000","1270","692","578","5","1275","2904","0","43.90","23.83"
"65","000","00","110","0035","2594","658","393","265","2","660","1423","0","46.38","27.62"
"65","000","00","110","0035","2595","612","299","313","3","615","1481","0","41.53","20.19"
"65","000","00","110","0036","0000","1865","972","893","20","1885","4716","0","39.97","20.61"
"65","000","00","110","0036","2596","610","332","278","6","616","1564","0","39.39","21.23"
"65","000","00","110","0036","2597","588","295","293","5","593","1493","0","39.72","19.76"
"65","000","00","110","0036","2598","667","345","322","9","676","1659","0","40.75","20.80"
"65","000","00","110","0037","0000","1640","1007","633","11","1651","3115","0","53.00","32.33"
"65","000","00","110","0037","2613","741","468","273","7","748","1475","0","50.71","31.73"
"65","000","00","110","0037","2614","899","539","360","4","903","1640","0","55.06","32.87"
"65","000","00","110","0038","0000","514","202","312","3","517","1145","0","45.15","17.64"
"65","000","00","110","0038","2615","514","202","312","3","517","1145","0","45.15","17.64"
"65","000","00","110","0039","0000","2073","1176","897","18","2091","4238","0","49.34","27.75"
"65","000","00","110","0039","2623","580","288","292","7","587","1209","0","48.55","23.82"
"65","000","00","110","0039","2624","528","311","217","6","534","1080","0","49.44","28.80"
"65","000","00","110","0039","2625","965","577","388","5","970","1949","0","49.77","29.60"
"65","000","00","110","0040","0000","891","531","360","9","900","2598","0","34.64","20.44"
"65","000","00","110","0040","2585","491","291","200","4","495","1428","0","34.66","20.38"
"65","000","00","110","0040","2586","400","240","160","5","405","1170","0","34.62","20.51"
"65","000","00","110","0041","0000","1091","595","496","2","1093","2552","0","42.83","23.32"
"65","000","00","110","0041","2506","536","270","266","2","538","1262","0","42.63","21.39"
"65","000","00","110","0041","2507","555","325","230","0","555","1290","0","43.02","25.19"
"65","000","00","110","0042","0000","1921","1002","919","19","1940","4444","0","43.65","22.55"
"65","000","00","110","0042","2538","695","353","342","9","704","1693","0","41.58","20.85"
"65","000","00","110","0042","2539","664","318","346","5","669","1577","0","42.42","20.16"
"65","000","00","110","0042","2540","562","331","231","5","567","1174","0","48.30","28.19"
"65","000","00","110","0043","0000","2743","1671","1072","21","2764","6020","0","45.91","27.76"
"65","000","00","110","0043","2605","705","437","268","8","713","1571","0","45.39","27.82"
"65","000","00","110","0043","2606","711","428","283","2","713","1458","0","48.90","29.36"
"65","000","00","110","0043","2607","647","383","264","3","650","1568","0","41.45","24.43"
"65","000","00","110","0043","2608","680","423","257","8","688","1423","0","48.35","29.73"
"65","000","00","110","0044","0000","453","257","196","8","461","872","0","52.87","29.47"
"65","000","00","110","0044","2568","453","257","196","8","461","872","0","52.87","29.47"
"65","000","00","110","0045","0000","2265","1194","1071","19","2284","5639","0","40.50","21.17"
"65","000","00","110","0045","2512","525","278","247","5","530","1345","0","39.41","20.67"
"65","000","00","110","0045","2513","595","335","260","9","604","1426","0","42.36","23.49"
"65","000","00","110","0045","2514","581","296","285","3","584","1437","0","40.64","20.60"
"65","000","00","110","0045","2515","564","285","279","2","566","1431","0","39.55","19.92"
"65","000","00","110","0046","0000","1673","923","750","16","1689","3952","0","42.74","23.36"
"65","000","00","110","0046","2519","537","285","252","2","539","1277","0","42.21","22.32"
"65","000","00","110","0046","2520","539","279","260","4","543","1304","0","41.64","21.40"
"65","000","00","110","0046","2521","597","359","238","10","607","1371","0","44.27","26.19"
"65","000","00","110","0047","0000","2130","1242","888","14","2144","4633","0","46.28","26.81"
"65","000","00","110","0047","2546","811","462","349","3","814","1663","0","48.95","27.78"
"65","000","00","110","0047","2547","754","458","296","3","757","1703","0","44.45","26.89"
"65","000","00","110","0047","2548","565","322","243","8","573","1267","0","45.22","25.41"
"65","000","00","110","0048","0000","1845","1082","763","17","1862","4091","0","45.51","26.45"
"65","000","00","110","0048","2541","608","326","282","7","615","1270","0","48.43","25.67"
"65","000","00","110","0048","2542","610","361","249","6","616","1351","0","45.60","26.72"
"65","000","00","110","0048","2543","627","395","232","4","631","1470","0","42.93","26.87"
"65","000","00","110","0049","0000","1355","872","483","12","1367","2514","0","54.38","34.69"
"65","000","00","110","0049","2603","600","382","218","5","605","1154","0","52.43","33.10"
"65","000","00","110","0049","2604","755","490","265","7","762","1360","0","56.03","36.03"
"65","000","00","110","0050","0000","1031","616","415","11","1042","2680","0","38.88","22.99"
"65","000","00","110","0050","2555","784","512","272","5","789","1988","0","39.69","25.75"
"65","000","00","110","0050","2556","247","104","143","6","253","692","0","36.56","15.03"
"65","000","00","120","0000","0000","11945","6202","5743","149","12094","34231","38764","35.33","18.12"
"65","000","00","120","0001","0000","304","164","140","2","306","728","0","42.03","22.53"
"65","000","00","120","0001","2379","304","164","140","2","306","728","0","42.03","22.53"
"65","000","00","120","0002","0000","782","415","367","11","793","1862","0","42.59","22.29"
"65","000","00","120","0002","2380","450","224","226","8","458","1044","0","43.87","21.46"
"65","000","00","120","0002","2381","332","191","141","3","335","818","0","40.95","23.35"
"65","000","00","120","0003","0000","465","248","217","3","468","1203","0","38.90","20.62"
"65","000","00","120","0003","2382","465","248","217","3","468","1203","0","38.90","20.62"
"65","000","00","120","0004","0000","588","315","273","6","594","1573","0","37.76","20.03"
"65","000","00","120","0004","2384","327","175","152","3","330","861","0","38.33","20.33"
"65","000","00","120","0004","2385","261","140","121","3","264","712","0","37.08","19.66"
"65","000","00","120","0005","0000","477","277","200","8","485","1281","0","37.86","21.62"
"65","000","00","120","0005","2386","477","277","200","8","485","1281","0","37.86","21.62"
"65","000","00","120","0006","0000","218","133","85","4","222","598","0","37.12","22.24"
"65","000","00","120","0006","2383","218","133","85","4","222","598","0","37.12","22.24"
"65","000","00","120","0007","0000","1291","639","652","17","1308","3539","0","36.96","18.06"
"65","000","00","120","0007","2387","533","261","272","4","537","1534","0","35.01","17.01"
"65","000","00","120","0007","2388","370","192","178","4","374","945","0","39.58","20.32"
"65","000","00","120","0007","2389","388","186","202","9","397","1060","0","37.45","17.55"
"65","000","00","120","0008","0000","368","162","206","3","371","1041","0","35.64","15.56"
"65","000","00","120","0008","2394","368","162","206","3","371","1041","0","35.64","15.56"
"65","000","00","120","0009","0000","563","276","287","6","569","1589","0","35.81","17.37"
"65","000","00","120","0009","2392","341","159","182","2","343","954","0","35.95","16.67"
"65","000","00","120","0009","2393","222","117","105","4","226","635","0","35.59","18.43"
"65","000","00","120","0010","0000","466","237","229","6","472","1272","0","37.11","18.63"
"65","000","00","120","0010","2404","240","130","110","2","242","666","0","36.34","19.52"
"65","000","00","120","0010","2405","226","107","119","4","230","606","0","37.95","17.66"
"65","000","00","120","0011","0000","561","318","243","5","566","1680","0","33.69","18.93"
"65","000","00","120","0011","2399","306","154","152","4","310","815","0","38.04","18.90"
"65","000","00","120","0011","2400","255","164","91","1","256","865","0","29.60","18.96"
"65","000","00","120","0012","0000","980","519","461","11","991","2918","0","33.96","17.79"
"65","000","00","120","0012","2401","259","152","107","3","262","758","0","34.56","20.05"
"65","000","00","120","0012","2402","375","204","171","7","382","1137","0","33.60","17.94"
"65","000","00","120","0012","2403","346","163","183","1","347","1023","0","33.92","15.93"
"65","000","00","120","0013","0000","662","290","372","8","670","1891","0","35.43","15.34"
"65","000","00","120","0013","2406","370","169","201","4","374","1054","0","35.48","16.03"
"65","000","00","120","0013","2407","292","121","171","4","296","837","0","35.36","14.46"
"65","000","00","120","0014","0000","142","65","77","0","142","434","0","32.72","14.98"
"65","000","00","120","0014","2396","142","65","77","0","142","434","0","32.72","14.98"
"65","000","00","120","0015","0000","91","39","52","3","94","241","0","39.00","16.18"
"65","000","00","120","0015","2397","91","39","52","3","94","241","0","39.00","16.18"
"65","000","00","120","0016","0000","116","39","77","3","119","264","0","45.08","14.77"
"65","000","00","120","0016","2395","116","39","77","3","119","264","0","45.08","14.77"
"65","000","00","120","0017","0000","72","37","35","1","73","138","0","52.90","26.81"
"65","000","00","120","0017","2398","72","37","35","1","73","138","0","52.90","26.81"
"65","000","00","120","0018","0000","180","82","98","3","183","417","0","43.88","19.66"
"65","000","00","120","0018","2408","180","82","98","3","183","417","0","43.88","19.66"
"65","000","00","120","0019","0000","128","57","71","0","128","408","0","31.37","13.97"
"65","000","00","120","0019","2409","128","57","71","0","128","408","0","31.37","13.97"
"65","000","00","120","0020","0000","115","53","62","1","116","296","0","39.19","17.91"
"65","000","00","120","0020","2410","115","53","62","1","116","296","0","39.19","17.91"
"65","000","00","120","0021","0000","69","42","27","2","71","164","0","43.29","25.61"
"65","000","00","120","0021","2411","69","42","27","2","71","164","0","43.29","25.61"
"65","000","00","120","0022","0000","120","59","61","0","120","326","0","36.81","18.10"
"65","000","00","120","0022","2412","120","59","61","0","120","326","0","36.81","18.10"
"65","000","00","120","0023","0000","105","57","48","4","109","339","0","32.15","16.81"
"65","000","00","120","0023","2415","105","57","48","4","109","339","0","32.15","16.81"
"65","000","00","120","0024","0000","74","48","26","0","74","164","0","45.12","29.27"
"65","000","00","120","0024","2413","74","48","26","0","74","164","0","45.12","29.27"
"65","000","00","120","0025","0000","79","37","42","3","82","186","0","44.09","19.89"
"65","000","00","120","0025","2414","79","37","42","3","82","186","0","44.09","19.89"
"65","000","00","120","0026","0000","109","65","44","1","110","321","0","34.27","20.25"
"65","000","00","120","0026","2416","109","65","44","1","110","321","0","34.27","20.25"
"65","000","00","120","0027","0000","79","34","45","1","80","286","0","27.97","11.89"
"65","000","00","120","0027","2418","79","34","45","1","80","286","0","27.97","11.89"
"65","000","00","120","0028","0000","167","102","65","3","170","459","0","37.04","22.22"
"65","000","00","120","0028","2417","167","102","65","3","170","459","0","37.04","22.22"
"65","000","00","120","0029","0000","332","203","129","6","338","1241","0","27.24","16.36"
"65","000","00","120","0029","2421","332","203","129","6","338","1241","0","27.24","16.36"
"65","000","00","120","0030","0000","590","314","276","6","596","1905","0","31.29","16.48"
"65","000","00","120","0030","2422","338","168","170","4","342","979","0","34.93","17.16"
"65","000","00","120","0030","2423","252","146","106","2","254","926","0","27.43","15.77"
"65","000","00","120","0031","0000","363","219","144","4","367","1290","0","28.45","16.98"
"65","000","00","120","0031","2424","363","219","144","4","367","1290","0","28.45","16.98"
"65","000","00","120","0032","0000","120","53","67","0","120","264","0","45.45","20.08"
"65","000","00","120","0032","2419","120","53","67","0","120","264","0","45.45","20.08"
"65","000","00","120","0033","0000","264","113","151","6","270","853","0","31.65","13.25"
"65","000","00","120","0033","2420","264","113","151","6","270","853","0","31.65","13.25"
"65","000","00","120","0034","0000","905","491","414","12","917","3060","0","29.97","16.05"
"65","000","00","120","0034","2390","457","247","210","8","465","1454","0","31.98","16.99"
"65","000","00","120","0034","2391","448","244","204","4","452","1606","0","28.14","15.19"
"65","000","00","130","0000","0000","80706","38892","41814","723","81429","203012","238020","40.11","19.16"
"65","000","00","130","0001","0000","1288","591","697","9","1297","5065","0","25.61","11.67"
"65","000","00","130","0001","1912","434","192","242","5","439","2800","0","15.68","6.86"
"65","000","00","130","0001","1913","453","206","247","1","454","1215","0","37.37","16.95"
"65","000","00","130","0001","1914","401","193","208","3","404","1050","0","38.48","18.38"
"65","000","00","130","0002","0000","740","369","371","13","753","1838","0","40.97","20.08"
"65","000","00","130","0002","1915","378","180","198","9","387","952","0","40.65","18.91"
"65","000","00","130","0002","1916","362","189","173","4","366","886","0","41.31","21.33"
"65","000","00","130","0003","0000","2585","1331","1254","18","2603","6368","0","40.88","20.90"
"65","000","00","130","0003","1922","621","309","312","6","627","1619","0","38.73","19.09"
"65","000","00","130","0003","1923","645","325","320","7","652","1625","0","40.12","20.00"
"65","000","00","130","0003","1924","654","330","324","0","654","1521","0","43.00","21.70"
"65","000","00","130","0003","1925","665","367","298","5","670","1603","0","41.80","22.89"
"65","000","00","130","0004","0000","1843","903","940","19","1862","4879","0","38.16","18.51"
"65","000","00","130","0004","1908","518","256","262","6","524","1322","0","39.64","19.36"
"65","000","00","130","0004","1909","439","206","233","5","444","1209","0","36.72","17.04"
"65","000","00","130","0004","1910","455","267","188","7","462","1171","0","39.45","22.80"
"65","000","00","130","0004","1911","431","174","257","1","432","1177","0","36.70","14.78"
"65","000","00","130","0005","0000","993","728","265","5","998","1844","0","54.12","39.48"
"65","000","00","130","0005","1917","455","321","134","3","458","895","0","51.17","35.87"
"65","000","00","130","0005","1918","538","407","131","2","540","949","0","56.90","42.89"
"65","000","00","130","0006","0000","1715","771","944","21","1736","4107","0","42.27","18.77"
"65","000","00","130","0006","1934","579","236","343","9","588","1365","0","43.08","17.29"
"65","000","00","130","0006","1935","506","280","226","3","509","1374","0","37.05","20.38"
"65","000","00","130","0006","1936","630","255","375","9","639","1368","0","46.71","18.64"
"65","000","00","130","0007","0000","2377","1047","1330","16","2393","5788","0","41.34","18.09"
"65","000","00","130","0007","1930","677","324","353","5","682","1558","0","43.77","20.80"
"65","000","00","130","0007","1931","624","285","339","4","628","1488","0","42.20","19.15"
"65","000","00","130","0007","1932","563","232","331","5","568","1477","0","38.46","15.71"
"65","000","00","130","0007","1933","513","206","307","2","515","1265","0","40.71","16.28"
"65","000","00","130","0008","0000","1615","705","910","7","1622","3999","0","40.56","17.63"
"65","000","00","130","0008","1941","470","212","258","2","472","1247","0","37.85","17.00"
"65","000","00","130","0008","1942","671","287","384","1","672","1652","0","40.68","17.37"
"65","000","00","130","0008","1943","474","206","268","4","478","1100","0","43.45","18.73"
"65","000","00","130","0009","0000","1322","652","670","15","1337","3209","0","41.66","20.32"
"65","000","00","130","0009","1972","466","221","245","5","471","1130","0","41.68","19.56"
"65","000","00","130","0009","1973","408","210","198","6","414","1017","0","40.71","20.65"
"65","000","00","130","0009","1974","448","221","227","4","452","1062","0","42.56","20.81"
"65","000","00","130","0010","0000","3174","1602","1572","19","3193","7337","0","43.52","21.83"
"65","000","00","130","0010","1954","636","271","365","2","638","1545","0","41.29","17.54"
"65","000","00","130","0010","1955","584","279","305","1","585","1409","0","41.52","19.80"
"65","000","00","130","0010","1956","648","313","335","5","653","1506","0","43.36","20.78"
"65","000","00","130","0010","1957","665","368","297","7","672","1470","0","45.71","25.03"
"65","000","00","130","0010","1958","641","371","270","4","645","1407","0","45.84","26.37"
"65","000","00","130","0011","0000","1075","443","632","10","1085","2741","0","39.58","16.16"
"65","000","00","130","0011","1944","528","210","318","7","535","1322","0","40.47","15.89"
"65","000","00","130","0011","1945","547","233","314","3","550","1419","0","38.76","16.42"
"65","000","00","130","0012","0000","2811","1309","1502","17","2828","7167","0","39.46","18.26"
"65","000","00","130","0012","1990","444","207","237","1","445","1261","0","35.29","16.42"
"65","000","00","130","0012","1991","535","250","285","3","538","1314","0","40.94","19.03"
"65","000","00","130","0012","1992","600","288","312","7","607","1512","0","40.15","19.05"
"65","000","00","130","0012","1993","646","290","356","3","649","1553","0","41.79","18.67"
"65","000","00","130","0012","1994","586","274","312","3","589","1527","0","38.57","17.94"
"65","000","00","130","0013","0000","1974","880","1094","27","2001","5572","0","35.91","15.79"
"65","000","00","130","0013","1979","497","199","298","5","502","1292","0","38.85","15.40"
"65","000","00","130","0013","1980","468","186","282","10","478","1483","0","32.23","12.54"
"65","000","00","130","0013","1981","505","216","289","3","508","1411","0","36.00","15.31"
"65","000","00","130","0013","1982","504","279","225","9","513","1386","0","37.01","20.13"
"65","000","00","130","0014","0000","1487","771","716","17","1504","3780","0","39.79","20.40"
"65","000","00","130","0014","1995","487","232","255","7","494","1228","0","40.23","18.89"
"65","000","00","130","0014","1996","444","231","213","7","451","1228","0","36.73","18.81"
"65","000","00","130","0014","1997","556","308","248","3","559","1324","0","42.22","23.26"
"65","000","00","130","0015","0000","579","214","365","4","583","1455","0","40.07","14.71"
"65","000","00","130","0015","1983","579","214","365","4","583","1455","0","40.07","14.71"
"65","000","00","130","0016","0000","2430","1230","1200","24","2454","6034","0","40.67","20.38"
"65","000","00","130","0016","1984","550","261","289","3","553","1479","0","37.39","17.65"
"65","000","00","130","0016","1985","628","331","297","2","630","1492","0","42.23","22.18"
"65","000","00","130","0016","1986","633","327","306","9","642","1565","0","41.02","20.89"
"65","000","00","130","0016","1987","619","311","308","10","629","1498","0","41.99","20.76"
"65","000","00","130","0017","0000","2371","1069","1302","24","2395","6492","0","36.89","16.47"
"65","000","00","130","0017","2008","559","248","311","4","563","1314","0","42.85","18.87"
"65","000","00","130","0017","2009","443","207","236","5","448","1306","0","34.30","15.85"
"65","000","00","130","0017","2010","394","186","208","2","396","1144","0","34.62","16.26"
"65","000","00","130","0017","2011","469","196","273","9","478","1267","0","37.73","15.47"
"65","000","00","130","0017","2012","506","232","274","4","510","1461","0","34.91","15.88"
"65","000","00","130","0018","0000","2471","1102","1369","26","2497","6188","0","40.35","17.81"
"65","000","00","130","0018","2022","575","258","317","4","579","1463","0","39.58","17.63"
"65","000","00","130","0018","2023","721","315","406","9","730","1610","0","45.34","19.57"
"65","000","00","130","0018","2024","574","275","299","6","580","1540","0","37.66","17.86"
"65","000","00","130","0018","2025","601","254","347","7","608","1575","0","38.60","16.13"
"65","000","00","130","0019","0000","1741","770","971","12","1753","4348","0","40.32","17.71"
"65","000","00","130","0019","2001","590","258","332","4","594","1312","0","45.27","19.66"
"65","000","00","130","0019","2002","562","283","279","4","566","1509","0","37.51","18.75"
"65","000","00","130","0019","2003","589","229","360","4","593","1527","0","38.83","15.00"
"65","000","00","130","0020","0000","1857","885","972","15","1872","4345","0","43.08","20.37"
"65","000","00","130","0020","1904","499","229","270","6","505","1220","0","41.39","18.77"
"65","000","00","130","0020","1905","563","240","323","3","566","1201","0","47.13","19.98"
"65","000","00","130","0020","1906","381","214","167","4","385","968","0","39.77","22.11"
"65","000","00","130","0020","1907","414","202","212","2","416","956","0","43.51","21.13"
"65","000","00","130","0021","0000","2686","1322","1364","21","2707","7273","0","37.22","18.18"
"65","000","00","130","0021","1899","511","227","284","4","515","1510","0","34.11","15.03"
"65","000","00","130","0021","1900","568","274","294","4","572","1484","0","38.54","18.46"
"65","000","00","130","0021","1901","481","205","276","4","485","1399","0","34.67","14.65"
"65","000","00","130","0021","1902","552","308","244","3","555","1357","0","40.90","22.70"
"65","000","00","130","0021","1903","574","308","266","6","580","1523","0","38.08","20.22"
"65","000","00","130","0022","0000","1732","804","928","23","1755","4244","0","41.35","18.94"
"65","000","00","130","0022","1896","535","251","284","11","546","1326","0","41.18","18.93"
"65","000","00","130","0022","1897","514","243","271","3","517","1329","0","38.90","18.28"
"65","000","00","130","0022","1898","683","310","373","9","692","1589","0","43.55","19.51"
"65","000","00","130","0023","0000","1720","851","869","23","1743","4447","0","39.19","19.14"
"65","000","00","130","0023","1893","570","281","289","6","576","1408","0","40.91","19.96"
"65","000","00","130","0023","1894","564","322","242","12","576","1556","0","37.02","20.69"
"65","000","00","130","0023","1895","586","248","338","5","591","1483","0","39.85","16.72"
"65","000","00","130","0024","0000","1794","890","904","21","1815","4672","0","38.85","19.05"
"65","000","00","130","0024","1890","478","237","241","8","486","1377","0","35.29","17.21"
"65","000","00","130","0024","1891","613","293","320","3","616","1638","0","37.61","17.89"
"65","000","00","130","0024","1892","703","360","343","10","713","1657","0","43.03","21.73"
"65","000","00","130","0025","0000","1153","723","430","9","1162","2561","0","45.37","28.23"
"65","000","00","130","0025","1888","566","331","235","5","571","1299","0","43.96","25.48"
"65","000","00","130","0025","1889","587","392","195","4","591","1262","0","46.83","31.06"
"65","000","00","130","0026","0000","571","217","354","3","574","1476","0","38.89","14.70"
"65","000","00","130","0026","1887","571","217","354","3","574","1476","0","38.89","14.70"
"65","000","00","130","0027","0000","1832","852","980","26","1858","4491","0","41.37","18.97"
"65","000","00","130","0027","1961","626","300","326","11","637","1559","0","40.86","19.24"
"65","000","00","130","0027","1962","583","223","360","6","589","1402","0","42.01","15.91"
"65","000","00","130","0027","1963","623","329","294","9","632","1530","0","41.31","21.50"
"65","000","00","130","0028","0000","2205","1129","1076","20","2225","4980","0","44.68","22.67"
"65","000","00","130","0028","1949","729","368","361","5","734","1695","0","43.30","21.71"
"65","000","00","130","0028","1950","755","419","336","8","763","1605","0","47.54","26.11"
"65","000","00","130","0028","1951","721","342","379","7","728","1680","0","43.33","20.36"
"65","000","00","130","0029","0000","1268","595","673","18","1286","3076","0","41.81","19.34"
"65","000","00","130","0029","1964","678","317","361","11","689","1574","0","43.77","20.14"
"65","000","00","130","0029","1965","590","278","312","7","597","1502","0","39.75","18.51"
"65","000","00","130","0030","0000","1526","735","791","8","1534","3907","0","39.26","18.81"
"65","000","00","130","0030","2016","512","248","264","5","517","1249","0","41.39","19.86"
"65","000","00","130","0030","2017","528","239","289","2","530","1314","0","40.33","18.19"
"65","000","00","130","0030","2018","486","248","238","1","487","1344","0","36.24","18.45"
"65","000","00","130","0031","0000","1816","824","992","14","1830","4353","0","42.04","18.93"
"65","000","00","130","0031","2026","627","286","341","6","633","1363","0","46.44","20.98"
"65","000","00","130","0031","2027","603","253","350","5","608","1489","0","40.83","16.99"
"65","000","00","130","0031","2028","586","285","301","3","589","1501","0","39.24","18.99"
"65","000","00","130","0032","0000","1168","556","612","10","1178","2751","0","42.82","20.21"
"65","000","00","130","0032","1977","595","291","304","4","599","1387","0","43.19","20.98"
"65","000","00","130","0032","1978","573","265","308","6","579","1364","0","42.45","19.43"
"65","000","00","130","0033","0000","1936","947","989","18","1954","4879","0","40.05","19.41"
"65","000","00","130","0033","1926","518","243","275","8","526","1264","0","41.61","19.22"
"65","000","00","130","0033","1927","397","187","210","4","401","1131","0","35.46","16.53"
"65","000","00","130","0033","1928","555","293","262","3","558","1306","0","42.73","22.43"
"65","000","00","130","0033","1929","466","224","242","3","469","1178","0","39.81","19.02"
"65","000","00","130","0034","0000","1436","624","812","13","1449","3854","0","37.60","16.19"
"65","000","00","130","0034","2013","443","209","234","5","448","1198","0","37.40","17.45"
"65","000","00","130","0034","2014","573","237","336","6","579","1443","0","40.12","16.42"
"65","000","00","130","0034","2015","420","178","242","2","422","1213","0","34.79","14.67"
"65","000","00","130","0035","0000","1627","778","849","18","1645","3997","0","41.16","19.46"
"65","000","00","130","0035","1946","458","208","250","2","460","1239","0","37.13","16.79"
"65","000","00","130","0035","1947","507","228","279","4","511","1314","0","38.89","17.35"
"65","000","00","130","0035","1948","662","342","320","12","674","1444","0","46.68","23.68"
"65","000","00","130","0036","0000","1979","879","1100","14","1993","4880","0","40.84","18.01"
"65","000","00","130","0036","1937","477","171","306","2","479","1117","0","42.88","15.31"
"65","000","00","130","0036","1938","500","229","271","4","504","1290","0","39.07","17.75"
"65","000","00","130","0036","1939","539","257","282","1","540","1342","0","40.24","19.15"
"65","000","00","130","0036","1940","463","222","241","7","470","1131","0","41.56","19.63"
"65","000","00","130","0037","0000","1438","725","713","13","1451","3873","0","37.46","18.72"
"65","000","00","130","0037","1919","486","249","237","9","495","1302","0","38.02","19.12"
"65","000","00","130","0037","1920","483","239","244","1","484","1333","0","36.31","17.93"
"65","000","00","130","0037","1921","469","237","232","3","472","1238","0","38.13","19.14"
"65","000","00","130","0038","0000","1816","863","953","14","1830","4972","0","36.81","17.36"
"65","000","00","130","0038","1998","465","246","219","5","470","1384","0","33.96","17.77"
"65","000","00","130","0038","1999","556","251","305","6","562","1556","0","36.12","16.13"
"65","000","00","130","0038","2000","795","366","429","3","798","2032","0","39.27","18.01"
"65","000","00","130","0039","0000","1299","558","741","3","1302","2895","0","44.97","19.27"
"65","000","00","130","0039","1952","577","261","316","1","578","1341","0","43.10","19.46"
"65","000","00","130","0039","1953","722","297","425","2","724","1554","0","46.59","19.11"
"65","000","00","130","0040","0000","2356","1135","1221","23","2379","5897","0","40.34","19.25"
"65","000","00","130","0040","2029","649","304","345","3","652","1527","0","42.70","19.91"
"65","000","00","130","0040","2030","535","261","274","5","540","1350","0","40.00","19.33"
"65","000","00","130","0040","2031","595","273","322","7","602","1493","0","40.32","18.29"
"65","000","00","130","0040","2032","577","297","280","8","585","1527","0","38.31","19.45"
"65","000","00","130","0041","0000","1212","620","592","12","1224","2851","0","42.93","21.75"
"65","000","00","130","0041","1975","631","318","313","6","637","1508","0","42.24","21.09"
"65","000","00","130","0041","1976","581","302","279","6","587","1343","0","43.71","22.49"
"65","000","00","130","0042","0000","1875","952","923","17","1892","4214","0","44.90","22.59"
"65","000","00","130","0042","1969","618","346","272","5","623","1431","0","43.54","24.18"
"65","000","00","130","0042","1970","606","287","319","5","611","1299","0","47.04","22.09"
"65","000","00","130","0042","1971","651","319","332","7","658","1484","0","44.34","21.50"
"65","000","00","130","0043","0000","2198","1137","1061","23","2221","5145","0","43.17","22.10"
"65","000","00","130","0043","1966","705","357","348","6","711","1689","0","42.10","21.14"
"65","000","00","130","0043","1967","698","348","350","12","710","1671","0","42.49","20.83"
"65","000","00","130","0043","1968","795","432","363","5","800","1785","0","44.82","24.20"
"65","000","00","130","0044","0000","1241","622","619","13","1254","3049","0","41.13","20.40"
"65","000","00","130","0044","1959","644","330","314","7","651","1592","0","40.89","20.73"
"65","000","00","130","0044","1960","597","292","305","6","603","1457","0","41.39","20.04"
"65","000","00","130","0045","0000","1078","488","590","5","1083","2621","0","41.32","18.62"
"65","000","00","130","0045","1988","621","274","347","1","622","1353","0","45.97","20.25"
"65","000","00","130","0045","1989","457","214","243","4","461","1268","0","36.36","16.88"
"65","000","00","130","0046","0000","1994","1116","878","16","2010","5390","0","37.29","20.71"
"65","000","00","130","0046","2004","469","268","201","1","470","1290","0","36.43","20.78"
"65","000","00","130","0046","2005","533","305","228","4","537","1377","0","39.00","22.15"
"65","000","00","130","0046","2006","495","279","216","6","501","1344","0","37.28","20.76"
"65","000","00","130","0046","2007","497","264","233","5","502","1379","0","36.40","19.14"
"65","000","00","130","0047","0000","1302","578","724","7","1309","3708","0","35.30","15.59"
"65","000","00","130","0047","2019","478","249","229","1","479","1358","0","35.27","18.34"
"65","000","00","130","0047","2020","375","164","211","2","377","1143","0","32.98","14.35"
"65","000","00","130","0047","2021","449","165","284","4","453","1207","0","37.53","13.67"
"65","000","00","140","0000","0000","67547","27955","39592","614","68161","170282","202131","40.03","16.42"
"65","000","00","140","0001","0000","4819","2192","2627","43","4862","11581","0","41.98","18.93"
"65","000","00","140","0001","0647","631","296","335","3","634","1574","0","40.28","18.81"
"65","000","00","140","0001","0648","765","356","409","8","773","1667","0","46.37","21.36"
"65","000","00","140","0001","0649","618","238","380","5","623","1537","0","40.53","15.48"
"65","000","00","140","0001","0650","831","403","428","4","835","1816","0","45.98","22.19"
"65","000","00","140","0001","0651","616","267","349","5","621","1588","0","39.11","16.81"
"65","000","00","140","0001","0652","712","338","374","10","722","1735","0","41.61","19.48"
"65","000","00","140","0001","0653","646","294","352","8","654","1664","0","39.30","17.67"
"65","000","00","140","0002","0000","2053","883","1170","12","2065","5216","0","39.59","16.93"
"65","000","00","140","0002","0638","568","280","288","2","570","1369","0","41.64","20.45"
"65","000","00","140","0002","0639","566","214","352","6","572","1342","0","42.62","15.95"
"65","000","00","140","0002","0640","455","181","274","0","455","1240","0","36.69","14.60"
"65","000","00","140","0002","0641","464","208","256","4","468","1265","0","37.00","16.44"
"65","000","00","140","0003","0000","1451","618","833","15","1466","3615","0","40.55","17.10"
"65","000","00","140","0003","0625","485","189","296","7","492","1311","0","37.53","14.42"
"65","000","00","140","0003","0626","599","259","340","7","606","1490","0","40.67","17.38"
"65","000","00","140","0003","0627","367","170","197","1","368","814","0","45.21","20.88"
"65","000","00","140","0004","0000","1923","826","1097","10","1933","4716","0","40.99","17.51"
"65","000","00","140","0004","0619","696","289","407","3","699","1591","0","43.93","18.16"
"65","000","00","140","0004","0620","614","255","359","5","619","1492","0","41.49","17.09"
"65","000","00","140","0004","0621","613","282","331","2","615","1633","0","37.66","17.27"
"65","000","00","140","0005","0000","1276","552","724","15","1291","3348","0","38.56","16.49"
"65","000","00","140","0005","0725","614","264","350","5","619","1636","0","37.84","16.14"
"65","000","00","140","0005","0726","662","288","374","10","672","1712","0","39.25","16.82"
"65","000","00","140","0006","0000","3648","1513","2135","33","3681","9167","0","40.15","16.50"
"65","000","00","140","0006","0715","769","337","432","8","777","1811","0","42.90","18.61"
"65","000","00","140","0006","0716","658","259","399","9","667","1803","0","36.99","14.36"
"65","000","00","140","0006","0717","761","298","463","6","767","1882","0","40.75","15.83"
"65","000","00","140","0006","0718","684","289","395","5","689","1805","0","38.17","16.01"
"65","000","00","140","0006","0719","776","330","446","5","781","1866","0","41.85","17.68"
"65","000","00","140","0007","0000","2464","1125","1339","20","2484","5872","0","42.30","19.16"
"65","000","00","140","0007","0671","664","323","341","7","671","1522","0","44.09","21.22"
"65","000","00","140","0007","0672","745","339","406","6","751","1714","0","43.82","19.78"
"65","000","00","140","0007","0673","435","171","264","2","437","1073","0","40.73","15.94"
"65","000","00","140","0007","0674","620","292","328","5","625","1563","0","39.99","18.68"
"65","000","00","140","0008","0000","1943","804","1139","13","1956","4812","0","40.65","16.71"
"65","000","00","140","0008","0685","714","300","414","3","717","1735","0","41.33","17.29"
"65","000","00","140","0008","0686","630","279","351","8","638","1573","0","40.56","17.74"
"65","000","00","140","0008","0687","599","225","374","2","601","1504","0","39.96","14.96"
"65","000","00","140","0009","0000","2238","1025","1213","21","2259","5571","0","40.55","18.40"
"65","000","00","140","0009","0688","513","222","291","6","519","1321","0","39.29","16.81"
"65","000","00","140","0009","0689","534","240","294","7","541","1380","0","39.20","17.39"
"65","000","00","140","0009","0690","507","213","294","4","511","1378","0","37.08","15.46"
"65","000","00","140","0009","0691","684","350","334","4","688","1492","0","46.11","23.46"
"65","000","00","140","0010","0000","1233","467","766","10","1243","2798","0","44.42","16.69"
"65","000","00","140","0010","0692","556","193","363","2","558","1306","0","42.73","14.78"
"65","000","00","140","0010","0693","677","274","403","8","685","1492","0","45.91","18.36"
"65","000","00","140","0011","0000","1297","552","745","14","1311","2888","0","45.39","19.11"
"65","000","00","140","0011","0706","695","306","389","7","702","1549","0","45.32","19.75"
"65","000","00","140","0011","0707","602","246","356","7","609","1339","0","45.48","18.37"
"65","000","00","140","0012","0000","940","385","555","12","952","2322","0","41.00","16.58"
"65","000","00","140","0012","0704","454","185","269","7","461","1151","0","40.05","16.07"
"65","000","00","140","0012","0705","486","200","286","5","491","1171","0","41.93","17.08"
"65","000","00","140","0013","0000","734","288","446","5","739","1885","0","39.20","15.28"
"65","000","00","140","0013","0694","734","288","446","5","739","1885","0","39.20","15.28"
"65","000","00","140","0014","0000","1182","489","693","9","1191","2972","0","40.07","16.45"
"65","000","00","140","0014","0700","540","237","303","3","543","1321","0","41.11","17.94"
"65","000","00","140","0014","0701","642","252","390","6","648","1651","0","39.25","15.26"
"65","000","00","140","0015","0000","1922","773","1149","16","1938","5162","0","37.54","14.97"
"65","000","00","140","0015","0654","584","215","369","2","586","1648","0","35.56","13.05"
"65","000","00","140","0015","0655","663","281","382","8","671","1726","0","38.88","16.28"
"65","000","00","140","0015","0656","675","277","398","6","681","1788","0","38.09","15.49"
"65","000","00","140","0016","0000","2138","918","1220","18","2156","5439","0","39.64","16.88"
"65","000","00","140","0016","0657","728","310","418","9","737","1869","0","39.43","16.59"
"65","000","00","140","0016","0658","686","299","387","2","688","1773","0","38.80","16.86"
"65","000","00","140","0016","0659","724","309","415","7","731","1797","0","40.68","17.20"
"65","000","00","140","0017","0000","2244","892","1352","28","2272","5948","0","38.20","15.00"
"65","000","00","140","0017","0664","505","187","318","2","507","1370","0","37.01","13.65"
"65","000","00","140","0017","0665","535","194","341","2","537","1452","0","36.98","13.36"
"65","000","00","140","0017","0666","573","239","334","18","591","1547","0","38.20","15.45"
"65","000","00","140","0017","0667","631","272","359","6","637","1579","0","40.34","17.23"
"65","000","00","140","0018","0000","1396","546","850","15","1411","3564","0","39.59","15.32"
"65","000","00","140","0018","0675","728","299","429","10","738","1798","0","41.05","16.63"
"65","000","00","140","0018","0676","668","247","421","5","673","1766","0","38.11","13.99"
"65","000","00","140","0019","0000","2201","965","1236","14","2215","5243","0","42.25","18.41"
"65","000","00","140","0019","0677","587","229","358","6","593","1439","0","41.21","15.91"
"65","000","00","140","0019","0678","556","248","308","4","560","1396","0","40.11","17.77"
"65","000","00","140","0019","0679","605","276","329","3","608","1362","0","44.64","20.26"
"65","000","00","140","0019","0680","453","212","241","1","454","1046","0","43.40","20.27"
"65","000","00","140","0020","0000","1360","508","852","7","1367","3166","0","43.18","16.05"
"65","000","00","140","0020","0681","677","253","424","3","680","1558","0","43.65","16.24"
"65","000","00","140","0020","0682","683","255","428","4","687","1608","0","42.72","15.86"
"65","000","00","140","0021","0000","3209","1278","1931","39","3248","8441","0","38.48","15.14"
"65","000","00","140","0021","0710","671","194","477","11","682","1706","0","39.98","11.37"
"65","000","00","140","0021","0711","586","235","351","4","590","1564","0","37.72","15.03"
"65","000","00","140","0021","0712","674","255","419","12","686","1798","0","38.15","14.18"
"65","000","00","140","0021","0713","657","239","418","5","662","1759","0","37.64","13.59"
"65","000","00","140","0021","0714","621","355","266","7","628","1614","0","38.91","22.00"
"65","000","00","140","0022","0000","1885","747","1138","19","1904","4663","0","40.83","16.02"
"65","000","00","140","0022","0720","656","252","404","4","660","1503","0","43.91","16.77"
"65","000","00","140","0022","0721","649","243","406","8","657","1644","0","39.96","14.78"
"65","000","00","140","0022","0722","580","252","328","7","587","1516","0","38.72","16.62"
"65","000","00","140","0023","0000","1022","419","603","11","1033","2855","0","36.18","14.68"
"65","000","00","140","0023","0645","457","188","269","6","463","1338","0","34.60","14.05"
"65","000","00","140","0023","0646","565","231","334","5","570","1517","0","37.57","15.23"
"65","000","00","140","0024","0000","1858","796","1062","12","1870","4834","0","38.68","16.47"
"65","000","00","140","0024","0631","616","254","362","5","621","1559","0","39.83","16.29"
"65","000","00","140","0024","0632","606","246","360","3","609","1595","0","38.18","15.42"
"65","000","00","140","0024","0633","636","296","340","4","640","1680","0","38.10","17.62"
"65","000","00","140","0025","0000","1253","493","760","12","1265","2975","0","42.52","16.57"
"65","000","00","140","0025","0636","634","215","419","7","641","1539","0","41.65","13.97"
"65","000","00","140","0025","0637","619","278","341","5","624","1436","0","43.45","19.36"
"65","000","00","140","0026","0000","1234","507","727","16","1250","2688","0","46.50","18.86"
"65","000","00","140","0026","0702","643","275","368","10","653","1327","0","49.21","20.72"
"65","000","00","140","0026","0703","591","232","359","6","597","1361","0","43.86","17.05"
"65","000","00","140","0027","0000","1963","791","1172","20","1983","4838","0","40.99","16.35"
"65","000","00","140","0027","0695","675","262","413","6","681","1714","0","39.73","15.29"
"65","000","00","140","0027","0696","667","290","377","9","676","1566","0","43.17","18.52"
"65","000","00","140","0027","0697","621","239","382","5","626","1558","0","40.18","15.34"
"65","000","00","140","0028","0000","1592","670","922","13","1605","4916","0","32.65","13.63"
"65","000","00","140","0028","0698","830","380","450","6","836","3136","0","26.66","12.12"
"65","000","00","140","0028","0699","762","290","472","7","769","1780","0","43.20","16.29"
"65","000","00","140","0029","0000","1710","685","1025","14","1724","4262","0","40.45","16.07"
"65","000","00","140","0029","0622","515","203","312","3","518","1319","0","39.27","15.39"
"65","000","00","140","0029","0623","564","194","370","4","568","1381","0","41.13","14.05"
"65","000","00","140","0029","0624","631","288","343","7","638","1562","0","40.85","18.44"
"65","000","00","140","0030","0000","1317","549","768","21","1338","3431","0","39.00","16.00"
"65","000","00","140","0030","0727","595","247","348","8","603","1560","0","38.65","15.83"
"65","000","00","140","0030","0728","722","302","420","13","735","1871","0","39.28","16.14"
"65","000","00","140","0031","0000","1622","580","1042","13","1635","4622","0","35.37","12.55"
"65","000","00","140","0031","0642","490","185","305","8","498","1537","0","32.40","12.04"
"65","000","00","140","0031","0643","576","187","389","3","579","1498","0","38.65","12.48"
"65","000","00","140","0031","0644","556","208","348","2","558","1587","0","35.16","13.11"
"65","000","00","140","0032","0000","1011","444","567","9","1020","2400","0","42.50","18.50"
"65","000","00","140","0032","0708","611","282","329","4","615","1483","0","41.47","19.02"
"65","000","00","140","0032","0709","400","162","238","5","405","917","0","44.17","17.67"
"65","000","00","140","0033","0000","874","311","563","7","881","2171","0","40.58","14.33"
"65","000","00","140","0033","0723","439","172","267","6","445","1183","0","37.62","14.54"
"65","000","00","140","0033","0724","435","139","296","1","436","988","0","44.13","14.07"
"65","000","00","140","0034","0000","1213","487","726","11","1224","2886","0","42.41","16.87"
"65","000","00","140","0034","0683","675","269","406","7","682","1655","0","41.21","16.25"
"65","000","00","140","0034","0684","538","218","320","4","542","1231","0","44.03","17.71"
"65","000","00","140","0035","0000","1842","694","1148","13","1855","4625","0","40.11","15.01"
"65","000","00","140","0035","0628","562","193","369","6","568","1367","0","41.55","14.12"
"65","000","00","140","0035","0629","700","299","401","6","706","1659","0","42.56","18.02"
"65","000","00","140","0035","0630","580","202","378","1","581","1599","0","36.34","12.63"
"65","000","00","140","0036","0000","1478","586","892","15","1493","3685","0","40.52","15.90"
"65","000","00","140","0036","0634","779","328","451","6","785","1897","0","41.38","17.29"
"65","000","00","140","0036","0635","699","258","441","9","708","1788","0","39.60","14.43"
"65","000","00","140","0037","0000","2590","1024","1566","26","2616","6695","0","39.07","15.29"
"65","000","00","140","0037","0660","621","254","367","4","625","1637","0","38.18","15.52"
"65","000","00","140","0037","0661","655","277","378","12","667","1729","0","38.58","16.02"
"65","000","00","140","0037","0662","680","268","412","6","686","1761","0","38.96","15.22"
"65","000","00","140","0037","0663","634","225","409","4","638","1568","0","40.69","14.35"
"65","000","00","140","0038","0000","1412","573","839","13","1425","4010","0","35.54","14.29"
"65","000","00","140","0038","0668","431","190","241","8","439","1382","0","31.77","13.75"
"65","000","00","140","0038","0669","518","197","321","1","519","1316","0","39.44","14.97"
"65","000","00","140","0038","0670","463","186","277","4","467","1312","0","35.59","14.18"
"65","000","00","150","0000","0000","30080","13456","16624","273","30353","76657","90027","39.60","17.55"
"65","000","00","150","0001","0000","1735","619","1116","16","1751","4197","0","41.72","14.75"
"65","000","00","150","0001","0243","572","189","383","4","576","1398","0","41.20","13.52"
"65","000","00","150","0001","0244","553","223","330","5","558","1495","0","37.32","14.92"
"65","000","00","150","0001","0245","610","207","403","7","617","1304","0","47.32","15.87"
"65","000","00","150","0002","0000","487","130","357","5","492","1073","0","45.85","12.12"
"65","000","00","150","0002","0246","487","130","357","5","492","1073","0","45.85","12.12"
"65","000","00","150","0003","0000","1483","610","873","13","1496","3475","0","43.05","17.55"
"65","000","00","150","0003","0248","692","282","410","8","700","1616","0","43.32","17.45"
"65","000","00","150","0003","0249","598","262","336","3","601","1381","0","43.52","18.97"
"65","000","00","150","0003","0250","193","66","127","2","195","478","0","40.79","13.81"
"65","000","00","150","0004","0000","496","140","356","3","499","1260","0","39.60","11.11"
"65","000","00","150","0004","0247","496","140","356","3","499","1260","0","39.60","11.11"
"65","000","00","150","0005","0000","1974","774","1200","17","1991","5457","0","36.49","14.18"
"65","000","00","150","0005","0255","550","208","342","2","552","1534","0","35.98","13.56"
"65","000","00","150","0005","0256","598","241","357","6","604","1546","0","39.07","15.59"
"65","000","00","150","0005","0257","381","146","235","3","384","1182","0","32.49","12.35"
"65","000","00","150","0005","0258","445","179","266","6","451","1195","0","37.74","14.98"
"65","000","00","150","0006","0000","2414","963","1451","15","2429","6462","0","37.59","14.90"
"65","000","00","150","0006","0259","685","328","357","3","688","2035","0","33.81","16.12"
"65","000","00","150","0006","0260","585","191","394","5","590","1499","0","39.36","12.74"
"65","000","00","150","0006","0261","551","207","344","2","553","1426","0","38.78","14.52"
"65","000","00","150","0006","0262","593","237","356","5","598","1502","0","39.81","15.78"
"65","000","00","150","0007","0000","522","136","386","5","527","1245","0","42.33","10.92"
"65","000","00","150","0007","0269","522","136","386","5","527","1245","0","42.33","10.92"
"65","000","00","150","0008","0000","1389","607","782","14","1403","3885","0","36.11","15.62"
"65","000","00","150","0008","0276","472","224","248","4","476","1638","0","29.06","13.68"
"65","000","00","150","0008","0277","489","232","257","5","494","1191","0","41.48","19.48"
"65","000","00","150","0008","0278","428","151","277","5","433","1056","0","41.00","14.30"
"65","000","00","150","0009","0000","1238","541","697","11","1249","3097","0","40.33","17.47"
"65","000","00","150","0009","0270","611","276","335","4","615","1519","0","40.49","18.17"
"65","000","00","150","0009","0271","627","265","362","7","634","1578","0","40.18","16.79"
"65","000","00","150","0010","0000","1942","945","997","26","1968","4718","0","41.71","20.03"
"65","000","00","150","0010","0279","599","313","286","11","610","1591","0","38.34","19.67"
"65","000","00","150","0010","0280","621","293","328","5","626","1475","0","42.44","19.86"
"65","000","00","150","0010","0281","722","339","383","10","732","1652","0","44.31","20.52"
"65","000","00","150","0011","0000","1047","841","206","12","1059","2315","0","45.75","36.33"
"65","000","00","150","0011","0294","532","425","107","4","536","1133","0","47.31","37.51"
"65","000","00","150","0011","0295","515","416","99","8","523","1182","0","44.25","35.19"
"65","000","00","150","0012","0000","1241","874","367","19","1260","2648","0","47.58","33.01"
"65","000","00","150","0012","0292","697","462","235","11","708","1418","0","49.93","32.58"
"65","000","00","150","0012","0293","544","412","132","8","552","1230","0","44.88","33.50"
"65","000","00","150","0013","0000","1548","769","779","20","1568","3948","0","39.72","19.48"
"65","000","00","150","0013","0289","515","264","251","6","521","1439","0","36.21","18.35"
"65","000","00","150","0013","0290","559","287","272","6","565","1324","0","42.67","21.68"
"65","000","00","150","0013","0291","474","218","256","8","482","1185","0","40.68","18.40"
"65","000","00","150","0014","0000","1113","472","641","7","1120","3009","0","37.22","15.69"
"65","000","00","150","0014","0253","532","235","297","3","535","1530","0","34.97","15.36"
"65","000","00","150","0014","0254","581","237","344","4","585","1479","0","39.55","16.02"
"65","000","00","150","0015","0000","1358","674","684","16","1374","3460","0","39.71","19.48"
"65","000","00","150","0015","0272","667","329","338","11","678","1737","0","39.03","18.94"
"65","000","00","150","0015","0273","691","345","346","5","696","1723","0","40.39","20.02"
"65","000","00","150","0016","0000","1492","579","913","10","1502","3661","0","41.03","15.82"
"65","000","00","150","0016","0251","759","304","455","5","764","1876","0","40.72","16.20"
"65","000","00","150","0016","0252","733","275","458","5","738","1785","0","41.34","15.41"
"65","000","00","150","0017","0000","1302","608","694","9","1311","3192","0","41.07","19.05"
"65","000","00","150","0017","0274","570","263","307","1","571","1480","0","38.58","17.77"
"65","000","00","150","0017","0275","732","345","387","8","740","1712","0","43.22","20.15"
"65","000","00","150","0018","0000","3541","1575","1966","20","3561","9533","0","37.35","16.52"
"65","000","00","150","0018","0263","414","203","211","1","415","1230","0","33.74","16.50"
"65","000","00","150","0018","0264","403","200","203","2","405","1151","0","35.19","17.38"
"65","000","00","150","0018","0265","697","348","349","2","699","1879","0","37.20","18.52"
"65","000","00","150","0018","0266","601","241","360","4","605","1635","0","37.00","14.74"
"65","000","00","150","0018","0267","720","316","404","2","722","1808","0","39.93","17.48"
"65","000","00","150","0018","0268","706","267","439","9","715","1830","0","39.07","14.59"
"65","000","00","150","0019","0000","2738","1149","1589","24","2762","7004","0","39.43","16.40"
"65","000","00","150","0019","0284","546","225","321","3","549","1436","0","38.23","15.67"
"65","000","00","150","0019","0285","500","190","310","3","503","1317","0","38.19","14.43"
"65","000","00","150","0019","0286","550","249","301","7","557","1359","0","40.99","18.32"
"65","000","00","150","0019","0287","570","242","328","9","579","1483","0","39.04","16.32"
"65","000","00","150","0019","0288","572","243","329","2","574","1409","0","40.74","17.25"
"65","000","00","150","0020","0000","1020","450","570","11","1031","3018","0","34.16","14.91"
"65","000","00","150","0020","0282","505","211","294","7","512","1440","0","35.56","14.65"
"65","000","00","150","0020","0283","515","239","276","4","519","1578","0","32.89","15.15"
"65","000","00","160","0000","0000","26213","12555","13658","229","26442","64477","77862","41.01","19.47"
"65","000","00","160","0001","0000","325","134","191","3","328","822","0","39.90","16.30"
"65","000","00","160","0001","0296","228","86","142","3","231","646","0","35.76","13.31"
"65","000","00","160","0001","0297","97","48","49","0","97","176","0","55.11","27.27"
"65","000","00","160","0002","0000","1225","598","627","7","1232","3030","0","40.66","19.74"
"65","000","00","160","0002","0298","614","284","330","3","617","1445","0","42.70","19.65"
"65","000","00","160","0002","0299","611","314","297","4","615","1585","0","38.80","19.81"
"65","000","00","160","0003","0000","2242","1058","1184","15","2257","5956","0","37.89","17.76"
"65","000","00","160","0003","0300","616","312","304","7","623","1689","0","36.89","18.47"
"65","000","00","160","0003","0301","659","294","365","3","662","1784","0","37.11","16.48"
"65","000","00","160","0003","0302","428","234","194","1","429","1197","0","35.84","19.55"
"65","000","00","160","0003","0303","539","218","321","4","543","1286","0","42.22","16.95"
"65","000","00","160","0004","0000","987","466","521","16","1003","2521","0","39.79","18.48"
"65","000","00","160","0004","0304","489","248","241","6","495","1254","0","39.47","19.78"
"65","000","00","160","0004","0305","498","218","280","10","508","1267","0","40.09","17.21"
"65","000","00","160","0005","0000","1538","757","781","18","1556","3870","0","40.21","19.56"
"65","000","00","160","0005","0308","502","265","237","10","512","1283","0","39.91","20.65"
"65","000","00","160","0005","0309","477","229","248","4","481","1254","0","38.36","18.26"
"65","000","00","160","0005","0310","559","263","296","4","563","1333","0","42.24","19.73"
"65","000","00","160","0006","0000","1508","774","734","14","1522","3617","0","42.08","21.40"
"65","000","00","160","0006","0311","553","321","232","7","560","1312","0","42.68","24.47"
"65","000","00","160","0006","0312","542","260","282","5","547","1221","0","44.80","21.29"
"65","000","00","160","0006","0313","413","193","220","2","415","1084","0","38.28","17.80"
"65","000","00","160","0007","0000","1668","778","890","15","1683","4172","0","40.34","18.65"
"65","000","00","160","0007","0322","592","261","331","4","596","1404","0","42.45","18.59"
"65","000","00","160","0007","0323","537","233","304","7","544","1446","0","37.62","16.11"
"65","000","00","160","0007","0324","539","284","255","4","543","1322","0","41.07","21.48"
"65","000","00","160","0008","0000","1440","680","760","18","1458","3385","0","43.07","20.09"
"65","000","00","160","0008","0330","472","223","249","4","476","1277","0","37.27","17.46"
"65","000","00","160","0008","0331","472","224","248","5","477","1076","0","44.33","20.82"
"65","000","00","160","0008","0332","496","233","263","9","505","1032","0","48.93","22.58"
"65","000","00","160","0009","0000","1570","739","831","9","1579","3571","0","44.22","20.69"
"65","000","00","160","0009","0337","527","249","278","1","528","1227","0","43.03","20.29"
"65","000","00","160","0009","0338","601","277","324","5","606","1329","0","45.60","20.84"
"65","000","00","160","0009","0339","442","213","229","3","445","1015","0","43.84","20.99"
"65","000","00","160","0010","0000","1815","863","952","17","1832","4404","0","41.60","19.60"
"65","000","00","160","0010","0343","565","303","262","9","574","1387","0","41.38","21.85"
"65","000","00","160","0010","0344","571","266","305","8","579","1367","0","42.36","19.46"
"65","000","00","160","0010","0345","679","294","385","0","679","1650","0","41.15","17.82"
"65","000","00","160","0011","0000","1376","585","791","12","1388","3234","0","42.92","18.09"
"65","000","00","160","0011","0314","451","221","230","5","456","1085","0","42.03","20.37"
"65","000","00","160","0011","0315","467","188","279","3","470","1108","0","42.42","16.97"
"65","000","00","160","0011","0316","458","176","282","4","462","1041","0","44.38","16.91"
"65","000","00","160","0012","0000","2888","1352","1536","20","2908","7169","0","40.56","18.86"
"65","000","00","160","0012","0325","603","265","338","8","611","1520","0","40.20","17.43"
"65","000","00","160","0012","0326","641","269","372","2","643","1565","0","41.09","17.19"
"65","000","00","160","0012","0327","484","235","249","5","489","1310","0","37.33","17.94"
"65","000","00","160","0012","0328","581","297","284","4","585","1577","0","37.10","18.83"
"65","000","00","160","0012","0329","579","286","293","1","580","1197","0","48.45","23.89"
"65","000","00","160","0013","0000","767","375","392","6","773","1857","0","41.63","20.19"
"65","000","00","160","0013","0333","370","197","173","2","372","954","0","38.99","20.65"
"65","000","00","160","0013","0334","397","178","219","4","401","903","0","44.41","19.71"
"65","000","00","160","0014","0000","1147","536","611","10","1157","2868","0","40.34","18.69"
"65","000","00","160","0014","0335","561","254","307","4","565","1396","0","40.47","18.19"
"65","000","00","160","0014","0336","586","282","304","6","592","1472","0","40.22","19.16"
"65","000","00","160","0015","0000","1532","766","766","12","1544","3300","0","46.79","23.21"
"65","000","00","160","0015","0340","567","291","276","3","570","1110","0","51.35","26.22"
"65","000","00","160","0015","0341","479","255","224","0","479","1150","0","41.65","22.17"
"65","000","00","160","0015","0342","486","220","266","9","495","1040","0","47.60","21.15"
"65","000","00","160","0016","0000","1257","647","610","12","1269","3114","0","40.75","20.78"
"65","000","00","160","0016","0306","585","293","292","8","593","1513","0","39.19","19.37"
"65","000","00","160","0016","0307","672","354","318","4","676","1601","0","42.22","22.11"
"65","000","00","160","0017","0000","2928","1447","1481","25","2953","7587","0","38.92","19.07"
"65","000","00","160","0017","0317","537","265","272","7","544","1571","0","34.63","16.87"
"65","000","00","160","0017","0318","605","294","311","5","610","1584","0","38.51","18.56"
"65","000","00","160","0017","0319","726","376","350","5","731","1661","0","44.01","22.64"
"65","000","00","160","0017","0320","563","282","281","6","569","1479","0","38.47","19.07"
"65","000","00","160","0017","0321","497","230","267","2","499","1292","0","38.62","17.80"
"65","000","00","170","0000","0000","39406","20629","18777","351","39757","97167","123095","40.92","21.23"
"65","000","00","170","0001","0000","1224","518","706","14","1238","3528","0","35.09","14.68"
"65","000","00","170","0001","0167","386","159","227","5","391","1217","0","32.13","13.06"
"65","000","00","170","0001","0168","356","160","196","3","359","1114","0","32.23","14.36"
"65","000","00","170","0001","0169","482","199","283","6","488","1197","0","40.77","16.62"
"65","000","00","170","0002","0000","1728","829","899","19","1747","4811","0","36.31","17.23"
"65","000","00","170","0002","0170","507","260","247","7","514","1383","0","37.17","18.80"
"65","000","00","170","0002","0171","402","190","212","2","404","1157","0","34.92","16.42"
"65","000","00","170","0002","0172","420","194","226","4","424","1197","0","35.42","16.21"
"65","000","00","170","0002","0173","399","185","214","6","405","1074","0","37.71","17.23"
"65","000","00","170","0003","0000","3756","1934","1822","26","3782","9419","0","40.15","20.53"
"65","000","00","170","0003","0174","451","198","253","8","459","1292","0","35.53","15.33"
"65","000","00","170","0003","0175","388","203","185","1","389","1337","0","29.09","15.18"
"65","000","00","170","0003","0176","519","275","244","3","522","1367","0","38.19","20.12"
"65","000","00","170","0003","0177","638","347","291","2","640","1385","0","46.21","25.05"
"65","000","00","170","0003","0178","619","301","318","5","624","1351","0","46.19","22.28"
"65","000","00","170","0003","0179","563","281","282","4","567","1282","0","44.23","21.92"
"65","000","00","170","0003","0180","578","329","249","3","581","1405","0","41.35","23.42"
"65","000","00","170","0004","0000","1650","716","934","18","1668","3771","0","44.23","18.99"
"65","000","00","170","0004","0181","626","264","362","11","637","1345","0","47.36","19.63"
"65","000","00","170","0004","0182","423","145","278","6","429","1162","0","36.92","12.48"
"65","000","00","170","0004","0183","601","307","294","1","602","1264","0","47.63","24.29"
"65","000","00","170","0005","0000","1552","720","832","12","1564","4170","0","37.51","17.27"
"65","000","00","170","0005","0184","507","230","277","2","509","1348","0","37.76","17.06"
"65","000","00","170","0005","0185","456","253","203","4","460","1373","0","33.50","18.43"
"65","000","00","170","0005","0186","589","237","352","6","595","1449","0","41.06","16.36"
"65","000","00","170","0006","0000","613","227","386","10","623","1384","0","45.01","16.40"
"65","000","00","170","0006","0187","613","227","386","10","623","1384","0","45.01","16.40"
"65","000","00","170","0007","0000","8367","4693","3674","58","8425","20700","0","40.70","22.67"
"65","000","00","170","0007","0188","445","277","168","2","447","1181","0","37.85","23.45"
"65","000","00","170","0007","0189","447","279","168","5","452","1225","0","36.90","22.78"
"65","000","00","170","0007","0190","518","287","231","1","519","1363","0","38.08","21.06"
"65","000","00","170","0007","0191","554","328","226","4","558","1362","0","40.97","24.08"
"65","000","00","170","0007","0192","471","281","190","0","471","1228","0","38.36","22.88"
"65","000","00","170","0007","0193","507","305","202","3","510","1165","0","43.78","26.18"
"65","000","00","170","0007","0194","552","331","221","3","555","1168","0","47.52","28.34"
"65","000","00","170","0007","0195","642","352","290","8","650","1433","0","45.36","24.56"
"65","000","00","170","0007","0196","556","315","241","2","558","1194","0","46.73","26.38"
"65","000","00","170","0007","0197","510","297","213","2","512","1245","0","41.12","23.86"
"65","000","00","170","0007","0198","548","245","303","0","548","1353","0","40.50","18.11"
"65","000","00","170","0007","0199","472","224","248","4","476","1097","0","43.39","20.42"
"65","000","00","170","0007","0200","560","305","255","3","563","1447","0","38.91","21.08"
"65","000","00","170","0007","0201","509","268","241","1","510","1384","0","36.85","19.36"
"65","000","00","170","0007","0202","548","303","245","6","554","1421","0","38.99","21.32"
"65","000","00","170","0007","0203","528","296","232","14","542","1434","0","37.80","20.64"
"65","000","00","170","0008","0000","8653","4745","3908","74","8727","20299","0","42.99","23.38"
"65","000","00","170","0008","0204","560","259","301","2","562","1444","0","38.92","17.94"
"65","000","00","170","0008","0205","631","324","307","5","636","1365","0","46.59","23.74"
"65","000","00","170","0008","0206","504","231","273","9","513","1343","0","38.20","17.20"
"65","000","00","170","0008","0207","555","342","213","2","557","1258","0","44.28","27.19"
"65","000","00","170","0008","0208","566","312","254","10","576","1264","0","45.57","24.68"
"65","000","00","170","0008","0209","553","315","238","6","559","1274","0","43.88","24.73"
"65","000","00","170","0008","0210","621","334","287","2","623","1312","0","47.48","25.46"
"65","000","00","170","0008","0211","645","357","288","8","653","1413","0","46.21","25.27"
"65","000","00","170","0008","0212","558","307","251","3","561","1254","0","44.74","24.48"
"65","000","00","170","0008","0213","581","355","226","3","584","1351","0","43.23","26.28"
"65","000","00","170","0008","0214","541","302","239","4","545","1365","0","39.93","22.12"
"65","000","00","170","0008","0215","651","359","292","6","657","1702","0","38.60","21.09"
"65","000","00","170","0008","0216","594","324","270","5","599","1356","0","44.17","23.89"
"65","000","00","170","0008","0217","576","336","240","7","583","1379","0","42.28","24.37"
"65","000","00","170","0008","0218","517","288","229","2","519","1219","0","42.58","23.63"
"65","000","00","170","0009","0000","2725","1502","1223","26","2751","6489","0","42.39","23.15"
"65","000","00","170","0009","0230","520","281","239","6","526","1189","0","44.24","23.63"
"65","000","00","170","0009","0231","598","338","260","3","601","1262","0","47.62","26.78"
"65","000","00","170","0009","0232","488","287","201","5","493","1253","0","39.35","22.91"
"65","000","00","170","0009","0233","594","310","284","3","597","1315","0","45.40","23.57"
"65","000","00","170","0009","0234","525","286","239","9","534","1470","0","36.33","19.46"
"65","000","00","170","0010","0000","357","107","250","3","360","1010","0","35.64","10.59"
"65","000","00","170","0010","0238","357","107","250","3","360","1010","0","35.64","10.59"
"65","000","00","170","0011","0000","450","203","247","7","457","1229","0","37.18","16.52"
"65","000","00","170","0011","0239","450","203","247","7","457","1229","0","37.18","16.52"
"65","000","00","170","0012","0000","395","135","260","6","401","911","0","44.02","14.82"
"65","000","00","170","0012","0240","395","135","260","6","401","911","0","44.02","14.82"
"65","000","00","170","0013","0000","262","94","168","1","263","763","0","34.47","12.32"
"65","000","00","170","0013","0241","262","94","168","1","263","763","0","34.47","12.32"
"65","000","00","170","0014","0000","462","153","309","4","466","1461","0","31.90","10.47"
"65","000","00","170","0014","0242","462","153","309","4","466","1461","0","31.90","10.47"
"65","000","00","170","0015","0000","2514","1436","1078","22","2536","6006","0","42.22","23.91"
"65","000","00","170","0015","0219","406","221","185","7","413","1099","0","37.58","20.11"
"65","000","00","170","0015","0220","484","295","189","4","488","1157","0","42.18","25.50"
"65","000","00","170","0015","0221","454","258","196","4","458","1191","0","38.46","21.66"
"65","000","00","170","0015","0222","552","335","217","2","554","1190","0","46.55","28.15"
"65","000","00","170","0015","0223","618","327","291","5","623","1369","0","45.51","23.89"
"65","000","00","170","0016","0000","3144","1820","1324","33","3177","7589","0","41.86","23.98"
"65","000","00","170","0016","0224","569","327","242","3","572","1355","0","42.21","24.13"
"65","000","00","170","0016","0225","422","240","182","6","428","1140","0","37.54","21.05"
"65","000","00","170","0016","0226","479","294","185","6","485","1207","0","40.18","24.36"
"65","000","00","170","0016","0227","515","297","218","5","520","1233","0","42.17","24.09"
"65","000","00","170","0016","0228","580","341","239","9","589","1404","0","41.95","24.29"
"65","000","00","170","0016","0229","579","321","258","4","583","1250","0","46.64","25.68"
"65","000","00","170","0017","0000","1554","797","757","18","1572","3627","0","43.34","21.97"
"65","000","00","170","0017","0235","510","261","249","6","516","1308","0","39.45","19.95"
"65","000","00","170","0017","0236","501","262","239","1","502","1126","0","44.58","23.27"
"65","000","00","170","0017","0237","543","274","269","11","554","1193","0","46.44","22.97"
"65","000","00","180","0000","0000","9002","4763","4239","70","9072","20901","23730","43.40","22.79"
"65","000","00","180","0001","0000","1328","647","681","9","1337","3097","0","43.17","20.89"
"65","000","00","180","0001","2326","618","276","342","5","623","1536","0","40.56","17.97"
"65","000","00","180","0001","2327","710","371","339","4","714","1561","0","45.74","23.77"
"65","000","00","180","0002","0000","955","465","490","9","964","2316","0","41.62","20.08"
"65","000","00","180","0002","2320","448","205","243","2","450","1157","0","38.89","17.72"
"65","000","00","180","0002","2321","507","260","247","7","514","1159","0","44.35","22.43"
"65","000","00","180","0003","0000","1141","587","554","12","1153","2749","0","41.94","21.35"
"65","000","00","180","0003","2324","588","305","283","6","594","1376","0","43.17","22.17"
"65","000","00","180","0003","2325","553","282","271","6","559","1373","0","40.71","20.54"
"65","000","00","180","0004","0000","901","513","388","9","910","1926","0","47.25","26.64"
"65","000","00","180","0004","2332","343","147","196","6","349","765","0","45.62","19.22"
"65","000","00","180","0004","2333","558","366","192","3","561","1161","0","48.32","31.52"
"65","000","00","180","0005","0000","234","109","125","4","238","558","0","42.65","19.53"
"65","000","00","180","0005","2336","234","109","125","4","238","558","0","42.65","19.53"
"65","000","00","180","0006","0000","2432","1338","1094","15","2447","5654","0","43.28","23.66"
"65","000","00","180","0006","2328","616","333","283","5","621","1458","0","42.59","22.84"
"65","000","00","180","0006","2329","629","364","265","4","633","1402","0","45.15","25.96"
"65","000","00","180","0006","2330","551","310","241","5","556","1334","0","41.68","23.24"
"65","000","00","180","0006","2331","636","331","305","1","637","1460","0","43.63","22.67"
"65","000","00","180","0007","0000","1045","530","515","6","1051","2486","0","42.28","21.32"
"65","000","00","180","0007","2322","438","203","235","2","440","1063","0","41.39","19.10"
"65","000","00","180","0007","2323","607","327","280","4","611","1423","0","42.94","22.98"
"65","000","00","180","0008","0000","966","574","392","6","972","2115","0","45.96","27.14"
"65","000","00","180","0008","2334","619","378","241","5","624","1380","0","45.22","27.39"
"65","000","00","180","0008","2335","347","196","151","1","348","735","0","47.35","26.67"
"65","000","00","190","0000","0000","2607","1035","1572","26","2633","6790","7487","38.78","15.24"
"65","000","00","190","0001","0000","142","58","84","1","143","365","0","39.18","15.89"
"65","000","00","190","0001","2337","142","58","84","1","143","365","0","39.18","15.89"
"65","000","00","190","0002","0000","293","154","139","1","294","798","0","36.84","19.30"
"65","000","00","190","0002","2338","293","154","139","1","294","798","0","36.84","19.30"
"65","000","00","190","0003","0000","235","98","137","5","240","668","0","35.93","14.67"
"65","000","00","190","0003","2343","235","98","137","5","240","668","0","35.93","14.67"
"65","000","00","190","0004","0000","242","88","154","3","245","607","0","40.36","14.50"
"65","000","00","190","0004","2339","242","88","154","3","245","607","0","40.36","14.50"
"65","000","00","190","0005","0000","104","49","55","2","106","296","0","35.81","16.55"
"65","000","00","190","0005","2340","104","49","55","2","106","296","0","35.81","16.55"
"65","000","00","190","0006","0000","184","79","105","1","185","387","0","47.80","20.41"
"65","000","00","190","0006","2341","134","58","76","0","134","291","0","46.05","19.93"
"65","000","00","190","0006","2342","50","21","29","1","51","96","0","53.13","21.88"
"65","000","00","190","0007","0000","204","80","124","1","205","589","0","34.80","13.58"
"65","000","00","190","0007","2346","204","80","124","1","205","589","0","34.80","13.58"
"65","000","00","190","0008","0000","249","98","151","2","251","717","0","35.01","13.67"
"65","000","00","190","0008","2345","249","98","151","2","251","717","0","35.01","13.67"
"65","000","00","190","0009","0000","106","32","74","1","107","261","0","41.00","12.26"
"65","000","00","190","0009","2347","106","32","74","1","107","261","0","41.00","12.26"
"65","000","00","190","0010","0000","124","57","67","0","124","302","0","41.06","18.87"
"65","000","00","190","0010","2344","124","57","67","0","124","302","0","41.06","18.87"
"65","000","00","190","0011","0000","313","104","209","6","319","809","0","39.43","12.86"
"65","000","00","190","0011","2348","313","104","209","6","319","809","0","39.43","12.86"
"65","000","00","190","0012","0000","411","138","273","3","414","991","0","41.78","13.93"
"65","000","00","190","0012","2349","411","138","273","3","414","991","0","41.78","13.93"
"65","000","00","200","0000","0000","2198","829","1369","26","2224","6057","6670","36.72","13.69"
"65","000","00","200","0001","0000","322","138","184","5","327","853","0","38.34","16.18"
"65","000","00","200","0001","2354","220","88","132","2","222","583","0","38.08","15.09"
"65","000","00","200","0001","2355","102","50","52","3","105","270","0","38.89","18.52"
"65","000","00","200","0002","0000","499","210","289","3","502","1290","0","38.91","16.28"
"65","000","00","200","0002","2350","499","210","289","3","502","1290","0","38.91","16.28"
"65","000","00","200","0003","0000","441","131","310","3","444","1167","0","38.05","11.23"
"65","000","00","200","0003","2352","441","131","310","3","444","1167","0","38.05","11.23"
"65","000","00","200","0004","0000","136","44","92","3","139","420","0","33.10","10.48"
"65","000","00","200","0004","2353","136","44","92","3","139","420","0","33.10","10.48"
"65","000","00","200","0005","0000","278","128","150","6","284","836","0","33.97","15.31"
"65","000","00","200","0005","2356","111","33","78","1","112","350","0","32.00","9.43"
"65","000","00","200","0005","2357","167","95","72","5","172","486","0","35.39","19.55"
"65","000","00","200","0006","0000","212","83","129","0","212","631","0","33.60","13.15"
"65","000","00","200","0006","2351","212","83","129","0","212","631","0","33.60","13.15"
"65","000","00","200","0007","0000","310","95","215","6","316","860","0","36.74","11.05"
"65","000","00","200","0007","2358","161","49","112","1","162","402","0","40.30","12.19"
"65","000","00","200","0007","2359","149","46","103","5","154","458","0","33.62","10.04"
"65","000","00","210","0000","0000","6781","3518","3263","74","6855","19927","22460","34.40","17.65"
"65","000","00","210","0001","0000","106","29","77","1","107","311","0","34.41","9.32"
"65","000","00","210","0001","0011","106","29","77","1","107","311","0","34.41","9.32"
"65","000","00","210","0002","0000","1555","814","741","12","1567","4787","0","32.73","17.00"
"65","000","00","210","0002","0012","400","227","173","4","404","1228","0","32.90","18.49"
"65","000","00","210","0002","0013","428","223","205","4","432","1228","0","35.18","18.16"
"65","000","00","210","0002","0014","394","201","193","2","396","1250","0","31.68","16.08"
"65","000","00","210","0002","0015","333","163","170","2","335","1081","0","30.99","15.08"
"65","000","00","210","0003","0000","381","196","185","3","384","1113","0","34.50","17.61"
"65","000","00","210","0003","0016","381","196","185","3","384","1113","0","34.50","17.61"
"65","000","00","210","0004","0000","271","143","128","5","276","776","0","35.57","18.43"
"65","000","00","210","0004","0017","271","143","128","5","276","776","0","35.57","18.43"
"65","000","00","210","0005","0000","1893","1023","870","27","1920","6124","0","31.35","16.70"
"65","000","00","210","0005","0018","410","216","194","6","416","1267","0","32.83","17.05"
"65","000","00","210","0005","0019","400","202","198","8","408","1324","0","30.82","15.26"
"65","000","00","210","0005","0020","374","205","169","3","377","1174","0","32.11","17.46"
"65","000","00","210","0005","0021","348","183","165","5","353","1207","0","29.25","15.16"
"65","000","00","210","0005","0022","361","217","144","5","366","1152","0","31.77","18.84"
"65","000","00","210","0006","0000","276","139","137","3","279","604","0","46.19","23.01"
"65","000","00","210","0006","0023","276","139","137","3","279","604","0","46.19","23.01"
"65","000","00","210","0007","0000","160","92","68","2","162","477","0","33.96","19.29"
"65","000","00","210","0007","0024","160","92","68","2","162","477","0","33.96","19.29"
"65","000","00","210","0008","0000","281","127","154","4","285","661","0","43.12","19.21"
"65","000","00","210","0008","0025","281","127","154","4","285","661","0","43.12","19.21"
"65","000","00","210","0009","0000","776","461","315","4","780","2030","0","38.42","22.71"
"65","000","00","210","0009","0026","316","167","149","2","318","862","0","36.89","19.37"
"65","000","00","210","0009","0027","460","294","166","2","462","1168","0","39.55","25.17"
"65","000","00","210","0010","0000","302","155","147","2","304","762","0","39.90","20.34"
"65","000","00","210","0010","0028","302","155","147","2","304","762","0","39.90","20.34"
"65","000","00","210","0011","0000","155","92","63","3","158","532","0","29.70","17.29"
"65","000","00","210","0011","0029","155","92","63","3","158","532","0","29.70","17.29"
"65","000","00","210","0012","0000","191","75","116","1","192","580","0","33.10","12.93"
"65","000","00","210","0012","0030","191","75","116","1","192","580","0","33.10","12.93"
"65","000","00","210","0013","0000","434","172","262","7","441","1170","0","37.69","14.70"
"65","000","00","210","0013","0031","434","172","262","7","441","1170","0","37.69","14.70"
"65","000","00","220","0000","0000","3193","1635","1558","56","3249","10089","11303","32.20","16.21"
"65","000","00","220","0001","0000","334","157","177","8","342","1087","0","31.46","14.44"
"65","000","00","220","0001","0001","334","157","177","8","342","1087","0","31.46","14.44"
"65","000","00","220","0002","0000","483","250","233","5","488","1316","0","37.08","19.00"
"65","000","00","220","0002","0002","483","250","233","5","488","1316","0","37.08","19.00"
"65","000","00","220","0003","0000","623","310","313","13","636","2052","0","30.99","15.11"
"65","000","00","220","0003","0003","315","167","148","6","321","876","0","36.64","19.06"
"65","000","00","220","0003","0004","308","143","165","7","315","1176","0","26.79","12.16"
"65","000","00","220","0004","0000","264","129","135","6","270","867","0","31.14","14.88"
"65","000","00","220","0004","0005","264","129","135","6","270","867","0","31.14","14.88"
"65","000","00","220","0005","0000","515","296","219","10","525","1496","0","35.09","19.79"
"65","000","00","220","0005","0006","515","296","219","10","525","1496","0","35.09","19.79"
"65","000","00","220","0006","0000","425","211","214","8","433","1452","0","29.82","14.53"
"65","000","00","220","0006","0007","425","211","214","8","433","1452","0","29.82","14.53"
"65","000","00","220","0007","0000","98","53","45","2","100","315","0","31.75","16.83"
"65","000","00","220","0007","0008","98","53","45","2","100","315","0","31.75","16.83"
"65","000","00","220","0008","0000","193","94","99","1","194","589","0","32.94","15.96"
"65","000","00","220","0008","0009","193","94","99","1","194","589","0","32.94","15.96"
"65","000","00","220","0009","0000","258","135","123","3","261","915","0","28.52","14.75"
"65","000","00","220","0009","0010","258","135","123","3","261","915","0","28.52","14.75"
"65","000","00","230","0000","0000","12721","5996","6725","106","12827","34221","39799","37.48","17.52"
"65","000","00","230","0001","0000","2781","1381","1400","20","2801","6740","0","41.56","20.49"
"65","000","00","230","0001","0146","712","294","418","7","719","1851","0","38.84","15.88"
"65","000","00","230","0001","0147","716","396","320","5","721","1727","0","41.75","22.93"
"65","000","00","230","0001","0148","609","309","300","5","614","1504","0","40.82","20.55"
"65","000","00","230","0001","0149","744","382","362","3","747","1658","0","45.05","23.04"
"65","000","00","230","0002","0000","1191","596","595","8","1199","3256","0","36.82","18.30"
"65","000","00","230","0002","0150","618","304","314","3","621","1748","0","35.53","17.39"
"65","000","00","230","0002","0151","573","292","281","5","578","1508","0","38.33","19.36"
"65","000","00","230","0003","0000","1208","534","674","6","1214","3091","0","39.28","17.28"
"65","000","00","230","0003","0152","680","302","378","3","683","1611","0","42.40","18.75"
"65","000","00","230","0003","0153","528","232","296","3","531","1480","0","35.88","15.68"
"65","000","00","230","0004","0000","1411","631","780","15","1426","3745","0","38.08","16.85"
"65","000","00","230","0004","0154","626","244","382","3","629","1770","0","35.54","13.79"
"65","000","00","230","0004","0155","785","387","398","12","797","1975","0","40.35","19.59"
"65","000","00","230","0005","0000","779","382","397","8","787","2139","0","36.79","17.86"
"65","000","00","230","0005","0156","779","382","397","8","787","2139","0","36.79","17.86"
"65","000","00","230","0006","0000","2321","1069","1252","20","2341","6501","0","36.01","16.44"
"65","000","00","230","0006","0157","583","258","325","5","588","1568","0","37.50","16.45"
"65","000","00","230","0006","0158","601","282","319","6","607","1630","0","37.24","17.30"
"65","000","00","230","0006","0159","593","269","324","4","597","1656","0","36.05","16.24"
"65","000","00","230","0006","0160","544","260","284","5","549","1647","0","33.33","15.79"
"65","000","00","230","0007","0000","1469","676","793","9","1478","4113","0","35.93","16.44"
"65","000","00","230","0007","0161","533","247","286","2","535","1388","0","38.54","17.80"
"65","000","00","230","0007","0162","442","203","239","1","443","1380","0","32.10","14.71"
"65","000","00","230","0007","0163","494","226","268","6","500","1345","0","37.17","16.80"
"65","000","00","230","0008","0000","560","249","311","5","565","1639","0","34.47","15.19"
"65","000","00","230","0008","0164","560","249","311","5","565","1639","0","34.47","15.19"
"65","000","00","230","0009","0000","507","224","283","8","515","1521","0","33.86","14.73"
"65","000","00","230","0009","0165","507","224","283","8","515","1521","0","33.86","14.73"
"65","000","00","230","0010","0000","494","254","240","7","501","1476","0","33.94","17.21"
"65","000","00","230","0010","0166","494","254","240","7","501","1476","0","33.94","17.21"
"65","000","00","240","0000","0000","1451","676","775","23","1474","4076","4354","36.16","16.58"
"65","000","00","240","0001","0000","132","53","79","2","134","361","0","37.12","14.68"
"65","000","00","240","0001","2367","132","53","79","2","134","361","0","37.12","14.68"
"65","000","00","240","0002","0000","84","50","34","1","85","226","0","37.61","22.12"
"65","000","00","240","0002","2368","84","50","34","1","85","226","0","37.61","22.12"
"65","000","00","240","0003","0000","97","40","57","0","97","229","0","42.36","17.47"
"65","000","00","240","0003","2369","97","40","57","0","97","229","0","42.36","17.47"
"65","000","00","240","0004","0000","160","58","102","2","162","417","0","38.85","13.91"
"65","000","00","240","0004","2370","160","58","102","2","162","417","0","38.85","13.91"
"65","000","00","240","0005","0000","102","64","38","0","102","247","0","41.30","25.91"
"65","000","00","240","0005","2371","102","64","38","0","102","247","0","41.30","25.91"
"65","000","00","240","0006","0000","179","88","91","1","180","586","0","30.72","15.02"
"65","000","00","240","0006","2372","179","88","91","1","180","586","0","30.72","15.02"
"65","000","00","240","0007","0000","157","72","85","3","160","406","0","39.41","17.73"
"65","000","00","240","0007","2373","157","72","85","3","160","406","0","39.41","17.73"
"65","000","00","240","0008","0000","58","25","33","0","58","154","0","37.66","16.23"
"65","000","00","240","0008","2375","58","25","33","0","58","154","0","37.66","16.23"
"65","000","00","240","0009","0000","120","54","66","4","124","337","0","36.80","16.02"
"65","000","00","240","0009","2376","120","54","66","4","124","337","0","36.80","16.02"
"65","000","00","240","0010","0000","72","31","41","0","72","164","0","43.90","18.90"
"65","000","00","240","0010","2378","72","31","41","0","72","164","0","43.90","18.90"
"65","000","00","240","0011","0000","250","120","130","10","260","798","0","32.58","15.04"
"65","000","00","240","0011","2374","250","120","130","10","260","798","0","32.58","15.04"
"65","000","00","240","0012","0000","40","21","19","0","40","151","0","26.49","13.91"
"65","000","00","240","0012","2377","40","21","19","0","40","151","0","26.49","13.91"
"65","000","00","250","0000","0000","2687","1296","1391","49","2736","7605","8307","35.98","17.04"
"65","000","00","250","0001","0000","176","101","75","3","179","444","0","40.32","22.75"
"65","000","00","250","0001","2425","176","101","75","3","179","444","0","40.32","22.75"
"65","000","00","250","0002","0000","131","55","76","3","134","363","0","36.91","15.15"
"65","000","00","250","0002","2437","131","55","76","3","134","363","0","36.91","15.15"
"65","000","00","250","0003","0000","295","157","138","9","304","713","0","42.64","22.02"
"65","000","00","250","0003","2426","118","69","49","4","122","268","0","45.52","25.75"
"65","000","00","250","0003","2427","177","88","89","5","182","445","0","40.90","19.78"
"65","000","00","250","0004","0000","229","103","126","5","234","678","0","34.51","15.19"
"65","000","00","250","0004","2438","108","41","67","1","109","337","0","32.34","12.17"
"65","000","00","250","0004","2439","121","62","59","4","125","341","0","36.66","18.18"
"65","000","00","250","0005","0000","122","54","68","2","124","345","0","35.94","15.65"
"65","000","00","250","0005","2428","122","54","68","2","124","345","0","35.94","15.65"
"65","000","00","250","0006","0000","492","233","259","10","502","1416","0","35.45","16.45"
"65","000","00","250","0006","2429","278","123","155","4","282","800","0","35.25","15.38"
"65","000","00","250","0006","2430","214","110","104","6","220","616","0","35.71","17.86"
"65","000","00","250","0007","0000","107","50","57","1","108","319","0","33.86","15.67"
"65","000","00","250","0007","2431","107","50","57","1","108","319","0","33.86","15.67"
"65","000","00","250","0008","0000","330","180","150","2","332","860","0","38.60","20.93"
"65","000","00","250","0008","2432","214","116","98","2","216","602","0","35.88","19.27"
"65","000","00","250","0008","2433","116","64","52","0","116","258","0","44.96","24.81"
"65","000","00","250","0009","0000","203","86","117","8","211","593","0","35.58","14.50"
"65","000","00","250","0009","2434","203","86","117","8","211","593","0","35.58","14.50"
"65","000","00","250","0010","0000","162","80","82","1","163","394","0","41.37","20.30"
"65","000","00","250","0010","2435","162","80","82","1","163","394","0","41.37","20.30"
"65","000","00","250","0011","0000","109","35","74","0","109","351","0","31.05","9.97"
"65","000","00","250","0011","2436","109","35","74","0","109","351","0","31.05","9.97"
"65","000","00","250","0012","0000","331","162","169","5","336","1129","0","29.76","14.35"
"65","000","00","250","0012","2440","331","162","169","5","336","1129","0","29.76","14.35"
"65","000","00","260","0000","0000","4149","1323","2826","57","4206","10765","11658","39.07","12.29"
"65","000","00","260","0001","0000","317","139","178","3","320","823","0","38.88","16.89"
"65","000","00","260","0001","2441","317","139","178","3","320","823","0","38.88","16.89"
"65","000","00","260","0002","0000","158","55","103","4","162","462","0","35.06","11.90"
"65","000","00","260","0002","2443","158","55","103","4","162","462","0","35.06","11.90"
"65","000","00","260","0003","0000","240","82","158","6","246","631","0","38.99","13.00"
"65","000","00","260","0003","2444","117","37","80","5","122","341","0","35.78","10.85"
"65","000","00","260","0003","2445","123","45","78","1","124","290","0","42.76","15.52"
"65","000","00","260","0004","0000","146","52","94","2","148","398","0","37.19","13.07"
"65","000","00","260","0004","2442","146","52","94","2","148","398","0","37.19","13.07"
"65","000","00","260","0005","0000","280","72","208","4","284","630","0","45.08","11.43"
"65","000","00","260","0005","2450","280","72","208","4","284","630","0","45.08","11.43"
"65","000","00","260","0006","0000","590","240","350","5","595","1599","0","37.21","15.01"
"65","000","00","260","0006","2448","290","128","162","3","293","776","0","37.76","16.49"
"65","000","00","260","0006","2449","300","112","188","2","302","823","0","36.70","13.61"
"65","000","00","260","0007","0000","734","250","484","7","741","1652","0","44.85","15.13"
"65","000","00","260","0007","2453","318","110","208","3","321","725","0","44.28","15.17"
"65","000","00","260","0007","2454","416","140","276","4","420","927","0","45.31","15.10"
"65","000","00","260","0008","0000","736","157","579","13","749","1987","0","37.70","7.90"
"65","000","00","260","0008","2451","392","94","298","9","401","1072","0","37.41","8.77"
"65","000","00","260","0008","2452","344","63","281","4","348","915","0","38.03","6.89"
"65","000","00","260","0009","0000","319","92","227","2","321","886","0","36.23","10.38"
"65","000","00","260","0009","2446","169","56","113","2","171","495","0","34.55","11.31"
"65","000","00","260","0009","2447","150","36","114","0","150","391","0","38.36","9.21"
"65","000","00","260","0010","0000","291","94","197","8","299","716","0","41.76","13.13"
"65","000","00","260","0010","2455","172","47","125","4","176","391","0","45.01","12.02"
"65","000","00","260","0010","2456","119","47","72","4","123","325","0","37.85","14.46"
"65","000","00","260","0011","0000","338","90","248","3","341","981","0","34.76","9.17"
"65","000","00","260","0011","2457","180","51","129","1","181","490","0","36.94","10.41"
"65","000","00","260","0011","2458","158","39","119","2","160","491","0","32.59","7.94"
"65","000","00","270","0000","0000","6498","2877","3621","79","6577","18573","20926","35.41","15.49"
"65","000","00","270","0001","0000","190","99","91","1","191","456","0","41.89","21.71"
"65","000","00","270","0001","2459","190","99","91","1","191","456","0","41.89","21.71"
"65","000","00","270","0002","0000","243","124","119","3","246","712","0","34.55","17.42"
"65","000","00","270","0002","2460","243","124","119","3","246","712","0","34.55","17.42"
"65","000","00","270","0003","0000","195","85","110","0","195","502","0","38.84","16.93"
"65","000","00","270","0003","2461","195","85","110","0","195","502","0","38.84","16.93"
"65","000","00","270","0004","0000","626","210","416","4","630","1719","0","36.65","12.22"
"65","000","00","270","0004","2462","283","94","189","0","283","802","0","35.29","11.72"
"65","000","00","270","0004","2463","343","116","227","4","347","917","0","37.84","12.65"
"65","000","00","270","0005","0000","1306","619","687","14","1320","3777","0","34.95","16.39"
"65","000","00","270","0005","2470","455","182","273","6","461","1241","0","37.15","14.67"
"65","000","00","270","0005","2471","408","191","217","2","410","1229","0","33.36","15.54"
"65","000","00","270","0005","2472","443","246","197","6","449","1307","0","34.35","18.82"
"65","000","00","270","0006","0000","598","292","306","7","605","1641","0","36.87","17.79"
"65","000","00","270","0006","2468","318","160","158","3","321","783","0","41.00","20.43"
"65","000","00","270","0006","2469","280","132","148","4","284","858","0","33.10","15.38"
"65","000","00","270","0007","0000","400","155","245","6","406","1182","0","34.35","13.11"
"65","000","00","270","0007","2473","400","155","245","6","406","1182","0","34.35","13.11"
"65","000","00","270","0008","0000","121","55","66","2","123","377","0","32.63","14.59"
"65","000","00","270","0008","2474","121","55","66","2","123","377","0","32.63","14.59"
"65","000","00","270","0009","0000","237","87","150","7","244","643","0","37.95","13.53"
"65","000","00","270","0009","2475","237","87","150","7","244","643","0","37.95","13.53"
"65","000","00","270","0010","0000","232","89","143","5","237","619","0","38.29","14.38"
"65","000","00","270","0010","2476","232","89","143","5","237","619","0","38.29","14.38"
"65","000","00","270","0011","0000","250","110","140","4","254","801","0","31.71","13.73"
"65","000","00","270","0011","2478","250","110","140","4","254","801","0","31.71","13.73"
"65","000","00","270","0012","0000","162","54","108","4","166","443","0","37.47","12.19"
"65","000","00","270","0012","2477","162","54","108","4","166","443","0","37.47","12.19"
"65","000","00","270","0013","0000","72","34","38","1","73","177","0","41.24","19.21"
"65","000","00","270","0013","2479","72","34","38","1","73","177","0","41.24","19.21"
"65","000","00","270","0014","0000","178","71","107","4","182","570","0","31.93","12.46"
"65","000","00","270","0014","2480","178","71","107","4","182","570","0","31.93","12.46"
"65","000","00","270","0015","0000","1688","793","895","17","1705","4954","0","34.42","16.01"
"65","000","00","270","0015","2464","438","196","242","5","443","1183","0","37.45","16.57"
"65","000","00","270","0015","2465","502","244","258","5","507","1352","0","37.50","18.05"
"65","000","00","270","0015","2466","407","186","221","2","409","1269","0","32.23","14.66"
"65","000","00","270","0015","2467","341","167","174","5","346","1150","0","30.09","14.52"
"65","000","00","280","0000","0000","6335","3077","3258","68","6403","19074","21542","33.57","16.13"
"65","000","00","280","0001","0000","1469","736","733","16","1485","4232","0","35.09","17.39"
"65","000","00","280","0001","2481","351","194","157","2","353","1004","0","35.16","19.32"
"65","000","00","280","0001","2482","287","136","151","5","292","903","0","32.34","15.06"
"65","000","00","280","0001","2483","361","183","178","2","363","937","0","38.74","19.53"
"65","000","00","280","0001","2484","470","223","247","7","477","1388","0","34.37","16.07"
"65","000","00","280","0002","0000","766","383","383","3","769","2548","0","30.18","15.03"
"65","000","00","280","0002","2487","365","192","173","2","367","1229","0","29.86","15.62"
"65","000","00","280","0002","2488","401","191","210","1","402","1319","0","30.48","14.48"
"65","000","00","280","0003","0000","1023","485","538","9","1032","3153","0","32.73","15.38"
"65","000","00","280","0003","2489","279","127","152","3","282","838","0","33.65","15.16"
"65","000","00","280","0003","2490","248","114","134","1","249","799","0","31.16","14.27"
"65","000","00","280","0003","2491","496","244","252","5","501","1516","0","33.05","16.09"
"65","000","00","280","0004","0000","943","449","494","16","959","2681","0","35.77","16.75"
"65","000","00","280","0004","2492","326","141","185","6","332","951","0","34.91","14.83"
"65","000","00","280","0004","2493","345","151","194","9","354","893","0","39.64","16.91"
"65","000","00","280","0004","2494","272","157","115","1","273","837","0","32.62","18.76"
"65","000","00","280","0005","0000","183","93","90","2","185","574","0","32.23","16.20"
"65","000","00","280","0005","2495","183","93","90","2","185","574","0","32.23","16.20"
"65","000","00","280","0006","0000","325","136","189","5","330","966","0","34.16","14.08"
"65","000","00","280","0006","2496","325","136","189","5","330","966","0","34.16","14.08"
"65","000","00","280","0007","0000","201","71","130","3","204","659","0","30.96","10.77"
"65","000","00","280","0007","2497","201","71","130","3","204","659","0","30.96","10.77"
"65","000","00","280","0008","0000","148","50","98","0","148","403","0","36.72","12.41"
"65","000","00","280","0008","2498","148","50","98","0","148","403","0","36.72","12.41"
"65","000","00","280","0009","0000","353","173","180","6","359","1107","0","32.43","15.63"
"65","000","00","280","0009","2499","353","173","180","6","359","1107","0","32.43","15.63"
"65","000","00","280","0010","0000","924","501","423","8","932","2751","0","33.88","18.21"
"65","000","00","280","0010","2485","473","270","203","5","478","1411","0","33.88","19.14"
"65","000","00","280","0010","2486","451","231","220","3","454","1340","0","33.88","17.24"
"65","000","00","290","0000","0000","1683","998","685","24","1707","5261","6343","32.45","18.97"
"65","000","00","290","0001","0000","774","447","327","12","786","2348","0","33.48","19.04"
"65","000","00","290","0001","2362","442","233","209","7","449","1186","0","37.86","19.65"
"65","000","00","290","0001","2363","332","214","118","5","337","1162","0","29.00","18.42"
"65","000","00","290","0002","0000","534","326","208","4","538","1572","0","34.22","20.74"
"65","000","00","290","0002","2360","350","182","168","3","353","938","0","37.63","19.40"
"65","000","00","290","0002","2361","184","144","40","1","185","634","0","29.18","22.71"
"65","000","00","290","0003","0000","152","122","30","6","158","606","0","26.07","20.13"
"65","000","00","290","0003","2366","152","122","30","6","158","606","0","26.07","20.13"
"65","000","00","290","0004","0000","156","77","79","1","157","504","0","31.15","15.28"
"65","000","00","290","0004","2365","156","77","79","1","157","504","0","31.15","15.28"
"65","000","00","290","0005","0000","67","26","41","1","68","231","0","29.44","11.26"
"65","000","00","290","0005","2364","67","26","41","1","68","231","0","29.44","11.26"
"68","000","00","000","0000","0000","741385","393423","347962","6793","748178","1869908","2272459","40.01","21.04"
"68","000","00","010","0000","0000","153969","79029","74940","1300","155269","375012","458824","41.40","21.07"
"68","000","00","010","0001","0000","485","239","246","2","487","1024","0","47.56","23.34"
"68","000","00","010","0001","0036","485","239","246","2","487","1024","0","47.56","23.34"
"68","000","00","010","0002","0000","691","342","349","4","695","1396","0","49.79","24.50"
"68","000","00","010","0002","0038","691","342","349","4","695","1396","0","49.79","24.50"
"68","000","00","010","0003","0000","621","297","324","6","627","1628","0","38.51","18.24"
"68","000","00","010","0003","0047","621","297","324","6","627","1628","0","38.51","18.24"
"68","000","00","010","0004","0000","2539","1215","1324","21","2560","6940","0","36.89","17.51"
"68","000","00","010","0004","0001","551","262","289","7","558","1515","0","36.83","17.29"
"68","000","00","010","0004","0002","388","201","187","0","388","1110","0","34.95","18.11"
"68","000","00","010","0004","0003","468","230","238","8","476","1357","0","35.08","16.95"
"68","000","00","010","0004","0004","602","266","336","2","604","1422","0","42.48","18.71"
"68","000","00","010","0004","0005","530","256","274","4","534","1536","0","34.77","16.67"
"68","000","00","010","0005","0000","1361","761","600","16","1377","3581","0","38.45","21.25"
"68","000","00","010","0005","0219","692","415","277","9","701","1850","0","37.89","22.43"
"68","000","00","010","0005","0220","669","346","323","7","676","1731","0","39.05","19.99"
"68","000","00","010","0006","0000","3773","2174","1599","23","3796","9791","0","38.77","22.20"
"68","000","00","010","0006","0233","616","333","283","2","618","1612","0","38.34","20.66"
"68","000","00","010","0006","0234","584","335","249","4","588","1483","0","39.65","22.59"
"68","000","00","010","0006","0235","607","346","261","3","610","1694","0","36.01","20.43"
"68","000","00","010","0006","0236","675","385","290","3","678","1728","0","39.24","22.28"
"68","000","00","010","0006","0237","687","412","275","7","694","1709","0","40.61","24.11"
"68","000","00","010","0006","0238","604","363","241","4","608","1565","0","38.85","23.19"
"68","000","00","010","0007","0000","466","161","305","5","471","1005","0","46.87","16.02"
"68","000","00","010","0007","0048","466","161","305","5","471","1005","0","46.87","16.02"
"68","000","00","010","0008","0000","680","329","351","6","686","1649","0","41.60","19.95"
"68","000","00","010","0008","0040","680","329","351","6","686","1649","0","41.60","19.95"
"68","000","00","010","0009","0000","748","306","442","4","752","1820","0","41.32","16.81"
"68","000","00","010","0009","0041","748","306","442","4","752","1820","0","41.32","16.81"
"68","000","00","010","0010","0000","2588","1140","1448","27","2615","6542","0","39.97","17.43"
"68","000","00","010","0010","0215","844","376","468","10","854","2211","0","38.63","17.01"
"68","000","00","010","0010","0216","613","276","337","7","620","1496","0","41.44","18.45"
"68","000","00","010","0010","0217","571","289","282","6","577","1496","0","38.57","19.32"
"68","000","00","010","0010","0218","560","199","361","4","564","1339","0","42.12","14.86"
"68","000","00","010","0011","0000","2060","893","1167","26","2086","4520","0","46.15","19.76"
"68","000","00","010","0011","0131","630","305","325","9","639","1382","0","46.24","22.07"
"68","000","00","010","0011","0132","673","302","371","10","683","1577","0","43.31","19.15"
"68","000","00","010","0011","0133","757","286","471","7","764","1561","0","48.94","18.32"
"68","000","00","010","0012","0000","1877","827","1050","17","1894","4602","0","41.16","17.97"
"68","000","00","010","0012","0152","634","263","371","3","637","1668","0","38.19","15.77"
"68","000","00","010","0012","0153","628","289","339","6","634","1533","0","41.36","18.85"
"68","000","00","010","0012","0154","615","275","340","8","623","1401","0","44.47","19.63"
"68","000","00","010","0013","0000","1360","684","676","8","1368","3019","0","45.31","22.66"
"68","000","00","010","0013","0222","651","332","319","3","654","1512","0","43.25","21.96"
"68","000","00","010","0013","0223","709","352","357","5","714","1507","0","47.38","23.36"
"68","000","00","010","0014","0000","807","373","434","10","817","1896","0","43.09","19.67"
"68","000","00","010","0014","0221","807","373","434","10","817","1896","0","43.09","19.67"
"68","000","00","010","0015","0000","392","159","233","2","394","924","0","42.64","17.21"
"68","000","00","010","0015","0239","392","159","233","2","394","924","0","42.64","17.21"
"68","000","00","010","0016","0000","1481","656","825","11","1492","3527","0","42.30","18.60"
"68","000","00","010","0016","0155","694","275","419","4","698","1701","0","41.03","16.17"
"68","000","00","010","0016","0156","787","381","406","7","794","1826","0","43.48","20.87"
"68","000","00","010","0017","0000","978","374","604","8","986","2382","0","41.39","15.70"
"68","000","00","010","0017","0122","543","240","303","6","549","1327","0","41.37","18.09"
"68","000","00","010","0017","0123","435","134","301","2","437","1055","0","41.42","12.70"
"68","000","00","010","0018","0000","1328","517","811","17","1345","3082","0","43.64","16.77"
"68","000","00","010","0018","0148","815","311","504","11","826","2001","0","41.28","15.54"
"68","000","00","010","0018","0149","513","206","307","6","519","1081","0","48.01","19.06"
"68","000","00","010","0019","0000","640","310","330","4","644","1626","0","39.61","19.07"
"68","000","00","010","0019","0045","640","310","330","4","644","1626","0","39.61","19.07"
"68","000","00","010","0020","0000","617","260","357","5","622","1307","0","47.59","19.89"
"68","000","00","010","0020","0031","617","260","357","5","622","1307","0","47.59","19.89"
"68","000","00","010","0021","0000","380","140","240","4","384","778","0","49.36","17.99"
"68","000","00","010","0021","0037","380","140","240","4","384","778","0","49.36","17.99"
"68","000","00","010","0022","0000","4194","2337","1857","40","4234","9814","0","43.14","23.81"
"68","000","00","010","0022","0177","665","356","309","5","670","1694","0","39.55","21.02"
"68","000","00","010","0022","0178","755","421","334","2","757","1619","0","46.76","26.00"
"68","000","00","010","0022","0179","749","418","331","11","760","1575","0","48.25","26.54"
"68","000","00","010","0022","0180","719","391","328","8","727","1803","0","40.32","21.69"
"68","000","00","010","0022","0181","625","360","265","5","630","1462","0","43.09","24.62"
"68","000","00","010","0022","0182","681","391","290","9","690","1661","0","41.54","23.54"
"68","000","00","010","0023","0000","2881","1525","1356","16","2897","6789","0","42.67","22.46"
"68","000","00","010","0023","0054","687","360","327","4","691","1687","0","40.96","21.34"
"68","000","00","010","0023","0055","774","412","362","6","780","1721","0","45.32","23.94"
"68","000","00","010","0023","0056","647","326","321","2","649","1644","0","39.48","19.83"
"68","000","00","010","0023","0057","773","427","346","4","777","1737","0","44.73","24.58"
"68","000","00","010","0024","0000","2445","1212","1233","20","2465","6329","0","38.95","19.15"
"68","000","00","010","0024","0173","614","289","325","3","617","1665","0","37.06","17.36"
"68","000","00","010","0024","0174","592","345","247","6","598","1549","0","38.61","22.27"
"68","000","00","010","0024","0175","607","252","355","7","614","1518","0","40.45","16.60"
"68","000","00","010","0024","0176","632","326","306","4","636","1597","0","39.82","20.41"
"68","000","00","010","0025","0000","633","317","316","5","638","1430","0","44.62","22.17"
"68","000","00","010","0025","0046","633","317","316","5","638","1430","0","44.62","22.17"
"68","000","00","010","0026","0000","2466","1221","1245","33","2499","5908","0","42.30","20.67"
"68","000","00","010","0026","0049","862","415","447","10","872","2055","0","42.43","20.19"
"68","000","00","010","0026","0050","419","223","196","7","426","996","0","42.77","22.39"
"68","000","00","010","0026","0051","456","208","248","11","467","1063","0","43.93","19.57"
"68","000","00","010","0026","0052","729","375","354","5","734","1794","0","40.91","20.90"
"68","000","00","010","0027","0000","604","241","363","11","615","1365","0","45.05","17.66"
"68","000","00","010","0027","0053","604","241","363","11","615","1365","0","45.05","17.66"
"68","000","00","010","0028","0000","2061","956","1105","19","2080","4880","0","42.62","19.59"
"68","000","00","010","0028","0092","643","273","370","8","651","1424","0","45.72","19.17"
"68","000","00","010","0028","0093","457","209","248","4","461","1203","0","38.32","17.37"
"68","000","00","010","0028","0094","516","262","254","6","522","1137","0","45.91","23.04"
"68","000","00","010","0028","0095","445","212","233","1","446","1116","0","39.96","19.00"
"68","000","00","010","0029","0000","2265","1066","1199","12","2277","5722","0","39.79","18.63"
"68","000","00","010","0029","0065","549","204","345","2","551","1135","0","48.55","17.97"
"68","000","00","010","0029","0066","436","203","233","5","441","1231","0","35.82","16.49"
"68","000","00","010","0029","0067","813","366","447","3","816","1962","0","41.59","18.65"
"68","000","00","010","0029","0068","467","293","174","2","469","1394","0","33.64","21.02"
"68","000","00","010","0030","0000","2880","1565","1315","11","2891","6550","0","44.14","23.89"
"68","000","00","010","0030","0061","761","433","328","5","766","1565","0","48.95","27.67"
"68","000","00","010","0030","0062","670","341","329","1","671","1569","0","42.77","21.73"
"68","000","00","010","0030","0063","807","428","379","3","810","1914","0","42.32","22.36"
"68","000","00","010","0030","0064","642","363","279","2","644","1502","0","42.88","24.17"
"68","000","00","010","0031","0000","730","312","418","3","733","1710","0","42.87","18.25"
"68","000","00","010","0031","0039","730","312","418","3","733","1710","0","42.87","18.25"
"68","000","00","010","0032","0000","2627","1339","1288","23","2650","6053","0","43.78","22.12"
"68","000","00","010","0032","0016","659","284","375","6","665","1416","0","46.96","20.06"
"68","000","00","010","0032","0017","597","297","300","8","605","1425","0","42.46","20.84"
"68","000","00","010","0032","0018","638","319","319","6","644","1556","0","41.39","20.50"
"68","000","00","010","0032","0019","733","439","294","3","736","1656","0","44.44","26.51"
"68","000","00","010","0033","0000","2636","1342","1294","34","2670","5943","0","44.93","22.58"
"68","000","00","010","0033","0023","661","334","327","9","670","1409","0","47.55","23.70"
"68","000","00","010","0033","0024","749","370","379","7","756","1576","0","47.97","23.48"
"68","000","00","010","0033","0025","659","343","316","8","667","1515","0","44.03","22.64"
"68","000","00","010","0033","0026","567","295","272","10","577","1443","0","39.99","20.44"
"68","000","00","010","0034","0000","2135","954","1181","15","2150","4548","0","47.27","20.98"
"68","000","00","010","0034","0042","652","287","365","5","657","1579","0","41.61","18.18"
"68","000","00","010","0034","0043","725","328","397","6","731","1467","0","49.83","22.36"
"68","000","00","010","0034","0044","758","339","419","4","762","1502","0","50.73","22.57"
"68","000","00","010","0035","0000","1291","689","602","13","1304","3479","0","37.48","19.80"
"68","000","00","010","0035","0099","416","202","214","4","420","1135","0","37.00","17.80"
"68","000","00","010","0035","0100","450","264","186","3","453","1170","0","38.72","22.56"
"68","000","00","010","0035","0101","425","223","202","6","431","1174","0","36.71","18.99"
"68","000","00","010","0036","0000","2320","1322","998","26","2346","5803","0","40.43","22.78"
"68","000","00","010","0036","0106","592","321","271","4","596","1414","0","42.15","22.70"
"68","000","00","010","0036","0107","580","317","263","8","588","1557","0","37.76","20.36"
"68","000","00","010","0036","0108","608","366","242","10","618","1519","0","40.68","24.09"
"68","000","00","010","0036","0109","540","318","222","4","544","1313","0","41.43","24.22"
"68","000","00","010","0037","0000","1806","963","843","15","1821","3846","0","47.35","25.04"
"68","000","00","010","0037","0212","529","286","243","3","532","1124","0","47.33","25.44"
"68","000","00","010","0037","0213","602","313","289","6","608","1346","0","45.17","23.25"
"68","000","00","010","0037","0214","675","364","311","6","681","1376","0","49.49","26.45"
"68","000","00","010","0038","0000","1827","773","1054","20","1847","4213","0","43.84","18.35"
"68","000","00","010","0038","0224","546","224","322","4","550","1272","0","43.24","17.61"
"68","000","00","010","0038","0225","637","250","387","11","648","1458","0","44.44","17.15"
"68","000","00","010","0038","0226","644","299","345","5","649","1483","0","43.76","20.16"
"68","000","00","010","0039","0000","891","411","480","13","904","1970","0","45.89","20.86"
"68","000","00","010","0039","0231","492","225","267","7","499","1010","0","49.41","22.28"
"68","000","00","010","0039","0232","399","186","213","6","405","960","0","42.19","19.38"
"68","000","00","010","0040","0000","2461","1151","1310","15","2476","5681","0","43.58","20.26"
"68","000","00","010","0040","0032","582","261","321","5","587","1321","0","44.44","19.76"
"68","000","00","010","0040","0033","612","269","343","3","615","1458","0","42.18","18.45"
"68","000","00","010","0040","0034","704","310","394","6","710","1543","0","46.01","20.09"
"68","000","00","010","0040","0035","563","311","252","1","564","1359","0","41.50","22.88"
"68","000","00","010","0041","0000","2836","1422","1414","19","2855","6243","0","45.73","22.78"
"68","000","00","010","0041","0027","730","393","337","5","735","1654","0","44.44","23.76"
"68","000","00","010","0041","0028","708","343","365","6","714","1620","0","44.07","21.17"
"68","000","00","010","0041","0029","655","331","324","5","660","1478","0","44.65","22.40"
"68","000","00","010","0041","0030","743","355","388","3","746","1491","0","50.03","23.81"
"68","000","00","010","0042","0000","2214","1128","1086","31","2245","5129","0","43.77","21.99"
"68","000","00","010","0042","0012","556","283","273","12","568","1282","0","44.31","22.07"
"68","000","00","010","0042","0013","603","285","318","5","608","1393","0","43.65","20.46"
"68","000","00","010","0042","0014","511","290","221","7","518","1225","0","42.29","23.67"
"68","000","00","010","0042","0015","544","270","274","7","551","1229","0","44.83","21.97"
"68","000","00","010","0043","0000","2044","990","1054","13","2057","4911","0","41.89","20.16"
"68","000","00","010","0043","0009","726","370","356","3","729","1811","0","40.25","20.43"
"68","000","00","010","0043","0010","651","311","340","7","658","1554","0","42.34","20.01"
"68","000","00","010","0043","0011","667","309","358","3","670","1546","0","43.34","19.99"
"68","000","00","010","0044","0000","1753","887","866","13","1766","4122","0","42.84","21.52"
"68","000","00","010","0044","0020","542","302","240","2","544","1284","0","42.37","23.52"
"68","000","00","010","0044","0021","522","257","265","5","527","1373","0","38.38","18.72"
"68","000","00","010","0044","0022","689","328","361","6","695","1465","0","47.44","22.39"
"68","000","00","010","0045","0000","1964","1138","826","16","1980","4162","0","47.57","27.34"
"68","000","00","010","0045","0199","645","381","264","4","649","1412","0","45.96","26.98"
"68","000","00","010","0045","0200","707","412","295","7","714","1371","0","52.08","30.05"
"68","000","00","010","0045","0201","612","345","267","5","617","1379","0","44.74","25.02"
"68","000","00","010","0046","0000","1982","926","1056","20","2002","5398","0","37.09","17.15"
"68","000","00","010","0046","0209","607","278","329","7","614","1776","0","34.57","15.65"
"68","000","00","010","0046","0210","683","310","373","6","689","1801","0","38.26","17.21"
"68","000","00","010","0046","0211","692","338","354","7","699","1821","0","38.39","18.56"
"68","000","00","010","0047","0000","2238","1094","1144","27","2265","6093","0","37.17","17.96"
"68","000","00","010","0047","0227","592","278","314","4","596","1510","0","39.47","18.41"
"68","000","00","010","0047","0228","561","264","297","8","569","1429","0","39.82","18.47"
"68","000","00","010","0047","0229","574","275","299","7","581","1537","0","37.80","17.89"
"68","000","00","010","0047","0230","511","277","234","8","519","1617","0","32.10","17.13"
"68","000","00","010","0048","0000","2770","1322","1448","27","2797","6914","0","40.45","19.12"
"68","000","00","010","0048","0160","537","205","332","3","540","1304","0","41.41","15.72"
"68","000","00","010","0048","0161","469","230","239","4","473","1299","0","36.41","17.71"
"68","000","00","010","0048","0162","568","271","297","6","574","1385","0","41.44","19.57"
"68","000","00","010","0048","0163","603","293","310","7","610","1554","0","39.25","18.85"
"68","000","00","010","0048","0164","593","323","270","7","600","1372","0","43.73","23.54"
"68","000","00","010","0049","0000","2415","1335","1080","11","2426","6089","0","39.84","21.92"
"68","000","00","010","0049","0124","609","299","310","5","614","1473","0","41.68","20.30"
"68","000","00","010","0049","0125","624","335","289","3","627","1457","0","43.03","22.99"
"68","000","00","010","0049","0126","563","348","215","1","564","1674","0","33.69","20.79"
"68","000","00","010","0049","0127","619","353","266","2","621","1485","0","41.82","23.77"
"68","000","00","010","0050","0000","3886","1953","1933","24","3910","9540","0","40.99","20.47"
"68","000","00","010","0050","0134","784","416","368","4","788","1817","0","43.37","22.89"
"68","000","00","010","0050","0135","719","340","379","3","722","1956","0","36.91","17.38"
"68","000","00","010","0050","0136","812","413","399","4","816","1892","0","43.13","21.83"
"68","000","00","010","0050","0137","896","449","447","9","905","2195","0","41.23","20.46"
"68","000","00","010","0050","0138","675","335","340","4","679","1680","0","40.42","19.94"
"68","000","00","010","0051","0000","3698","2114","1584","30","3728","8779","0","42.46","24.08"
"68","000","00","010","0051","0168","709","403","306","9","718","1689","0","42.51","23.86"
"68","000","00","010","0051","0169","792","420","372","5","797","1772","0","44.98","23.70"
"68","000","00","010","0051","0170","683","373","310","1","684","1766","0","38.73","21.12"
"68","000","00","010","0051","0171","773","449","324","9","782","1837","0","42.57","24.44"
"68","000","00","010","0051","0172","741","469","272","6","747","1715","0","43.56","27.35"
"68","000","00","010","0052","0000","1763","923","840","14","1777","3991","0","44.53","23.13"
"68","000","00","010","0052","0090","815","401","414","5","820","1990","0","41.21","20.15"
"68","000","00","010","0052","0091","948","522","426","9","957","2001","0","47.83","26.09"
"68","000","00","010","0053","0000","1634","854","780","18","1652","3653","0","45.22","23.38"
"68","000","00","010","0053","0096","539","307","232","5","544","1225","0","44.41","25.06"
"68","000","00","010","0053","0097","597","290","307","6","603","1294","0","46.60","22.41"
"68","000","00","010","0053","0098","498","257","241","7","505","1134","0","44.53","22.66"
"68","000","00","010","0054","0000","1603","833","770","17","1620","3883","0","41.72","21.45"
"68","000","00","010","0054","0083","575","298","277","8","583","1263","0","46.16","23.59"
"68","000","00","010","0054","0084","481","241","240","3","484","1258","0","38.47","19.16"
"68","000","00","010","0054","0085","547","294","253","6","553","1362","0","40.60","21.59"
"68","000","00","010","0055","0000","2670","1365","1305","27","2697","6452","0","41.80","21.16"
"68","000","00","010","0055","0086","661","363","298","7","668","1637","0","40.81","22.17"
"68","000","00","010","0055","0087","596","315","281","5","601","1439","0","41.77","21.89"
"68","000","00","010","0055","0088","745","289","456","11","756","1571","0","48.12","18.40"
"68","000","00","010","0055","0089","668","398","270","4","672","1805","0","37.23","22.05"
"68","000","00","010","0056","0000","1821","1080","741","16","1837","4939","0","37.19","21.87"
"68","000","00","010","0056","0110","600","367","233","4","604","1619","0","37.31","22.67"
"68","000","00","010","0056","0111","578","333","245","5","583","1625","0","35.88","20.49"
"68","000","00","010","0056","0112","643","380","263","7","650","1695","0","38.35","22.42"
"68","000","00","010","0057","0000","2396","1357","1039","18","2414","6433","0","37.53","21.09"
"68","000","00","010","0057","0202","575","317","258","5","580","1570","0","36.94","20.19"
"68","000","00","010","0057","0203","565","323","242","8","573","1596","0","35.90","20.24"
"68","000","00","010","0057","0204","636","380","256","4","640","1631","0","39.24","23.30"
"68","000","00","010","0057","0205","620","337","283","1","621","1636","0","37.96","20.60"
"68","000","00","010","0058","0000","3155","1704","1451","24","3179","8491","0","37.44","20.07"
"68","000","00","010","0058","0243","587","318","269","4","591","1547","0","38.20","20.56"
"68","000","00","010","0058","0244","525","270","255","3","528","1359","0","38.85","19.87"
"68","000","00","010","0058","0245","502","263","239","3","505","1427","0","35.39","18.43"
"68","000","00","010","0058","0246","546","304","242","5","551","1709","0","32.24","17.79"
"68","000","00","010","0058","0247","559","311","248","9","568","1318","0","43.10","23.60"
"68","000","00","010","0058","0248","436","238","198","0","436","1131","0","38.55","21.04"
"68","000","00","010","0059","0000","2978","1588","1390","22","3000","9776","0","30.69","16.24"
"68","000","00","010","0059","0117","648","356","292","1","649","1561","0","41.58","22.81"
"68","000","00","010","0059","0118","482","255","227","4","486","3546","0","13.71","7.19"
"68","000","00","010","0059","0119","640","362","278","2","642","1647","0","38.98","21.98"
"68","000","00","010","0059","0120","565","259","306","7","572","1477","0","38.73","17.54"
"68","000","00","010","0059","0121","643","356","287","8","651","1545","0","42.14","23.04"
"68","000","00","010","0060","0000","2101","1136","965","16","2117","5408","0","39.15","21.01"
"68","000","00","010","0060","0102","542","261","281","6","548","1283","0","42.71","20.34"
"68","000","00","010","0060","0103","579","286","293","3","582","1448","0","40.19","19.75"
"68","000","00","010","0060","0104","512","298","214","4","516","1323","0","39.00","22.52"
"68","000","00","010","0060","0105","468","291","177","3","471","1354","0","34.79","21.49"
"68","000","00","010","0061","0000","3229","1732","1497","26","3255","7355","0","44.26","23.55"
"68","000","00","010","0061","0143","761","401","360","5","766","1721","0","44.51","23.30"
"68","000","00","010","0061","0144","592","306","286","5","597","1489","0","40.09","20.55"
"68","000","00","010","0061","0145","598","303","295","8","606","1401","0","43.25","21.63"
"68","000","00","010","0061","0146","598","335","263","7","605","1288","0","46.97","26.01"
"68","000","00","010","0061","0147","680","387","293","1","681","1456","0","46.77","26.58"
"68","000","00","010","0062","0000","2210","1161","1049","16","2226","5612","0","39.67","20.69"
"68","000","00","010","0062","0069","599","305","294","4","603","1319","0","45.72","23.12"
"68","000","00","010","0062","0070","566","290","276","5","571","1436","0","39.76","20.19"
"68","000","00","010","0062","0071","548","277","271","4","552","1426","0","38.71","19.42"
"68","000","00","010","0062","0072","497","289","208","3","500","1431","0","34.94","20.20"
"68","000","00","010","0063","0000","2200","1044","1156","11","2211","4931","0","44.84","21.17"
"68","000","00","010","0063","0157","775","364","411","4","779","1686","0","46.20","21.59"
"68","000","00","010","0063","0158","591","266","325","5","596","1351","0","44.12","19.69"
"68","000","00","010","0063","0159","834","414","420","2","836","1894","0","44.14","21.86"
"68","000","00","010","0064","0000","1958","1077","881","14","1972","4612","0","42.76","23.35"
"68","000","00","010","0064","0058","688","405","283","7","695","1749","0","39.74","23.16"
"68","000","00","010","0064","0059","706","378","328","4","710","1615","0","43.96","23.41"
"68","000","00","010","0064","0060","564","294","270","3","567","1248","0","45.43","23.56"
"68","000","00","010","0065","0000","2018","1135","883","15","2033","4570","0","44.49","24.84"
"68","000","00","010","0065","0073","672","377","295","6","678","1613","0","42.03","23.37"
"68","000","00","010","0065","0074","742","427","315","4","746","1562","0","47.76","27.34"
"68","000","00","010","0065","0075","604","331","273","5","609","1395","0","43.66","23.73"
"68","000","00","010","0066","0000","1828","1054","774","14","1842","4145","0","44.44","25.43"
"68","000","00","010","0066","0076","656","379","277","6","662","1502","0","44.07","25.23"
"68","000","00","010","0066","0077","536","307","229","3","539","1338","0","40.28","22.94"
"68","000","00","010","0066","0078","636","368","268","5","641","1305","0","49.12","28.20"
"68","000","00","010","0067","0000","2100","1047","1053","18","2118","4872","0","43.47","21.49"
"68","000","00","010","0067","0165","714","335","379","8","722","1649","0","43.78","20.32"
"68","000","00","010","0067","0166","712","352","360","8","720","1602","0","44.94","21.97"
"68","000","00","010","0067","0167","674","360","314","2","676","1621","0","41.70","22.21"
"68","000","00","010","0068","0000","2560","1386","1174","24","2584","6169","0","41.89","22.47"
"68","000","00","010","0068","0192","657","348","309","4","661","1510","0","43.77","23.05"
"68","000","00","010","0068","0193","720","401","319","6","726","1652","0","43.95","24.27"
"68","000","00","010","0068","0194","646","360","286","8","654","1639","0","39.90","21.96"
"68","000","00","010","0068","0195","537","277","260","6","543","1368","0","39.69","20.25"
"68","000","00","010","0069","0000","1911","1046","865","18","1929","4734","0","40.75","22.10"
"68","000","00","010","0069","0128","622","307","315","6","628","1573","0","39.92","19.52"
"68","000","00","010","0069","0129","654","395","259","7","661","1571","0","42.08","25.14"
"68","000","00","010","0069","0130","635","344","291","5","640","1590","0","40.25","21.64"
"68","000","00","010","0070","0000","2308","1373","935","23","2331","5481","0","42.53","25.05"
"68","000","00","010","0070","0079","501","314","187","7","508","1388","0","36.60","22.62"
"68","000","00","010","0070","0080","539","309","230","4","543","1281","0","42.39","24.12"
"68","000","00","010","0070","0081","586","328","258","9","595","1429","0","41.64","22.95"
"68","000","00","010","0070","0082","682","422","260","3","685","1383","0","49.53","30.51"
"68","000","00","010","0071","0000","2462","1252","1210","27","2489","6540","0","38.06","19.14"
"68","000","00","010","0071","0113","660","348","312","3","663","1601","0","41.41","21.74"
"68","000","00","010","0071","0114","619","294","325","4","623","1641","0","37.96","17.92"
"68","000","00","010","0071","0115","584","280","304","8","592","1685","0","35.13","16.62"
"68","000","00","010","0071","0116","599","330","269","12","611","1613","0","37.88","20.46"
"68","000","00","010","0072","0000","2587","1468","1119","17","2604","6061","0","42.96","24.22"
"68","000","00","010","0072","0139","648","376","272","3","651","1564","0","41.62","24.04"
"68","000","00","010","0072","0140","672","381","291","8","680","1538","0","44.21","24.77"
"68","000","00","010","0072","0141","626","354","272","4","630","1490","0","42.28","23.76"
"68","000","00","010","0072","0142","641","357","284","2","643","1469","0","43.77","24.30"
"68","000","00","010","0073","0000","1448","767","681","10","1458","3179","0","45.86","24.13"
"68","000","00","010","0073","0150","603","322","281","7","610","1412","0","43.20","22.80"
"68","000","00","010","0073","0151","845","445","400","3","848","1767","0","47.99","25.18"
"68","000","00","010","0074","0000","3097","1688","1409","22","3119","8113","0","38.44","20.81"
"68","000","00","010","0074","0187","611","333","278","6","617","1563","0","39.48","21.31"
"68","000","00","010","0074","0188","545","284","261","7","552","1624","0","33.99","17.49"
"68","000","00","010","0074","0189","622","337","285","2","624","1546","0","40.36","21.80"
"68","000","00","010","0074","0190","658","358","300","5","663","1637","0","40.50","21.87"
"68","000","00","010","0074","0191","661","376","285","2","663","1743","0","38.04","21.57"
"68","000","00","010","0075","0000","2258","1202","1056","19","2277","5936","0","38.36","20.25"
"68","000","00","010","0075","0183","516","258","258","7","523","1567","0","33.38","16.46"
"68","000","00","010","0075","0184","629","347","282","5","634","1483","0","42.75","23.40"
"68","000","00","010","0075","0185","591","322","269","4","595","1486","0","40.04","21.67"
"68","000","00","010","0075","0186","522","275","247","3","525","1400","0","37.50","19.64"
"68","000","00","010","0076","0000","1529","801","728","14","1543","3791","0","40.70","21.13"
"68","000","00","010","0076","0196","561","267","294","4","565","1360","0","41.54","19.63"
"68","000","00","010","0076","0197","436","232","204","5","441","1109","0","39.77","20.92"
"68","000","00","010","0076","0198","532","302","230","5","537","1322","0","40.62","22.84"
"68","000","00","010","0077","0000","1494","732","762","9","1503","3881","0","38.73","18.86"
"68","000","00","010","0077","0006","540","256","284","3","543","1445","0","37.58","17.72"
"68","000","00","010","0077","0007","487","231","256","2","489","1245","0","39.28","18.55"
"68","000","00","010","0077","0008","467","245","222","4","471","1191","0","39.55","20.57"
"68","000","00","010","0078","0000","1999","1057","942","18","2017","5006","0","40.29","21.11"
"68","000","00","010","0078","0206","744","369","375","9","753","1727","0","43.60","21.37"
"68","000","00","010","0078","0207","649","355","294","2","651","1658","0","39.26","21.41"
"68","000","00","010","0078","0208","606","333","273","7","613","1621","0","37.82","20.54"
"68","000","00","010","0079","0000","1827","1005","822","12","1839","4546","0","40.45","22.11"
"68","000","00","010","0079","0240","582","325","257","6","588","1367","0","43.01","23.77"
"68","000","00","010","0079","0241","715","383","332","5","720","1804","0","39.91","21.23"
"68","000","00","010","0079","0242","530","297","233","1","531","1375","0","38.62","21.60"
"68","000","00","020","0000","0000","143054","82125","60929","1200","144254","347023","422582","41.57","23.67"
"68","000","00","020","0001","0000","1286","992","294","15","1301","2898","0","44.89","34.23"
"68","000","00","020","0001","0712","656","524","132","9","665","1343","0","49.52","39.02"
"68","000","00","020","0001","0713","630","468","162","6","636","1555","0","40.90","30.10"
"68","000","00","020","0002","0000","2243","1433","810","15","2258","5428","0","41.60","26.40"
"68","000","00","020","0002","0708","682","440","242","5","687","1406","0","48.86","31.29"
"68","000","00","020","0002","0709","479","309","170","1","480","1263","0","38.00","24.47"
"68","000","00","020","0002","0710","559","367","192","5","564","1382","0","40.81","26.56"
"68","000","00","020","0002","0711","523","317","206","4","527","1377","0","38.27","23.02"
"68","000","00","020","0003","0000","1275","811","464","18","1293","3064","0","42.20","26.47"
"68","000","00","020","0003","0755","648","388","260","12","660","1595","0","41.38","24.33"
"68","000","00","020","0003","0756","627","423","204","6","633","1469","0","43.09","28.80"
"68","000","00","020","0004","0000","392","196","196","4","396","914","0","43.33","21.44"
"68","000","00","020","0004","0881","392","196","196","4","396","914","0","43.33","21.44"
"68","000","00","020","0005","0000","912","572","340","13","925","2196","0","42.12","26.05"
"68","000","00","020","0005","0793","449","265","184","6","455","1093","0","41.63","24.25"
"68","000","00","020","0005","0794","463","307","156","7","470","1103","0","42.61","27.83"
"68","000","00","020","0006","0000","1744","1023","721","16","1760","4380","0","40.18","23.36"
"68","000","00","020","0006","0795","638","359","279","8","646","1563","0","41.33","22.97"
"68","000","00","020","0006","0796","525","303","222","4","529","1513","0","34.96","20.03"
"68","000","00","020","0006","0797","581","361","220","4","585","1304","0","44.86","27.68"
"68","000","00","020","0007","0000","2385","1367","1018","21","2406","5320","0","45.23","25.70"
"68","000","00","020","0007","0889","642","377","265","6","648","1498","0","43.26","25.17"
"68","000","00","020","0007","0890","461","244","217","4","465","1022","0","45.50","23.87"
"68","000","00","020","0007","0891","631","360","271","5","636","1398","0","45.49","25.75"
"68","000","00","020","0007","0892","651","386","265","6","657","1402","0","46.86","27.53"
"68","000","00","020","0008","0000","2329","1921","408","29","2358","5087","0","46.35","37.76"
"68","000","00","020","0008","0781","586","499","87","6","592","1239","0","47.78","40.27"
"68","000","00","020","0008","0782","588","500","88","9","597","1242","0","48.07","40.26"
"68","000","00","020","0008","0783","633","522","111","7","640","1313","0","48.74","39.76"
"68","000","00","020","0008","0784","522","400","122","7","529","1293","0","40.91","30.94"
"68","000","00","020","0009","0000","1529","1036","493","11","1540","3497","0","44.04","29.63"
"68","000","00","020","0009","0777","739","478","261","7","746","1642","0","45.43","29.11"
"68","000","00","020","0009","0778","790","558","232","4","794","1855","0","42.80","30.08"
"68","000","00","020","0010","0000","1504","1003","501","13","1517","3778","0","40.15","26.55"
"68","000","00","020","0010","0764","596","385","211","5","601","1453","0","41.36","26.50"
"68","000","00","020","0010","0765","327","218","109","1","328","803","0","40.85","27.15"
"68","000","00","020","0010","0766","581","400","181","7","588","1522","0","38.63","26.28"
"68","000","00","020","0011","0000","1778","1019","759","25","1803","4305","0","41.88","23.67"
"68","000","00","020","0011","0696","513","298","215","4","517","1243","0","41.59","23.97"
"68","000","00","020","0011","0697","628","356","272","12","640","1469","0","43.57","24.23"
"68","000","00","020","0011","0698","637","365","272","9","646","1593","0","40.55","22.91"
"68","000","00","020","0012","0000","2206","1334","872","14","2220","5566","0","39.89","23.97"
"68","000","00","020","0012","0714","747","481","266","2","749","1853","0","40.42","25.96"
"68","000","00","020","0012","0715","439","273","166","5","444","1229","0","36.13","22.21"
"68","000","00","020","0012","0716","448","273","175","4","452","1105","0","40.90","24.71"
"68","000","00","020","0012","0717","572","307","265","3","575","1379","0","41.70","22.26"
"68","000","00","020","0013","0000","1294","734","560","7","1301","3006","0","43.28","24.42"
"68","000","00","020","0013","0753","649","374","275","4","653","1507","0","43.33","24.82"
"68","000","00","020","0013","0754","645","360","285","3","648","1499","0","43.23","24.02"
"68","000","00","020","0014","0000","974","525","449","13","987","2310","0","42.73","22.73"
"68","000","00","020","0014","0871","421","206","215","6","427","1114","0","38.33","18.49"
"68","000","00","020","0014","0872","553","319","234","7","560","1196","0","46.82","26.67"
"68","000","00","020","0015","0000","1639","865","774","8","1647","3407","0","48.34","25.39"
"68","000","00","020","0015","0830","669","385","284","1","670","1408","0","47.59","27.34"
"68","000","00","020","0015","0831","501","251","250","3","504","1042","0","48.37","24.09"
"68","000","00","020","0015","0832","469","229","240","4","473","957","0","49.43","23.93"
"68","000","00","020","0016","0000","1616","941","675","14","1630","4240","0","38.44","22.19"
"68","000","00","020","0016","0724","568","321","247","6","574","1395","0","41.15","23.01"
"68","000","00","020","0016","0725","524","304","220","4","528","1420","0","37.18","21.41"
"68","000","00","020","0016","0726","524","316","208","4","528","1425","0","37.05","22.18"
"68","000","00","020","0017","0000","1733","1049","684","15","1748","5599","0","31.22","18.74"
"68","000","00","020","0017","0740","600","362","238","5","605","1175","0","51.49","30.81"
"68","000","00","020","0017","0741","569","331","238","5","574","1204","0","47.67","27.49"
"68","000","00","020","0017","0742","564","356","208","5","569","3220","0","17.67","11.06"
"68","000","00","020","0018","0000","1575","855","720","12","1587","3943","0","40.25","21.68"
"68","000","00","020","0018","0748","514","272","242","3","517","1519","0","34.04","17.91"
"68","000","00","020","0018","0749","585","301","284","6","591","1316","0","44.91","22.87"
"68","000","00","020","0018","0750","476","282","194","3","479","1108","0","43.23","25.45"
"68","000","00","020","0019","0000","1980","1258","722","17","1997","5241","0","38.10","24.00"
"68","000","00","020","0019","0769","558","344","214","3","561","1661","0","33.77","20.71"
"68","000","00","020","0019","0770","684","439","245","7","691","1781","0","38.80","24.65"
"68","000","00","020","0019","0771","738","475","263","7","745","1799","0","41.41","26.40"
"68","000","00","020","0020","0000","1276","753","523","10","1286","3393","0","37.90","22.19"
"68","000","00","020","0020","0767","667","389","278","7","674","1721","0","39.16","22.60"
"68","000","00","020","0020","0768","609","364","245","3","612","1672","0","36.60","21.77"
"68","000","00","020","0021","0000","1485","775","710","10","1495","3315","0","45.10","23.38"
"68","000","00","020","0021","0842","687","364","323","5","692","1653","0","41.86","22.02"
"68","000","00","020","0021","0843","798","411","387","5","803","1662","0","48.32","24.73"
"68","000","00","020","0022","0000","2805","1360","1445","23","2828","6960","0","40.63","19.54"
"68","000","00","020","0022","0909","649","251","398","6","655","1850","0","35.41","13.57"
"68","000","00","020","0022","0910","803","395","408","8","811","1830","0","44.32","21.58"
"68","000","00","020","0022","0911","715","367","348","6","721","1657","0","43.51","22.15"
"68","000","00","020","0022","0912","638","347","291","3","641","1623","0","39.49","21.38"
"68","000","00","020","0023","0000","1003","603","400","7","1010","2660","0","37.97","22.67"
"68","000","00","020","0023","0775","456","268","188","4","460","1295","0","35.52","20.69"
"68","000","00","020","0023","0776","547","335","212","3","550","1365","0","40.29","24.54"
"68","000","00","020","0024","0000","1579","742","837","14","1593","3765","0","42.31","19.71"
"68","000","00","020","0024","0886","522","228","294","8","530","1251","0","42.37","18.23"
"68","000","00","020","0024","0887","514","226","288","1","515","1200","0","42.92","18.83"
"68","000","00","020","0024","0888","543","288","255","5","548","1314","0","41.70","21.92"
"68","000","00","020","0025","0000","1542","835","707","12","1554","3646","0","42.62","22.90"
"68","000","00","020","0025","0833","782","430","352","8","790","1804","0","43.79","23.84"
"68","000","00","020","0025","0834","760","405","355","4","764","1842","0","41.48","21.99"
"68","000","00","020","0026","0000","1559","844","715","9","1568","3654","0","42.91","23.10"
"68","000","00","020","0026","0800","540","242","298","2","542","1182","0","45.85","20.47"
"68","000","00","020","0026","0801","504","286","218","5","509","1242","0","40.98","23.03"
"68","000","00","020","0026","0802","515","316","199","2","517","1230","0","42.03","25.69"
"68","000","00","020","0027","0000","2454","1128","1326","16","2470","6882","0","35.89","16.39"
"68","000","00","020","0027","0824","439","189","250","4","443","1216","0","36.43","15.54"
"68","000","00","020","0027","0825","441","215","226","4","445","1212","0","36.72","17.74"
"68","000","00","020","0027","0826","538","242","296","1","539","1547","0","34.84","15.64"
"68","000","00","020","0027","0827","547","247","300","2","549","1629","0","33.70","15.16"
"68","000","00","020","0027","0828","489","235","254","5","494","1278","0","38.65","18.39"
"68","000","00","020","0028","0000","294","147","147","1","295","674","0","43.77","21.81"
"68","000","00","020","0028","0882","294","147","147","1","295","674","0","43.77","21.81"
"68","000","00","020","0029","0000","2000","1317","683","23","2023","4607","0","43.91","28.59"
"68","000","00","020","0029","0702","693","444","249","3","696","1627","0","42.78","27.29"
"68","000","00","020","0029","0703","656","427","229","13","669","1481","0","45.17","28.83"
"68","000","00","020","0029","0704","651","446","205","7","658","1499","0","43.90","29.75"
"68","000","00","020","0030","0000","1064","719","345","8","1072","2813","0","38.11","25.56"
"68","000","00","020","0030","0759","575","373","202","6","581","1530","0","37.97","24.38"
"68","000","00","020","0030","0760","489","346","143","2","491","1283","0","38.27","26.97"
"68","000","00","020","0031","0000","1499","706","793","16","1515","3634","0","41.69","19.43"
"68","000","00","020","0031","0847","436","154","282","7","443","1095","0","40.46","14.06"
"68","000","00","020","0031","0848","578","282","296","3","581","1340","0","43.36","21.04"
"68","000","00","020","0031","0849","485","270","215","6","491","1199","0","40.95","22.52"
"68","000","00","020","0032","0000","2625","1335","1290","20","2645","6486","0","40.78","20.58"
"68","000","00","020","0032","0867","677","338","339","4","681","1738","0","39.18","19.45"
"68","000","00","020","0032","0868","651","315","336","5","656","1632","0","40.20","19.30"
"68","000","00","020","0032","0869","735","374","361","5","740","1800","0","41.11","20.78"
"68","000","00","020","0032","0870","562","308","254","6","568","1316","0","43.16","23.40"
"68","000","00","020","0033","0000","3481","1995","1486","28","3509","9665","0","36.31","20.64"
"68","000","00","020","0033","0806","573","359","214","5","578","1504","0","38.43","23.87"
"68","000","00","020","0033","0807","556","347","209","5","561","1533","0","36.59","22.64"
"68","000","00","020","0033","0808","671","347","324","10","681","1820","0","37.42","19.07"
"68","000","00","020","0033","0809","587","300","287","2","589","1796","0","32.80","16.70"
"68","000","00","020","0033","0810","559","341","218","4","563","1562","0","36.04","21.83"
"68","000","00","020","0033","0811","535","301","234","2","537","1450","0","37.03","20.76"
"68","000","00","020","0034","0000","3401","1807","1594","20","3421","8837","0","38.71","20.45"
"68","000","00","020","0034","0816","506","257","249","4","510","1257","0","40.57","20.45"
"68","000","00","020","0034","0817","452","234","218","1","453","1221","0","37.10","19.16"
"68","000","00","020","0034","0818","503","251","252","2","505","1255","0","40.24","20.00"
"68","000","00","020","0034","0819","562","334","228","4","566","1522","0","37.19","21.94"
"68","000","00","020","0034","0820","674","334","340","3","677","1765","0","38.36","18.92"
"68","000","00","020","0034","0821","704","397","307","6","710","1817","0","39.08","21.85"
"68","000","00","020","0035","0000","855","404","451","8","863","1888","0","45.71","21.40"
"68","000","00","020","0035","0875","396","173","223","5","401","952","0","42.12","18.17"
"68","000","00","020","0035","0876","459","231","228","3","462","936","0","49.36","24.68"
"68","000","00","020","0036","0000","3160","1721","1439","27","3187","7822","0","40.74","22.00"
"68","000","00","020","0036","0853","509","255","254","1","510","1203","0","42.39","21.20"
"68","000","00","020","0036","0854","413","198","215","3","416","1109","0","37.51","17.85"
"68","000","00","020","0036","0855","565","343","222","7","572","1129","0","50.66","30.38"
"68","000","00","020","0036","0856","516","256","260","4","520","1336","0","38.92","19.16"
"68","000","00","020","0036","0857","586","332","254","6","592","1390","0","42.59","23.88"
"68","000","00","020","0036","0858","571","337","234","6","577","1655","0","34.86","20.36"
"68","000","00","020","0037","0000","1982","1142","840","9","1991","4334","0","45.94","26.35"
"68","000","00","020","0037","0734","651","360","291","5","656","1346","0","48.74","26.75"
"68","000","00","020","0037","0735","681","393","288","4","685","1428","0","47.97","27.52"
"68","000","00","020","0037","0736","650","389","261","0","650","1560","0","41.67","24.94"
"68","000","00","020","0038","0000","701","330","371","6","707","1585","0","44.61","20.82"
"68","000","00","020","0038","0829","701","330","371","6","707","1585","0","44.61","20.82"
"68","000","00","020","0039","0000","2061","1588","473","22","2083","4952","0","42.06","32.07"
"68","000","00","020","0039","0705","657","490","167","10","667","1661","0","40.16","29.50"
"68","000","00","020","0039","0706","686","543","143","7","693","1566","0","44.25","34.67"
"68","000","00","020","0039","0707","718","555","163","5","723","1725","0","41.91","32.17"
"68","000","00","020","0040","0000","448","199","249","3","451","991","0","45.51","20.08"
"68","000","00","020","0040","0884","448","199","249","3","451","991","0","45.51","20.08"
"68","000","00","020","0041","0000","1277","729","548","15","1292","3012","0","42.90","24.20"
"68","000","00","020","0041","0873","621","309","312","9","630","1395","0","45.16","22.15"
"68","000","00","020","0041","0874","656","420","236","6","662","1617","0","40.94","25.97"
"68","000","00","020","0042","0000","1830","1052","778","17","1847","4849","0","38.09","21.70"
"68","000","00","020","0042","0685","643","377","266","4","647","1542","0","41.96","24.45"
"68","000","00","020","0042","0686","560","317","243","9","569","1500","0","37.93","21.13"
"68","000","00","020","0042","0687","627","358","269","4","631","1807","0","34.92","19.81"
"68","000","00","020","0043","0000","3012","1444","1568","25","3037","7935","0","38.27","18.20"
"68","000","00","020","0043","0923","672","280","392","7","679","1535","0","44.23","18.24"
"68","000","00","020","0043","0924","559","279","280","5","564","1413","0","39.92","19.75"
"68","000","00","020","0043","0925","539","238","301","4","543","1432","0","37.92","16.62"
"68","000","00","020","0043","0926","614","334","280","3","617","1715","0","35.98","19.48"
"68","000","00","020","0043","0927","628","313","315","6","634","1840","0","34.46","17.01"
"68","000","00","020","0044","0000","2547","1270","1277","24","2571","6137","0","41.89","20.69"
"68","000","00","020","0044","0899","566","271","295","8","574","1392","0","41.24","19.47"
"68","000","00","020","0044","0900","648","291","357","5","653","1577","0","41.41","18.45"
"68","000","00","020","0044","0901","575","312","263","4","579","1466","0","39.50","21.28"
"68","000","00","020","0044","0902","758","396","362","7","765","1702","0","44.95","23.27"
"68","000","00","020","0045","0000","702","323","379","11","713","1460","0","48.84","22.12"
"68","000","00","020","0045","0885","702","323","379","11","713","1460","0","48.84","22.12"
"68","000","00","020","0046","0000","1711","863","848","14","1725","4196","0","41.11","20.57"
"68","000","00","020","0046","0906","593","360","233","5","598","1413","0","42.32","25.48"
"68","000","00","020","0046","0907","573","203","370","6","579","1297","0","44.64","15.65"
"68","000","00","020","0046","0908","545","300","245","3","548","1486","0","36.88","20.19"
"68","000","00","020","0047","0000","2101","730","1371","19","2120","5631","0","37.65","12.96"
"68","000","00","020","0047","0916","595","221","374","6","601","1509","0","39.83","14.65"
"68","000","00","020","0047","0917","459","164","295","9","468","1374","0","34.06","11.94"
"68","000","00","020","0047","0918","608","200","408","2","610","1589","0","38.39","12.59"
"68","000","00","020","0047","0919","439","145","294","2","441","1159","0","38.05","12.51"
"68","000","00","020","0048","0000","1267","573","694","9","1276","3254","0","39.21","17.61"
"68","000","00","020","0048","0897","622","277","345","5","627","1591","0","39.41","17.41"
"68","000","00","020","0048","0898","645","296","349","4","649","1663","0","39.03","17.80"
"68","000","00","020","0049","0000","1470","502","968","18","1488","3746","0","39.72","13.40"
"68","000","00","020","0049","0920","489","181","308","5","494","1266","0","39.02","14.30"
"68","000","00","020","0049","0921","512","168","344","5","517","1248","0","41.43","13.46"
"68","000","00","020","0049","0922","469","153","316","8","477","1232","0","38.72","12.42"
"68","000","00","020","0050","0000","383","181","202","3","386","827","0","46.67","21.89"
"68","000","00","020","0050","0883","383","181","202","3","386","827","0","46.67","21.89"
"68","000","00","020","0051","0000","2040","846","1194","20","2060","4787","0","43.03","17.67"
"68","000","00","020","0051","0913","696","285","411","10","706","1738","0","40.62","16.40"
"68","000","00","020","0051","0914","599","244","355","0","599","1429","0","41.92","17.07"
"68","000","00","020","0051","0915","745","317","428","10","755","1620","0","46.60","19.57"
"68","000","00","020","0052","0000","2103","1233","870","17","2120","4813","0","44.05","25.62"
"68","000","00","020","0052","0838","548","324","224","5","553","1234","0","44.81","26.26"
"68","000","00","020","0052","0839","540","318","222","2","542","1296","0","41.82","24.54"
"68","000","00","020","0052","0840","539","329","210","4","543","1221","0","44.47","26.95"
"68","000","00","020","0052","0841","476","262","214","6","482","1062","0","45.39","24.67"
"68","000","00","020","0053","0000","1149","690","459","5","1154","2583","0","44.68","26.71"
"68","000","00","020","0053","0732","559","332","227","3","562","1298","0","43.30","25.58"
"68","000","00","020","0053","0733","590","358","232","2","592","1285","0","46.07","27.86"
"68","000","00","020","0054","0000","1224","542","682","10","1234","2700","0","45.70","20.07"
"68","000","00","020","0054","0879","425","159","266","3","428","1018","0","42.04","15.62"
"68","000","00","020","0054","0880","799","383","416","7","806","1682","0","47.92","22.77"
"68","000","00","020","0055","0000","2221","1146","1075","15","2236","5435","0","41.14","21.09"
"68","000","00","020","0055","0893","516","218","298","3","519","1332","0","38.96","16.37"
"68","000","00","020","0055","0894","703","401","302","3","706","1491","0","47.35","26.89"
"68","000","00","020","0055","0895","504","239","265","7","511","1215","0","42.06","19.67"
"68","000","00","020","0055","0896","498","288","210","2","500","1397","0","35.79","20.62"
"68","000","00","020","0056","0000","2224","1251","973","21","2245","5563","0","40.36","22.49"
"68","000","00","020","0056","0812","506","289","217","4","510","1314","0","38.81","21.99"
"68","000","00","020","0056","0813","660","361","299","1","661","1492","0","44.30","24.20"
"68","000","00","020","0056","0814","401","224","177","5","406","1218","0","33.33","18.39"
"68","000","00","020","0056","0815","657","377","280","11","668","1539","0","43.40","24.50"
"68","000","00","020","0057","0000","1867","1117","750","20","1887","4591","0","41.10","24.33"
"68","000","00","020","0057","0803","734","414","320","8","742","1613","0","46.00","25.67"
"68","000","00","020","0057","0804","514","298","216","4","518","1432","0","36.17","20.81"
"68","000","00","020","0057","0805","619","405","214","8","627","1546","0","40.56","26.20"
"68","000","00","020","0058","0000","1214","689","525","9","1223","2834","0","43.15","24.31"
"68","000","00","020","0058","0798","570","300","270","7","577","1349","0","42.77","22.24"
"68","000","00","020","0058","0799","644","389","255","2","646","1485","0","43.50","26.20"
"68","000","00","020","0059","0000","1005","558","447","4","1009","2525","0","39.96","22.10"
"68","000","00","020","0059","0822","459","260","199","3","462","1264","0","36.55","20.57"
"68","000","00","020","0059","0823","546","298","248","1","547","1261","0","43.38","23.63"
"68","000","00","020","0060","0000","1451","826","625","8","1459","3252","0","44.86","25.40"
"68","000","00","020","0060","0727","782","437","345","4","786","1718","0","45.75","25.44"
"68","000","00","020","0060","0728","669","389","280","4","673","1534","0","43.87","25.36"
"68","000","00","020","0061","0000","1690","1035","655","9","1699","3683","0","46.13","28.10"
"68","000","00","020","0061","0729","626","385","241","5","631","1328","0","47.52","28.99"
"68","000","00","020","0061","0730","483","297","186","1","484","1109","0","43.64","26.78"
"68","000","00","020","0061","0731","581","353","228","3","584","1246","0","46.87","28.33"
"68","000","00","020","0062","0000","2036","1149","887","9","2045","4693","0","43.58","24.48"
"68","000","00","020","0062","0688","750","436","314","4","754","1701","0","44.33","25.63"
"68","000","00","020","0062","0689","606","335","271","3","609","1475","0","41.29","22.71"
"68","000","00","020","0062","0690","680","378","302","2","682","1517","0","44.96","24.92"
"68","000","00","020","0063","0000","1422","960","462","12","1434","3713","0","38.62","25.86"
"68","000","00","020","0063","0691","644","446","198","7","651","1627","0","40.01","27.41"
"68","000","00","020","0063","0692","778","514","264","5","783","2086","0","37.54","24.64"
"68","000","00","020","0064","0000","1487","724","763","14","1501","3620","0","41.46","20.00"
"68","000","00","020","0064","0903","449","192","257","3","452","1081","0","41.81","17.76"
"68","000","00","020","0064","0904","433","227","206","4","437","1147","0","38.10","19.79"
"68","000","00","020","0064","0905","605","305","300","7","612","1392","0","43.97","21.91"
"68","000","00","020","0065","0000","1775","1119","656","12","1787","4104","0","43.54","27.27"
"68","000","00","020","0065","0699","567","320","247","5","572","1339","0","42.72","23.90"
"68","000","00","020","0065","0700","615","395","220","5","620","1309","0","47.36","30.18"
"68","000","00","020","0065","0701","593","404","189","2","595","1456","0","40.87","27.75"
"68","000","00","020","0066","0000","1914","1055","859","11","1925","4282","0","44.96","24.64"
"68","000","00","020","0066","0737","638","343","295","6","644","1409","0","45.71","24.34"
"68","000","00","020","0066","0738","605","346","259","3","608","1379","0","44.09","25.09"
"68","000","00","020","0066","0739","671","366","305","2","673","1494","0","45.05","24.50"
"68","000","00","020","0067","0000","1016","797","219","4","1020","2050","0","49.76","38.88"
"68","000","00","020","0067","0751","451","355","96","1","452","960","0","47.08","36.98"
"68","000","00","020","0067","0752","565","442","123","3","568","1090","0","52.11","40.55"
"68","000","00","020","0068","0000","1830","1178","652","15","1845","4761","0","38.75","24.74"
"68","000","00","020","0068","0772","580","363","217","4","584","1506","0","38.78","24.10"
"68","000","00","020","0068","0773","673","434","239","7","680","1746","0","38.95","24.86"
"68","000","00","020","0068","0774","577","381","196","4","581","1509","0","38.50","25.25"
"68","000","00","020","0069","0000","1131","631","500","9","1140","2501","0","45.58","25.23"
"68","000","00","020","0069","0743","480","260","220","6","486","1112","0","43.71","23.38"
"68","000","00","020","0069","0744","651","371","280","3","654","1389","0","47.08","26.71"
"68","000","00","020","0070","0000","1591","854","737","18","1609","3783","0","42.53","22.57"
"68","000","00","020","0070","0745","506","284","222","9","515","1155","0","44.59","24.59"
"68","000","00","020","0070","0746","553","288","265","2","555","1321","0","42.01","21.80"
"68","000","00","020","0070","0747","532","282","250","7","539","1307","0","41.24","21.58"
"68","000","00","020","0071","0000","1482","1058","424","15","1497","3965","0","37.76","26.68"
"68","000","00","020","0071","0761","444","350","94","8","452","1028","0","43.97","34.05"
"68","000","00","020","0071","0762","457","305","152","4","461","1232","0","37.42","24.76"
"68","000","00","020","0071","0763","581","403","178","3","584","1705","0","34.25","23.64"
"68","000","00","020","0072","0000","1841","1210","631","17","1858","4804","0","38.68","25.19"
"68","000","00","020","0072","0718","690","449","241","4","694","1635","0","42.45","27.46"
"68","000","00","020","0072","0719","607","415","192","9","616","1578","0","39.04","26.30"
"68","000","00","020","0072","0720","544","346","198","4","548","1591","0","34.44","21.75"
"68","000","00","020","0073","0000","2446","1343","1103","19","2465","6095","0","40.44","22.03"
"68","000","00","020","0073","0859","657","311","346","6","663","1586","0","41.80","19.61"
"68","000","00","020","0073","0860","641","361","280","7","648","1706","0","37.98","21.16"
"68","000","00","020","0073","0861","521","284","237","2","523","1357","0","38.54","20.93"
"68","000","00","020","0073","0862","627","387","240","4","631","1446","0","43.64","26.76"
"68","000","00","020","0074","0000","2429","1243","1186","17","2446","5469","0","44.72","22.73"
"68","000","00","020","0074","0863","262","120","142","1","263","640","0","41.09","18.75"
"68","000","00","020","0074","0864","736","369","367","5","741","1523","0","48.65","24.23"
"68","000","00","020","0074","0865","708","362","346","4","712","1621","0","43.92","22.33"
"68","000","00","020","0074","0866","723","392","331","7","730","1685","0","43.32","23.26"
"68","000","00","020","0075","0000","1381","856","525","19","1400","3582","0","39.08","23.90"
"68","000","00","020","0075","0757","700","418","282","9","709","1740","0","40.75","24.02"
"68","000","00","020","0075","0758","681","438","243","10","691","1842","0","37.51","23.78"
"68","000","00","020","0076","0000","1356","879","477","15","1371","3555","0","38.57","24.73"
"68","000","00","020","0076","0721","451","291","160","6","457","1220","0","37.46","23.85"
"68","000","00","020","0076","0722","457","303","154","5","462","1102","0","41.92","27.50"
"68","000","00","020","0076","0723","448","285","163","4","452","1233","0","36.66","23.11"
"68","000","00","020","0077","0000","1611","1235","376","29","1640","3413","0","48.05","36.19"
"68","000","00","020","0077","0789","838","724","114","22","860","1711","0","50.26","42.31"
"68","000","00","020","0077","0790","773","511","262","7","780","1702","0","45.83","30.02"
"68","000","00","020","0078","0000","1655","1235","420","12","1667","3620","0","46.05","34.12"
"68","000","00","020","0078","0791","832","616","216","5","837","1830","0","45.74","33.66"
"68","000","00","020","0078","0792","823","619","204","7","830","1790","0","46.37","34.58"
"68","000","00","020","0079","0000","1912","1118","794","15","1927","4454","0","43.26","25.10"
"68","000","00","020","0079","0844","612","344","268","4","616","1393","0","44.22","24.69"
"68","000","00","020","0079","0845","615","387","228","8","623","1526","0","40.83","25.36"
"68","000","00","020","0079","0846","685","387","298","3","688","1535","0","44.82","25.21"
"68","000","00","020","0080","0000","1153","516","637","3","1156","2395","0","48.27","21.54"
"68","000","00","020","0080","0877","569","256","313","1","570","1222","0","46.64","20.95"
"68","000","00","020","0080","0878","584","260","324","2","586","1173","0","49.96","22.17"
"68","000","00","020","0081","0000","1351","890","461","11","1362","3376","0","40.34","26.36"
"68","000","00","020","0081","0779","624","425","199","2","626","1783","0","35.11","23.84"
"68","000","00","020","0081","0780","727","465","262","9","736","1593","0","46.20","29.19"
"68","000","00","020","0082","0000","2009","1332","677","13","2022","4787","0","42.24","27.83"
"68","000","00","020","0082","0693","505","283","222","2","507","1135","0","44.67","24.93"
"68","000","00","020","0082","0694","766","519","247","3","769","1881","0","40.88","27.59"
"68","000","00","020","0082","0695","738","530","208","8","746","1771","0","42.12","29.93"
"68","000","00","020","0083","0000","2291","1458","833","20","2311","5590","0","41.34","26.08"
"68","000","00","020","0083","0785","550","358","192","4","554","1376","0","40.26","26.02"
"68","000","00","020","0083","0786","543","363","180","4","547","1275","0","42.90","28.47"
"68","000","00","020","0083","0787","633","411","222","5","638","1523","0","41.89","26.99"
"68","000","00","020","0083","0788","565","326","239","7","572","1416","0","40.40","23.02"
"68","000","00","020","0084","0000","1702","1009","693","11","1713","3821","0","44.83","26.41"
"68","000","00","020","0084","0835","613","366","247","6","619","1346","0","45.99","27.19"
"68","000","00","020","0084","0836","511","310","201","1","512","1229","0","41.66","25.22"
"68","000","00","020","0084","0837","578","333","245","4","582","1246","0","46.71","26.73"
"68","000","00","020","0085","0000","2077","1292","785","15","2092","4035","0","51.85","32.02"
"68","000","00","020","0085","0850","732","457","275","9","741","1414","0","52.40","32.32"
"68","000","00","020","0085","0851","674","426","248","2","676","1341","0","50.41","31.77"
"68","000","00","020","0085","0852","671","409","262","4","675","1280","0","52.73","31.95"
"68","000","00","030","0000","0000","31066","14846","16220","348","31414","79690","95240","39.42","18.63"
"68","000","00","030","0001","0000","671","247","424","5","676","1435","0","47.11","17.21"
"68","000","00","030","0001","0611","671","247","424","5","676","1435","0","47.11","17.21"
"68","000","00","030","0002","0000","452","162","290","5","457","963","0","47.46","16.82"
"68","000","00","030","0002","0612","452","162","290","5","457","963","0","47.46","16.82"
"68","000","00","030","0003","0000","1819","809","1010","15","1834","4760","0","38.53","17.00"
"68","000","00","030","0003","0616","446","196","250","7","453","1140","0","39.74","17.19"
"68","000","00","030","0003","0617","504","228","276","1","505","1263","0","39.98","18.05"
"68","000","00","030","0003","0618","494","221","273","3","497","1213","0","40.97","18.22"
"68","000","00","030","0003","0619","375","164","211","4","379","1144","0","33.13","14.34"
"68","000","00","030","0004","0000","1996","788","1208","27","2023","5582","0","36.24","14.12"
"68","000","00","030","0004","0620","505","174","331","5","510","1224","0","41.67","14.22"
"68","000","00","030","0004","0621","446","217","229","7","453","1395","0","32.47","15.56"
"68","000","00","030","0004","0622","524","187","337","9","533","1415","0","37.67","13.22"
"68","000","00","030","0004","0623","521","210","311","6","527","1548","0","34.04","13.57"
"68","000","00","030","0005","0000","476","149","327","8","484","1237","0","39.13","12.05"
"68","000","00","030","0005","0624","476","149","327","8","484","1237","0","39.13","12.05"
"68","000","00","030","0006","0000","433","122","311","3","436","964","0","45.23","12.66"
"68","000","00","030","0006","0625","433","122","311","3","436","964","0","45.23","12.66"
"68","000","00","030","0007","0000","1234","449","785","11","1245","3069","0","40.57","14.63"
"68","000","00","030","0007","0629","465","164","301","2","467","1059","0","44.10","15.49"
"68","000","00","030","0007","0630","479","190","289","6","485","1253","0","38.71","15.16"
"68","000","00","030","0007","0631","290","95","195","3","293","757","0","38.71","12.55"
"68","000","00","030","0008","0000","894","303","591","13","907","2222","0","40.82","13.64"
"68","000","00","030","0008","0632","496","187","309","6","502","1271","0","39.50","14.71"
"68","000","00","030","0008","0633","398","116","282","7","405","951","0","42.59","12.20"
"68","000","00","030","0009","0000","348","121","227","5","353","859","0","41.09","14.09"
"68","000","00","030","0009","0634","348","121","227","5","353","859","0","41.09","14.09"
"68","000","00","030","0010","0000","304","111","193","5","309","808","0","38.24","13.74"
"68","000","00","030","0010","0635","304","111","193","5","309","808","0","38.24","13.74"
"68","000","00","030","0011","0000","579","173","406","8","587","1300","0","45.15","13.31"
"68","000","00","030","0011","0626","579","173","406","8","587","1300","0","45.15","13.31"
"68","000","00","030","0012","0000","724","256","468","7","731","1752","0","41.72","14.61"
"68","000","00","030","0012","0627","458","158","300","4","462","1114","0","41.47","14.18"
"68","000","00","030","0012","0628","266","98","168","3","269","638","0","42.16","15.36"
"68","000","00","030","0013","0000","998","383","615","15","1013","2714","0","37.32","14.11"
"68","000","00","030","0013","0638","562","175","387","10","572","1403","0","40.77","12.47"
"68","000","00","030","0013","0639","436","208","228","5","441","1311","0","33.64","15.87"
"68","000","00","030","0014","0000","672","232","440","8","680","1519","0","44.77","15.27"
"68","000","00","030","0014","0636","363","116","247","4","367","827","0","44.38","14.03"
"68","000","00","030","0014","0637","309","116","193","4","313","692","0","45.23","16.76"
"68","000","00","030","0015","0000","1053","759","294","25","1078","2831","0","38.08","26.81"
"68","000","00","030","0015","0648","545","359","186","15","560","1447","0","38.70","24.81"
"68","000","00","030","0015","0649","508","400","108","10","518","1384","0","37.43","28.90"
"68","000","00","030","0016","0000","1089","913","176","9","1098","2488","0","44.13","36.70"
"68","000","00","030","0016","0646","601","539","62","5","606","1222","0","49.59","44.11"
"68","000","00","030","0016","0647","488","374","114","4","492","1266","0","38.86","29.54"
"68","000","00","030","0017","0000","1780","914","866","13","1793","4490","0","39.93","20.36"
"68","000","00","030","0017","0640","558","254","304","7","565","1488","0","37.97","17.07"
"68","000","00","030","0017","0641","502","282","220","3","505","1271","0","39.73","22.19"
"68","000","00","030","0017","0642","720","378","342","3","723","1731","0","41.77","21.84"
"68","000","00","030","0018","0000","1948","970","978","20","1968","5178","0","38.01","18.73"
"68","000","00","030","0018","0653","542","282","260","7","549","1345","0","40.82","20.97"
"68","000","00","030","0018","0654","483","221","262","7","490","1100","0","44.55","20.09"
"68","000","00","030","0018","0655","518","241","277","3","521","1337","0","38.97","18.03"
"68","000","00","030","0018","0656","405","226","179","3","408","1396","0","29.23","16.19"
"68","000","00","030","0019","0000","1265","700","565","12","1277","3244","0","39.36","21.58"
"68","000","00","030","0019","0657","721","387","334","9","730","1758","0","41.52","22.01"
"68","000","00","030","0019","0658","544","313","231","3","547","1486","0","36.81","21.06"
"68","000","00","030","0020","0000","599","306","293","4","603","1577","0","38.24","19.40"
"68","000","00","030","0020","0668","599","306","293","4","603","1577","0","38.24","19.40"
"68","000","00","030","0021","0000","1781","802","979","26","1807","5101","0","35.42","15.72"
"68","000","00","030","0021","0662","438","160","278","6","444","1174","0","37.82","13.63"
"68","000","00","030","0021","0663","490","195","295","7","497","1320","0","37.65","14.77"
"68","000","00","030","0021","0664","407","191","216","5","412","1290","0","31.94","14.81"
"68","000","00","030","0021","0665","446","256","190","8","454","1317","0","34.47","19.44"
"68","000","00","030","0022","0000","1451","638","813","9","1460","3734","0","39.10","17.09"
"68","000","00","030","0022","0671","467","224","243","5","472","1254","0","37.64","17.86"
"68","000","00","030","0022","0672","455","239","216","2","457","1156","0","39.53","20.67"
"68","000","00","030","0022","0673","529","175","354","2","531","1324","0","40.11","13.22"
"68","000","00","030","0023","0000","924","583","341","18","942","2437","0","38.65","23.92"
"68","000","00","030","0023","0666","428","250","178","11","439","1271","0","34.54","19.67"
"68","000","00","030","0023","0667","496","333","163","7","503","1166","0","43.14","28.56"
"68","000","00","030","0024","0000","1201","795","406","12","1213","3012","0","40.27","26.39"
"68","000","00","030","0024","0669","603","377","226","6","609","1470","0","41.43","25.65"
"68","000","00","030","0024","0670","598","418","180","6","604","1542","0","39.17","27.11"
"68","000","00","030","0025","0000","1843","733","1110","22","1865","4436","0","42.04","16.52"
"68","000","00","030","0025","0613","650","277","373","6","656","1541","0","42.57","17.98"
"68","000","00","030","0025","0614","607","225","382","12","619","1427","0","43.38","15.77"
"68","000","00","030","0025","0615","586","231","355","4","590","1468","0","40.19","15.74"
"68","000","00","030","0026","0000","1473","813","660","14","1487","3897","0","38.16","20.86"
"68","000","00","030","0026","0659","457","240","217","1","458","1378","0","33.24","17.42"
"68","000","00","030","0026","0660","410","245","165","5","415","1040","0","39.90","23.56"
"68","000","00","030","0026","0661","606","328","278","8","614","1479","0","41.51","22.18"
"68","000","00","030","0027","0000","1818","936","882","15","1833","4772","0","38.41","19.61"
"68","000","00","030","0027","0650","675","393","282","6","681","1647","0","41.35","23.86"
"68","000","00","030","0027","0651","570","266","304","4","574","1561","0","36.77","17.04"
"68","000","00","030","0027","0652","573","277","296","5","578","1564","0","36.96","17.71"
"68","000","00","030","0028","0000","1241","679","562","14","1255","3309","0","37.93","20.52"
"68","000","00","030","0028","0643","369","203","166","7","376","977","0","38.49","20.78"
"68","000","00","030","0028","0644","412","228","184","5","417","1074","0","38.83","21.23"
"68","000","00","030","0028","0645","460","248","212","2","462","1258","0","36.72","19.71"
"68","000","00","040","0000","0000","53900","30812","23088","485","54385","144349","176189","37.68","21.35"
"68","000","00","040","0001","0000","1576","936","640","8","1584","3845","0","41.20","24.34"
"68","000","00","040","0001","1104","552","292","260","3","555","1363","0","40.72","21.42"
"68","000","00","040","0001","1105","465","287","178","3","468","1274","0","36.73","22.53"
"68","000","00","040","0001","1106","559","357","202","2","561","1208","0","46.44","29.55"
"68","000","00","040","0002","0000","468","287","181","6","474","1054","0","44.97","27.23"
"68","000","00","040","0002","1107","468","287","181","6","474","1054","0","44.97","27.23"
"68","000","00","040","0003","0000","1088","653","435","12","1100","2595","0","42.39","25.16"
"68","000","00","040","0003","1110","466","278","188","4","470","1252","0","37.54","22.20"
"68","000","00","040","0003","1111","622","375","247","8","630","1343","0","46.91","27.92"
"68","000","00","040","0004","0000","2463","1409","1054","19","2482","7481","0","33.18","18.83"
"68","000","00","040","0004","1112","476","228","248","6","482","2073","0","23.25","11.00"
"68","000","00","040","0004","1113","635","335","300","8","643","1799","0","35.74","18.62"
"68","000","00","040","0004","1114","656","424","232","2","658","1744","0","37.73","24.31"
"68","000","00","040","0004","1115","696","422","274","3","699","1865","0","37.48","22.63"
"68","000","00","040","0005","0000","1135","706","429","9","1144","3148","0","36.34","22.43"
"68","000","00","040","0005","1116","530","362","168","5","535","1572","0","34.03","23.03"
"68","000","00","040","0005","1117","605","344","261","4","609","1576","0","38.64","21.83"
"68","000","00","040","0006","0000","987","451","536","7","994","2934","0","33.88","15.37"
"68","000","00","040","0006","1120","578","242","336","2","580","1761","0","32.94","13.74"
"68","000","00","040","0006","1121","409","209","200","5","414","1173","0","35.29","17.82"
"68","000","00","040","0007","0000","1602","804","798","18","1620","4097","0","39.54","19.62"
"68","000","00","040","0007","1155","575","263","312","7","582","1453","0","40.06","18.10"
"68","000","00","040","0007","1156","468","257","211","5","473","1337","0","35.38","19.22"
"68","000","00","040","0007","1157","559","284","275","6","565","1307","0","43.23","21.73"
"68","000","00","040","0008","0000","974","456","518","8","982","2632","0","37.31","17.33"
"68","000","00","040","0008","1139","446","197","249","4","450","1196","0","37.63","16.47"
"68","000","00","040","0008","1140","528","259","269","4","532","1436","0","37.05","18.04"
"68","000","00","040","0009","0000","794","461","333","8","802","1933","0","41.49","23.85"
"68","000","00","040","0009","1108","380","237","143","2","382","904","0","42.26","26.22"
"68","000","00","040","0009","1109","414","224","190","6","420","1029","0","40.82","21.77"
"68","000","00","040","0010","0000","1430","876","554","14","1444","3487","0","41.41","25.12"
"68","000","00","040","0010","1100","732","451","281","7","739","1782","0","41.47","25.31"
"68","000","00","040","0010","1101","698","425","273","7","705","1705","0","41.35","24.93"
"68","000","00","040","0011","0000","656","317","339","14","670","1355","0","49.45","23.39"
"68","000","00","040","0011","1063","656","317","339","14","670","1355","0","49.45","23.39"
"68","000","00","040","0012","0000","565","400","165","8","573","1396","0","41.05","28.65"
"68","000","00","040","0012","1066","565","400","165","8","573","1396","0","41.05","28.65"
"68","000","00","040","0013","0000","2153","1183","970","18","2171","5757","0","37.71","20.55"
"68","000","00","040","0013","1072","645","329","316","5","650","1648","0","39.44","19.96"
"68","000","00","040","0013","1073","466","252","214","5","471","1349","0","34.91","18.68"
"68","000","00","040","0013","1074","512","291","221","3","515","1460","0","35.27","19.93"
"68","000","00","040","0013","1075","530","311","219","5","535","1300","0","41.15","23.92"
"68","000","00","040","0014","0000","1900","1163","737","18","1918","4609","0","41.61","25.23"
"68","000","00","040","0014","1067","691","407","284","5","696","1679","0","41.45","24.24"
"68","000","00","040","0014","1068","639","411","228","5","644","1487","0","43.31","27.64"
"68","000","00","040","0014","1069","570","345","225","8","578","1443","0","40.06","23.91"
"68","000","00","040","0015","0000","1460","866","594","11","1471","4143","0","35.51","20.90"
"68","000","00","040","0015","1080","525","306","219","3","528","1416","0","37.29","21.61"
"68","000","00","040","0015","1081","484","272","212","6","490","1379","0","35.53","19.72"
"68","000","00","040","0015","1082","451","288","163","2","453","1348","0","33.61","21.36"
"68","000","00","040","0016","0000","1251","751","500","11","1262","3760","0","33.56","19.97"
"68","000","00","040","0016","1141","408","258","150","4","412","1198","0","34.39","21.54"
"68","000","00","040","0016","1142","399","226","173","4","403","1287","0","31.31","17.56"
"68","000","00","040","0016","1143","444","267","177","3","447","1275","0","35.06","20.94"
"68","000","00","040","0017","0000","1372","665","707","15","1387","3518","0","39.43","18.90"
"68","000","00","040","0017","1149","716","323","393","7","723","1721","0","42.01","18.77"
"68","000","00","040","0017","1150","656","342","314","8","664","1797","0","36.95","19.03"
"68","000","00","040","0018","0000","1653","961","692","15","1668","3818","0","43.69","25.17"
"68","000","00","040","0018","1060","514","294","220","6","520","1214","0","42.83","24.22"
"68","000","00","040","0018","1061","625","345","280","3","628","1331","0","47.18","25.92"
"68","000","00","040","0018","1062","514","322","192","6","520","1273","0","40.85","25.29"
"68","000","00","040","0019","0000","1305","824","481","17","1322","3153","0","41.93","26.13"
"68","000","00","040","0019","1064","634","417","217","6","640","1522","0","42.05","27.40"
"68","000","00","040","0019","1065","671","407","264","11","682","1631","0","41.81","24.95"
"68","000","00","040","0020","0000","697","404","293","6","703","1787","0","39.34","22.61"
"68","000","00","040","0020","1125","358","216","142","3","361","929","0","38.86","23.25"
"68","000","00","040","0020","1126","339","188","151","3","342","858","0","39.86","21.91"
"68","000","00","040","0021","0000","1457","798","659","10","1467","3873","0","37.88","20.60"
"68","000","00","040","0021","1122","529","299","230","4","533","1290","0","41.32","23.18"
"68","000","00","040","0021","1123","445","259","186","3","448","1244","0","36.01","20.82"
"68","000","00","040","0021","1124","483","240","243","3","486","1339","0","36.30","17.92"
"68","000","00","040","0022","0000","1048","564","484","22","1070","2859","0","37.43","19.73"
"68","000","00","040","0022","1129","570","305","265","12","582","1616","0","36.01","18.87"
"68","000","00","040","0022","1130","478","259","219","10","488","1243","0","39.26","20.84"
"68","000","00","040","0023","0000","1186","663","523","23","1209","3757","0","32.18","17.65"
"68","000","00","040","0023","1158","426","224","202","9","435","1251","0","34.77","17.91"
"68","000","00","040","0023","1159","380","236","144","9","389","1192","0","32.63","19.80"
"68","000","00","040","0023","1160","380","203","177","5","385","1314","0","29.30","15.45"
"68","000","00","040","0024","0000","974","497","477","3","977","2794","0","34.97","17.79"
"68","000","00","040","0024","1131","457","251","206","3","460","1335","0","34.46","18.80"
"68","000","00","040","0024","1132","517","246","271","0","517","1459","0","35.44","16.86"
"68","000","00","040","0025","0000","1952","1109","843","16","1968","5853","0","33.62","18.95"
"68","000","00","040","0025","1135","572","307","265","6","578","1606","0","35.99","19.12"
"68","000","00","040","0025","1136","510","259","251","3","513","1456","0","35.23","17.79"
"68","000","00","040","0025","1137","439","269","170","1","440","1404","0","31.34","19.16"
"68","000","00","040","0025","1138","431","274","157","6","437","1387","0","31.51","19.75"
"68","000","00","040","0026","0000","1209","720","489","6","1215","2986","0","40.69","24.11"
"68","000","00","040","0026","1102","695","423","272","5","700","1687","0","41.49","25.07"
"68","000","00","040","0026","1103","514","297","217","1","515","1299","0","39.65","22.86"
"68","000","00","040","0027","0000","2749","1603","1146","15","2764","7742","0","35.70","20.71"
"68","000","00","040","0027","1091","547","347","200","4","551","1482","0","37.18","23.41"
"68","000","00","040","0027","1092","590","335","255","3","593","1483","0","39.99","22.59"
"68","000","00","040","0027","1093","513","304","209","1","514","1499","0","34.29","20.28"
"68","000","00","040","0027","1094","604","364","240","5","609","1727","0","35.26","21.08"
"68","000","00","040","0027","1095","495","253","242","2","497","1551","0","32.04","16.31"
"68","000","00","040","0028","0000","1644","1037","607","19","1663","4048","0","41.08","25.62"
"68","000","00","040","0028","1086","421","262","159","6","427","1406","0","30.37","18.63"
"68","000","00","040","0028","1087","622","384","238","8","630","1270","0","49.61","30.24"
"68","000","00","040","0028","1088","601","391","210","5","606","1372","0","44.17","28.50"
"68","000","00","040","0029","0000","1479","898","581","11","1490","3286","0","45.34","27.33"
"68","000","00","040","0029","1096","745","469","276","2","747","1612","0","46.34","29.09"
"68","000","00","040","0029","1097","734","429","305","9","743","1674","0","44.38","25.63"
"68","000","00","040","0030","0000","1328","702","626","16","1344","3311","0","40.59","21.20"
"68","000","00","040","0030","1118","703","362","341","10","713","1669","0","42.72","21.69"
"68","000","00","040","0030","1119","625","340","285","6","631","1642","0","38.43","20.71"
"68","000","00","040","0031","0000","1430","865","565","11","1441","4482","0","32.15","19.30"
"68","000","00","040","0031","1146","469","288","181","7","476","1506","0","31.61","19.12"
"68","000","00","040","0031","1147","487","274","213","3","490","1537","0","31.88","17.83"
"68","000","00","040","0031","1148","474","303","171","1","475","1439","0","33.01","21.06"
"68","000","00","040","0032","0000","1420","730","690","13","1433","3453","0","41.50","21.14"
"68","000","00","040","0032","1153","762","384","378","6","768","1740","0","44.14","22.07"
"68","000","00","040","0032","1154","658","346","312","7","665","1713","0","38.82","20.20"
"68","000","00","040","0033","0000","1415","732","683","14","1429","3233","0","44.20","22.64"
"68","000","00","040","0033","1151","727","410","317","8","735","1620","0","45.37","25.31"
"68","000","00","040","0033","1152","688","322","366","6","694","1613","0","43.03","19.96"
"68","000","00","040","0034","0000","2090","1272","818","14","2104","5934","0","35.46","21.44"
"68","000","00","040","0034","1076","540","356","184","3","543","1488","0","36.49","23.92"
"68","000","00","040","0034","1077","463","274","189","2","465","1445","0","32.18","18.96"
"68","000","00","040","0034","1078","539","288","251","5","544","1510","0","36.03","19.07"
"68","000","00","040","0034","1079","548","354","194","4","552","1491","0","37.02","23.74"
"68","000","00","040","0035","0000","742","441","301","7","749","1966","0","38.10","22.43"
"68","000","00","040","0035","1070","269","159","110","1","270","870","0","31.03","18.28"
"68","000","00","040","0035","1071","473","282","191","6","479","1096","0","43.70","25.73"
"68","000","00","040","0036","0000","1183","704","479","10","1193","3639","0","32.78","19.35"
"68","000","00","040","0036","1083","388","227","161","2","390","1309","0","29.79","17.34"
"68","000","00","040","0036","1084","458","283","175","4","462","1200","0","38.50","23.58"
"68","000","00","040","0036","1085","337","194","143","4","341","1130","0","30.18","17.17"
"68","000","00","040","0037","0000","971","510","461","8","979","2766","0","35.39","18.44"
"68","000","00","040","0037","1144","489","232","257","4","493","1442","0","34.19","16.09"
"68","000","00","040","0037","1145","482","278","204","4","486","1324","0","36.71","21.00"
"68","000","00","040","0038","0000","1024","537","487","9","1033","3030","0","34.09","17.72"
"68","000","00","040","0038","1127","502","236","266","5","507","1453","0","34.89","16.24"
"68","000","00","040","0038","1128","522","301","221","4","526","1577","0","33.35","19.09"
"68","000","00","040","0039","0000","853","543","310","2","855","2486","0","34.39","21.84"
"68","000","00","040","0039","1098","371","247","124","1","372","1277","0","29.13","19.34"
"68","000","00","040","0039","1099","482","296","186","1","483","1209","0","39.95","24.48"
"68","000","00","040","0040","0000","1196","725","471","5","1201","3449","0","34.82","21.02"
"68","000","00","040","0040","1089","639","390","249","2","641","1681","0","38.13","23.20"
"68","000","00","040","0040","1090","557","335","222","3","560","1768","0","31.67","18.95"
"68","000","00","040","0041","0000","1021","589","432","9","1030","2900","0","35.52","20.31"
"68","000","00","040","0041","1133","521","328","193","4","525","1315","0","39.92","24.94"
"68","000","00","040","0041","1134","500","261","239","5","505","1585","0","31.86","16.47"
"68","000","00","050","0000","0000","52596","24570","28026","459","53055","133965","166690","39.60","18.34"
"68","000","00","050","0001","0000","1244","420","824","14","1258","2950","0","42.64","14.24"
"68","000","00","050","0001","0463","673","237","436","6","679","1566","0","43.36","15.13"
"68","000","00","050","0001","0464","571","183","388","8","579","1384","0","41.84","13.22"
"68","000","00","050","0002","0000","1651","590","1061","17","1668","4062","0","41.06","14.52"
"68","000","00","050","0002","0465","590","209","381","5","595","1441","0","41.29","14.50"
"68","000","00","050","0002","0466","532","194","338","10","542","1358","0","39.91","14.29"
"68","000","00","050","0002","0467","529","187","342","2","531","1263","0","42.04","14.81"
"68","000","00","050","0003","0000","1992","830","1162","18","2010","5043","0","39.86","16.46"
"68","000","00","050","0003","0473","657","282","375","3","660","1683","0","39.22","16.76"
"68","000","00","050","0003","0474","445","174","271","5","450","1172","0","38.40","14.85"
"68","000","00","050","0003","0475","435","163","272","4","439","1103","0","39.80","14.78"
"68","000","00","050","0003","0476","455","211","244","6","461","1085","0","42.49","19.45"
"68","000","00","050","0004","0000","1934","918","1016","16","1950","4969","0","39.24","18.47"
"68","000","00","050","0004","0482","674","311","363","9","683","1733","0","39.41","17.95"
"68","000","00","050","0004","0483","599","290","309","3","602","1657","0","36.33","17.50"
"68","000","00","050","0004","0484","661","317","344","4","665","1579","0","42.12","20.08"
"68","000","00","050","0006","0000","1573","564","1009","15","1588","4036","0","39.35","13.97"
"68","000","00","050","0006","0486","451","142","309","7","458","1238","0","37.00","11.47"
"68","000","00","050","0006","0487","562","195","367","2","564","1366","0","41.29","14.28"
"68","000","00","050","0006","0488","560","227","333","6","566","1432","0","39.53","15.85"
"68","000","00","050","0007","0000","1536","747","789","13","1549","3675","0","42.15","20.33"
"68","000","00","050","0007","0507","524","248","276","2","526","1152","0","45.66","21.53"
"68","000","00","050","0007","0508","547","251","296","5","552","1361","0","40.56","18.44"
"68","000","00","050","0007","0509","465","248","217","6","471","1162","0","40.53","21.34"
"68","000","00","050","0008","0000","1612","771","841","8","1620","3906","0","41.47","19.74"
"68","000","00","050","0008","0510","565","250","315","7","572","1344","0","42.56","18.60"
"68","000","00","050","0008","0511","468","210","258","1","469","1152","0","40.71","18.23"
"68","000","00","050","0008","0512","579","311","268","0","579","1410","0","41.06","22.06"
"68","000","00","050","0009","0000","1019","527","492","7","1026","2425","0","42.31","21.73"
"68","000","00","050","0009","0519","578","294","284","3","581","1215","0","47.82","24.20"
"68","000","00","050","0009","0520","441","233","208","4","445","1210","0","36.78","19.26"
"68","000","00","050","0010","0000","917","333","584","7","924","2595","0","35.61","12.83"
"68","000","00","050","0010","0542","379","145","234","1","380","1343","0","28.29","10.80"
"68","000","00","050","0010","0543","538","188","350","6","544","1252","0","43.45","15.02"
"68","000","00","050","0011","0000","595","242","353","8","603","1778","0","33.91","13.61"
"68","000","00","050","0011","0544","595","242","353","8","603","1778","0","33.91","13.61"
"68","000","00","050","0012","0000","1309","454","855","18","1327","3579","0","37.08","12.69"
"68","000","00","050","0012","0545","442","161","281","7","449","1192","0","37.67","13.51"
"68","000","00","050","0012","0546","461","156","305","7","468","1218","0","38.42","12.81"
"68","000","00","050","0012","0547","406","137","269","4","410","1169","0","35.07","11.72"
"68","000","00","050","0013","0000","619","156","463","11","630","1486","0","42.40","10.50"
"68","000","00","050","0013","0548","619","156","463","11","630","1486","0","42.40","10.50"
"68","000","00","050","0014","0000","616","175","441","8","624","1673","0","37.30","10.46"
"68","000","00","050","0014","0549","616","175","441","8","624","1673","0","37.30","10.46"
"68","000","00","050","0015","0000","979","349","630","6","985","2501","0","39.38","13.95"
"68","000","00","050","0015","0550","530","181","349","4","534","1310","0","40.76","13.82"
"68","000","00","050","0015","0551","449","168","281","2","451","1191","0","37.87","14.11"
"68","000","00","050","0016","0000","927","439","488","12","939","2969","0","31.63","14.79"
"68","000","00","050","0016","0552","439","219","220","6","445","1485","0","29.97","14.75"
"68","000","00","050","0016","0553","488","220","268","6","494","1484","0","33.29","14.82"
"68","000","00","050","0017","0000","1526","723","803","15","1541","3532","0","43.63","20.47"
"68","000","00","050","0017","0505","832","370","462","9","841","1881","0","44.71","19.67"
"68","000","00","050","0017","0506","694","353","341","6","700","1651","0","42.40","21.38"
"68","000","00","050","0018","0000","2191","1167","1024","13","2204","5162","0","42.70","22.61"
"68","000","00","050","0018","0489","484","266","218","5","489","1167","0","41.90","22.79"
"68","000","00","050","0018","0490","640","351","289","4","644","1347","0","47.81","26.06"
"68","000","00","050","0018","0491","519","265","254","2","521","1279","0","40.73","20.72"
"68","000","00","050","0018","0492","548","285","263","2","550","1369","0","40.18","20.82"
"68","000","00","050","0019","0000","863","405","458","6","869","2582","0","33.66","15.69"
"68","000","00","050","0019","0517","425","187","238","5","430","1148","0","37.46","16.29"
"68","000","00","050","0019","0518","438","218","220","1","439","1434","0","30.61","15.20"
"68","000","00","050","0020","0000","1325","616","709","9","1334","3128","0","42.65","19.69"
"68","000","00","050","0020","0513","626","242","384","3","629","1471","0","42.76","16.45"
"68","000","00","050","0020","0516","699","374","325","6","705","1657","0","42.55","22.57"
"68","000","00","050","0021","0000","575","146","429","6","581","1327","0","43.78","11.00"
"68","000","00","050","0021","0485","575","146","429","6","581","1327","0","43.78","11.00"
"68","000","00","050","0022","0000","1428","636","792","12","1440","3516","0","40.96","18.09"
"68","000","00","050","0022","0477","462","195","267","1","463","1181","0","39.20","16.51"
"68","000","00","050","0022","0478","717","319","398","6","723","1717","0","42.11","18.58"
"68","000","00","050","0022","0479","249","122","127","5","254","618","0","41.10","19.74"
"68","000","00","050","0023","0000","1159","471","688","20","1179","2982","0","39.54","15.79"
"68","000","00","050","0023","0480","626","242","384","9","635","1534","0","41.40","15.78"
"68","000","00","050","0023","0481","533","229","304","11","544","1448","0","37.57","15.81"
"68","000","00","050","0024","0000","1276","703","573","14","1290","3360","0","38.39","20.92"
"68","000","00","050","0024","0540","627","306","321","5","632","1645","0","38.42","18.60"
"68","000","00","050","0024","0541","649","397","252","9","658","1715","0","38.37","23.15"
"68","000","00","050","0025","0000","1934","1033","901","20","1954","4886","0","39.99","21.14"
"68","000","00","050","0025","0535","620","327","293","6","626","1506","0","41.57","21.71"
"68","000","00","050","0025","0536","700","410","290","5","705","1732","0","40.70","23.67"
"68","000","00","050","0025","0537","614","296","318","9","623","1648","0","37.80","17.96"
"68","000","00","050","0026","0000","1911","955","956","17","1928","4459","0","43.24","21.42"
"68","000","00","050","0026","0525","709","350","359","6","715","1624","0","44.03","21.55"
"68","000","00","050","0026","0526","638","328","310","6","644","1503","0","42.85","21.82"
"68","000","00","050","0026","0527","564","277","287","5","569","1332","0","42.72","20.80"
"68","000","00","050","0027","0000","1518","765","753","6","1524","3985","0","38.24","19.20"
"68","000","00","050","0027","0501","549","271","278","1","550","1579","0","34.83","17.16"
"68","000","00","050","0027","0502","442","208","234","2","444","1153","0","38.51","18.04"
"68","000","00","050","0027","0503","527","286","241","3","530","1253","0","42.30","22.83"
"68","000","00","050","0028","0000","1960","1095","865","13","1973","5062","0","38.98","21.63"
"68","000","00","050","0028","0493","668","385","283","3","671","1820","0","36.87","21.15"
"68","000","00","050","0028","0494","620","338","282","5","625","1628","0","38.39","20.76"
"68","000","00","050","0028","0495","672","372","300","5","677","1614","0","41.95","23.05"
"68","000","00","050","0029","0000","1346","692","654","12","1358","3442","0","39.45","20.10"
"68","000","00","050","0029","0496","671","350","321","5","676","1683","0","40.17","20.80"
"68","000","00","050","0029","0497","675","342","333","7","682","1759","0","38.77","19.44"
"68","000","00","050","0030","0000","593","255","338","8","601","1633","0","36.80","15.62"
"68","000","00","050","0030","0504","593","255","338","8","601","1633","0","36.80","15.62"
"68","000","00","050","0031","0000","2343","1289","1054","17","2360","5584","0","42.26","23.08"
"68","000","00","050","0031","0531","647","349","298","4","651","1522","0","42.77","22.93"
"68","000","00","050","0031","0532","525","307","218","8","533","1314","0","40.56","23.36"
"68","000","00","050","0031","0533","562","288","274","3","565","1352","0","41.79","21.30"
"68","000","00","050","0031","0534","609","345","264","2","611","1396","0","43.77","24.71"
"68","000","00","050","0032","0000","1757","968","789","14","1771","3690","0","47.99","26.23"
"68","000","00","050","0032","0528","572","306","266","7","579","1190","0","48.66","25.71"
"68","000","00","050","0032","0529","685","397","288","5","690","1245","0","55.42","31.89"
"68","000","00","050","0032","0530","500","265","235","2","502","1255","0","40.00","21.12"
"68","000","00","050","0033","0000","1224","649","575","12","1236","3243","0","38.11","20.01"
"68","000","00","050","0033","0521","658","351","307","8","666","1711","0","38.92","20.51"
"68","000","00","050","0033","0522","566","298","268","4","570","1532","0","37.21","19.45"
"68","000","00","050","0034","0000","1175","571","604","9","1184","3227","0","36.69","17.69"
"68","000","00","050","0034","0523","579","270","309","6","585","1535","0","38.11","17.59"
"68","000","00","050","0034","0524","596","301","295","3","599","1692","0","35.40","17.79"
"68","000","00","050","0035","0000","1231","648","583","9","1240","2793","0","44.40","23.20"
"68","000","00","050","0035","0514","605","313","292","6","611","1423","0","42.94","22.00"
"68","000","00","050","0035","0515","626","335","291","3","629","1370","0","45.91","24.45"
"68","000","00","050","0036","0000","1815","912","903","10","1825","5074","0","35.97","17.97"
"68","000","00","050","0036","0470","603","308","295","2","605","1498","0","40.39","20.56"
"68","000","00","050","0036","0471","581","291","290","4","585","1805","0","32.41","16.12"
"68","000","00","050","0036","0472","631","313","318","4","635","1771","0","35.86","17.67"
"68","000","00","050","0037","0000","1372","655","717","7","1379","3380","0","40.80","19.38"
"68","000","00","050","0037","0468","658","283","375","3","661","1591","0","41.55","17.79"
"68","000","00","050","0037","0469","714","372","342","4","718","1789","0","40.13","20.79"
"68","000","00","050","0038","0000","1280","658","622","11","1291","3296","0","39.17","19.96"
"68","000","00","050","0038","0538","598","297","301","3","601","1597","0","37.63","18.60"
"68","000","00","050","0038","0539","682","361","321","8","690","1699","0","40.61","21.25"
"68","000","00","050","0039","0000","1514","705","809","6","1520","4443","0","34.21","15.87"
"68","000","00","050","0039","0498","496","217","279","1","497","1512","0","32.87","14.35"
"68","000","00","050","0039","0499","578","265","313","3","581","1576","0","36.87","16.81"
"68","000","00","050","0039","0500","440","223","217","2","442","1355","0","32.62","16.46"
"68","000","00","050","0040","0000","757","338","419","15","772","2532","0","30.49","13.35"
"68","000","00","050","0040","0554","360","167","193","7","367","1210","0","30.33","13.80"
"68","000","00","050","0040","0555","397","171","226","8","405","1322","0","30.64","12.93"
"68","000","00","060","0000","0000","27887","12481","15406","254","28141","77353","93663","36.38","16.14"
"68","000","00","060","0001","0000","2341","1066","1275","16","2357","6107","0","38.60","17.46"
"68","000","00","060","0001","0556","617","315","302","6","623","1523","0","40.91","20.68"
"68","000","00","060","0001","0557","530","257","273","2","532","1639","0","32.46","15.68"
"68","000","00","060","0001","0558","555","226","329","2","557","1405","0","39.64","16.09"
"68","000","00","060","0001","0559","639","268","371","6","645","1540","0","41.88","17.40"
"68","000","00","060","0002","0000","2512","1087","1425","25","2537","6972","0","36.39","15.59"
"68","000","00","060","0002","0560","465","177","288","8","473","1233","0","38.36","14.36"
"68","000","00","060","0002","0561","548","242","306","8","556","1503","0","36.99","16.10"
"68","000","00","060","0002","0562","457","204","253","1","458","1312","0","34.91","15.55"
"68","000","00","060","0002","0563","524","243","281","5","529","1462","0","36.18","16.62"
"68","000","00","060","0002","0564","518","221","297","3","521","1462","0","35.64","15.12"
"68","000","00","060","0003","0000","1472","625","847","18","1490","4705","0","31.67","13.28"
"68","000","00","060","0003","0565","489","226","263","5","494","1601","0","30.86","14.12"
"68","000","00","060","0003","0566","472","180","292","7","479","1438","0","33.31","12.52"
"68","000","00","060","0003","0567","511","219","292","6","517","1666","0","31.03","13.15"
"68","000","00","060","0004","0000","642","230","412","4","646","1612","0","40.07","14.27"
"68","000","00","060","0004","0568","642","230","412","4","646","1612","0","40.07","14.27"
"68","000","00","060","0005","0000","4553","2179","2374","50","4603","11610","0","39.65","18.77"
"68","000","00","060","0005","0569","476","196","280","5","481","1434","0","33.54","13.67"
"68","000","00","060","0005","0570","480","220","260","3","483","1352","0","35.72","16.27"
"68","000","00","060","0005","0571","513","247","266","11","524","1488","0","35.22","16.60"
"68","000","00","060","0005","0572","741","281","460","9","750","1630","0","46.01","17.24"
"68","000","00","060","0005","0573","658","328","330","10","668","1450","0","46.07","22.62"
"68","000","00","060","0005","0574","596","330","266","4","600","1462","0","41.04","22.57"
"68","000","00","060","0005","0575","593","335","258","2","595","1443","0","41.23","23.22"
"68","000","00","060","0005","0576","496","242","254","6","502","1351","0","37.16","17.91"
"68","000","00","060","0006","0000","1983","703","1280","15","1998","5222","0","38.26","13.46"
"68","000","00","060","0006","0577","602","190","412","4","606","1412","0","42.92","13.46"
"68","000","00","060","0006","0578","547","188","359","2","549","1417","0","38.74","13.27"
"68","000","00","060","0006","0579","514","174","340","5","519","1488","0","34.88","11.69"
"68","000","00","060","0006","0580","320","151","169","4","324","905","0","35.80","16.69"
"68","000","00","060","0007","0000","2155","914","1241","13","2168","5896","0","36.77","15.50"
"68","000","00","060","0007","0581","532","234","298","4","536","1496","0","35.83","15.64"
"68","000","00","060","0007","0582","507","244","263","2","509","1434","0","35.50","17.02"
"68","000","00","060","0007","0583","569","261","308","2","571","1555","0","36.72","16.78"
"68","000","00","060","0007","0584","547","175","372","5","552","1411","0","39.12","12.40"
"68","000","00","060","0008","0000","654","358","296","8","662","1650","0","40.12","21.70"
"68","000","00","060","0008","0585","654","358","296","8","662","1650","0","40.12","21.70"
"68","000","00","060","0010","0000","1202","506","696","13","1215","2851","0","42.62","17.75"
"68","000","00","060","0010","0586","545","206","339","5","550","1446","0","38.04","14.25"
"68","000","00","060","0010","0587","657","300","357","8","665","1405","0","47.33","21.35"
"68","000","00","060","0011","0000","2489","1120","1369","26","2515","7202","0","34.92","15.55"
"68","000","00","060","0011","0588","530","210","320","9","539","1454","0","37.07","14.44"
"68","000","00","060","0011","0589","512","225","287","7","519","1396","0","37.18","16.12"
"68","000","00","060","0011","0590","503","243","260","3","506","1531","0","33.05","15.87"
"68","000","00","060","0011","0591","515","254","261","3","518","1598","0","32.42","15.89"
"68","000","00","060","0011","0592","429","188","241","4","433","1223","0","35.40","15.37"
"68","000","00","060","0012","0000","1193","567","626","7","1200","3212","0","37.36","17.65"
"68","000","00","060","0012","0593","589","270","319","4","593","1638","0","36.20","16.48"
"68","000","00","060","0012","0594","604","297","307","3","607","1574","0","38.56","18.87"
"68","000","00","060","0013","0000","602","318","284","5","607","1863","0","32.58","17.07"
"68","000","00","060","0013","0595","314","165","149","2","316","904","0","34.96","18.25"
"68","000","00","060","0013","0596","288","153","135","3","291","959","0","30.34","15.95"
"68","000","00","060","0014","0000","878","506","372","11","889","2595","0","34.26","19.50"
"68","000","00","060","0014","0597","363","180","183","5","368","1174","0","31.35","15.33"
"68","000","00","060","0014","0598","515","326","189","6","521","1421","0","36.66","22.94"
"68","000","00","060","0015","0000","817","373","444","5","822","2523","0","32.58","14.78"
"68","000","00","060","0015","0599","438","200","238","3","441","1277","0","34.53","15.66"
"68","000","00","060","0015","0600","379","173","206","2","381","1246","0","30.58","13.88"
"68","000","00","060","0016","0000","945","399","546","9","954","2566","0","37.18","15.55"
"68","000","00","060","0016","0601","444","210","234","4","448","1224","0","36.60","17.16"
"68","000","00","060","0016","0602","501","189","312","5","506","1342","0","37.70","14.08"
"68","000","00","060","0017","0000","757","309","448","5","762","2154","0","35.38","14.35"
"68","000","00","060","0017","0603","391","156","235","2","393","1095","0","35.89","14.25"
"68","000","00","060","0017","0604","366","153","213","3","369","1059","0","34.84","14.45"
"68","000","00","060","0018","0000","955","371","584","15","970","2912","0","33.31","12.74"
"68","000","00","060","0018","0605","507","179","328","8","515","1343","0","38.35","13.33"
"68","000","00","060","0018","0606","448","192","256","7","455","1569","0","29.00","12.24"
"68","000","00","060","0019","0000","1737","850","887","9","1746","5701","0","30.63","14.91"
"68","000","00","060","0019","0607","442","213","229","4","446","1557","0","28.64","13.68"
"68","000","00","060","0019","0608","473","232","241","1","474","1587","0","29.87","14.62"
"68","000","00","060","0019","0609","511","235","276","1","512","1496","0","34.22","15.71"
"68","000","00","060","0019","0610","311","170","141","3","314","1061","0","29.59","16.02"
"68","000","00","070","0000","0000","54030","27495","26535","529","54559","138592","165716","39.37","19.84"
"68","000","00","070","0001","0000","1700","757","943","11","1711","3984","0","42.95","19.00"
"68","000","00","070","0001","0318","550","274","276","5","555","1269","0","43.74","21.59"
"68","000","00","070","0001","0319","490","167","323","5","495","1186","0","41.74","14.08"
"68","000","00","070","0001","0320","660","316","344","1","661","1529","0","43.23","20.67"
"68","000","00","070","0002","0000","2587","1275","1312","18","2605","6579","0","39.60","19.38"
"68","000","00","070","0002","0332","505","264","241","3","508","1129","0","45.00","23.38"
"68","000","00","070","0002","0333","525","266","259","3","528","1252","0","42.17","21.25"
"68","000","00","070","0002","0334","631","267","364","3","634","1480","0","42.84","18.04"
"68","000","00","070","0002","0335","455","257","198","3","458","1378","0","33.24","18.65"
"68","000","00","070","0002","0336","471","221","250","6","477","1340","0","35.60","16.49"
"68","000","00","070","0003","0000","1559","737","822","12","1571","4492","0","34.97","16.41"
"68","000","00","070","0003","0288","353","149","204","4","357","823","0","43.38","18.10"
"68","000","00","070","0003","0289","427","216","211","2","429","1282","0","33.46","16.85"
"68","000","00","070","0003","0290","373","191","182","2","375","1197","0","31.33","15.96"
"68","000","00","070","0003","0291","406","181","225","4","410","1190","0","34.45","15.21"
"68","000","00","070","0004","0000","2221","1112","1109","17","2238","5834","0","38.36","19.06"
"68","000","00","070","0004","0249","582","303","279","3","585","1562","0","37.45","19.40"
"68","000","00","070","0004","0250","570","290","280","5","575","1423","0","40.41","20.38"
"68","000","00","070","0004","0251","556","236","320","8","564","1645","0","34.29","14.35"
"68","000","00","070","0004","0252","513","283","230","1","514","1204","0","42.69","23.50"
"68","000","00","070","0005","0000","1262","619","643","19","1281","3262","0","39.27","18.98"
"68","000","00","070","0005","0270","731","357","374","7","738","1853","0","39.83","19.27"
"68","000","00","070","0005","0271","531","262","269","12","543","1409","0","38.54","18.59"
"68","000","00","070","0006","0000","1958","1002","956","17","1975","5439","0","36.31","18.42"
"68","000","00","070","0006","0267","621","306","315","3","624","1732","0","36.03","17.67"
"68","000","00","070","0006","0268","614","293","321","8","622","1922","0","32.36","15.24"
"68","000","00","070","0006","0269","723","403","320","6","729","1785","0","40.84","22.58"
"68","000","00","070","0007","0000","1771","1544","227","30","1801","3606","0","49.94","42.82"
"68","000","00","070","0007","0305","894","782","112","13","907","1738","0","52.19","44.99"
"68","000","00","070","0007","0306","877","762","115","17","894","1868","0","47.86","40.79"
"68","000","00","070","0008","0000","2149","1436","713","34","2183","5179","0","42.15","27.73"
"68","000","00","070","0008","0323","783","655","128","11","794","1616","0","49.13","40.53"
"68","000","00","070","0008","0324","664","429","235","16","680","1717","0","39.60","24.99"
"68","000","00","070","0008","0325","702","352","350","7","709","1846","0","38.41","19.07"
"68","000","00","070","0009","0000","627","286","341","6","633","1298","0","48.77","22.03"
"68","000","00","070","0009","0278","627","286","341","6","633","1298","0","48.77","22.03"
"68","000","00","070","0010","0000","1922","855","1067","14","1936","5523","0","35.05","15.48"
"68","000","00","070","0010","0326","767","338","429","7","774","2261","0","34.23","14.95"
"68","000","00","070","0010","0327","513","219","294","3","516","1546","0","33.38","14.17"
"68","000","00","070","0010","0328","642","298","344","4","646","1716","0","37.65","17.37"
"68","000","00","070","0011","0000","793","338","455","7","800","1874","0","42.69","18.04"
"68","000","00","070","0011","0298","793","338","455","7","800","1874","0","42.69","18.04"
"68","000","00","070","0012","0000","728","343","385","4","732","1975","0","37.06","17.37"
"68","000","00","070","0012","0253","356","196","160","2","358","983","0","36.42","19.94"
"68","000","00","070","0012","0254","372","147","225","2","374","992","0","37.70","14.82"
"68","000","00","070","0013","0000","1792","994","798","20","1812","4708","0","38.49","21.11"
"68","000","00","070","0013","0275","548","304","244","9","557","1612","0","34.55","18.86"
"68","000","00","070","0013","0276","681","328","353","7","688","1651","0","41.67","19.87"
"68","000","00","070","0013","0277","563","362","201","4","567","1445","0","39.24","25.05"
"68","000","00","070","0014","0000","1982","910","1072","18","2000","4790","0","41.75","19.00"
"68","000","00","070","0014","0272","675","313","362","7","682","1651","0","41.31","18.96"
"68","000","00","070","0014","0273","631","283","348","7","638","1480","0","43.11","19.12"
"68","000","00","070","0014","0274","676","314","362","4","680","1659","0","40.99","18.93"
"68","000","00","070","0015","0000","2286","1100","1186","29","2315","5265","0","43.97","20.89"
"68","000","00","070","0015","0307","638","319","319","4","642","1449","0","44.31","22.02"
"68","000","00","070","0015","0308","459","207","252","10","469","1021","0","45.94","20.27"
"68","000","00","070","0015","0309","525","258","267","5","530","1403","0","37.78","18.39"
"68","000","00","070","0015","0310","664","316","348","10","674","1392","0","48.42","22.70"
"68","000","00","070","0016","0000","1507","685","822","19","1526","4034","0","37.83","16.98"
"68","000","00","070","0016","0337","475","203","272","6","481","1222","0","39.36","16.61"
"68","000","00","070","0016","0338","598","280","318","8","606","1491","0","40.64","18.78"
"68","000","00","070","0016","0339","434","202","232","5","439","1321","0","33.23","15.29"
"68","000","00","070","0017","0000","689","214","475","8","697","1760","0","39.60","12.16"
"68","000","00","070","0017","0331","689","214","475","8","697","1760","0","39.60","12.16"
"68","000","00","070","0018","0000","1144","567","577","17","1161","2636","0","44.04","21.51"
"68","000","00","070","0018","0340","715","413","302","8","723","1578","0","45.82","26.17"
"68","000","00","070","0018","0341","429","154","275","9","438","1058","0","41.40","14.56"
"68","000","00","070","0019","0000","1397","647","750","19","1416","4111","0","34.44","15.74"
"68","000","00","070","0019","0255","462","219","243","1","463","1378","0","33.60","15.89"
"68","000","00","070","0019","0256","539","235","304","7","546","1472","0","37.09","15.96"
"68","000","00","070","0019","0257","396","193","203","11","407","1261","0","32.28","15.31"
"68","000","00","070","0020","0000","2729","1330","1399","23","2752","6959","0","39.55","19.11"
"68","000","00","070","0020","0279","718","310","408","6","724","1788","0","40.49","17.34"
"68","000","00","070","0020","0280","671","335","336","4","675","1712","0","39.43","19.57"
"68","000","00","070","0020","0281","708","372","336","5","713","1734","0","41.12","21.45"
"68","000","00","070","0020","0282","632","313","319","8","640","1725","0","37.10","18.14"
"68","000","00","070","0021","0000","910","435","475","8","918","2303","0","39.86","18.89"
"68","000","00","070","0021","0299","416","176","240","2","418","1137","0","36.76","15.48"
"68","000","00","070","0021","0300","494","259","235","6","500","1166","0","42.88","22.21"
"68","000","00","070","0022","0000","1682","870","812","25","1707","5268","0","32.40","16.51"
"68","000","00","070","0022","0292","593","344","249","7","600","1794","0","33.44","19.18"
"68","000","00","070","0022","0293","501","238","263","9","510","1622","0","31.44","14.67"
"68","000","00","070","0022","0294","588","288","300","9","597","1852","0","32.24","15.55"
"68","000","00","070","0023","0000","783","403","380","9","792","1960","0","40.41","20.56"
"68","000","00","070","0023","0321","604","316","288","8","612","1459","0","41.95","21.66"
"68","000","00","070","0023","0322","179","87","92","1","180","501","0","35.93","17.37"
"68","000","00","070","0024","0000","1338","601","737","12","1350","3423","0","39.44","17.56"
"68","000","00","070","0024","0329","796","353","443","5","801","1893","0","42.31","18.65"
"68","000","00","070","0024","0330","542","248","294","7","549","1530","0","35.88","16.21"
"68","000","00","070","0025","0000","2342","1156","1186","27","2369","6098","0","38.85","18.96"
"68","000","00","070","0025","0301","754","350","404","14","768","1934","0","39.71","18.10"
"68","000","00","070","0025","0302","498","256","242","3","501","1362","0","36.78","18.80"
"68","000","00","070","0025","0303","535","273","262","3","538","1420","0","37.89","19.23"
"68","000","00","070","0025","0304","555","277","278","7","562","1382","0","40.67","20.04"
"68","000","00","070","0026","0000","1401","680","721","16","1417","3965","0","35.74","17.15"
"68","000","00","070","0026","0313","456","225","231","5","461","1201","0","38.38","18.73"
"68","000","00","070","0026","0314","340","191","149","7","347","987","0","35.16","19.35"
"68","000","00","070","0026","0315","605","264","341","4","609","1777","0","34.27","14.86"
"68","000","00","070","0027","0000","2046","1041","1005","10","2056","5410","0","38.00","19.24"
"68","000","00","070","0027","0258","648","317","331","5","653","1690","0","38.64","18.76"
"68","000","00","070","0027","0259","689","352","337","4","693","1854","0","37.38","18.99"
"68","000","00","070","0027","0260","709","372","337","1","710","1866","0","38.05","19.94"
"68","000","00","070","0028","0000","3528","1701","1827","25","3553","8945","0","39.72","19.02"
"68","000","00","070","0028","0261","557","258","299","5","562","1485","0","37.85","17.37"
"68","000","00","070","0028","0262","569","247","322","1","570","1387","0","41.10","17.81"
"68","000","00","070","0028","0263","653","347","306","5","658","1533","0","42.92","22.64"
"68","000","00","070","0028","0264","685","321","364","4","689","1675","0","41.13","19.16"
"68","000","00","070","0028","0265","521","235","286","3","524","1402","0","37.38","16.76"
"68","000","00","070","0028","0266","543","293","250","7","550","1463","0","37.59","20.03"
"68","000","00","070","0029","0000","1768","801","967","11","1779","4161","0","42.75","19.25"
"68","000","00","070","0029","0295","553","248","305","6","559","1426","0","39.20","17.39"
"68","000","00","070","0029","0296","562","249","313","3","565","1412","0","40.01","17.63"
"68","000","00","070","0029","0297","653","304","349","2","655","1323","0","49.51","22.98"
"68","000","00","070","0030","0000","928","602","326","14","942","3071","0","30.67","19.60"
"68","000","00","070","0030","0311","689","491","198","14","703","1528","0","46.01","32.13"
"68","000","00","070","0030","0312","239","111","128","0","239","1543","0","15.49","7.19"
"68","000","00","070","0031","0000","3128","1751","1377","22","3150","7571","0","41.61","23.13"
"68","000","00","070","0031","0283","603","318","285","7","610","1352","0","45.12","23.52"
"68","000","00","070","0031","0284","771","412","359","6","777","1899","0","40.92","21.70"
"68","000","00","070","0031","0285","513","298","215","4","517","1304","0","39.65","22.85"
"68","000","00","070","0031","0286","540","333","207","2","542","1365","0","39.71","24.40"
"68","000","00","070","0031","0287","701","390","311","3","704","1651","0","42.64","23.62"
"68","000","00","070","0032","0000","1373","703","670","8","1381","3109","0","44.42","22.61"
"68","000","00","070","0032","0316","720","373","347","4","724","1633","0","44.34","22.84"
"68","000","00","070","0032","0317","653","330","323","4","657","1476","0","44.51","22.36"
"68","000","00","080","0000","0000","67615","36243","31372","710","68325","172627","209448","39.58","20.99"
"68","000","00","080","0001","0000","2938","1571","1367","22","2960","9275","0","31.91","16.94"
"68","000","00","080","0001","0342","569","327","242","3","572","1693","0","33.79","19.31"
"68","000","00","080","0001","0343","565","295","270","7","572","1744","0","32.80","16.92"
"68","000","00","080","0001","0344","558","294","264","8","566","1597","0","35.44","18.41"
"68","000","00","080","0001","0345","521","288","233","1","522","1434","0","36.40","20.08"
"68","000","00","080","0001","0346","528","283","245","2","530","1402","0","37.80","20.19"
"68","000","00","080","0001","0347","197","84","113","1","198","1405","0","14.09","5.98"
"68","000","00","080","0002","0000","3358","1774","1584","33","3391","9960","0","34.05","17.81"
"68","000","00","080","0002","0348","596","306","290","7","603","1932","0","31.21","15.84"
"68","000","00","080","0002","0349","610","336","274","4","614","1941","0","31.63","17.31"
"68","000","00","080","0002","0350","660","344","316","9","669","1605","0","41.68","21.43"
"68","000","00","080","0002","0351","456","243","213","6","462","1536","0","30.08","15.82"
"68","000","00","080","0002","0352","564","315","249","5","569","1475","0","38.58","21.36"
"68","000","00","080","0002","0353","472","230","242","2","474","1471","0","32.22","15.64"
"68","000","00","080","0003","0000","1669","939","730","9","1678","4926","0","34.06","19.06"
"68","000","00","080","0003","0354","577","308","269","3","580","1519","0","38.18","20.28"
"68","000","00","080","0003","0355","629","358","271","2","631","1832","0","34.44","19.54"
"68","000","00","080","0003","0356","463","273","190","4","467","1575","0","29.65","17.33"
"68","000","00","080","0004","0000","1320","782","538","34","1354","3178","0","42.61","24.61"
"68","000","00","080","0004","0362","652","372","280","16","668","1582","0","42.23","23.51"
"68","000","00","080","0004","0363","668","410","258","18","686","1596","0","42.98","25.69"
"68","000","00","080","0005","0000","1343","839","504","25","1368","3521","0","38.85","23.83"
"68","000","00","080","0005","0364","688","423","265","16","704","1668","0","42.21","25.36"
"68","000","00","080","0005","0365","655","416","239","9","664","1853","0","35.83","22.45"
"68","000","00","080","0006","0000","1299","890","409","22","1321","3201","0","41.27","27.80"
"68","000","00","080","0006","0366","652","451","201","18","670","1588","0","42.19","28.40"
"68","000","00","080","0006","0367","647","439","208","4","651","1613","0","40.36","27.22"
"68","000","00","080","0007","0000","1268","594","674","8","1276","3233","0","39.47","18.37"
"68","000","00","080","0007","0370","643","307","336","5","648","1665","0","38.92","18.44"
"68","000","00","080","0007","0371","625","287","338","3","628","1568","0","40.05","18.30"
"68","000","00","080","0008","0000","1946","1078","868","19","1965","4536","0","43.32","23.77"
"68","000","00","080","0008","0372","775","462","313","12","787","1740","0","45.23","26.55"
"68","000","00","080","0008","0373","733","398","335","6","739","1776","0","41.61","22.41"
"68","000","00","080","0008","0374","438","218","220","1","439","1020","0","43.04","21.37"
"68","000","00","080","0009","0000","1257","641","616","11","1268","3596","0","35.26","17.83"
"68","000","00","080","0009","0375","636","310","326","7","643","1809","0","35.54","17.14"
"68","000","00","080","0009","0376","621","331","290","4","625","1787","0","34.97","18.52"
"68","000","00","080","0010","0000","822","405","417","14","836","2214","0","37.76","18.29"
"68","000","00","080","0010","0377","384","222","162","9","393","1091","0","36.02","20.35"
"68","000","00","080","0010","0378","438","183","255","5","443","1123","0","39.45","16.30"
"68","000","00","080","0011","0000","921","400","521","10","931","2537","0","36.70","15.77"
"68","000","00","080","0011","0384","472","210","262","5","477","1336","0","35.70","15.72"
"68","000","00","080","0011","0385","449","190","259","5","454","1201","0","37.80","15.82"
"68","000","00","080","0012","0000","1492","722","770","12","1504","3852","0","39.04","18.74"
"68","000","00","080","0012","0388","577","271","306","2","579","1366","0","42.39","19.84"
"68","000","00","080","0012","0389","409","202","207","7","416","1183","0","35.16","17.08"
"68","000","00","080","0012","0390","506","249","257","3","509","1303","0","39.06","19.11"
"68","000","00","080","0013","0000","1265","579","686","14","1279","3101","0","41.24","18.67"
"68","000","00","080","0013","0393","759","335","424","10","769","1902","0","40.43","17.61"
"68","000","00","080","0013","0394","506","244","262","4","510","1199","0","42.54","20.35"
"68","000","00","080","0014","0000","1471","660","811","12","1483","3930","0","37.74","16.79"
"68","000","00","080","0014","0395","588","269","319","2","590","1408","0","41.90","19.11"
"68","000","00","080","0014","0396","469","207","262","3","472","1273","0","37.08","16.26"
"68","000","00","080","0014","0397","414","184","230","7","421","1249","0","33.71","14.73"
"68","000","00","080","0015","0000","1372","620","752","15","1387","3486","0","39.79","17.79"
"68","000","00","080","0015","0405","528","207","321","4","532","1348","0","39.47","15.36"
"68","000","00","080","0015","0406","389","195","194","4","393","1052","0","37.36","18.54"
"68","000","00","080","0015","0407","455","218","237","7","462","1086","0","42.54","20.07"
"68","000","00","080","0016","0000","1511","782","729","13","1524","3792","0","40.19","20.62"
"68","000","00","080","0016","0409","517","280","237","7","524","1312","0","39.94","21.34"
"68","000","00","080","0016","0410","576","256","320","3","579","1356","0","42.70","18.88"
"68","000","00","080","0016","0411","418","246","172","3","421","1124","0","37.46","21.89"
"68","000","00","080","0017","0000","3004","1828","1176","34","3038","7352","0","41.32","24.86"
"68","000","00","080","0017","0418","572","381","191","4","576","1557","0","36.99","24.47"
"68","000","00","080","0017","0419","611","356","255","6","617","1341","0","46.01","26.55"
"68","000","00","080","0017","0420","570","340","230","7","577","1505","0","38.34","22.59"
"68","000","00","080","0017","0421","666","454","212","8","674","1575","0","42.79","28.83"
"68","000","00","080","0017","0422","585","297","288","9","594","1374","0","43.23","21.62"
"68","000","00","080","0018","0000","664","292","372","1","665","1505","0","44.19","19.40"
"68","000","00","080","0018","0431","664","292","372","1","665","1505","0","44.19","19.40"
"68","000","00","080","0019","0000","1423","694","729","14","1437","3312","0","43.39","20.95"
"68","000","00","080","0019","0433","712","296","416","5","717","1634","0","43.88","18.12"
"68","000","00","080","0019","0434","711","398","313","9","720","1678","0","42.91","23.72"
"68","000","00","080","0020","0000","1452","835","617","14","1466","3738","0","39.22","22.34"
"68","000","00","080","0020","0435","433","270","163","9","442","1219","0","36.26","22.15"
"68","000","00","080","0020","0436","504","243","261","3","507","1235","0","41.05","19.68"
"68","000","00","080","0020","0437","515","322","193","2","517","1284","0","40.26","25.08"
"68","000","00","080","0021","0000","711","399","312","9","720","1789","0","40.25","22.30"
"68","000","00","080","0021","0438","711","399","312","9","720","1789","0","40.25","22.30"
"68","000","00","080","0022","0000","2323","1216","1107","13","2336","5181","0","45.09","23.47"
"68","000","00","080","0022","0448","893","524","369","3","896","1752","0","51.14","29.91"
"68","000","00","080","0022","0449","728","342","386","4","732","1769","0","41.38","19.33"
"68","000","00","080","0022","0450","702","350","352","6","708","1660","0","42.65","21.08"
"68","000","00","080","0023","0000","1688","854","834","14","1702","4113","0","41.38","20.76"
"68","000","00","080","0023","0453","513","222","291","3","516","1303","0","39.60","17.04"
"68","000","00","080","0023","0454","553","291","262","7","560","1385","0","40.43","21.01"
"68","000","00","080","0023","0455","622","341","281","4","626","1425","0","43.93","23.93"
"68","000","00","080","0024","0000","1274","704","570","25","1299","3515","0","36.96","20.03"
"68","000","00","080","0024","0425","471","216","255","8","479","1470","0","32.59","14.69"
"68","000","00","080","0024","0426","278","239","39","10","288","624","0","46.15","38.30"
"68","000","00","080","0024","0427","525","249","276","7","532","1421","0","37.44","17.52"
"68","000","00","080","0025","0000","1060","574","486","10","1070","2531","0","42.28","22.68"
"68","000","00","080","0025","0414","559","291","268","5","564","1213","0","46.50","23.99"
"68","000","00","080","0025","0415","501","283","218","5","506","1318","0","38.39","21.47"
"68","000","00","080","0026","0000","1748","806","942","16","1764","4188","0","42.12","19.25"
"68","000","00","080","0026","0400","553","225","328","5","558","1227","0","45.48","18.34"
"68","000","00","080","0026","0401","619","297","322","6","625","1611","0","38.80","18.44"
"68","000","00","080","0026","0402","576","284","292","5","581","1350","0","43.04","21.04"
"68","000","00","080","0027","0000","1793","1108","685","12","1805","4256","0","42.41","26.03"
"68","000","00","080","0027","0439","611","388","223","1","612","1442","0","42.44","26.91"
"68","000","00","080","0027","0440","537","328","209","2","539","1327","0","40.62","24.72"
"68","000","00","080","0027","0441","645","392","253","9","654","1487","0","43.98","26.36"
"68","000","00","080","0028","0000","1579","785","794","10","1589","4161","0","38.19","18.87"
"68","000","00","080","0028","0359","626","300","326","4","630","1601","0","39.35","18.74"
"68","000","00","080","0028","0360","504","229","275","2","506","1234","0","41.00","18.56"
"68","000","00","080","0028","0361","449","256","193","4","453","1326","0","34.16","19.31"
"68","000","00","080","0029","0000","1185","626","559","20","1205","2848","0","42.31","21.98"
"68","000","00","080","0029","0423","573","290","283","13","586","1371","0","42.74","21.15"
"68","000","00","080","0029","0424","612","336","276","7","619","1477","0","41.91","22.75"
"68","000","00","080","0030","0000","1626","852","774","17","1643","4290","0","38.30","19.86"
"68","000","00","080","0030","0445","617","313","304","4","621","1461","0","42.51","21.42"
"68","000","00","080","0030","0446","499","269","230","11","510","1413","0","36.09","19.04"
"68","000","00","080","0030","0447","510","270","240","2","512","1416","0","36.16","19.07"
"68","000","00","080","0031","0000","1341","589","752","9","1350","3074","0","43.92","19.16"
"68","000","00","080","0031","0451","682","266","416","5","687","1546","0","44.44","17.21"
"68","000","00","080","0031","0452","659","323","336","4","663","1528","0","43.39","21.14"
"68","000","00","080","0032","0000","811","373","438","5","816","2030","0","40.20","18.37"
"68","000","00","080","0032","0398","432","196","236","4","436","1003","0","43.47","19.54"
"68","000","00","080","0032","0399","379","177","202","1","380","1027","0","37.00","17.23"
"68","000","00","080","0033","0000","1452","682","770","21","1473","3632","0","40.56","18.78"
"68","000","00","080","0033","0403","727","325","402","11","738","1878","0","39.30","17.31"
"68","000","00","080","0033","0404","725","357","368","10","735","1754","0","41.90","20.35"
"68","000","00","080","0034","0000","598","251","347","12","610","1474","0","41.38","17.03"
"68","000","00","080","0034","0408","598","251","347","12","610","1474","0","41.38","17.03"
"68","000","00","080","0035","0000","554","271","283","8","562","1414","0","39.75","19.17"
"68","000","00","080","0035","0432","554","271","283","8","562","1414","0","39.75","19.17"
"68","000","00","080","0036","0000","845","491","354","9","854","2222","0","38.43","22.10"
"68","000","00","080","0036","0458","434","259","175","7","441","1090","0","40.46","23.76"
"68","000","00","080","0036","0459","411","232","179","2","413","1132","0","36.48","20.49"
"68","000","00","080","0037","0000","765","387","378","10","775","1947","0","39.80","19.88"
"68","000","00","080","0037","0456","427","230","197","6","433","984","0","44.00","23.37"
"68","000","00","080","0037","0457","338","157","181","4","342","963","0","35.51","16.30"
"68","000","00","080","0038","0000","1766","936","830","24","1790","4778","0","37.46","19.59"
"68","000","00","080","0038","0381","670","371","299","8","678","1862","0","36.41","19.92"
"68","000","00","080","0038","0382","576","291","285","11","587","1457","0","40.29","19.97"
"68","000","00","080","0038","0383","520","274","246","5","525","1459","0","35.98","18.78"
"68","000","00","080","0039","0000","1236","654","582","8","1244","3114","0","39.95","21.00"
"68","000","00","080","0039","0391","633","328","305","4","637","1491","0","42.72","22.00"
"68","000","00","080","0039","0392","603","326","277","4","607","1623","0","37.40","20.09"
"68","000","00","080","0040","0000","1119","502","617","14","1133","2788","0","40.64","18.01"
"68","000","00","080","0040","0357","602","261","341","5","607","1554","0","39.06","16.80"
"68","000","00","080","0040","0358","517","241","276","9","526","1234","0","42.63","19.53"
"68","000","00","080","0041","0000","1070","605","465","10","1080","2512","0","42.99","24.08"
"68","000","00","080","0041","0412","519","286","233","5","524","1195","0","43.85","23.93"
"68","000","00","080","0041","0413","551","319","232","5","556","1317","0","42.22","24.22"
"68","000","00","080","0042","0000","1788","1030","758","10","1798","4144","0","43.39","24.86"
"68","000","00","080","0042","0442","575","326","249","3","578","1313","0","44.02","24.83"
"68","000","00","080","0042","0443","649","353","296","4","653","1440","0","45.35","24.51"
"68","000","00","080","0042","0444","564","351","213","3","567","1391","0","40.76","25.23"
"68","000","00","080","0043","0000","1537","878","659","9","1546","3923","0","39.41","22.38"
"68","000","00","080","0043","0460","570","336","234","6","576","1412","0","40.79","23.80"
"68","000","00","080","0043","0461","479","264","215","1","480","1234","0","38.90","21.39"
"68","000","00","080","0043","0462","488","278","210","2","490","1277","0","38.37","21.77"
"68","000","00","080","0044","0000","1202","591","611","11","1213","2667","0","45.48","22.16"
"68","000","00","080","0044","0368","559","244","315","5","564","1302","0","43.32","18.74"
"68","000","00","080","0044","0369","643","347","296","6","649","1365","0","47.55","25.42"
"68","000","00","080","0045","0000","950","740","210","13","963","2166","0","44.46","34.16"
"68","000","00","080","0045","0379","467","371","96","8","475","1151","0","41.27","32.23"
"68","000","00","080","0045","0380","483","369","114","5","488","1015","0","48.08","36.35"
"68","000","00","080","0046","0000","1721","1370","351","37","1758","4338","0","40.53","31.58"
"68","000","00","080","0046","0428","593","463","130","10","603","1490","0","40.47","31.07"
"68","000","00","080","0046","0429","629","533","96","13","642","1550","0","41.42","34.39"
"68","000","00","080","0046","0430","499","374","125","14","513","1298","0","39.52","28.81"
"68","000","00","080","0047","0000","1063","501","562","13","1076","2762","0","38.96","18.14"
"68","000","00","080","0047","0386","504","245","259","11","515","1340","0","38.43","18.28"
"68","000","00","080","0047","0387","559","256","303","2","561","1422","0","39.45","18.00"
"68","000","00","080","0048","0000","1015","543","472","5","1020","2525","0","40.40","21.50"
"68","000","00","080","0048","0416","489","295","194","4","493","1152","0","42.80","25.61"
"68","000","00","080","0048","0417","526","248","278","1","527","1373","0","38.38","18.06"
"68","000","00","090","0000","0000","41185","24606","16579","383","41568","103835","124481","40.03","23.70"
"68","000","00","090","0001","0000","1692","971","721","12","1704","4655","0","36.61","20.86"
"68","000","00","090","0001","1161","595","321","274","4","599","1609","0","37.23","19.95"
"68","000","00","090","0001","1162","518","315","203","2","520","1528","0","34.03","20.62"
"68","000","00","090","0001","1163","579","335","244","6","585","1518","0","38.54","22.07"
"68","000","00","090","0002","0000","2280","1300","980","35","2315","5884","0","39.34","22.09"
"68","000","00","090","0002","1166","728","378","350","17","745","2241","0","33.24","16.87"
"68","000","00","090","0002","1167","418","264","154","4","422","990","0","42.63","26.67"
"68","000","00","090","0002","1168","431","223","208","3","434","1055","0","41.14","21.14"
"68","000","00","090","0002","1169","703","435","268","11","714","1598","0","44.68","27.22"
"68","000","00","090","0003","0000","1481","846","635","18","1499","4416","0","33.94","19.16"
"68","000","00","090","0003","1172","500","251","249","9","509","1476","0","34.49","17.01"
"68","000","00","090","0003","1173","496","286","210","5","501","1595","0","31.41","17.93"
"68","000","00","090","0003","1174","485","309","176","4","489","1345","0","36.36","22.97"
"68","000","00","090","0004","0000","1195","582","613","9","1204","3205","0","37.57","18.16"
"68","000","00","090","0004","1226","637","331","306","4","641","1634","0","39.23","20.26"
"68","000","00","090","0004","1227","558","251","307","5","563","1571","0","35.84","15.98"
"68","000","00","090","0006","0000","1322","766","556","12","1334","3744","0","35.63","20.46"
"68","000","00","090","0006","1178","484","274","210","2","486","1287","0","37.76","21.29"
"68","000","00","090","0006","1179","457","272","185","5","462","1312","0","35.21","20.73"
"68","000","00","090","0006","1180","381","220","161","5","386","1145","0","33.71","19.21"
"68","000","00","090","0007","0000","1576","864","712","13","1589","4226","0","37.60","20.44"
"68","000","00","090","0007","1183","563","286","277","7","570","1419","0","40.17","20.16"
"68","000","00","090","0007","1184","450","263","187","4","454","1307","0","34.74","20.12"
"68","000","00","090","0007","1185","563","315","248","2","565","1500","0","37.67","21.00"
"68","000","00","090","0008","0000","280","85","195","3","283","652","0","43.40","13.04"
"68","000","00","090","0008","1233","280","85","195","3","283","652","0","43.40","13.04"
"68","000","00","090","0009","0000","1718","946","772","9","1727","4406","0","39.20","21.47"
"68","000","00","090","0009","1188","601","310","291","3","604","1769","0","34.14","17.52"
"68","000","00","090","0009","1189","573","312","261","4","577","1335","0","43.22","23.37"
"68","000","00","090","0009","1190","544","324","220","2","546","1302","0","41.94","24.88"
"68","000","00","090","0010","0000","2149","1395","754","14","2163","5430","0","39.83","25.69"
"68","000","00","090","0010","1196","590","366","224","5","595","1390","0","42.81","26.33"
"68","000","00","090","0010","1197","533","364","169","3","536","1343","0","39.91","27.10"
"68","000","00","090","0010","1198","495","329","166","3","498","1340","0","37.16","24.55"
"68","000","00","090","0010","1199","531","336","195","3","534","1357","0","39.35","24.76"
"68","000","00","090","0011","0000","835","423","412","7","842","1835","0","45.89","23.05"
"68","000","00","090","0011","1191","415","214","201","2","417","909","0","45.87","23.54"
"68","000","00","090","0011","1192","420","209","211","5","425","926","0","45.90","22.57"
"68","000","00","090","0012","0000","1624","844","780","19","1643","4539","0","36.20","18.59"
"68","000","00","090","0012","1228","600","288","312","11","611","1583","0","38.60","18.19"
"68","000","00","090","0012","1229","471","222","249","6","477","1395","0","34.19","15.91"
"68","000","00","090","0012","1230","553","334","219","2","555","1561","0","35.55","21.40"
"68","000","00","090","0013","0000","1440","890","550","12","1452","3741","0","38.81","23.79"
"68","000","00","090","0013","1202","570","374","196","6","576","1337","0","43.08","27.97"
"68","000","00","090","0013","1203","445","266","179","4","449","1293","0","34.73","20.57"
"68","000","00","090","0013","1204","425","250","175","2","427","1111","0","38.43","22.50"
"68","000","00","090","0014","0000","1567","967","600","17","1584","4232","0","37.43","22.85"
"68","000","00","090","0014","1210","478","317","161","3","481","1259","0","38.20","25.18"
"68","000","00","090","0014","1211","541","342","199","6","547","1406","0","38.90","24.32"
"68","000","00","090","0014","1212","548","308","240","8","556","1567","0","35.48","19.66"
"68","000","00","090","0015","0000","1566","1063","503","17","1583","3420","0","46.29","31.08"
"68","000","00","090","0015","1215","768","467","301","11","779","1765","0","44.14","26.46"
"68","000","00","090","0015","1216","798","596","202","6","804","1655","0","48.58","36.01"
"68","000","00","090","0016","0000","1185","733","452","9","1194","2574","0","46.39","28.48"
"68","000","00","090","0016","1231","318","149","169","5","323","857","0","37.69","17.39"
"68","000","00","090","0016","1232","867","584","283","4","871","1717","0","50.73","34.01"
"68","000","00","090","0017","0000","607","276","331","7","614","1466","0","41.88","18.83"
"68","000","00","090","0017","1217","607","276","331","7","614","1466","0","41.88","18.83"
"68","000","00","090","0018","0000","1034","565","469","6","1040","2332","0","44.60","24.23"
"68","000","00","090","0018","1218","550","296","254","3","553","1270","0","43.54","23.31"
"68","000","00","090","0018","1219","484","269","215","3","487","1062","0","45.86","25.33"
"68","000","00","090","0019","0000","1451","936","515","9","1460","3072","0","47.53","30.47"
"68","000","00","090","0019","1220","690","424","266","2","692","1581","0","43.77","26.82"
"68","000","00","090","0019","1221","761","512","249","7","768","1491","0","51.51","34.34"
"68","000","00","090","0020","0000","1076","602","474","15","1091","2825","0","38.62","21.31"
"68","000","00","090","0020","1164","492","275","217","8","500","1359","0","36.79","20.24"
"68","000","00","090","0020","1165","584","327","257","7","591","1466","0","40.31","22.31"
"68","000","00","090","0021","0000","1013","534","479","6","1019","2613","0","39.00","20.44"
"68","000","00","090","0021","1170","446","227","219","4","450","1213","0","37.10","18.71"
"68","000","00","090","0021","1171","567","307","260","2","569","1400","0","40.64","21.93"
"68","000","00","090","0022","0000","1962","1404","558","17","1979","4262","0","46.43","32.94"
"68","000","00","090","0022","1175","692","494","198","6","698","1532","0","45.56","32.25"
"68","000","00","090","0022","1176","696","483","213","6","702","1564","0","44.88","30.88"
"68","000","00","090","0022","1177","574","427","147","5","579","1166","0","49.66","36.62"
"68","000","00","090","0023","0000","1282","785","497","10","1292","3487","0","37.05","22.51"
"68","000","00","090","0023","1181","651","382","269","4","655","1677","0","39.06","22.78"
"68","000","00","090","0023","1182","631","403","228","6","637","1810","0","35.19","22.27"
"68","000","00","090","0024","0000","1138","561","577","7","1145","2995","0","38.23","18.73"
"68","000","00","090","0024","1186","529","235","294","1","530","1344","0","39.43","17.49"
"68","000","00","090","0024","1187","609","326","283","6","615","1651","0","37.25","19.75"
"68","000","00","090","0025","0000","1828","1081","747","23","1851","4094","0","45.21","26.40"
"68","000","00","090","0025","1193","673","411","262","7","680","1424","0","47.75","28.86"
"68","000","00","090","0025","1194","453","245","208","7","460","1033","0","44.53","23.72"
"68","000","00","090","0025","1195","702","425","277","9","711","1637","0","43.43","25.96"
"68","000","00","090","0026","0000","1386","883","503","13","1399","3238","0","43.21","27.27"
"68","000","00","090","0026","1200","739","433","306","8","747","1719","0","43.46","25.19"
"68","000","00","090","0026","1201","647","450","197","5","652","1519","0","42.92","29.62"
"68","000","00","090","0027","0000","553","344","209","9","562","1491","0","37.69","23.07"
"68","000","00","090","0027","1205","553","344","209","9","562","1491","0","37.69","23.07"
"68","000","00","090","0028","0000","1468","1014","454","17","1485","3992","0","37.20","25.40"
"68","000","00","090","0028","1207","412","298","114","10","422","1322","0","31.92","22.54"
"68","000","00","090","0028","1208","461","319","142","5","466","1325","0","35.17","24.08"
"68","000","00","090","0028","1209","595","397","198","2","597","1345","0","44.39","29.52"
"68","000","00","090","0029","0000","772","491","281","9","781","2314","0","33.75","21.22"
"68","000","00","090","0029","1213","407","235","172","8","415","1280","0","32.42","18.36"
"68","000","00","090","0029","1214","365","256","109","1","366","1034","0","35.40","24.76"
"68","000","00","090","0030","0000","1783","1254","529","10","1793","3664","0","48.94","34.22"
"68","000","00","090","0030","1222","866","625","241","7","873","1832","0","47.65","34.12"
"68","000","00","090","0030","1223","917","629","288","3","920","1832","0","50.22","34.33"
"68","000","00","090","0031","0000","1440","972","468","13","1453","3448","0","42.14","28.19"
"68","000","00","090","0031","1224","721","484","237","5","726","1776","0","40.88","27.25"
"68","000","00","090","0031","1225","719","488","231","8","727","1672","0","43.48","29.19"
"68","000","00","090","0032","0000","482","229","253","6","488","1583","0","30.83","14.47"
"68","000","00","090","0032","1206","482","229","253","6","488","1583","0","30.83","14.47"
"68","000","00","100","0000","0000","76194","42622","33572","717","76911","187597","228672","41.00","22.72"
"68","000","00","100","0001","0000","1808","978","830","16","1824","4741","0","38.47","20.63"
"68","000","00","100","0001","0996","682","385","297","4","686","1721","0","39.86","22.37"
"68","000","00","100","0001","0997","570","295","275","5","575","1592","0","36.12","18.53"
"68","000","00","100","0001","0998","556","298","258","7","563","1428","0","39.43","20.87"
"68","000","00","100","0002","0000","1906","927","979","13","1919","4288","0","44.75","21.62"
"68","000","00","100","0002","0999","710","311","399","5","715","1682","0","42.51","18.49"
"68","000","00","100","0002","1000","540","247","293","6","546","1318","0","41.43","18.74"
"68","000","00","100","0002","1001","656","369","287","2","658","1288","0","51.09","28.65"
"68","000","00","100","0003","0000","2286","1311","975","15","2301","5412","0","42.52","24.22"
"68","000","00","100","0003","0981","573","337","236","4","577","1290","0","44.73","26.12"
"68","000","00","100","0003","0982","557","324","233","4","561","1357","0","41.34","23.88"
"68","000","00","100","0003","0983","579","310","269","3","582","1407","0","41.36","22.03"
"68","000","00","100","0003","0984","577","340","237","4","581","1358","0","42.78","25.04"
"68","000","00","100","0004","0000","2503","1342","1161","27","2530","5467","0","46.28","24.55"
"68","000","00","100","0004","0971","594","250","344","4","598","1293","0","46.25","19.33"
"68","000","00","100","0004","0972","581","314","267","4","585","1283","0","45.60","24.47"
"68","000","00","100","0004","0973","700","419","281","4","704","1411","0","49.89","29.70"
"68","000","00","100","0004","0974","628","359","269","15","643","1480","0","43.45","24.26"
"68","000","00","100","0005","0000","2049","1163","886","18","2067","5228","0","39.54","22.25"
"68","000","00","100","0005","0988","584","322","262","10","594","1353","0","43.90","23.80"
"68","000","00","100","0005","0989","564","321","243","5","569","1292","0","44.04","24.85"
"68","000","00","100","0005","0990","481","271","210","3","484","1303","0","37.15","20.80"
"68","000","00","100","0005","0991","420","249","171","0","420","1280","0","32.81","19.45"
"68","000","00","100","0006","0000","1669","910","759","16","1685","4332","0","38.90","21.01"
"68","000","00","100","0006","0964","584","306","278","9","593","1437","0","41.27","21.29"
"68","000","00","100","0006","0965","576","307","269","5","581","1466","0","39.63","20.94"
"68","000","00","100","0006","0966","509","297","212","2","511","1429","0","35.76","20.78"
"68","000","00","100","0007","0000","1582","846","736","13","1595","3659","0","43.59","23.12"
"68","000","00","100","0007","1007","464","247","217","3","467","1123","0","41.59","21.99"
"68","000","00","100","0007","1008","546","270","276","6","552","1253","0","44.05","21.55"
"68","000","00","100","0007","1009","572","329","243","4","576","1283","0","44.89","25.64"
"68","000","00","100","0008","0000","2367","1331","1036","24","2391","6520","0","36.67","20.41"
"68","000","00","100","0008","1015","456","248","208","5","461","2312","0","19.94","10.73"
"68","000","00","100","0008","1016","474","244","230","6","480","974","0","49.28","25.05"
"68","000","00","100","0008","1017","748","454","294","7","755","1569","0","48.12","28.94"
"68","000","00","100","0008","1018","689","385","304","6","695","1665","0","41.74","23.12"
"68","000","00","100","0009","0000","1160","579","581","10","1170","2424","0","48.27","23.89"
"68","000","00","100","0009","1002","592","285","307","4","596","1217","0","48.97","23.42"
"68","000","00","100","0009","1003","568","294","274","6","574","1207","0","47.56","24.36"
"68","000","00","100","0010","0000","1578","799","779","10","1588","3911","0","40.60","20.43"
"68","000","00","100","0010","1024","444","202","242","4","448","989","0","45.30","20.42"
"68","000","00","100","0010","1025","580","297","283","5","585","1454","0","40.23","20.43"
"68","000","00","100","0010","1026","554","300","254","1","555","1468","0","37.81","20.44"
"68","000","00","100","0011","0000","1700","870","830","13","1713","3974","0","43.11","21.89"
"68","000","00","100","0011","1029","585","264","321","8","593","1436","0","41.30","18.38"
"68","000","00","100","0011","1030","578","278","300","3","581","1386","0","41.92","20.06"
"68","000","00","100","0011","1031","537","328","209","2","539","1152","0","46.79","28.47"
"68","000","00","100","0012","0000","1666","865","801","22","1688","4457","0","37.87","19.41"
"68","000","00","100","0012","0928","503","241","262","3","506","1464","0","34.56","16.46"
"68","000","00","100","0012","0929","627","312","315","9","636","1551","0","41.01","20.12"
"68","000","00","100","0012","0930","536","312","224","10","546","1442","0","37.86","21.64"
"68","000","00","100","0013","0000","2265","1230","1035","14","2279","5771","0","39.49","21.31"
"68","000","00","100","0013","0933","609","324","285","3","612","1562","0","39.18","20.74"
"68","000","00","100","0013","0934","567","315","252","4","571","1364","0","41.86","23.09"
"68","000","00","100","0013","0935","583","315","268","5","588","1441","0","40.80","21.86"
"68","000","00","100","0013","0936","506","276","230","2","508","1404","0","36.18","19.66"
"68","000","00","100","0014","0000","1894","1203","691","28","1922","4674","0","41.12","25.74"
"68","000","00","100","0014","0956","479","297","182","5","484","1232","0","39.29","24.11"
"68","000","00","100","0014","0957","473","287","186","5","478","1183","0","40.41","24.26"
"68","000","00","100","0014","0958","403","307","96","12","415","1001","0","41.46","30.67"
"68","000","00","100","0014","0959","539","312","227","6","545","1258","0","43.32","24.80"
"68","000","00","100","0015","0000","907","568","339","8","915","2330","0","39.27","24.38"
"68","000","00","100","0015","0948","420","265","155","2","422","1134","0","37.21","23.37"
"68","000","00","100","0015","0949","487","303","184","6","493","1196","0","41.22","25.33"
"68","000","00","100","0016","0000","2110","1199","911","26","2136","5189","0","41.16","23.11"
"68","000","00","100","0016","0952","493","255","238","7","500","1328","0","37.65","19.20"
"68","000","00","100","0016","0953","517","303","214","6","523","1293","0","40.45","23.43"
"68","000","00","100","0016","0954","546","330","216","8","554","1304","0","42.48","25.31"
"68","000","00","100","0016","0955","554","311","243","5","559","1264","0","44.22","24.60"
"68","000","00","100","0017","0000","1116","744","372","13","1129","2791","0","40.45","26.66"
"68","000","00","100","0017","1050","528","367","161","8","536","1344","0","39.88","27.31"
"68","000","00","100","0017","1051","588","377","211","5","593","1447","0","40.98","26.05"
"68","000","00","100","0018","0000","1301","860","441","15","1316","3322","0","39.61","25.89"
"68","000","00","100","0018","1052","686","429","257","8","694","1699","0","40.85","25.25"
"68","000","00","100","0018","1053","615","431","184","7","622","1623","0","38.32","26.56"
"68","000","00","100","0019","0000","1067","779","288","15","1082","2548","0","42.46","30.57"
"68","000","00","100","0019","1057","453","313","140","3","456","1119","0","40.75","27.97"
"68","000","00","100","0019","1058","614","466","148","12","626","1429","0","43.81","32.61"
"68","000","00","100","0020","0000","922","645","277","6","928","1945","0","47.71","33.16"
"68","000","00","100","0020","1055","511","364","147","2","513","1087","0","47.19","33.49"
"68","000","00","100","0020","1056","411","281","130","4","415","858","0","48.37","32.75"
"68","000","00","100","0021","0000","602","444","158","3","605","1318","0","45.90","33.69"
"68","000","00","100","0021","1054","602","444","158","3","605","1318","0","45.90","33.69"
"68","000","00","100","0022","0000","705","540","165","9","714","1650","0","43.27","32.73"
"68","000","00","100","0022","1059","705","540","165","9","714","1650","0","43.27","32.73"
"68","000","00","100","0023","0000","1721","884","837","16","1737","4292","0","40.47","20.60"
"68","000","00","100","0023","1035","567","246","321","4","571","1260","0","45.32","19.52"
"68","000","00","100","0023","1036","644","371","273","5","649","1632","0","39.77","22.73"
"68","000","00","100","0023","1037","510","267","243","7","517","1400","0","36.93","19.07"
"68","000","00","100","0024","0000","2062","991","1071","13","2075","5410","0","38.35","18.32"
"68","000","00","100","0024","1046","410","152","258","1","411","1095","0","37.53","13.88"
"68","000","00","100","0024","1047","607","299","308","6","613","1440","0","42.57","20.76"
"68","000","00","100","0024","1048","524","223","301","2","526","1327","0","39.64","16.80"
"68","000","00","100","0024","1049","521","317","204","4","525","1548","0","33.91","20.48"
"68","000","00","100","0025","0000","1012","662","350","11","1023","2812","0","36.38","23.54"
"68","000","00","100","0025","1041","513","330","183","7","520","1377","0","37.76","23.97"
"68","000","00","100","0025","1042","499","332","167","4","503","1435","0","35.05","23.14"
"68","000","00","100","0026","0000","1595","965","630","21","1616","4358","0","37.08","22.14"
"68","000","00","100","0026","1043","540","333","207","6","546","1522","0","35.87","21.88"
"68","000","00","100","0026","1044","525","306","219","6","531","1471","0","36.10","20.80"
"68","000","00","100","0026","1045","530","326","204","9","539","1365","0","39.49","23.88"
"68","000","00","100","0027","0000","1201","573","628","14","1215","3084","0","39.40","18.58"
"68","000","00","100","0027","0931","557","243","314","8","565","1378","0","41.00","17.63"
"68","000","00","100","0027","0932","644","330","314","6","650","1706","0","38.10","19.34"
"68","000","00","100","0028","0000","2956","1537","1419","19","2975","6850","0","43.43","22.44"
"68","000","00","100","0028","0992","835","424","411","9","844","1785","0","47.28","23.75"
"68","000","00","100","0028","0993","709","353","356","1","710","1619","0","43.85","21.80"
"68","000","00","100","0028","0994","710","359","351","5","715","1672","0","42.76","21.47"
"68","000","00","100","0028","0995","702","401","301","4","706","1774","0","39.80","22.60"
"68","000","00","100","0029","0000","712","392","320","8","720","1755","0","41.03","22.34"
"68","000","00","100","0029","0960","712","392","320","8","720","1755","0","41.03","22.34"
"68","000","00","100","0030","0000","1541","915","626","15","1556","4511","0","34.49","20.28"
"68","000","00","100","0030","0961","568","334","234","4","572","1675","0","34.15","19.94"
"68","000","00","100","0030","0962","503","299","204","9","512","1408","0","36.36","21.24"
"68","000","00","100","0030","0963","470","282","188","2","472","1428","0","33.05","19.75"
"68","000","00","100","0031","0000","1701","815","886","18","1719","3871","0","44.41","21.05"
"68","000","00","100","0031","0975","625","310","315","7","632","1378","0","45.86","22.50"
"68","000","00","100","0031","0976","529","250","279","6","535","1241","0","43.11","20.15"
"68","000","00","100","0031","0977","547","255","292","5","552","1252","0","44.09","20.37"
"68","000","00","100","0032","0000","1437","766","671","12","1449","3429","0","42.26","22.34"
"68","000","00","100","0032","0950","680","325","355","8","688","1650","0","41.70","19.70"
"68","000","00","100","0032","0951","757","441","316","4","761","1779","0","42.78","24.79"
"68","000","00","100","0033","0000","2436","1426","1010","24","2460","6586","0","37.35","21.65"
"68","000","00","100","0033","0937","723","443","280","5","728","1825","0","39.89","24.27"
"68","000","00","100","0033","0938","529","322","207","5","534","1782","0","29.97","18.07"
"68","000","00","100","0033","0939","628","346","282","7","635","1470","0","43.20","23.54"
"68","000","00","100","0033","0940","556","315","241","7","563","1509","0","37.31","20.87"
"68","000","00","100","0034","0000","1533","812","721","8","1541","4222","0","36.50","19.23"
"68","000","00","100","0034","0978","583","305","278","4","587","1459","0","40.23","20.90"
"68","000","00","100","0034","0979","512","285","227","3","515","1402","0","36.73","20.33"
"68","000","00","100","0034","0980","438","222","216","1","439","1361","0","32.26","16.31"
"68","000","00","100","0035","0000","1366","681","685","14","1380","3064","0","45.04","22.23"
"68","000","00","100","0035","1022","664","332","332","5","669","1531","0","43.70","21.69"
"68","000","00","100","0035","1023","702","349","353","9","711","1533","0","46.38","22.77"
"68","000","00","100","0036","0000","1662","853","809","20","1682","3878","0","43.37","22.00"
"68","000","00","100","0036","1032","551","337","214","5","556","1375","0","40.44","24.51"
"68","000","00","100","0036","1033","558","270","288","9","567","1257","0","45.11","21.48"
"68","000","00","100","0036","1034","553","246","307","6","559","1246","0","44.86","19.74"
"68","000","00","100","0037","0000","2244","1233","1011","24","2268","5110","0","44.38","24.13"
"68","000","00","100","0037","1012","790","406","384","11","801","1719","0","46.60","23.62"
"68","000","00","100","0037","1013","802","464","338","7","809","1764","0","45.86","26.30"
"68","000","00","100","0037","1014","652","363","289","6","658","1627","0","40.44","22.31"
"68","000","00","100","0038","0000","1513","977","536","23","1536","4282","0","35.87","22.82"
"68","000","00","100","0038","1038","503","338","165","10","513","1393","0","36.83","24.26"
"68","000","00","100","0038","1039","549","345","204","6","555","1337","0","41.51","25.80"
"68","000","00","100","0038","1040","461","294","167","7","468","1552","0","30.15","18.94"
"68","000","00","100","0039","0000","1266","724","542","9","1275","2823","0","45.16","25.65"
"68","000","00","100","0039","1027","597","332","265","5","602","1345","0","44.76","24.68"
"68","000","00","100","0039","1028","669","392","277","4","673","1478","0","45.53","26.52"
"68","000","00","100","0040","0000","733","335","398","3","736","1551","0","47.45","21.60"
"68","000","00","100","0040","1010","342","161","181","1","343","739","0","46.41","21.79"
"68","000","00","100","0040","1011","391","174","217","2","393","812","0","48.40","21.43"
"68","000","00","100","0041","0000","1727","1027","700","9","1736","3758","0","46.19","27.33"
"68","000","00","100","0041","1004","587","360","227","6","593","1271","0","46.66","28.32"
"68","000","00","100","0041","1005","642","356","286","2","644","1376","0","46.80","25.87"
"68","000","00","100","0041","1006","498","311","187","1","499","1111","0","44.91","27.99"
"68","000","00","100","0042","0000","2192","1171","1021","25","2217","4904","0","45.21","23.88"
"68","000","00","100","0042","0985","771","395","376","11","782","1789","0","43.71","22.08"
"68","000","00","100","0042","0986","636","359","277","4","640","1442","0","44.38","24.90"
"68","000","00","100","0042","0987","785","417","368","10","795","1673","0","47.52","24.93"
"68","000","00","100","0043","0000","2181","1214","967","16","2197","5498","0","39.96","22.08"
"68","000","00","100","0043","0967","534","311","223","4","538","1345","0","40.00","23.12"
"68","000","00","100","0043","0968","589","321","268","8","597","1408","0","42.40","22.80"
"68","000","00","100","0043","0969","520","287","233","3","523","1392","0","37.57","20.62"
"68","000","00","100","0043","0970","538","295","243","1","539","1353","0","39.84","21.80"
"68","000","00","100","0044","0000","1599","991","608","14","1613","3806","0","42.38","26.04"
"68","000","00","100","0044","1019","481","302","179","3","484","1199","0","40.37","25.19"
"68","000","00","100","0044","1020","510","310","200","4","514","1209","0","42.51","25.64"
"68","000","00","100","0044","1021","608","379","229","7","615","1398","0","43.99","27.11"
"68","000","00","100","0045","0000","2022","1082","940","25","2047","5085","0","40.26","21.28"
"68","000","00","100","0045","0941","688","331","357","9","697","1842","0","37.84","17.97"
"68","000","00","100","0045","0942","578","308","270","9","587","1436","0","40.88","21.45"
"68","000","00","100","0045","0943","756","443","313","7","763","1807","0","42.22","24.52"
"68","000","00","100","0046","0000","2619","1463","1156","22","2641","6707","0","39.38","21.81"
"68","000","00","100","0046","0944","648","320","328","4","652","1806","0","36.10","17.72"
"68","000","00","100","0046","0945","636","355","281","7","643","1652","0","38.92","21.49"
"68","000","00","100","0046","0946","666","394","272","4","670","1524","0","43.96","25.85"
"68","000","00","100","0046","0947","669","394","275","7","676","1725","0","39.19","22.84"
"68","000","00","110","0000","0000","16068","7723","8345","159","16227","42036","49237","38.60","18.37"
"68","000","00","110","0001","0000","1135","574","561","13","1148","2883","0","39.82","19.91"
"68","000","00","110","0001","1234","593","303","290","6","599","1446","0","41.42","20.95"
"68","000","00","110","0001","1235","542","271","271","7","549","1437","0","38.20","18.86"
"68","000","00","110","0002","0000","1559","831","728","12","1571","3991","0","39.36","20.82"
"68","000","00","110","0002","1236","500","259","241","1","501","1337","0","37.47","19.37"
"68","000","00","110","0002","1237","482","252","230","7","489","1263","0","38.72","19.95"
"68","000","00","110","0002","1238","577","320","257","4","581","1391","0","41.77","23.01"
"68","000","00","110","0003","0000","537","274","263","6","543","1517","0","35.79","18.06"
"68","000","00","110","0003","1239","537","274","263","6","543","1517","0","35.79","18.06"
"68","000","00","110","0004","0000","1451","743","708","9","1460","4096","0","35.64","18.14"
"68","000","00","110","0004","1240","531","254","277","6","537","1368","0","39.25","18.57"
"68","000","00","110","0004","1241","481","264","217","2","483","1341","0","36.02","19.69"
"68","000","00","110","0004","1242","439","225","214","1","440","1387","0","31.72","16.22"
"68","000","00","110","0005","0000","1721","835","886","15","1736","4467","0","38.86","18.69"
"68","000","00","110","0005","1251","556","293","263","6","562","1581","0","35.55","18.53"
"68","000","00","110","0005","1252","607","294","313","5","612","1424","0","42.98","20.65"
"68","000","00","110","0005","1253","558","248","310","4","562","1462","0","38.44","16.96"
"68","000","00","110","0006","0000","885","454","431","6","891","2563","0","34.76","17.71"
"68","000","00","110","0006","1247","444","221","223","3","447","1263","0","35.39","17.50"
"68","000","00","110","0006","1248","441","233","208","3","444","1300","0","34.15","17.92"
"68","000","00","110","0007","0000","888","393","495","11","899","2292","0","39.22","17.15"
"68","000","00","110","0007","1249","510","248","262","3","513","1252","0","40.97","19.81"
"68","000","00","110","0007","1250","378","145","233","8","386","1040","0","37.12","13.94"
"68","000","00","110","0008","0000","536","230","306","4","540","1356","0","39.82","16.96"
"68","000","00","110","0008","1246","536","230","306","4","540","1356","0","39.82","16.96"
"68","000","00","110","0009","0000","570","272","298","7","577","1466","0","39.36","18.55"
"68","000","00","110","0009","1245","570","272","298","7","577","1466","0","39.36","18.55"
"68","000","00","110","0010","0000","809","352","457","16","825","2076","0","39.74","16.96"
"68","000","00","110","0010","1243","384","170","214","9","393","979","0","40.14","17.36"
"68","000","00","110","0010","1244","425","182","243","7","432","1097","0","39.38","16.59"
"68","000","00","110","0011","0000","309","146","163","1","310","730","0","42.47","20.00"
"68","000","00","110","0011","1264","309","146","163","1","310","730","0","42.47","20.00"
"68","000","00","110","0012","0000","629","298","331","6","635","1727","0","36.77","17.26"
"68","000","00","110","0012","1266","629","298","331","6","635","1727","0","36.77","17.26"
"68","000","00","110","0013","0000","382","202","180","6","388","926","0","41.90","21.81"
"68","000","00","110","0013","1265","382","202","180","6","388","926","0","41.90","21.81"
"68","000","00","110","0014","0000","493","237","256","7","500","1310","0","38.17","18.09"
"68","000","00","110","0014","1267","493","237","256","7","500","1310","0","38.17","18.09"
"68","000","00","110","0015","0000","416","186","230","6","422","1021","0","41.33","18.22"
"68","000","00","110","0015","1263","416","186","230","6","422","1021","0","41.33","18.22"
"68","000","00","110","0016","0000","899","438","461","11","910","2201","0","41.34","19.90"
"68","000","00","110","0016","1261","419","200","219","5","424","1015","0","41.77","19.70"
"68","000","00","110","0016","1262","480","238","242","6","486","1186","0","40.98","20.07"
"68","000","00","110","0017","0000","411","208","203","6","417","1020","0","40.88","20.39"
"68","000","00","110","0017","1260","411","208","203","6","417","1020","0","40.88","20.39"
"68","000","00","110","0018","0000","245","120","125","0","245","639","0","38.34","18.78"
"68","000","00","110","0018","1258","245","120","125","0","245","639","0","38.34","18.78"
"68","000","00","110","0019","0000","334","117","217","4","338","900","0","37.56","13.00"
"68","000","00","110","0019","1257","334","117","217","4","338","900","0","37.56","13.00"
"68","000","00","110","0020","0000","413","175","238","6","419","1072","0","39.09","16.32"
"68","000","00","110","0020","1259","413","175","238","6","419","1072","0","39.09","16.32"
"68","000","00","110","0021","0000","452","224","228","3","455","1098","0","41.44","20.40"
"68","000","00","110","0021","1256","452","224","228","3","455","1098","0","41.44","20.40"
"68","000","00","110","0022","0000","480","190","290","1","481","1294","0","37.17","14.68"
"68","000","00","110","0022","1254","480","190","290","1","481","1294","0","37.17","14.68"
"68","000","00","110","0023","0000","514","224","290","3","517","1391","0","37.17","16.10"
"68","000","00","110","0023","1255","514","224","290","3","517","1391","0","37.17","16.10"
"68","000","00","120","0000","0000","21103","8996","12107","213","21316","57793","69326","36.88","15.57"
"68","000","00","120","0001","0000","994","477","517","9","1003","2767","0","36.25","17.24"
"68","000","00","120","0001","1268","531","257","274","3","534","1359","0","39.29","18.91"
"68","000","00","120","0001","1269","463","220","243","6","469","1408","0","33.31","15.63"
"68","000","00","120","0002","0000","371","97","274","4","375","875","0","42.86","11.09"
"68","000","00","120","0002","1270","371","97","274","4","375","875","0","42.86","11.09"
"68","000","00","120","0003","0000","483","235","248","8","491","1310","0","37.48","17.94"
"68","000","00","120","0003","1271","483","235","248","8","491","1310","0","37.48","17.94"
"68","000","00","120","0004","0000","798","340","458","14","812","1899","0","42.76","17.90"
"68","000","00","120","0004","1272","798","340","458","14","812","1899","0","42.76","17.90"
"68","000","00","120","0005","0000","375","168","207","5","380","912","0","41.67","18.42"
"68","000","00","120","0005","1275","375","168","207","5","380","912","0","41.67","18.42"
"68","000","00","120","0006","0000","813","365","448","9","822","2180","0","37.71","16.74"
"68","000","00","120","0006","1273","454","203","251","4","458","1329","0","34.46","15.27"
"68","000","00","120","0006","1274","359","162","197","5","364","851","0","42.77","19.04"
"68","000","00","120","0007","0000","373","179","194","2","375","854","0","43.91","20.96"
"68","000","00","120","0007","1276","373","179","194","2","375","854","0","43.91","20.96"
"68","000","00","120","0008","0000","297","136","161","3","300","705","0","42.55","19.29"
"68","000","00","120","0008","1277","297","136","161","3","300","705","0","42.55","19.29"
"68","000","00","120","0009","0000","606","270","336","5","611","1831","0","33.37","14.75"
"68","000","00","120","0009","1278","606","270","336","5","611","1831","0","33.37","14.75"
"68","000","00","120","0010","0000","927","395","532","8","935","2633","0","35.51","15.00"
"68","000","00","120","0010","1279","456","191","265","6","462","1278","0","36.15","14.95"
"68","000","00","120","0010","1280","471","204","267","2","473","1355","0","34.91","15.06"
"68","000","00","120","0011","0000","1046","432","614","6","1052","2621","0","40.14","16.48"
"68","000","00","120","0011","1281","516","242","274","1","517","1329","0","38.90","18.21"
"68","000","00","120","0011","1282","530","190","340","5","535","1292","0","41.41","14.71"
"68","000","00","120","0012","0000","1191","451","740","18","1209","3116","0","38.80","14.47"
"68","000","00","120","0012","1283","615","210","405","11","626","1534","0","40.81","13.69"
"68","000","00","120","0012","1284","576","241","335","7","583","1582","0","36.85","15.23"
"68","000","00","120","0013","0000","543","208","335","5","548","1484","0","36.93","14.02"
"68","000","00","120","0013","1285","543","208","335","5","548","1484","0","36.93","14.02"
"68","000","00","120","0014","0000","1921","734","1187","6","1927","4757","0","40.51","15.43"
"68","000","00","120","0014","1286","463","149","314","0","463","1123","0","41.23","13.27"
"68","000","00","120","0014","1287","471","172","299","1","472","1105","0","42.71","15.57"
"68","000","00","120","0014","1288","526","205","321","1","527","1228","0","42.92","16.69"
"68","000","00","120","0014","1289","461","208","253","4","465","1301","0","35.74","15.99"
"68","000","00","120","0015","0000","1480","739","741","11","1491","3918","0","38.06","18.86"
"68","000","00","120","0015","1290","475","223","252","1","476","1271","0","37.45","17.55"
"68","000","00","120","0015","1291","522","264","258","7","529","1468","0","36.04","17.98"
"68","000","00","120","0015","1292","483","252","231","3","486","1179","0","41.22","21.37"
"68","000","00","120","0016","0000","970","423","547","12","982","2458","0","39.95","17.21"
"68","000","00","120","0016","1293","441","184","257","6","447","1102","0","40.56","16.70"
"68","000","00","120","0016","1294","529","239","290","6","535","1356","0","39.45","17.63"
"68","000","00","120","0017","0000","1132","451","681","6","1138","2971","0","38.30","15.18"
"68","000","00","120","0017","1295","615","269","346","4","619","1435","0","43.14","18.75"
"68","000","00","120","0017","1296","517","182","335","2","519","1536","0","33.79","11.85"
"68","000","00","120","0018","0000","921","356","565","9","930","2482","0","37.47","14.34"
"68","000","00","120","0018","1297","474","179","295","4","478","1272","0","37.58","14.07"
"68","000","00","120","0018","1298","447","177","270","5","452","1210","0","37.36","14.63"
"68","000","00","120","0019","0000","340","140","200","5","345","1021","0","33.79","13.71"
"68","000","00","120","0019","1299","340","140","200","5","345","1021","0","33.79","13.71"
"68","000","00","120","0020","0000","775","246","529","8","783","1950","0","40.15","12.62"
"68","000","00","120","0020","1300","358","117","241","7","365","992","0","36.79","11.79"
"68","000","00","120","0020","1301","417","129","288","1","418","958","0","43.63","13.47"
"68","000","00","120","0021","0000","979","396","583","14","993","2935","0","33.83","13.49"
"68","000","00","120","0021","1302","521","207","314","10","531","1462","0","36.32","14.16"
"68","000","00","120","0021","1303","458","189","269","4","462","1473","0","31.36","12.83"
"68","000","00","120","0022","0000","1235","579","656","19","1254","4468","0","28.07","12.96"
"68","000","00","120","0022","1308","438","186","252","4","442","1381","0","32.01","13.47"
"68","000","00","120","0022","1309","401","203","198","3","404","1531","0","26.39","13.26"
"68","000","00","120","0022","1310","396","190","206","12","408","1556","0","26.22","12.21"
"68","000","00","120","0023","0000","650","285","365","8","658","1926","0","34.16","14.80"
"68","000","00","120","0023","1311","332","134","198","3","335","874","0","38.33","15.33"
"68","000","00","120","0023","1312","318","151","167","5","323","1052","0","30.70","14.35"
"68","000","00","120","0024","0000","1883","894","989","19","1902","5720","0","33.25","15.63"
"68","000","00","120","0024","1304","453","201","252","6","459","1372","0","33.45","14.65"
"68","000","00","120","0024","1305","509","240","269","6","515","1501","0","34.31","15.99"
"68","000","00","120","0024","1306","462","229","233","5","467","1355","0","34.46","16.90"
"68","000","00","120","0024","1307","459","224","235","2","461","1492","0","30.90","15.01"
"68","000","00","130","0000","0000","2718","1875","843","36","2754","10036","12391","27.44","18.68"
"68","000","00","130","0001","0000","668","354","314","13","681","2041","0","33.37","17.34"
"68","000","00","130","0001","0674","351","168","183","8","359","1020","0","35.20","16.47"
"68","000","00","130","0001","0675","317","186","131","5","322","1021","0","31.54","18.22"
"68","000","00","130","0002","0000","434","308","126","5","439","1426","0","30.79","21.60"
"68","000","00","130","0002","0676","434","308","126","5","439","1426","0","30.79","21.60"
"68","000","00","130","0003","0000","218","183","35","5","223","745","0","29.93","24.56"
"68","000","00","130","0003","0678","218","183","35","5","223","745","0","29.93","24.56"
"68","000","00","130","0004","0000","165","135","30","0","165","631","0","26.15","21.39"
"68","000","00","130","0004","0677","165","135","30","0","165","631","0","26.15","21.39"
"68","000","00","130","0005","0000","157","116","41","3","160","660","0","24.24","17.58"
"68","000","00","130","0005","0680","157","116","41","3","160","660","0","24.24","17.58"
"68","000","00","130","0006","0000","127","112","15","3","130","683","0","19.03","16.40"
"68","000","00","130","0006","0683","127","112","15","3","130","683","0","19.03","16.40"
"68","000","00","130","0007","0000","203","164","39","3","206","764","0","26.96","21.47"
"68","000","00","130","0007","0681","203","164","39","3","206","764","0","26.96","21.47"
"68","000","00","130","0008","0000","289","165","124","1","290","1265","0","22.92","13.04"
"68","000","00","130","0008","0684","289","165","124","1","290","1265","0","22.92","13.04"
"68","000","00","130","0009","0000","334","246","88","3","337","1067","0","31.58","23.06"
"68","000","00","130","0009","0679","334","246","88","3","337","1067","0","31.58","23.06"
"68","000","00","130","0010","0000","123","92","31","0","123","754","0","16.31","12.20"
"68","000","00","130","0010","0682","123","92","31","0","123","754","0","16.31","12.20"
"66","000","00","000","0000","0000","975133","484612","490521","9433","984566","2337667","2819081","42.12","20.73"
"66","000","00","010","0000","0000","6028","2798","3230","53","6081","14195","17930","42.84","19.71"
"66","000","00","010","0001","0000","645","268","377","1","646","1436","0","44.99","18.66"
"66","000","00","010","0001","1286","645","268","377","1","646","1436","0","44.99","18.66"
"66","000","00","010","0002","0000","826","390","436","2","828","1946","0","42.55","20.04"
"66","000","00","010","0002","1290","448","204","244","1","449","1121","0","40.05","18.20"
"66","000","00","010","0002","1291","378","186","192","1","379","825","0","45.94","22.55"
"66","000","00","010","0003","0000","680","303","377","7","687","1572","0","43.70","19.27"
"66","000","00","010","0003","1284","326","148","178","2","328","795","0","41.26","18.62"
"66","000","00","010","0003","1285","354","155","199","5","359","777","0","46.20","19.95"
"66","000","00","010","0004","0000","574","267","307","9","583","1353","0","43.09","19.73"
"66","000","00","010","0004","1287","574","267","307","9","583","1353","0","43.09","19.73"
"66","000","00","010","0005","0000","847","409","438","5","852","1913","0","44.54","21.38"
"66","000","00","010","0005","1288","465","232","233","2","467","1012","0","46.15","22.92"
"66","000","00","010","0005","1289","382","177","205","3","385","901","0","42.73","19.64"
"66","000","00","010","0006","0000","704","334","370","10","714","1884","0","37.90","17.73"
"66","000","00","010","0006","1292","406","179","227","7","413","1202","0","34.36","14.89"
"66","000","00","010","0006","1293","298","155","143","3","301","682","0","44.13","22.73"
"66","000","00","010","0007","0000","992","444","548","11","1003","2244","0","44.70","19.79"
"66","000","00","010","0007","1294","469","231","238","3","472","988","0","47.77","23.38"
"66","000","00","010","0007","1295","523","213","310","8","531","1256","0","42.28","16.96"
"66","000","00","010","0008","0000","760","383","377","8","768","1847","0","41.58","20.74"
"66","000","00","010","0008","1296","397","182","215","5","402","960","0","41.88","18.96"
"66","000","00","010","0008","1297","363","201","162","3","366","887","0","41.26","22.66"
"66","000","00","020","0000","0000","28819","13774","15045","290","29109","64617","75468","45.05","21.32"
"66","000","00","020","0001","0000","1170","508","662","6","1176","2974","0","39.54","17.08"
"66","000","00","020","0001","1298","369","149","220","2","371","1174","0","31.60","12.69"
"66","000","00","020","0001","1299","447","214","233","2","449","948","0","47.36","22.57"
"66","000","00","020","0001","1300","354","145","209","2","356","852","0","41.78","17.02"
"66","000","00","020","0002","0000","1419","589","830","24","1443","3053","0","47.26","19.29"
"66","000","00","020","0002","1301","526","221","305","6","532","1073","0","49.58","20.60"
"66","000","00","020","0002","1302","478","203","275","9","487","1098","0","44.35","18.49"
"66","000","00","020","0002","1303","415","165","250","9","424","882","0","48.07","18.71"
"66","000","00","020","0003","0000","1698","638","1060","18","1716","3732","0","45.98","17.10"
"66","000","00","020","0003","1304","589","247","342","8","597","1351","0","44.19","18.28"
"66","000","00","020","0003","1305","534","196","338","6","540","1201","0","44.96","16.32"
"66","000","00","020","0003","1306","575","195","380","4","579","1180","0","49.07","16.53"
"66","000","00","020","0004","0000","1244","534","710","14","1258","2791","0","45.07","19.13"
"66","000","00","020","0004","1307","586","255","331","3","589","1360","0","43.31","18.75"
"66","000","00","020","0004","1308","658","279","379","11","669","1431","0","46.75","19.50"
"66","000","00","020","0005","0000","910","435","475","12","922","1889","0","48.81","23.03"
"66","000","00","020","0005","1311","529","193","336","8","537","1122","0","47.86","17.20"
"66","000","00","020","0005","1312","381","242","139","4","385","767","0","50.20","31.55"
"66","000","00","020","0006","0000","928","406","522","8","936","2030","0","46.11","20.00"
"66","000","00","020","0006","1309","327","139","188","5","332","763","0","43.51","18.22"
"66","000","00","020","0006","1310","601","267","334","3","604","1267","0","47.67","21.07"
"66","000","00","020","0007","0000","1179","520","659","10","1189","2499","0","47.58","20.81"
"66","000","00","020","0007","1313","404","188","216","4","408","859","0","47.50","21.89"
"66","000","00","020","0007","1314","363","150","213","5","368","805","0","45.71","18.63"
"66","000","00","020","0007","1315","412","182","230","1","413","835","0","49.46","21.80"
"66","000","00","020","0008","0000","966","410","556","8","974","2244","0","43.40","18.27"
"66","000","00","020","0008","1316","513","210","303","5","518","1156","0","44.81","18.17"
"66","000","00","020","0008","1317","453","200","253","3","456","1088","0","41.91","18.38"
"66","000","00","020","0009","0000","3033","1253","1780","30","3063","6693","0","45.76","18.72"
"66","000","00","020","0009","1318","535","201","334","9","544","1158","0","46.98","17.36"
"66","000","00","020","0009","1319","431","163","268","5","436","1043","0","41.80","15.63"
"66","000","00","020","0009","1320","501","229","272","3","504","1172","0","43.00","19.54"
"66","000","00","020","0009","1321","671","243","428","10","681","1350","0","50.44","18.00"
"66","000","00","020","0009","1322","520","223","297","3","523","1089","0","48.03","20.48"
"66","000","00","020","0009","1323","375","194","181","0","375","881","0","42.57","22.02"
"66","000","00","020","0010","0000","2086","989","1097","19","2105","4732","0","44.48","20.90"
"66","000","00","020","0010","1324","547","256","291","7","554","1210","0","45.79","21.16"
"66","000","00","020","0010","1325","524","263","261","4","528","1164","0","45.36","22.59"
"66","000","00","020","0010","1326","524","242","282","3","527","1262","0","41.76","19.18"
"66","000","00","020","0010","1327","491","228","263","5","496","1096","0","45.26","20.80"
"66","000","00","020","0011","0000","1648","880","768","12","1660","3682","0","45.08","23.90"
"66","000","00","020","0011","1334","581","309","272","3","584","1306","0","44.72","23.66"
"66","000","00","020","0011","1335","516","250","266","4","520","1113","0","46.72","22.46"
"66","000","00","020","0011","1336","551","321","230","5","556","1263","0","44.02","25.42"
"66","000","00","020","0012","0000","1077","560","517","12","1089","2651","0","41.08","21.12"
"66","000","00","020","0012","1337","541","246","295","1","542","1307","0","41.47","18.82"
"66","000","00","020","0012","1338","536","314","222","11","547","1344","0","40.70","23.36"
"66","000","00","020","0013","0000","1675","1066","609","14","1689","3985","0","42.38","26.75"
"66","000","00","020","0013","1339","657","358","299","2","659","1410","0","46.74","25.39"
"66","000","00","020","0013","1340","441","247","194","6","447","1141","0","39.18","21.65"
"66","000","00","020","0013","1341","577","461","116","6","583","1434","0","40.66","32.15"
"66","000","00","020","0014","0000","760","511","249","7","767","1703","0","45.04","30.01"
"66","000","00","020","0014","1346","340","227","113","3","343","764","0","44.90","29.71"
"66","000","00","020","0014","1347","420","284","136","4","424","939","0","45.15","30.24"
"66","000","00","020","0015","0000","1837","1253","584","21","1858","4044","0","45.94","30.98"
"66","000","00","020","0015","1342","483","278","205","5","488","1172","0","41.64","23.72"
"66","000","00","020","0015","1343","435","361","74","4","439","914","0","48.03","39.50"
"66","000","00","020","0015","1344","492","281","211","8","500","993","0","50.35","28.30"
"66","000","00","020","0015","1345","427","333","94","4","431","965","0","44.66","34.51"
"66","000","00","020","0016","0000","3988","1759","2229","48","4036","8763","0","46.06","20.07"
"66","000","00","020","0016","1348","612","297","315","7","619","1254","0","49.36","23.68"
"66","000","00","020","0016","1349","595","238","357","7","602","1277","0","47.14","18.64"
"66","000","00","020","0016","1350","456","248","208","2","458","1276","0","35.89","19.44"
"66","000","00","020","0016","1351","585","246","339","11","596","1265","0","47.11","19.45"
"66","000","00","020","0016","1352","606","215","391","11","617","1258","0","49.05","17.09"
"66","000","00","020","0016","1353","523","231","292","5","528","1226","0","43.07","18.84"
"66","000","00","020","0016","1354","611","284","327","5","616","1207","0","51.04","23.53"
"66","000","00","020","0017","0000","3201","1463","1738","27","3228","7152","0","45.13","20.46"
"66","000","00","020","0017","1328","598","315","283","6","604","1228","0","49.19","25.65"
"66","000","00","020","0017","1329","452","188","264","2","454","1091","0","41.61","17.23"
"66","000","00","020","0017","1330","392","166","226","4","396","956","0","41.42","17.36"
"66","000","00","020","0017","1331","598","280","318","8","606","1293","0","46.87","21.66"
"66","000","00","020","0017","1332","613","258","355","2","615","1304","0","47.16","19.79"
"66","000","00","020","0017","1333","548","256","292","5","553","1280","0","43.20","20.00"
"66","000","00","030","0000","0000","46744","23410","23334","391","47135","105752","126574","44.57","22.14"
"66","000","00","030","0001","0000","1607","742","865","12","1619","3502","0","46.23","21.19"
"66","000","00","030","0001","1359","548","227","321","5","553","1194","0","46.31","19.01"
"66","000","00","030","0001","1360","532","265","267","5","537","1108","0","48.47","23.92"
"66","000","00","030","0001","1361","527","250","277","2","529","1200","0","44.08","20.83"
"66","000","00","030","0002","0000","1676","736","940","19","1695","3745","0","45.26","19.65"
"66","000","00","030","0002","1362","559","245","314","6","565","1213","0","46.58","20.20"
"66","000","00","030","0002","1363","542","242","300","6","548","1251","0","43.80","19.34"
"66","000","00","030","0002","1364","575","249","326","7","582","1281","0","45.43","19.44"
"66","000","00","030","0003","0000","1629","762","867","11","1640","3412","0","48.07","22.33"
"66","000","00","030","0003","1365","579","268","311","4","583","1156","0","50.43","23.18"
"66","000","00","030","0003","1366","574","280","294","5","579","1180","0","49.07","23.73"
"66","000","00","030","0003","1367","476","214","262","2","478","1076","0","44.42","19.89"
"66","000","00","030","0004","0000","1347","684","663","15","1362","2840","0","47.96","24.08"
"66","000","00","030","0004","1368","691","384","307","9","700","1361","0","51.43","28.21"
"66","000","00","030","0004","1369","656","300","356","6","662","1479","0","44.76","20.28"
"66","000","00","030","0005","0000","1149","511","638","9","1158","2506","0","46.21","20.39"
"66","000","00","030","0005","1370","524","221","303","5","529","1133","0","46.69","19.51"
"66","000","00","030","0005","1371","625","290","335","4","629","1373","0","45.81","21.12"
"66","000","00","030","0006","0000","1325","657","668","17","1342","2714","0","49.45","24.21"
"66","000","00","030","0006","1372","655","315","340","9","664","1324","0","50.15","23.79"
"66","000","00","030","0006","1373","670","342","328","8","678","1390","0","48.78","24.60"
"66","000","00","030","0007","0000","1902","1015","887","13","1915","4415","0","43.37","22.99"
"66","000","00","030","0007","1374","639","368","271","4","643","1505","0","42.72","24.45"
"66","000","00","030","0007","1375","650","344","306","7","657","1490","0","44.09","23.09"
"66","000","00","030","0007","1376","613","303","310","2","615","1420","0","43.31","21.34"
"66","000","00","030","0008","0000","1822","911","911","9","1831","3817","0","47.97","23.87"
"66","000","00","030","0008","1377","674","328","346","6","680","1314","0","51.75","24.96"
"66","000","00","030","0008","1378","610","271","339","2","612","1292","0","47.37","20.98"
"66","000","00","030","0008","1379","538","312","226","1","539","1211","0","44.51","25.76"
"66","000","00","030","0009","0000","2316","1123","1193","17","2333","5297","0","44.04","21.20"
"66","000","00","030","0009","1380","552","273","279","6","558","1305","0","42.76","20.92"
"66","000","00","030","0009","1381","622","313","309","3","625","1390","0","44.96","22.52"
"66","000","00","030","0009","1382","563","248","315","3","566","1292","0","43.81","19.20"
"66","000","00","030","0009","1383","579","289","290","5","584","1310","0","44.58","22.06"
"66","000","00","030","0010","0000","1555","770","785","13","1568","4091","0","38.33","18.82"
"66","000","00","030","0010","1388","607","284","323","4","611","1533","0","39.86","18.53"
"66","000","00","030","0010","1389","508","278","230","4","512","1216","0","42.11","22.86"
"66","000","00","030","0010","1390","440","208","232","5","445","1342","0","33.16","15.50"
"66","000","00","030","0011","0000","3510","1854","1656","29","3539","7871","0","44.96","23.55"
"66","000","00","030","0011","1399","468","248","220","5","473","1097","0","43.12","22.61"
"66","000","00","030","0011","1400","612","315","297","2","614","1260","0","48.73","25.00"
"66","000","00","030","0011","1401","595","328","267","5","600","1326","0","45.25","24.74"
"66","000","00","030","0011","1402","524","301","223","7","531","1330","0","39.92","22.63"
"66","000","00","030","0011","1403","600","306","294","4","604","1432","0","42.18","21.37"
"66","000","00","030","0011","1404","711","356","355","6","717","1426","0","50.28","24.96"
"66","000","00","030","0012","0000","5046","2509","2537","41","5087","11718","0","43.41","21.41"
"66","000","00","030","0012","1409","554","266","288","3","557","1458","0","38.20","18.24"
"66","000","00","030","0012","1410","569","311","258","3","572","1489","0","38.42","20.89"
"66","000","00","030","0012","1411","668","328","340","4","672","1437","0","46.76","22.83"
"66","000","00","030","0012","1412","709","344","365","10","719","1515","0","47.46","22.71"
"66","000","00","030","0012","1413","648","302","346","7","655","1498","0","43.72","20.16"
"66","000","00","030","0012","1414","604","317","287","5","609","1462","0","41.66","21.68"
"66","000","00","030","0012","1415","632","301","331","4","636","1435","0","44.32","20.98"
"66","000","00","030","0012","1416","662","340","322","5","667","1424","0","46.84","23.88"
"66","000","00","030","0013","0000","3748","1993","1755","40","3788","8372","0","45.25","23.81"
"66","000","00","030","0013","1422","598","308","290","6","604","1341","0","45.04","22.97"
"66","000","00","030","0013","1423","617","348","269","9","626","1430","0","43.78","24.34"
"66","000","00","030","0013","1424","648","345","303","5","653","1338","0","48.80","25.78"
"66","000","00","030","0013","1425","563","275","288","5","568","1309","0","43.39","21.01"
"66","000","00","030","0013","1426","625","353","272","5","630","1506","0","41.83","23.44"
"66","000","00","030","0013","1427","697","364","333","10","707","1448","0","48.83","25.14"
"66","000","00","030","0014","0000","1908","997","911","15","1923","4215","0","45.62","23.65"
"66","000","00","030","0014","1428","638","323","315","6","644","1390","0","46.33","23.24"
"66","000","00","030","0014","1429","623","310","313","6","629","1386","0","45.38","22.37"
"66","000","00","030","0014","1430","647","364","283","3","650","1439","0","45.17","25.30"
"66","000","00","030","0015","0000","894","419","475","11","905","1865","0","48.53","22.47"
"66","000","00","030","0015","1355","433","190","243","7","440","897","0","49.05","21.18"
"66","000","00","030","0015","1356","461","229","232","4","465","968","0","48.04","23.66"
"66","000","00","030","0016","0000","1159","553","606","15","1174","2394","0","49.04","23.10"
"66","000","00","030","0016","1357","567","277","290","6","573","1220","0","46.97","22.70"
"66","000","00","030","0016","1358","592","276","316","9","601","1174","0","51.19","23.51"
"66","000","00","030","0017","0000","2414","1217","1197","22","2436","5566","0","43.77","21.86"
"66","000","00","030","0017","1384","683","360","323","8","691","1394","0","49.57","25.82"
"66","000","00","030","0017","1385","582","288","294","5","587","1395","0","42.08","20.65"
"66","000","00","030","0017","1386","593","267","326","7","600","1330","0","45.11","20.08"
"66","000","00","030","0017","1387","556","302","254","2","558","1447","0","38.56","20.87"
"66","000","00","030","0018","0000","1506","694","812","16","1522","3459","0","44.00","20.06"
"66","000","00","030","0018","1391","508","232","276","7","515","1156","0","44.55","20.07"
"66","000","00","030","0018","1392","495","216","279","3","498","1165","0","42.75","18.54"
"66","000","00","030","0018","1393","503","246","257","6","509","1138","0","44.73","21.62"
"66","000","00","030","0019","0000","2985","1613","1372","20","3005","7374","0","40.75","21.87"
"66","000","00","030","0019","1394","683","373","310","5","688","1463","0","47.03","25.50"
"66","000","00","030","0019","1395","640","345","295","4","644","1961","0","32.84","17.59"
"66","000","00","030","0019","1396","541","277","264","3","544","1351","0","40.27","20.50"
"66","000","00","030","0019","1397","529","290","239","5","534","1339","0","39.88","21.66"
"66","000","00","030","0019","1398","592","328","264","3","595","1260","0","47.22","26.03"
"66","000","00","030","0020","0000","1953","970","983","10","1963","4610","0","42.58","21.04"
"66","000","00","030","0020","1405","483","237","246","3","486","1163","0","41.79","20.38"
"66","000","00","030","0020","1406","526","263","263","2","528","1243","0","42.48","21.16"
"66","000","00","030","0020","1407","490","241","249","2","492","1073","0","45.85","22.46"
"66","000","00","030","0020","1408","454","229","225","3","457","1131","0","40.41","20.25"
"66","000","00","030","0021","0000","2850","1492","1358","15","2865","6608","0","43.36","22.58"
"66","000","00","030","0021","1417","537","293","244","5","542","1367","0","39.65","21.43"
"66","000","00","030","0021","1418","557","285","272","3","560","1373","0","40.79","20.76"
"66","000","00","030","0021","1419","557","270","287","3","560","1360","0","41.18","19.85"
"66","000","00","030","0021","1420","674","366","308","4","678","1323","0","51.25","27.66"
"66","000","00","030","0021","1421","525","278","247","0","525","1185","0","44.30","23.46"
"66","000","00","030","0022","0000","2443","1188","1255","22","2465","5361","0","45.98","22.16"
"66","000","00","030","0022","1431","620","294","326","4","624","1259","0","49.56","23.35"
"66","000","00","030","0022","1432","631","300","331","9","640","1336","0","47.90","22.46"
"66","000","00","030","0022","1433","607","308","299","4","611","1358","0","44.99","22.68"
"66","000","00","030","0022","1434","585","286","299","5","590","1408","0","41.90","20.31"
"66","000","00","040","0000","0000","43119","21194","21925","376","43495","94273","113744","46.14","22.48"
"66","000","00","040","0001","0000","800","405","395","6","806","1694","0","47.58","23.91"
"66","000","00","040","0001","1210","365","186","179","2","367","787","0","46.63","23.63"
"66","000","00","040","0001","1211","435","219","216","4","439","907","0","48.40","24.15"
"66","000","00","040","0002","0000","622","362","260","8","630","1340","0","47.01","27.01"
"66","000","00","040","0002","1209","622","362","260","8","630","1340","0","47.01","27.01"
"66","000","00","040","0003","0000","806","419","387","0","806","2306","0","34.95","18.17"
"66","000","00","040","0003","1207","386","196","190","0","386","1504","0","25.66","13.03"
"66","000","00","040","0003","1208","420","223","197","0","420","802","0","52.37","27.81"
"66","000","00","040","0004","0000","1099","561","538","8","1107","2250","0","49.20","24.93"
"66","000","00","040","0004","1215","593","296","297","5","598","1175","0","50.89","25.19"
"66","000","00","040","0004","1216","506","265","241","3","509","1075","0","47.35","24.65"
"66","000","00","040","0005","0000","607","294","313","6","613","1370","0","44.74","21.46"
"66","000","00","040","0005","1212","607","294","313","6","613","1370","0","44.74","21.46"
"66","000","00","040","0006","0000","807","432","375","4","811","1840","0","44.08","23.48"
"66","000","00","040","0006","1213","429","241","188","2","431","967","0","44.57","24.92"
"66","000","00","040","0006","1214","378","191","187","2","380","873","0","43.53","21.88"
"66","000","00","040","0007","0000","2248","1071","1177","19","2267","4767","0","47.56","22.47"
"66","000","00","040","0007","1217","494","255","239","3","497","1078","0","46.10","23.65"
"66","000","00","040","0007","1218","568","271","297","5","573","1191","0","48.11","22.75"
"66","000","00","040","0007","1219","584","279","305","5","589","1233","0","47.77","22.63"
"66","000","00","040","0007","1220","602","266","336","6","608","1265","0","48.06","21.03"
"66","000","00","040","0008","0000","1842","936","906","24","1866","3884","0","48.04","24.10"
"66","000","00","040","0008","1221","618","306","312","6","624","1278","0","48.83","23.94"
"66","000","00","040","0008","1222","610","333","277","9","619","1306","0","47.40","25.50"
"66","000","00","040","0008","1223","614","297","317","9","623","1300","0","47.92","22.85"
"66","000","00","040","0009","0000","2514","1194","1320","19","2533","5582","0","45.38","21.39"
"66","000","00","040","0009","1224","644","311","333","7","651","1380","0","47.17","22.54"
"66","000","00","040","0009","1225","639","306","333","4","643","1356","0","47.42","22.57"
"66","000","00","040","0009","1226","520","265","255","1","521","1430","0","36.43","18.53"
"66","000","00","040","0009","1227","711","312","399","7","718","1416","0","50.71","22.03"
"66","000","00","040","0010","0000","984","433","551","13","997","2244","0","44.43","19.30"
"66","000","00","040","0010","1247","574","255","319","8","582","1271","0","45.79","20.06"
"66","000","00","040","0010","1248","410","178","232","5","415","973","0","42.65","18.29"
"66","000","00","040","0011","0000","1509","810","699","17","1526","3397","0","44.92","23.84"
"66","000","00","040","0011","1244","459","244","215","7","466","1021","0","45.64","23.90"
"66","000","00","040","0011","1245","670","359","311","2","672","1413","0","47.56","25.41"
"66","000","00","040","0011","1246","380","207","173","8","388","963","0","40.29","21.50"
"66","000","00","040","0012","0000","1486","701","785","14","1500","3447","0","43.52","20.34"
"66","000","00","040","0012","1249","432","200","232","3","435","1069","0","40.69","18.71"
"66","000","00","040","0012","1250","562","267","295","3","565","1208","0","46.77","22.10"
"66","000","00","040","0012","1251","492","234","258","8","500","1170","0","42.74","20.00"
"66","000","00","040","0013","0000","1370","667","703","14","1384","2776","0","49.86","24.03"
"66","000","00","040","0013","1228","640","336","304","6","646","1327","0","48.68","25.32"
"66","000","00","040","0013","1229","730","331","399","8","738","1449","0","50.93","22.84"
"66","000","00","040","0014","0000","2963","1534","1429","19","2982","6405","0","46.56","23.95"
"66","000","00","040","0014","1230","614","277","337","4","618","1318","0","46.89","21.02"
"66","000","00","040","0014","1231","601","333","268","4","605","1296","0","46.68","25.69"
"66","000","00","040","0014","1232","643","318","325","7","650","1282","0","50.70","24.80"
"66","000","00","040","0014","1233","582","319","263","3","585","1308","0","44.72","24.39"
"66","000","00","040","0014","1234","523","287","236","1","524","1201","0","43.63","23.90"
"66","000","00","040","0015","0000","2507","1180","1327","19","2526","5634","0","44.83","20.94"
"66","000","00","040","0015","1254","603","282","321","8","611","1433","0","42.64","19.68"
"66","000","00","040","0015","1255","611","273","338","0","611","1396","0","43.77","19.56"
"66","000","00","040","0015","1256","606","290","316","5","611","1385","0","44.12","20.94"
"66","000","00","040","0015","1257","687","335","352","6","693","1420","0","48.80","23.59"
"66","000","00","040","0016","0000","2677","1263","1414","22","2699","5653","0","47.74","22.34"
"66","000","00","040","0016","1275","517","227","290","3","520","1115","0","46.64","20.36"
"66","000","00","040","0016","1276","551","323","228","2","553","1117","0","49.51","28.92"
"66","000","00","040","0016","1277","534","254","280","4","538","1181","0","45.55","21.51"
"66","000","00","040","0016","1278","525","219","306","5","530","1082","0","48.98","20.24"
"66","000","00","040","0016","1279","550","240","310","8","558","1158","0","48.19","20.73"
"66","000","00","040","0017","0000","2914","1460","1454","28","2942","6172","0","47.67","23.66"
"66","000","00","040","0017","1266","524","266","258","4","528","1157","0","45.64","22.99"
"66","000","00","040","0017","1267","618","325","293","8","626","1252","0","50.00","25.96"
"66","000","00","040","0017","1268","552","247","305","5","557","1161","0","47.98","21.27"
"66","000","00","040","0017","1269","577","300","277","5","582","1270","0","45.83","23.62"
"66","000","00","040","0017","1270","643","322","321","6","649","1332","0","48.72","24.17"
"66","000","00","040","0018","0000","2566","1197","1369","24","2590","5619","0","46.09","21.30"
"66","000","00","040","0018","1235","432","216","216","3","435","904","0","48.12","23.89"
"66","000","00","040","0018","1236","518","228","290","10","528","1034","0","51.06","22.05"
"66","000","00","040","0018","1237","551","258","293","5","556","1267","0","43.88","20.36"
"66","000","00","040","0018","1238","512","223","289","2","514","1234","0","41.65","18.07"
"66","000","00","040","0018","1239","553","272","281","4","557","1180","0","47.20","23.05"
"66","000","00","040","0019","0000","2476","1173","1303","21","2497","5548","0","45.01","21.14"
"66","000","00","040","0019","1280","598","252","346","3","601","1416","0","42.44","17.80"
"66","000","00","040","0019","1281","614","276","338","6","620","1318","0","47.04","20.94"
"66","000","00","040","0019","1282","603","292","311","9","612","1398","0","43.78","20.89"
"66","000","00","040","0019","1283","661","353","308","3","664","1416","0","46.89","24.93"
"66","000","00","040","0020","0000","1262","557","705","14","1276","2725","0","46.83","20.44"
"66","000","00","040","0020","1261","652","293","359","7","659","1403","0","46.97","20.88"
"66","000","00","040","0020","1262","610","264","346","7","617","1322","0","46.67","19.97"
"66","000","00","040","0021","0000","1711","739","972","16","1727","3518","0","49.09","21.01"
"66","000","00","040","0021","1258","534","234","300","5","539","1148","0","46.95","20.38"
"66","000","00","040","0021","1259","621","263","358","8","629","1258","0","50.00","20.91"
"66","000","00","040","0021","1260","556","242","314","3","559","1112","0","50.27","21.76"
"66","000","00","040","0022","0000","2119","1119","1000","14","2133","4905","0","43.49","22.81"
"66","000","00","040","0022","1271","531","251","280","3","534","1220","0","43.77","20.57"
"66","000","00","040","0022","1272","535","260","275","3","538","1239","0","43.42","20.98"
"66","000","00","040","0022","1273","517","287","230","4","521","1213","0","42.95","23.66"
"66","000","00","040","0022","1274","536","321","215","4","540","1233","0","43.80","26.03"
"66","000","00","040","0023","0000","1865","946","919","19","1884","4170","0","45.18","22.69"
"66","000","00","040","0023","1263","617","312","305","7","624","1395","0","44.73","22.37"
"66","000","00","040","0023","1264","590","294","296","5","595","1372","0","43.37","21.43"
"66","000","00","040","0023","1265","658","340","318","7","665","1403","0","47.40","24.23"
"66","000","00","040","0024","0000","1240","645","595","10","1250","2712","0","46.09","23.78"
"66","000","00","040","0024","1252","585","302","283","2","587","1310","0","44.81","23.05"
"66","000","00","040","0024","1253","655","343","312","8","663","1402","0","47.29","24.47"
"66","000","00","040","0025","0000","2125","1096","1029","18","2143","4315","0","49.66","25.40"
"66","000","00","040","0025","1240","607","356","251","6","613","1135","0","54.01","31.37"
"66","000","00","040","0025","1241","470","250","220","1","471","1074","0","43.85","23.28"
"66","000","00","040","0025","1242","523","238","285","5","528","1079","0","48.93","22.06"
"66","000","00","040","0025","1243","525","252","273","6","531","1027","0","51.70","24.54"
"66","000","00","050","0000","0000","54394","28205","26189","467","54861","124160","145438","44.19","22.72"
"66","000","00","050","0001","0000","838","390","448","14","852","2049","0","41.58","19.03"
"66","000","00","050","0001","1111","428","197","231","5","433","1064","0","40.70","18.52"
"66","000","00","050","0001","1112","410","193","217","9","419","985","0","42.54","19.59"
"66","000","00","050","0002","0000","1615","1013","602","23","1638","3331","0","49.17","30.41"
"66","000","00","050","0002","1113","459","216","243","5","464","924","0","50.22","23.38"
"66","000","00","050","0002","1114","426","232","194","9","435","960","0","45.31","24.17"
"66","000","00","050","0002","1115","730","565","165","9","739","1447","0","51.07","39.05"
"66","000","00","050","0003","0000","563","231","332","6","569","1343","0","42.37","17.20"
"66","000","00","050","0003","1118","563","231","332","6","569","1343","0","42.37","17.20"
"66","000","00","050","0004","0000","614","357","257","7","621","1453","0","42.74","24.57"
"66","000","00","050","0004","1123","308","203","105","1","309","705","0","43.83","28.79"
"66","000","00","050","0004","1124","306","154","152","6","312","748","0","41.71","20.59"
"66","000","00","050","0005","0000","774","371","403","7","781","1655","0","47.19","22.42"
"66","000","00","050","0005","1121","345","174","171","3","348","683","0","50.95","25.48"
"66","000","00","050","0005","1122","429","197","232","4","433","972","0","44.55","20.27"
"66","000","00","050","0006","0000","1150","892","258","12","1162","2490","0","46.67","35.82"
"66","000","00","050","0006","1125","687","561","126","6","693","1389","0","49.89","40.39"
"66","000","00","050","0006","1126","463","331","132","6","469","1101","0","42.60","30.06"
"66","000","00","050","0007","0000","1504","780","724","10","1514","3071","0","49.30","25.40"
"66","000","00","050","0007","1127","810","403","407","6","816","1685","0","48.43","23.92"
"66","000","00","050","0007","1128","694","377","317","4","698","1386","0","50.36","27.20"
"66","000","00","050","0008","0000","2294","1136","1158","20","2314","5570","0","41.54","20.39"
"66","000","00","050","0008","1129","558","219","339","7","565","1271","0","44.45","17.23"
"66","000","00","050","0008","1130","456","189","267","3","459","1026","0","44.74","18.42"
"66","000","00","050","0008","1131","673","379","294","7","680","1714","0","39.67","22.11"
"66","000","00","050","0008","1132","607","349","258","3","610","1559","0","39.13","22.39"
"66","000","00","050","0009","0000","1452","822","630","16","1468","3236","0","45.36","25.40"
"66","000","00","050","0009","1136","441","230","211","8","449","1042","0","43.09","22.07"
"66","000","00","050","0009","1137","517","300","217","2","519","1138","0","45.61","26.36"
"66","000","00","050","0009","1138","494","292","202","6","500","1056","0","47.35","27.65"
"66","000","00","050","0010","0000","1174","652","522","9","1183","2501","0","47.30","26.07"
"66","000","00","050","0010","1142","559","314","245","2","561","1200","0","46.75","26.17"
"66","000","00","050","0010","1143","615","338","277","7","622","1301","0","47.81","25.98"
"66","000","00","050","0011","0000","1847","964","883","12","1859","4247","0","43.77","22.70"
"66","000","00","050","0011","1144","624","337","287","2","626","1375","0","45.53","24.51"
"66","000","00","050","0011","1145","623","330","293","6","629","1426","0","44.11","23.14"
"66","000","00","050","0011","1146","600","297","303","4","604","1446","0","41.77","20.54"
"66","000","00","050","0012","0000","991","507","484","9","1000","2256","0","44.33","22.47"
"66","000","00","050","0012","1147","491","252","239","6","497","1194","0","41.62","21.11"
"66","000","00","050","0012","1148","500","255","245","3","503","1062","0","47.36","24.01"
"66","000","00","050","0013","0000","2459","1190","1269","14","2473","5454","0","45.34","21.82"
"66","000","00","050","0013","1149","511","267","244","4","515","1184","0","43.50","22.55"
"66","000","00","050","0013","1150","566","265","301","1","567","1203","0","47.13","22.03"
"66","000","00","050","0013","1151","511","244","267","6","517","1053","0","49.10","23.17"
"66","000","00","050","0013","1152","440","210","230","1","441","1030","0","42.82","20.39"
"66","000","00","050","0013","1153","431","204","227","2","433","984","0","44.00","20.73"
"66","000","00","050","0014","0000","1860","986","874","23","1883","4109","0","45.83","24.00"
"66","000","00","050","0014","1154","537","285","252","4","541","1231","0","43.95","23.15"
"66","000","00","050","0014","1155","675","334","341","13","688","1467","0","46.90","22.77"
"66","000","00","050","0014","1156","648","367","281","6","654","1411","0","46.35","26.01"
"66","000","00","050","0015","0000","1712","966","746","12","1724","5017","0","34.36","19.25"
"66","000","00","050","0015","1160","461","259","202","0","461","2015","0","22.88","12.85"
"66","000","00","050","0015","1161","671","395","276","5","676","1543","0","43.81","25.60"
"66","000","00","050","0015","1162","580","312","268","7","587","1459","0","40.23","21.38"
"66","000","00","050","0016","0000","1923","884","1039","17","1940","4300","0","45.12","20.56"
"66","000","00","050","0016","1177","598","255","343","3","601","1308","0","45.95","19.50"
"66","000","00","050","0016","1178","639","298","341","5","644","1403","0","45.90","21.24"
"66","000","00","050","0016","1179","686","331","355","9","695","1589","0","43.74","20.83"
"66","000","00","050","0017","0000","1657","847","810","10","1667","3585","0","46.50","23.63"
"66","000","00","050","0017","1180","725","393","332","4","729","1496","0","48.73","26.27"
"66","000","00","050","0017","1181","388","180","208","3","391","929","0","42.09","19.38"
"66","000","00","050","0017","1182","544","274","270","3","547","1160","0","47.16","23.62"
"66","000","00","050","0018","0000","2260","1122","1138","19","2279","5018","0","45.42","22.36"
"66","000","00","050","0018","1183","649","335","314","6","655","1456","0","44.99","23.01"
"66","000","00","050","0018","1184","488","242","246","6","494","1137","0","43.45","21.28"
"66","000","00","050","0018","1185","605","275","330","2","607","1255","0","48.37","21.91"
"66","000","00","050","0018","1186","518","270","248","5","523","1170","0","44.70","23.08"
"66","000","00","050","0019","0000","1138","577","561","11","1149","2573","0","44.66","22.43"
"66","000","00","050","0019","1205","591","283","308","7","598","1352","0","44.23","20.93"
"66","000","00","050","0019","1206","547","294","253","4","551","1221","0","45.13","24.08"
"66","000","00","050","0020","0000","1964","1089","875","14","1978","4459","0","44.36","24.42"
"66","000","00","050","0020","1139","647","341","306","9","656","1555","0","42.19","21.93"
"66","000","00","050","0020","1140","657","374","283","3","660","1501","0","43.97","24.92"
"66","000","00","050","0020","1141","660","374","286","2","662","1403","0","47.18","26.66"
"66","000","00","050","0021","0000","3057","1412","1645","26","3083","6438","0","47.89","21.93"
"66","000","00","050","0021","1187","661","320","341","3","664","1313","0","50.57","24.37"
"66","000","00","050","0021","1188","497","235","262","4","501","1049","0","47.76","22.40"
"66","000","00","050","0021","1189","580","274","306","5","585","1266","0","46.21","21.64"
"66","000","00","050","0021","1190","629","268","361","6","635","1265","0","50.20","21.19"
"66","000","00","050","0021","1191","690","315","375","8","698","1545","0","45.18","20.39"
"66","000","00","050","0022","0000","2314","1171","1143","22","2336","5217","0","44.78","22.45"
"66","000","00","050","0022","1192","565","276","289","3","568","1313","0","43.26","21.02"
"66","000","00","050","0022","1193","623","301","322","6","629","1343","0","46.84","22.41"
"66","000","00","050","0022","1194","582","310","272","8","590","1302","0","45.31","23.81"
"66","000","00","050","0022","1195","544","284","260","5","549","1259","0","43.61","22.56"
"66","000","00","050","0023","0000","2565","1269","1296","24","2589","5993","0","43.20","21.17"
"66","000","00","050","0023","1198","600","286","314","2","602","1457","0","41.32","19.63"
"66","000","00","050","0023","1199","616","305","311","4","620","1455","0","42.61","20.96"
"66","000","00","050","0023","1200","706","371","335","5","711","1524","0","46.65","24.34"
"66","000","00","050","0023","1201","643","307","336","13","656","1557","0","42.13","19.72"
"66","000","00","050","0024","0000","1574","867","707","13","1587","3763","0","42.17","23.04"
"66","000","00","050","0024","1172","561","301","260","2","563","1240","0","45.40","24.27"
"66","000","00","050","0024","1173","498","307","191","2","500","1282","0","39.00","23.95"
"66","000","00","050","0024","1174","515","259","256","9","524","1241","0","42.22","20.87"
"66","000","00","050","0025","0000","1643","941","702","12","1655","3730","0","44.37","25.23"
"66","000","00","050","0025","1166","575","313","262","3","578","1420","0","40.70","22.04"
"66","000","00","050","0025","1167","527","299","228","5","532","1153","0","46.14","25.93"
"66","000","00","050","0025","1168","541","329","212","4","545","1157","0","47.10","28.44"
"66","000","00","050","0026","0000","574","224","350","4","578","1309","0","44.16","17.11"
"66","000","00","050","0026","1109","574","224","350","4","578","1309","0","44.16","17.11"
"66","000","00","050","0027","0000","675","258","417","4","679","1727","0","39.32","14.94"
"66","000","00","050","0027","1110","675","258","417","4","679","1727","0","39.32","14.94"
"66","000","00","050","0028","0000","818","325","493","8","826","2153","0","38.37","15.10"
"66","000","00","050","0028","1116","461","176","285","5","466","1267","0","36.78","13.89"
"66","000","00","050","0028","1117","357","149","208","3","360","886","0","40.63","16.82"
"66","000","00","050","0029","0000","778","361","417","5","783","1840","0","42.55","19.62"
"66","000","00","050","0029","1119","423","228","195","4","427","994","0","42.96","22.94"
"66","000","00","050","0029","1120","355","133","222","1","356","846","0","42.08","15.72"
"66","000","00","050","0030","0000","1558","820","738","15","1573","3229","0","48.71","25.39"
"66","000","00","050","0030","1133","458","231","227","3","461","1044","0","44.16","22.13"
"66","000","00","050","0030","1134","563","313","250","8","571","1091","0","52.34","28.69"
"66","000","00","050","0030","1135","537","276","261","4","541","1094","0","49.45","25.23"
"66","000","00","050","0031","0000","1449","735","714","6","1455","3417","0","42.58","21.51"
"66","000","00","050","0031","1157","466","238","228","3","469","1113","0","42.14","21.38"
"66","000","00","050","0031","1158","498","244","254","2","500","1140","0","43.86","21.40"
"66","000","00","050","0031","1159","485","253","232","1","486","1164","0","41.75","21.74"
"66","000","00","050","0032","0000","1657","875","782","9","1666","4259","0","39.12","20.54"
"66","000","00","050","0032","1169","457","249","208","3","460","1162","0","39.59","21.43"
"66","000","00","050","0032","1170","618","325","293","3","621","1634","0","38.00","19.89"
"66","000","00","050","0032","1171","582","301","281","3","585","1463","0","39.99","20.57"
"66","000","00","050","0033","0000","1157","623","534","21","1178","2661","0","44.27","23.41"
"66","000","00","050","0033","1196","589","334","255","11","600","1340","0","44.78","24.93"
"66","000","00","050","0033","1197","568","289","279","10","578","1321","0","43.75","21.88"
"66","000","00","050","0034","0000","1552","852","700","11","1563","3755","0","41.62","22.69"
"66","000","00","050","0034","1202","504","272","232","3","507","1190","0","42.61","22.86"
"66","000","00","050","0034","1203","548","304","244","5","553","1292","0","42.80","23.53"
"66","000","00","050","0034","1204","500","276","224","3","503","1273","0","39.51","21.68"
"66","000","00","050","0035","0000","1395","731","664","11","1406","3190","0","44.08","22.92"
"66","000","00","050","0035","1175","681","378","303","6","687","1578","0","43.54","23.95"
"66","000","00","050","0035","1176","714","353","361","5","719","1612","0","44.60","21.90"
"66","000","00","050","0036","0000","1839","965","874","11","1850","3762","0","49.18","25.65"
"66","000","00","050","0036","1163","713","378","335","5","718","1327","0","54.11","28.49"
"66","000","00","050","0036","1164","605","308","297","2","607","1318","0","46.05","23.37"
"66","000","00","050","0036","1165","521","279","242","4","525","1117","0","47.00","24.98"
"66","000","00","060","0000","0000","80763","42611","38152","775","81538","188793","231415","43.19","22.57"
"66","000","00","060","0001","0000","2256","1143","1113","21","2277","5165","0","44.09","22.13"
"66","000","00","060","0001","0668","539","262","277","8","547","1268","0","43.14","20.66"
"66","000","00","060","0001","0669","576","289","287","2","578","1310","0","44.12","22.06"
"66","000","00","060","0001","0670","494","228","266","6","500","1079","0","46.34","21.13"
"66","000","00","060","0001","0671","647","364","283","5","652","1508","0","43.24","24.14"
"66","000","00","060","0002","0000","2430","1171","1259","18","2448","5884","0","41.60","19.90"
"66","000","00","060","0002","0679","499","208","291","6","505","1176","0","42.94","17.69"
"66","000","00","060","0002","0680","476","225","251","5","481","1159","0","41.50","19.41"
"66","000","00","060","0002","0681","495","243","252","3","498","1179","0","42.24","20.61"
"66","000","00","060","0002","0682","503","257","246","4","507","1207","0","42.00","21.29"
"66","000","00","060","0002","0683","457","238","219","0","457","1163","0","39.29","20.46"
"66","000","00","060","0003","0000","2272","1126","1146","24","2296","6268","0","36.63","17.96"
"66","000","00","060","0003","0684","545","294","251","6","551","1438","0","38.32","20.45"
"66","000","00","060","0003","0685","568","269","299","7","575","1406","0","40.90","19.13"
"66","000","00","060","0003","0686","644","298","346","6","650","1318","0","49.32","22.61"
"66","000","00","060","0003","0687","515","265","250","5","520","2106","0","24.69","12.58"
"66","000","00","060","0004","0000","408","158","250","8","416","833","0","49.94","18.97"
"66","000","00","060","0004","0688","408","158","250","8","416","833","0","49.94","18.97"
"66","000","00","060","0005","0000","6210","3281","2929","53","6263","14638","0","42.79","22.41"
"66","000","00","060","0005","0689","529","296","233","2","531","1292","0","41.10","22.91"
"66","000","00","060","0005","0690","516","295","221","0","516","1309","0","39.42","22.54"
"66","000","00","060","0005","0691","543","283","260","4","547","1331","0","41.10","21.26"
"66","000","00","060","0005","0692","522","277","245","4","526","1316","0","39.97","21.05"
"66","000","00","060","0005","0693","542","294","248","6","548","1309","0","41.86","22.46"
"66","000","00","060","0005","0694","647","312","335","10","657","1497","0","43.89","20.84"
"66","000","00","060","0005","0695","548","304","244","5","553","1271","0","43.51","23.92"
"66","000","00","060","0005","0696","762","387","375","7","769","1704","0","45.13","22.71"
"66","000","00","060","0005","0697","506","271","235","8","514","1229","0","41.82","22.05"
"66","000","00","060","0005","0698","591","286","305","5","596","1213","0","49.13","23.58"
"66","000","00","060","0005","0699","504","276","228","2","506","1167","0","43.36","23.65"
"66","000","00","060","0006","0000","1972","1056","916","21","1993","5016","0","39.73","21.05"
"66","000","00","060","0006","0700","515","286","229","0","515","1290","0","39.92","22.17"
"66","000","00","060","0006","0701","478","243","235","7","485","1201","0","40.38","20.23"
"66","000","00","060","0006","0702","478","264","214","4","482","1236","0","39.00","21.36"
"66","000","00","060","0006","0703","501","263","238","10","511","1289","0","39.64","20.40"
"66","000","00","060","0007","0000","1752","933","819","9","1761","4314","0","40.82","21.63"
"66","000","00","060","0007","0711","579","325","254","2","581","1517","0","38.30","21.42"
"66","000","00","060","0007","0712","577","310","267","7","584","1383","0","42.23","22.42"
"66","000","00","060","0007","0713","596","298","298","0","596","1414","0","42.15","21.07"
"66","000","00","060","0008","0000","1240","1061","179","17","1257","2619","0","48.00","40.51"
"66","000","00","060","0008","0718","632","544","88","8","640","1334","0","47.98","40.78"
"66","000","00","060","0008","0719","608","517","91","9","617","1285","0","48.02","40.23"
"66","000","00","060","0009","0000","2191","1071","1120","25","2216","5075","0","43.67","21.10"
"66","000","00","060","0009","0734","594","278","316","7","601","1329","0","45.22","20.92"
"66","000","00","060","0009","0735","529","279","250","5","534","1247","0","42.82","22.37"
"66","000","00","060","0009","0736","540","260","280","4","544","1331","0","40.87","19.53"
"66","000","00","060","0009","0737","528","254","274","9","537","1168","0","45.98","21.75"
"66","000","00","060","0010","0000","1353","631","722","8","1361","3200","0","42.53","19.72"
"66","000","00","060","0010","0720","444","214","230","3","447","1041","0","42.94","20.56"
"66","000","00","060","0010","0721","458","215","243","3","461","1017","0","45.33","21.14"
"66","000","00","060","0010","0722","451","202","249","2","453","1142","0","39.67","17.69"
"66","000","00","060","0011","0000","1795","769","1026","19","1814","3726","0","48.68","20.64"
"66","000","00","060","0011","0754","578","248","330","8","586","1232","0","47.56","20.13"
"66","000","00","060","0011","0755","646","264","382","6","652","1225","0","53.22","21.55"
"66","000","00","060","0011","0756","571","257","314","5","576","1269","0","45.39","20.25"
"66","000","00","060","0012","0000","1020","868","152","21","1041","2082","0","50.00","41.69"
"66","000","00","060","0012","0757","504","432","72","6","510","1013","0","50.35","42.65"
"66","000","00","060","0012","0758","516","436","80","15","531","1069","0","49.67","40.79"
"66","000","00","060","0013","0000","1361","781","580","12","1373","3255","0","42.18","23.99"
"66","000","00","060","0013","0759","423","237","186","6","429","1038","0","41.33","22.83"
"66","000","00","060","0013","0760","419","213","206","3","422","1068","0","39.51","19.94"
"66","000","00","060","0013","0761","519","331","188","3","522","1149","0","45.43","28.81"
"66","000","00","060","0014","0000","1994","1118","876","13","2007","4745","0","42.30","23.56"
"66","000","00","060","0014","0762","588","313","275","4","592","1226","0","48.29","25.53"
"66","000","00","060","0014","0763","490","300","190","4","494","1220","0","40.49","24.59"
"66","000","00","060","0014","0764","551","294","257","3","554","1331","0","41.62","22.09"
"66","000","00","060","0014","0765","365","211","154","2","367","968","0","37.91","21.80"
"66","000","00","060","0015","0000","2124","1025","1099","18","2142","4944","0","43.33","20.73"
"66","000","00","060","0015","0766","474","177","297","8","482","1149","0","41.95","15.40"
"66","000","00","060","0015","0767","573","307","266","5","578","1282","0","45.09","23.95"
"66","000","00","060","0015","0768","529","282","247","2","531","1213","0","43.78","23.25"
"66","000","00","060","0015","0769","548","259","289","3","551","1300","0","42.38","19.92"
"66","000","00","060","0016","0000","1045","439","606","8","1053","2324","0","45.31","18.89"
"66","000","00","060","0016","0770","563","218","345","6","569","1257","0","45.27","17.34"
"66","000","00","060","0016","0771","482","221","261","2","484","1067","0","45.36","20.71"
"66","000","00","060","0017","0000","1428","760","668","14","1442","3398","0","42.44","22.37"
"66","000","00","060","0017","0772","533","318","215","3","536","1117","0","47.99","28.47"
"66","000","00","060","0017","0773","485","227","258","7","492","1182","0","41.62","19.20"
"66","000","00","060","0017","0774","410","215","195","4","414","1099","0","37.67","19.56"
"66","000","00","060","0018","0000","4984","2657","2327","47","5031","12696","0","39.63","20.93"
"66","000","00","060","0018","0775","658","273","385","8","666","1561","0","42.66","17.49"
"66","000","00","060","0018","0776","635","364","271","6","641","1432","0","44.76","25.42"
"66","000","00","060","0018","0777","595","291","304","3","598","1367","0","43.75","21.29"
"66","000","00","060","0018","0778","533","329","204","5","538","1387","0","38.79","23.72"
"66","000","00","060","0018","0779","521","257","264","2","523","1356","0","38.57","18.95"
"66","000","00","060","0018","0780","559","308","251","7","566","1397","0","40.52","22.05"
"66","000","00","060","0018","0781","495","290","205","5","500","1400","0","35.71","20.71"
"66","000","00","060","0018","0782","492","286","206","8","500","1401","0","35.69","20.41"
"66","000","00","060","0018","0783","496","259","237","3","499","1395","0","35.77","18.57"
"66","000","00","060","0019","0000","1349","700","649","14","1363","2940","0","46.36","23.81"
"66","000","00","060","0019","0784","696","357","339","7","703","1552","0","45.30","23.00"
"66","000","00","060","0019","0785","653","343","310","7","660","1388","0","47.55","24.71"
"66","000","00","060","0020","0000","1931","892","1039","18","1949","4642","0","41.99","19.22"
"66","000","00","060","0020","0810","513","235","278","7","520","1253","0","41.50","18.75"
"66","000","00","060","0020","0811","491","195","296","4","495","1123","0","44.08","17.36"
"66","000","00","060","0020","0812","442","231","211","5","447","1130","0","39.56","20.44"
"66","000","00","060","0020","0813","485","231","254","2","487","1136","0","42.87","20.33"
"66","000","00","060","0021","0000","2654","1303","1351","22","2676","6083","0","43.99","21.42"
"66","000","00","060","0021","0738","603","321","282","5","608","1478","0","41.14","21.72"
"66","000","00","060","0021","0739","634","297","337","5","639","1405","0","45.48","21.14"
"66","000","00","060","0021","0740","612","294","318","4","616","1367","0","45.06","21.51"
"66","000","00","060","0021","0741","386","184","202","1","387","890","0","43.48","20.67"
"66","000","00","060","0021","0742","419","207","212","7","426","943","0","45.17","21.95"
"66","000","00","060","0022","0000","1566","784","782","19","1585","3633","0","43.63","21.58"
"66","000","00","060","0022","0743","528","264","264","5","533","1229","0","43.37","21.48"
"66","000","00","060","0022","0744","542","272","270","6","548","1171","0","46.80","23.23"
"66","000","00","060","0022","0745","496","248","248","8","504","1233","0","40.88","20.11"
"66","000","00","060","0023","0000","2865","1539","1326","29","2894","6639","0","43.59","23.18"
"66","000","00","060","0023","0749","536","280","256","8","544","1243","0","43.77","22.53"
"66","000","00","060","0023","0750","561","302","259","2","563","1257","0","44.79","24.03"
"66","000","00","060","0023","0751","562","291","271","5","567","1319","0","42.99","22.06"
"66","000","00","060","0023","0752","629","353","276","8","637","1430","0","44.55","24.69"
"66","000","00","060","0023","0753","577","313","264","6","583","1390","0","41.94","22.52"
"66","000","00","060","0024","0000","1965","1197","768","14","1979","4807","0","41.17","24.90"
"66","000","00","060","0024","0675","459","299","160","0","459","1133","0","40.51","26.39"
"66","000","00","060","0024","0676","514","285","229","3","517","1296","0","39.89","21.99"
"66","000","00","060","0024","0677","570","418","152","9","579","1232","0","47.00","33.93"
"66","000","00","060","0024","0678","422","195","227","2","424","1146","0","37.00","17.02"
"66","000","00","060","0025","0000","1964","1048","916","17","1981","4097","0","48.35","25.58"
"66","000","00","060","0025","0726","644","350","294","6","650","1333","0","48.76","26.26"
"66","000","00","060","0025","0727","683","387","296","6","689","1386","0","49.71","27.92"
"66","000","00","060","0025","0728","637","311","326","5","642","1378","0","46.59","22.57"
"66","000","00","060","0026","0000","1896","1011","885","31","1927","4381","0","43.99","23.08"
"66","000","00","060","0026","0672","683","391","292","14","697","1616","0","43.13","24.20"
"66","000","00","060","0026","0673","569","296","273","7","576","1292","0","44.58","22.91"
"66","000","00","060","0026","0674","644","324","320","10","654","1473","0","44.40","22.00"
"66","000","00","060","0027","0000","2299","1210","1089","25","2324","5223","0","44.50","23.17"
"66","000","00","060","0027","0704","639","328","311","3","642","1385","0","46.35","23.68"
"66","000","00","060","0027","0705","561","266","295","9","570","1303","0","43.75","20.41"
"66","000","00","060","0027","0706","527","303","224","6","533","1286","0","41.45","23.56"
"66","000","00","060","0027","0707","572","313","259","7","579","1249","0","46.36","25.06"
"66","000","00","060","0028","0000","1867","1046","821","19","1886","4120","0","45.78","25.39"
"66","000","00","060","0028","0708","664","354","310","10","674","1380","0","48.84","25.65"
"66","000","00","060","0028","0709","572","330","242","4","576","1350","0","42.67","24.44"
"66","000","00","060","0028","0710","631","362","269","5","636","1390","0","45.76","26.04"
"66","000","00","060","0029","0000","2434","1344","1090","16","2450","5257","0","46.60","25.57"
"66","000","00","060","0029","0714","656","329","327","6","662","1425","0","46.46","23.09"
"66","000","00","060","0029","0715","598","344","254","5","603","1214","0","49.67","28.34"
"66","000","00","060","0029","0716","613","358","255","2","615","1307","0","47.05","27.39"
"66","000","00","060","0029","0717","567","313","254","3","570","1311","0","43.48","23.87"
"66","000","00","060","0030","0000","1688","833","855","10","1698","3558","0","47.72","23.41"
"66","000","00","060","0030","0723","616","281","335","0","616","1179","0","52.25","23.83"
"66","000","00","060","0030","0724","542","280","262","4","546","1194","0","45.73","23.45"
"66","000","00","060","0030","0725","530","272","258","6","536","1185","0","45.23","22.95"
"66","000","00","060","0031","0000","3064","1538","1526","26","3090","7080","0","43.64","21.72"
"66","000","00","060","0031","0729","649","325","324","3","652","1438","0","45.34","22.60"
"66","000","00","060","0031","0730","590","293","297","3","593","1449","0","40.92","20.22"
"66","000","00","060","0031","0731","621","300","321","6","627","1402","0","44.72","21.40"
"66","000","00","060","0031","0732","642","317","325","5","647","1403","0","46.12","22.59"
"66","000","00","060","0031","0733","562","303","259","9","571","1388","0","41.14","21.83"
"66","000","00","060","0032","0000","1959","943","1016","15","1974","4322","0","45.67","21.82"
"66","000","00","060","0032","0746","644","331","313","2","646","1423","0","45.40","23.26"
"66","000","00","060","0032","0747","659","312","347","9","668","1428","0","46.78","21.85"
"66","000","00","060","0032","0748","656","300","356","4","660","1471","0","44.87","20.39"
"66","000","00","060","0033","0000","1759","737","1022","19","1778","4278","0","41.56","17.23"
"66","000","00","060","0033","0800","628","256","372","7","635","1474","0","43.08","17.37"
"66","000","00","060","0033","0801","578","229","349","8","586","1430","0","40.98","16.01"
"66","000","00","060","0033","0802","553","252","301","4","557","1374","0","40.54","18.34"
"66","000","00","060","0034","0000","1378","702","676","11","1389","3203","0","43.37","21.92"
"66","000","00","060","0034","0803","503","265","238","3","506","1105","0","45.79","23.98"
"66","000","00","060","0034","0804","467","243","224","4","471","1048","0","44.94","23.19"
"66","000","00","060","0034","0805","408","194","214","4","412","1050","0","39.24","18.48"
"66","000","00","060","0035","0000","2241","1250","991","28","2269","4778","0","47.49","26.16"
"66","000","00","060","0035","0806","572","316","256","5","577","1252","0","46.09","25.24"
"66","000","00","060","0035","0807","536","299","237","5","541","1183","0","45.73","25.27"
"66","000","00","060","0035","0808","543","322","221","6","549","1195","0","45.94","26.95"
"66","000","00","060","0035","0809","590","313","277","12","602","1148","0","52.44","27.26"
"66","000","00","060","0036","0000","1111","616","495","19","1130","3166","0","35.69","19.46"
"66","000","00","060","0036","0798","571","330","241","10","581","1626","0","35.73","20.30"
"66","000","00","060","0036","0799","540","286","254","9","549","1540","0","35.65","18.57"
"66","000","00","060","0037","0000","1116","666","450","13","1129","2980","0","37.89","22.35"
"66","000","00","060","0037","0796","586","348","238","5","591","1523","0","38.80","22.85"
"66","000","00","060","0037","0797","530","318","212","8","538","1457","0","36.93","21.83"
"66","000","00","060","0038","0000","3358","1857","1501","38","3396","7655","0","44.36","24.26"
"66","000","00","060","0038","0790","498","272","226","2","500","1275","0","39.22","21.33"
"66","000","00","060","0038","0791","567","333","234","11","578","1255","0","46.06","26.53"
"66","000","00","060","0038","0792","623","324","299","6","629","1404","0","44.80","23.08"
"66","000","00","060","0038","0793","556","277","279","8","564","1235","0","45.67","22.43"
"66","000","00","060","0038","0794","593","350","243","8","601","1274","0","47.17","27.47"
"66","000","00","060","0038","0795","521","301","220","3","524","1212","0","43.23","24.83"
"66","000","00","060","0039","0000","2464","1347","1117","16","2480","5769","0","42.99","23.35"
"66","000","00","060","0039","0786","624","329","295","4","628","1410","0","44.54","23.33"
"66","000","00","060","0039","0787","636","346","290","0","636","1394","0","45.62","24.82"
"66","000","00","060","0039","0788","638","342","296","11","649","1541","0","42.12","22.19"
"66","000","00","060","0039","0789","566","330","236","1","567","1424","0","39.82","23.17"
"66","000","00","070","0000","0000","62025","31205","30820","566","62591","142512","176754","43.92","21.90"
"66","000","00","070","0001","0000","3790","1871","1919","41","3831","8528","0","44.92","21.94"
"66","000","00","070","0001","0814","534","284","250","9","543","1220","0","44.51","23.28"
"66","000","00","070","0001","0815","552","250","302","5","557","1255","0","44.38","19.92"
"66","000","00","070","0001","0816","490","181","309","9","499","1129","0","44.20","16.03"
"66","000","00","070","0001","0817","615","267","348","4","619","1326","0","46.68","20.14"
"66","000","00","070","0001","0818","564","306","258","5","569","1272","0","44.73","24.06"
"66","000","00","070","0001","0819","560","324","236","5","565","1203","0","46.97","26.93"
"66","000","00","070","0001","0820","475","259","216","4","479","1123","0","42.65","23.06"
"66","000","00","070","0002","0000","5222","2572","2650","44","5266","11358","0","46.36","22.64"
"66","000","00","070","0002","0821","591","255","336","9","600","1414","0","42.43","18.03"
"66","000","00","070","0002","0822","618","286","332","7","625","1396","0","44.77","20.49"
"66","000","00","070","0002","0823","727","379","348","4","731","1591","0","45.95","23.82"
"66","000","00","070","0002","0824","656","326","330","8","664","1440","0","46.11","22.64"
"66","000","00","070","0002","0825","593","307","286","3","596","1349","0","44.18","22.76"
"66","000","00","070","0002","0826","646","321","325","5","651","1365","0","47.69","23.52"
"66","000","00","070","0002","0827","696","343","353","1","697","1434","0","48.61","23.92"
"66","000","00","070","0002","0828","695","355","340","7","702","1369","0","51.28","25.93"
"66","000","00","070","0003","0000","2807","1309","1498","26","2833","5891","0","48.09","22.22"
"66","000","00","070","0003","0829","680","338","342","4","684","1480","0","46.22","22.84"
"66","000","00","070","0003","0830","731","311","420","8","739","1525","0","48.46","20.39"
"66","000","00","070","0003","0831","695","322","373","9","704","1412","0","49.86","22.80"
"66","000","00","070","0003","0832","701","338","363","5","706","1474","0","47.90","22.93"
"66","000","00","070","0004","0000","1857","774","1083","19","1876","4324","0","43.39","17.90"
"66","000","00","070","0004","0833","615","276","339","10","625","1498","0","41.72","18.42"
"66","000","00","070","0004","0834","588","248","340","4","592","1384","0","42.77","17.92"
"66","000","00","070","0004","0835","654","250","404","5","659","1442","0","45.70","17.34"
"66","000","00","070","0005","0000","2463","1318","1145","22","2485","6534","0","38.03","20.17"
"66","000","00","070","0005","0838","490","237","253","4","494","1156","0","42.73","20.50"
"66","000","00","070","0005","0839","523","288","235","3","526","1270","0","41.42","22.68"
"66","000","00","070","0005","0840","509","274","235","4","513","1282","0","40.02","21.37"
"66","000","00","070","0005","0841","507","267","240","10","517","1358","0","38.07","19.66"
"66","000","00","070","0005","0842","434","252","182","1","435","1468","0","29.63","17.17"
"66","000","00","070","0006","0000","490","260","230","7","497","1366","0","36.38","19.03"
"66","000","00","070","0006","0843","490","260","230","7","497","1366","0","36.38","19.03"
"66","000","00","070","0007","0000","4270","2059","2211","37","4307","11272","0","38.21","18.27"
"66","000","00","070","0007","0844","454","204","250","3","457","1326","0","34.46","15.38"
"66","000","00","070","0007","0845","505","244","261","7","512","1248","0","41.03","19.55"
"66","000","00","070","0007","0846","470","223","247","5","475","1233","0","38.52","18.09"
"66","000","00","070","0007","0847","526","278","248","8","534","1433","0","37.26","19.40"
"66","000","00","070","0007","0848","580","266","314","2","582","1434","0","40.59","18.55"
"66","000","00","070","0007","0849","500","231","269","7","507","1405","0","36.09","16.44"
"66","000","00","070","0007","0850","636","302","334","4","640","1489","0","42.98","20.28"
"66","000","00","070","0007","0851","599","311","288","1","600","1704","0","35.21","18.25"
"66","000","00","070","0008","0000","913","437","476","6","919","2301","0","39.94","18.99"
"66","000","00","070","0008","0856","432","184","248","5","437","956","0","45.71","19.25"
"66","000","00","070","0008","0857","481","253","228","1","482","1345","0","35.84","18.81"
"66","000","00","070","0009","0000","2137","943","1194","19","2156","5105","0","42.23","18.47"
"66","000","00","070","0009","0858","511","224","287","4","515","1227","0","41.97","18.26"
"66","000","00","070","0009","0859","495","226","269","4","499","1207","0","41.34","18.72"
"66","000","00","070","0009","0860","538","217","321","7","545","1292","0","42.18","16.80"
"66","000","00","070","0009","0861","593","276","317","4","597","1379","0","43.29","20.01"
"66","000","00","070","0010","0000","2978","1547","1431","34","3012","7137","0","42.20","21.68"
"66","000","00","070","0010","0862","607","265","342","8","615","1334","0","46.10","19.87"
"66","000","00","070","0010","0863","618","336","282","4","622","1400","0","44.43","24.00"
"66","000","00","070","0010","0864","569","281","288","6","575","1397","0","41.16","20.11"
"66","000","00","070","0010","0865","621","329","292","10","631","1581","0","39.91","20.81"
"66","000","00","070","0010","0866","563","336","227","6","569","1425","0","39.93","23.58"
"66","000","00","070","0011","0000","2627","1348","1279","22","2649","5220","0","50.75","25.82"
"66","000","00","070","0011","0882","596","301","295","2","598","1150","0","52.00","26.17"
"66","000","00","070","0011","0883","668","341","327","8","676","1358","0","49.78","25.11"
"66","000","00","070","0011","0884","706","335","371","5","711","1425","0","49.89","23.51"
"66","000","00","070","0011","0885","657","371","286","7","664","1287","0","51.59","28.83"
"66","000","00","070","0012","0000","2758","1308","1450","29","2787","6268","0","44.46","20.87"
"66","000","00","070","0012","0896","744","386","358","7","751","1580","0","47.53","24.43"
"66","000","00","070","0012","0897","703","292","411","5","708","1498","0","47.26","19.49"
"66","000","00","070","0012","0898","696","339","357","7","703","1634","0","43.02","20.75"
"66","000","00","070","0012","0899","615","291","324","10","625","1556","0","40.17","18.70"
"66","000","00","070","0013","0000","1953","1167","786","17","1970","4151","0","47.46","28.11"
"66","000","00","070","0013","0878","515","328","187","3","518","951","0","54.47","34.49"
"66","000","00","070","0013","0879","468","291","177","4","472","1051","0","44.91","27.69"
"66","000","00","070","0013","0880","425","259","166","3","428","974","0","43.94","26.59"
"66","000","00","070","0013","0881","545","289","256","7","552","1175","0","46.98","24.60"
"66","000","00","070","0014","0000","580","213","367","9","589","1357","0","43.40","15.70"
"66","000","00","070","0014","0836","244","89","155","6","250","578","0","43.25","15.40"
"66","000","00","070","0014","0837","336","124","212","3","339","779","0","43.52","15.92"
"66","000","00","070","0015","0000","2274","1088","1186","12","2286","4877","0","46.87","22.31"
"66","000","00","070","0015","0910","594","297","297","3","597","1375","0","43.42","21.60"
"66","000","00","070","0015","0911","522","239","283","2","524","1133","0","46.25","21.09"
"66","000","00","070","0015","0912","591","268","323","4","595","1183","0","50.30","22.65"
"66","000","00","070","0015","0913","567","284","283","3","570","1186","0","48.06","23.95"
"66","000","00","070","0016","0000","1723","888","835","24","1747","3803","0","45.94","23.35"
"66","000","00","070","0016","0903","587","325","262","14","601","1233","0","48.74","26.36"
"66","000","00","070","0016","0904","620","304","316","4","624","1430","0","43.64","21.26"
"66","000","00","070","0016","0905","516","259","257","6","522","1140","0","45.79","22.72"
"66","000","00","070","0017","0000","2237","1156","1081","29","2266","5223","0","43.39","22.13"
"66","000","00","070","0017","0906","622","372","250","4","626","1499","0","41.76","24.82"
"66","000","00","070","0017","0907","678","347","331","6","684","1567","0","43.65","22.14"
"66","000","00","070","0017","0908","458","213","245","6","464","1019","0","45.53","20.90"
"66","000","00","070","0017","0909","479","224","255","13","492","1138","0","43.23","19.68"
"66","000","00","070","0018","0000","2155","1084","1071","27","2182","5433","0","40.16","19.95"
"66","000","00","070","0018","0900","748","339","409","9","757","1634","0","46.33","20.75"
"66","000","00","070","0018","0901","758","376","382","8","766","2281","0","33.58","16.48"
"66","000","00","070","0018","0902","649","369","280","10","659","1518","0","43.41","24.31"
"66","000","00","070","0019","0000","1644","827","817","11","1655","3609","0","45.86","22.91"
"66","000","00","070","0019","0917","515","266","249","4","519","1099","0","47.22","24.20"
"66","000","00","070","0019","0918","597","311","286","4","601","1292","0","46.52","24.07"
"66","000","00","070","0019","0919","532","250","282","3","535","1218","0","43.92","20.53"
"66","000","00","070","0020","0000","1991","955","1036","20","2011","4436","0","45.33","21.53"
"66","000","00","070","0020","0914","615","307","308","8","623","1289","0","48.33","23.82"
"66","000","00","070","0020","0915","653","306","347","7","660","1587","0","41.59","19.28"
"66","000","00","070","0020","0916","723","342","381","5","728","1560","0","46.67","21.92"
"66","000","00","070","0021","0000","3023","1538","1485","14","3037","6517","0","46.60","23.60"
"66","000","00","070","0021","0886","572","314","258","1","573","1209","0","47.39","25.97"
"66","000","00","070","0021","0887","582","315","267","2","584","1313","0","44.48","23.99"
"66","000","00","070","0021","0888","555","272","283","4","559","1259","0","44.40","21.60"
"66","000","00","070","0021","0889","614","296","318","4","618","1429","0","43.25","20.71"
"66","000","00","070","0021","0890","700","341","359","3","703","1307","0","53.79","26.09"
"66","000","00","070","0022","0000","3381","1767","1614","27","3408","7565","0","45.05","23.36"
"66","000","00","070","0022","0891","730","359","371","6","736","1629","0","45.18","22.04"
"66","000","00","070","0022","0892","627","354","273","1","628","1434","0","43.79","24.69"
"66","000","00","070","0022","0893","638","354","284","3","641","1470","0","43.61","24.08"
"66","000","00","070","0022","0894","646","340","306","8","654","1442","0","45.35","23.58"
"66","000","00","070","0022","0895","740","360","380","9","749","1590","0","47.11","22.64"
"66","000","00","070","0023","0000","2061","1017","1044","13","2074","5266","0","39.38","19.31"
"66","000","00","070","0023","0852","511","224","287","4","515","1275","0","40.39","17.57"
"66","000","00","070","0023","0853","448","211","237","1","449","1224","0","36.68","17.24"
"66","000","00","070","0023","0854","543","293","250","4","547","1334","0","41.00","21.96"
"66","000","00","070","0023","0855","559","289","270","4","563","1433","0","39.29","20.17"
"66","000","00","070","0024","0000","3784","2142","1642","37","3821","8478","0","45.07","25.27"
"66","000","00","070","0024","0872","660","361","299","2","662","1420","0","46.62","25.42"
"66","000","00","070","0024","0873","678","436","242","13","691","1475","0","46.85","29.56"
"66","000","00","070","0024","0874","687","371","316","9","696","1551","0","44.87","23.92"
"66","000","00","070","0024","0875","626","340","286","3","629","1345","0","46.77","25.28"
"66","000","00","070","0024","0876","576","327","249","4","580","1316","0","44.07","24.85"
"66","000","00","070","0024","0877","557","307","250","6","563","1371","0","41.06","22.39"
"66","000","00","070","0025","0000","2907","1617","1290","20","2927","6493","0","45.08","24.90"
"66","000","00","070","0025","0867","591","329","262","1","592","1339","0","44.21","24.57"
"66","000","00","070","0025","0868","548","329","219","6","554","1304","0","42.48","25.23"
"66","000","00","070","0025","0869","616","353","263","5","621","1290","0","48.14","27.36"
"66","000","00","070","0025","0870","604","309","295","4","608","1303","0","46.66","23.71"
"66","000","00","070","0025","0871","548","297","251","4","552","1257","0","43.91","23.63"
"66","000","00","080","0000","0000","101576","53841","47735","855","102431","238830","289830","42.89","22.54"
"66","000","00","080","0001","0000","1430","763","667","11","1441","3133","0","45.99","24.35"
"66","000","00","080","0001","0974","360","191","169","4","364","894","0","40.72","21.36"
"66","000","00","080","0001","0975","549","290","259","5","554","1150","0","48.17","25.22"
"66","000","00","080","0001","0976","521","282","239","2","523","1089","0","48.03","25.90"
"66","000","00","080","0002","0000","1477","821","656","4","1481","3392","0","43.66","24.20"
"66","000","00","080","0002","0968","526","271","255","2","528","1199","0","44.04","22.60"
"66","000","00","080","0002","0969","451","261","190","1","452","1081","0","41.81","24.14"
"66","000","00","080","0002","0970","500","289","211","1","501","1112","0","45.05","25.99"
"66","000","00","080","0003","0000","3042","1681","1361","26","3068","6954","0","44.12","24.17"
"66","000","00","080","0003","0920","601","347","254","5","606","1156","0","52.42","30.02"
"66","000","00","080","0003","0921","511","295","216","2","513","1215","0","42.22","24.28"
"66","000","00","080","0003","0922","434","241","193","3","437","1180","0","37.03","20.42"
"66","000","00","080","0003","0923","506","261","245","4","510","1178","0","43.29","22.16"
"66","000","00","080","0003","0924","475","249","226","4","479","1135","0","42.20","21.94"
"66","000","00","080","0003","0925","515","288","227","8","523","1090","0","47.98","26.42"
"66","000","00","080","0004","0000","2393","1276","1117","24","2417","5705","0","42.37","22.37"
"66","000","00","080","0004","0982","437","257","180","1","438","1072","0","40.86","23.97"
"66","000","00","080","0004","0983","555","256","299","8","563","1241","0","45.37","20.63"
"66","000","00","080","0004","0984","482","230","252","2","484","1103","0","43.88","20.85"
"66","000","00","080","0004","0985","430","236","194","5","435","1122","0","38.77","21.03"
"66","000","00","080","0004","0986","489","297","192","8","497","1167","0","42.59","25.45"
"66","000","00","080","0005","0000","2095","1170","925","11","2106","5097","0","41.32","22.95"
"66","000","00","080","0005","0991","530","279","251","2","532","1209","0","44.00","23.08"
"66","000","00","080","0005","0992","497","291","206","5","502","1196","0","41.97","24.33"
"66","000","00","080","0005","0993","578","312","266","3","581","1390","0","41.80","22.45"
"66","000","00","080","0005","0994","490","288","202","1","491","1302","0","37.71","22.12"
"66","000","00","080","0006","0000","1945","1012","933","15","1960","4595","0","42.66","22.02"
"66","000","00","080","0006","1046","453","228","225","6","459","1081","0","42.46","21.09"
"66","000","00","080","0006","1047","367","157","210","3","370","929","0","39.83","16.90"
"66","000","00","080","0006","1048","608","326","282","1","609","1260","0","48.33","25.87"
"66","000","00","080","0006","1049","517","301","216","5","522","1325","0","39.40","22.72"
"66","000","00","080","0007","0000","2928","1483","1445","24","2952","7211","0","40.94","20.57"
"66","000","00","080","0007","1104","770","393","377","8","778","1803","0","43.15","21.80"
"66","000","00","080","0007","1105","618","301","317","2","620","1632","0","37.99","18.44"
"66","000","00","080","0007","1106","558","274","284","6","564","1425","0","39.58","19.23"
"66","000","00","080","0007","1107","521","259","262","2","523","1241","0","42.14","20.87"
"66","000","00","080","0007","1108","461","256","205","6","467","1110","0","42.07","23.06"
"66","000","00","080","0008","0000","5911","2942","2969","40","5951","13462","0","44.21","21.85"
"66","000","00","080","0008","0952","513","268","245","1","514","1240","0","41.45","21.61"
"66","000","00","080","0008","0953","488","249","239","3","491","1191","0","41.23","20.91"
"66","000","00","080","0008","0954","519","263","256","3","522","1183","0","44.13","22.23"
"66","000","00","080","0008","0955","632","300","332","2","634","1279","0","49.57","23.46"
"66","000","00","080","0008","0956","570","257","313","3","573","1268","0","45.19","20.27"
"66","000","00","080","0008","0957","586","279","307","3","589","1272","0","46.31","21.93"
"66","000","00","080","0008","0958","567","287","280","3","570","1359","0","41.94","21.12"
"66","000","00","080","0008","0959","522","271","251","3","525","1234","0","42.54","21.96"
"66","000","00","080","0008","0960","539","280","259","11","550","1248","0","44.07","22.44"
"66","000","00","080","0008","0961","534","282","252","5","539","1171","0","46.03","24.08"
"66","000","00","080","0008","0962","441","206","235","3","444","1017","0","43.66","20.26"
"66","000","00","080","0009","0000","5435","2629","2806","60","5495","12347","0","44.50","21.29"
"66","000","00","080","0009","1079","510","233","277","9","519","1139","0","45.57","20.46"
"66","000","00","080","0009","1080","542","255","287","6","548","1194","0","45.90","21.36"
"66","000","00","080","0009","1081","599","306","293","2","601","1299","0","46.27","23.56"
"66","000","00","080","0009","1082","449","217","232","3","452","1172","0","38.57","18.52"
"66","000","00","080","0009","1083","516","287","229","5","521","1261","0","41.32","22.76"
"66","000","00","080","0009","1084","568","259","309","7","575","1201","0","47.88","21.57"
"66","000","00","080","0009","1085","624","297","327","8","632","1360","0","46.47","21.84"
"66","000","00","080","0009","1086","618","329","289","8","626","1336","0","46.86","24.63"
"66","000","00","080","0009","1087","492","242","250","0","492","1154","0","42.63","20.97"
"66","000","00","080","0009","1088","517","204","313","12","529","1231","0","42.97","16.57"
"66","000","00","080","0010","0000","4746","2347","2399","35","4781","11410","0","41.90","20.57"
"66","000","00","080","0010","1033","705","305","400","5","710","1594","0","44.54","19.13"
"66","000","00","080","0010","1034","502","206","296","3","505","1202","0","42.01","17.14"
"66","000","00","080","0010","1035","731","381","350","8","739","1444","0","51.18","26.39"
"66","000","00","080","0010","1036","605","336","269","4","609","1675","0","36.36","20.06"
"66","000","00","080","0010","1037","586","298","288","4","590","1364","0","43.26","21.85"
"66","000","00","080","0010","1038","473","250","223","4","477","1201","0","39.72","20.82"
"66","000","00","080","0010","1039","546","282","264","4","550","1529","0","35.97","18.44"
"66","000","00","080","0010","1040","598","289","309","3","601","1401","0","42.90","20.63"
"66","000","00","080","0011","0000","922","375","547","7","929","2030","0","45.76","18.47"
"66","000","00","080","0011","1044","522","208","314","3","525","1165","0","45.06","17.85"
"66","000","00","080","0011","1045","400","167","233","4","404","865","0","46.71","19.31"
"66","000","00","080","0012","0000","374","174","200","3","377","1008","0","37.40","17.26"
"66","000","00","080","0012","1019","374","174","200","3","377","1008","0","37.40","17.26"
"66","000","00","080","0013","0000","5445","2885","2560","47","5492","14177","0","38.74","20.35"
"66","000","00","080","0013","1096","700","392","308","8","708","2133","0","33.19","18.38"
"66","000","00","080","0013","1097","665","362","303","2","667","1606","0","41.53","22.54"
"66","000","00","080","0013","1098","557","256","301","2","559","1395","0","40.07","18.35"
"66","000","00","080","0013","1099","702","392","310","7","709","1774","0","39.97","22.10"
"66","000","00","080","0013","1100","603","318","285","5","608","1463","0","41.56","21.74"
"66","000","00","080","0013","1101","650","375","275","5","655","1773","0","36.94","21.15"
"66","000","00","080","0013","1102","914","472","442","11","925","2505","0","36.93","18.84"
"66","000","00","080","0013","1103","654","318","336","7","661","1528","0","43.26","20.81"
"66","000","00","080","0014","0000","890","434","456","28","918","2160","0","42.50","20.09"
"66","000","00","080","0014","0931","442","188","254","22","464","1063","0","43.65","17.69"
"66","000","00","080","0014","0932","448","246","202","6","454","1097","0","41.39","22.42"
"66","000","00","080","0015","0000","356","170","186","3","359","905","0","39.67","18.78"
"66","000","00","080","0015","1020","356","170","186","3","359","905","0","39.67","18.78"
"66","000","00","080","0016","0000","3872","2145","1727","29","3901","8784","0","44.41","24.42"
"66","000","00","080","0016","1054","511","274","237","6","517","1170","0","44.19","23.42"
"66","000","00","080","0016","1055","520","327","193","3","523","1113","0","46.99","29.38"
"66","000","00","080","0016","1056","537","266","271","3","540","1174","0","46.00","22.66"
"66","000","00","080","0016","1057","519","260","259","3","522","1126","0","46.36","23.09"
"66","000","00","080","0016","1058","625","348","277","4","629","1416","0","44.42","24.58"
"66","000","00","080","0016","1059","574","326","248","5","579","1337","0","43.31","24.38"
"66","000","00","080","0016","1060","586","344","242","5","591","1448","0","40.81","23.76"
"66","000","00","080","0017","0000","3502","1846","1656","31","3533","9231","0","38.27","20.00"
"66","000","00","080","0017","0937","513","261","252","3","516","1107","0","46.61","23.58"
"66","000","00","080","0017","0938","494","288","206","3","497","1201","0","41.38","23.98"
"66","000","00","080","0017","0939","279","161","118","1","280","1948","0","14.37","8.26"
"66","000","00","080","0017","0940","529","251","278","8","537","1165","0","46.09","21.55"
"66","000","00","080","0017","0941","562","319","243","8","570","1231","0","46.30","25.91"
"66","000","00","080","0017","0942","514","259","255","4","518","1282","0","40.41","20.20"
"66","000","00","080","0017","0943","611","307","304","4","615","1297","0","47.42","23.67"
"66","000","00","080","0018","0000","4000","2043","1957","17","4017","9374","0","42.85","21.79"
"66","000","00","080","0018","0944","411","217","194","1","412","1044","0","39.46","20.79"
"66","000","00","080","0018","0945","445","238","207","0","445","1141","0","39.00","20.86"
"66","000","00","080","0018","0946","622","329","293","3","625","1323","0","47.24","24.87"
"66","000","00","080","0018","0947","490","232","258","3","493","1250","0","39.44","18.56"
"66","000","00","080","0018","0948","624","319","305","4","628","1543","0","40.70","20.67"
"66","000","00","080","0018","0949","698","352","346","4","702","1601","0","43.85","21.99"
"66","000","00","080","0018","0950","710","356","354","2","712","1472","0","48.37","24.18"
"66","000","00","080","0019","0000","690","347","343","7","697","1525","0","45.70","22.75"
"66","000","00","080","0019","0977","690","347","343","7","697","1525","0","45.70","22.75"
"66","000","00","080","0020","0000","4316","2566","1750","41","4357","9850","0","44.23","26.05"
"66","000","00","080","0020","1025","539","323","216","4","543","1258","0","43.16","25.68"
"66","000","00","080","0020","1026","423","248","175","4","427","1016","0","42.03","24.41"
"66","000","00","080","0020","1027","611","370","241","4","615","1250","0","49.20","29.60"
"66","000","00","080","0020","1028","546","296","250","4","550","1324","0","41.54","22.36"
"66","000","00","080","0020","1029","532","321","211","8","540","1210","0","44.63","26.53"
"66","000","00","080","0020","1030","513","309","204","5","518","1178","0","43.97","26.23"
"66","000","00","080","0020","1031","565","319","246","6","571","1337","0","42.71","23.86"
"66","000","00","080","0020","1032","587","380","207","6","593","1277","0","46.44","29.76"
"66","000","00","080","0021","0000","2407","1281","1126","18","2425","5327","0","45.52","24.05"
"66","000","00","080","0021","1021","701","334","367","6","707","1527","0","46.30","21.87"
"66","000","00","080","0021","1022","571","322","249","2","573","1230","0","46.59","26.18"
"66","000","00","080","0021","1023","545","299","246","4","549","1287","0","42.66","23.23"
"66","000","00","080","0021","1024","590","326","264","6","596","1283","0","46.45","25.41"
"66","000","00","080","0022","0000","479","273","206","3","482","1046","0","46.08","26.10"
"66","000","00","080","0022","0951","479","273","206","3","482","1046","0","46.08","26.10"
"66","000","00","080","0023","0000","2965","1547","1418","37","3002","6614","0","45.39","23.39"
"66","000","00","080","0023","0963","594","343","251","9","603","1355","0","44.50","25.31"
"66","000","00","080","0023","0964","554","309","245","7","561","1334","0","42.05","23.16"
"66","000","00","080","0023","0965","620","282","338","4","624","1246","0","50.08","22.63"
"66","000","00","080","0023","0966","614","327","287","8","622","1425","0","43.65","22.95"
"66","000","00","080","0023","0967","583","286","297","9","592","1254","0","47.21","22.81"
"66","000","00","080","0024","0000","1930","1104","826","14","1944","4564","0","42.59","24.19"
"66","000","00","080","0024","1089","610","332","278","5","615","1420","0","43.31","23.38"
"66","000","00","080","0024","1090","449","257","192","1","450","1078","0","41.74","23.84"
"66","000","00","080","0024","1091","398","204","194","4","402","1013","0","39.68","20.14"
"66","000","00","080","0024","1092","473","311","162","4","477","1053","0","45.30","29.53"
"66","000","00","080","0025","0000","1742","1023","719","16","1758","4248","0","41.38","24.08"
"66","000","00","080","0025","1093","588","330","258","6","594","1520","0","39.08","21.71"
"66","000","00","080","0025","1094","536","333","203","5","541","1223","0","44.24","27.23"
"66","000","00","080","0025","1095","618","360","258","5","623","1505","0","41.40","23.92"
"66","000","00","080","0026","0000","2360","1181","1179","17","2377","5130","0","46.34","23.02"
"66","000","00","080","0026","0987","519","266","253","2","521","1126","0","46.27","23.62"
"66","000","00","080","0026","0988","626","291","335","4","630","1263","0","49.88","23.04"
"66","000","00","080","0026","0989","585","311","274","6","591","1345","0","43.94","23.12"
"66","000","00","080","0026","0990","630","313","317","5","635","1396","0","45.49","22.42"
"66","000","00","080","0027","0000","1395","707","688","9","1404","3146","0","44.63","22.47"
"66","000","00","080","0027","1003","502","256","246","5","507","1079","0","46.99","23.73"
"66","000","00","080","0027","1004","391","199","192","2","393","958","0","41.02","20.77"
"66","000","00","080","0027","1005","502","252","250","2","504","1109","0","45.45","22.72"
"66","000","00","080","0028","0000","2616","1385","1231","11","2627","6176","0","42.54","22.43"
"66","000","00","080","0028","1009","559","292","267","2","561","1311","0","42.79","22.27"
"66","000","00","080","0028","1010","554","275","279","3","557","1311","0","42.49","20.98"
"66","000","00","080","0028","1011","543","293","250","1","544","1360","0","40.00","21.54"
"66","000","00","080","0028","1012","517","273","244","2","519","1215","0","42.72","22.47"
"66","000","00","080","0028","1013","443","252","191","3","446","979","0","45.56","25.74"
"66","000","00","080","0029","0000","2058","1045","1013","21","2079","4780","0","43.49","21.86"
"66","000","00","080","0029","1050","490","216","274","4","494","1120","0","44.11","19.29"
"66","000","00","080","0029","1051","437","208","229","1","438","1117","0","39.21","18.62"
"66","000","00","080","0029","1052","572","310","262","8","580","1350","0","42.96","22.96"
"66","000","00","080","0029","1053","559","311","248","8","567","1193","0","47.53","26.07"
"66","000","00","080","0030","0000","2252","1290","962","18","2270","5241","0","43.31","24.61"
"66","000","00","080","0030","1070","597","353","244","7","604","1269","0","47.60","27.82"
"66","000","00","080","0030","1071","547","339","208","2","549","1345","0","40.82","25.20"
"66","000","00","080","0030","1072","575","333","242","7","582","1286","0","45.26","25.89"
"66","000","00","080","0030","1073","533","265","268","2","535","1341","0","39.90","19.76"
"66","000","00","080","0031","0000","2257","1306","951","21","2278","4863","0","46.84","26.86"
"66","000","00","080","0031","0933","607","329","278","6","613","1356","0","45.21","24.26"
"66","000","00","080","0031","0934","467","255","212","3","470","1034","0","45.45","24.66"
"66","000","00","080","0031","0935","610","358","252","10","620","1282","0","48.36","27.93"
"66","000","00","080","0031","0936","573","364","209","2","575","1191","0","48.28","30.56"
"66","000","00","080","0032","0000","2722","1416","1306","18","2740","6705","0","40.87","21.12"
"66","000","00","080","0032","1074","510","253","257","0","510","1295","0","39.38","19.54"
"66","000","00","080","0032","1075","563","295","268","6","569","1323","0","43.01","22.30"
"66","000","00","080","0032","1076","542","284","258","4","546","1370","0","39.85","20.73"
"66","000","00","080","0032","1077","502","275","227","5","507","1265","0","40.08","21.74"
"66","000","00","080","0032","1078","605","309","296","3","608","1452","0","41.87","21.28"
"66","000","00","080","0033","0000","2247","1228","1019","25","2272","5153","0","44.09","23.83"
"66","000","00","080","0033","1066","492","245","247","3","495","1316","0","37.61","18.62"
"66","000","00","080","0033","1067","571","315","256","6","577","1235","0","46.72","25.51"
"66","000","00","080","0033","1068","555","306","249","10","565","1260","0","44.84","24.29"
"66","000","00","080","0033","1069","629","362","267","6","635","1342","0","47.32","26.97"
"66","000","00","080","0034","0000","1450","703","747","17","1467","3180","0","46.13","22.11"
"66","000","00","080","0034","0971","468","202","266","6","474","1083","0","43.77","18.65"
"66","000","00","080","0034","0972","399","186","213","6","405","879","0","46.08","21.16"
"66","000","00","080","0034","0973","583","315","268","5","588","1218","0","48.28","25.86"
"66","000","00","080","0035","0000","2008","1079","929","19","2027","4765","0","42.54","22.64"
"66","000","00","080","0035","0978","522","269","253","5","527","1164","0","45.27","23.11"
"66","000","00","080","0035","0979","487","277","210","4","491","1164","0","42.18","23.80"
"66","000","00","080","0035","0980","523","274","249","5","528","1211","0","43.60","22.63"
"66","000","00","080","0035","0981","476","259","217","5","481","1226","0","39.23","21.13"
"66","000","00","080","0036","0000","1595","893","702","20","1615","3560","0","45.37","25.08"
"66","000","00","080","0036","1006","578","311","267","4","582","1161","0","50.13","26.79"
"66","000","00","080","0036","1007","486","294","192","5","491","1210","0","40.58","24.30"
"66","000","00","080","0036","1008","531","288","243","11","542","1189","0","45.58","24.22"
"66","000","00","080","0037","0000","2474","1318","1156","20","2494","6410","0","38.91","20.56"
"66","000","00","080","0037","1061","487","243","244","2","489","1275","0","38.35","19.06"
"66","000","00","080","0037","1062","505","282","223","5","510","1210","0","42.15","23.31"
"66","000","00","080","0037","1063","429","229","200","2","431","1292","0","33.36","17.72"
"66","000","00","080","0037","1064","547","305","242","4","551","1303","0","42.29","23.41"
"66","000","00","080","0037","1065","506","259","247","7","513","1330","0","38.57","19.47"
"66","000","00","080","0038","0000","2068","1122","946","14","2082","4887","0","42.60","22.96"
"66","000","00","080","0038","0999","473","254","219","2","475","1151","0","41.27","22.07"
"66","000","00","080","0038","1000","541","302","239","7","548","1303","0","42.06","23.18"
"66","000","00","080","0038","1001","465","240","225","1","466","1166","0","39.97","20.58"
"66","000","00","080","0038","1002","589","326","263","4","593","1267","0","46.80","25.73"
"66","000","00","080","0039","0000","2722","1439","1283","24","2746","6741","0","40.74","21.35"
"66","000","00","080","0039","1014","492","257","235","2","494","1422","0","34.74","18.07"
"66","000","00","080","0039","1015","579","292","287","2","581","1458","0","39.85","20.03"
"66","000","00","080","0039","1016","500","227","273","2","502","1280","0","39.22","17.73"
"66","000","00","080","0039","1017","551","285","266","6","557","1302","0","42.78","21.89"
"66","000","00","080","0039","1018","600","378","222","12","612","1279","0","47.85","29.55"
"66","000","00","080","0040","0000","1879","978","901","11","1890","4376","0","43.19","22.35"
"66","000","00","080","0040","0995","474","247","227","1","475","1106","0","42.95","22.33"
"66","000","00","080","0040","0996","445","237","208","4","449","1033","0","43.47","22.94"
"66","000","00","080","0040","0997","492","269","223","4","496","1193","0","41.58","22.55"
"66","000","00","080","0040","0998","468","225","243","2","470","1044","0","45.02","21.55"
"66","000","00","080","0041","0000","2479","1393","1086","24","2503","5662","0","44.21","24.60"
"66","000","00","080","0041","0926","581","340","241","7","588","1383","0","42.52","24.58"
"66","000","00","080","0041","0927","527","298","229","3","530","1302","0","40.71","22.89"
"66","000","00","080","0041","0928","571","327","244","5","576","1144","0","50.35","28.58"
"66","000","00","080","0041","0929","407","247","160","8","415","967","0","42.92","25.54"
"66","000","00","080","0041","0930","393","181","212","1","394","866","0","45.50","20.90"
"66","000","00","080","0042","0000","1702","1021","681","15","1717","3906","0","43.96","26.14"
"66","000","00","080","0042","1041","592","369","223","8","600","1361","0","44.09","27.11"
"66","000","00","080","0042","1042","654","386","268","2","656","1447","0","45.34","26.68"
"66","000","00","080","0042","1043","456","266","190","5","461","1098","0","41.99","24.23"
"66","000","00","090","0000","0000","58785","27050","31735","555","59340","136820","165529","43.37","19.77"
"66","000","00","090","0001","0000","986","530","456","13","999","2243","0","44.54","23.63"
"66","000","00","090","0001","1674","367","169","198","5","372","933","0","39.87","18.11"
"66","000","00","090","0001","1675","619","361","258","8","627","1310","0","47.86","27.56"
"66","000","00","090","0002","0000","421","166","255","2","423","919","0","46.03","18.06"
"66","000","00","090","0002","1677","421","166","255","2","423","919","0","46.03","18.06"
"66","000","00","090","0003","0000","404","177","227","2","406","795","0","51.07","22.26"
"66","000","00","090","0003","1678","404","177","227","2","406","795","0","51.07","22.26"
"66","000","00","090","0004","0000","514","213","301","7","521","1106","0","47.11","19.26"
"66","000","00","090","0004","1676","514","213","301","7","521","1106","0","47.11","19.26"
"66","000","00","090","0005","0000","297","135","162","4","301","744","0","40.46","18.15"
"66","000","00","090","0005","1679","297","135","162","4","301","744","0","40.46","18.15"
"66","000","00","090","0006","0000","384","157","227","4","388","720","0","53.89","21.81"
"66","000","00","090","0006","1703","384","157","227","4","388","720","0","53.89","21.81"
"66","000","00","090","0007","0000","301","124","177","3","304","607","0","50.08","20.43"
"66","000","00","090","0007","1704","301","124","177","3","304","607","0","50.08","20.43"
"66","000","00","090","0008","0000","758","363","395","2","760","1595","0","47.65","22.76"
"66","000","00","090","0008","1698","758","363","395","2","760","1595","0","47.65","22.76"
"66","000","00","090","0009","0000","2179","1024","1155","16","2195","4781","0","45.91","21.42"
"66","000","00","090","0009","1705","571","290","281","1","572","1110","0","51.53","26.13"
"66","000","00","090","0009","1706","518","227","291","2","520","1225","0","42.45","18.53"
"66","000","00","090","0009","1707","543","250","293","7","550","1223","0","44.97","20.44"
"66","000","00","090","0009","1708","547","257","290","6","553","1223","0","45.22","21.01"
"66","000","00","090","0010","0000","1045","476","569","11","1056","2152","0","49.07","22.12"
"66","000","00","090","0010","1709","648","303","345","10","658","1286","0","51.17","23.56"
"66","000","00","090","0010","1710","397","173","224","1","398","866","0","45.96","19.98"
"66","000","00","090","0011","0000","663","295","368","7","670","1433","0","46.76","20.59"
"66","000","00","090","0011","1725","663","295","368","7","670","1433","0","46.76","20.59"
"66","000","00","090","0012","0000","469","181","288","3","472","1119","0","42.18","16.18"
"66","000","00","090","0012","1726","469","181","288","3","472","1119","0","42.18","16.18"
"66","000","00","090","0013","0000","1098","494","604","7","1105","2494","0","44.31","19.81"
"66","000","00","090","0013","1684","475","209","266","5","480","1068","0","44.94","19.57"
"66","000","00","090","0013","1685","623","285","338","2","625","1426","0","43.83","19.99"
"66","000","00","090","0014","0000","1286","667","619","13","1299","2882","0","45.07","23.14"
"66","000","00","090","0014","1686","631","327","304","5","636","1435","0","44.32","22.79"
"66","000","00","090","0014","1687","655","340","315","8","663","1447","0","45.82","23.50"
"66","000","00","090","0015","0000","1663","641","1022","13","1676","3976","0","42.15","16.12"
"66","000","00","090","0015","1688","572","215","357","5","577","1464","0","39.41","14.69"
"66","000","00","090","0015","1689","588","226","362","6","594","1377","0","43.14","16.41"
"66","000","00","090","0015","1690","503","200","303","2","505","1135","0","44.49","17.62"
"66","000","00","090","0016","0000","3824","1666","2158","51","3875","9125","0","42.47","18.26"
"66","000","00","090","0016","1691","591","228","363","9","600","1367","0","43.89","16.68"
"66","000","00","090","0016","1692","641","250","391","7","648","1439","0","45.03","17.37"
"66","000","00","090","0016","1693","406","174","232","8","414","1050","0","39.43","16.57"
"66","000","00","090","0016","1694","598","295","303","13","611","1428","0","42.79","20.66"
"66","000","00","090","0016","1695","455","206","249","2","457","1107","0","41.28","18.61"
"66","000","00","090","0016","1696","600","275","325","5","605","1364","0","44.35","20.16"
"66","000","00","090","0016","1697","533","238","295","7","540","1370","0","39.42","17.37"
"66","000","00","090","0017","0000","592","252","340","8","600","1231","0","48.74","20.47"
"66","000","00","090","0017","1699","592","252","340","8","600","1231","0","48.74","20.47"
"66","000","00","090","0018","0000","1494","731","763","14","1508","3367","0","44.79","21.71"
"66","000","00","090","0018","1700","535","277","258","9","544","1212","0","44.88","22.85"
"66","000","00","090","0018","1701","499","231","268","2","501","1065","0","47.04","21.69"
"66","000","00","090","0018","1702","460","223","237","3","463","1090","0","42.48","20.46"
"66","000","00","090","0019","0000","3887","1860","2027","38","3925","9864","0","39.79","18.86"
"66","000","00","090","0019","1713","511","237","274","6","517","1263","0","40.93","18.76"
"66","000","00","090","0019","1714","569","315","254","6","575","1411","0","40.75","22.32"
"66","000","00","090","0019","1715","537","259","278","11","548","1397","0","39.23","18.54"
"66","000","00","090","0019","1716","449","221","228","2","451","1418","0","31.81","15.59"
"66","000","00","090","0019","1717","584","305","279","4","588","1451","0","40.52","21.02"
"66","000","00","090","0019","1718","634","255","379","6","640","1415","0","45.23","18.02"
"66","000","00","090","0019","1719","603","268","335","3","606","1509","0","40.16","17.76"
"66","000","00","090","0020","0000","2790","1284","1506","27","2817","6283","0","44.84","20.44"
"66","000","00","090","0020","1720","545","262","283","7","552","1151","0","47.96","22.76"
"66","000","00","090","0020","1721","523","262","261","4","527","1164","0","45.27","22.51"
"66","000","00","090","0020","1722","602","287","315","4","606","1402","0","43.22","20.47"
"66","000","00","090","0020","1723","554","213","341","8","562","1228","0","45.77","17.35"
"66","000","00","090","0020","1724","566","260","306","4","570","1338","0","42.60","19.43"
"66","000","00","090","0021","0000","1238","699","539","12","1250","2877","0","43.45","24.30"
"66","000","00","090","0021","1711","584","307","277","4","588","1397","0","42.09","21.98"
"66","000","00","090","0021","1712","654","392","262","8","662","1480","0","44.73","26.49"
"66","000","00","090","0022","0000","2486","1177","1309","24","2510","6296","0","39.87","18.69"
"66","000","00","090","0022","1727","622","286","336","8","630","1991","0","31.64","14.36"
"66","000","00","090","0022","1728","629","311","318","8","637","1437","0","44.33","21.64"
"66","000","00","090","0022","1729","582","236","346","3","585","1370","0","42.70","17.23"
"66","000","00","090","0022","1730","653","344","309","5","658","1498","0","43.93","22.96"
"66","000","00","090","0023","0000","4256","1889","2367","36","4292","10193","0","42.11","18.53"
"66","000","00","090","0023","1731","652","268","384","12","664","1443","0","46.02","18.57"
"66","000","00","090","0023","1732","636","268","368","3","639","1446","0","44.19","18.53"
"66","000","00","090","0023","1733","598","215","383","5","603","1478","0","40.80","14.55"
"66","000","00","090","0023","1734","578","262","316","1","579","1443","0","40.12","18.16"
"66","000","00","090","0023","1735","597","262","335","3","600","1465","0","40.96","17.88"
"66","000","00","090","0023","1736","543","299","244","5","548","1383","0","39.62","21.62"
"66","000","00","090","0023","1737","652","315","337","7","659","1535","0","42.93","20.52"
"66","000","00","090","0024","0000","2001","905","1096","22","2023","4633","0","43.67","19.53"
"66","000","00","090","0024","1738","648","254","394","8","656","1537","0","42.68","16.53"
"66","000","00","090","0024","1739","651","319","332","8","659","1492","0","44.17","21.38"
"66","000","00","090","0024","1740","702","332","370","6","708","1604","0","44.14","20.70"
"66","000","00","090","0025","0000","4401","2134","2267","24","4425","10538","0","41.99","20.25"
"66","000","00","090","0025","1743","481","214","267","5","486","1243","0","39.10","17.22"
"66","000","00","090","0025","1744","538","303","235","7","545","1324","0","41.16","22.89"
"66","000","00","090","0025","1745","621","287","334","5","626","1402","0","44.65","20.47"
"66","000","00","090","0025","1746","625","306","319","0","625","1365","0","45.79","22.42"
"66","000","00","090","0025","1747","543","275","268","1","544","1364","0","39.88","20.16"
"66","000","00","090","0025","1748","546","265","281","4","550","1283","0","42.87","20.65"
"66","000","00","090","0025","1749","510","230","280","2","512","1200","0","42.67","19.17"
"66","000","00","090","0025","1750","537","254","283","0","537","1357","0","39.57","18.72"
"66","000","00","090","0026","0000","1164","567","597","11","1175","2631","0","44.66","21.55"
"66","000","00","090","0026","1741","522","259","263","7","529","1174","0","45.06","22.06"
"66","000","00","090","0026","1742","642","308","334","4","646","1457","0","44.34","21.14"
"66","000","00","090","0027","0000","5438","2611","2827","45","5483","12989","0","42.21","20.10"
"66","000","00","090","0027","1751","616","310","306","1","617","1520","0","40.59","20.39"
"66","000","00","090","0027","1752","610","276","334","7","617","1446","0","42.67","19.09"
"66","000","00","090","0027","1753","595","316","279","4","599","1448","0","41.37","21.82"
"66","000","00","090","0027","1754","650","286","364","1","651","1558","0","41.78","18.36"
"66","000","00","090","0027","1755","656","300","356","7","663","1499","0","44.23","20.01"
"66","000","00","090","0027","1756","608","302","306","9","617","1434","0","43.03","21.06"
"66","000","00","090","0027","1757","623","318","305","2","625","1469","0","42.55","21.65"
"66","000","00","090","0027","1758","505","252","253","7","512","1246","0","41.09","20.22"
"66","000","00","090","0027","1759","575","251","324","7","582","1369","0","42.51","18.33"
"66","000","00","090","0028","0000","2258","1092","1166","18","2276","5045","0","45.11","21.65"
"66","000","00","090","0028","1680","600","264","336","5","605","1333","0","45.39","19.80"
"66","000","00","090","0028","1681","548","257","291","4","552","1275","0","43.29","20.16"
"66","000","00","090","0028","1682","621","316","305","5","626","1371","0","45.66","23.05"
"66","000","00","090","0028","1683","489","255","234","4","493","1066","0","46.25","23.92"
"66","000","00","090","0029","0000","727","297","430","10","737","1574","0","46.82","18.87"
"66","000","00","090","0029","1760","727","297","430","10","737","1574","0","46.82","18.87"
"66","000","00","090","0030","0000","2320","1014","1306","22","2342","5234","0","44.75","19.37"
"66","000","00","090","0030","1761","596","223","373","11","607","1400","0","43.36","15.93"
"66","000","00","090","0030","1762","579","243","336","2","581","1183","0","49.11","20.54"
"66","000","00","090","0030","1763","541","245","296","3","544","1198","0","45.41","20.45"
"66","000","00","090","0030","1764","604","303","301","6","610","1453","0","41.98","20.85"
"66","000","00","090","0031","0000","1389","578","811","19","1408","3175","0","44.35","18.20"
"66","000","00","090","0031","1765","448","209","239","7","455","1086","0","41.90","19.24"
"66","000","00","090","0031","1766","487","188","299","9","496","1085","0","45.71","17.33"
"66","000","00","090","0031","1767","454","181","273","3","457","1004","0","45.52","18.03"
"66","000","00","090","0032","0000","1437","607","830","20","1457","3377","0","43.14","17.97"
"66","000","00","090","0032","1768","480","198","282","2","482","1048","0","45.99","18.89"
"66","000","00","090","0032","1769","451","192","259","10","461","1096","0","42.06","17.52"
"66","000","00","090","0032","1770","506","217","289","8","514","1233","0","41.69","17.60"
"66","000","00","090","0033","0000","980","484","496","6","986","2265","0","43.53","21.37"
"66","000","00","090","0033","1771","493","250","243","2","495","1109","0","44.63","22.54"
"66","000","00","090","0033","1772","487","234","253","4","491","1156","0","42.47","20.24"
"66","000","00","090","0034","0000","1329","637","692","13","1342","3221","0","41.66","19.78"
"66","000","00","090","0034","1773","455","238","217","6","461","1053","0","43.78","22.60"
"66","000","00","090","0034","1774","430","178","252","4","434","1080","0","40.19","16.48"
"66","000","00","090","0034","1775","444","221","223","3","447","1088","0","41.08","20.31"
"66","000","00","090","0035","0000","951","399","552","14","965","2049","0","47.10","19.47"
"66","000","00","090","0035","1776","432","193","239","6","438","944","0","46.40","20.44"
"66","000","00","090","0035","1777","519","206","313","8","527","1105","0","47.69","18.64"
"66","000","00","090","0036","0000","1355","524","831","14","1369","3287","0","41.65","15.94"
"66","000","00","090","0036","1778","490","200","290","6","496","1089","0","45.55","18.37"
"66","000","00","090","0036","1779","425","164","261","1","426","1036","0","41.12","15.83"
"66","000","00","090","0036","1780","440","160","280","7","447","1162","0","38.47","13.77"
"66","000","00","100","0000","0000","16854","9471","7383","240","17094","42357","48747","40.36","22.36"
"66","000","00","100","0001","0000","490","318","172","10","500","1297","0","38.55","24.52"
"66","000","00","100","0001","1843","490","318","172","10","500","1297","0","38.55","24.52"
"66","000","00","100","0002","0000","365","236","129","6","371","833","0","44.54","28.33"
"66","000","00","100","0002","1842","365","236","129","6","371","833","0","44.54","28.33"
"66","000","00","100","0003","0000","431","255","176","2","433","996","0","43.47","25.60"
"66","000","00","100","0003","1841","431","255","176","2","433","996","0","43.47","25.60"
"66","000","00","100","0004","0000","808","540","268","4","812","1754","0","46.29","30.79"
"66","000","00","100","0004","1839","398","269","129","2","400","913","0","43.81","29.46"
"66","000","00","100","0004","1840","410","271","139","2","412","841","0","48.99","32.22"
"66","000","00","100","0005","0000","909","511","398","8","917","2138","0","42.89","23.90"
"66","000","00","100","0005","1837","468","279","189","4","472","1124","0","41.99","24.82"
"66","000","00","100","0005","1838","441","232","209","4","445","1014","0","43.89","22.88"
"66","000","00","100","0006","0000","424","265","159","1","425","951","0","44.69","27.87"
"66","000","00","100","0006","1835","424","265","159","1","425","951","0","44.69","27.87"
"66","000","00","100","0007","0000","571","346","225","8","579","1403","0","41.27","24.66"
"66","000","00","100","0007","1836","571","346","225","8","579","1403","0","41.27","24.66"
"66","000","00","100","0008","0000","1445","904","541","16","1461","3402","0","42.95","26.57"
"66","000","00","100","0008","1832","451","259","192","7","458","1103","0","41.52","23.48"
"66","000","00","100","0008","1833","546","362","184","3","549","1259","0","43.61","28.75"
"66","000","00","100","0008","1834","448","283","165","6","454","1040","0","43.65","27.21"
"66","000","00","100","0009","0000","667","394","273","11","678","1835","0","36.95","21.47"
"66","000","00","100","0009","1830","308","186","122","6","314","849","0","36.98","21.91"
"66","000","00","100","0009","1831","359","208","151","5","364","986","0","36.92","21.10"
"66","000","00","100","0010","0000","1459","848","611","22","1481","3709","0","39.93","22.86"
"66","000","00","100","0010","1826","487","292","195","7","494","1166","0","42.37","25.04"
"66","000","00","100","0010","1827","574","335","239","8","582","1411","0","41.25","23.74"
"66","000","00","100","0010","1828","398","221","177","7","405","1132","0","35.78","19.52"
"66","000","00","100","0011","0000","487","279","208","4","491","1418","0","34.63","19.68"
"66","000","00","100","0011","1829","487","279","208","4","491","1418","0","34.63","19.68"
"66","000","00","100","0012","0000","1891","1009","882","17","1908","4812","0","39.65","20.97"
"66","000","00","100","0012","1822","451","209","242","7","458","1276","0","35.89","16.38"
"66","000","00","100","0012","1823","461","268","193","5","466","1144","0","40.73","23.43"
"66","000","00","100","0012","1824","503","250","253","3","506","1236","0","40.94","20.23"
"66","000","00","100","0012","1825","476","282","194","2","478","1156","0","41.35","24.39"
"66","000","00","100","0013","0000","665","324","341","13","678","1616","0","41.96","20.05"
"66","000","00","100","0013","1820","391","174","217","7","398","901","0","44.17","19.31"
"66","000","00","100","0013","1821","274","150","124","6","280","715","0","39.16","20.98"
"66","000","00","100","0014","0000","429","234","195","8","437","963","0","45.38","24.30"
"66","000","00","100","0014","1818","429","234","195","8","437","963","0","45.38","24.30"
"66","000","00","100","0015","0000","363","184","179","9","372","832","0","44.71","22.12"
"66","000","00","100","0015","1819","363","184","179","9","372","832","0","44.71","22.12"
"66","000","00","100","0016","0000","691","313","378","20","711","1825","0","38.96","17.15"
"66","000","00","100","0016","1816","354","161","193","14","368","988","0","37.25","16.30"
"66","000","00","100","0016","1817","337","152","185","6","343","837","0","40.98","18.16"
"66","000","00","100","0017","0000","371","204","167","9","380","1233","0","30.82","16.55"
"66","000","00","100","0017","1815","371","204","167","9","380","1233","0","30.82","16.55"
"66","000","00","100","0018","0000","857","520","337","9","866","1954","0","44.32","26.61"
"66","000","00","100","0018","1848","415","256","159","3","418","956","0","43.72","26.78"
"66","000","00","100","0018","1849","442","264","178","6","448","998","0","44.89","26.45"
"66","000","00","100","0019","0000","836","453","383","15","851","2023","0","42.07","22.39"
"66","000","00","100","0019","1844","294","173","121","4","298","723","0","41.22","23.93"
"66","000","00","100","0019","1845","542","280","262","11","553","1300","0","42.54","21.54"
"66","000","00","100","0020","0000","650","343","307","17","667","1651","0","40.40","20.78"
"66","000","00","100","0020","1846","416","212","204","12","428","1010","0","42.38","20.99"
"66","000","00","100","0020","1847","234","131","103","5","239","641","0","37.29","20.44"
"66","000","00","100","0021","0000","457","202","255","3","460","1172","0","39.25","17.24"
"66","000","00","100","0021","1850","457","202","255","3","460","1172","0","39.25","17.24"
"66","000","00","100","0022","0000","621","352","269","6","627","1817","0","34.51","19.37"
"66","000","00","100","0022","1851","259","135","124","3","262","901","0","29.08","14.98"
"66","000","00","100","0022","1852","362","217","145","3","365","916","0","39.85","23.69"
"66","000","00","100","0023","0000","227","120","107","1","228","701","0","32.52","17.12"
"66","000","00","100","0023","1853","227","120","107","1","228","701","0","32.52","17.12"
"66","000","00","100","0024","0000","283","109","174","8","291","657","0","44.29","16.59"
"66","000","00","100","0024","1854","283","109","174","8","291","657","0","44.29","16.59"
"66","000","00","100","0025","0000","457","208","249","13","470","1365","0","34.43","15.24"
"66","000","00","100","0025","1855","457","208","249","13","470","1365","0","34.43","15.24"
"66","000","00","110","0000","0000","23332","11238","12094","258","23590","62481","75819","37.76","17.99"
"66","000","00","110","0001","0000","574","259","315","8","582","1331","0","43.73","19.46"
"66","000","00","110","0001","0001","574","259","315","8","582","1331","0","43.73","19.46"
"66","000","00","110","0002","0000","429","192","237","9","438","991","0","44.20","19.37"
"66","000","00","110","0002","0002","429","192","237","9","438","991","0","44.20","19.37"
"66","000","00","110","0003","0000","684","319","365","3","687","1532","0","44.84","20.82"
"66","000","00","110","0003","0003","324","159","165","1","325","695","0","46.76","22.88"
"66","000","00","110","0003","0004","360","160","200","2","362","837","0","43.25","19.12"
"66","000","00","110","0004","0000","288","150","138","2","290","748","0","38.77","20.05"
"66","000","00","110","0004","0005","288","150","138","2","290","748","0","38.77","20.05"
"66","000","00","110","0005","0000","788","367","421","8","796","2008","0","39.64","18.28"
"66","000","00","110","0005","0006","365","178","187","6","371","864","0","42.94","20.60"
"66","000","00","110","0005","0007","423","189","234","2","425","1144","0","37.15","16.52"
"66","000","00","110","0006","0000","889","403","486","5","894","2055","0","43.50","19.61"
"66","000","00","110","0006","0008","387","158","229","4","391","899","0","43.49","17.58"
"66","000","00","110","0006","0009","502","245","257","1","503","1156","0","43.51","21.19"
"66","000","00","110","0007","0000","1331","675","656","14","1345","3394","0","39.63","19.89"
"66","000","00","110","0007","0010","415","201","214","6","421","1062","0","39.64","18.93"
"66","000","00","110","0007","0011","479","239","240","6","485","1276","0","38.01","18.73"
"66","000","00","110","0007","0012","437","235","202","2","439","1056","0","41.57","22.25"
"66","000","00","110","0008","0000","772","376","396","7","779","2042","0","38.15","18.41"
"66","000","00","110","0008","0013","387","167","220","6","393","1015","0","38.72","16.45"
"66","000","00","110","0008","0014","385","209","176","1","386","1027","0","37.59","20.35"
"66","000","00","110","0009","0000","1716","897","819","20","1736","4515","0","38.45","19.87"
"66","000","00","110","0009","0015","426","222","204","5","431","1112","0","38.76","19.96"
"66","000","00","110","0009","0016","427","206","221","8","435","1133","0","38.39","18.18"
"66","000","00","110","0009","0017","468","264","204","2","470","1282","0","36.66","20.59"
"66","000","00","110","0009","0018","395","205","190","5","400","988","0","40.49","20.75"
"66","000","00","110","0010","0000","326","160","166","5","331","813","0","40.71","19.68"
"66","000","00","110","0010","0019","326","160","166","5","331","813","0","40.71","19.68"
"66","000","00","110","0011","0000","396","177","219","6","402","860","0","46.74","20.58"
"66","000","00","110","0011","0020","396","177","219","6","402","860","0","46.74","20.58"
"66","000","00","110","0012","0000","1141","558","583","9","1150","3232","0","35.58","17.26"
"66","000","00","110","0012","0021","575","259","316","3","578","1628","0","35.50","15.91"
"66","000","00","110","0012","0022","566","299","267","6","572","1604","0","35.66","18.64"
"66","000","00","110","0013","0000","452","252","200","4","456","1160","0","39.31","21.72"
"66","000","00","110","0013","0023","452","252","200","4","456","1160","0","39.31","21.72"
"66","000","00","110","0014","0000","356","131","225","0","356","1073","0","33.18","12.21"
"66","000","00","110","0014","0024","356","131","225","0","356","1073","0","33.18","12.21"
"66","000","00","110","0015","0000","700","346","354","5","705","1810","0","38.95","19.12"
"66","000","00","110","0015","0025","390","202","188","1","391","966","0","40.48","20.91"
"66","000","00","110","0015","0026","310","144","166","4","314","844","0","37.20","17.06"
"66","000","00","110","0016","0000","2069","1044","1025","18","2087","5206","0","40.09","20.05"
"66","000","00","110","0016","0027","538","294","244","6","544","1322","0","41.15","22.24"
"66","000","00","110","0016","0028","436","200","236","1","437","1082","0","40.39","18.48"
"66","000","00","110","0016","0029","469","231","238","3","472","1161","0","40.65","19.90"
"66","000","00","110","0016","0030","380","192","188","7","387","955","0","40.52","20.10"
"66","000","00","110","0016","0031","246","127","119","1","247","686","0","36.01","18.51"
"66","000","00","110","0017","0000","795","433","362","5","800","1996","0","40.08","21.69"
"66","000","00","110","0017","0032","505","264","241","2","507","1241","0","40.85","21.27"
"66","000","00","110","0017","0033","290","169","121","3","293","755","0","38.81","22.38"
"66","000","00","110","0018","0000","632","274","358","6","638","1755","0","36.35","15.61"
"66","000","00","110","0018","0034","295","101","194","3","298","770","0","38.70","13.12"
"66","000","00","110","0018","0035","337","173","164","3","340","985","0","34.52","17.56"
"66","000","00","110","0019","0000","466","229","237","2","468","1356","0","34.51","16.89"
"66","000","00","110","0019","0036","466","229","237","2","468","1356","0","34.51","16.89"
"66","000","00","110","0020","0000","1672","790","882","17","1689","4450","0","37.96","17.75"
"66","000","00","110","0020","0037","454","198","256","5","459","1319","0","34.80","15.01"
"66","000","00","110","0020","0038","436","220","216","5","441","1156","0","38.15","19.03"
"66","000","00","110","0020","0039","359","164","195","4","363","928","0","39.12","17.67"
"66","000","00","110","0020","0040","423","208","215","3","426","1047","0","40.69","19.87"
"66","000","00","110","0021","0000","426","187","239","11","437","1233","0","35.44","15.17"
"66","000","00","110","0021","0041","426","187","239","11","437","1233","0","35.44","15.17"
"66","000","00","110","0022","0000","1369","631","738","16","1385","3909","0","35.43","16.14"
"66","000","00","110","0022","0042","520","258","262","10","530","1363","0","38.88","18.93"
"66","000","00","110","0022","0043","352","153","199","3","355","1160","0","30.60","13.19"
"66","000","00","110","0022","0044","497","220","277","3","500","1386","0","36.08","15.87"
"66","000","00","110","0023","0000","847","363","484","17","864","2515","0","34.35","14.43"
"66","000","00","110","0023","0045","385","143","242","7","392","1119","0","35.03","12.78"
"66","000","00","110","0023","0046","462","220","242","10","472","1396","0","33.81","15.76"
"66","000","00","110","0024","0000","1807","864","943","22","1829","5476","0","33.40","15.78"
"66","000","00","110","0024","0047","453","200","253","2","455","1231","0","36.96","16.25"
"66","000","00","110","0024","0048","475","242","233","8","483","1473","0","32.79","16.43"
"66","000","00","110","0024","0049","432","194","238","6","438","1415","0","30.95","13.71"
"66","000","00","110","0024","0050","447","228","219","6","453","1357","0","33.38","16.80"
"66","000","00","110","0025","0000","575","273","302","8","583","1475","0","39.53","18.51"
"66","000","00","110","0025","0051","256","142","114","3","259","640","0","40.47","22.19"
"66","000","00","110","0025","0052","319","131","188","5","324","835","0","38.80","15.69"
"66","000","00","110","0026","0000","592","294","298","9","601","1649","0","36.45","17.83"
"66","000","00","110","0026","0053","305","139","166","4","309","869","0","35.56","16.00"
"66","000","00","110","0026","0054","287","155","132","5","292","780","0","37.44","19.87"
"66","000","00","110","0027","0000","432","209","223","9","441","1340","0","32.91","15.60"
"66","000","00","110","0027","0055","432","209","223","9","441","1340","0","32.91","15.60"
"66","000","00","110","0028","0000","373","195","178","3","376","1111","0","33.84","17.55"
"66","000","00","110","0028","0056","373","195","178","3","376","1111","0","33.84","17.55"
"66","000","00","110","0029","0000","435","190","245","10","445","1446","0","30.77","13.14"
"66","000","00","110","0029","0057","435","190","245","10","445","1446","0","30.77","13.14"
"66","000","00","120","0000","0000","28494","13164","15330","281","28775","73629","88227","39.08","17.88"
"66","000","00","120","0001","0000","456","209","247","13","469","1063","0","44.12","19.66"
"66","000","00","120","0001","0099","456","209","247","13","469","1063","0","44.12","19.66"
"66","000","00","120","0002","0000","466","214","252","0","466","930","0","50.11","23.01"
"66","000","00","120","0002","0100","466","214","252","0","466","930","0","50.11","23.01"
"66","000","00","120","0003","0000","915","418","497","6","921","2049","0","44.95","20.40"
"66","000","00","120","0003","0101","377","156","221","3","380","892","0","42.60","17.49"
"66","000","00","120","0003","0102","538","262","276","3","541","1157","0","46.76","22.64"
"66","000","00","120","0004","0000","308","143","165","6","314","661","0","47.50","21.63"
"66","000","00","120","0004","0103","308","143","165","6","314","661","0","47.50","21.63"
"66","000","00","120","0005","0000","763","350","413","4","767","1743","0","44.00","20.08"
"66","000","00","120","0005","0104","381","171","210","1","382","853","0","44.78","20.05"
"66","000","00","120","0005","0105","382","179","203","3","385","890","0","43.26","20.11"
"66","000","00","120","0006","0000","660","274","386","3","663","1553","0","42.69","17.64"
"66","000","00","120","0006","0106","660","274","386","3","663","1553","0","42.69","17.64"
"66","000","00","120","0007","0000","328","149","179","3","331","673","0","49.18","22.14"
"66","000","00","120","0007","0107","328","149","179","3","331","673","0","49.18","22.14"
"66","000","00","120","0008","0000","207","89","118","4","211","391","0","53.96","22.76"
"66","000","00","120","0008","0108","207","89","118","4","211","391","0","53.96","22.76"
"66","000","00","120","0009","0000","955","415","540","11","966","2191","0","44.09","18.94"
"66","000","00","120","0009","0109","618","271","347","9","627","1424","0","44.03","19.03"
"66","000","00","120","0009","0110","337","144","193","2","339","767","0","44.20","18.77"
"66","000","00","120","0010","0000","4116","1985","2131","27","4143","9925","0","41.74","20.00"
"66","000","00","120","0010","0111","556","251","305","0","556","1315","0","42.28","19.09"
"66","000","00","120","0010","0112","672","301","371","6","678","1676","0","40.45","17.96"
"66","000","00","120","0010","0113","528","274","254","5","533","1327","0","40.17","20.65"
"66","000","00","120","0010","0114","627","338","289","1","628","1352","0","46.45","25.00"
"66","000","00","120","0010","0115","547","258","289","4","551","1392","0","39.58","18.53"
"66","000","00","120","0010","0116","628","315","313","10","638","1553","0","41.08","20.28"
"66","000","00","120","0010","0117","558","248","310","1","559","1310","0","42.67","18.93"
"66","000","00","120","0011","0000","539","239","300","5","544","1448","0","37.57","16.51"
"66","000","00","120","0011","0118","539","239","300","5","544","1448","0","37.57","16.51"
"66","000","00","120","0012","0000","592","291","301","7","599","1505","0","39.80","19.34"
"66","000","00","120","0012","0119","592","291","301","7","599","1505","0","39.80","19.34"
"66","000","00","120","0013","0000","1751","867","884","12","1763","4370","0","40.34","19.84"
"66","000","00","120","0013","0120","584","274","310","3","587","1508","0","38.93","18.17"
"66","000","00","120","0013","0121","673","335","338","8","681","1611","0","42.27","20.79"
"66","000","00","120","0013","0122","494","258","236","1","495","1251","0","39.57","20.62"
"66","000","00","120","0014","0000","1244","533","711","8","1252","3341","0","37.47","15.95"
"66","000","00","120","0014","0123","427","162","265","4","431","1170","0","36.84","13.85"
"66","000","00","120","0014","0124","497","228","269","1","498","1310","0","38.02","17.40"
"66","000","00","120","0014","0125","320","143","177","3","323","861","0","37.51","16.61"
"66","000","00","120","0015","0000","791","338","453","14","805","2104","0","38.26","16.06"
"66","000","00","120","0015","0126","428","176","252","8","436","1082","0","40.30","16.27"
"66","000","00","120","0015","0127","363","162","201","6","369","1022","0","36.11","15.85"
"66","000","00","120","0016","0000","2296","1019","1277","18","2314","6655","0","34.77","15.31"
"66","000","00","120","0016","0128","574","265","309","3","577","1529","0","37.74","17.33"
"66","000","00","120","0016","0129","552","201","351","4","556","1473","0","37.75","13.65"
"66","000","00","120","0016","0130","656","322","334","8","664","2246","0","29.56","14.34"
"66","000","00","120","0016","0131","514","231","283","3","517","1407","0","36.74","16.42"
"66","000","00","120","0017","0000","1186","839","347","6","1192","2801","0","42.56","29.95"
"66","000","00","120","0017","0132","767","622","145","4","771","1641","0","46.98","37.90"
"66","000","00","120","0017","0133","419","217","202","2","421","1160","0","36.29","18.71"
"66","000","00","120","0018","0000","397","236","161","5","402","1278","0","31.46","18.47"
"66","000","00","120","0018","0134","397","236","161","5","402","1278","0","31.46","18.47"
"66","000","00","120","0019","0000","447","198","249","4","451","1330","0","33.91","14.89"
"66","000","00","120","0019","0135","447","198","249","4","451","1330","0","33.91","14.89"
"66","000","00","120","0020","0000","412","178","234","7","419","1234","0","33.95","14.42"
"66","000","00","120","0020","0136","412","178","234","7","419","1234","0","33.95","14.42"
"66","000","00","120","0021","0000","335","149","186","2","337","1155","0","29.18","12.90"
"66","000","00","120","0021","0137","335","149","186","2","337","1155","0","29.18","12.90"
"66","000","00","120","0022","0000","446","220","226","6","452","1309","0","34.53","16.81"
"66","000","00","120","0022","0138","446","220","226","6","452","1309","0","34.53","16.81"
"66","000","00","120","0023","0000","662","229","433","6","668","2039","0","32.76","11.23"
"66","000","00","120","0023","0139","341","119","222","1","342","1134","0","30.16","10.49"
"66","000","00","120","0023","0140","321","110","211","5","326","905","0","36.02","12.15"
"66","000","00","120","0024","0000","893","368","525","11","904","2252","0","40.14","16.34"
"66","000","00","120","0024","0141","460","186","274","7","467","1111","0","42.03","16.74"
"66","000","00","120","0024","0142","433","182","251","4","437","1141","0","38.30","15.95"
"66","000","00","120","0025","0000","594","276","318","10","604","1765","0","34.22","15.64"
"66","000","00","120","0025","0143","312","161","151","5","317","835","0","37.96","19.28"
"66","000","00","120","0025","0144","282","115","167","5","287","930","0","30.86","12.37"
"66","000","00","120","0026","0000","806","298","508","12","818","2488","0","32.88","11.98"
"66","000","00","120","0026","0145","455","184","271","6","461","1394","0","33.07","13.20"
"66","000","00","120","0026","0146","351","114","237","6","357","1094","0","32.63","10.42"
"66","000","00","120","0027","0000","2939","1257","1682","36","2975","7404","0","40.18","16.98"
"66","000","00","120","0027","0147","495","203","292","6","501","1346","0","37.22","15.08"
"66","000","00","120","0027","0148","593","257","336","5","598","1446","0","41.36","17.77"
"66","000","00","120","0027","0149","561","215","346","9","570","1336","0","42.66","16.09"
"66","000","00","120","0027","0150","740","357","383","8","748","1771","0","42.24","20.16"
"66","000","00","120","0027","0151","550","225","325","8","558","1505","0","37.08","14.95"
"66","000","00","120","0028","0000","1070","478","592","7","1077","2764","0","38.97","17.29"
"66","000","00","120","0028","0152","480","227","253","6","486","1340","0","36.27","16.94"
"66","000","00","120","0028","0153","590","251","339","1","591","1424","0","41.50","17.63"
"66","000","00","120","0029","0000","423","221","202","8","431","1197","0","36.01","18.46"
"66","000","00","120","0029","0154","423","221","202","8","431","1197","0","36.01","18.46"
"66","000","00","120","0030","0000","436","181","255","4","440","1156","0","38.06","15.66"
"66","000","00","120","0030","0156","436","181","255","4","440","1156","0","38.06","15.66"
"66","000","00","120","0031","0000","496","242","254","7","503","1390","0","36.19","17.41"
"66","000","00","120","0031","0157","496","242","254","7","503","1390","0","36.19","17.41"
"66","000","00","120","0032","0000","565","261","304","9","574","1465","0","39.18","17.82"
"66","000","00","120","0032","0155","565","261","304","9","574","1465","0","39.18","17.82"
"66","000","00","130","0000","0000","32897","16392","16505","343","33240","76561","95562","43.42","21.41"
"66","000","00","130","0001","0000","607","280","327","4","611","1364","0","44.79","20.53"
"66","000","00","130","0001","0198","375","144","231","3","378","765","0","49.41","18.82"
"66","000","00","130","0001","0199","232","136","96","1","233","599","0","38.90","22.70"
"66","000","00","130","0002","0000","1028","502","526","7","1035","1976","0","52.38","25.40"
"66","000","00","130","0002","0200","400","182","218","3","403","830","0","48.55","21.93"
"66","000","00","130","0002","0201","628","320","308","4","632","1146","0","55.15","27.92"
"66","000","00","130","0003","0000","464","185","279","5","469","893","0","52.52","20.72"
"66","000","00","130","0003","0202","464","185","279","5","469","893","0","52.52","20.72"
"66","000","00","130","0004","0000","234","114","120","4","238","489","0","48.67","23.31"
"66","000","00","130","0004","0203","234","114","120","4","238","489","0","48.67","23.31"
"66","000","00","130","0005","0000","1080","512","568","6","1086","2409","0","45.08","21.25"
"66","000","00","130","0005","0204","340","167","173","2","342","769","0","44.47","21.72"
"66","000","00","130","0005","0205","422","210","212","4","426","932","0","45.71","22.53"
"66","000","00","130","0005","0206","318","135","183","0","318","708","0","44.92","19.07"
"66","000","00","130","0006","0000","1981","965","1016","20","2001","4364","0","45.85","22.11"
"66","000","00","130","0006","0210","494","242","252","2","496","1058","0","46.88","22.87"
"66","000","00","130","0006","0211","470","241","229","4","474","974","0","48.67","24.74"
"66","000","00","130","0006","0212","604","282","322","10","614","1415","0","43.39","19.93"
"66","000","00","130","0006","0213","413","200","213","4","417","917","0","45.47","21.81"
"66","000","00","130","0007","0000","2326","1047","1279","27","2353","5345","0","44.02","19.59"
"66","000","00","130","0007","0214","514","243","271","9","523","1202","0","43.51","20.22"
"66","000","00","130","0007","0215","516","243","273","5","521","1205","0","43.24","20.17"
"66","000","00","130","0007","0216","616","243","373","4","620","1392","0","44.54","17.46"
"66","000","00","130","0007","0217","680","318","362","9","689","1546","0","44.57","20.57"
"66","000","00","130","0008","0000","3126","1273","1853","26","3152","6799","0","46.36","18.72"
"66","000","00","130","0008","0218","495","188","307","1","496","1176","0","42.18","15.99"
"66","000","00","130","0008","0219","516","200","316","5","521","1149","0","45.34","17.41"
"66","000","00","130","0008","0220","509","207","302","7","516","1155","0","44.68","17.92"
"66","000","00","130","0008","0221","497","184","313","4","501","1044","0","47.99","17.62"
"66","000","00","130","0008","0222","533","199","334","4","537","1143","0","46.98","17.41"
"66","000","00","130","0008","0223","576","295","281","5","581","1132","0","51.33","26.06"
"66","000","00","130","0009","0000","3074","1597","1477","41","3115","7344","0","42.42","21.75"
"66","000","00","130","0009","0224","386","225","161","8","394","936","0","42.09","24.04"
"66","000","00","130","0009","0225","372","177","195","0","372","879","0","42.32","20.14"
"66","000","00","130","0009","0226","467","262","205","5","472","1074","0","43.95","24.39"
"66","000","00","130","0009","0227","454","219","235","6","460","1103","0","41.70","19.85"
"66","000","00","130","0009","0228","419","189","230","8","427","1133","0","37.69","16.68"
"66","000","00","130","0009","0229","521","292","229","5","526","1137","0","46.26","25.68"
"66","000","00","130","0009","0230","455","233","222","9","464","1082","0","42.88","21.53"
"66","000","00","130","0010","0000","475","211","264","3","478","1089","0","43.89","19.38"
"66","000","00","130","0010","0231","475","211","264","3","478","1089","0","43.89","19.38"
"66","000","00","130","0011","0000","1868","967","901","19","1887","4904","0","38.48","19.72"
"66","000","00","130","0011","0235","379","180","199","3","382","974","0","39.22","18.48"
"66","000","00","130","0011","0236","376","198","178","1","377","919","0","41.02","21.55"
"66","000","00","130","0011","0237","418","200","218","5","423","1054","0","40.13","18.98"
"66","000","00","130","0011","0238","361","199","162","5","366","1025","0","35.71","19.41"
"66","000","00","130","0011","0239","334","190","144","5","339","932","0","36.37","20.39"
"66","000","00","130","0012","0000","1612","830","782","10","1622","3843","0","42.21","21.60"
"66","000","00","130","0012","0232","571","269","302","6","577","1403","0","41.13","19.17"
"66","000","00","130","0012","0233","499","278","221","3","502","1137","0","44.15","24.45"
"66","000","00","130","0012","0234","542","283","259","1","543","1303","0","41.67","21.72"
"66","000","00","130","0013","0000","767","361","406","16","783","1748","0","44.79","20.65"
"66","000","00","130","0013","0240","286","116","170","6","292","698","0","41.83","16.62"
"66","000","00","130","0013","0241","481","245","236","10","491","1050","0","46.76","23.33"
"66","000","00","130","0014","0000","2214","1066","1148","14","2228","5388","0","41.35","19.78"
"66","000","00","130","0014","0242","595","279","316","1","596","1434","0","41.56","19.46"
"66","000","00","130","0014","0243","474","217","257","6","480","1186","0","40.47","18.30"
"66","000","00","130","0014","0244","511","231","280","2","513","1272","0","40.33","18.16"
"66","000","00","130","0014","0245","634","339","295","5","639","1496","0","42.71","22.66"
"66","000","00","130","0015","0000","1402","744","658","17","1419","3381","0","41.97","22.01"
"66","000","00","130","0015","0246","297","164","133","5","302","729","0","41.43","22.50"
"66","000","00","130","0015","0247","367","198","169","3","370","853","0","43.38","23.21"
"66","000","00","130","0015","0248","426","208","218","5","431","1041","0","41.40","19.98"
"66","000","00","130","0015","0249","312","174","138","4","316","758","0","41.69","22.96"
"66","000","00","130","0016","0000","2505","1335","1170","28","2533","5682","0","44.58","23.50"
"66","000","00","130","0016","0250","540","256","284","4","544","1276","0","42.63","20.06"
"66","000","00","130","0016","0251","427","246","181","7","434","995","0","43.62","24.72"
"66","000","00","130","0016","0252","395","215","180","4","399","1026","0","38.89","20.96"
"66","000","00","130","0016","0253","537","258","279","8","545","1113","0","48.97","23.18"
"66","000","00","130","0016","0254","606","360","246","5","611","1272","0","48.03","28.30"
"66","000","00","130","0017","0000","1801","1051","750","22","1823","4396","0","41.47","23.91"
"66","000","00","130","0017","0261","528","276","252","9","537","1404","0","38.25","19.66"
"66","000","00","130","0017","0262","371","278","93","2","373","890","0","41.91","31.24"
"66","000","00","130","0017","0263","386","208","178","6","392","945","0","41.48","22.01"
"66","000","00","130","0017","0264","516","289","227","5","521","1157","0","45.03","24.98"
"66","000","00","130","0018","0000","1016","588","428","14","1030","2331","0","44.19","25.23"
"66","000","00","130","0018","0265","559","282","277","8","567","1296","0","43.75","21.76"
"66","000","00","130","0018","0266","457","306","151","6","463","1035","0","44.73","29.57"
"66","000","00","130","0019","0000","855","479","376","9","864","2130","0","40.56","22.49"
"66","000","00","130","0019","0267","457","233","224","7","464","1128","0","41.13","20.66"
"66","000","00","130","0019","0268","398","246","152","2","400","1002","0","39.92","24.55"
"66","000","00","130","0020","0000","1446","652","794","18","1464","3365","0","43.51","19.38"
"66","000","00","130","0020","0207","524","221","303","9","533","1294","0","41.19","17.08"
"66","000","00","130","0020","0208","502","244","258","3","505","1109","0","45.54","22.00"
"66","000","00","130","0020","0209","420","187","233","6","426","962","0","44.28","19.44"
"66","000","00","130","0021","0000","3016","1633","1383","33","3049","7321","0","41.65","22.31"
"66","000","00","130","0021","0255","606","318","288","10","616","1353","0","45.53","23.50"
"66","000","00","130","0021","0256","531","264","267","3","534","1340","0","39.85","19.70"
"66","000","00","130","0021","0257","498","281","217","8","506","1141","0","44.35","24.63"
"66","000","00","130","0021","0258","401","210","191","2","403","1000","0","40.30","21.00"
"66","000","00","130","0021","0259","319","180","139","0","319","886","0","36.00","20.32"
"66","000","00","130","0021","0260","661","380","281","10","671","1601","0","41.91","23.74"
"66","000","00","140","0000","0000","18615","8759","9856","201","18816","48591","59487","38.72","18.03"
"66","000","00","140","0001","0000","1427","676","751","13","1440","3632","0","39.65","18.61"
"66","000","00","140","0001","0158","438","178","260","4","442","1103","0","40.07","16.14"
"66","000","00","140","0001","0159","456","215","241","4","460","1200","0","38.33","17.92"
"66","000","00","140","0001","0160","533","283","250","5","538","1329","0","40.48","21.29"
"66","000","00","140","0002","0000","835","384","451","8","843","1967","0","42.86","19.52"
"66","000","00","140","0002","0161","482","206","276","4","486","1109","0","43.82","18.58"
"66","000","00","140","0002","0162","353","178","175","4","357","858","0","41.61","20.75"
"66","000","00","140","0003","0000","1491","771","720","15","1506","3879","0","38.82","19.88"
"66","000","00","140","0003","0163","401","203","198","5","406","1016","0","39.96","19.98"
"66","000","00","140","0003","0164","574","296","278","7","581","1440","0","40.35","20.56"
"66","000","00","140","0003","0165","516","272","244","3","519","1423","0","36.47","19.11"
"66","000","00","140","0004","0000","223","104","119","3","226","484","0","46.69","21.49"
"66","000","00","140","0004","0166","223","104","119","3","226","484","0","46.69","21.49"
"66","000","00","140","0005","0000","487","242","245","7","494","1161","0","42.55","20.84"
"66","000","00","140","0005","0167","487","242","245","7","494","1161","0","42.55","20.84"
"66","000","00","140","0006","0000","331","149","182","1","332","780","0","42.56","19.10"
"66","000","00","140","0006","0168","331","149","182","1","332","780","0","42.56","19.10"
"66","000","00","140","0007","0000","2413","1173","1240","23","2436","6132","0","39.73","19.13"
"66","000","00","140","0007","0169","375","199","176","4","379","993","0","38.17","20.04"
"66","000","00","140","0007","0170","564","283","281","5","569","1334","0","42.65","21.21"
"66","000","00","140","0007","0171","379","145","234","2","381","1020","0","37.35","14.22"
"66","000","00","140","0007","0172","548","273","275","9","557","1389","0","40.10","19.65"
"66","000","00","140","0007","0173","547","273","274","3","550","1396","0","39.40","19.56"
"66","000","00","140","0008","0000","1975","866","1109","21","1996","5294","0","37.70","16.36"
"66","000","00","140","0008","0174","475","183","292","4","479","1282","0","37.36","14.27"
"66","000","00","140","0008","0175","475","197","278","8","483","1292","0","37.38","15.25"
"66","000","00","140","0008","0176","503","224","279","4","507","1267","0","40.02","17.68"
"66","000","00","140","0008","0177","522","262","260","5","527","1453","0","36.27","18.03"
"66","000","00","140","0009","0000","1754","806","948","15","1769","4953","0","35.72","16.27"
"66","000","00","140","0009","0178","463","207","256","5","468","1231","0","38.02","16.82"
"66","000","00","140","0009","0179","413","202","211","2","415","1235","0","33.60","16.36"
"66","000","00","140","0009","0180","456","212","244","3","459","1237","0","37.11","17.14"
"66","000","00","140","0009","0181","422","185","237","5","427","1250","0","34.16","14.80"
"66","000","00","140","0010","0000","2874","1376","1498","42","2916","7509","0","38.83","18.32"
"66","000","00","140","0010","0182","408","203","205","8","416","962","0","43.24","21.10"
"66","000","00","140","0010","0183","479","212","267","3","482","1238","0","38.93","17.12"
"66","000","00","140","0010","0184","529","211","318","7","536","1409","0","38.04","14.98"
"66","000","00","140","0010","0185","421","205","216","9","430","1181","0","36.41","17.36"
"66","000","00","140","0010","0186","460","243","217","8","468","1254","0","37.32","19.38"
"66","000","00","140","0010","0187","577","302","275","7","584","1465","0","39.86","20.61"
"66","000","00","140","0011","0000","2190","1036","1154","24","2214","5687","0","38.93","18.22"
"66","000","00","140","0011","0188","551","263","288","2","553","1466","0","37.72","17.94"
"66","000","00","140","0011","0189","517","271","246","8","525","1348","0","38.95","20.10"
"66","000","00","140","0011","0190","473","205","268","9","482","1289","0","37.39","15.90"
"66","000","00","140","0011","0191","649","297","352","5","654","1584","0","41.29","18.75"
"66","000","00","140","0012","0000","828","379","449","9","837","2322","0","36.05","16.32"
"66","000","00","140","0012","0192","360","180","180","3","363","1034","0","35.11","17.41"
"66","000","00","140","0012","0193","468","199","269","6","474","1288","0","36.80","15.45"
"66","000","00","140","0013","0000","860","378","482","11","871","2298","0","37.90","16.45"
"66","000","00","140","0013","0194","400","170","230","3","403","1077","0","37.42","15.78"
"66","000","00","140","0013","0195","460","208","252","8","468","1221","0","38.33","17.04"
"66","000","00","140","0014","0000","927","419","508","9","936","2493","0","37.55","16.81"
"66","000","00","140","0014","0196","506","237","269","7","513","1394","0","36.80","17.00"
"66","000","00","140","0014","0197","421","182","239","2","423","1099","0","38.49","16.56"
"66","000","00","150","0000","0000","17375","8627","8748","233","17608","45052","54126","39.08","19.15"
"66","000","00","150","0001","0000","775","516","259","20","795","2076","0","38.29","24.86"
"66","000","00","150","0001","0456","328","210","118","7","335","882","0","37.98","23.81"
"66","000","00","150","0001","0457","447","306","141","13","460","1194","0","38.53","25.63"
"66","000","00","150","0002","0000","388","197","191","5","393","1031","0","38.12","19.11"
"66","000","00","150","0002","0458","388","197","191","5","393","1031","0","38.12","19.11"
"66","000","00","150","0003","0000","1187","707","480","17","1204","3086","0","39.01","22.91"
"66","000","00","150","0003","0459","408","236","172","1","409","1085","0","37.70","21.75"
"66","000","00","150","0003","0460","392","256","136","10","402","1020","0","39.41","25.10"
"66","000","00","150","0003","0461","387","215","172","6","393","981","0","40.06","21.92"
"66","000","00","150","0004","0000","1559","783","776","18","1577","3652","0","43.18","21.44"
"66","000","00","150","0004","0464","497","255","242","4","501","1169","0","42.86","21.81"
"66","000","00","150","0004","0465","510","243","267","6","516","1156","0","44.64","21.02"
"66","000","00","150","0004","0466","552","285","267","8","560","1327","0","42.20","21.48"
"66","000","00","150","0005","0000","831","408","423","8","839","2136","0","39.28","19.10"
"66","000","00","150","0005","0467","393","192","201","1","394","991","0","39.76","19.37"
"66","000","00","150","0005","0468","438","216","222","7","445","1145","0","38.86","18.86"
"66","000","00","150","0006","0000","1921","1005","916","17","1938","4739","0","40.89","21.21"
"66","000","00","150","0006","0469","445","242","203","6","451","1171","0","38.51","20.67"
"66","000","00","150","0006","0470","491","261","230","3","494","1133","0","43.60","23.04"
"66","000","00","150","0006","0471","450","226","224","3","453","1252","0","36.18","18.05"
"66","000","00","150","0006","0472","535","276","259","5","540","1183","0","45.65","23.33"
"66","000","00","150","0007","0000","764","323","441","3","767","1917","0","40.01","16.85"
"66","000","00","150","0007","0473","371","172","199","1","372","954","0","38.99","18.03"
"66","000","00","150","0007","0474","393","151","242","2","395","963","0","41.02","15.68"
"66","000","00","150","0008","0000","1326","623","703","16","1342","3347","0","40.10","18.61"
"66","000","00","150","0008","0475","481","225","256","9","490","1173","0","41.77","19.18"
"66","000","00","150","0008","0476","457","201","256","4","461","1136","0","40.58","17.69"
"66","000","00","150","0008","0477","388","197","191","3","391","1038","0","37.67","18.98"
"66","000","00","150","0009","0000","1428","626","802","17","1445","3538","0","40.84","17.69"
"66","000","00","150","0009","0478","570","270","300","10","580","1278","0","45.38","21.13"
"66","000","00","150","0009","0479","408","152","256","3","411","1102","0","37.30","13.79"
"66","000","00","150","0009","0480","450","204","246","4","454","1158","0","39.21","17.62"
"66","000","00","150","0010","0000","935","406","529","16","951","2376","0","40.03","17.09"
"66","000","00","150","0010","0481","468","211","257","9","477","1179","0","40.46","17.90"
"66","000","00","150","0010","0482","467","195","272","7","474","1197","0","39.60","16.29"
"66","000","00","150","0011","0000","816","409","407","14","830","2187","0","37.95","18.70"
"66","000","00","150","0011","0483","449","224","225","10","459","1183","0","38.80","18.93"
"66","000","00","150","0011","0484","367","185","182","4","371","1004","0","36.95","18.43"
"66","000","00","150","0012","0000","613","275","338","9","622","1559","0","39.90","17.64"
"66","000","00","150","0012","0485","275","132","143","3","278","696","0","39.94","18.97"
"66","000","00","150","0012","0486","338","143","195","6","344","863","0","39.86","16.57"
"66","000","00","150","0013","0000","707","344","363","5","712","2131","0","33.41","16.14"
"66","000","00","150","0013","0487","355","179","176","4","359","1051","0","34.16","17.03"
"66","000","00","150","0013","0488","352","165","187","1","353","1080","0","32.69","15.28"
"66","000","00","150","0014","0000","1140","574","566","16","1156","3198","0","36.15","17.95"
"66","000","00","150","0014","0489","379","181","198","11","390","1084","0","35.98","16.70"
"66","000","00","150","0014","0490","425","202","223","4","429","1118","0","38.37","18.07"
"66","000","00","150","0014","0491","336","191","145","1","337","996","0","33.84","19.18"
"66","000","00","150","0015","0000","519","235","284","7","526","1393","0","37.76","16.87"
"66","000","00","150","0015","0496","519","235","284","7","526","1393","0","37.76","16.87"
"66","000","00","150","0016","0000","734","327","407","16","750","2139","0","35.06","15.29"
"66","000","00","150","0016","0494","380","155","225","7","387","1032","0","37.50","15.02"
"66","000","00","150","0016","0495","354","172","182","9","363","1107","0","32.79","15.54"
"66","000","00","150","0017","0000","769","306","463","12","781","1956","0","39.93","15.64"
"66","000","00","150","0017","0492","398","172","226","5","403","986","0","40.87","17.44"
"66","000","00","150","0017","0493","371","134","237","7","378","970","0","38.97","13.81"
"66","000","00","150","0018","0000","963","563","400","17","980","2591","0","37.82","21.73"
"66","000","00","150","0018","0462","482","283","199","7","489","1380","0","35.43","20.51"
"66","000","00","150","0018","0463","481","280","201","10","491","1211","0","40.55","23.12"
"66","000","00","160","0000","0000","21588","9076","12512","223","21811","54903","65143","39.73","16.53"
"66","000","00","160","0001","0000","1231","608","623","17","1248","3173","0","39.33","19.16"
"66","000","00","160","0001","0497","406","188","218","7","413","1055","0","39.15","17.82"
"66","000","00","160","0001","0498","393","204","189","7","400","978","0","40.90","20.86"
"66","000","00","160","0001","0499","432","216","216","3","435","1140","0","38.16","18.95"
"66","000","00","160","0002","0000","957","440","517","8","965","2296","0","42.03","19.16"
"66","000","00","160","0002","0500","499","227","272","5","504","1240","0","40.65","18.31"
"66","000","00","160","0002","0501","458","213","245","3","461","1056","0","43.66","20.17"
"66","000","00","160","0003","0000","1059","456","603","5","1064","2611","0","40.75","17.46"
"66","000","00","160","0003","0502","521","228","293","0","521","1298","0","40.14","17.57"
"66","000","00","160","0003","0503","538","228","310","5","543","1313","0","41.36","17.36"
"66","000","00","160","0004","0000","937","350","587","8","945","2220","0","42.57","15.77"
"66","000","00","160","0004","0504","475","168","307","5","480","1138","0","42.18","14.76"
"66","000","00","160","0004","0505","462","182","280","3","465","1082","0","42.98","16.82"
"66","000","00","160","0005","0000","2840","1225","1615","18","2858","7481","0","38.20","16.37"
"66","000","00","160","0005","0514","459","209","250","3","462","1258","0","36.72","16.61"
"66","000","00","160","0005","0515","462","214","248","2","464","1250","0","37.12","17.12"
"66","000","00","160","0005","0516","494","211","283","2","496","1377","0","36.02","15.32"
"66","000","00","160","0005","0517","445","195","250","2","447","1131","0","39.52","17.24"
"66","000","00","160","0005","0518","477","185","292","2","479","1232","0","38.88","15.02"
"66","000","00","160","0005","0519","503","211","292","7","510","1233","0","41.36","17.11"
"66","000","00","160","0006","0000","2093","806","1287","19","2112","5257","0","40.18","15.33"
"66","000","00","160","0006","0520","469","187","282","9","478","1379","0","34.66","13.56"
"66","000","00","160","0006","0521","529","197","332","3","532","1150","0","46.26","17.13"
"66","000","00","160","0006","0522","581","223","358","3","584","1442","0","40.50","15.46"
"66","000","00","160","0006","0523","514","199","315","4","518","1286","0","40.28","15.47"
"66","000","00","160","0007","0000","1083","415","668","5","1088","2555","0","42.58","16.24"
"66","000","00","160","0007","0524","531","212","319","2","533","1170","0","45.56","18.12"
"66","000","00","160","0007","0525","552","203","349","3","555","1385","0","40.07","14.66"
"66","000","00","160","0008","0000","1183","437","746","14","1197","2845","0","42.07","15.36"
"66","000","00","160","0008","0530","644","242","402","3","647","1444","0","44.81","16.76"
"66","000","00","160","0008","0531","539","195","344","11","550","1401","0","39.26","13.92"
"66","000","00","160","0009","0000","1682","762","920","15","1697","4465","0","38.01","17.07"
"66","000","00","160","0009","0526","479","197","282","3","482","1118","0","43.11","17.62"
"66","000","00","160","0009","0527","448","183","265","2","450","1124","0","40.04","16.28"
"66","000","00","160","0009","0528","339","188","151","6","345","1005","0","34.33","18.71"
"66","000","00","160","0009","0529","416","194","222","4","420","1218","0","34.48","15.93"
"66","000","00","160","0010","0000","2785","1167","1618","30","2815","7152","0","39.36","16.32"
"66","000","00","160","0010","0532","424","189","235","2","426","1229","0","34.66","15.38"
"66","000","00","160","0010","0533","477","193","284","4","481","1303","0","36.91","14.81"
"66","000","00","160","0010","0534","426","156","270","7","433","1075","0","40.28","14.51"
"66","000","00","160","0010","0535","548","234","314","4","552","1311","0","42.11","17.85"
"66","000","00","160","0010","0536","402","166","236","9","411","1024","0","40.14","16.21"
"66","000","00","160","0010","0537","508","229","279","4","512","1210","0","42.31","18.93"
"66","000","00","160","0011","0000","1077","398","679","17","1094","2539","0","43.09","15.68"
"66","000","00","160","0011","0538","537","189","348","8","545","1215","0","44.86","15.56"
"66","000","00","160","0011","0539","540","209","331","9","549","1324","0","41.47","15.79"
"66","000","00","160","0012","0000","1107","478","629","21","1128","2800","0","40.29","17.07"
"66","000","00","160","0012","0540","549","268","281","7","556","1464","0","37.98","18.31"
"66","000","00","160","0012","0541","558","210","348","14","572","1336","0","42.81","15.72"
"66","000","00","160","0013","0000","887","426","461","18","905","2268","0","39.90","18.78"
"66","000","00","160","0013","0506","506","205","301","11","517","1199","0","43.12","17.10"
"66","000","00","160","0013","0507","381","221","160","7","388","1069","0","36.30","20.67"
"66","000","00","160","0014","0000","1456","563","893","15","1471","4135","0","35.57","13.62"
"66","000","00","160","0014","0510","478","171","307","1","479","1301","0","36.82","13.14"
"66","000","00","160","0014","0511","528","213","315","10","538","1396","0","38.54","15.26"
"66","000","00","160","0014","0512","450","179","271","4","454","1438","0","31.57","12.45"
"66","000","00","160","0015","0000","799","393","406","9","808","2090","0","38.66","18.80"
"66","000","00","160","0015","0508","393","178","215","5","398","887","0","44.87","20.07"
"66","000","00","160","0015","0509","406","215","191","4","410","1203","0","34.08","17.87"
"66","000","00","160","0016","0000","412","152","260","4","416","1016","0","40.94","14.96"
"66","000","00","160","0016","0513","412","152","260","4","416","1016","0","40.94","14.96"
"66","000","00","170","0000","0000","37639","18325","19314","339","37978","91035","109158","41.72","20.13"
"66","000","00","170","0001","0000","4316","2074","2242","36","4352","10990","0","39.60","18.87"
"66","000","00","170","0001","0600","458","216","242","6","464","1184","0","39.19","18.24"
"66","000","00","170","0001","0601","467","217","250","3","470","1267","0","37.10","17.13"
"66","000","00","170","0001","0602","495","209","286","3","498","1322","0","37.67","15.81"
"66","000","00","170","0001","0603","388","194","194","3","391","987","0","39.61","19.66"
"66","000","00","170","0001","0604","567","273","294","2","569","1376","0","41.35","19.84"
"66","000","00","170","0001","0605","590","314","276","9","599","1485","0","40.34","21.14"
"66","000","00","170","0001","0606","469","228","241","5","474","1199","0","39.53","19.02"
"66","000","00","170","0001","0607","460","231","229","2","462","1120","0","41.25","20.63"
"66","000","00","170","0001","0608","422","192","230","3","425","1050","0","40.48","18.29"
"66","000","00","170","0002","0000","595","230","365","7","602","1262","0","47.70","18.23"
"66","000","00","170","0002","0597","595","230","365","7","602","1262","0","47.70","18.23"
"66","000","00","170","0003","0000","1020","524","496","5","1025","2378","0","43.10","22.04"
"66","000","00","170","0003","0598","487","265","222","2","489","1119","0","43.70","23.68"
"66","000","00","170","0003","0599","533","259","274","3","536","1259","0","42.57","20.57"
"66","000","00","170","0004","0000","4195","2175","2020","27","4222","10488","0","40.26","20.74"
"66","000","00","170","0004","0609","568","276","292","2","570","1308","0","43.58","21.10"
"66","000","00","170","0004","0610","520","266","254","5","525","1379","0","38.07","19.29"
"66","000","00","170","0004","0611","465","236","229","2","467","1426","0","32.75","16.55"
"66","000","00","170","0004","0612","462","252","210","5","467","1145","0","40.79","22.01"
"66","000","00","170","0004","0613","608","335","273","7","615","1425","0","43.16","23.51"
"66","000","00","170","0004","0614","634","321","313","4","638","1463","0","43.61","21.94"
"66","000","00","170","0004","0615","561","315","246","1","562","1339","0","41.97","23.53"
"66","000","00","170","0004","0616","377","174","203","1","378","1003","0","37.69","17.35"
"66","000","00","170","0005","0000","2275","1191","1084","21","2296","5345","0","42.96","22.28"
"66","000","00","170","0005","0617","652","340","312","8","660","1422","0","46.41","23.91"
"66","000","00","170","0005","0618","523","274","249","3","526","1365","0","38.53","20.07"
"66","000","00","170","0005","0619","567","305","262","4","571","1269","0","45.00","24.03"
"66","000","00","170","0005","0620","533","272","261","6","539","1289","0","41.82","21.10"
"66","000","00","170","0006","0000","3867","1999","1868","27","3894","9332","0","41.73","21.42"
"66","000","00","170","0006","0635","601","327","274","5","606","1324","0","45.77","24.70"
"66","000","00","170","0006","0636","612","316","296","5","617","1311","0","47.06","24.10"
"66","000","00","170","0006","0637","550","280","270","2","552","1372","0","40.23","20.41"
"66","000","00","170","0006","0638","603","277","326","2","605","1407","0","43.00","19.69"
"66","000","00","170","0006","0639","533","286","247","5","538","1325","0","40.60","21.58"
"66","000","00","170","0006","0640","461","236","225","1","462","1298","0","35.59","18.18"
"66","000","00","170","0006","0641","507","277","230","7","514","1295","0","39.69","21.39"
"66","000","00","170","0007","0000","5007","2360","2647","51","5058","12018","0","42.09","19.64"
"66","000","00","170","0007","0642","557","280","277","5","562","1369","0","41.05","20.45"
"66","000","00","170","0007","0643","588","263","325","9","597","1354","0","44.09","19.42"
"66","000","00","170","0007","0644","546","221","325","8","554","1268","0","43.69","17.43"
"66","000","00","170","0007","0645","604","293","311","7","611","1458","0","41.91","20.10"
"66","000","00","170","0007","0646","581","298","283","5","586","1250","0","46.88","23.84"
"66","000","00","170","0007","0647","513","281","232","8","521","1219","0","42.74","23.05"
"66","000","00","170","0007","0648","540","253","287","2","542","1470","0","36.87","17.21"
"66","000","00","170","0007","0649","598","258","340","2","600","1314","0","45.66","19.63"
"66","000","00","170","0007","0650","480","213","267","5","485","1316","0","36.85","16.19"
"66","000","00","170","0008","0000","1219","558","661","9","1228","2801","0","43.84","19.92"
"66","000","00","170","0008","0651","626","270","356","4","630","1453","0","43.36","18.58"
"66","000","00","170","0008","0652","593","288","305","5","598","1348","0","44.36","21.36"
"66","000","00","170","0009","0000","2549","1180","1369","27","2576","6066","0","42.47","19.45"
"66","000","00","170","0009","0653","622","334","288","7","629","1464","0","42.96","22.81"
"66","000","00","170","0009","0654","602","272","330","6","608","1529","0","39.76","17.79"
"66","000","00","170","0009","0655","654","301","353","4","658","1544","0","42.62","19.49"
"66","000","00","170","0009","0656","671","273","398","10","681","1529","0","44.54","17.85"
"66","000","00","170","0010","0000","2109","887","1222","26","2135","4733","0","45.11","18.74"
"66","000","00","170","0010","0657","552","257","295","7","559","1303","0","42.90","19.72"
"66","000","00","170","0010","0658","478","197","281","7","485","1066","0","45.50","18.48"
"66","000","00","170","0010","0659","536","236","300","8","544","1234","0","44.08","19.12"
"66","000","00","170","0010","0660","543","197","346","4","547","1130","0","48.41","17.43"
"66","000","00","170","0011","0000","1613","709","904","15","1628","3997","0","40.73","17.74"
"66","000","00","170","0011","0661","573","210","363","4","577","1442","0","40.01","14.56"
"66","000","00","170","0011","0662","594","299","295","6","600","1447","0","41.47","20.66"
"66","000","00","170","0011","0663","446","200","246","5","451","1108","0","40.70","18.05"
"66","000","00","170","0012","0000","663","252","411","4","667","1536","0","43.42","16.41"
"66","000","00","170","0012","0664","663","252","411","4","667","1536","0","43.42","16.41"
"66","000","00","170","0013","0000","1569","734","835","26","1595","4262","0","37.42","17.22"
"66","000","00","170","0013","0665","557","238","319","9","566","1374","0","41.19","17.32"
"66","000","00","170","0013","0666","556","270","286","9","565","1421","0","39.76","19.00"
"66","000","00","170","0013","0667","456","226","230","8","464","1467","0","31.63","15.41"
"66","000","00","170","0014","0000","1764","895","869","10","1774","4319","0","41.07","20.72"
"66","000","00","170","0014","0621","489","255","234","5","494","1307","0","37.80","19.51"
"66","000","00","170","0014","0622","551","311","240","4","555","1219","0","45.53","25.51"
"66","000","00","170","0014","0623","306","122","184","0","306","711","0","43.04","17.16"
"66","000","00","170","0014","0624","418","207","211","1","419","1082","0","38.72","19.13"
"66","000","00","170","0015","0000","2890","1536","1354","25","2915","6933","0","42.05","22.15"
"66","000","00","170","0015","0625","507","265","242","2","509","1302","0","39.09","20.35"
"66","000","00","170","0015","0626","463","251","212","2","465","1045","0","44.50","24.02"
"66","000","00","170","0015","0627","489","281","208","7","496","1155","0","42.94","24.33"
"66","000","00","170","0015","0628","511","297","214","2","513","1231","0","41.67","24.13"
"66","000","00","170","0015","0629","445","201","244","5","450","998","0","45.09","20.14"
"66","000","00","170","0015","0630","475","241","234","7","482","1202","0","40.10","20.05"
"66","000","00","170","0016","0000","1988","1021","967","23","2011","4575","0","43.96","22.32"
"66","000","00","170","0016","0631","636","320","316","3","639","1360","0","46.99","23.53"
"66","000","00","170","0016","0632","528","288","240","9","537","1215","0","44.20","23.70"
"66","000","00","170","0016","0633","396","203","193","4","400","901","0","44.40","22.53"
"66","000","00","170","0016","0634","428","210","218","7","435","1099","0","39.58","19.11"
"66","000","00","180","0000","0000","30354","15248","15106","302","30656","78438","95800","39.08","19.44"
"66","000","00","180","0001","0000","1785","870","915","18","1803","4325","0","41.69","20.12"
"66","000","00","180","0001","0546","592","311","281","6","598","1407","0","42.50","22.10"
"66","000","00","180","0001","0547","603","294","309","6","609","1456","0","41.83","20.19"
"66","000","00","180","0001","0548","590","265","325","6","596","1462","0","40.77","18.13"
"66","000","00","180","0002","0000","3621","1699","1922","31","3652","9201","0","39.69","18.47"
"66","000","00","180","0002","0578","589","289","300","3","592","1527","0","38.77","18.93"
"66","000","00","180","0002","0579","617","310","307","5","622","1547","0","40.21","20.04"
"66","000","00","180","0002","0580","593","286","307","4","597","1502","0","39.75","19.04"
"66","000","00","180","0002","0581","609","289","320","7","616","1502","0","41.01","19.24"
"66","000","00","180","0002","0582","558","236","322","8","566","1577","0","35.89","14.97"
"66","000","00","180","0002","0583","655","289","366","4","659","1546","0","42.63","18.69"
"66","000","00","180","0003","0000","2396","1305","1091","29","2425","6208","0","39.06","21.02"
"66","000","00","180","0003","0584","543","387","156","6","549","1489","0","36.87","25.99"
"66","000","00","180","0003","0585","693","310","383","12","705","1673","0","42.14","18.53"
"66","000","00","180","0003","0586","527","303","224","5","532","1495","0","35.59","20.27"
"66","000","00","180","0003","0587","633","305","328","6","639","1551","0","41.20","19.66"
"66","000","00","180","0004","0000","1340","598","742","16","1356","3353","0","40.44","17.83"
"66","000","00","180","0004","0588","408","178","230","7","415","1002","0","41.42","17.76"
"66","000","00","180","0004","0589","478","203","275","5","483","1182","0","40.86","17.17"
"66","000","00","180","0004","0590","454","217","237","4","458","1169","0","39.18","18.56"
"66","000","00","180","0005","0000","1298","950","348","15","1313","3594","0","36.53","26.43"
"66","000","00","180","0005","0594","362","291","71","7","369","1107","0","33.33","26.29"
"66","000","00","180","0005","0595","425","288","137","5","430","1175","0","36.60","24.51"
"66","000","00","180","0005","0596","511","371","140","3","514","1312","0","39.18","28.28"
"66","000","00","180","0006","0000","1699","822","877","19","1718","4313","0","39.83","19.06"
"66","000","00","180","0006","0591","561","264","297","7","568","1434","0","39.61","18.41"
"66","000","00","180","0006","0592","633","305","328","9","642","1557","0","41.23","19.59"
"66","000","00","180","0006","0593","505","253","252","3","508","1322","0","38.43","19.14"
"66","000","00","180","0007","0000","2035","992","1043","29","2064","5252","0","39.30","18.89"
"66","000","00","180","0007","0553","517","248","269","13","530","1293","0","40.99","19.18"
"66","000","00","180","0007","0554","603","277","326","6","609","1464","0","41.60","18.92"
"66","000","00","180","0007","0555","429","206","223","6","435","1194","0","36.43","17.25"
"66","000","00","180","0007","0556","486","261","225","4","490","1301","0","37.66","20.06"
"66","000","00","180","0008","0000","1750","813","937","19","1769","4779","0","37.02","17.01"
"66","000","00","180","0008","0564","554","255","299","5","559","1664","0","33.59","15.32"
"66","000","00","180","0008","0565","606","286","320","2","608","1558","0","39.02","18.36"
"66","000","00","180","0008","0566","590","272","318","12","602","1557","0","38.66","17.47"
"66","000","00","180","0009","0000","2294","1053","1241","22","2316","6244","0","37.09","16.86"
"66","000","00","180","0009","0567","588","272","316","2","590","1557","0","37.89","17.47"
"66","000","00","180","0009","0568","563","268","295","5","568","1511","0","37.59","17.74"
"66","000","00","180","0009","0569","533","215","318","5","538","1529","0","35.19","14.06"
"66","000","00","180","0009","0570","610","298","312","10","620","1647","0","37.64","18.09"
"66","000","00","180","0010","0000","2313","1192","1121","17","2330","5915","0","39.39","20.15"
"66","000","00","180","0010","0557","597","300","297","6","603","1450","0","41.59","20.69"
"66","000","00","180","0010","0558","568","276","292","2","570","1525","0","37.38","18.10"
"66","000","00","180","0010","0559","614","320","294","4","618","1467","0","42.13","21.81"
"66","000","00","180","0010","0560","534","296","238","5","539","1473","0","36.59","20.10"
"66","000","00","180","0011","0000","1926","1008","918","14","1940","4622","0","41.97","21.81"
"66","000","00","180","0011","0561","665","352","313","5","670","1599","0","41.90","22.01"
"66","000","00","180","0011","0562","615","328","287","4","619","1526","0","40.56","21.49"
"66","000","00","180","0011","0563","646","328","318","5","651","1497","0","43.49","21.91"
"66","000","00","180","0012","0000","2273","1085","1188","22","2295","6037","0","38.02","17.97"
"66","000","00","180","0012","0542","580","317","263","3","583","1504","0","38.76","21.08"
"66","000","00","180","0012","0543","567","232","335","2","569","1478","0","38.50","15.70"
"66","000","00","180","0012","0544","501","201","300","9","510","1538","0","33.16","13.07"
"66","000","00","180","0012","0545","625","335","290","8","633","1517","0","41.73","22.08"
"66","000","00","180","0013","0000","2344","1217","1127","22","2366","6021","0","39.30","20.21"
"66","000","00","180","0013","0549","581","329","252","4","585","1530","0","38.24","21.50"
"66","000","00","180","0013","0550","606","335","271","6","612","1547","0","39.56","21.65"
"66","000","00","180","0013","0551","626","296","330","4","630","1499","0","42.03","19.75"
"66","000","00","180","0013","0552","531","257","274","8","539","1445","0","37.30","17.79"
"66","000","00","180","0014","0000","1951","963","988","19","1970","5029","0","39.17","19.15"
"66","000","00","180","0014","0571","476","255","221","4","480","1310","0","36.64","19.47"
"66","000","00","180","0014","0572","522","265","257","6","528","1313","0","40.21","20.18"
"66","000","00","180","0014","0573","484","234","250","4","488","1210","0","40.33","19.34"
"66","000","00","180","0014","0574","469","209","260","5","474","1196","0","39.63","17.47"
"66","000","00","180","0015","0000","1329","681","648","10","1339","3545","0","37.77","19.21"
"66","000","00","180","0015","0575","392","185","207","3","395","1034","0","38.20","17.89"
"66","000","00","180","0015","0576","480","250","230","3","483","1122","0","43.05","22.28"
"66","000","00","180","0015","0577","457","246","211","4","461","1389","0","33.19","17.71"
"66","000","00","190","0000","0000","8046","4052","3994","133","8179","20710","23859","39.49","19.57"
"66","000","00","190","0001","0000","1368","741","627","19","1387","3261","0","42.53","22.72"
"66","000","00","190","0001","1792","448","219","229","7","455","1005","0","45.27","21.79"
"66","000","00","190","0001","1793","487","261","226","5","492","1181","0","41.66","22.10"
"66","000","00","190","0001","1794","433","261","172","7","440","1075","0","40.93","24.28"
"66","000","00","190","0002","0000","606","338","268","7","613","1835","0","33.41","18.42"
"66","000","00","190","0002","1795","300","161","139","2","302","906","0","33.33","17.77"
"66","000","00","190","0002","1796","306","177","129","5","311","929","0","33.48","19.05"
"66","000","00","190","0003","0000","537","275","262","6","543","1342","0","40.46","20.49"
"66","000","00","190","0003","1797","537","275","262","6","543","1342","0","40.46","20.49"
"66","000","00","190","0004","0000","381","152","229","8","389","986","0","39.45","15.42"
"66","000","00","190","0004","1798","381","152","229","8","389","986","0","39.45","15.42"
"66","000","00","190","0005","0000","467","162","305","5","472","1156","0","40.83","14.01"
"66","000","00","190","0005","1799","467","162","305","5","472","1156","0","40.83","14.01"
"66","000","00","190","0006","0000","720","383","337","17","737","1879","0","39.22","20.38"
"66","000","00","190","0006","1800","391","199","192","9","400","987","0","40.53","20.16"
"66","000","00","190","0006","1801","329","184","145","8","337","892","0","37.78","20.63"
"66","000","00","190","0007","0000","1157","480","677","21","1178","2983","0","39.49","16.09"
"66","000","00","190","0007","1802","381","196","185","4","385","1047","0","36.77","18.72"
"66","000","00","190","0007","1803","396","155","241","13","409","1060","0","38.58","14.62"
"66","000","00","190","0007","1804","380","129","251","4","384","876","0","43.84","14.73"
"66","000","00","190","0008","0000","265","203","62","2","267","582","0","45.88","34.88"
"66","000","00","190","0008","1805","265","203","62","2","267","582","0","45.88","34.88"
"66","000","00","190","0009","0000","1099","495","604","16","1115","2927","0","38.09","16.91"
"66","000","00","190","0009","1806","369","181","188","4","373","1004","0","37.15","18.03"
"66","000","00","190","0009","1807","361","138","223","7","368","909","0","40.48","15.18"
"66","000","00","190","0009","1808","369","176","193","5","374","1014","0","36.88","17.36"
"66","000","00","190","0010","0000","492","299","193","6","498","1187","0","41.95","25.19"
"66","000","00","190","0010","1809","492","299","193","6","498","1187","0","41.95","25.19"
"66","000","00","190","0011","0000","318","130","188","8","326","885","0","36.84","14.69"
"66","000","00","190","0011","1810","110","60","50","2","112","229","0","48.91","26.20"
"66","000","00","190","0011","1811","208","70","138","6","214","656","0","32.62","10.67"
"66","000","00","190","0012","0000","223","167","56","9","232","575","0","40.35","29.04"
"66","000","00","190","0012","1812","223","167","56","9","232","575","0","40.35","29.04"
"66","000","00","190","0013","0000","413","227","186","9","422","1112","0","37.95","20.41"
"66","000","00","190","0013","1813","319","159","160","7","326","897","0","36.34","17.73"
"66","000","00","190","0013","1814","94","68","26","2","96","215","0","44.65","31.63"
"66","000","00","200","0000","0000","5219","2789","2430","76","5295","12679","14532","41.76","22.00"
"66","000","00","200","0001","0000","440","229","211","6","446","1210","0","36.86","18.93"
"66","000","00","200","0001","1781","440","229","211","6","446","1210","0","36.86","18.93"
"66","000","00","200","0002","0000","641","321","320","15","656","1518","0","43.21","21.15"
"66","000","00","200","0002","1782","641","321","320","15","656","1518","0","43.21","21.15"
"66","000","00","200","0003","0000","522","271","251","4","526","1204","0","43.69","22.51"
"66","000","00","200","0003","1783","522","271","251","4","526","1204","0","43.69","22.51"
"66","000","00","200","0004","0000","459","215","244","10","469","1232","0","38.07","17.45"
"66","000","00","200","0004","1784","459","215","244","10","469","1232","0","38.07","17.45"
"66","000","00","200","0005","0000","262","130","132","1","263","638","0","41.22","20.38"
"66","000","00","200","0005","1785","262","130","132","1","263","638","0","41.22","20.38"
"66","000","00","200","0006","0000","628","319","309","9","637","1443","0","44.14","22.11"
"66","000","00","200","0006","1786","628","319","309","9","637","1443","0","44.14","22.11"
"66","000","00","200","0007","0000","749","404","345","15","764","1794","0","42.59","22.52"
"66","000","00","200","0007","1787","282","143","139","7","289","674","0","42.88","21.22"
"66","000","00","200","0007","1788","467","261","206","8","475","1120","0","42.41","23.30"
"66","000","00","200","0008","0000","417","245","172","3","420","1002","0","41.92","24.45"
"66","000","00","200","0008","1789","417","245","172","3","420","1002","0","41.92","24.45"
"66","000","00","200","0009","0000","573","337","236","8","581","1408","0","41.26","23.93"
"66","000","00","200","0009","1790","573","337","236","8","581","1408","0","41.26","23.93"
"66","000","00","200","0010","0000","528","318","210","5","533","1230","0","43.33","25.85"
"66","000","00","200","0010","1791","528","318","210","5","533","1230","0","43.33","25.85"
"66","000","00","210","0000","0000","9782","5152","4630","99","9881","27041","31790","36.54","19.05"
"66","000","00","210","0001","0000","388","213","175","2","390","1099","0","35.49","19.38"
"66","000","00","210","0001","0075","388","213","175","2","390","1099","0","35.49","19.38"
"66","000","00","210","0002","0000","774","431","343","6","780","2193","0","35.57","19.65"
"66","000","00","210","0002","0076","349","210","139","2","351","1038","0","33.82","20.23"
"66","000","00","210","0002","0077","425","221","204","4","429","1155","0","37.14","19.13"
"66","000","00","210","0003","0000","621","324","297","6","627","1887","0","33.23","17.17"
"66","000","00","210","0003","0087","396","213","183","2","398","1070","0","37.20","19.91"
"66","000","00","210","0003","0088","225","111","114","4","229","817","0","28.03","13.59"
"66","000","00","210","0004","0000","1761","991","770","20","1781","4680","0","38.06","21.18"
"66","000","00","210","0004","0078","418","235","183","3","421","1083","0","38.87","21.70"
"66","000","00","210","0004","0079","367","181","186","2","369","849","0","43.46","21.32"
"66","000","00","210","0004","0080","484","276","208","7","491","1305","0","37.62","21.15"
"66","000","00","210","0004","0081","492","299","193","8","500","1443","0","34.65","20.72"
"66","000","00","210","0005","0000","1256","636","620","13","1269","3392","0","37.41","18.75"
"66","000","00","210","0005","0089","397","201","196","8","405","1086","0","37.29","18.51"
"66","000","00","210","0005","0090","389","214","175","3","392","1086","0","36.10","19.71"
"66","000","00","210","0005","0091","470","221","249","2","472","1220","0","38.69","18.11"
"66","000","00","210","0006","0000","2334","1231","1103","28","2362","6342","0","37.24","19.41"
"66","000","00","210","0006","0082","415","219","196","10","425","1064","0","39.94","20.58"
"66","000","00","210","0006","0083","430","229","201","4","434","1212","0","35.81","18.89"
"66","000","00","210","0006","0084","437","223","214","4","441","1357","0","32.50","16.43"
"66","000","00","210","0006","0085","508","271","237","5","513","1367","0","37.53","19.82"
"66","000","00","210","0006","0086","544","289","255","5","549","1342","0","40.91","21.54"
"66","000","00","210","0007","0000","477","238","239","4","481","1384","0","34.75","17.20"
"66","000","00","210","0007","0095","477","238","239","4","481","1384","0","34.75","17.20"
"66","000","00","210","0008","0000","521","290","231","5","526","1210","0","43.47","23.97"
"66","000","00","210","0008","0094","521","290","231","5","526","1210","0","43.47","23.97"
"66","000","00","210","0009","0000","707","389","318","4","711","2115","0","33.62","18.39"
"66","000","00","210","0009","0092","295","166","129","2","297","944","0","31.46","17.58"
"66","000","00","210","0009","0093","412","223","189","2","414","1171","0","35.35","19.04"
"66","000","00","210","0010","0000","594","244","350","5","599","1581","0","37.89","15.43"
"66","000","00","210","0010","0096","295","102","193","3","298","815","0","36.56","12.52"
"66","000","00","210","0010","0097","299","142","157","2","301","766","0","39.30","18.54"
"66","000","00","210","0011","0000","349","165","184","6","355","1158","0","30.66","14.25"
"66","000","00","210","0011","0098","349","165","184","6","355","1158","0","30.66","14.25"
"66","000","00","220","0000","0000","5666","2621","3045","71","5737","16320","18688","35.15","16.06"
"66","000","00","220","0001","0000","357","122","235","5","362","1055","0","34.31","11.56"
"66","000","00","220","0001","0058","357","122","235","5","362","1055","0","34.31","11.56"
"66","000","00","220","0002","0000","355","164","191","2","357","1023","0","34.90","16.03"
"66","000","00","220","0002","0059","355","164","191","2","357","1023","0","34.90","16.03"
"66","000","00","220","0003","0000","858","387","471","10","868","2624","0","33.08","14.75"
"66","000","00","220","0003","0060","425","189","236","4","429","1210","0","35.45","15.62"
"66","000","00","220","0003","0061","433","198","235","6","439","1414","0","31.05","14.00"
"66","000","00","220","0004","0000","521","254","267","7","528","1502","0","35.15","16.91"
"66","000","00","220","0004","0064","355","175","180","6","361","872","0","41.40","20.07"
"66","000","00","220","0004","0065","166","79","87","1","167","630","0","26.51","12.54"
"66","000","00","220","0005","0000","396","170","226","4","400","1149","0","34.81","14.80"
"66","000","00","220","0005","0063","396","170","226","4","400","1149","0","34.81","14.80"
"66","000","00","220","0006","0000","448","195","253","2","450","1199","0","37.53","16.26"
"66","000","00","220","0006","0062","448","195","253","2","450","1199","0","37.53","16.26"
"66","000","00","220","0007","0000","337","164","173","9","346","889","0","38.92","18.45"
"66","000","00","220","0007","0066","337","164","173","9","346","889","0","38.92","18.45"
"66","000","00","220","0008","0000","560","267","293","10","570","1753","0","32.52","15.23"
"66","000","00","220","0008","0067","392","177","215","8","400","1291","0","30.98","13.71"
"66","000","00","220","0008","0068","168","90","78","2","170","462","0","36.80","19.48"
"66","000","00","220","0009","0000","335","156","179","3","338","1037","0","32.59","15.04"
"66","000","00","220","0009","0069","335","156","179","3","338","1037","0","32.59","15.04"
"66","000","00","220","0010","0000","449","243","206","5","454","1385","0","32.78","17.55"
"66","000","00","220","0010","0070","210","116","94","5","215","629","0","34.18","18.44"
"66","000","00","220","0010","0071","239","127","112","0","239","756","0","31.61","16.80"
"66","000","00","220","0011","0000","610","309","301","11","621","1738","0","35.73","17.78"
"66","000","00","220","0011","0072","341","147","194","7","348","938","0","37.10","15.67"
"66","000","00","220","0011","0073","269","162","107","4","273","800","0","34.13","20.25"
"66","000","00","220","0012","0000","440","190","250","3","443","966","0","45.86","19.67"
"66","000","00","220","0012","0074","440","190","250","3","443","966","0","45.86","19.67"
"66","000","00","230","0000","0000","28959","14052","14907","263","29222","63587","76907","45.96","22.10"
"66","000","00","230","0001","0000","4118","1946","2172","43","4161","8638","0","48.17","22.53"
"66","000","00","230","0001","0359","716","342","374","11","727","1437","0","50.59","23.80"
"66","000","00","230","0001","0360","617","293","324","5","622","1385","0","44.91","21.16"
"66","000","00","230","0001","0361","591","244","347","8","599","1271","0","47.13","19.20"
"66","000","00","230","0001","0362","695","318","377","5","700","1508","0","46.42","21.09"
"66","000","00","230","0001","0363","688","318","370","5","693","1415","0","48.98","22.47"
"66","000","00","230","0001","0364","811","431","380","9","820","1622","0","50.55","26.57"
"66","000","00","230","0002","0000","1150","523","627","15","1165","2486","0","46.86","21.04"
"66","000","00","230","0002","0365","588","256","332","10","598","1210","0","49.42","21.16"
"66","000","00","230","0002","0366","562","267","295","5","567","1276","0","44.44","20.92"
"66","000","00","230","0003","0000","2498","1264","1234","26","2524","5768","0","43.76","21.91"
"66","000","00","230","0003","0367","871","385","486","13","884","1785","0","49.52","21.57"
"66","000","00","230","0003","0368","690","326","364","5","695","1792","0","38.78","18.19"
"66","000","00","230","0003","0369","400","257","143","5","405","1012","0","40.02","25.40"
"66","000","00","230","0003","0370","537","296","241","3","540","1179","0","45.80","25.11"
"66","000","00","230","0004","0000","2457","1304","1153","20","2477","5795","0","42.74","22.50"
"66","000","00","230","0004","0371","660","348","312","4","664","1636","0","40.59","21.27"
"66","000","00","230","0004","0372","554","305","249","5","559","1379","0","40.54","22.12"
"66","000","00","230","0004","0373","607","315","292","11","618","1348","0","45.85","23.37"
"66","000","00","230","0004","0374","636","336","300","0","636","1432","0","44.41","23.46"
"66","000","00","230","0005","0000","1141","604","537","9","1150","2612","0","44.03","23.12"
"66","000","00","230","0005","0375","608","334","274","4","612","1389","0","44.06","24.05"
"66","000","00","230","0005","0376","533","270","263","5","538","1223","0","43.99","22.08"
"66","000","00","230","0006","0000","5796","2852","2944","34","5830","12829","0","45.44","22.23"
"66","000","00","230","0006","0377","747","452","295","5","752","1541","0","48.80","29.33"
"66","000","00","230","0006","0378","563","257","306","1","564","1305","0","43.22","19.69"
"66","000","00","230","0006","0379","609","277","332","2","611","1229","0","49.72","22.54"
"66","000","00","230","0006","0380","680","363","317","5","685","1492","0","45.91","24.33"
"66","000","00","230","0006","0381","492","178","314","6","498","1075","0","46.33","16.56"
"66","000","00","230","0006","0382","377","195","182","3","380","790","0","48.10","24.68"
"66","000","00","230","0006","0383","543","267","276","4","547","1426","0","38.36","18.72"
"66","000","00","230","0006","0384","577","248","329","3","580","1323","0","43.84","18.75"
"66","000","00","230","0006","0385","707","366","341","3","710","1419","0","50.04","25.79"
"66","000","00","230","0006","0386","501","249","252","2","503","1229","0","40.93","20.26"
"66","000","00","230","0007","0000","3567","1750","1817","28","3595","7556","0","47.58","23.16"
"66","000","00","230","0007","0387","650","281","369","9","659","1376","0","47.89","20.42"
"66","000","00","230","0007","0388","542","279","263","4","546","1280","0","42.66","21.80"
"66","000","00","230","0007","0389","689","364","325","1","690","1388","0","49.71","26.22"
"66","000","00","230","0007","0390","502","247","255","3","505","1069","0","47.24","23.11"
"66","000","00","230","0007","0391","603","310","293","1","604","1171","0","51.58","26.47"
"66","000","00","230","0007","0392","581","269","312","10","591","1272","0","46.46","21.15"
"66","000","00","230","0008","0000","797","335","462","10","807","1621","0","49.78","20.67"
"66","000","00","230","0008","0393","317","136","181","3","320","655","0","48.85","20.76"
"66","000","00","230","0008","0394","480","199","281","7","487","966","0","50.41","20.60"
"66","000","00","230","0009","0000","753","345","408","10","763","1676","0","45.53","20.58"
"66","000","00","230","0009","0395","753","345","408","10","763","1676","0","45.53","20.58"
"66","000","00","230","0010","0000","942","411","531","7","949","2095","0","45.30","19.62"
"66","000","00","230","0010","0396","395","157","238","3","398","884","0","45.02","17.76"
"66","000","00","230","0010","0397","547","254","293","4","551","1211","0","45.50","20.97"
"66","000","00","230","0011","0000","973","433","540","11","984","2196","0","44.81","19.72"
"66","000","00","230","0011","0398","545","265","280","5","550","1222","0","45.01","21.69"
"66","000","00","230","0011","0399","428","168","260","6","434","974","0","44.56","17.25"
"66","000","00","230","0012","0000","1921","892","1029","23","1944","4327","0","44.93","20.61"
"66","000","00","230","0012","0400","631","319","312","8","639","1383","0","46.20","23.07"
"66","000","00","230","0012","0401","735","338","397","11","746","1642","0","45.43","20.58"
"66","000","00","230","0012","0402","555","235","320","4","559","1302","0","42.93","18.05"
"66","000","00","230","0013","0000","1075","498","577","8","1083","2158","0","50.19","23.08"
"66","000","00","230","0013","0403","521","227","294","5","526","1037","0","50.72","21.89"
"66","000","00","230","0013","0404","554","271","283","3","557","1121","0","49.69","24.17"
"66","000","00","230","0014","0000","754","320","434","7","761","1651","0","46.09","19.38"
"66","000","00","230","0014","0405","754","320","434","7","761","1651","0","46.09","19.38"
"66","000","00","230","0015","0000","653","361","292","6","659","1350","0","48.81","26.74"
"66","000","00","230","0015","0406","653","361","292","6","659","1350","0","48.81","26.74"
"66","000","00","230","0016","0000","364","214","150","6","370","829","0","44.63","25.81"
"66","000","00","230","0016","0407","364","214","150","6","370","829","0","44.63","25.81"
"66","000","00","240","0000","0000","20491","10168","10323","199","20690","47755","56669","43.33","21.29"
"66","000","00","240","0001","0000","1738","798","940","19","1757","4325","0","40.62","18.45"
"66","000","00","240","0001","0320","628","284","344","9","637","1459","0","43.66","19.47"
"66","000","00","240","0001","0321","488","225","263","6","494","1373","0","35.98","16.39"
"66","000","00","240","0001","0322","622","289","333","4","626","1493","0","41.93","19.36"
"66","000","00","240","0002","0000","412","201","211","3","415","865","0","47.98","23.24"
"66","000","00","240","0002","0323","412","201","211","3","415","865","0","47.98","23.24"
"66","000","00","240","0003","0000","1490","694","796","13","1503","3486","0","43.12","19.91"
"66","000","00","240","0003","0324","569","284","285","6","575","1242","0","46.30","22.87"
"66","000","00","240","0003","0325","473","211","262","4","477","1254","0","38.04","16.83"
"66","000","00","240","0003","0326","448","199","249","3","451","990","0","45.56","20.10"
"66","000","00","240","0004","0000","640","315","325","8","648","1505","0","43.06","20.93"
"66","000","00","240","0004","0327","640","315","325","8","648","1505","0","43.06","20.93"
"66","000","00","240","0005","0000","1100","603","497","6","1106","2438","0","45.37","24.73"
"66","000","00","240","0005","0328","557","315","242","3","560","1188","0","47.14","26.52"
"66","000","00","240","0005","0329","543","288","255","3","546","1250","0","43.68","23.04"
"66","000","00","240","0006","0000","1128","576","552","6","1134","2601","0","43.60","22.15"
"66","000","00","240","0006","0330","582","293","289","4","586","1333","0","43.96","21.98"
"66","000","00","240","0006","0331","546","283","263","2","548","1268","0","43.22","22.32"
"66","000","00","240","0007","0000","1363","725","638","17","1380","3003","0","45.95","24.14"
"66","000","00","240","0007","0332","378","214","164","9","387","899","0","43.05","23.80"
"66","000","00","240","0007","0333","424","234","190","4","428","888","0","48.20","26.35"
"66","000","00","240","0007","0334","561","277","284","4","565","1216","0","46.46","22.78"
"66","000","00","240","0008","0000","1092","571","521","12","1104","2165","0","50.99","26.37"
"66","000","00","240","0008","0335","411","217","194","8","419","850","0","49.29","25.53"
"66","000","00","240","0008","0336","681","354","327","4","685","1315","0","52.09","26.92"
"66","000","00","240","0009","0000","400","220","180","3","403","819","0","49.21","26.86"
"66","000","00","240","0009","0337","400","220","180","3","403","819","0","49.21","26.86"
"66","000","00","240","0010","0000","727","356","371","7","734","1699","0","43.20","20.95"
"66","000","00","240","0010","0338","727","356","371","7","734","1699","0","43.20","20.95"
"66","000","00","240","0011","0000","767","342","425","9","776","1688","0","45.97","20.26"
"66","000","00","240","0011","0339","767","342","425","9","776","1688","0","45.97","20.26"
"66","000","00","240","0012","0000","368","207","161","6","374","943","0","39.66","21.95"
"66","000","00","240","0012","0340","368","207","161","6","374","943","0","39.66","21.95"
"66","000","00","240","0013","0000","574","285","289","10","584","1310","0","44.58","21.76"
"66","000","00","240","0013","0341","574","285","289","10","584","1310","0","44.58","21.76"
"66","000","00","240","0014","0000","3197","1688","1509","33","3230","7418","0","43.54","22.76"
"66","000","00","240","0014","0342","552","298","254","7","559","1316","0","42.48","22.64"
"66","000","00","240","0014","0343","521","248","273","5","526","1249","0","42.11","19.86"
"66","000","00","240","0014","0344","573","302","271","4","577","1369","0","42.15","22.06"
"66","000","00","240","0014","0345","533","265","268","6","539","1111","0","48.51","23.85"
"66","000","00","240","0014","0346","505","297","208","7","512","1213","0","42.21","24.48"
"66","000","00","240","0014","0347","513","278","235","4","517","1160","0","44.57","23.97"
"66","000","00","240","0015","0000","2056","971","1085","17","2073","5061","0","40.96","19.19"
"66","000","00","240","0015","0348","510","207","303","6","516","1197","0","43.11","17.29"
"66","000","00","240","0015","0349","568","262","306","6","574","1352","0","42.46","19.38"
"66","000","00","240","0015","0350","501","250","251","3","504","1212","0","41.58","20.63"
"66","000","00","240","0015","0351","477","252","225","2","479","1300","0","36.85","19.38"
"66","000","00","240","0016","0000","1943","805","1138","10","1953","4958","0","39.39","16.24"
"66","000","00","240","0016","0352","517","210","307","2","519","1302","0","39.86","16.13"
"66","000","00","240","0016","0353","479","193","286","2","481","1189","0","40.45","16.23"
"66","000","00","240","0016","0354","459","186","273","2","461","1192","0","38.67","15.60"
"66","000","00","240","0016","0355","488","216","272","4","492","1275","0","38.59","16.94"
"66","000","00","240","0017","0000","1496","811","685","20","1516","3471","0","43.68","23.37"
"66","000","00","240","0017","0356","468","199","269","7","475","1191","0","39.88","16.71"
"66","000","00","240","0017","0357","557","331","226","7","564","1187","0","47.51","27.89"
"66","000","00","240","0017","0358","471","281","190","6","477","1093","0","43.64","25.71"
"66","000","00","250","0000","0000","26501","13210","13291","280","26781","64759","78039","41.35","20.40"
"66","000","00","250","0001","0000","1234","628","606","10","1244","3019","0","41.21","20.80"
"66","000","00","250","0001","0269","377","170","207","5","382","932","0","40.99","18.24"
"66","000","00","250","0001","0270","324","160","164","1","325","852","0","38.15","18.78"
"66","000","00","250","0001","0271","533","298","235","4","537","1235","0","43.48","24.13"
"66","000","00","250","0002","0000","1159","579","580","6","1165","2849","0","40.89","20.32"
"66","000","00","250","0002","0272","581","278","303","5","586","1412","0","41.50","19.69"
"66","000","00","250","0002","0273","578","301","277","1","579","1437","0","40.29","20.95"
"66","000","00","250","0003","0000","771","404","367","13","784","1822","0","43.03","22.17"
"66","000","00","250","0003","0274","367","173","194","5","372","941","0","39.53","18.38"
"66","000","00","250","0003","0275","404","231","173","8","412","881","0","46.77","26.22"
"66","000","00","250","0004","0000","1576","756","820","18","1594","3624","0","43.98","20.86"
"66","000","00","250","0004","0276","562","265","297","7","569","1302","0","43.70","20.35"
"66","000","00","250","0004","0277","580","275","305","6","586","1264","0","46.36","21.76"
"66","000","00","250","0004","0278","434","216","218","5","439","1058","0","41.49","20.42"
"66","000","00","250","0005","0000","376","200","176","7","383","1043","0","36.72","19.18"
"66","000","00","250","0005","0279","376","200","176","7","383","1043","0","36.72","19.18"
"66","000","00","250","0006","0000","927","529","398","7","934","2271","0","41.13","23.29"
"66","000","00","250","0006","0280","553","337","216","4","557","1397","0","39.87","24.12"
"66","000","00","250","0006","0281","374","192","182","3","377","874","0","43.14","21.97"
"66","000","00","250","0007","0000","1980","862","1118","28","2008","5015","0","40.04","17.19"
"66","000","00","250","0007","0282","570","261","309","6","576","1465","0","39.32","17.82"
"66","000","00","250","0007","0283","576","296","280","12","588","1375","0","42.76","21.53"
"66","000","00","250","0007","0284","478","222","256","6","484","1318","0","36.72","16.84"
"66","000","00","250","0007","0285","356","83","273","4","360","857","0","42.01","9.68"
"66","000","00","250","0008","0000","1035","427","608","14","1049","2952","0","35.54","14.46"
"66","000","00","250","0008","0286","522","212","310","6","528","1533","0","34.44","13.83"
"66","000","00","250","0008","0287","513","215","298","8","521","1419","0","36.72","15.15"
"66","000","00","250","0009","0000","1967","839","1128","20","1987","4892","0","40.62","17.15"
"66","000","00","250","0009","0288","536","240","296","7","543","1172","0","46.33","20.48"
"66","000","00","250","0009","0289","471","179","292","6","477","1293","0","36.89","13.84"
"66","000","00","250","0009","0290","508","255","253","3","511","1256","0","40.68","20.30"
"66","000","00","250","0009","0291","452","165","287","4","456","1171","0","38.94","14.09"
"66","000","00","250","0010","0000","2187","1021","1166","25","2212","5745","0","38.50","17.77"
"66","000","00","250","0010","0292","571","262","309","5","576","1510","0","38.15","17.35"
"66","000","00","250","0010","0293","522","234","288","6","528","1421","0","37.16","16.47"
"66","000","00","250","0010","0294","526","273","253","7","533","1470","0","36.26","18.57"
"66","000","00","250","0010","0295","568","252","316","7","575","1344","0","42.78","18.75"
"66","000","00","250","0011","0000","3085","1545","1540","35","3120","7612","0","40.99","20.30"
"66","000","00","250","0011","0296","566","315","251","9","575","1456","0","39.49","21.63"
"66","000","00","250","0011","0297","562","237","325","9","571","1565","0","36.49","15.14"
"66","000","00","250","0011","0298","627","318","309","6","633","1434","0","44.14","22.18"
"66","000","00","250","0011","0299","396","198","198","4","400","941","0","42.51","21.04"
"66","000","00","250","0011","0300","374","188","186","3","377","918","0","41.07","20.48"
"66","000","00","250","0011","0301","560","289","271","4","564","1298","0","43.45","22.27"
"66","000","00","250","0012","0000","1074","523","551","13","1087","2640","0","41.17","19.81"
"66","000","00","250","0012","0302","554","277","277","8","562","1489","0","37.74","18.60"
"66","000","00","250","0012","0303","520","246","274","5","525","1151","0","45.61","21.37"
"66","000","00","250","0013","0000","2526","1238","1288","23","2549","6354","0","40.12","19.48"
"66","000","00","250","0013","0304","550","270","280","6","556","1492","0","37.27","18.10"
"66","000","00","250","0013","0305","445","223","222","5","450","1197","0","37.59","18.63"
"66","000","00","250","0013","0306","445","245","200","4","449","1116","0","40.23","21.95"
"66","000","00","250","0013","0307","480","212","268","6","486","1155","0","42.08","18.35"
"66","000","00","250","0013","0308","606","288","318","2","608","1394","0","43.62","20.66"
"66","000","00","250","0014","0000","704","313","391","7","711","1558","0","45.64","20.09"
"66","000","00","250","0014","0309","704","313","391","7","711","1558","0","45.64","20.09"
"66","000","00","250","0015","0000","2073","1091","982","23","2096","4747","0","44.15","22.98"
"66","000","00","250","0015","0310","479","229","250","11","490","1087","0","45.08","21.07"
"66","000","00","250","0015","0311","447","218","229","2","449","996","0","45.08","21.89"
"66","000","00","250","0015","0312","588","342","246","4","592","1404","0","42.17","24.36"
"66","000","00","250","0015","0313","559","302","257","6","565","1260","0","44.84","23.97"
"66","000","00","250","0016","0000","3827","2255","1572","31","3858","8616","0","44.78","26.17"
"66","000","00","250","0016","0314","583","320","263","5","588","1380","0","42.61","23.19"
"66","000","00","250","0016","0315","656","396","260","11","667","1523","0","43.80","26.00"
"66","000","00","250","0016","0316","679","333","346","6","685","1546","0","44.31","21.54"
"66","000","00","250","0016","0317","634","354","280","7","641","1423","0","45.05","24.88"
"66","000","00","250","0016","0318","648","460","188","0","648","1348","0","48.07","34.12"
"66","000","00","250","0016","0319","627","392","235","2","629","1396","0","45.06","28.08"
"66","000","00","260","0000","0000","24627","11995","12632","223","24850","55248","64801","44.98","21.71"
"66","000","00","260","0001","0000","540","257","283","6","546","1194","0","45.73","21.52"
"66","000","00","260","0001","0408","540","257","283","6","546","1194","0","45.73","21.52"
"66","000","00","260","0002","0000","3995","2007","1988","29","4024","9381","0","42.90","21.39"
"66","000","00","260","0002","0409","479","233","246","3","482","1155","0","41.73","20.17"
"66","000","00","260","0002","0410","523","249","274","2","525","1129","0","46.50","22.05"
"66","000","00","260","0002","0411","503","269","234","5","508","1253","0","40.54","21.47"
"66","000","00","260","0002","0412","461","228","233","0","461","1116","0","41.31","20.43"
"66","000","00","260","0002","0413","414","171","243","6","420","1037","0","40.50","16.49"
"66","000","00","260","0002","0414","488","276","212","5","493","1161","0","42.46","23.77"
"66","000","00","260","0002","0415","543","239","304","4","547","1248","0","43.83","19.15"
"66","000","00","260","0002","0416","584","342","242","4","588","1282","0","45.87","26.68"
"66","000","00","260","0003","0000","1971","1032","939","15","1986","4671","0","42.52","22.09"
"66","000","00","260","0003","0417","474","243","231","6","480","1103","0","43.52","22.03"
"66","000","00","260","0003","0418","505","266","239","5","510","1253","0","40.70","21.23"
"66","000","00","260","0003","0419","505","284","221","2","507","1196","0","42.39","23.75"
"66","000","00","260","0003","0420","487","239","248","2","489","1119","0","43.70","21.36"
"66","000","00","260","0004","0000","1090","519","571","9","1099","2320","0","47.37","22.37"
"66","000","00","260","0004","0421","536","246","290","3","539","1066","0","50.56","23.08"
"66","000","00","260","0004","0422","554","273","281","6","560","1254","0","44.66","21.77"
"66","000","00","260","0005","0000","1000","509","491","3","1003","2025","0","49.53","25.14"
"66","000","00","260","0005","0423","591","330","261","2","593","1153","0","51.43","28.62"
"66","000","00","260","0005","0424","409","179","230","1","410","872","0","47.02","20.53"
"66","000","00","260","0006","0000","562","298","264","6","568","1224","0","46.41","24.35"
"66","000","00","260","0006","0425","562","298","264","6","568","1224","0","46.41","24.35"
"66","000","00","260","0007","0000","489","210","279","7","496","1045","0","47.46","20.10"
"66","000","00","260","0007","0426","489","210","279","7","496","1045","0","47.46","20.10"
"66","000","00","260","0008","0000","2656","1437","1219","20","2676","5783","0","46.27","24.85"
"66","000","00","260","0008","0427","524","267","257","2","526","1031","0","51.02","25.90"
"66","000","00","260","0008","0428","603","326","277","4","607","1250","0","48.56","26.08"
"66","000","00","260","0008","0429","543","309","234","5","548","1180","0","46.44","26.19"
"66","000","00","260","0008","0430","532","289","243","8","540","1268","0","42.59","22.79"
"66","000","00","260","0008","0431","454","246","208","1","455","1054","0","43.17","23.34"
"66","000","00","260","0009","0000","1336","692","644","9","1345","2918","0","46.09","23.71"
"66","000","00","260","0009","0450","488","282","206","2","490","1071","0","45.75","26.33"
"66","000","00","260","0009","0451","422","191","231","3","425","995","0","42.71","19.20"
"66","000","00","260","0009","0452","426","219","207","4","430","852","0","50.47","25.70"
"66","000","00","260","0010","0000","1752","784","968","17","1769","3965","0","44.62","19.77"
"66","000","00","260","0010","0432","551","282","269","2","553","1280","0","43.20","22.03"
"66","000","00","260","0010","0433","563","231","332","5","568","1289","0","44.07","17.92"
"66","000","00","260","0010","0434","638","271","367","10","648","1396","0","46.42","19.41"
"66","000","00","260","0011","0000","912","418","494","10","922","1860","0","49.57","22.47"
"66","000","00","260","0011","0435","500","226","274","5","505","995","0","50.75","22.71"
"66","000","00","260","0011","0436","412","192","220","5","417","865","0","48.21","22.20"
"66","000","00","260","0012","0000","1027","461","566","11","1038","2470","0","42.02","18.66"
"66","000","00","260","0012","0437","557","268","289","8","565","1360","0","41.54","19.71"
"66","000","00","260","0012","0438","470","193","277","3","473","1110","0","42.61","17.39"
"66","000","00","260","0013","0000","1192","572","620","19","1211","2651","0","45.68","21.58"
"66","000","00","260","0013","0439","630","317","313","9","639","1346","0","47.47","23.55"
"66","000","00","260","0013","0440","562","255","307","10","572","1305","0","43.83","19.54"
"66","000","00","260","0014","0000","1103","502","601","9","1112","2577","0","43.15","19.48"
"66","000","00","260","0014","0446","542","228","314","5","547","1294","0","42.27","17.62"
"66","000","00","260","0014","0447","561","274","287","4","565","1283","0","44.04","21.36"
"66","000","00","260","0015","0000","879","418","461","11","890","2046","0","43.50","20.43"
"66","000","00","260","0015","0448","412","185","227","5","417","973","0","42.86","19.01"
"66","000","00","260","0015","0449","467","233","234","6","473","1073","0","44.08","21.71"
"66","000","00","260","0016","0000","433","173","260","3","436","1104","0","39.49","15.67"
"66","000","00","260","0016","0453","433","173","260","3","436","1104","0","39.49","15.67"
"66","000","00","260","0017","0000","1112","438","674","15","1127","2352","0","47.92","18.62"
"66","000","00","260","0017","0454","542","197","345","8","550","1151","0","47.78","17.12"
"66","000","00","260","0017","0455","570","241","329","7","577","1201","0","48.04","20.07"
"66","000","00","260","0018","0000","1070","432","638","18","1088","2284","0","47.64","18.91"
"66","000","00","260","0018","0441","562","264","298","8","570","1132","0","50.35","23.32"
"66","000","00","260","0018","0442","508","168","340","10","518","1152","0","44.97","14.58"
"66","000","00","260","0019","0000","951","563","388","3","954","2071","0","46.06","27.18"
"66","000","00","260","0019","0443","458","280","178","2","460","1018","0","45.19","27.50"
"66","000","00","260","0019","0444","493","283","210","1","494","1053","0","46.91","26.88"
"66","000","00","260","0020","0000","557","273","284","3","560","1307","0","42.85","20.89"
"66","000","00","260","0020","0445","557","273","284","3","560","1307","0","42.85","20.89"
"66","000","00","270","0000","0000","62575","30622","31953","630","63205","162482","195494","38.90","18.85"
"66","000","00","270","0001","0000","2167","921","1246","32","2199","5378","0","40.89","17.13"
"66","000","00","270","0001","1435","546","244","302","8","554","1314","0","42.16","18.57"
"66","000","00","270","0001","1436","566","246","320","10","576","1428","0","40.34","17.23"
"66","000","00","270","0001","1437","521","209","312","7","528","1350","0","39.11","15.48"
"66","000","00","270","0001","1438","534","222","312","7","541","1286","0","42.07","17.26"
"66","000","00","270","0002","0000","2407","1188","1219","27","2434","6193","0","39.30","19.18"
"66","000","00","270","0002","1439","677","297","380","8","685","1545","0","44.34","19.22"
"66","000","00","270","0002","1440","526","259","267","6","532","1378","0","38.61","18.80"
"66","000","00","270","0002","1441","536","291","245","6","542","1555","0","34.86","18.71"
"66","000","00","270","0002","1442","668","341","327","7","675","1715","0","39.36","19.88"
"66","000","00","270","0003","0000","1588","702","886","14","1602","4030","0","39.75","17.42"
"66","000","00","270","0003","1448","579","255","324","5","584","1468","0","39.78","17.37"
"66","000","00","270","0003","1449","515","226","289","2","517","1277","0","40.49","17.70"
"66","000","00","270","0003","1450","494","221","273","7","501","1285","0","38.99","17.20"
"66","000","00","270","0004","0000","1320","558","762","20","1340","3192","0","41.98","17.48"
"66","000","00","270","0004","1456","435","198","237","8","443","993","0","44.61","19.94"
"66","000","00","270","0004","1457","434","191","243","8","442","1124","0","39.32","16.99"
"66","000","00","270","0004","1458","451","169","282","4","455","1075","0","42.33","15.72"
"66","000","00","270","0005","0000","1120","529","591","18","1138","2873","0","39.61","18.41"
"66","000","00","270","0005","1470","482","245","237","7","489","1357","0","36.04","18.05"
"66","000","00","270","0005","1471","638","284","354","11","649","1516","0","42.81","18.73"
"66","000","00","270","0006","0000","1524","692","832","19","1543","4108","0","37.56","16.85"
"66","000","00","270","0006","1462","494","218","276","3","497","1474","0","33.72","14.79"
"66","000","00","270","0006","1463","508","209","299","10","518","1376","0","37.65","15.19"
"66","000","00","270","0006","1464","522","265","257","6","528","1258","0","41.97","21.07"
"66","000","00","270","0007","0000","2311","1059","1252","26","2337","6203","0","37.68","17.07"
"66","000","00","270","0007","1493","668","322","346","5","673","1721","0","39.11","18.71"
"66","000","00","270","0007","1494","555","240","315","8","563","1539","0","36.58","15.59"
"66","000","00","270","0007","1495","568","253","315","7","575","1468","0","39.17","17.23"
"66","000","00","270","0007","1496","520","244","276","6","526","1475","0","35.66","16.54"
"66","000","00","270","0008","0000","1271","717","554","10","1281","3727","0","34.37","19.24"
"66","000","00","270","0008","1488","677","418","259","3","680","1674","0","40.62","24.97"
"66","000","00","270","0008","1489","594","299","295","7","601","2053","0","29.27","14.56"
"66","000","00","270","0009","0000","1443","828","615","15","1458","3294","0","44.26","25.14"
"66","000","00","270","0009","1474","494","283","211","8","502","1128","0","44.50","25.09"
"66","000","00","270","0009","1475","472","258","214","6","478","1071","0","44.63","24.09"
"66","000","00","270","0009","1476","477","287","190","1","478","1095","0","43.65","26.21"
"66","000","00","270","0010","0000","2081","1149","932","22","2103","5188","0","40.54","22.15"
"66","000","00","270","0010","1481","594","311","283","8","602","1345","0","44.76","23.12"
"66","000","00","270","0010","1482","636","398","238","5","641","1550","0","41.35","25.68"
"66","000","00","270","0010","1483","435","204","231","5","440","1139","0","38.63","17.91"
"66","000","00","270","0010","1484","416","236","180","4","420","1154","0","36.40","20.45"
"66","000","00","270","0011","0000","2775","1493","1282","17","2792","7707","0","36.23","19.37"
"66","000","00","270","0011","1504","524","295","229","5","529","1491","0","35.48","19.79"
"66","000","00","270","0011","1505","617","327","290","6","623","1566","0","39.78","20.88"
"66","000","00","270","0011","1506","508","261","247","0","508","1590","0","31.95","16.42"
"66","000","00","270","0011","1507","612","312","300","5","617","1579","0","39.08","19.76"
"66","000","00","270","0011","1508","514","298","216","1","515","1481","0","34.77","20.12"
"66","000","00","270","0012","0000","3077","1497","1580","37","3114","7600","0","40.97","19.70"
"66","000","00","270","0012","1517","559","231","328","3","562","1373","0","40.93","16.82"
"66","000","00","270","0012","1518","600","292","308","10","610","1482","0","41.16","19.70"
"66","000","00","270","0012","1519","605","308","297","4","609","1445","0","42.15","21.31"
"66","000","00","270","0012","1520","661","357","304","10","671","1643","0","40.84","21.73"
"66","000","00","270","0012","1521","652","309","343","10","662","1657","0","39.95","18.65"
"66","000","00","270","0013","0000","2740","1422","1318","20","2760","6669","0","41.39","21.32"
"66","000","00","270","0013","1531","654","359","295","4","658","1433","0","45.92","25.05"
"66","000","00","270","0013","1532","461","206","255","4","465","1223","0","38.02","16.84"
"66","000","00","270","0013","1533","501","275","226","2","503","1184","0","42.48","23.23"
"66","000","00","270","0013","1534","501","269","232","4","505","1376","0","36.70","19.55"
"66","000","00","270","0013","1535","623","313","310","6","629","1453","0","43.29","21.54"
"66","000","00","270","0014","0000","658","328","330","7","665","1767","0","37.63","18.56"
"66","000","00","270","0014","1536","340","176","164","6","346","870","0","39.77","20.23"
"66","000","00","270","0014","1537","318","152","166","1","319","897","0","35.56","16.95"
"66","000","00","270","0015","0000","403","165","238","4","407","1199","0","33.94","13.76"
"66","000","00","270","0015","1539","403","165","238","4","407","1199","0","33.94","13.76"
"66","000","00","270","0016","0000","1180","574","606","16","1196","3227","0","37.06","17.79"
"66","000","00","270","0016","1540","571","305","266","4","575","1651","0","34.83","18.47"
"66","000","00","270","0016","1541","609","269","340","12","621","1576","0","39.40","17.07"
"66","000","00","270","0017","0000","1182","437","745","13","1195","3052","0","39.15","14.32"
"66","000","00","270","0017","1546","590","204","386","5","595","1486","0","40.04","13.73"
"66","000","00","270","0017","1547","592","233","359","8","600","1566","0","38.31","14.88"
"66","000","00","270","0018","0000","1770","743","1027","22","1792","4742","0","37.79","15.67"
"66","000","00","270","0018","1550","448","170","278","5","453","1123","0","40.34","15.14"
"66","000","00","270","0018","1551","423","171","252","6","429","1258","0","34.10","13.59"
"66","000","00","270","0018","1552","474","209","265","4","478","1052","0","45.44","19.87"
"66","000","00","270","0018","1553","425","193","232","7","432","1309","0","33.00","14.74"
"66","000","00","270","0019","0000","246","100","146","7","253","649","0","38.98","15.41"
"66","000","00","270","0019","1545","246","100","146","7","253","649","0","38.98","15.41"
"66","000","00","270","0020","0000","2531","1162","1369","23","2554","6807","0","37.52","17.07"
"66","000","00","270","0020","1443","521","228","293","6","527","1351","0","39.01","16.88"
"66","000","00","270","0020","1444","438","199","239","4","442","1323","0","33.41","15.04"
"66","000","00","270","0020","1445","523","246","277","9","532","1397","0","38.08","17.61"
"66","000","00","270","0020","1446","552","260","292","1","553","1369","0","40.39","18.99"
"66","000","00","270","0020","1447","497","229","268","3","500","1367","0","36.58","16.75"
"66","000","00","270","0021","0000","1535","706","829","8","1543","4018","0","38.40","17.57"
"66","000","00","270","0021","1459","510","246","264","4","514","1387","0","37.06","17.74"
"66","000","00","270","0021","1460","516","219","297","3","519","1279","0","40.58","17.12"
"66","000","00","270","0021","1461","509","241","268","1","510","1352","0","37.72","17.83"
"66","000","00","270","0022","0000","1453","599","854","14","1467","3985","0","36.81","15.03"
"66","000","00","270","0022","1465","454","176","278","5","459","1207","0","38.03","14.58"
"66","000","00","270","0022","1466","503","213","290","5","508","1430","0","35.52","14.90"
"66","000","00","270","0022","1467","496","210","286","4","500","1348","0","37.09","15.58"
"66","000","00","270","0023","0000","1023","496","527","9","1032","2818","0","36.62","17.60"
"66","000","00","270","0023","1468","509","244","265","6","515","1415","0","36.40","17.24"
"66","000","00","270","0023","1469","514","252","262","3","517","1403","0","36.85","17.96"
"66","000","00","270","0024","0000","1391","636","755","13","1404","3701","0","37.94","17.18"
"66","000","00","270","0024","1451","450","200","250","4","454","1168","0","38.87","17.12"
"66","000","00","270","0024","1452","454","205","249","4","458","1191","0","38.46","17.21"
"66","000","00","270","0024","1453","487","231","256","5","492","1342","0","36.66","17.21"
"66","000","00","270","0025","0000","870","384","486","10","880","2204","0","39.93","17.42"
"66","000","00","270","0025","1454","446","185","261","5","451","1190","0","37.90","15.55"
"66","000","00","270","0025","1455","424","199","225","5","429","1014","0","42.31","19.63"
"66","000","00","270","0026","0000","1002","461","541","7","1009","2894","0","34.87","15.93"
"66","000","00","270","0026","1472","520","227","293","4","524","1465","0","35.77","15.49"
"66","000","00","270","0026","1473","482","234","248","3","485","1429","0","33.94","16.38"
"66","000","00","270","0027","0000","2245","1106","1139","20","2265","5508","0","41.12","20.08"
"66","000","00","270","0027","1522","514","227","287","4","518","1237","0","41.88","18.35"
"66","000","00","270","0027","1523","584","300","284","4","588","1351","0","43.52","22.21"
"66","000","00","270","0027","1524","584","293","291","6","590","1470","0","40.14","19.93"
"66","000","00","270","0027","1525","563","286","277","6","569","1450","0","39.24","19.72"
"66","000","00","270","0028","0000","3237","1647","1590","28","3265","8031","0","40.65","20.51"
"66","000","00","270","0028","1526","576","287","289","6","582","1458","0","39.92","19.68"
"66","000","00","270","0028","1527","657","355","302","6","663","1546","0","42.88","22.96"
"66","000","00","270","0028","1528","570","272","298","5","575","1545","0","37.22","17.61"
"66","000","00","270","0028","1529","534","281","253","6","540","1438","0","37.55","19.54"
"66","000","00","270","0028","1530","900","452","448","5","905","2044","0","44.28","22.11"
"66","000","00","270","0029","0000","2195","1182","1013","25","2220","5692","0","39.00","20.77"
"66","000","00","270","0029","1509","593","301","292","5","598","1449","0","41.27","20.77"
"66","000","00","270","0029","1510","480","264","216","5","485","1346","0","36.03","19.61"
"66","000","00","270","0029","1511","475","251","224","5","480","1255","0","38.25","20.00"
"66","000","00","270","0029","1512","647","366","281","10","657","1642","0","40.01","22.29"
"66","000","00","270","0030","0000","1943","1037","906","21","1964","5664","0","34.68","18.31"
"66","000","00","270","0030","1513","476","249","227","7","483","1312","0","36.81","18.98"
"66","000","00","270","0030","1514","516","283","233","1","517","1527","0","33.86","18.53"
"66","000","00","270","0030","1515","417","214","203","6","423","1321","0","32.02","16.20"
"66","000","00","270","0030","1516","534","291","243","7","541","1504","0","35.97","19.35"
"66","000","00","270","0031","0000","2304","1205","1099","19","2323","6055","0","38.36","19.90"
"66","000","00","270","0031","1497","567","311","256","7","574","1587","0","36.17","19.60"
"66","000","00","270","0031","1498","685","362","323","4","689","1573","0","43.80","23.01"
"66","000","00","270","0031","1499","529","265","264","2","531","1417","0","37.47","18.70"
"66","000","00","270","0031","1500","523","267","256","6","529","1478","0","35.79","18.06"
"66","000","00","270","0032","0000","1399","625","774","17","1416","3821","0","37.06","16.36"
"66","000","00","270","0032","1501","624","264","360","13","637","1479","0","43.07","17.85"
"66","000","00","270","0032","1502","410","188","222","1","411","1212","0","33.91","15.51"
"66","000","00","270","0032","1503","365","173","192","3","368","1130","0","32.57","15.31"
"66","000","00","270","0033","0000","1504","866","638","10","1514","3832","0","39.51","22.60"
"66","000","00","270","0033","1485","498","288","210","5","503","1256","0","40.05","22.93"
"66","000","00","270","0033","1486","449","231","218","2","451","1175","0","38.38","19.66"
"66","000","00","270","0033","1487","557","347","210","3","560","1401","0","39.97","24.77"
"66","000","00","270","0034","0000","1911","1053","858","14","1925","4323","0","44.53","24.36"
"66","000","00","270","0034","1490","703","409","294","4","707","1549","0","45.64","26.40"
"66","000","00","270","0034","1491","595","301","294","3","598","1426","0","41.94","21.11"
"66","000","00","270","0034","1492","613","343","270","7","620","1348","0","45.99","25.45"
"66","000","00","270","0035","0000","931","446","485","8","939","2539","0","36.98","17.57"
"66","000","00","270","0035","1477","576","280","296","5","581","1495","0","38.86","18.73"
"66","000","00","270","0035","1478","355","166","189","3","358","1044","0","34.29","15.90"
"66","000","00","270","0036","0000","898","538","360","12","910","2139","0","42.54","25.15"
"66","000","00","270","0036","1479","488","283","205","5","493","1081","0","45.61","26.18"
"66","000","00","270","0036","1480","410","255","155","7","417","1058","0","39.41","24.10"
"66","000","00","270","0037","0000","586","275","311","8","594","1536","0","38.67","17.90"
"66","000","00","270","0037","1538","586","275","311","8","594","1536","0","38.67","17.90"
"66","000","00","270","0038","0000","1456","667","789","9","1465","3631","0","40.35","18.37"
"66","000","00","270","0038","1542","497","207","290","2","499","1249","0","39.95","16.57"
"66","000","00","270","0038","1543","623","302","321","3","626","1501","0","41.71","20.12"
"66","000","00","270","0038","1544","336","158","178","4","340","881","0","38.59","17.93"
"66","000","00","270","0039","0000","898","429","469","9","907","2486","0","36.48","17.26"
"66","000","00","270","0039","1548","420","183","237","6","426","1191","0","35.77","15.37"
"66","000","00","270","0039","1549","478","246","232","3","481","1295","0","37.14","19.00"
"66","000","00","280","0000","0000","70882","33493","37389","668","71550","174651","212710","40.97","19.18"
"66","000","00","280","0001","0000","1534","725","809","19","1553","3731","0","41.62","19.43"
"66","000","00","280","0001","1563","570","253","317","7","577","1381","0","41.78","18.32"
"66","000","00","280","0001","1564","534","271","263","7","541","1231","0","43.95","22.01"
"66","000","00","280","0001","1565","430","201","229","5","435","1119","0","38.87","17.96"
"66","000","00","280","0002","0000","4234","2012","2222","37","4271","10438","0","40.92","19.28"
"66","000","00","280","0002","1566","686","305","381","3","689","1641","0","41.99","18.59"
"66","000","00","280","0002","1567","907","433","474","4","911","2900","0","31.41","14.93"
"66","000","00","280","0002","1568","663","305","358","7","670","1710","0","39.18","17.84"
"66","000","00","280","0002","1569","588","279","309","9","597","1334","0","44.75","20.91"
"66","000","00","280","0002","1570","571","340","231","8","579","1144","0","50.61","29.72"
"66","000","00","280","0002","1571","819","350","469","6","825","1709","0","48.27","20.48"
"66","000","00","280","0003","0000","1557","603","954","14","1571","3621","0","43.39","16.65"
"66","000","00","280","0003","1576","519","175","344","3","522","1172","0","44.54","14.93"
"66","000","00","280","0003","1577","527","225","302","5","532","1317","0","40.39","17.08"
"66","000","00","280","0003","1578","511","203","308","6","517","1132","0","45.67","17.93"
"66","000","00","280","0004","0000","2910","1349","1561","19","2929","6901","0","42.44","19.55"
"66","000","00","280","0004","1619","590","261","329","4","594","1372","0","43.29","19.02"
"66","000","00","280","0004","1620","519","252","267","3","522","1365","0","38.24","18.46"
"66","000","00","280","0004","1621","619","260","359","4","623","1335","0","46.67","19.48"
"66","000","00","280","0004","1622","573","254","319","5","578","1331","0","43.43","19.08"
"66","000","00","280","0004","1623","609","322","287","3","612","1498","0","40.85","21.50"
"66","000","00","280","0005","0000","3086","1372","1714","35","3121","7279","0","42.88","18.85"
"66","000","00","280","0005","1579","708","317","391","7","715","1624","0","44.03","19.52"
"66","000","00","280","0005","1580","526","231","295","6","532","1251","0","42.53","18.47"
"66","000","00","280","0005","1581","660","290","370","5","665","1614","0","41.20","17.97"
"66","000","00","280","0005","1582","676","327","349","11","687","1666","0","41.24","19.63"
"66","000","00","280","0005","1583","516","207","309","6","522","1124","0","46.44","18.42"
"66","000","00","280","0006","0000","1815","899","916","19","1834","4162","0","44.07","21.60"
"66","000","00","280","0006","1633","570","300","270","7","577","1293","0","44.62","23.20"
"66","000","00","280","0006","1634","569","285","284","4","573","1257","0","45.58","22.67"
"66","000","00","280","0006","1635","676","314","362","8","684","1612","0","42.43","19.48"
"66","000","00","280","0007","0000","2198","1031","1167","24","2222","5520","0","40.25","18.68"
"66","000","00","280","0007","1636","541","237","304","6","547","1415","0","38.66","16.75"
"66","000","00","280","0007","1637","549","236","313","7","556","1363","0","40.79","17.31"
"66","000","00","280","0007","1638","543","274","269","4","547","1413","0","38.71","19.39"
"66","000","00","280","0007","1639","565","284","281","7","572","1329","0","43.04","21.37"
"66","000","00","280","0008","0000","3383","1742","1641","23","3406","8350","0","40.79","20.86"
"66","000","00","280","0008","1584","564","299","265","6","570","1350","0","42.22","22.15"
"66","000","00","280","0008","1585","614","325","289","5","619","1476","0","41.94","22.02"
"66","000","00","280","0008","1586","554","274","280","4","558","1368","0","40.79","20.03"
"66","000","00","280","0008","1587","551","284","267","4","555","1395","0","39.78","20.36"
"66","000","00","280","0008","1588","600","297","303","4","604","1452","0","41.60","20.45"
"66","000","00","280","0008","1589","500","263","237","0","500","1309","0","38.20","20.09"
"66","000","00","280","0009","0000","1411","674","737","20","1431","3400","0","42.09","19.82"
"66","000","00","280","0009","1594","702","342","360","9","711","1707","0","41.65","20.04"
"66","000","00","280","0009","1595","709","332","377","11","720","1693","0","42.53","19.61"
"66","000","00","280","0010","0000","1967","878","1089","27","1994","5356","0","37.23","16.39"
"66","000","00","280","0010","1652","519","239","280","9","528","1387","0","38.07","17.23"
"66","000","00","280","0010","1653","447","205","242","5","452","1272","0","35.53","16.12"
"66","000","00","280","0010","1654","508","255","253","5","513","1415","0","36.25","18.02"
"66","000","00","280","0010","1655","493","179","314","8","501","1282","0","39.08","13.96"
"66","000","00","280","0011","0000","3232","1449","1783","32","3264","7841","0","41.63","18.48"
"66","000","00","280","0011","1661","555","255","300","6","561","1424","0","39.40","17.91"
"66","000","00","280","0011","1662","735","329","406","8","743","1644","0","45.19","20.01"
"66","000","00","280","0011","1663","709","326","383","4","713","1727","0","41.29","18.88"
"66","000","00","280","0011","1664","666","273","393","7","673","1522","0","44.22","17.94"
"66","000","00","280","0011","1665","567","266","301","7","574","1524","0","37.66","17.45"
"66","000","00","280","0012","0000","1872","822","1050","21","1893","4167","0","45.43","19.73"
"66","000","00","280","0012","1596","516","230","286","3","519","1129","0","45.97","20.37"
"66","000","00","280","0012","1597","714","269","445","11","725","1539","0","47.11","17.48"
"66","000","00","280","0012","1598","642","323","319","7","649","1499","0","43.30","21.55"
"66","000","00","280","0013","0000","463","172","291","6","469","982","0","47.76","17.52"
"66","000","00","280","0013","1599","463","172","291","6","469","982","0","47.76","17.52"
"66","000","00","280","0014","0000","3125","1373","1752","30","3155","8402","0","37.55","16.34"
"66","000","00","280","0014","1600","552","249","303","2","554","1493","0","37.11","16.68"
"66","000","00","280","0014","1601","475","180","295","7","482","1330","0","36.24","13.53"
"66","000","00","280","0014","1602","500","223","277","7","507","1299","0","39.03","17.17"
"66","000","00","280","0014","1603","520","219","301","7","527","1435","0","36.72","15.26"
"66","000","00","280","0014","1604","540","239","301","6","546","1415","0","38.59","16.89"
"66","000","00","280","0014","1605","538","263","275","1","539","1430","0","37.69","18.39"
"66","000","00","280","0015","0000","1701","751","950","14","1715","4704","0","36.46","15.97"
"66","000","00","280","0015","1610","553","229","324","5","558","1419","0","39.32","16.14"
"66","000","00","280","0015","1611","607","256","351","5","612","1702","0","35.96","15.04"
"66","000","00","280","0015","1612","541","266","275","4","545","1583","0","34.43","16.80"
"66","000","00","280","0016","0000","3193","1430","1763","33","3226","8359","0","38.59","17.11"
"66","000","00","280","0016","1613","506","232","274","3","509","1419","0","35.87","16.35"
"66","000","00","280","0016","1614","563","284","279","11","574","1394","0","41.18","20.37"
"66","000","00","280","0016","1615","581","261","320","6","587","1441","0","40.74","18.11"
"66","000","00","280","0016","1616","478","194","284","5","483","1311","0","36.84","14.80"
"66","000","00","280","0016","1617","481","194","287","2","483","1312","0","36.81","14.79"
"66","000","00","280","0016","1618","584","265","319","6","590","1482","0","39.81","17.88"
"66","000","00","280","0017","0000","4482","2140","2342","37","4519","11593","0","38.98","18.46"
"66","000","00","280","0017","1666","498","214","284","10","508","1354","0","37.52","15.81"
"66","000","00","280","0017","1667","606","318","288","1","607","1445","0","42.01","22.01"
"66","000","00","280","0017","1668","565","286","279","4","569","1521","0","37.41","18.80"
"66","000","00","280","0017","1669","564","274","290","4","568","1441","0","39.42","19.01"
"66","000","00","280","0017","1670","633","335","298","1","634","1485","0","42.69","22.56"
"66","000","00","280","0017","1671","480","224","256","2","482","1486","0","32.44","15.07"
"66","000","00","280","0017","1672","486","205","281","9","495","1364","0","36.29","15.03"
"66","000","00","280","0017","1673","650","284","366","6","656","1497","0","43.82","18.97"
"66","000","00","280","0018","0000","3744","1772","1972","30","3774","9507","0","39.70","18.64"
"66","000","00","280","0018","1646","621","298","323","8","629","1589","0","39.58","18.75"
"66","000","00","280","0018","1647","633","328","305","5","638","1631","0","39.12","20.11"
"66","000","00","280","0018","1648","624","280","344","3","627","1441","0","43.51","19.43"
"66","000","00","280","0018","1649","629","288","341","3","632","1620","0","39.01","17.78"
"66","000","00","280","0018","1650","656","302","354","8","664","1743","0","38.10","17.33"
"66","000","00","280","0018","1651","581","276","305","3","584","1483","0","39.38","18.61"
"66","000","00","280","0019","0000","4013","1966","2047","42","4055","10403","0","38.98","18.90"
"66","000","00","280","0019","1554","603","325","278","8","611","1624","0","37.62","20.01"
"66","000","00","280","0019","1555","579","275","304","12","591","1597","0","37.01","17.22"
"66","000","00","280","0019","1556","553","256","297","2","555","1650","0","33.64","15.52"
"66","000","00","280","0019","1557","542","248","294","7","549","1291","0","42.53","19.21"
"66","000","00","280","0019","1558","588","263","325","3","591","1439","0","41.07","18.28"
"66","000","00","280","0019","1559","494","294","200","6","500","1191","0","41.98","24.69"
"66","000","00","280","0019","1560","654","305","349","4","658","1611","0","40.84","18.93"
"66","000","00","280","0020","0000","1164","513","651","15","1179","2803","0","42.06","18.30"
"66","000","00","280","0020","1561","621","275","346","4","625","1402","0","44.58","19.61"
"66","000","00","280","0020","1562","543","238","305","11","554","1401","0","39.54","16.99"
"66","000","00","280","0021","0000","2447","1262","1185","21","2468","5719","0","43.15","22.07"
"66","000","00","280","0021","1572","618","353","265","5","623","1417","0","43.97","24.91"
"66","000","00","280","0021","1573","556","257","299","2","558","1410","0","39.57","18.23"
"66","000","00","280","0021","1574","714","363","351","9","723","1564","0","46.23","23.21"
"66","000","00","280","0021","1575","559","289","270","5","564","1328","0","42.47","21.76"
"66","000","00","280","0022","0000","1670","779","891","17","1687","4144","0","40.71","18.80"
"66","000","00","280","0022","1624","574","265","309","7","581","1495","0","38.86","17.73"
"66","000","00","280","0022","1625","503","236","267","4","507","1251","0","40.53","18.86"
"66","000","00","280","0022","1626","593","278","315","6","599","1398","0","42.85","19.89"
"66","000","00","280","0023","0000","4415","2320","2095","34","4449","9667","0","46.02","24.00"
"66","000","00","280","0023","1627","772","409","363","5","777","1621","0","47.93","25.23"
"66","000","00","280","0023","1628","696","356","340","9","705","1552","0","45.43","22.94"
"66","000","00","280","0023","1629","784","420","364","5","789","1589","0","49.65","26.43"
"66","000","00","280","0023","1630","728","378","350","4","732","1612","0","45.41","23.45"
"66","000","00","280","0023","1631","707","372","335","7","714","1616","0","44.18","23.02"
"66","000","00","280","0023","1632","728","385","343","4","732","1677","0","43.65","22.96"
"66","000","00","280","0024","0000","3803","1919","1884","39","3842","8636","0","44.49","22.22"
"66","000","00","280","0024","1640","629","319","310","4","633","1498","0","42.26","21.30"
"66","000","00","280","0024","1641","639","342","297","2","641","1387","0","46.21","24.66"
"66","000","00","280","0024","1642","628","314","314","8","636","1387","0","45.85","22.64"
"66","000","00","280","0024","1643","644","289","355","16","660","1351","0","48.85","21.39"
"66","000","00","280","0024","1644","630","325","305","8","638","1486","0","42.93","21.87"
"66","000","00","280","0024","1645","633","330","303","1","634","1527","0","41.52","21.61"
"66","000","00","280","0025","0000","2121","1077","1044","22","2143","5389","0","39.77","19.99"
"66","000","00","280","0025","1590","496","239","257","1","497","1278","0","38.89","18.70"
"66","000","00","280","0025","1591","513","252","261","7","520","1315","0","39.54","19.16"
"66","000","00","280","0025","1592","582","335","247","7","589","1507","0","39.08","22.23"
"66","000","00","280","0025","1593","530","251","279","7","537","1289","0","41.66","19.47"
"66","000","00","280","0026","0000","3022","1407","1615","23","3045","7712","0","39.48","18.24"
"66","000","00","280","0026","1656","630","297","333","2","632","1585","0","39.87","18.74"
"66","000","00","280","0026","1657","624","287","337","6","630","1574","0","40.03","18.23"
"66","000","00","280","0026","1658","563","248","315","2","565","1512","0","37.37","16.40"
"66","000","00","280","0026","1659","634","311","323","7","641","1630","0","39.33","19.08"
"66","000","00","280","0026","1660","571","264","307","6","577","1411","0","40.89","18.71"
"66","000","00","280","0027","0000","2320","1056","1264","15","2335","5865","0","39.81","18.01"
"66","000","00","280","0027","1606","632","265","367","4","636","1566","0","40.61","16.92"
"66","000","00","280","0027","1607","569","287","282","5","574","1464","0","39.21","19.60"
"66","000","00","280","0027","1608","440","201","239","3","443","1161","0","38.16","17.31"
"66","000","00","280","0027","1609","679","303","376","3","682","1674","0","40.74","18.10"
"66","000","00","290","0000","0000","2984","2070","914","43","3027","9436","10841","32.08","21.94"
"66","000","00","290","0001","0000","645","416","229","15","660","1883","0","35.05","22.09"
"66","000","00","290","0001","1856","315","169","146","11","326","936","0","34.83","18.06"
"66","000","00","290","0001","1857","330","247","83","4","334","947","0","35.27","26.08"
"66","000","00","290","0002","0000","142","76","66","3","145","456","0","31.80","16.67"
"66","000","00","290","0002","1858","142","76","66","3","145","456","0","31.80","16.67"
"66","000","00","290","0003","0000","529","391","138","6","535","1641","0","32.60","23.83"
"66","000","00","290","0003","1859","317","234","83","4","321","999","0","32.13","23.42"
"66","000","00","290","0003","1860","212","157","55","2","214","642","0","33.33","24.45"
"66","000","00","290","0004","0000","192","135","57","3","195","461","0","42.30","29.28"
"66","000","00","290","0004","1866","192","135","57","3","195","461","0","42.30","29.28"
"66","000","00","290","0005","0000","420","319","101","5","425","1081","0","39.32","29.51"
"66","000","00","290","0005","1861","99","59","40","2","101","291","0","34.71","20.27"
"66","000","00","290","0005","1862","175","153","22","1","176","459","0","38.34","33.33"
"66","000","00","290","0005","1863","146","107","39","2","148","331","0","44.71","32.33"
"66","000","00","290","0006","0000","419","300","119","3","422","1107","0","38.12","27.10"
"66","000","00","290","0006","1864","288","195","93","3","291","755","0","38.54","25.83"
"66","000","00","290","0006","1865","131","105","26","0","131","352","0","37.22","29.83"
"66","000","00","290","0007","0000","429","275","154","4","433","1939","0","22.33","14.18"
"66","000","00","290","0007","1867","80","42","38","1","81","346","0","23.41","12.14"
"66","000","00","290","0007","1868","158","108","50","3","161","755","0","21.32","14.30"
"66","000","00","290","0007","1869","132","87","45","0","132","566","0","23.32","15.37"
"66","000","00","290","0007","1870","59","38","21","0","59","272","0","21.69","13.97"
"66","000","00","290","0008","0000","208","158","50","4","212","868","0","24.42","18.20"
"66","000","00","290","0008","1871","35","27","8","0","35","149","0","23.49","18.12"
"66","000","00","290","0008","1872","173","131","42","4","177","719","0","24.62","18.22"
"67","000","00","000","0000","0000","648162","241018","407144","6028","654190","1592388","1868739","41.08","15.14"
"67","000","00","010","0000","0000","25156","10698","14458","216","25372","63992","76027","39.65","16.72"
"67","000","00","010","0001","0000","1945","1025","920","10","1955","4561","0","42.86","22.47"
"67","000","00","010","0001","0139","499","267","232","1","500","1274","0","39.25","20.96"
"67","000","00","010","0001","0140","445","256","189","3","448","1112","0","40.29","23.02"
"67","000","00","010","0001","0141","477","229","248","2","479","1035","0","46.28","22.13"
"67","000","00","010","0001","0142","524","273","251","4","528","1140","0","46.32","23.95"
"67","000","00","010","0002","0000","911","410","501","6","917","2212","0","41.46","18.54"
"67","000","00","010","0002","0143","480","187","293","5","485","1156","0","41.96","16.18"
"67","000","00","010","0002","0144","431","223","208","1","432","1056","0","40.91","21.12"
"67","000","00","010","0003","0000","1151","476","675","5","1156","2807","0","41.18","16.96"
"67","000","00","010","0003","0145","561","228","333","4","565","1366","0","41.36","16.69"
"67","000","00","010","0003","0146","590","248","342","1","591","1441","0","41.01","17.21"
"67","000","00","010","0007","0000","1174","494","680","6","1180","2795","0","42.22","17.67"
"67","000","00","010","0007","0150","427","193","234","3","430","1014","0","42.41","19.03"
"67","000","00","010","0007","0151","366","152","214","1","367","892","0","41.14","17.04"
"67","000","00","010","0007","0152","381","149","232","2","383","889","0","43.08","16.76"
"67","000","00","010","0008","0000","1578","715","863","11","1589","4010","0","39.63","17.83"
"67","000","00","010","0008","0153","515","228","287","6","521","1314","0","39.65","17.35"
"67","000","00","010","0008","0154","476","228","248","4","480","1311","0","36.61","17.39"
"67","000","00","010","0008","0155","587","259","328","1","588","1385","0","42.45","18.70"
"67","000","00","010","0009","0000","472","190","282","5","477","1131","0","42.18","16.80"
"67","000","00","010","0009","0161","472","190","282","5","477","1131","0","42.18","16.80"
"67","000","00","010","0010","0000","569","187","382","8","577","1430","0","40.35","13.08"
"67","000","00","010","0010","0162","569","187","382","8","577","1430","0","40.35","13.08"
"67","000","00","010","0012","0000","886","407","479","5","891","2371","0","37.58","17.17"
"67","000","00","010","0012","0165","450","184","266","4","454","1166","0","38.94","15.78"
"67","000","00","010","0012","0166","436","223","213","1","437","1205","0","36.27","18.51"
"67","000","00","010","0013","0000","734","344","390","8","742","1734","0","42.79","19.84"
"67","000","00","010","0013","0163","329","169","160","4","333","816","0","40.81","20.71"
"67","000","00","010","0013","0164","405","175","230","4","409","918","0","44.55","19.06"
"67","000","00","010","0014","0000","1197","473","724","15","1212","3194","0","37.95","14.81"
"67","000","00","010","0014","0167","389","158","231","3","392","1000","0","39.20","15.80"
"67","000","00","010","0014","0168","359","141","218","2","361","1000","0","36.10","14.10"
"67","000","00","010","0014","0169","449","174","275","10","459","1194","0","38.44","14.57"
"67","000","00","010","0015","0000","1648","657","991","13","1661","4405","0","37.71","14.91"
"67","000","00","010","0015","0178","447","189","258","3","450","1256","0","35.83","15.05"
"67","000","00","010","0015","0179","365","127","238","3","368","912","0","40.35","13.93"
"67","000","00","010","0015","0180","379","167","212","4","383","1038","0","36.90","16.09"
"67","000","00","010","0015","0181","457","174","283","3","460","1199","0","38.37","14.51"
"67","000","00","010","0016","0000","639","228","411","15","654","1632","0","40.07","13.97"
"67","000","00","010","0016","0182","370","126","244","8","378","921","0","41.04","13.68"
"67","000","00","010","0016","0183","269","102","167","7","276","711","0","38.82","14.35"
"67","000","00","010","0017","0000","512","171","341","4","516","1333","0","38.71","12.83"
"67","000","00","010","0017","0184","512","171","341","4","516","1333","0","38.71","12.83"
"67","000","00","010","0018","0000","596","168","428","9","605","1724","0","35.09","9.74"
"67","000","00","010","0018","0185","479","129","350","7","486","1456","0","33.38","8.86"
"67","000","00","010","0018","0186","117","39","78","2","119","268","0","44.40","14.55"
"67","000","00","010","0019","0000","655","193","462","7","662","1696","0","39.03","11.38"
"67","000","00","010","0019","0187","381","121","260","5","386","939","0","41.11","12.89"
"67","000","00","010","0019","0188","274","72","202","2","276","757","0","36.46","9.51"
"67","000","00","010","0020","0000","1321","575","746","14","1335","3665","0","36.43","15.69"
"67","000","00","010","0020","0189","431","168","263","4","435","1169","0","37.21","14.37"
"67","000","00","010","0020","0190","481","204","277","7","488","1361","0","35.86","14.99"
"67","000","00","010","0020","0191","409","203","206","3","412","1135","0","36.30","17.89"
"67","000","00","010","0021","0000","659","237","422","6","665","1880","0","35.37","12.61"
"67","000","00","010","0021","0192","357","122","235","3","360","1038","0","34.68","11.75"
"67","000","00","010","0021","0193","302","115","187","3","305","842","0","36.22","13.66"
"67","000","00","010","0025","0000","609","166","443","6","615","1555","0","39.55","10.68"
"67","000","00","010","0025","0196","247","76","171","2","249","670","0","37.16","11.34"
"67","000","00","010","0025","0197","362","90","272","4","366","885","0","41.36","10.17"
"67","000","00","010","0026","0000","343","106","237","4","347","897","0","38.68","11.82"
"67","000","00","010","0026","0194","211","57","154","0","211","507","0","41.62","11.24"
"67","000","00","010","0026","0195","132","49","83","4","136","390","0","34.87","12.56"
"67","000","00","010","0027","0000","1880","868","1012","16","1896","4874","0","38.90","17.81"
"67","000","00","010","0027","0170","495","227","268","4","499","1254","0","39.79","18.10"
"67","000","00","010","0027","0171","451","213","238","5","456","1274","0","35.79","16.72"
"67","000","00","010","0027","0172","426","190","236","5","431","1082","0","39.83","17.56"
"67","000","00","010","0027","0173","508","238","270","2","510","1264","0","40.35","18.83"
"67","000","00","010","0028","0000","2040","896","1144","16","2056","5086","0","40.42","17.62"
"67","000","00","010","0028","0174","556","221","335","4","560","1369","0","40.91","16.14"
"67","000","00","010","0028","0175","507","253","254","3","510","1265","0","40.32","20.00"
"67","000","00","010","0028","0176","456","206","250","3","459","1171","0","39.20","17.59"
"67","000","00","010","0028","0177","521","216","305","6","527","1281","0","41.14","16.86"
"67","000","00","010","0029","0000","2504","1244","1260","19","2523","6401","0","39.42","19.43"
"67","000","00","010","0029","0156","492","217","275","3","495","1252","0","39.54","17.33"
"67","000","00","010","0029","0157","521","294","227","3","524","1310","0","40.00","22.44"
"67","000","00","010","0029","0158","448","204","244","2","450","1215","0","37.04","16.79"
"67","000","00","010","0029","0159","522","264","258","4","526","1294","0","40.65","20.40"
"67","000","00","010","0029","0160","521","265","256","7","528","1330","0","39.70","19.92"
"67","000","00","010","0030","0000","1133","468","665","8","1141","2599","0","43.90","18.01"
"67","000","00","010","0030","0147","399","167","232","0","399","867","0","46.02","19.26"
"67","000","00","010","0030","0148","430","169","261","6","436","1004","0","43.43","16.83"
"67","000","00","010","0030","0149","304","132","172","2","306","728","0","42.03","18.13"
"67","000","00","020","0000","0000","8318","2716","5602","115","8433","21950","24892","38.42","12.37"
"67","000","00","020","0001","0000","590","201","389","4","594","1549","0","38.35","12.98"
"67","000","00","020","0001","0108","404","124","280","3","407","1074","0","37.90","11.55"
"67","000","00","020","0001","0109","186","77","109","1","187","475","0","39.37","16.21"
"67","000","00","020","0008","0000","1294","478","816","15","1309","3724","0","35.15","12.84"
"67","000","00","020","0008","0116","413","139","274","2","415","1093","0","37.97","12.72"
"67","000","00","020","0008","0117","471","184","287","11","482","1366","0","35.29","13.47"
"67","000","00","020","0008","0118","410","155","255","2","412","1265","0","32.57","12.25"
"67","000","00","020","0010","0000","310","45","265","14","324","875","0","37.03","5.14"
"67","000","00","020","0010","0122","310","45","265","14","324","875","0","37.03","5.14"
"67","000","00","020","0011","0000","1442","531","911","21","1463","3815","0","38.35","13.92"
"67","000","00","020","0011","0119","519","196","323","8","527","1434","0","36.75","13.67"
"67","000","00","020","0011","0120","542","194","348","7","549","1289","0","42.59","15.05"
"67","000","00","020","0011","0121","381","141","240","6","387","1092","0","35.44","12.91"
"67","000","00","020","0014","0000","603","189","414","11","614","1621","0","37.88","11.66"
"67","000","00","020","0014","0130","352","120","232","8","360","903","0","39.87","13.29"
"67","000","00","020","0014","0131","251","69","182","3","254","718","0","35.38","9.61"
"67","000","00","020","0026","0000","611","229","382","4","615","1413","0","43.52","16.21"
"67","000","00","020","0026","0110","249","95","154","2","251","626","0","40.10","15.18"
"67","000","00","020","0026","0111","140","55","85","1","141","308","0","45.78","17.86"
"67","000","00","020","0026","0112","222","79","143","1","223","479","0","46.56","16.49"
"67","000","00","020","0027","0000","650","286","364","3","653","1575","0","41.46","18.16"
"67","000","00","020","0027","0113","306","138","168","2","308","761","0","40.47","18.13"
"67","000","00","020","0027","0114","128","52","76","0","128","315","0","40.63","16.51"
"67","000","00","020","0027","0115","216","96","120","1","217","499","0","43.49","19.24"
"67","000","00","020","0028","0000","621","150","471","6","627","1519","0","41.28","9.87"
"67","000","00","020","0028","0125","335","71","264","3","338","770","0","43.90","9.22"
"67","000","00","020","0028","0126","118","32","86","0","118","282","0","41.84","11.35"
"67","000","00","020","0028","0127","168","47","121","3","171","467","0","36.62","10.06"
"67","000","00","020","0029","0000","562","154","408","8","570","1545","0","36.89","9.97"
"67","000","00","020","0029","0123","301","77","224","4","305","817","0","37.33","9.42"
"67","000","00","020","0029","0124","261","77","184","4","265","728","0","36.40","10.58"
"67","000","00","020","0030","0000","367","103","264","2","369","981","0","37.61","10.50"
"67","000","00","020","0030","0128","238","65","173","2","240","597","0","40.20","10.89"
"67","000","00","020","0030","0129","129","38","91","0","129","384","0","33.59","9.90"
"67","000","00","020","0031","0000","435","109","326","9","444","1073","0","41.38","10.16"
"67","000","00","020","0031","0135","304","74","230","6","310","724","0","42.82","10.22"
"67","000","00","020","0031","0136","131","35","96","3","134","349","0","38.40","10.03"
"67","000","00","020","0032","0000","366","111","255","10","376","900","0","41.78","12.33"
"67","000","00","020","0032","0132","107","26","81","3","110","211","0","52.13","12.32"
"67","000","00","020","0032","0133","129","52","77","6","135","382","0","35.34","13.61"
"67","000","00","020","0032","0134","130","33","97","1","131","307","0","42.67","10.75"
"67","000","00","020","0033","0000","467","130","337","8","475","1360","0","34.93","9.56"
"67","000","00","020","0033","0137","321","80","241","2","323","903","0","35.77","8.86"
"67","000","00","020","0033","0138","146","50","96","6","152","457","0","33.26","10.94"
"67","000","00","030","0000","0000","9135","2893","6242","124","9259","24122","26978","38.38","11.99"
"67","000","00","030","0001","0000","670","214","456","4","674","1688","0","39.93","12.68"
"67","000","00","030","0001","0030","373","110","263","1","374","953","0","39.24","11.54"
"67","000","00","030","0001","0031","297","104","193","3","300","735","0","40.82","14.15"
"67","000","00","030","0002","0000","1271","433","838","6","1277","2937","0","43.48","14.74"
"67","000","00","030","0002","0032","393","122","271","2","395","864","0","45.72","14.12"
"67","000","00","030","0002","0033","413","142","271","3","416","966","0","43.06","14.70"
"67","000","00","030","0002","0034","465","169","296","1","466","1107","0","42.10","15.27"
"67","000","00","030","0003","0000","546","184","362","4","550","1364","0","40.32","13.49"
"67","000","00","030","0003","0035","546","184","362","4","550","1364","0","40.32","13.49"
"67","000","00","030","0004","0000","643","212","431","9","652","1596","0","40.85","13.28"
"67","000","00","030","0004","0036","290","92","198","6","296","699","0","42.35","13.16"
"67","000","00","030","0004","0037","353","120","233","3","356","897","0","39.69","13.38"
"67","000","00","030","0005","0000","336","116","220","6","342","874","0","39.13","13.27"
"67","000","00","030","0005","0038","336","116","220","6","342","874","0","39.13","13.27"
"67","000","00","030","0006","0000","545","177","368","9","554","1334","0","41.53","13.27"
"67","000","00","030","0006","0039","342","110","232","6","348","793","0","43.88","13.87"
"67","000","00","030","0006","0040","203","67","136","3","206","541","0","38.08","12.38"
"67","000","00","030","0007","0000","175","62","113","3","178","440","0","40.45","14.09"
"67","000","00","030","0007","0041","175","62","113","3","178","440","0","40.45","14.09"
"67","000","00","030","0008","0000","181","40","141","2","183","560","0","32.68","7.14"
"67","000","00","030","0008","0042","181","40","141","2","183","560","0","32.68","7.14"
"67","000","00","030","0009","0000","120","39","81","3","123","369","0","33.33","10.57"
"67","000","00","030","0009","0043","120","39","81","3","123","369","0","33.33","10.57"
"67","000","00","030","0010","0000","160","34","126","2","162","487","0","33.26","6.98"
"67","000","00","030","0010","0044","160","34","126","2","162","487","0","33.26","6.98"
"67","000","00","030","0011","0000","381","139","242","7","388","1178","0","32.94","11.80"
"67","000","00","030","0011","0047","141","74","67","2","143","431","0","33.18","17.17"
"67","000","00","030","0011","0048","240","65","175","5","245","747","0","32.80","8.70"
"67","000","00","030","0012","0000","334","92","242","3","337","1001","0","33.67","9.19"
"67","000","00","030","0012","0045","213","52","161","0","213","617","0","34.52","8.43"
"67","000","00","030","0012","0046","121","40","81","3","124","384","0","32.29","10.42"
"67","000","00","030","0014","0000","491","158","333","7","498","1380","0","36.09","11.45"
"67","000","00","030","0014","0051","256","81","175","3","259","698","0","37.11","11.60"
"67","000","00","030","0014","0052","235","77","158","4","239","682","0","35.04","11.29"
"67","000","00","030","0018","0000","318","112","206","7","325","836","0","38.88","13.40"
"67","000","00","030","0018","0055","318","112","206","7","325","836","0","38.88","13.40"
"67","000","00","030","0019","0000","193","86","107","1","194","705","0","27.52","12.20"
"67","000","00","030","0019","0056","193","86","107","1","194","705","0","27.52","12.20"
"67","000","00","030","0020","0000","477","143","334","6","483","1303","0","37.07","10.97"
"67","000","00","030","0020","0057","477","143","334","6","483","1303","0","37.07","10.97"
"67","000","00","030","0021","0000","279","66","213","6","285","707","0","40.31","9.34"
"67","000","00","030","0021","0058","279","66","213","6","285","707","0","40.31","9.34"
"67","000","00","030","0022","0000","254","82","172","3","257","657","0","39.12","12.48"
"67","000","00","030","0022","0059","254","82","172","3","257","657","0","39.12","12.48"
"67","000","00","030","0025","0000","743","209","534","12","755","1930","0","39.12","10.83"
"67","000","00","030","0025","0049","319","68","251","5","324","781","0","41.49","8.71"
"67","000","00","030","0025","0050","424","141","283","7","431","1149","0","37.51","12.27"
"67","000","00","030","0026","0000","580","162","418","10","590","1458","0","40.47","11.11"
"67","000","00","030","0026","0053","223","71","152","4","227","620","0","36.61","11.45"
"67","000","00","030","0026","0054","357","91","266","6","363","838","0","43.32","10.86"
"67","000","00","030","0027","0000","438","133","305","14","452","1318","0","34.29","10.09"
"67","000","00","030","0027","0060","282","102","180","11","293","817","0","35.86","12.48"
"67","000","00","030","0027","0061","156","31","125","3","159","501","0","31.74","6.19"
"67","000","00","040","0000","0000","7142","2354","4788","90","7232","18522","20733","39.05","12.71"
"67","000","00","040","0001","0000","707","234","473","14","721","1825","0","39.51","12.82"
"67","000","00","040","0001","0198","435","137","298","9","444","1142","0","38.88","12.00"
"67","000","00","040","0001","0199","272","97","175","5","277","683","0","40.56","14.20"
"67","000","00","040","0002","0000","706","251","455","2","708","1608","0","44.03","15.61"
"67","000","00","040","0002","0200","325","127","198","0","325","731","0","44.46","17.37"
"67","000","00","040","0002","0201","381","124","257","2","383","877","0","43.67","14.14"
"67","000","00","040","0003","0000","445","163","282","8","453","1107","0","40.92","14.72"
"67","000","00","040","0003","0202","445","163","282","8","453","1107","0","40.92","14.72"
"67","000","00","040","0004","0000","1090","382","708","12","1102","2722","0","40.48","14.03"
"67","000","00","040","0004","0203","347","101","246","4","351","880","0","39.89","11.48"
"67","000","00","040","0004","0204","390","148","242","4","394","981","0","40.16","15.09"
"67","000","00","040","0004","0205","353","133","220","4","357","861","0","41.46","15.45"
"67","000","00","040","0005","0000","508","174","334","3","511","1368","0","37.35","12.72"
"67","000","00","040","0005","0206","508","174","334","3","511","1368","0","37.35","12.72"
"67","000","00","040","0006","0000","298","110","188","0","298","727","0","40.99","15.13"
"67","000","00","040","0006","0207","173","67","106","0","173","398","0","43.47","16.83"
"67","000","00","040","0006","0208","125","43","82","0","125","329","0","37.99","13.07"
"67","000","00","040","0007","0000","602","209","393","14","616","1454","0","42.37","14.37"
"67","000","00","040","0007","0209","321","128","193","7","328","701","0","46.79","18.26"
"67","000","00","040","0007","0210","281","81","200","7","288","753","0","38.25","10.76"
"67","000","00","040","0008","0000","643","185","458","9","652","1738","0","37.51","10.64"
"67","000","00","040","0008","0211","257","64","193","5","262","690","0","37.97","9.28"
"67","000","00","040","0008","0212","293","92","201","2","295","768","0","38.41","11.98"
"67","000","00","040","0008","0213","93","29","64","2","95","280","0","33.93","10.36"
"67","000","00","040","0009","0000","468","147","321","7","475","1275","0","37.25","11.53"
"67","000","00","040","0009","0214","221","81","140","5","226","666","0","33.93","12.16"
"67","000","00","040","0009","0215","247","66","181","2","249","609","0","40.89","10.84"
"67","000","00","040","0010","0000","254","63","191","4","258","652","0","39.57","9.66"
"67","000","00","040","0010","0216","254","63","191","4","258","652","0","39.57","9.66"
"67","000","00","040","0011","0000","482","140","342","8","490","1337","0","36.65","10.47"
"67","000","00","040","0011","0217","405","120","285","6","411","1139","0","36.08","10.54"
"67","000","00","040","0011","0218","77","20","57","2","79","198","0","39.90","10.10"
"67","000","00","040","0012","0000","437","127","310","4","441","1192","0","37.00","10.65"
"67","000","00","040","0012","0219","358","95","263","2","360","1033","0","34.85","9.20"
"67","000","00","040","0012","0220","79","32","47","2","81","159","0","50.94","20.13"
"67","000","00","040","0013","0000","502","169","333","5","507","1517","0","33.42","11.14"
"67","000","00","040","0013","0221","263","100","163","4","267","858","0","31.12","11.66"
"67","000","00","040","0013","0222","183","51","132","1","184","491","0","37.47","10.39"
"67","000","00","040","0013","0223","56","18","38","0","56","168","0","33.33","10.71"
"67","000","00","050","0000","0000","8049","2575","5474","105","8154","20265","22532","40.24","12.71"
"67","000","00","050","0001","0000","690","277","413","7","697","1620","0","43.02","17.10"
"67","000","00","050","0001","0001","315","118","197","2","317","717","0","44.21","16.46"
"67","000","00","050","0001","0002","375","159","216","5","380","903","0","42.08","17.61"
"67","000","00","050","0002","0000","505","156","349","6","511","1264","0","40.43","12.34"
"67","000","00","050","0002","0003","304","99","205","5","309","748","0","41.31","13.24"
"67","000","00","050","0002","0004","201","57","144","1","202","516","0","39.15","11.05"
"67","000","00","050","0003","0000","478","150","328","7","485","1275","0","38.04","11.76"
"67","000","00","050","0003","0005","378","125","253","7","385","1039","0","37.05","12.03"
"67","000","00","050","0003","0006","100","25","75","0","100","236","0","42.37","10.59"
"67","000","00","050","0004","0000","524","140","384","8","532","1304","0","40.80","10.74"
"67","000","00","050","0004","0007","196","59","137","3","199","459","0","43.36","12.85"
"67","000","00","050","0004","0008","328","81","247","5","333","845","0","39.41","9.59"
"67","000","00","050","0010","0000","576","129","447","5","581","1336","0","43.49","9.66"
"67","000","00","050","0010","0021","413","90","323","2","415","902","0","46.01","9.98"
"67","000","00","050","0010","0022","163","39","124","3","166","434","0","38.25","8.99"
"67","000","00","050","0011","0000","604","186","418","9","613","1610","0","38.07","11.55"
"67","000","00","050","0011","0023","247","75","172","5","252","639","0","39.44","11.74"
"67","000","00","050","0011","0024","357","111","246","4","361","971","0","37.18","11.43"
"67","000","00","050","0012","0000","483","183","300","8","491","1223","0","40.15","14.96"
"67","000","00","050","0012","0025","483","183","300","8","491","1223","0","40.15","14.96"
"67","000","00","050","0013","0000","507","198","309","6","513","1216","0","42.19","16.28"
"67","000","00","050","0013","0026","267","107","160","3","270","659","0","40.97","16.24"
"67","000","00","050","0013","0027","240","91","149","3","243","557","0","43.63","16.34"
"67","000","00","050","0014","0000","685","239","446","5","690","1753","0","39.36","13.63"
"67","000","00","050","0014","0028","224","55","169","3","227","603","0","37.65","9.12"
"67","000","00","050","0014","0029","461","184","277","2","463","1150","0","40.26","16.00"
"67","000","00","050","0018","0000","565","193","372","6","571","1379","0","41.41","14.00"
"67","000","00","050","0018","0013","141","46","95","2","143","349","0","40.97","13.18"
"67","000","00","050","0018","0014","264","82","182","2","266","636","0","41.82","12.89"
"67","000","00","050","0018","0015","160","65","95","2","162","394","0","41.12","16.50"
"67","000","00","050","0019","0000","301","81","220","6","307","966","0","31.78","8.39"
"67","000","00","050","0019","0016","165","43","122","4","169","515","0","32.82","8.35"
"67","000","00","050","0019","0017","136","38","98","2","138","451","0","30.60","8.43"
"67","000","00","050","0022","0000","817","255","562","17","834","1961","0","42.53","13.00"
"67","000","00","050","0022","0018","365","135","230","12","377","953","0","39.56","14.17"
"67","000","00","050","0022","0019","233","55","178","2","235","476","0","49.37","11.55"
"67","000","00","050","0022","0020","219","65","154","3","222","532","0","41.73","12.22"
"67","000","00","050","0023","0000","863","240","623","10","873","2164","0","40.34","11.09"
"67","000","00","050","0023","0009","429","122","307","7","436","1052","0","41.44","11.60"
"67","000","00","050","0023","0010","434","118","316","3","437","1112","0","39.30","10.61"
"67","000","00","050","0024","0000","451","148","303","5","456","1194","0","38.19","12.40"
"67","000","00","050","0024","0011","291","94","197","2","293","749","0","39.12","12.55"
"67","000","00","050","0024","0012","160","54","106","3","163","445","0","36.63","12.13"
"67","000","00","060","0000","0000","5737","2004","3733","80","5817","17960","19922","32.39","11.16"
"67","000","00","060","0001","0000","475","200","275","7","482","1400","0","34.43","14.29"
"67","000","00","060","0001","0224","475","200","275","7","482","1400","0","34.43","14.29"
"67","000","00","060","0002","0000","871","333","538","4","875","2475","0","35.35","13.45"
"67","000","00","060","0002","0225","445","160","285","2","447","1166","0","38.34","13.72"
"67","000","00","060","0002","0226","426","173","253","2","428","1309","0","32.70","13.22"
"67","000","00","060","0003","0000","468","143","325","4","472","1405","0","33.59","10.18"
"67","000","00","060","0003","0227","228","69","159","0","228","715","0","31.89","9.65"
"67","000","00","060","0003","0228","240","74","166","4","244","690","0","35.36","10.72"
"67","000","00","060","0004","0000","284","92","192","4","288","920","0","31.30","10.00"
"67","000","00","060","0004","0230","284","92","192","4","288","920","0","31.30","10.00"
"67","000","00","060","0005","0000","295","98","197","3","298","1058","0","28.17","9.26"
"67","000","00","060","0005","0229","295","98","197","3","298","1058","0","28.17","9.26"
"67","000","00","060","0006","0000","417","142","275","7","424","1193","0","35.54","11.90"
"67","000","00","060","0006","0231","168","64","104","5","173","633","0","27.33","10.11"
"67","000","00","060","0006","0232","249","78","171","2","251","560","0","44.82","13.93"
"67","000","00","060","0007","0000","291","79","212","9","300","826","0","36.32","9.56"
"67","000","00","060","0007","0233","291","79","212","9","300","826","0","36.32","9.56"
"67","000","00","060","0008","0000","115","27","88","3","118","420","0","28.10","6.43"
"67","000","00","060","0008","0237","115","27","88","3","118","420","0","28.10","6.43"
"67","000","00","060","0009","0000","106","31","75","0","106","376","0","28.19","8.24"
"67","000","00","060","0009","0238","106","31","75","0","106","376","0","28.19","8.24"
"67","000","00","060","0010","0000","135","45","90","5","140","370","0","37.84","12.16"
"67","000","00","060","0010","0239","135","45","90","5","140","370","0","37.84","12.16"
"67","000","00","060","0011","0000","620","236","384","8","628","2040","0","30.78","11.57"
"67","000","00","060","0011","0240","372","128","244","6","378","1181","0","32.01","10.84"
"67","000","00","060","0011","0241","248","108","140","2","250","859","0","29.10","12.57"
"67","000","00","060","0012","0000","147","54","93","1","148","647","0","22.87","8.35"
"67","000","00","060","0012","0242","147","54","93","1","148","647","0","22.87","8.35"
"67","000","00","060","0013","0000","277","83","194","3","280","1054","0","26.57","7.87"
"67","000","00","060","0013","0243","277","83","194","3","280","1054","0","26.57","7.87"
"67","000","00","060","0014","0000","300","113","187","4","304","1052","0","28.90","10.74"
"67","000","00","060","0014","0244","300","113","187","4","304","1052","0","28.90","10.74"
"67","000","00","060","0015","0000","218","113","105","3","221","877","0","25.20","12.88"
"67","000","00","060","0015","0245","218","113","105","3","221","877","0","25.20","12.88"
"67","000","00","060","0016","0000","718","215","503","15","733","1847","0","39.69","11.64"
"67","000","00","060","0016","0234","307","85","222","4","311","756","0","41.14","11.24"
"67","000","00","060","0016","0235","172","48","124","5","177","481","0","36.80","9.98"
"67","000","00","060","0016","0236","239","82","157","6","245","610","0","40.16","13.44"
"67","000","00","070","0000","0000","16398","4386","12012","187","16585","37508","43610","44.22","11.69"
"67","000","00","070","0003","0000","1124","379","745","9","1133","2562","0","44.22","14.79"
"67","000","00","070","0003","0388","395","125","270","5","400","945","0","42.33","13.23"
"67","000","00","070","0003","0389","376","133","243","2","378","800","0","47.25","16.63"
"67","000","00","070","0003","0390","353","121","232","2","355","817","0","43.45","14.81"
"67","000","00","070","0004","0000","1101","313","788","18","1119","2463","0","45.43","12.71"
"67","000","00","070","0004","0391","327","86","241","5","332","737","0","45.05","11.67"
"67","000","00","070","0004","0392","356","115","241","7","363","826","0","43.95","13.92"
"67","000","00","070","0004","0393","418","112","306","6","424","900","0","47.11","12.44"
"67","000","00","070","0005","0000","969","324","645","6","975","2086","0","46.74","15.53"
"67","000","00","070","0005","0386","445","133","312","3","448","915","0","48.96","14.54"
"67","000","00","070","0005","0387","524","191","333","3","527","1171","0","45.00","16.31"
"67","000","00","070","0006","0000","847","287","560","11","858","1936","0","44.32","14.82"
"67","000","00","070","0006","0394","459","161","298","9","468","990","0","47.27","16.26"
"67","000","00","070","0006","0395","388","126","262","2","390","946","0","41.23","13.32"
"67","000","00","070","0007","0000","648","173","475","5","653","1433","0","45.57","12.07"
"67","000","00","070","0007","0396","390","123","267","1","391","768","0","50.91","16.02"
"67","000","00","070","0007","0397","258","50","208","4","262","665","0","39.40","7.52"
"67","000","00","070","0009","0000","1588","431","1157","15","1603","3474","0","46.14","12.41"
"67","000","00","070","0009","0398","529","156","373","5","534","1107","0","48.24","14.09"
"67","000","00","070","0009","0399","562","144","418","3","565","1273","0","44.38","11.31"
"67","000","00","070","0009","0400","497","131","366","7","504","1094","0","46.07","11.97"
"67","000","00","070","0010","0000","457","84","373","4","461","1093","0","42.18","7.69"
"67","000","00","070","0010","0401","457","84","373","4","461","1093","0","42.18","7.69"
"67","000","00","070","0011","0000","1246","352","894","13","1259","2846","0","44.24","12.37"
"67","000","00","070","0011","0402","400","133","267","5","405","852","0","47.54","15.61"
"67","000","00","070","0011","0403","385","86","299","4","389","918","0","42.37","9.37"
"67","000","00","070","0011","0404","461","133","328","4","465","1076","0","43.22","12.36"
"67","000","00","070","0014","0000","990","342","648","10","1000","2315","0","43.20","14.77"
"67","000","00","070","0014","0407","295","107","188","2","297","689","0","43.11","15.53"
"67","000","00","070","0014","0408","335","142","193","5","340","782","0","43.48","18.16"
"67","000","00","070","0014","0409","360","93","267","3","363","844","0","43.01","11.02"
"67","000","00","070","0015","0000","746","148","598","5","751","1645","0","45.65","9.00"
"67","000","00","070","0015","0410","346","73","273","0","346","804","0","43.03","9.08"
"67","000","00","070","0015","0411","400","75","325","5","405","841","0","48.16","8.92"
"67","000","00","070","0017","0000","951","183","768","12","963","2284","0","42.16","8.01"
"67","000","00","070","0017","0412","526","102","424","8","534","1321","0","40.42","7.72"
"67","000","00","070","0017","0413","425","81","344","4","429","963","0","44.55","8.41"
"67","000","00","070","0019","0000","835","210","625","12","847","2089","0","40.55","10.05"
"67","000","00","070","0019","0414","381","107","274","6","387","985","0","39.29","10.86"
"67","000","00","070","0019","0415","281","73","208","4","285","648","0","43.98","11.27"
"67","000","00","070","0019","0416","173","30","143","2","175","456","0","38.38","6.58"
"67","000","00","070","0021","0000","516","133","383","8","524","1232","0","42.53","10.80"
"67","000","00","070","0021","0417","516","133","383","8","524","1232","0","42.53","10.80"
"67","000","00","070","0022","0000","446","101","345","3","449","1171","0","38.34","8.63"
"67","000","00","070","0022","0418","446","101","345","3","449","1171","0","38.34","8.63"
"67","000","00","070","0024","0000","623","129","494","10","633","1297","0","48.80","9.95"
"67","000","00","070","0024","0419","278","63","215","4","282","539","0","52.32","11.69"
"67","000","00","070","0024","0420","345","66","279","6","351","758","0","46.31","8.71"
"67","000","00","070","0028","0000","374","93","281","5","379","925","0","40.97","10.05"
"67","000","00","070","0028","0423","374","93","281","5","379","925","0","40.97","10.05"
"67","000","00","070","0030","0000","795","197","598","10","805","1871","0","43.03","10.53"
"67","000","00","070","0030","0384","501","121","380","7","508","1192","0","42.62","10.15"
"67","000","00","070","0030","0385","294","76","218","3","297","679","0","43.74","11.19"
"67","000","00","070","0031","0000","773","156","617","15","788","1633","0","48.25","9.55"
"67","000","00","070","0031","0421","405","91","314","12","417","844","0","49.41","10.78"
"67","000","00","070","0031","0422","368","65","303","3","371","789","0","47.02","8.24"
"67","000","00","070","0032","0000","751","181","570","9","760","1704","0","44.60","10.62"
"67","000","00","070","0032","0424","487","108","379","5","492","1110","0","44.32","9.73"
"67","000","00","070","0032","0425","264","73","191","4","268","594","0","45.12","12.29"
"67","000","00","070","0033","0000","618","170","448","7","625","1449","0","43.13","11.73"
"67","000","00","070","0033","0405","299","98","201","1","300","691","0","43.42","14.18"
"67","000","00","070","0033","0406","319","72","247","6","325","758","0","42.88","9.50"
"67","000","00","080","0000","0000","7826","2594","5232","94","7920","20418","23214","38.79","12.70"
"67","000","00","080","0001","0000","615","251","364","6","621","1503","0","41.32","16.70"
"67","000","00","080","0001","0270","316","126","190","2","318","759","0","41.90","16.60"
"67","000","00","080","0001","0271","299","125","174","4","303","744","0","40.73","16.80"
"67","000","00","080","0002","0000","700","237","463","7","707","1925","0","36.73","12.31"
"67","000","00","080","0002","0272","324","106","218","1","325","951","0","34.17","11.15"
"67","000","00","080","0002","0273","376","131","245","6","382","974","0","39.22","13.45"
"67","000","00","080","0003","0000","606","237","369","8","614","1601","0","38.35","14.80"
"67","000","00","080","0003","0274","275","105","170","3","278","735","0","37.82","14.29"
"67","000","00","080","0003","0275","331","132","199","5","336","866","0","38.80","15.24"
"67","000","00","080","0004","0000","612","239","373","3","615","1555","0","39.55","15.37"
"67","000","00","080","0004","0276","301","121","180","1","302","730","0","41.37","16.58"
"67","000","00","080","0004","0277","311","118","193","2","313","825","0","37.94","14.30"
"67","000","00","080","0005","0000","680","253","427","6","686","1945","0","35.27","13.01"
"67","000","00","080","0005","0278","343","144","199","4","347","994","0","34.91","14.49"
"67","000","00","080","0005","0279","337","109","228","2","339","951","0","35.65","11.46"
"67","000","00","080","0006","0000","806","284","522","12","818","2079","0","39.35","13.66"
"67","000","00","080","0006","0280","383","117","266","5","388","1036","0","37.45","11.29"
"67","000","00","080","0006","0281","423","167","256","7","430","1043","0","41.23","16.01"
"67","000","00","080","0011","0000","729","214","515","6","735","1817","0","40.45","11.78"
"67","000","00","080","0011","0286","373","105","268","2","375","919","0","40.81","11.43"
"67","000","00","080","0011","0287","356","109","247","4","360","898","0","40.09","12.14"
"67","000","00","080","0012","0000","392","98","294","5","397","866","0","45.84","11.32"
"67","000","00","080","0012","0288","392","98","294","5","397","866","0","45.84","11.32"
"67","000","00","080","0013","0000","424","127","297","3","427","1269","0","33.65","10.01"
"67","000","00","080","0013","0289","226","74","152","2","228","647","0","35.24","11.44"
"67","000","00","080","0013","0290","198","53","145","1","199","622","0","31.99","8.52"
"67","000","00","080","0016","0000","847","230","617","12","859","2146","0","40.03","10.72"
"67","000","00","080","0016","0284","457","126","331","6","463","1099","0","42.13","11.46"
"67","000","00","080","0016","0285","390","104","286","6","396","1047","0","37.82","9.93"
"67","000","00","080","0017","0000","563","211","352","11","574","1539","0","37.30","13.71"
"67","000","00","080","0017","0282","255","84","171","6","261","700","0","37.29","12.00"
"67","000","00","080","0017","0283","308","127","181","5","313","839","0","37.31","15.14"
"67","000","00","080","0018","0000","852","213","639","15","867","2173","0","39.90","9.80"
"67","000","00","080","0018","0291","460","120","340","10","470","1138","0","41.30","10.54"
"67","000","00","080","0018","0292","392","93","299","5","397","1035","0","38.36","8.99"
"67","000","00","090","0000","0000","7016","2236","4780","84","7100","18759","21572","37.85","11.92"
"67","000","00","090","0001","0000","1059","341","718","11","1070","2866","0","37.33","11.90"
"67","000","00","090","0001","0293","303","108","195","2","305","795","0","38.36","13.58"
"67","000","00","090","0001","0294","228","81","147","1","229","627","0","36.52","12.92"
"67","000","00","090","0001","0295","528","152","376","8","536","1444","0","37.12","10.53"
"67","000","00","090","0002","0000","956","296","660","15","971","2601","0","37.33","11.38"
"67","000","00","090","0002","0296","572","191","381","8","580","1483","0","39.11","12.88"
"67","000","00","090","0002","0297","384","105","279","7","391","1118","0","34.97","9.39"
"67","000","00","090","0003","0000","547","185","362","5","552","1327","0","41.60","13.94"
"67","000","00","090","0003","0298","547","185","362","5","552","1327","0","41.60","13.94"
"67","000","00","090","0005","0000","697","204","493","7","704","1910","0","36.86","10.68"
"67","000","00","090","0005","0299","339","107","232","3","342","1014","0","33.73","10.55"
"67","000","00","090","0005","0300","358","97","261","4","362","896","0","40.40","10.83"
"67","000","00","090","0006","0000","1255","396","859","19","1274","3299","0","38.62","12.00"
"67","000","00","090","0006","0301","529","152","377","6","535","1369","0","39.08","11.10"
"67","000","00","090","0006","0302","342","110","232","9","351","938","0","37.42","11.73"
"67","000","00","090","0006","0303","384","134","250","4","388","992","0","39.11","13.51"
"67","000","00","090","0007","0000","772","229","543","4","776","2062","0","37.63","11.11"
"67","000","00","090","0007","0304","439","122","317","2","441","1168","0","37.76","10.45"
"67","000","00","090","0007","0305","333","107","226","2","335","894","0","37.47","11.97"
"67","000","00","090","0008","0000","616","206","410","8","624","1583","0","39.42","13.01"
"67","000","00","090","0008","0306","229","78","151","0","229","603","0","37.98","12.94"
"67","000","00","090","0008","0307","387","128","259","8","395","980","0","40.31","13.06"
"67","000","00","090","0009","0000","473","174","299","7","480","1229","0","39.06","14.16"
"67","000","00","090","0009","0308","473","174","299","7","480","1229","0","39.06","14.16"
"67","000","00","090","0010","0000","265","98","167","3","268","583","0","45.97","16.81"
"67","000","00","090","0010","0309","265","98","167","3","268","583","0","45.97","16.81"
"67","000","00","090","0011","0000","194","56","138","2","196","719","0","27.26","7.79"
"67","000","00","090","0011","0310","194","56","138","2","196","719","0","27.26","7.79"
"67","000","00","090","0012","0000","182","51","131","3","185","580","0","31.90","8.79"
"67","000","00","090","0012","0311","182","51","131","3","185","580","0","31.90","8.79"
"67","000","00","100","0000","0000","7628","2233","5395","99","7727","18603","21123","41.54","12.00"
"67","000","00","100","0001","0000","809","270","539","8","817","2045","0","39.95","13.20"
"67","000","00","100","0001","0426","437","170","267","4","441","1070","0","41.21","15.89"
"67","000","00","100","0001","0427","372","100","272","4","376","975","0","38.56","10.26"
"67","000","00","100","0002","0000","1316","300","1016","14","1330","3141","0","42.34","9.55"
"67","000","00","100","0002","0428","442","118","324","6","448","1017","0","44.05","11.60"
"67","000","00","100","0002","0429","398","74","324","3","401","1037","0","38.67","7.14"
"67","000","00","100","0002","0430","476","108","368","5","481","1087","0","44.25","9.94"
"67","000","00","100","0005","0000","144","51","93","2","146","402","0","36.32","12.69"
"67","000","00","100","0005","0433","144","51","93","2","146","402","0","36.32","12.69"
"67","000","00","100","0006","0000","782","288","494","11","793","1948","0","40.71","14.78"
"67","000","00","100","0006","0434","426","150","276","6","432","934","0","46.25","16.06"
"67","000","00","100","0006","0435","356","138","218","5","361","1014","0","35.60","13.61"
"67","000","00","100","0007","0000","1408","554","854","17","1425","3476","0","41.00","15.94"
"67","000","00","100","0007","0436","330","102","228","2","332","923","0","35.97","11.05"
"67","000","00","100","0007","0437","515","209","306","6","521","1208","0","43.13","17.30"
"67","000","00","100","0007","0438","563","243","320","9","572","1345","0","42.53","18.07"
"67","000","00","100","0008","0000","453","126","327","8","461","1243","0","37.09","10.14"
"67","000","00","100","0008","0439","453","126","327","8","461","1243","0","37.09","10.14"
"67","000","00","100","0013","0000","314","68","246","2","316","855","0","36.96","7.95"
"67","000","00","100","0013","0446","314","68","246","2","316","855","0","36.96","7.95"
"67","000","00","100","0014","0000","521","138","383","4","525","1197","0","43.86","11.53"
"67","000","00","100","0014","0431","402","84","318","3","405","928","0","43.64","9.05"
"67","000","00","100","0014","0432","119","54","65","1","120","269","0","44.61","20.07"
"67","000","00","100","0015","0000","1081","333","748","19","1100","2498","0","44.04","13.33"
"67","000","00","100","0015","0442","230","81","149","3","233","497","0","46.88","16.30"
"67","000","00","100","0015","0443","313","105","208","6","319","706","0","45.18","14.87"
"67","000","00","100","0015","0444","336","91","245","4","340","785","0","43.31","11.59"
"67","000","00","100","0015","0445","202","56","146","6","208","510","0","40.78","10.98"
"67","000","00","100","0016","0000","800","105","695","14","814","1798","0","45.27","5.84"
"67","000","00","100","0016","0440","553","82","471","9","562","1215","0","46.26","6.75"
"67","000","00","100","0016","0441","247","23","224","5","252","583","0","43.22","3.95"
"67","000","00","110","0000","0000","3186","975","2211","43","3229","8312","9096","38.85","11.73"
"67","000","00","110","0001","0000","384","125","259","5","389","992","0","39.21","12.60"
"67","000","00","110","0001","0480","292","73","219","3","295","743","0","39.70","9.83"
"67","000","00","110","0001","0481","92","52","40","2","94","249","0","37.75","20.88"
"67","000","00","110","0002","0000","228","54","174","7","235","619","0","37.96","8.72"
"67","000","00","110","0002","0482","228","54","174","7","235","619","0","37.96","8.72"
"67","000","00","110","0003","0000","519","131","388","10","529","1411","0","37.49","9.28"
"67","000","00","110","0003","0483","519","131","388","10","529","1411","0","37.49","9.28"
"67","000","00","110","0004","0000","329","130","199","1","330","885","0","37.29","14.69"
"67","000","00","110","0004","0484","329","130","199","1","330","885","0","37.29","14.69"
"67","000","00","110","0005","0000","352","121","231","4","356","744","0","47.85","16.26"
"67","000","00","110","0005","0485","352","121","231","4","356","744","0","47.85","16.26"
"67","000","00","110","0006","0000","250","71","179","2","252","598","0","42.14","11.87"
"67","000","00","110","0006","0486","250","71","179","2","252","598","0","42.14","11.87"
"67","000","00","110","0007","0000","337","100","237","3","340","969","0","35.09","10.32"
"67","000","00","110","0007","0487","337","100","237","3","340","969","0","35.09","10.32"
"67","000","00","110","0008","0000","234","69","165","7","241","722","0","33.38","9.56"
"67","000","00","110","0008","0488","234","69","165","7","241","722","0","33.38","9.56"
"67","000","00","110","0009","0000","329","120","209","2","331","822","0","40.27","14.60"
"67","000","00","110","0009","0489","329","120","209","2","331","822","0","40.27","14.60"
"67","000","00","110","0010","0000","224","54","170","2","226","550","0","41.09","9.82"
"67","000","00","110","0010","0490","224","54","170","2","226","550","0","41.09","9.82"
"67","000","00","120","0000","0000","19704","6470","13234","168","19872","49901","58600","39.82","12.97"
"67","000","00","120","0001","0000","998","352","646","9","1007","2192","0","45.94","16.06"
"67","000","00","120","0001","0337","488","154","334","3","491","1081","0","45.42","14.25"
"67","000","00","120","0001","0338","510","198","312","6","516","1111","0","46.44","17.82"
"67","000","00","120","0002","0000","1080","333","747","9","1089","2827","0","38.52","11.78"
"67","000","00","120","0002","0339","554","167","387","5","559","1371","0","40.77","12.18"
"67","000","00","120","0002","0340","526","166","360","4","530","1456","0","36.40","11.40"
"67","000","00","120","0003","0000","2158","704","1454","12","2170","5534","0","39.21","12.72"
"67","000","00","120","0003","0341","434","140","294","0","434","1083","0","40.07","12.93"
"67","000","00","120","0003","0342","420","143","277","5","425","1102","0","38.57","12.98"
"67","000","00","120","0003","0343","411","155","256","1","412","1066","0","38.65","14.54"
"67","000","00","120","0003","0344","433","154","279","0","433","1127","0","38.42","13.66"
"67","000","00","120","0003","0345","460","112","348","6","466","1156","0","40.31","9.69"
"67","000","00","120","0004","0000","1599","548","1051","16","1615","4239","0","38.10","12.93"
"67","000","00","120","0004","0355","406","124","282","2","408","1034","0","39.46","11.99"
"67","000","00","120","0004","0356","380","136","244","5","385","999","0","38.54","13.61"
"67","000","00","120","0004","0357","422","140","282","5","427","1164","0","36.68","12.03"
"67","000","00","120","0004","0358","391","148","243","4","395","1042","0","37.91","14.20"
"67","000","00","120","0005","0000","2275","804","1471","21","2296","5723","0","40.12","14.05"
"67","000","00","120","0005","0346","429","158","271","4","433","1034","0","41.88","15.28"
"67","000","00","120","0005","0347","453","161","292","4","457","1155","0","39.57","13.94"
"67","000","00","120","0005","0348","417","150","267","3","420","1097","0","38.29","13.67"
"67","000","00","120","0005","0349","518","190","328","6","524","1234","0","42.46","15.40"
"67","000","00","120","0005","0350","458","145","313","4","462","1203","0","38.40","12.05"
"67","000","00","120","0006","0000","1570","608","962","20","1590","3989","0","39.86","15.24"
"67","000","00","120","0006","0363","541","182","359","7","548","1367","0","40.09","13.31"
"67","000","00","120","0006","0364","515","208","307","5","520","1338","0","38.86","15.55"
"67","000","00","120","0006","0365","514","218","296","8","522","1284","0","40.65","16.98"
"67","000","00","120","0007","0000","814","255","559","5","819","2115","0","38.72","12.06"
"67","000","00","120","0007","0366","435","151","284","1","436","1146","0","38.05","13.18"
"67","000","00","120","0007","0367","379","104","275","4","383","969","0","39.53","10.73"
"67","000","00","120","0012","0000","770","245","525","11","781","2153","0","36.27","11.38"
"67","000","00","120","0012","0372","422","140","282","3","425","1148","0","37.02","12.20"
"67","000","00","120","0012","0373","348","105","243","8","356","1005","0","35.42","10.45"
"67","000","00","120","0019","0000","664","168","496","3","667","1660","0","40.18","10.12"
"67","000","00","120","0019","0379","511","126","385","3","514","1290","0","39.84","9.77"
"67","000","00","120","0019","0380","153","42","111","0","153","370","0","41.35","11.35"
"67","000","00","120","0020","0000","984","251","733","14","998","2328","0","42.87","10.78"
"67","000","00","120","0020","0381","286","58","228","5","291","677","0","42.98","8.57"
"67","000","00","120","0020","0382","294","99","195","5","299","739","0","40.46","13.40"
"67","000","00","120","0020","0383","404","94","310","4","408","912","0","44.74","10.31"
"67","000","00","120","0022","0000","400","135","265","8","408","1045","0","39.04","12.92"
"67","000","00","120","0022","0370","266","90","176","6","272","689","0","39.48","13.06"
"67","000","00","120","0022","0371","134","45","89","2","136","356","0","38.20","12.64"
"67","000","00","120","0023","0000","2023","797","1226","6","2029","5063","0","40.08","15.74"
"67","000","00","120","0023","0351","467","187","280","0","467","1180","0","39.58","15.85"
"67","000","00","120","0023","0352","532","216","316","3","535","1337","0","40.01","16.16"
"67","000","00","120","0023","0353","511","182","329","0","511","1309","0","39.04","13.90"
"67","000","00","120","0023","0354","513","212","301","3","516","1237","0","41.71","17.14"
"67","000","00","120","0024","0000","899","249","650","9","908","2103","0","43.18","11.84"
"67","000","00","120","0024","0368","472","119","353","5","477","1162","0","41.05","10.24"
"67","000","00","120","0024","0369","427","130","297","4","431","941","0","45.80","13.82"
"67","000","00","120","0025","0000","723","217","506","2","725","1786","0","40.59","12.15"
"67","000","00","120","0025","0374","373","105","268","1","374","856","0","43.69","12.27"
"67","000","00","120","0025","0375","350","112","238","1","351","930","0","37.74","12.04"
"67","000","00","120","0026","0000","1055","261","794","14","1069","2729","0","39.17","9.56"
"67","000","00","120","0026","0376","437","112","325","5","442","1006","0","43.94","11.13"
"67","000","00","120","0026","0377","319","86","233","5","324","944","0","34.32","9.11"
"67","000","00","120","0026","0378","299","63","236","4","303","779","0","38.90","8.09"
"67","000","00","120","0027","0000","1692","543","1149","9","1701","4415","0","38.53","12.30"
"67","000","00","120","0027","0359","381","141","240","2","383","1070","0","35.79","13.18"
"67","000","00","120","0027","0360","404","102","302","3","407","1131","0","35.99","9.02"
"67","000","00","120","0027","0361","361","120","241","2","363","942","0","38.54","12.74"
"67","000","00","120","0027","0362","546","180","366","2","548","1272","0","43.08","14.15"
"67","000","00","130","0000","0000","8639","2573","6066","93","8732","22220","25121","39.30","11.58"
"67","000","00","130","0001","0000","1584","490","1094","14","1598","3771","0","42.38","12.99"
"67","000","00","130","0001","0088","422","124","298","5","427","953","0","44.81","13.01"
"67","000","00","130","0001","0089","466","151","315","1","467","1083","0","43.12","13.94"
"67","000","00","130","0001","0090","376","100","276","3","379","886","0","42.78","11.29"
"67","000","00","130","0001","0091","320","115","205","5","325","849","0","38.28","13.55"
"67","000","00","130","0002","0000","883","257","626","7","890","2308","0","38.56","11.14"
"67","000","00","130","0002","0095","395","97","298","4","399","1064","0","37.50","9.12"
"67","000","00","130","0002","0096","488","160","328","3","491","1244","0","39.47","12.86"
"67","000","00","130","0003","0000","457","115","342","2","459","1207","0","38.03","9.53"
"67","000","00","130","0003","0101","306","71","235","2","308","821","0","37.52","8.65"
"67","000","00","130","0003","0102","151","44","107","0","151","386","0","39.12","11.40"
"67","000","00","130","0004","0000","283","94","189","4","287","771","0","37.22","12.19"
"67","000","00","130","0004","0103","283","94","189","4","287","771","0","37.22","12.19"
"67","000","00","130","0005","0000","776","284","492","6","782","1967","0","39.76","14.44"
"67","000","00","130","0005","0085","280","111","169","3","283","625","0","45.28","17.76"
"67","000","00","130","0005","0086","319","103","216","2","321","924","0","34.74","11.15"
"67","000","00","130","0005","0087","177","70","107","1","178","418","0","42.58","16.75"
"67","000","00","130","0006","0000","953","284","669","13","966","2463","0","39.22","11.53"
"67","000","00","130","0006","0080","310","102","208","3","313","848","0","36.91","12.03"
"67","000","00","130","0006","0081","250","67","183","3","253","663","0","38.16","10.11"
"67","000","00","130","0006","0082","393","115","278","7","400","952","0","42.02","12.08"
"67","000","00","130","0007","0000","775","202","573","9","784","1887","0","41.55","10.70"
"67","000","00","130","0007","0083","417","93","324","4","421","1058","0","39.79","8.79"
"67","000","00","130","0007","0084","358","109","249","5","363","829","0","43.79","13.15"
"67","000","00","130","0008","0000","447","112","335","4","451","1175","0","38.38","9.53"
"67","000","00","130","0008","0098","447","112","335","4","451","1175","0","38.38","9.53"
"67","000","00","130","0009","0000","372","69","303","5","377","1001","0","37.66","6.89"
"67","000","00","130","0009","0104","372","69","303","5","377","1001","0","37.66","6.89"
"67","000","00","130","0010","0000","787","269","518","10","797","2054","0","38.80","13.10"
"67","000","00","130","0010","0092","298","121","177","4","302","712","0","42.42","16.99"
"67","000","00","130","0010","0093","263","95","168","3","266","743","0","35.80","12.79"
"67","000","00","130","0010","0094","226","53","173","3","229","599","0","38.23","8.85"
"67","000","00","130","0011","0000","379","110","269","6","385","939","0","41.00","11.71"
"67","000","00","130","0011","0097","379","110","269","6","385","939","0","41.00","11.71"
"67","000","00","130","0012","0000","474","147","327","9","483","1310","0","36.87","11.22"
"67","000","00","130","0012","0105","199","61","138","5","204","578","0","35.29","10.55"
"67","000","00","130","0012","0106","137","47","90","1","138","405","0","34.07","11.60"
"67","000","00","130","0012","0107","138","39","99","3","141","327","0","43.12","11.93"
"67","000","00","130","0013","0000","469","140","329","4","473","1367","0","34.60","10.24"
"67","000","00","130","0013","0099","281","83","198","1","282","808","0","34.90","10.27"
"67","000","00","130","0013","0100","188","57","131","3","191","559","0","34.17","10.20"
"67","000","00","140","0000","0000","8083","2281","5802","94","8177","21470","24521","38.09","10.62"
"67","000","00","140","0001","0000","1235","381","854","20","1255","3112","0","40.33","12.24"
"67","000","00","140","0001","0516","386","135","251","7","393","920","0","42.72","14.67"
"67","000","00","140","0001","0517","400","110","290","6","406","884","0","45.93","12.44"
"67","000","00","140","0001","0518","449","136","313","7","456","1308","0","34.86","10.40"
"67","000","00","140","0002","0000","979","245","734","12","991","2413","0","41.07","10.15"
"67","000","00","140","0002","0522","691","193","498","7","698","1682","0","41.50","11.47"
"67","000","00","140","0002","0523","288","52","236","5","293","731","0","40.08","7.11"
"67","000","00","140","0003","0000","601","164","437","2","603","1625","0","37.11","10.09"
"67","000","00","140","0003","0524","442","141","301","0","442","1217","0","36.32","11.59"
"67","000","00","140","0003","0525","159","23","136","2","161","408","0","39.46","5.64"
"67","000","00","140","0004","0000","544","141","403","6","550","1640","0","33.54","8.60"
"67","000","00","140","0004","0526","297","73","224","4","301","778","0","38.69","9.38"
"67","000","00","140","0004","0527","247","68","179","2","249","862","0","28.89","7.89"
"67","000","00","140","0005","0000","498","113","385","9","507","1436","0","35.31","7.87"
"67","000","00","140","0005","0528","498","113","385","9","507","1436","0","35.31","7.87"
"67","000","00","140","0006","0000","473","127","346","3","476","1456","0","32.69","8.72"
"67","000","00","140","0006","0529","473","127","346","3","476","1456","0","32.69","8.72"
"67","000","00","140","0007","0000","313","86","227","6","319","758","0","42.08","11.35"
"67","000","00","140","0007","0530","313","86","227","6","319","758","0","42.08","11.35"
"67","000","00","140","0008","0000","493","146","347","8","501","1338","0","37.44","10.91"
"67","000","00","140","0008","0531","493","146","347","8","501","1338","0","37.44","10.91"
"67","000","00","140","0009","0000","556","128","428","5","561","1342","0","41.80","9.54"
"67","000","00","140","0009","0532","556","128","428","5","561","1342","0","41.80","9.54"
"67","000","00","140","0010","0000","539","129","410","4","543","1352","0","40.16","9.54"
"67","000","00","140","0010","0533","340","83","257","3","343","961","0","35.69","8.64"
"67","000","00","140","0010","0534","199","46","153","1","200","391","0","51.15","11.76"
"67","000","00","140","0011","0000","279","114","165","7","286","805","0","35.53","14.16"
"67","000","00","140","0011","0535","279","114","165","7","286","805","0","35.53","14.16"
"67","000","00","140","0012","0000","1573","507","1066","12","1585","4193","0","37.80","12.09"
"67","000","00","140","0012","0519","486","169","317","4","490","1354","0","36.19","12.48"
"67","000","00","140","0012","0520","565","184","381","3","568","1294","0","43.89","14.22"
"67","000","00","140","0012","0521","522","154","368","5","527","1545","0","34.11","9.97"
"67","000","00","150","0000","0000","7061","1922","5139","82","7143","19595","21996","36.45","9.81"
"67","000","00","150","0001","0000","392","104","288","1","393","998","0","39.38","10.42"
"67","000","00","150","0001","0312","188","56","132","1","189","518","0","36.49","10.81"
"67","000","00","150","0001","0313","204","48","156","0","204","480","0","42.50","10.00"
"67","000","00","150","0002","0000","232","54","178","4","236","648","0","36.42","8.33"
"67","000","00","150","0002","0314","232","54","178","4","236","648","0","36.42","8.33"
"67","000","00","150","0004","0000","307","95","212","1","308","820","0","37.56","11.59"
"67","000","00","150","0004","0315","307","95","212","1","308","820","0","37.56","11.59"
"67","000","00","150","0005","0000","308","96","212","3","311","809","0","38.44","11.87"
"67","000","00","150","0005","0316","308","96","212","3","311","809","0","38.44","11.87"
"67","000","00","150","0006","0000","164","43","121","1","165","444","0","37.16","9.68"
"67","000","00","150","0006","0317","164","43","121","1","165","444","0","37.16","9.68"
"67","000","00","150","0007","0000","155","31","124","0","155","410","0","37.80","7.56"
"67","000","00","150","0007","0318","155","31","124","0","155","410","0","37.80","7.56"
"67","000","00","150","0008","0000","611","132","479","5","616","1608","0","38.31","8.21"
"67","000","00","150","0008","0320","316","79","237","4","320","832","0","38.46","9.50"
"67","000","00","150","0008","0321","295","53","242","1","296","776","0","38.14","6.83"
"67","000","00","150","0009","0000","128","50","78","1","129","343","0","37.61","14.58"
"67","000","00","150","0009","0322","128","50","78","1","129","343","0","37.61","14.58"
"67","000","00","150","0010","0000","342","80","262","5","347","861","0","40.30","9.29"
"67","000","00","150","0010","0323","342","80","262","5","347","861","0","40.30","9.29"
"67","000","00","150","0011","0000","276","82","194","5","281","775","0","36.26","10.58"
"67","000","00","150","0011","0324","276","82","194","5","281","775","0","36.26","10.58"
"67","000","00","150","0012","0000","882","224","658","10","892","2548","0","35.01","8.79"
"67","000","00","150","0012","0325","268","79","189","5","273","856","0","31.89","9.23"
"67","000","00","150","0012","0326","287","69","218","2","289","811","0","35.64","8.51"
"67","000","00","150","0012","0327","327","76","251","3","330","881","0","37.46","8.63"
"67","000","00","150","0015","0000","624","141","483","11","635","1894","0","33.53","7.44"
"67","000","00","150","0015","0328","394","85","309","3","397","1185","0","33.50","7.17"
"67","000","00","150","0015","0329","230","56","174","8","238","709","0","33.57","7.90"
"67","000","00","150","0017","0000","235","61","174","4","239","683","0","34.99","8.93"
"67","000","00","150","0017","0319","235","61","174","4","239","683","0","34.99","8.93"
"67","000","00","150","0018","0000","480","142","338","10","490","1214","0","40.36","11.70"
"67","000","00","150","0018","0330","237","69","168","6","243","605","0","40.17","11.40"
"67","000","00","150","0018","0331","243","73","170","4","247","609","0","40.56","11.99"
"67","000","00","150","0019","0000","707","196","511","10","717","1858","0","38.59","10.55"
"67","000","00","150","0019","0332","425","132","293","6","431","1170","0","36.84","11.28"
"67","000","00","150","0019","0333","282","64","218","4","286","688","0","41.57","9.30"
"67","000","00","150","0021","0000","344","120","224","4","348","992","0","35.08","12.10"
"67","000","00","150","0021","0334","344","120","224","4","348","992","0","35.08","12.10"
"67","000","00","150","0022","0000","444","120","324","2","446","1329","0","33.56","9.03"
"67","000","00","150","0022","0335","444","120","324","2","446","1329","0","33.56","9.03"
"67","000","00","150","0023","0000","430","151","279","5","435","1361","0","31.96","11.09"
"67","000","00","150","0023","0336","430","151","279","5","435","1361","0","31.96","11.09"
"67","000","00","160","0000","0000","6202","1582","4620","88","6290","17313","18966","36.33","9.14"
"67","000","00","160","0001","0000","435","129","306","4","439","1136","0","38.64","11.36"
"67","000","00","160","0001","0246","435","129","306","4","439","1136","0","38.64","11.36"
"67","000","00","160","0013","0000","261","51","210","2","263","821","0","32.03","6.21"
"67","000","00","160","0013","0262","261","51","210","2","263","821","0","32.03","6.21"
"67","000","00","160","0014","0000","183","65","118","4","187","636","0","29.40","10.22"
"67","000","00","160","0014","0263","183","65","118","4","187","636","0","29.40","10.22"
"67","000","00","160","0015","0000","447","107","340","7","454","1312","0","34.60","8.16"
"67","000","00","160","0015","0264","264","62","202","3","267","673","0","39.67","9.21"
"67","000","00","160","0015","0265","183","45","138","4","187","639","0","29.26","7.04"
"67","000","00","160","0016","0000","424","87","337","11","435","1171","0","37.15","7.43"
"67","000","00","160","0016","0266","424","87","337","11","435","1171","0","37.15","7.43"
"67","000","00","160","0017","0000","653","131","522","9","662","1862","0","35.55","7.04"
"67","000","00","160","0017","0267","235","42","193","4","239","800","0","29.88","5.25"
"67","000","00","160","0017","0268","418","89","329","5","423","1062","0","39.83","8.38"
"67","000","00","160","0018","0000","268","56","212","10","278","946","0","29.39","5.92"
"67","000","00","160","0018","0269","268","56","212","10","278","946","0","29.39","5.92"
"67","000","00","160","0019","0000","470","107","363","3","473","1166","0","40.57","9.18"
"67","000","00","160","0019","0257","261","58","203","2","263","614","0","42.83","9.45"
"67","000","00","160","0019","0258","209","49","160","1","210","552","0","38.04","8.88"
"67","000","00","160","0020","0000","914","255","659","6","920","2358","0","39.02","10.81"
"67","000","00","160","0020","0247","561","160","401","3","564","1453","0","38.82","11.01"
"67","000","00","160","0020","0248","353","95","258","3","356","905","0","39.34","10.50"
"67","000","00","160","0021","0000","844","251","593","17","861","2413","0","35.68","10.40"
"67","000","00","160","0021","0249","205","74","131","3","208","490","0","42.45","15.10"
"67","000","00","160","0021","0250","348","94","254","5","353","1065","0","33.15","8.83"
"67","000","00","160","0021","0251","165","43","122","9","174","516","0","33.72","8.33"
"67","000","00","160","0021","0252","126","40","86","0","126","342","0","36.84","11.70"
"67","000","00","160","0022","0000","757","195","562","11","768","1964","0","39.10","9.93"
"67","000","00","160","0022","0253","202","64","138","3","205","556","0","36.87","11.51"
"67","000","00","160","0022","0254","159","28","131","2","161","395","0","40.76","7.09"
"67","000","00","160","0022","0255","216","53","163","4","220","560","0","39.29","9.46"
"67","000","00","160","0022","0256","180","50","130","2","182","453","0","40.18","11.04"
"67","000","00","160","0023","0000","546","148","398","4","550","1528","0","35.99","9.69"
"67","000","00","160","0023","0259","193","48","145","2","195","569","0","34.27","8.44"
"67","000","00","160","0023","0260","197","55","142","1","198","543","0","36.46","10.13"
"67","000","00","160","0023","0261","156","45","111","1","157","416","0","37.74","10.82"
"67","000","00","170","0000","0000","3027","1012","2015","39","3066","9549","10460","32.11","10.60"
"67","000","00","170","0001","0000","386","134","252","3","389","1309","0","29.72","10.24"
"67","000","00","170","0001","0068","216","66","150","2","218","711","0","30.66","9.28"
"67","000","00","170","0001","0069","170","68","102","1","171","598","0","28.60","11.37"
"67","000","00","170","0002","0000","146","54","92","3","149","451","0","33.04","11.97"
"67","000","00","170","0002","0073","146","54","92","3","149","451","0","33.04","11.97"
"67","000","00","170","0005","0000","271","103","168","1","272","820","0","33.17","12.56"
"67","000","00","170","0005","0064","167","72","95","1","168","454","0","37.00","15.86"
"67","000","00","170","0005","0065","104","31","73","0","104","366","0","28.42","8.47"
"67","000","00","170","0006","0000","249","93","156","2","251","909","0","27.61","10.23"
"67","000","00","170","0006","0074","249","93","156","2","251","909","0","27.61","10.23"
"67","000","00","170","0007","0000","394","132","262","6","400","1152","0","34.72","11.46"
"67","000","00","170","0007","0076","205","61","144","3","208","647","0","32.15","9.43"
"67","000","00","170","0007","0077","189","71","118","3","192","505","0","38.02","14.06"
"67","000","00","170","0009","0000","242","73","169","5","247","702","0","35.19","10.40"
"67","000","00","170","0009","0066","132","41","91","4","136","344","0","39.53","11.92"
"67","000","00","170","0009","0067","110","32","78","1","111","358","0","31.01","8.94"
"67","000","00","170","0011","0000","199","67","132","2","201","726","0","27.69","9.23"
"67","000","00","170","0011","0075","199","67","132","2","201","726","0","27.69","9.23"
"67","000","00","170","0013","0000","280","102","178","5","285","843","0","33.81","12.10"
"67","000","00","170","0013","0062","162","44","118","2","164","454","0","36.12","9.69"
"67","000","00","170","0013","0063","118","58","60","3","121","389","0","31.11","14.91"
"67","000","00","170","0014","0000","430","143","287","2","432","1415","0","30.53","10.11"
"67","000","00","170","0014","0070","156","52","104","0","156","567","0","27.51","9.17"
"67","000","00","170","0014","0071","177","73","104","1","178","539","0","33.02","13.54"
"67","000","00","170","0014","0072","97","18","79","1","98","309","0","31.72","5.83"
"67","000","00","170","0015","0000","430","111","319","10","440","1222","0","36.01","9.08"
"67","000","00","170","0015","0078","201","46","155","5","206","606","0","33.99","7.59"
"67","000","00","170","0015","0079","229","65","164","5","234","616","0","37.99","10.55"
"67","000","00","180","0000","0000","14717","5674","9043","146","14863","37315","43049","39.83","15.21"
"67","000","00","180","0001","0000","1352","583","769","11","1363","3038","0","44.87","19.19"
"67","000","00","180","0001","1020","332","171","161","2","334","722","0","46.26","23.68"
"67","000","00","180","0001","1021","467","192","275","2","469","1094","0","42.87","17.55"
"67","000","00","180","0001","1022","173","68","105","2","175","334","0","52.40","20.36"
"67","000","00","180","0001","1023","380","152","228","5","385","888","0","43.36","17.12"
"67","000","00","180","0002","0000","1581","649","932","13","1594","3973","0","40.12","16.34"
"67","000","00","180","0002","1024","482","215","267","7","489","1178","0","41.51","18.25"
"67","000","00","180","0002","1025","332","107","225","0","332","822","0","40.39","13.02"
"67","000","00","180","0002","1026","358","145","213","2","360","921","0","39.09","15.74"
"67","000","00","180","0002","1027","409","182","227","4","413","1052","0","39.26","17.30"
"67","000","00","180","0003","0000","1078","444","634","10","1088","2724","0","39.94","16.30"
"67","000","00","180","0003","1028","409","154","255","5","414","912","0","45.39","16.89"
"67","000","00","180","0003","1029","320","155","165","2","322","810","0","39.75","19.14"
"67","000","00","180","0003","1030","349","135","214","3","352","1002","0","35.13","13.47"
"67","000","00","180","0004","0000","1834","695","1139","15","1849","4411","0","41.92","15.76"
"67","000","00","180","0004","1031","566","221","345","9","575","1338","0","42.97","16.52"
"67","000","00","180","0004","1032","404","160","244","1","405","1025","0","39.51","15.61"
"67","000","00","180","0004","1033","490","182","308","4","494","1256","0","39.33","14.49"
"67","000","00","180","0004","1034","374","132","242","1","375","792","0","47.35","16.67"
"67","000","00","180","0009","0000","1287","503","784","13","1300","3203","0","40.59","15.70"
"67","000","00","180","0009","1035","380","127","253","6","386","984","0","39.23","12.91"
"67","000","00","180","0009","1036","386","169","217","3","389","991","0","39.25","17.05"
"67","000","00","180","0009","1037","521","207","314","4","525","1228","0","42.75","16.86"
"67","000","00","180","0010","0000","850","304","546","10","860","2153","0","39.94","14.12"
"67","000","00","180","0010","1038","476","201","275","4","480","1160","0","41.38","17.33"
"67","000","00","180","0010","1039","374","103","271","6","380","993","0","38.27","10.37"
"67","000","00","180","0011","0000","563","210","353","3","566","1482","0","38.19","14.17"
"67","000","00","180","0011","1040","563","210","353","3","566","1482","0","38.19","14.17"
"67","000","00","180","0012","0000","1200","498","702","19","1219","3226","0","37.79","15.44"
"67","000","00","180","0012","1041","453","183","270","7","460","1224","0","37.58","14.95"
"67","000","00","180","0012","1042","436","198","238","5","441","1245","0","35.42","15.90"
"67","000","00","180","0012","1043","311","117","194","7","318","757","0","42.01","15.46"
"67","000","00","180","0013","0000","1090","489","601","15","1105","2804","0","39.41","17.44"
"67","000","00","180","0013","1044","464","183","281","6","470","1366","0","34.41","13.40"
"67","000","00","180","0013","1045","626","306","320","9","635","1438","0","44.16","21.28"
"67","000","00","180","0014","0000","847","270","577","11","858","2123","0","40.41","12.72"
"67","000","00","180","0014","1046","389","124","265","6","395","1011","0","39.07","12.27"
"67","000","00","180","0014","1047","458","146","312","5","463","1112","0","41.64","13.13"
"67","000","00","180","0015","0000","835","298","537","7","842","2155","0","39.07","13.83"
"67","000","00","180","0015","1048","475","164","311","6","481","1177","0","40.87","13.93"
"67","000","00","180","0015","1049","360","134","226","1","361","978","0","36.91","13.70"
"67","000","00","180","0016","0000","567","192","375","4","571","1679","0","34.01","11.44"
"67","000","00","180","0016","1050","337","105","232","4","341","962","0","35.45","10.91"
"67","000","00","180","0016","1051","230","87","143","0","230","717","0","32.08","12.13"
"67","000","00","180","0017","0000","161","36","125","1","162","425","0","38.12","8.47"
"67","000","00","180","0017","1052","161","36","125","1","162","425","0","38.12","8.47"
"67","000","00","180","0018","0000","738","296","442","7","745","2087","0","35.70","14.18"
"67","000","00","180","0018","1053","358","143","215","1","359","1051","0","34.16","13.61"
"67","000","00","180","0018","1054","380","153","227","6","386","1036","0","37.26","14.77"
"67","000","00","180","0019","0000","355","136","219","2","357","899","0","39.71","15.13"
"67","000","00","180","0019","1055","355","136","219","2","357","899","0","39.71","15.13"
"67","000","00","180","0020","0000","379","71","308","5","384","933","0","41.16","7.61"
"67","000","00","180","0020","1056","379","71","308","5","384","933","0","41.16","7.61"
"67","000","00","190","0000","0000","16668","5726","10942","184","16852","41406","51052","40.70","13.83"
"67","000","00","190","0001","0000","436","179","257","8","444","1123","0","39.54","15.94"
"67","000","00","190","0001","0447","436","179","257","8","444","1123","0","39.54","15.94"
"67","000","00","190","0002","0000","1559","638","921","16","1575","3901","0","40.37","16.35"
"67","000","00","190","0002","0448","606","282","324","5","611","1398","0","43.71","20.17"
"67","000","00","190","0002","0449","496","191","305","4","500","1169","0","42.77","16.34"
"67","000","00","190","0002","0450","457","165","292","7","464","1334","0","34.78","12.37"
"67","000","00","190","0003","0000","2203","881","1322","26","2229","5414","0","41.17","16.27"
"67","000","00","190","0003","0451","572","222","350","2","574","1342","0","42.77","16.54"
"67","000","00","190","0003","0452","592","229","363","9","601","1363","0","44.09","16.80"
"67","000","00","190","0003","0453","579","242","337","9","588","1496","0","39.30","16.18"
"67","000","00","190","0003","0454","460","188","272","6","466","1213","0","38.42","15.50"
"67","000","00","190","0004","0000","1017","370","647","5","1022","2685","0","38.06","13.78"
"67","000","00","190","0004","0455","585","217","368","3","588","1531","0","38.41","14.17"
"67","000","00","190","0004","0456","432","153","279","2","434","1154","0","37.61","13.26"
"67","000","00","190","0005","0000","732","236","496","8","740","1791","0","41.32","13.18"
"67","000","00","190","0005","0457","376","118","258","5","381","946","0","40.27","12.47"
"67","000","00","190","0005","0458","356","118","238","3","359","845","0","42.49","13.96"
"67","000","00","190","0008","0000","631","204","427","1","632","1601","0","39.48","12.74"
"67","000","00","190","0008","0460","631","204","427","1","632","1601","0","39.48","12.74"
"67","000","00","190","0009","0000","530","102","428","7","537","1235","0","43.48","8.26"
"67","000","00","190","0009","0461","530","102","428","7","537","1235","0","43.48","8.26"
"67","000","00","190","0010","0000","839","257","582","12","851","2010","0","42.34","12.79"
"67","000","00","190","0010","0462","448","125","323","6","454","1063","0","42.71","11.76"
"67","000","00","190","0010","0463","391","132","259","6","397","947","0","41.92","13.94"
"67","000","00","190","0011","0000","497","145","352","1","498","1226","0","40.62","11.83"
"67","000","00","190","0011","0464","497","145","352","1","498","1226","0","40.62","11.83"
"67","000","00","190","0012","0000","840","292","548","9","849","1944","0","43.67","15.02"
"67","000","00","190","0012","0465","438","151","287","4","442","1018","0","43.42","14.83"
"67","000","00","190","0012","0466","402","141","261","5","407","926","0","43.95","15.23"
"67","000","00","190","0013","0000","285","70","215","1","286","677","0","42.25","10.34"
"67","000","00","190","0013","0467","285","70","215","1","286","677","0","42.25","10.34"
"67","000","00","190","0014","0000","392","96","296","5","397","1041","0","38.14","9.22"
"67","000","00","190","0014","0468","392","96","296","5","397","1041","0","38.14","9.22"
"67","000","00","190","0015","0000","672","198","474","8","680","1684","0","40.38","11.76"
"67","000","00","190","0015","0469","672","198","474","8","680","1684","0","40.38","11.76"
"67","000","00","190","0018","0000","678","229","449","12","690","1608","0","42.91","14.24"
"67","000","00","190","0018","0472","678","229","449","12","690","1608","0","42.91","14.24"
"67","000","00","190","0019","0000","637","185","452","10","647","1587","0","40.77","11.66"
"67","000","00","190","0019","0473","637","185","452","10","647","1587","0","40.77","11.66"
"67","000","00","190","0020","0000","428","115","313","2","430","1068","0","40.26","10.77"
"67","000","00","190","0020","0474","428","115","313","2","430","1068","0","40.26","10.77"
"67","000","00","190","0021","0000","1673","605","1068","22","1695","4425","0","38.31","13.67"
"67","000","00","190","0021","0475","588","185","403","7","595","1414","0","42.08","13.08"
"67","000","00","190","0021","0476","554","208","346","7","561","1410","0","39.79","14.75"
"67","000","00","190","0021","0477","531","212","319","8","539","1601","0","33.67","13.24"
"67","000","00","190","0022","0000","483","193","290","1","484","1117","0","43.33","17.28"
"67","000","00","190","0022","0459","483","193","290","1","484","1117","0","43.33","17.28"
"67","000","00","190","0023","0000","774","234","540","16","790","1945","0","40.62","12.03"
"67","000","00","190","0023","0470","450","130","320","4","454","1083","0","41.92","12.00"
"67","000","00","190","0023","0471","324","104","220","12","336","862","0","38.98","12.06"
"67","000","00","190","0024","0000","1362","497","865","14","1376","3324","0","41.40","14.95"
"67","000","00","190","0024","0478","739","285","454","11","750","1824","0","41.12","15.63"
"67","000","00","190","0024","0479","623","212","411","3","626","1500","0","41.73","14.13"
"67","000","00","200","0000","0000","12202","4227","7975","105","12307","31369","37721","39.23","13.48"
"67","000","00","200","0001","0000","1141","425","716","12","1153","2990","0","38.56","14.21"
"67","000","00","200","0001","0829","359","136","223","1","360","964","0","37.34","14.11"
"67","000","00","200","0001","0830","456","163","293","6","462","1090","0","42.39","14.95"
"67","000","00","200","0001","0831","326","126","200","5","331","936","0","35.36","13.46"
"67","000","00","200","0002","0000","2654","990","1664","23","2677","6488","0","41.26","15.26"
"67","000","00","200","0002","0832","513","176","337","6","519","1253","0","41.42","14.05"
"67","000","00","200","0002","0833","542","202","340","3","545","1258","0","43.32","16.06"
"67","000","00","200","0002","0834","430","183","247","3","433","1056","0","41.00","17.33"
"67","000","00","200","0002","0835","446","170","276","4","450","1082","0","41.59","15.71"
"67","000","00","200","0002","0836","424","157","267","4","428","976","0","43.85","16.09"
"67","000","00","200","0002","0837","299","102","197","3","302","863","0","34.99","11.82"
"67","000","00","200","0003","0000","1113","334","779","7","1120","2768","0","40.46","12.07"
"67","000","00","200","0003","0838","391","117","274","4","395","932","0","42.38","12.55"
"67","000","00","200","0003","0839","401","144","257","2","403","1038","0","38.82","13.87"
"67","000","00","200","0003","0840","321","73","248","1","322","798","0","40.35","9.15"
"67","000","00","200","0004","0000","313","93","220","5","318","714","0","44.54","13.03"
"67","000","00","200","0004","0841","313","93","220","5","318","714","0","44.54","13.03"
"67","000","00","200","0005","0000","318","94","224","2","320","870","0","36.78","10.80"
"67","000","00","200","0005","0842","318","94","224","2","320","870","0","36.78","10.80"
"67","000","00","200","0006","0000","607","205","402","6","613","1563","0","39.22","13.12"
"67","000","00","200","0006","0843","338","104","234","5","343","910","0","37.69","11.43"
"67","000","00","200","0006","0844","269","101","168","1","270","653","0","41.35","15.47"
"67","000","00","200","0007","0000","1250","489","761","10","1260","3380","0","37.28","14.47"
"67","000","00","200","0007","0845","386","176","210","6","392","1124","0","34.88","15.66"
"67","000","00","200","0007","0846","446","171","275","1","447","1131","0","39.52","15.12"
"67","000","00","200","0007","0847","418","142","276","3","421","1125","0","37.42","12.62"
"67","000","00","200","0008","0000","1727","519","1208","13","1740","4530","0","38.41","11.46"
"67","000","00","200","0008","0848","446","161","285","5","451","1195","0","37.74","13.47"
"67","000","00","200","0008","0849","369","110","259","3","372","1048","0","35.50","10.50"
"67","000","00","200","0008","0850","474","140","334","3","477","1237","0","38.56","11.32"
"67","000","00","200","0008","0851","438","108","330","2","440","1050","0","41.90","10.29"
"67","000","00","200","0009","0000","678","201","477","4","682","1790","0","38.10","11.23"
"67","000","00","200","0009","0852","325","98","227","2","327","866","0","37.76","11.32"
"67","000","00","200","0009","0853","353","103","250","2","355","924","0","38.42","11.15"
"67","000","00","200","0010","0000","1165","402","763","15","1180","3330","0","35.44","12.07"
"67","000","00","200","0010","0854","294","138","156","4","298","913","0","32.64","15.12"
"67","000","00","200","0010","0855","436","115","321","2","438","1239","0","35.35","9.28"
"67","000","00","200","0010","0856","435","149","286","9","444","1178","0","37.69","12.65"
"67","000","00","200","0011","0000","1236","475","761","8","1244","2946","0","42.23","16.12"
"67","000","00","200","0011","0857","298","112","186","4","302","700","0","43.14","16.00"
"67","000","00","200","0011","0858","424","153","271","3","427","1056","0","40.44","14.49"
"67","000","00","200","0011","0859","514","210","304","1","515","1190","0","43.28","17.65"
"67","000","00","210","0000","0000","10654","3308","7346","115","10769","26163","30286","41.16","12.64"
"67","000","00","210","0001","0000","907","247","660","17","924","2065","0","44.75","11.96"
"67","000","00","210","0001","0536","546","157","389","8","554","1207","0","45.90","13.01"
"67","000","00","210","0001","0537","361","90","271","9","370","858","0","43.12","10.49"
"67","000","00","210","0002","0000","775","258","517","10","785","2038","0","38.52","12.66"
"67","000","00","210","0002","0538","420","149","271","5","425","1143","0","37.18","13.04"
"67","000","00","210","0002","0539","355","109","246","5","360","895","0","40.22","12.18"
"67","000","00","210","0003","0000","568","175","393","2","570","1381","0","41.27","12.67"
"67","000","00","210","0003","0540","252","83","169","1","253","653","0","38.74","12.71"
"67","000","00","210","0003","0541","316","92","224","1","317","728","0","43.54","12.64"
"67","000","00","210","0004","0000","892","281","611","10","902","2194","0","41.11","12.81"
"67","000","00","210","0004","0542","444","122","322","5","449","1112","0","40.38","10.97"
"67","000","00","210","0004","0543","448","159","289","5","453","1082","0","41.87","14.70"
"67","000","00","210","0006","0000","588","193","395","4","592","1485","0","39.87","13.00"
"67","000","00","210","0006","0544","276","76","200","3","279","726","0","38.43","10.47"
"67","000","00","210","0006","0545","312","117","195","1","313","759","0","41.24","15.42"
"67","000","00","210","0007","0000","715","228","487","10","725","1715","0","42.27","13.29"
"67","000","00","210","0007","0546","343","114","229","3","346","823","0","42.04","13.85"
"67","000","00","210","0007","0547","372","114","258","7","379","892","0","42.49","12.78"
"67","000","00","210","0008","0000","1189","412","777","12","1201","2901","0","41.40","14.20"
"67","000","00","210","0008","0548","483","191","292","6","489","1122","0","43.58","17.02"
"67","000","00","210","0008","0549","416","124","292","5","421","977","0","43.09","12.69"
"67","000","00","210","0008","0550","290","97","193","1","291","802","0","36.28","12.09"
"67","000","00","210","0009","0000","1094","328","766","8","1102","2658","0","41.46","12.34"
"67","000","00","210","0009","0551","530","137","393","5","535","1348","0","39.69","10.16"
"67","000","00","210","0009","0552","564","191","373","3","567","1310","0","43.28","14.58"
"67","000","00","210","0012","0000","315","96","219","2","317","715","0","44.34","13.43"
"67","000","00","210","0012","0555","315","96","219","2","317","715","0","44.34","13.43"
"67","000","00","210","0013","0000","978","276","702","6","984","2448","0","40.20","11.27"
"67","000","00","210","0013","0556","478","142","336","3","481","1260","0","38.17","11.27"
"67","000","00","210","0013","0557","500","134","366","3","503","1188","0","42.34","11.28"
"67","000","00","210","0014","0000","1032","332","700","14","1046","2574","0","40.64","12.90"
"67","000","00","210","0014","0558","510","146","364","6","516","1180","0","43.73","12.37"
"67","000","00","210","0014","0559","522","186","336","8","530","1394","0","38.02","13.34"
"67","000","00","210","0017","0000","679","191","488","5","684","1609","0","42.51","11.87"
"67","000","00","210","0017","0560","403","107","296","4","407","998","0","40.78","10.72"
"67","000","00","210","0017","0561","276","84","192","1","277","611","0","45.34","13.75"
"67","000","00","210","0018","0000","922","291","631","15","937","2380","0","39.37","12.23"
"67","000","00","210","0018","0553","485","136","349","7","492","1168","0","42.12","11.64"
"67","000","00","210","0018","0554","437","155","282","8","445","1212","0","36.72","12.79"
"67","000","00","220","0000","0000","2307","837","1470","41","2348","6378","7053","36.81","13.12"
"67","000","00","220","0001","0000","572","215","357","8","580","1662","0","34.90","12.94"
"67","000","00","220","0001","0562","284","111","173","5","289","848","0","34.08","13.09"
"67","000","00","220","0001","0563","288","104","184","3","291","814","0","35.75","12.78"
"67","000","00","220","0002","0000","640","221","419","11","651","1522","0","42.77","14.52"
"67","000","00","220","0002","0564","320","112","208","5","325","740","0","43.92","15.14"
"67","000","00","220","0002","0565","320","109","211","6","326","782","0","41.69","13.94"
"67","000","00","220","0003","0000","338","132","206","9","347","961","0","36.11","13.74"
"67","000","00","220","0003","0566","338","132","206","9","347","961","0","36.11","13.74"
"67","000","00","220","0004","0000","302","92","210","5","307","930","0","33.01","9.89"
"67","000","00","220","0004","0567","302","92","210","5","307","930","0","33.01","9.89"
"67","000","00","220","0005","0000","197","70","127","2","199","560","0","35.54","12.50"
"67","000","00","220","0005","0568","197","70","127","2","199","560","0","35.54","12.50"
"67","000","00","220","0006","0000","137","68","69","1","138","351","0","39.32","19.37"
"67","000","00","220","0006","0569","137","68","69","1","138","351","0","39.32","19.37"
"67","000","00","220","0007","0000","121","39","82","5","126","392","0","32.14","9.95"
"67","000","00","220","0007","0570","121","39","82","5","126","392","0","32.14","9.95"
"67","000","00","230","0000","0000","4353","2032","2321","67","4420","12025","13483","36.76","16.90"
"67","000","00","230","0001","0000","449","236","213","5","454","1202","0","37.77","19.63"
"67","000","00","230","0001","0491","449","236","213","5","454","1202","0","37.77","19.63"
"67","000","00","230","0002","0000","1266","648","618","14","1280","3556","0","36.00","18.22"
"67","000","00","230","0002","0492","340","194","146","3","343","960","0","35.73","20.21"
"67","000","00","230","0002","0493","288","138","150","5","293","811","0","36.13","17.02"
"67","000","00","230","0002","0494","283","136","147","0","283","822","0","34.43","16.55"
"67","000","00","230","0002","0495","355","180","175","6","361","963","0","37.49","18.69"
"67","000","00","230","0003","0000","485","213","272","6","491","1198","0","40.98","17.78"
"67","000","00","230","0003","0496","228","105","123","1","229","590","0","38.81","17.80"
"67","000","00","230","0003","0497","257","108","149","5","262","608","0","43.09","17.76"
"67","000","00","230","0004","0000","479","225","254","7","486","1398","0","34.76","16.09"
"67","000","00","230","0004","0498","310","143","167","6","316","899","0","35.15","15.91"
"67","000","00","230","0004","0499","169","82","87","1","170","499","0","34.07","16.43"
"67","000","00","230","0005","0000","195","92","103","9","204","497","0","41.05","18.51"
"67","000","00","230","0005","0500","195","92","103","9","204","497","0","41.05","18.51"
"67","000","00","230","0006","0000","175","56","119","2","177","490","0","36.12","11.43"
"67","000","00","230","0006","0501","175","56","119","2","177","490","0","36.12","11.43"
"67","000","00","230","0007","0000","290","115","175","5","295","731","0","40.36","15.73"
"67","000","00","230","0007","0502","290","115","175","5","295","731","0","40.36","15.73"
"67","000","00","230","0008","0000","494","232","262","7","501","1428","0","35.08","16.25"
"67","000","00","230","0008","0503","267","149","118","6","273","651","0","41.94","22.89"
"67","000","00","230","0008","0504","227","83","144","1","228","777","0","29.34","10.68"
"67","000","00","230","0009","0000","204","79","125","4","208","580","0","35.86","13.62"
"67","000","00","230","0009","0505","204","79","125","4","208","580","0","35.86","13.62"
"67","000","00","230","0010","0000","316","136","180","8","324","945","0","34.29","14.39"
"67","000","00","230","0010","0506","316","136","180","8","324","945","0","34.29","14.39"
"67","000","00","240","0000","0000","2630","1336","1294","35","2665","8230","9115","32.38","16.23"
"67","000","00","240","0001","0000","585","333","252","9","594","1779","0","33.39","18.72"
"67","000","00","240","0001","0507","315","180","135","5","320","950","0","33.68","18.95"
"67","000","00","240","0001","0508","270","153","117","4","274","829","0","33.05","18.46"
"67","000","00","240","0002","0000","293","134","159","1","294","1071","0","27.45","12.51"
"67","000","00","240","0002","0509","293","134","159","1","294","1071","0","27.45","12.51"
"67","000","00","240","0003","0000","202","100","102","2","204","681","0","29.96","14.68"
"67","000","00","240","0003","0510","202","100","102","2","204","681","0","29.96","14.68"
"67","000","00","240","0004","0000","304","122","182","4","308","951","0","32.39","12.83"
"67","000","00","240","0004","0511","304","122","182","4","308","951","0","32.39","12.83"
"67","000","00","240","0005","0000","311","181","130","6","317","894","0","35.46","20.25"
"67","000","00","240","0005","0512","311","181","130","6","317","894","0","35.46","20.25"
"67","000","00","240","0006","0000","205","95","110","3","208","639","0","32.55","14.87"
"67","000","00","240","0006","0513","205","95","110","3","208","639","0","32.55","14.87"
"67","000","00","240","0007","0000","730","371","359","10","740","2215","0","33.41","16.75"
"67","000","00","240","0007","0514","386","190","196","8","394","1176","0","33.50","16.16"
"67","000","00","240","0007","0515","344","181","163","2","346","1039","0","33.30","17.42"
"67","000","00","250","0000","0000","2293","1071","1222","29","2322","7508","8305","30.93","14.26"
"67","000","00","250","0001","0000","539","233","306","7","546","1343","0","40.66","17.35"
"67","000","00","250","0001","0581","257","121","136","3","260","664","0","39.16","18.22"
"67","000","00","250","0001","0582","282","112","170","4","286","679","0","42.12","16.49"
"67","000","00","250","0002","0000","216","98","118","3","219","764","0","28.66","12.83"
"67","000","00","250","0002","0583","216","98","118","3","219","764","0","28.66","12.83"
"67","000","00","250","0003","0000","118","57","61","1","119","404","0","29.46","14.11"
"67","000","00","250","0003","0586","118","57","61","1","119","404","0","29.46","14.11"
"67","000","00","250","0004","0000","200","78","122","5","205","547","0","37.48","14.26"
"67","000","00","250","0004","0587","200","78","122","5","205","547","0","37.48","14.26"
"67","000","00","250","0005","0000","175","76","99","1","176","620","0","28.39","12.26"
"67","000","00","250","0005","0584","175","76","99","1","176","620","0","28.39","12.26"
"67","000","00","250","0006","0000","211","99","112","0","211","725","0","29.10","13.66"
"67","000","00","250","0006","0585","211","99","112","0","211","725","0","29.10","13.66"
"67","000","00","250","0007","0000","344","178","166","3","347","1130","0","30.71","15.75"
"67","000","00","250","0007","0588","344","178","166","3","347","1130","0","30.71","15.75"
"67","000","00","250","0008","0000","310","150","160","4","314","1027","0","30.57","14.61"
"67","000","00","250","0008","0589","310","150","160","4","314","1027","0","30.57","14.61"
"67","000","00","250","0009","0000","180","102","78","5","185","948","0","19.51","10.76"
"67","000","00","250","0009","0590","180","102","78","5","185","948","0","19.51","10.76"
"67","000","00","260","0000","0000","1493","551","942","29","1522","4192","4475","36.31","13.14"
"67","000","00","260","0001","0000","126","55","71","0","126","359","0","35.10","15.32"
"67","000","00","260","0001","0571","126","55","71","0","126","359","0","35.10","15.32"
"67","000","00","260","0002","0000","228","72","156","3","231","612","0","37.75","11.76"
"67","000","00","260","0002","0572","228","72","156","3","231","612","0","37.75","11.76"
"67","000","00","260","0003","0000","158","51","107","4","162","456","0","35.53","11.18"
"67","000","00","260","0003","0573","158","51","107","4","162","456","0","35.53","11.18"
"67","000","00","260","0004","0000","233","112","121","3","236","717","0","32.91","15.62"
"67","000","00","260","0004","0574","233","112","121","3","236","717","0","32.91","15.62"
"67","000","00","260","0005","0000","117","47","70","4","121","333","0","36.34","14.11"
"67","000","00","260","0005","0575","117","47","70","4","121","333","0","36.34","14.11"
"67","000","00","260","0006","0000","147","72","75","4","151","355","0","42.54","20.28"
"67","000","00","260","0006","0576","147","72","75","4","151","355","0","42.54","20.28"
"67","000","00","260","0007","0000","167","35","132","3","170","488","0","34.84","7.17"
"67","000","00","260","0007","0580","167","35","132","3","170","488","0","34.84","7.17"
"67","000","00","260","0008","0000","137","49","88","0","137","407","0","33.66","12.04"
"67","000","00","260","0008","0577","137","49","88","0","137","407","0","33.66","12.04"
"67","000","00","260","0009","0000","94","36","58","4","98","286","0","34.27","12.59"
"67","000","00","260","0009","0578","94","36","58","4","98","286","0","34.27","12.59"
"67","000","00","260","0010","0000","86","22","64","4","90","179","0","50.28","12.29"
"67","000","00","260","0010","0579","86","22","64","4","90","179","0","50.28","12.29"
"67","000","00","270","0000","0000","27427","10556","16871","289","27716","65371","76229","42.40","16.15"
"67","000","00","270","0001","0000","2398","721","1677","25","2423","5421","0","44.70","13.30"
"67","000","00","270","0001","1384","608","178","430","7","615","1331","0","46.21","13.37"
"67","000","00","270","0001","1385","606","214","392","6","612","1418","0","43.16","15.09"
"67","000","00","270","0001","1386","629","169","460","5","634","1435","0","44.18","11.78"
"67","000","00","270","0001","1387","555","160","395","7","562","1237","0","45.43","12.93"
"67","000","00","270","0002","0000","1248","323","925","13","1261","2737","0","46.07","11.80"
"67","000","00","270","0002","1388","667","183","484","5","672","1432","0","46.93","12.78"
"67","000","00","270","0002","1389","581","140","441","8","589","1305","0","45.13","10.73"
"67","000","00","270","0003","0000","1109","401","708","15","1124","2570","0","43.74","15.60"
"67","000","00","270","0003","1390","538","205","333","11","549","1318","0","41.65","15.55"
"67","000","00","270","0003","1391","571","196","375","4","575","1252","0","45.93","15.65"
"67","000","00","270","0004","0000","3046","1252","1794","26","3072","7630","0","40.26","16.41"
"67","000","00","270","0004","1392","442","163","279","6","448","1109","0","40.40","14.70"
"67","000","00","270","0004","1393","446","182","264","2","448","1092","0","41.03","16.67"
"67","000","00","270","0004","1394","431","157","274","4","435","1074","0","40.50","14.62"
"67","000","00","270","0004","1395","414","164","250","5","419","1175","0","35.66","13.96"
"67","000","00","270","0004","1396","577","293","284","4","581","1431","0","40.60","20.48"
"67","000","00","270","0004","1397","386","163","223","3","389","949","0","40.99","17.18"
"67","000","00","270","0004","1398","350","130","220","2","352","800","0","44.00","16.25"
"67","000","00","270","0005","0000","3921","1524","2397","31","3952","9033","0","43.75","16.87"
"67","000","00","270","0005","1399","648","263","385","4","652","1441","0","45.25","18.25"
"67","000","00","270","0005","1400","563","208","355","8","571","1347","0","42.39","15.44"
"67","000","00","270","0005","1401","687","306","381","5","692","1477","0","46.85","20.72"
"67","000","00","270","0005","1402","492","183","309","0","492","1208","0","40.73","15.15"
"67","000","00","270","0005","1403","555","238","317","4","559","1348","0","41.47","17.66"
"67","000","00","270","0005","1404","484","164","320","4","488","1067","0","45.74","15.37"
"67","000","00","270","0005","1405","492","162","330","6","498","1145","0","43.49","14.15"
"67","000","00","270","0006","0000","1471","519","952","8","1479","3381","0","43.74","15.35"
"67","000","00","270","0006","1406","523","155","368","2","525","1247","0","42.10","12.43"
"67","000","00","270","0006","1407","448","163","285","3","451","971","0","46.45","16.79"
"67","000","00","270","0006","1408","500","201","299","3","503","1163","0","43.25","17.28"
"67","000","00","270","0007","0000","3799","1404","2395","27","3826","9317","0","41.06","15.07"
"67","000","00","270","0007","1409","564","188","376","6","570","1393","0","40.92","13.50"
"67","000","00","270","0007","1410","637","211","426","2","639","1453","0","43.98","14.52"
"67","000","00","270","0007","1411","574","200","374","4","578","1399","0","41.32","14.30"
"67","000","00","270","0007","1412","532","186","346","8","540","1332","0","40.54","13.96"
"67","000","00","270","0007","1413","446","178","268","7","453","1229","0","36.86","14.48"
"67","000","00","270","0007","1414","369","160","209","0","369","937","0","39.38","17.08"
"67","000","00","270","0007","1415","438","181","257","0","438","1027","0","42.65","17.62"
"67","000","00","270","0007","1416","239","100","139","0","239","547","0","43.69","18.28"
"67","000","00","270","0008","0000","2350","807","1543","31","2381","6025","0","39.52","13.39"
"67","000","00","270","0008","1417","326","111","215","7","333","846","0","39.36","13.12"
"67","000","00","270","0008","1418","310","109","201","5","315","759","0","41.50","14.36"
"67","000","00","270","0008","1419","547","193","354","7","554","1435","0","38.61","13.45"
"67","000","00","270","0008","1420","294","103","191","0","294","764","0","38.48","13.48"
"67","000","00","270","0008","1421","388","122","266","4","392","998","0","39.28","12.22"
"67","000","00","270","0008","1422","485","169","316","8","493","1223","0","40.31","13.82"
"67","000","00","270","0011","0000","1076","381","695","12","1088","2705","0","40.22","14.09"
"67","000","00","270","0011","1425","568","189","379","5","573","1380","0","41.52","13.70"
"67","000","00","270","0011","1426","508","192","316","7","515","1325","0","38.87","14.49"
"67","000","00","270","0012","0000","2105","1095","1010","28","2133","4809","0","44.35","22.77"
"67","000","00","270","0012","1427","631","318","313","5","636","1400","0","45.43","22.71"
"67","000","00","270","0012","1428","606","318","288","9","615","1333","0","46.14","23.86"
"67","000","00","270","0012","1429","582","343","239","13","595","1431","0","41.58","23.97"
"67","000","00","270","0012","1430","286","116","170","1","287","645","0","44.50","17.98"
"67","000","00","270","0013","0000","690","556","134","9","699","1493","0","46.82","37.24"
"67","000","00","270","0013","1431","690","556","134","9","699","1493","0","46.82","37.24"
"67","000","00","270","0014","0000","531","299","232","3","534","1211","0","44.10","24.69"
"67","000","00","270","0014","1432","531","299","232","3","534","1211","0","44.10","24.69"
"67","000","00","270","0015","0000","814","302","512","11","825","2102","0","39.25","14.37"
"67","000","00","270","0015","1433","463","188","275","8","471","1147","0","41.06","16.39"
"67","000","00","270","0015","1434","351","114","237","3","354","955","0","37.07","11.94"
"67","000","00","270","0016","0000","881","275","606","14","895","2110","0","42.42","13.03"
"67","000","00","270","0016","1435","415","124","291","8","423","935","0","45.24","13.26"
"67","000","00","270","0016","1436","466","151","315","6","472","1175","0","40.17","12.85"
"67","000","00","270","0017","0000","1070","357","713","19","1089","2612","0","41.69","13.67"
"67","000","00","270","0017","1437","496","153","343","7","503","1159","0","43.40","13.20"
"67","000","00","270","0017","1438","574","204","370","12","586","1453","0","40.33","14.04"
"67","000","00","270","0019","0000","918","340","578","17","935","2215","0","42.21","15.35"
"67","000","00","270","0019","1423","505","186","319","11","516","1252","0","41.21","14.86"
"67","000","00","270","0019","1424","413","154","259","6","419","963","0","43.51","15.99"
"67","000","00","280","0000","0000","23828","8082","15746","202","24030","57425","68074","41.85","14.07"
"67","000","00","280","0001","0000","2431","821","1610","16","2447","5856","0","41.79","14.02"
"67","000","00","280","0001","1439","484","171","313","3","487","1201","0","40.55","14.24"
"67","000","00","280","0001","1440","504","184","320","5","509","1154","0","44.11","15.94"
"67","000","00","280","0001","1441","428","149","279","3","431","1001","0","43.06","14.89"
"67","000","00","280","0001","1442","514","184","330","4","518","1212","0","42.74","15.18"
"67","000","00","280","0001","1443","501","133","368","1","502","1288","0","38.98","10.33"
"67","000","00","280","0002","0000","1376","437","939","12","1388","3838","0","36.16","11.39"
"67","000","00","280","0002","1448","344","111","233","3","347","967","0","35.88","11.48"
"67","000","00","280","0002","1449","261","83","178","4","265","961","0","27.58","8.64"
"67","000","00","280","0002","1450","379","100","279","3","382","957","0","39.92","10.45"
"67","000","00","280","0002","1451","392","143","249","2","394","953","0","41.34","15.01"
"67","000","00","280","0003","0000","927","368","559","6","933","2285","0","40.83","16.11"
"67","000","00","280","0003","1481","537","204","333","4","541","1255","0","43.11","16.25"
"67","000","00","280","0003","1482","390","164","226","2","392","1030","0","38.06","15.92"
"67","000","00","280","0004","0000","1347","462","885","7","1354","3225","0","41.98","14.33"
"67","000","00","280","0004","1454","459","172","287","4","463","1040","0","44.52","16.54"
"67","000","00","280","0004","1455","412","134","278","3","415","1073","0","38.68","12.49"
"67","000","00","280","0004","1456","476","156","320","0","476","1112","0","42.81","14.03"
"67","000","00","280","0005","0000","1339","498","841","8","1347","3248","0","41.47","15.33"
"67","000","00","280","0005","1460","415","182","233","3","418","1045","0","40.00","17.42"
"67","000","00","280","0005","1461","489","174","315","1","490","1125","0","43.56","15.47"
"67","000","00","280","0005","1462","435","142","293","4","439","1078","0","40.72","13.17"
"67","000","00","280","0006","0000","1324","448","876","13","1337","3254","0","41.09","13.77"
"67","000","00","280","0006","1466","458","171","287","2","460","1142","0","40.28","14.97"
"67","000","00","280","0006","1467","425","129","296","6","431","1040","0","41.44","12.40"
"67","000","00","280","0006","1468","441","148","293","5","446","1072","0","41.60","13.81"
"67","000","00","280","0007","0000","926","306","620","13","939","2155","0","43.57","14.20"
"67","000","00","280","0007","1469","467","157","310","7","474","1081","0","43.85","14.52"
"67","000","00","280","0007","1470","459","149","310","6","465","1074","0","43.30","13.87"
"67","000","00","280","0008","0000","762","282","480","10","772","1781","0","43.35","15.83"
"67","000","00","280","0008","1471","443","152","291","7","450","1012","0","44.47","15.02"
"67","000","00","280","0008","1472","319","130","189","3","322","769","0","41.87","16.91"
"67","000","00","280","0009","0000","1363","449","914","10","1373","3017","0","45.51","14.88"
"67","000","00","280","0009","1473","457","145","312","5","462","1055","0","43.79","13.74"
"67","000","00","280","0009","1474","413","137","276","1","414","917","0","45.15","14.94"
"67","000","00","280","0009","1475","493","167","326","4","497","1045","0","47.56","15.98"
"67","000","00","280","0010","0000","276","82","194","3","279","692","0","40.32","11.85"
"67","000","00","280","0010","1476","276","82","194","3","279","692","0","40.32","11.85"
"67","000","00","280","0011","0000","745","206","539","7","752","1871","0","40.19","11.01"
"67","000","00","280","0011","1477","410","118","292","5","415","995","0","41.71","11.86"
"67","000","00","280","0011","1478","335","88","247","2","337","876","0","38.47","10.05"
"67","000","00","280","0012","0000","646","232","414","5","651","1767","0","36.84","13.13"
"67","000","00","280","0012","1479","354","135","219","2","356","872","0","40.83","15.48"
"67","000","00","280","0012","1480","292","97","195","3","295","895","0","32.96","10.84"
"67","000","00","280","0013","0000","1178","391","787","9","1187","2678","0","44.32","14.60"
"67","000","00","280","0013","1483","395","126","269","1","396","848","0","46.70","14.86"
"67","000","00","280","0013","1484","366","127","239","3","369","862","0","42.81","14.73"
"67","000","00","280","0013","1485","417","138","279","5","422","968","0","43.60","14.26"
"67","000","00","280","0014","0000","1411","489","922","16","1427","3293","0","43.33","14.85"
"67","000","00","280","0014","1486","314","127","187","3","317","742","0","42.72","17.12"
"67","000","00","280","0014","1487","401","142","259","7","408","897","0","45.48","15.83"
"67","000","00","280","0014","1488","380","103","277","4","384","859","0","44.70","11.99"
"67","000","00","280","0014","1489","316","117","199","2","318","795","0","40.00","14.72"
"67","000","00","280","0015","0000","843","245","598","9","852","1938","0","43.96","12.64"
"67","000","00","280","0015","1490","387","122","265","3","390","938","0","41.58","13.01"
"67","000","00","280","0015","1491","456","123","333","6","462","1000","0","46.20","12.30"
"67","000","00","280","0016","0000","739","228","511","6","745","1652","0","45.10","13.80"
"67","000","00","280","0016","1492","421","133","288","5","426","940","0","45.32","14.15"
"67","000","00","280","0016","1493","318","95","223","1","319","712","0","44.80","13.34"
"67","000","00","280","0017","0000","1274","428","846","13","1287","3037","0","42.38","14.09"
"67","000","00","280","0017","1494","392","132","260","6","398","1022","0","38.94","12.92"
"67","000","00","280","0017","1495","434","122","312","4","438","936","0","46.79","13.03"
"67","000","00","280","0017","1496","448","174","274","3","451","1079","0","41.80","16.13"
"67","000","00","280","0018","0000","1767","645","1122","20","1787","4221","0","42.34","15.28"
"67","000","00","280","0018","1444","416","172","244","5","421","1012","0","41.60","17.00"
"67","000","00","280","0018","1445","469","167","302","4","473","1109","0","42.65","15.06"
"67","000","00","280","0018","1446","449","170","279","5","454","1045","0","43.44","16.27"
"67","000","00","280","0018","1447","433","136","297","6","439","1055","0","41.61","12.89"
"67","000","00","280","0019","0000","970","316","654","4","974","2447","0","39.80","12.91"
"67","000","00","280","0019","1463","341","114","227","0","341","883","0","38.62","12.91"
"67","000","00","280","0019","1464","426","149","277","3","429","1020","0","42.06","14.61"
"67","000","00","280","0019","1465","203","53","150","1","204","544","0","37.50","9.74"
"67","000","00","280","0020","0000","961","302","659","5","966","2218","0","43.55","13.62"
"67","000","00","280","0020","1452","481","149","332","2","483","1107","0","43.63","13.46"
"67","000","00","280","0020","1453","480","153","327","3","483","1111","0","43.47","13.77"
"67","000","00","280","0021","0000","1223","447","776","10","1233","2952","0","41.77","15.14"
"67","000","00","280","0021","1457","414","151","263","1","415","959","0","43.27","15.75"
"67","000","00","280","0021","1458","391","158","233","3","394","919","0","42.87","17.19"
"67","000","00","280","0021","1459","418","138","280","6","424","1074","0","39.48","12.85"
"67","000","00","290","0000","0000","12212","3985","8227","140","12352","29940","33986","41.26","13.31"
"67","000","00","290","0001","0000","961","333","628","18","979","2249","0","43.53","14.81"
"67","000","00","290","0001","1497","402","128","274","9","411","961","0","42.77","13.32"
"67","000","00","290","0001","1498","559","205","354","9","568","1288","0","44.10","15.92"
"67","000","00","290","0002","0000","855","279","576","5","860","2011","0","42.76","13.87"
"67","000","00","290","0002","1499","369","137","232","3","372","968","0","38.43","14.15"
"67","000","00","290","0002","1500","486","142","344","2","488","1043","0","46.79","13.61"
"67","000","00","290","0003","0000","1437","519","918","12","1449","3209","0","45.15","16.17"
"67","000","00","290","0003","1501","445","174","271","8","453","953","0","47.53","18.26"
"67","000","00","290","0003","1502","439","154","285","1","440","1001","0","43.96","15.38"
"67","000","00","290","0003","1503","553","191","362","3","556","1255","0","44.30","15.22"
"67","000","00","290","0004","0000","1041","313","728","14","1055","2473","0","42.66","12.66"
"67","000","00","290","0004","1504","557","173","384","9","566","1288","0","43.94","13.43"
"67","000","00","290","0004","1505","484","140","344","5","489","1185","0","41.27","11.81"
"67","000","00","290","0005","0000","368","112","256","7","375","1038","0","36.13","10.79"
"67","000","00","290","0005","1506","368","112","256","7","375","1038","0","36.13","10.79"
"67","000","00","290","0006","0000","286","81","205","0","286","695","0","41.15","11.65"
"67","000","00","290","0006","1507","286","81","205","0","286","695","0","41.15","11.65"
"67","000","00","290","0007","0000","1269","456","813","13","1282","3182","0","40.29","14.33"
"67","000","00","290","0007","1508","450","167","283","7","457","1105","0","41.36","15.11"
"67","000","00","290","0007","1509","436","151","285","4","440","1063","0","41.39","14.21"
"67","000","00","290","0007","1510","383","138","245","2","385","1014","0","37.97","13.61"
"67","000","00","290","0008","0000","1209","412","797","16","1225","3141","0","39.00","13.12"
"67","000","00","290","0008","1511","409","126","283","6","415","1112","0","37.32","11.33"
"67","000","00","290","0008","1512","347","149","198","6","353","981","0","35.98","15.19"
"67","000","00","290","0008","1513","453","137","316","4","457","1048","0","43.61","13.07"
"67","000","00","290","0009","0000","755","222","533","9","764","1949","0","39.20","11.39"
"67","000","00","290","0009","1514","346","99","247","4","350","965","0","36.27","10.26"
"67","000","00","290","0009","1515","409","123","286","5","414","984","0","42.07","12.50"
"67","000","00","290","0012","0000","592","215","377","6","598","1468","0","40.74","14.65"
"67","000","00","290","0012","1520","329","113","216","2","331","772","0","42.88","14.64"
"67","000","00","290","0012","1521","263","102","161","4","267","696","0","38.36","14.66"
"67","000","00","290","0013","0000","473","136","337","8","481","1183","0","40.66","11.50"
"67","000","00","290","0013","1522","330","100","230","5","335","826","0","40.56","12.11"
"67","000","00","290","0013","1523","143","36","107","3","146","357","0","40.90","10.08"
"67","000","00","290","0016","0000","772","237","535","7","779","1936","0","40.24","12.24"
"67","000","00","290","0016","1526","348","119","229","2","350","903","0","38.76","13.18"
"67","000","00","290","0016","1527","424","118","306","5","429","1033","0","41.53","11.42"
"67","000","00","290","0017","0000","205","73","132","4","209","470","0","44.47","15.53"
"67","000","00","290","0017","1528","205","73","132","4","209","470","0","44.47","15.53"
"67","000","00","290","0018","0000","1383","427","956","15","1398","3442","0","40.62","12.41"
"67","000","00","290","0018","1516","332","103","229","5","337","762","0","44.23","13.52"
"67","000","00","290","0018","1517","288","104","184","1","289","623","0","46.39","16.69"
"67","000","00","290","0018","1518","395","112","283","7","402","965","0","41.66","11.61"
"67","000","00","290","0018","1519","368","108","260","2","370","1092","0","33.88","9.89"
"67","000","00","290","0019","0000","606","170","436","6","612","1494","0","40.96","11.38"
"67","000","00","290","0019","1524","333","85","248","3","336","791","0","42.48","10.75"
"67","000","00","290","0019","1525","273","85","188","3","276","703","0","39.26","12.09"
"67","000","00","300","0000","0000","1305","507","798","17","1322","3545","3720","37.29","14.30"
"67","000","00","300","0001","0000","372","130","242","8","380","990","0","38.38","13.13"
"67","000","00","300","0001","1529","372","130","242","8","380","990","0","38.38","13.13"
"67","000","00","300","0002","0000","211","64","147","2","213","601","0","35.44","10.65"
"67","000","00","300","0002","1530","211","64","147","2","213","601","0","35.44","10.65"
"67","000","00","300","0003","0000","53","20","33","0","53","152","0","34.87","13.16"
"67","000","00","300","0003","1531","53","20","33","0","53","152","0","34.87","13.16"
"67","000","00","300","0004","0000","160","59","101","0","160","371","0","43.13","15.90"
"67","000","00","300","0004","1532","160","59","101","0","160","371","0","43.13","15.90"
"67","000","00","300","0005","0000","129","52","77","1","130","300","0","43.33","17.33"
"67","000","00","300","0005","1533","129","52","77","1","130","300","0","43.33","17.33"
"67","000","00","300","0006","0000","125","65","60","1","126","286","0","44.06","22.73"
"67","000","00","300","0006","1534","125","65","60","1","126","286","0","44.06","22.73"
"67","000","00","300","0007","0000","120","67","53","2","122","416","0","29.33","16.11"
"67","000","00","300","0007","1535","120","67","53","2","122","416","0","29.33","16.11"
"67","000","00","300","0008","0000","135","50","85","3","138","429","0","32.17","11.66"
"67","000","00","300","0008","1536","135","50","85","3","138","429","0","32.17","11.66"
"67","000","00","310","0000","0000","78858","32001","46857","697","79555","196894","235327","40.40","16.25"
"67","000","00","310","0001","0000","2208","902","1306","18","2226","5645","0","39.43","15.98"
"67","000","00","310","0001","0860","568","262","306","1","569","1365","0","41.68","19.19"
"67","000","00","310","0001","0861","539","211","328","5","544","1453","0","37.44","14.52"
"67","000","00","310","0001","0862","607","212","395","5","612","1410","0","43.40","15.04"
"67","000","00","310","0001","0863","494","217","277","7","501","1417","0","35.36","15.31"
"67","000","00","310","0002","0000","2739","1178","1561","26","2765","6942","0","39.83","16.97"
"67","000","00","310","0002","0871","572","194","378","10","582","1418","0","41.04","13.68"
"67","000","00","310","0002","0872","495","217","278","4","499","1322","0","37.75","16.41"
"67","000","00","310","0002","0873","547","205","342","2","549","1314","0","41.78","15.60"
"67","000","00","310","0002","0874","521","206","315","3","524","1337","0","39.19","15.41"
"67","000","00","310","0002","0875","604","356","248","7","611","1551","0","39.39","22.95"
"67","000","00","310","0003","0000","3073","1177","1896","23","3096","8806","0","35.16","13.37"
"67","000","00","310","0003","0882","596","238","358","6","602","1412","0","42.63","16.86"
"67","000","00","310","0003","0883","535","198","337","1","536","1364","0","39.30","14.52"
"67","000","00","310","0003","0884","533","185","348","4","537","1409","0","38.11","13.13"
"67","000","00","310","0003","0885","454","185","269","2","456","1318","0","34.60","14.04"
"67","000","00","310","0003","0886","356","130","226","1","357","1784","0","20.01","7.29"
"67","000","00","310","0003","0887","599","241","358","9","608","1519","0","40.03","15.87"
"67","000","00","310","0004","0000","2852","1050","1802","26","2878","7154","0","40.23","14.68"
"67","000","00","310","0004","0888","427","139","288","8","435","1045","0","41.63","13.30"
"67","000","00","310","0004","0889","439","186","253","2","441","1166","0","37.82","15.95"
"67","000","00","310","0004","0890","462","186","276","5","467","1185","0","39.41","15.70"
"67","000","00","310","0004","0891","597","223","374","3","600","1401","0","42.83","15.92"
"67","000","00","310","0004","0892","426","135","291","1","427","1068","0","39.98","12.64"
"67","000","00","310","0004","0893","501","181","320","7","508","1289","0","39.41","14.04"
"67","000","00","310","0005","0000","2330","988","1342","20","2350","5595","0","42.00","17.66"
"67","000","00","310","0005","0903","491","208","283","4","495","1123","0","44.08","18.52"
"67","000","00","310","0005","0904","449","209","240","4","453","1145","0","39.56","18.25"
"67","000","00","310","0005","0905","490","188","302","3","493","1124","0","43.86","16.73"
"67","000","00","310","0005","0906","449","189","260","6","455","1116","0","40.77","16.94"
"67","000","00","310","0005","0907","451","194","257","3","454","1087","0","41.77","17.85"
"67","000","00","310","0006","0000","1002","319","683","12","1014","2455","0","41.30","12.99"
"67","000","00","310","0006","0949","534","145","389","5","539","1247","0","43.22","11.63"
"67","000","00","310","0006","0950","468","174","294","7","475","1208","0","39.32","14.40"
"67","000","00","310","0007","0000","1085","403","682","15","1100","2791","0","39.41","14.44"
"67","000","00","310","0007","0951","537","176","361","8","545","1346","0","40.49","13.08"
"67","000","00","310","0007","0952","548","227","321","7","555","1445","0","38.41","15.71"
"67","000","00","310","0008","0000","708","225","483","5","713","1847","0","38.60","12.18"
"67","000","00","310","0008","0920","347","112","235","0","347","935","0","37.11","11.98"
"67","000","00","310","0008","0921","361","113","248","5","366","912","0","40.13","12.39"
"67","000","00","310","0009","0000","653","240","413","8","661","1503","0","43.98","15.97"
"67","000","00","310","0009","0922","428","180","248","4","432","958","0","45.09","18.79"
"67","000","00","310","0009","0923","225","60","165","4","229","545","0","42.02","11.01"
"67","000","00","310","0010","0000","2059","693","1366","18","2077","4855","0","42.78","14.27"
"67","000","00","310","0010","0924","539","196","343","3","542","1293","0","41.92","15.16"
"67","000","00","310","0010","0925","542","165","377","4","546","1218","0","44.83","13.55"
"67","000","00","310","0010","0926","504","161","343","4","508","1198","0","42.40","13.44"
"67","000","00","310","0010","0927","474","171","303","7","481","1146","0","41.97","14.92"
"67","000","00","310","0011","0000","982","305","677","6","988","2226","0","44.38","13.70"
"67","000","00","310","0011","0936","347","140","207","2","349","887","0","39.35","15.78"
"67","000","00","310","0011","0937","635","165","470","4","639","1339","0","47.72","12.32"
"67","000","00","310","0012","0000","1410","414","996","14","1424","3408","0","41.78","12.15"
"67","000","00","310","0012","0960","451","109","342","3","454","1147","0","39.58","9.50"
"67","000","00","310","0012","0961","427","123","304","4","431","1014","0","42.50","12.13"
"67","000","00","310","0012","0962","532","182","350","7","539","1247","0","43.22","14.60"
"67","000","00","310","0013","0000","1425","407","1018","20","1445","3440","0","42.01","11.83"
"67","000","00","310","0013","0963","472","134","338","6","478","1124","0","42.53","11.92"
"67","000","00","310","0013","0964","443","123","320","7","450","1154","0","38.99","10.66"
"67","000","00","310","0013","0965","510","150","360","7","517","1162","0","44.49","12.91"
"67","000","00","310","0014","0000","2997","1070","1927","28","3025","7237","0","41.80","14.79"
"67","000","00","310","0014","0966","497","141","356","5","502","1210","0","41.49","11.65"
"67","000","00","310","0014","0967","497","173","324","5","502","1113","0","45.10","15.54"
"67","000","00","310","0014","0968","518","197","321","2","520","1358","0","38.29","14.51"
"67","000","00","310","0014","0969","485","161","324","2","487","1140","0","42.72","14.12"
"67","000","00","310","0014","0970","527","204","323","6","533","1200","0","44.42","17.00"
"67","000","00","310","0014","0971","473","194","279","8","481","1216","0","39.56","15.95"
"67","000","00","310","0015","0000","1562","460","1102","9","1571","3833","0","40.99","12.00"
"67","000","00","310","0015","0972","547","163","384","3","550","1335","0","41.20","12.21"
"67","000","00","310","0015","0973","516","135","381","2","518","1239","0","41.81","10.90"
"67","000","00","310","0015","0974","499","162","337","4","503","1259","0","39.95","12.87"
"67","000","00","310","0016","0000","2526","870","1656","18","2544","5820","0","43.71","14.95"
"67","000","00","310","0016","0975","478","205","273","4","482","1136","0","42.43","18.05"
"67","000","00","310","0016","0976","539","164","375","1","540","1220","0","44.26","13.44"
"67","000","00","310","0016","0977","546","180","366","6","552","1220","0","45.25","14.75"
"67","000","00","310","0016","0978","503","187","316","4","507","1136","0","44.63","16.46"
"67","000","00","310","0016","0979","460","134","326","3","463","1108","0","41.79","12.09"
"67","000","00","310","0017","0000","1650","452","1198","16","1666","4081","0","40.82","11.08"
"67","000","00","310","0017","0980","575","92","483","6","581","1481","0","39.23","6.21"
"67","000","00","310","0017","0981","550","178","372","5","555","1344","0","41.29","13.24"
"67","000","00","310","0017","0982","525","182","343","5","530","1256","0","42.20","14.49"
"67","000","00","310","0018","0000","822","269","553","10","832","2121","0","39.23","12.68"
"67","000","00","310","0018","0958","392","143","249","5","397","1032","0","38.47","13.86"
"67","000","00","310","0018","0959","430","126","304","5","435","1089","0","39.94","11.57"
"67","000","00","310","0019","0000","705","467","238","13","718","1919","0","37.42","24.34"
"67","000","00","310","0019","0987","359","248","111","6","365","1036","0","35.23","23.94"
"67","000","00","310","0019","0988","346","219","127","7","353","883","0","39.98","24.80"
"67","000","00","310","0020","0000","3312","1768","1544","30","3342","8455","0","39.53","20.91"
"67","000","00","310","0020","0992","599","317","282","11","610","1313","0","46.46","24.14"
"67","000","00","310","0020","0993","563","306","257","3","566","1463","0","38.69","20.92"
"67","000","00","310","0020","0994","456","222","234","3","459","1339","0","34.28","16.58"
"67","000","00","310","0020","0995","413","221","192","4","417","1112","0","37.50","19.87"
"67","000","00","310","0020","0996","422","211","211","1","423","1277","0","33.12","16.52"
"67","000","00","310","0020","0997","334","182","152","2","336","812","0","41.38","22.41"
"67","000","00","310","0020","0998","525","309","216","6","531","1139","0","46.62","27.13"
"67","000","00","310","0021","0000","772","469","303","11","783","1905","0","41.10","24.62"
"67","000","00","310","0021","0990","348","240","108","9","357","864","0","41.32","27.78"
"67","000","00","310","0021","0991","424","229","195","2","426","1041","0","40.92","22.00"
"67","000","00","310","0022","0000","464","235","229","7","471","1264","0","37.26","18.59"
"67","000","00","310","0022","1006","464","235","229","7","471","1264","0","37.26","18.59"
"67","000","00","310","0023","0000","2426","871","1555","24","2450","6123","0","40.01","14.23"
"67","000","00","310","0023","0953","467","184","283","5","472","1230","0","38.37","14.96"
"67","000","00","310","0023","0954","467","181","286","5","472","1174","0","40.20","15.42"
"67","000","00","310","0023","0955","504","168","336","3","507","1264","0","40.11","13.29"
"67","000","00","310","0023","0956","507","181","326","5","512","1266","0","40.44","14.30"
"67","000","00","310","0023","0957","481","157","324","6","487","1189","0","40.96","13.20"
"67","000","00","310","0024","0000","832","588","244","16","848","2032","0","41.73","28.94"
"67","000","00","310","0024","1007","438","336","102","9","447","1022","0","43.74","32.88"
"67","000","00","310","0024","1008","394","252","142","7","401","1010","0","39.70","24.95"
"67","000","00","310","0025","0000","1385","687","698","12","1397","3317","0","42.12","20.71"
"67","000","00","310","0025","1011","439","225","214","5","444","1113","0","39.89","20.22"
"67","000","00","310","0025","1012","472","221","251","5","477","1128","0","42.29","19.59"
"67","000","00","310","0025","1013","474","241","233","2","476","1076","0","44.24","22.40"
"67","000","00","310","0026","0000","2963","1445","1518","26","2989","7661","0","39.02","18.86"
"67","000","00","310","0026","1014","553","249","304","4","557","1301","0","42.81","19.14"
"67","000","00","310","0026","1015","462","216","246","5","467","1207","0","38.69","17.90"
"67","000","00","310","0026","1016","413","182","231","0","413","1132","0","36.48","16.08"
"67","000","00","310","0026","1017","478","237","241","5","483","1396","0","34.60","16.98"
"67","000","00","310","0026","1018","524","244","280","1","525","1369","0","38.35","17.82"
"67","000","00","310","0026","1019","533","317","216","11","544","1256","0","43.31","25.24"
"67","000","00","310","0027","0000","2295","716","1579","24","2319","6139","0","37.77","11.66"
"67","000","00","310","0027","0941","477","149","328","5","482","1235","0","39.03","12.06"
"67","000","00","310","0027","0942","485","139","346","8","493","1279","0","38.55","10.87"
"67","000","00","310","0027","0943","457","136","321","5","462","1288","0","35.87","10.56"
"67","000","00","310","0027","0944","483","167","316","5","488","1307","0","37.34","12.78"
"67","000","00","310","0027","0945","393","125","268","1","394","1030","0","38.25","12.14"
"67","000","00","310","0028","0000","196","140","56","1","197","527","0","37.38","26.57"
"67","000","00","310","0028","0989","196","140","56","1","197","527","0","37.38","26.57"
"67","000","00","310","0029","0000","2382","989","1393","15","2397","5686","0","42.16","17.39"
"67","000","00","310","0029","0931","449","154","295","2","451","1175","0","38.38","13.11"
"67","000","00","310","0029","0932","432","131","301","0","432","1010","0","42.77","12.97"
"67","000","00","310","0029","0933","523","323","200","5","528","1201","0","43.96","26.89"
"67","000","00","310","0029","0934","484","201","283","7","491","1121","0","43.80","17.93"
"67","000","00","310","0029","0935","494","180","314","1","495","1179","0","41.98","15.27"
"67","000","00","310","0030","0000","3153","1427","1726","24","3177","7749","0","41.00","18.42"
"67","000","00","310","0030","0876","441","215","226","4","445","1212","0","36.72","17.74"
"67","000","00","310","0030","0877","553","255","298","2","555","1359","0","40.84","18.76"
"67","000","00","310","0030","0878","496","236","260","4","500","1244","0","40.19","18.97"
"67","000","00","310","0030","0879","540","243","297","1","541","1262","0","42.87","19.26"
"67","000","00","310","0030","0880","535","231","304","4","539","1296","0","41.59","17.82"
"67","000","00","310","0030","0881","588","247","341","9","597","1376","0","43.39","17.95"
"67","000","00","310","0031","0000","2255","1012","1243","9","2264","5449","0","41.55","18.57"
"67","000","00","310","0031","0867","536","202","334","2","538","1310","0","41.07","15.42"
"67","000","00","310","0031","0868","574","211","363","4","578","1365","0","42.34","15.46"
"67","000","00","310","0031","0869","539","260","279","2","541","1392","0","38.86","18.68"
"67","000","00","310","0031","0870","606","339","267","1","607","1382","0","43.92","24.53"
"67","000","00","310","0032","0000","1396","588","808","12","1408","3456","0","40.74","17.01"
"67","000","00","310","0032","0864","483","212","271","6","489","1139","0","42.93","18.61"
"67","000","00","310","0032","0865","472","213","259","4","476","1146","0","41.54","18.59"
"67","000","00","310","0032","0866","441","163","278","2","443","1171","0","37.83","13.92"
"67","000","00","310","0033","0000","2796","1079","1717","22","2818","7184","0","39.23","15.02"
"67","000","00","310","0033","0908","675","270","405","6","681","1629","0","41.80","16.57"
"67","000","00","310","0033","0909","697","256","441","5","702","1671","0","42.01","15.32"
"67","000","00","310","0033","0910","649","272","377","4","653","1747","0","37.38","15.57"
"67","000","00","310","0033","0911","284","94","190","2","286","667","0","42.88","14.09"
"67","000","00","310","0033","0912","491","187","304","5","496","1470","0","33.74","12.72"
"67","000","00","310","0034","0000","1863","764","1099","17","1880","4806","0","39.12","15.90"
"67","000","00","310","0034","0916","424","192","232","5","429","1106","0","38.79","17.36"
"67","000","00","310","0034","0917","479","186","293","5","484","1356","0","35.69","13.72"
"67","000","00","310","0034","0918","483","182","301","3","486","1217","0","39.93","14.95"
"67","000","00","310","0034","0919","477","204","273","4","481","1127","0","42.68","18.10"
"67","000","00","310","0035","0000","1235","482","753","18","1253","3018","0","41.52","15.97"
"67","000","00","310","0035","0913","385","147","238","5","390","946","0","41.23","15.54"
"67","000","00","310","0035","0914","430","167","263","8","438","1068","0","41.01","15.64"
"67","000","00","310","0035","0915","420","168","252","5","425","1004","0","42.33","16.73"
"67","000","00","310","0036","0000","1645","554","1091","10","1655","3737","0","44.29","14.82"
"67","000","00","310","0036","0938","568","166","402","3","571","1168","0","48.89","14.21"
"67","000","00","310","0036","0939","487","130","357","5","492","1138","0","43.23","11.42"
"67","000","00","310","0036","0940","590","258","332","2","592","1431","0","41.37","18.03"
"67","000","00","310","0037","0000","3641","1816","1825","28","3669","9242","0","39.70","19.65"
"67","000","00","310","0037","0999","569","298","271","5","574","1490","0","38.52","20.00"
"67","000","00","310","0037","1000","489","244","245","3","492","1382","0","35.60","17.66"
"67","000","00","310","0037","1001","485","231","254","5","490","1208","0","40.56","19.12"
"67","000","00","310","0037","1002","558","279","279","2","560","1281","0","43.72","21.78"
"67","000","00","310","0037","1003","560","285","275","5","565","1337","0","42.26","21.32"
"67","000","00","310","0037","1004","545","273","272","2","547","1434","0","38.15","19.04"
"67","000","00","310","0037","1005","435","206","229","6","441","1110","0","39.73","18.56"
"67","000","00","310","0038","0000","3024","1117","1907","25","3049","7578","0","40.23","14.74"
"67","000","00","310","0038","0897","553","185","368","1","554","1295","0","42.78","14.29"
"67","000","00","310","0038","0898","497","198","299","8","505","1159","0","43.57","17.08"
"67","000","00","310","0038","0899","481","168","313","4","485","1189","0","40.79","14.13"
"67","000","00","310","0038","0900","531","159","372","4","535","1283","0","41.70","12.39"
"67","000","00","310","0038","0901","486","196","290","4","490","1326","0","36.95","14.78"
"67","000","00","310","0038","0902","476","211","265","4","480","1326","0","36.20","15.91"
"67","000","00","310","0039","0000","1332","680","652","9","1341","2787","0","48.12","24.40"
"67","000","00","310","0039","1009","705","370","335","7","712","1441","0","49.41","25.68"
"67","000","00","310","0039","1010","627","310","317","2","629","1346","0","46.73","23.03"
"67","000","00","310","0040","0000","2039","767","1272","14","2053","4977","0","41.25","15.41"
"67","000","00","310","0040","0983","542","203","339","4","546","1294","0","42.19","15.69"
"67","000","00","310","0040","0984","475","199","276","4","479","1206","0","39.72","16.50"
"67","000","00","310","0040","0985","560","212","348","3","563","1300","0","43.31","16.31"
"67","000","00","310","0040","0986","462","153","309","3","465","1177","0","39.51","13.00"
"67","000","00","310","0041","0000","1457","560","897","7","1464","3732","0","39.23","15.01"
"67","000","00","310","0041","0894","435","168","267","2","437","1141","0","38.30","14.72"
"67","000","00","310","0041","0895","515","190","325","2","517","1255","0","41.20","15.14"
"67","000","00","310","0041","0896","507","202","305","3","510","1336","0","38.17","15.12"
"67","000","00","310","0042","0000","1856","825","1031","19","1875","4598","0","40.78","17.94"
"67","000","00","310","0042","0946","629","274","355","6","635","1595","0","39.81","17.18"
"67","000","00","310","0042","0947","569","266","303","6","575","1438","0","39.99","18.50"
"67","000","00","310","0042","0948","658","285","373","7","665","1565","0","42.49","18.21"
"67","000","00","310","0043","0000","1351","533","818","12","1363","3794","0","35.93","14.05"
"67","000","00","310","0043","0928","396","142","254","4","400","1118","0","35.78","12.70"
"67","000","00","310","0043","0929","461","198","263","5","466","1410","0","33.05","14.04"
"67","000","00","310","0043","0930","494","193","301","3","497","1266","0","39.26","15.24"
"67","000","00","320","0000","0000","67892","30597","37295","484","68376","151996","183689","44.99","20.13"
"67","000","00","320","0001","0000","963","376","587","8","971","2144","0","45.29","17.54"
"67","000","00","320","0001","1379","485","193","292","4","489","1065","0","45.92","18.12"
"67","000","00","320","0001","1380","478","183","295","4","482","1079","0","44.67","16.96"
"67","000","00","320","0002","0000","1295","570","725","14","1309","2857","0","45.82","19.95"
"67","000","00","320","0002","1374","657","277","380","10","667","1493","0","44.68","18.55"
"67","000","00","320","0002","1375","638","293","345","4","642","1364","0","47.07","21.48"
"67","000","00","320","0003","0000","2797","1389","1408","25","2822","6524","0","43.26","21.29"
"67","000","00","320","0003","1310","504","213","291","8","512","1319","0","38.82","16.15"
"67","000","00","320","0003","1311","648","354","294","5","653","1353","0","48.26","26.16"
"67","000","00","320","0003","1312","555","291","264","5","560","1242","0","45.09","23.43"
"67","000","00","320","0003","1313","545","277","268","4","549","1297","0","42.33","21.36"
"67","000","00","320","0003","1314","545","254","291","3","548","1313","0","41.74","19.35"
"67","000","00","320","0004","0000","1283","545","738","15","1298","2838","0","45.74","19.20"
"67","000","00","320","0004","1256","416","190","226","4","420","897","0","46.82","21.18"
"67","000","00","320","0004","1257","439","174","265","7","446","942","0","47.35","18.47"
"67","000","00","320","0004","1258","428","181","247","4","432","999","0","43.24","18.12"
"67","000","00","320","0005","0000","2065","851","1214","19","2084","4536","0","45.94","18.76"
"67","000","00","320","0005","1280","508","207","301","5","513","1156","0","44.38","17.91"
"67","000","00","320","0005","1281","483","204","279","4","487","1052","0","46.29","19.39"
"67","000","00","320","0005","1282","633","257","376","3","636","1367","0","46.53","18.80"
"67","000","00","320","0005","1283","441","183","258","7","448","961","0","46.62","19.04"
"67","000","00","320","0006","0000","1875","812","1063","15","1890","4489","0","42.10","18.09"
"67","000","00","320","0006","1318","607","274","333","4","611","1451","0","42.11","18.88"
"67","000","00","320","0006","1319","599","283","316","4","603","1463","0","41.22","19.34"
"67","000","00","320","0006","1320","669","255","414","7","676","1575","0","42.92","16.19"
"67","000","00","320","0007","0000","1189","489","700","10","1199","2816","0","42.58","17.37"
"67","000","00","320","0007","1352","352","131","221","3","355","857","0","41.42","15.29"
"67","000","00","320","0007","1353","422","174","248","3","425","965","0","44.04","18.03"
"67","000","00","320","0007","1354","415","184","231","4","419","994","0","42.15","18.51"
"67","000","00","320","0008","0000","2198","1038","1160","12","2210","4731","0","46.71","21.94"
"67","000","00","320","0008","1355","638","279","359","5","643","1332","0","48.27","20.95"
"67","000","00","320","0008","1356","445","198","247","2","447","1033","0","43.27","19.17"
"67","000","00","320","0008","1357","523","285","238","3","526","1208","0","43.54","23.59"
"67","000","00","320","0008","1358","592","276","316","2","594","1158","0","51.30","23.83"
"67","000","00","320","0009","0000","1154","564","590","5","1159","2370","0","48.90","23.80"
"67","000","00","320","0009","1369","527","254","273","2","529","1092","0","48.44","23.26"
"67","000","00","320","0009","1370","627","310","317","3","630","1278","0","49.30","24.26"
"67","000","00","320","0010","0000","1344","595","749","8","1352","2931","0","46.13","20.30"
"67","000","00","320","0010","1266","432","202","230","3","435","978","0","44.48","20.65"
"67","000","00","320","0010","1267","402","181","221","1","403","853","0","47.25","21.22"
"67","000","00","320","0010","1268","510","212","298","4","514","1100","0","46.73","19.27"
"67","000","00","320","0011","0000","538","207","331","3","541","1309","0","41.33","15.81"
"67","000","00","320","0011","1269","538","207","331","3","541","1309","0","41.33","15.81"
"67","000","00","320","0012","0000","1828","895","933","5","1833","3981","0","46.04","22.48"
"67","000","00","320","0012","1381","641","341","300","1","642","1357","0","47.31","25.13"
"67","000","00","320","0012","1382","557","262","295","3","560","1219","0","45.94","21.49"
"67","000","00","320","0012","1383","630","292","338","1","631","1405","0","44.91","20.78"
"67","000","00","320","0013","0000","2184","1000","1184","10","2194","5154","0","42.57","19.40"
"67","000","00","320","0013","1336","550","248","302","4","554","1344","0","41.22","18.45"
"67","000","00","320","0013","1337","580","266","314","1","581","1229","0","47.27","21.64"
"67","000","00","320","0013","1338","519","246","273","2","521","1311","0","39.74","18.76"
"67","000","00","320","0013","1339","535","240","295","3","538","1270","0","42.36","18.90"
"67","000","00","320","0014","0000","2112","889","1223","20","2132","5004","0","42.61","17.77"
"67","000","00","320","0014","1321","567","207","360","2","569","1246","0","45.67","16.61"
"67","000","00","320","0014","1322","587","253","334","3","590","1399","0","42.17","18.08"
"67","000","00","320","0014","1323","508","229","279","8","516","1272","0","40.57","18.00"
"67","000","00","320","0014","1324","450","200","250","7","457","1087","0","42.04","18.40"
"67","000","00","320","0015","0000","736","366","370","3","739","1574","0","46.95","23.25"
"67","000","00","320","0015","1276","736","366","370","3","739","1574","0","46.95","23.25"
"67","000","00","320","0016","0000","657","278","379","1","658","1465","0","44.91","18.98"
"67","000","00","320","0016","1275","657","278","379","1","658","1465","0","44.91","18.98"
"67","000","00","320","0017","0000","2076","1034","1042","12","2088","4496","0","46.44","23.00"
"67","000","00","320","0017","1342","493","227","266","3","496","1103","0","44.97","20.58"
"67","000","00","320","0017","1343","507","241","266","3","510","1059","0","48.16","22.76"
"67","000","00","320","0017","1344","505","281","224","3","508","1104","0","46.01","25.45"
"67","000","00","320","0017","1345","571","285","286","3","574","1230","0","46.67","23.17"
"67","000","00","320","0018","0000","651","295","356","8","659","1504","0","43.82","19.61"
"67","000","00","320","0018","1373","651","295","356","8","659","1504","0","43.82","19.61"
"67","000","00","320","0019","0000","2199","886","1313","14","2213","4969","0","44.54","17.83"
"67","000","00","320","0019","1295","652","260","392","5","657","1409","0","46.63","18.45"
"67","000","00","320","0019","1296","547","216","331","5","552","1370","0","40.29","15.77"
"67","000","00","320","0019","1297","578","225","353","4","582","1272","0","45.75","17.69"
"67","000","00","320","0019","1298","422","185","237","0","422","918","0","45.97","20.15"
"67","000","00","320","0020","0000","1935","784","1151","16","1951","4395","0","44.39","17.84"
"67","000","00","320","0020","1376","624","232","392","2","626","1416","0","44.21","16.38"
"67","000","00","320","0020","1377","584","244","340","7","591","1415","0","41.77","17.24"
"67","000","00","320","0020","1378","727","308","419","7","734","1564","0","46.93","19.69"
"67","000","00","320","0021","0000","860","359","501","8","868","1797","0","48.30","19.98"
"67","000","00","320","0021","1264","516","212","304","8","524","1038","0","50.48","20.42"
"67","000","00","320","0021","1265","344","147","197","0","344","759","0","45.32","19.37"
"67","000","00","320","0022","0000","1831","914","917","12","1843","4122","0","44.71","22.17"
"67","000","00","320","0022","1365","454","231","223","6","460","1038","0","44.32","22.25"
"67","000","00","320","0022","1366","507","265","242","1","508","1052","0","48.29","25.19"
"67","000","00","320","0022","1367","465","211","254","1","466","1083","0","43.03","19.48"
"67","000","00","320","0022","1368","405","207","198","4","409","949","0","43.10","21.81"
"67","000","00","320","0023","0000","517","241","276","4","521","1038","0","50.19","23.22"
"67","000","00","320","0023","1259","517","241","276","4","521","1038","0","50.19","23.22"
"67","000","00","320","0024","0000","2153","944","1209","11","2164","4589","0","47.16","20.57"
"67","000","00","320","0024","1284","424","189","235","2","426","924","0","46.10","20.45"
"67","000","00","320","0024","1285","603","278","325","2","605","1265","0","47.83","21.98"
"67","000","00","320","0024","1286","413","172","241","2","415","935","0","44.39","18.40"
"67","000","00","320","0024","1287","713","305","408","5","718","1465","0","49.01","20.82"
"67","000","00","320","0025","0000","2275","968","1307","18","2293","5079","0","45.15","19.06"
"67","000","00","320","0025","1325","547","229","318","5","552","1287","0","42.89","17.79"
"67","000","00","320","0025","1326","631","252","379","2","633","1346","0","47.03","18.72"
"67","000","00","320","0025","1327","507","239","268","6","513","1159","0","44.26","20.62"
"67","000","00","320","0025","1328","590","248","342","5","595","1287","0","46.23","19.27"
"67","000","00","320","0026","0000","1417","560","857","9","1426","3195","0","44.63","17.53"
"67","000","00","320","0026","1315","478","197","281","2","480","1083","0","44.32","18.19"
"67","000","00","320","0026","1316","600","222","378","5","605","1339","0","45.18","16.58"
"67","000","00","320","0026","1317","339","141","198","2","341","773","0","44.11","18.24"
"67","000","00","320","0027","0000","1555","725","830","8","1563","3480","0","44.91","20.83"
"67","000","00","320","0027","1362","502","227","275","3","505","1124","0","44.93","20.20"
"67","000","00","320","0027","1363","576","303","273","3","579","1242","0","46.62","24.40"
"67","000","00","320","0027","1364","477","195","282","2","479","1114","0","43.00","17.50"
"67","000","00","320","0028","0000","725","301","424","10","735","1609","0","45.68","18.71"
"67","000","00","320","0028","1274","725","301","424","10","735","1609","0","45.68","18.71"
"67","000","00","320","0029","0000","1938","949","989","19","1957","4148","0","47.18","22.88"
"67","000","00","320","0029","1270","440","229","211","4","444","975","0","45.54","23.49"
"67","000","00","320","0029","1271","463","188","275","8","471","1025","0","45.95","18.34"
"67","000","00","320","0029","1272","537","277","260","4","541","1086","0","49.82","25.51"
"67","000","00","320","0029","1273","498","255","243","3","501","1062","0","47.18","24.01"
"67","000","00","320","0030","0000","1108","577","531","6","1114","2346","0","47.49","24.60"
"67","000","00","320","0030","1371","494","282","212","2","496","1100","0","45.09","25.64"
"67","000","00","320","0030","1372","614","295","319","4","618","1246","0","49.60","23.68"
"67","000","00","320","0031","0000","1341","615","726","9","1350","2853","0","47.32","21.56"
"67","000","00","320","0031","1359","421","214","207","2","423","883","0","47.90","24.24"
"67","000","00","320","0031","1360","427","185","242","4","431","913","0","47.21","20.26"
"67","000","00","320","0031","1361","493","216","277","3","496","1057","0","46.93","20.44"
"67","000","00","320","0032","0000","2065","970","1095","22","2087","4400","0","47.43","22.05"
"67","000","00","320","0032","1291","586","295","291","10","596","1179","0","50.55","25.02"
"67","000","00","320","0032","1292","537","238","299","5","542","1152","0","47.05","20.66"
"67","000","00","320","0032","1293","499","244","255","3","502","1080","0","46.48","22.59"
"67","000","00","320","0032","1294","443","193","250","4","447","989","0","45.20","19.51"
"67","000","00","320","0033","0000","1205","568","637","7","1212","2747","0","44.12","20.68"
"67","000","00","320","0033","1307","362","171","191","3","365","824","0","44.30","20.75"
"67","000","00","320","0033","1308","439","225","214","2","441","1030","0","42.82","21.84"
"67","000","00","320","0033","1309","404","172","232","2","406","893","0","45.46","19.26"
"67","000","00","320","0034","0000","933","390","543","6","939","2206","0","42.57","17.68"
"67","000","00","320","0034","1340","443","179","264","3","446","1092","0","40.84","16.39"
"67","000","00","320","0034","1341","490","211","279","3","493","1114","0","44.25","18.94"
"67","000","00","320","0035","0000","1270","570","700","9","1279","2925","0","43.73","19.49"
"67","000","00","320","0035","1299","407","179","228","2","409","938","0","43.60","19.08"
"67","000","00","320","0035","1300","474","195","279","6","480","1072","0","44.78","18.19"
"67","000","00","320","0035","1301","389","196","193","1","390","915","0","42.62","21.42"
"67","000","00","320","0036","0000","834","338","496","8","842","1800","0","46.78","18.78"
"67","000","00","320","0036","1262","379","167","212","4","383","865","0","44.28","19.31"
"67","000","00","320","0036","1263","455","171","284","4","459","935","0","49.09","18.29"
"67","000","00","320","0037","0000","834","399","435","6","840","1924","0","43.66","20.74"
"67","000","00","320","0037","1260","446","205","241","5","451","987","0","45.69","20.77"
"67","000","00","320","0037","1261","388","194","194","1","389","937","0","41.52","20.70"
"67","000","00","320","0038","0000","1250","549","701","4","1254","2848","0","44.03","19.28"
"67","000","00","320","0038","1277","328","147","181","2","330","810","0","40.74","18.15"
"67","000","00","320","0038","1278","456","204","252","2","458","969","0","47.27","21.05"
"67","000","00","320","0038","1279","466","198","268","0","466","1069","0","43.59","18.52"
"67","000","00","320","0039","0000","1882","840","1042","9","1891","3861","0","48.98","21.76"
"67","000","00","320","0039","1288","682","297","385","4","686","1363","0","50.33","21.79"
"67","000","00","320","0039","1289","620","268","352","2","622","1219","0","51.03","21.99"
"67","000","00","320","0039","1290","580","275","305","3","583","1279","0","45.58","21.50"
"67","000","00","320","0040","0000","1563","621","942","5","1568","4399","0","35.64","14.12"
"67","000","00","320","0040","1253","559","194","365","3","562","2040","0","27.55","9.51"
"67","000","00","320","0040","1254","587","253","334","2","589","1324","0","44.49","19.11"
"67","000","00","320","0040","1255","417","174","243","0","417","1035","0","40.29","16.81"
"67","000","00","320","0041","0000","2594","1237","1357","12","2606","5808","0","44.87","21.30"
"67","000","00","320","0041","1302","528","247","281","2","530","1097","0","48.31","22.52"
"67","000","00","320","0041","1303","544","254","290","3","547","1301","0","42.04","19.52"
"67","000","00","320","0041","1304","557","261","296","2","559","1279","0","43.71","20.41"
"67","000","00","320","0041","1305","518","275","243","3","521","1169","0","44.57","23.52"
"67","000","00","320","0041","1306","447","200","247","2","449","962","0","46.67","20.79"
"67","000","00","320","0042","0000","1468","572","896","12","1480","3284","0","45.07","17.42"
"67","000","00","320","0042","1333","521","186","335","5","526","1179","0","44.61","15.78"
"67","000","00","320","0042","1334","411","177","234","4","415","1038","0","39.98","17.05"
"67","000","00","320","0042","1335","536","209","327","3","539","1067","0","50.52","19.59"
"67","000","00","320","0043","0000","2106","1077","1029","18","2124","4654","0","45.64","23.14"
"67","000","00","320","0043","1329","561","250","311","6","567","1181","0","48.01","21.17"
"67","000","00","320","0043","1330","539","288","251","6","545","1093","0","49.86","26.35"
"67","000","00","320","0043","1331","510","292","218","4","514","1211","0","42.44","24.11"
"67","000","00","320","0043","1332","496","247","249","2","498","1169","0","42.60","21.13"
"67","000","00","320","0044","0000","1133","543","590","7","1140","2522","0","45.20","21.53"
"67","000","00","320","0044","1346","526","231","295","4","530","1141","0","46.45","20.25"
"67","000","00","320","0044","1347","607","312","295","3","610","1381","0","44.17","22.59"
"67","000","00","320","0045","0000","1956","907","1049","22","1978","4275","0","46.27","21.22"
"67","000","00","320","0045","1348","499","217","282","2","501","1104","0","45.38","19.66"
"67","000","00","320","0045","1349","522","226","296","10","532","1079","0","49.30","20.95"
"67","000","00","320","0045","1350","463","245","218","4","467","1067","0","43.77","22.96"
"67","000","00","320","0045","1351","472","219","253","6","478","1025","0","46.63","21.37"
"67","000","00","330","0000","0000","47447","17542","29905","377","47824","108304","123057","44.16","16.20"
"67","000","00","330","0001","0000","823","388","435","7","830","1623","0","51.14","23.91"
"67","000","00","330","0001","1170","380","191","189","5","385","799","0","48.19","23.90"
"67","000","00","330","0001","1171","443","197","246","2","445","824","0","54.00","23.91"
"67","000","00","330","0003","0000","547","266","281","5","552","1383","0","39.91","19.23"
"67","000","00","330","0003","1172","547","266","281","5","552","1383","0","39.91","19.23"
"67","000","00","330","0004","0000","797","352","445","4","801","1753","0","45.69","20.08"
"67","000","00","330","0004","1173","430","213","217","1","431","985","0","43.76","21.62"
"67","000","00","330","0004","1174","367","139","228","3","370","768","0","48.18","18.10"
"67","000","00","330","0005","0000","1076","371","705","13","1089","2226","0","48.92","16.67"
"67","000","00","330","0005","1183","529","174","355","4","533","1117","0","47.72","15.58"
"67","000","00","330","0005","1184","547","197","350","9","556","1109","0","50.14","17.76"
"67","000","00","330","0006","0000","952","371","581","10","962","2173","0","44.27","17.07"
"67","000","00","330","0006","1185","501","182","319","4","505","1199","0","42.12","15.18"
"67","000","00","330","0006","1186","451","189","262","6","457","974","0","46.92","19.40"
"67","000","00","330","0007","0000","1248","479","769","9","1257","2697","0","46.61","17.76"
"67","000","00","330","0007","1178","424","177","247","1","425","884","0","48.08","20.02"
"67","000","00","330","0007","1179","411","147","264","3","414","889","0","46.57","16.54"
"67","000","00","330","0007","1180","413","155","258","5","418","924","0","45.24","16.77"
"67","000","00","330","0008","0000","1377","563","814","7","1384","3096","0","44.70","18.18"
"67","000","00","330","0008","1175","425","168","257","3","428","953","0","44.91","17.63"
"67","000","00","330","0008","1176","546","252","294","1","547","1173","0","46.63","21.48"
"67","000","00","330","0008","1177","406","143","263","3","409","970","0","42.16","14.74"
"67","000","00","330","0009","0000","1237","430","807","8","1245","2875","0","43.30","14.96"
"67","000","00","330","0009","1198","420","130","290","3","423","964","0","43.88","13.49"
"67","000","00","330","0009","1199","411","141","270","2","413","881","0","46.88","16.00"
"67","000","00","330","0009","1200","406","159","247","3","409","1030","0","39.71","15.44"
"67","000","00","330","0011","0000","1772","577","1195","17","1789","4140","0","43.21","13.94"
"67","000","00","330","0011","1205","414","107","307","5","419","945","0","44.34","11.32"
"67","000","00","330","0011","1206","413","169","244","2","415","947","0","43.82","17.85"
"67","000","00","330","0011","1207","492","142","350","6","498","1179","0","42.24","12.04"
"67","000","00","330","0011","1208","453","159","294","4","457","1069","0","42.75","14.87"
"67","000","00","330","0013","0000","1582","536","1046","19","1601","3510","0","45.61","15.27"
"67","000","00","330","0013","1209","460","149","311","8","468","1060","0","44.15","14.06"
"67","000","00","330","0013","1210","498","172","326","5","503","1099","0","45.77","15.65"
"67","000","00","330","0013","1211","624","215","409","6","630","1351","0","46.63","15.91"
"67","000","00","330","0014","0000","903","241","662","4","907","2071","0","43.80","11.64"
"67","000","00","330","0014","1238","476","151","325","3","479","1131","0","42.35","13.35"
"67","000","00","330","0014","1239","427","90","337","1","428","940","0","45.53","9.57"
"67","000","00","330","0015","0000","954","235","719","8","962","2143","0","44.89","10.97"
"67","000","00","330","0015","1235","453","122","331","2","455","1096","0","41.51","11.13"
"67","000","00","330","0015","1236","501","113","388","6","507","1047","0","48.42","10.79"
"67","000","00","330","0016","0000","543","111","432","3","546","1191","0","45.84","9.32"
"67","000","00","330","0016","1237","543","111","432","3","546","1191","0","45.84","9.32"
"67","000","00","330","0017","0000","1477","411","1066","10","1487","3849","0","38.63","10.68"
"67","000","00","330","0017","1240","546","123","423","6","552","1280","0","43.13","9.61"
"67","000","00","330","0017","1241","451","158","293","2","453","1303","0","34.77","12.13"
"67","000","00","330","0017","1242","480","130","350","2","482","1266","0","38.07","10.27"
"67","000","00","330","0018","0000","1099","308","791","9","1108","2639","0","41.99","11.67"
"67","000","00","330","0018","1251","439","98","341","6","445","1067","0","41.71","9.18"
"67","000","00","330","0018","1252","660","210","450","3","663","1572","0","42.18","13.36"
"67","000","00","330","0019","0000","941","267","674","7","948","2169","0","43.71","12.31"
"67","000","00","330","0019","1249","488","160","328","3","491","1137","0","43.18","14.07"
"67","000","00","330","0019","1250","453","107","346","4","457","1032","0","44.28","10.37"
"67","000","00","330","0020","0000","1061","256","805","2","1063","2471","0","43.02","10.36"
"67","000","00","330","0020","1247","525","114","411","0","525","1136","0","46.21","10.04"
"67","000","00","330","0020","1248","536","142","394","2","538","1335","0","40.30","10.64"
"67","000","00","330","0021","0000","1039","529","510","8","1047","2187","0","47.87","24.19"
"67","000","00","330","0021","1161","507","248","259","4","511","1095","0","46.67","22.65"
"67","000","00","330","0021","1162","532","281","251","4","536","1092","0","49.08","25.73"
"67","000","00","330","0022","0000","2016","878","1138","16","2032","4438","0","45.79","19.78"
"67","000","00","330","0022","1163","539","194","345","3","542","1189","0","45.58","16.32"
"67","000","00","330","0022","1164","490","234","256","3","493","997","0","49.45","23.47"
"67","000","00","330","0022","1165","386","187","199","1","387","955","0","40.52","19.58"
"67","000","00","330","0022","1166","601","263","338","9","610","1297","0","47.03","20.28"
"67","000","00","330","0023","0000","1458","667","791","10","1468","3368","0","43.59","19.80"
"67","000","00","330","0023","1158","414","178","236","2","416","904","0","46.02","19.69"
"67","000","00","330","0023","1159","505","224","281","6","511","1245","0","41.04","17.99"
"67","000","00","330","0023","1160","539","265","274","2","541","1219","0","44.38","21.74"
"67","000","00","330","0024","0000","1502","1045","457","18","1520","3347","0","45.41","31.22"
"67","000","00","330","0024","1167","449","301","148","3","452","1065","0","42.44","28.26"
"67","000","00","330","0024","1168","547","408","139","9","556","1127","0","49.33","36.20"
"67","000","00","330","0024","1169","506","336","170","6","512","1155","0","44.33","29.09"
"67","000","00","330","0025","0000","1053","519","534","6","1059","2222","0","47.66","23.36"
"67","000","00","330","0025","1181","568","345","223","2","570","1195","0","47.70","28.87"
"67","000","00","330","0025","1182","485","174","311","4","489","1027","0","47.61","16.94"
"67","000","00","330","0026","0000","1438","428","1010","8","1446","3277","0","44.13","13.06"
"67","000","00","330","0026","1215","722","213","509","4","726","1567","0","46.33","13.59"
"67","000","00","330","0026","1216","716","215","501","4","720","1710","0","42.11","12.57"
"67","000","00","330","0027","0000","1486","574","912","8","1494","3213","0","46.50","17.86"
"67","000","00","330","0027","1187","490","186","304","2","492","1116","0","44.09","16.67"
"67","000","00","330","0027","1188","479","178","301","6","485","1041","0","46.59","17.10"
"67","000","00","330","0027","1189","517","210","307","0","517","1056","0","48.96","19.89"
"67","000","00","330","0028","0000","2119","796","1323","20","2139","4948","0","43.23","16.09"
"67","000","00","330","0028","1194","527","207","320","4","531","1249","0","42.51","16.57"
"67","000","00","330","0028","1195","519","178","341","6","525","1293","0","40.60","13.77"
"67","000","00","330","0028","1196","505","191","314","5","510","1192","0","42.79","16.02"
"67","000","00","330","0028","1197","568","220","348","5","573","1214","0","47.20","18.12"
"67","000","00","330","0029","0000","929","360","569","14","943","2683","0","35.15","13.42"
"67","000","00","330","0029","1223","502","196","306","9","511","1660","0","30.78","11.81"
"67","000","00","330","0029","1224","427","164","263","5","432","1023","0","42.23","16.03"
"67","000","00","330","0030","0000","2359","883","1476","19","2378","5627","0","42.26","15.69"
"67","000","00","330","0030","1227","672","290","382","7","679","1666","0","40.76","17.41"
"67","000","00","330","0030","1228","482","171","311","2","484","1166","0","41.51","14.67"
"67","000","00","330","0030","1229","547","186","361","4","551","1282","0","42.98","14.51"
"67","000","00","330","0030","1230","658","236","422","6","664","1513","0","43.89","15.60"
"67","000","00","330","0031","0000","655","230","425","6","661","1531","0","43.17","15.02"
"67","000","00","330","0031","1231","351","126","225","3","354","903","0","39.20","13.95"
"67","000","00","330","0031","1232","304","104","200","3","307","628","0","48.89","16.56"
"67","000","00","330","0032","0000","2307","748","1559","19","2326","5014","0","46.39","14.92"
"67","000","00","330","0032","1219","573","190","383","6","579","1210","0","47.85","15.70"
"67","000","00","330","0032","1220","518","176","342","5","523","1114","0","46.95","15.80"
"67","000","00","330","0032","1221","571","176","395","4","575","1241","0","46.33","14.18"
"67","000","00","330","0032","1222","645","206","439","4","649","1449","0","44.79","14.22"
"67","000","00","330","0033","0000","1558","568","990","18","1576","3483","0","45.25","16.31"
"67","000","00","330","0033","1217","646","221","425","8","654","1472","0","44.43","15.01"
"67","000","00","330","0033","1218","912","347","565","10","922","2011","0","45.85","17.26"
"67","000","00","330","0034","0000","1932","734","1198","14","1946","4744","0","41.02","15.47"
"67","000","00","330","0034","1212","688","288","400","11","699","1720","0","40.64","16.74"
"67","000","00","330","0034","1213","620","242","378","2","622","1543","0","40.31","15.68"
"67","000","00","330","0034","1214","624","204","420","1","625","1481","0","42.20","13.77"
"67","000","00","330","0035","0000","2279","865","1414","12","2291","4978","0","46.02","17.38"
"67","000","00","330","0035","1190","466","171","295","2","468","1139","0","41.09","15.01"
"67","000","00","330","0035","1191","507","221","286","3","510","1152","0","44.27","19.18"
"67","000","00","330","0035","1192","692","258","434","3","695","1353","0","51.37","19.07"
"67","000","00","330","0035","1193","614","215","399","4","618","1334","0","46.33","16.12"
"67","000","00","330","0036","0000","688","249","439","5","693","1717","0","40.36","14.50"
"67","000","00","330","0036","1233","401","143","258","4","405","952","0","42.54","15.02"
"67","000","00","330","0036","1234","287","106","181","1","288","765","0","37.65","13.86"
"67","000","00","330","0037","0000","814","223","591","9","823","1752","0","46.97","12.73"
"67","000","00","330","0037","1245","503","117","386","5","508","1039","0","48.89","11.26"
"67","000","00","330","0037","1246","311","106","205","4","315","713","0","44.18","14.87"
"67","000","00","330","0038","0000","771","204","567","8","779","1700","0","45.82","12.00"
"67","000","00","330","0038","1243","414","100","314","5","419","963","0","43.51","10.38"
"67","000","00","330","0038","1244","357","104","253","3","360","737","0","48.85","14.11"
"67","000","00","330","0039","0000","978","349","629","7","985","2425","0","40.62","14.39"
"67","000","00","330","0039","1225","470","164","306","2","472","1193","0","39.56","13.75"
"67","000","00","330","0039","1226","508","185","323","5","513","1232","0","41.64","15.02"
"67","000","00","330","0040","0000","1677","531","1146","10","1687","3641","0","46.33","14.58"
"67","000","00","330","0040","1201","397","106","291","6","403","896","0","44.98","11.83"
"67","000","00","330","0040","1202","352","119","233","2","354","807","0","43.87","14.75"
"67","000","00","330","0040","1203","516","148","368","2","518","1025","0","50.54","14.44"
"67","000","00","330","0040","1204","412","158","254","0","412","913","0","45.13","17.31"
"67","000","00","340","0000","0000","48074","20222","27852","366","48440","109685","129057","44.16","18.44"
"67","000","00","340","0001","0000","1449","632","817","9","1458","3350","0","43.52","18.87"
"67","000","00","340","0001","0732","461","227","234","5","466","1150","0","40.52","19.74"
"67","000","00","340","0001","0733","513","209","304","2","515","1097","0","46.95","19.05"
"67","000","00","340","0001","0734","475","196","279","2","477","1103","0","43.25","17.77"
"67","000","00","340","0004","0000","931","507","424","10","941","1911","0","49.24","26.53"
"67","000","00","340","0004","0745","459","281","178","6","465","1003","0","46.36","28.02"
"67","000","00","340","0004","0746","472","226","246","4","476","908","0","52.42","24.89"
"67","000","00","340","0005","0000","1090","530","560","11","1101","2358","0","46.69","22.48"
"67","000","00","340","0005","0741","478","220","258","5","483","1160","0","41.64","18.97"
"67","000","00","340","0005","0742","612","310","302","6","618","1198","0","51.59","25.88"
"67","000","00","340","0007","0000","876","350","526","7","883","1929","0","45.78","18.14"
"67","000","00","340","0007","0750","426","170","256","2","428","931","0","45.97","18.26"
"67","000","00","340","0007","0751","450","180","270","5","455","998","0","45.59","18.04"
"67","000","00","340","0008","0000","1089","497","592","9","1098","2173","0","50.53","22.87"
"67","000","00","340","0008","0752","583","259","324","5","588","1135","0","51.81","22.82"
"67","000","00","340","0008","0753","506","238","268","4","510","1038","0","49.13","22.93"
"67","000","00","340","0018","0000","1686","566","1120","6","1692","4183","0","40.45","13.53"
"67","000","00","340","0018","0822","420","143","277","2","422","1018","0","41.45","14.05"
"67","000","00","340","0018","0823","374","105","269","3","377","1012","0","37.25","10.38"
"67","000","00","340","0018","0824","418","157","261","1","419","985","0","42.54","15.94"
"67","000","00","340","0018","0825","474","161","313","0","474","1168","0","40.58","13.78"
"67","000","00","340","0019","0000","882","428","454","5","887","1829","0","48.50","23.40"
"67","000","00","340","0019","0743","485","242","243","3","488","991","0","49.24","24.42"
"67","000","00","340","0019","0744","397","186","211","2","399","838","0","47.61","22.20"
"67","000","00","340","0020","0000","2202","889","1313","12","2214","4751","0","46.60","18.71"
"67","000","00","340","0020","0797","576","255","321","1","577","1250","0","46.16","20.40"
"67","000","00","340","0020","0798","498","222","276","2","500","1089","0","45.91","20.39"
"67","000","00","340","0020","0799","598","232","366","4","602","1298","0","46.38","17.87"
"67","000","00","340","0020","0800","530","180","350","5","535","1114","0","48.03","16.16"
"67","000","00","340","0023","0000","1380","456","924","15","1395","3128","0","44.60","14.58"
"67","000","00","340","0023","0780","497","173","324","3","500","1110","0","45.05","15.59"
"67","000","00","340","0023","0781","417","131","286","3","420","934","0","44.97","14.03"
"67","000","00","340","0023","0782","466","152","314","9","475","1084","0","43.82","14.02"
"67","000","00","340","0024","0000","1929","688","1241","15","1944","4481","0","43.38","15.35"
"67","000","00","340","0024","0783","685","232","453","5","690","1543","0","44.72","15.04"
"67","000","00","340","0024","0784","670","242","428","6","676","1545","0","43.75","15.66"
"67","000","00","340","0024","0785","574","214","360","4","578","1393","0","41.49","15.36"
"67","000","00","340","0025","0000","1442","551","891","12","1454","3391","0","42.88","16.25"
"67","000","00","340","0025","0811","439","170","269","6","445","1036","0","42.95","16.41"
"67","000","00","340","0025","0812","503","185","318","4","507","1277","0","39.70","14.49"
"67","000","00","340","0025","0813","500","196","304","2","502","1078","0","46.57","18.18"
"67","000","00","340","0026","0000","2371","928","1443","16","2387","5281","0","45.20","17.57"
"67","000","00","340","0026","0817","428","128","300","4","432","877","0","49.26","14.60"
"67","000","00","340","0026","0818","407","140","267","3","410","946","0","43.34","14.80"
"67","000","00","340","0026","0819","425","163","262","4","429","1020","0","42.06","15.98"
"67","000","00","340","0026","0820","506","237","269","0","506","1099","0","46.04","21.57"
"67","000","00","340","0026","0821","605","260","345","5","610","1339","0","45.56","19.42"
"67","000","00","340","0032","0000","655","275","380","6","661","1388","0","47.62","19.81"
"67","000","00","340","0032","0754","655","275","380","6","661","1388","0","47.62","19.81"
"67","000","00","340","0033","0000","816","398","418","9","825","1809","0","45.61","22.00"
"67","000","00","340","0033","0769","403","211","192","6","409","856","0","47.78","24.65"
"67","000","00","340","0033","0770","413","187","226","3","416","953","0","43.65","19.62"
"67","000","00","340","0038","0000","1596","711","885","11","1607","4041","0","39.77","17.59"
"67","000","00","340","0038","0735","620","285","335","4","624","1626","0","38.38","17.53"
"67","000","00","340","0038","0736","402","181","221","2","404","1037","0","38.96","17.45"
"67","000","00","340","0038","0737","574","245","329","5","579","1378","0","42.02","17.78"
"67","000","00","340","0039","0000","1355","595","760","15","1370","3012","0","45.48","19.75"
"67","000","00","340","0039","0755","671","325","346","10","681","1498","0","45.46","21.70"
"67","000","00","340","0039","0756","684","270","414","5","689","1514","0","45.51","17.83"
"67","000","00","340","0040","0000","1903","809","1094","14","1917","4329","0","44.28","18.69"
"67","000","00","340","0040","0793","505","200","305","3","508","1159","0","43.83","17.26"
"67","000","00","340","0040","0794","488","201","287","7","495","1121","0","44.16","17.93"
"67","000","00","340","0040","0795","508","223","285","1","509","1141","0","44.61","19.54"
"67","000","00","340","0040","0796","402","185","217","3","405","908","0","44.60","20.37"
"67","000","00","340","0041","0000","1326","514","812","8","1334","2933","0","45.48","17.52"
"67","000","00","340","0041","0805","472","190","282","1","473","1015","0","46.60","18.72"
"67","000","00","340","0041","0806","430","140","290","1","431","938","0","45.95","14.93"
"67","000","00","340","0041","0807","424","184","240","6","430","980","0","43.88","18.78"
"67","000","00","340","0042","0000","1548","476","1072","13","1561","3603","0","43.33","13.21"
"67","000","00","340","0042","0814","552","164","388","5","557","1249","0","44.60","13.13"
"67","000","00","340","0042","0815","540","177","363","4","544","1179","0","46.14","15.01"
"67","000","00","340","0042","0816","456","135","321","4","460","1175","0","39.15","11.49"
"67","000","00","340","0043","0000","1646","603","1043","13","1659","3566","0","46.52","16.91"
"67","000","00","340","0043","0826","546","191","355","4","550","1149","0","47.87","16.62"
"67","000","00","340","0043","0827","552","231","321","3","555","1268","0","43.77","18.22"
"67","000","00","340","0043","0828","548","181","367","6","554","1149","0","48.22","15.75"
"67","000","00","340","0044","0000","1708","1071","637","19","1727","3781","0","45.68","28.33"
"67","000","00","340","0044","0747","535","267","268","5","540","1193","0","45.26","22.38"
"67","000","00","340","0044","0748","583","450","133","8","591","1336","0","44.24","33.68"
"67","000","00","340","0044","0749","590","354","236","6","596","1252","0","47.60","28.27"
"67","000","00","340","0045","0000","1541","651","890","8","1549","3378","0","45.86","19.27"
"67","000","00","340","0045","0738","576","251","325","1","577","1275","0","45.25","19.69"
"67","000","00","340","0045","0739","483","200","283","4","487","1058","0","46.03","18.90"
"67","000","00","340","0045","0740","482","200","282","3","485","1045","0","46.41","19.14"
"67","000","00","340","0046","0000","2194","975","1219","16","2210","5163","0","42.80","18.88"
"67","000","00","340","0046","0757","391","213","178","1","392","989","0","39.64","21.54"
"67","000","00","340","0046","0758","472","264","208","5","477","1047","0","45.56","25.21"
"67","000","00","340","0046","0759","399","152","247","2","401","942","0","42.57","16.14"
"67","000","00","340","0046","0760","451","178","273","4","455","1038","0","43.83","17.15"
"67","000","00","340","0046","0761","481","168","313","4","485","1147","0","42.28","14.65"
"67","000","00","340","0047","0000","1593","620","973","16","1609","3826","0","42.05","16.20"
"67","000","00","340","0047","0776","377","142","235","9","386","924","0","41.77","15.37"
"67","000","00","340","0047","0777","371","139","232","4","375","831","0","45.13","16.73"
"67","000","00","340","0047","0778","401","173","228","0","401","923","0","43.45","18.74"
"67","000","00","340","0047","0779","444","166","278","3","447","1148","0","38.94","14.46"
"67","000","00","340","0048","0000","2032","1213","819","21","2053","4747","0","43.25","25.55"
"67","000","00","340","0048","0762","546","378","168","6","552","1284","0","42.99","29.44"
"67","000","00","340","0048","0763","437","321","116","8","445","1034","0","43.04","31.04"
"67","000","00","340","0048","0764","541","330","211","2","543","1318","0","41.20","25.04"
"67","000","00","340","0048","0765","508","184","324","5","513","1111","0","46.17","16.56"
"67","000","00","340","0049","0000","1266","532","734","8","1274","2929","0","43.50","18.16"
"67","000","00","340","0049","0766","409","157","252","1","410","966","0","42.44","16.25"
"67","000","00","340","0049","0767","457","193","264","3","460","993","0","46.32","19.44"
"67","000","00","340","0049","0768","400","182","218","4","404","970","0","41.65","18.76"
"67","000","00","340","0050","0000","1127","431","696","8","1135","2655","0","42.75","16.23"
"67","000","00","340","0050","0774","557","192","365","6","563","1250","0","45.04","15.36"
"67","000","00","340","0050","0775","570","239","331","2","572","1405","0","40.71","17.01"
"67","000","00","340","0051","0000","1464","555","909","8","1472","3987","0","36.92","13.92"
"67","000","00","340","0051","0771","537","191","346","3","540","1251","0","43.17","15.27"
"67","000","00","340","0051","0772","503","188","315","5","508","1230","0","41.30","15.28"
"67","000","00","340","0051","0773","424","176","248","0","424","1506","0","28.15","11.69"
"67","000","00","340","0052","0000","1568","624","944","6","1574","3631","0","43.35","17.19"
"67","000","00","340","0052","0786","470","194","276","3","473","1081","0","43.76","17.95"
"67","000","00","340","0052","0787","675","274","401","2","677","1560","0","43.40","17.56"
"67","000","00","340","0052","0788","423","156","267","1","424","990","0","42.83","15.76"
"67","000","00","340","0053","0000","1951","822","1129","15","1966","4418","0","44.50","18.61"
"67","000","00","340","0053","0789","432","185","247","5","437","980","0","44.59","18.88"
"67","000","00","340","0053","0790","480","186","294","3","483","1137","0","42.48","16.36"
"67","000","00","340","0053","0791","511","221","290","1","512","1102","0","46.46","20.05"
"67","000","00","340","0053","0792","528","230","298","6","534","1199","0","44.54","19.18"
"67","000","00","340","0054","0000","1111","380","731","9","1120","2467","0","45.40","15.40"
"67","000","00","340","0054","0801","554","200","354","5","559","1343","0","41.62","14.89"
"67","000","00","340","0054","0802","557","180","377","4","561","1124","0","49.91","16.01"
"67","000","00","340","0055","0000","1018","436","582","6","1024","2258","0","45.35","19.31"
"67","000","00","340","0055","0803","484","225","259","1","485","1060","0","45.75","21.23"
"67","000","00","340","0055","0804","534","211","323","5","539","1198","0","44.99","17.61"
"67","000","00","340","0056","0000","1329","509","820","10","1339","2999","0","44.65","16.97"
"67","000","00","340","0056","0808","489","194","295","4","493","1033","0","47.73","18.78"
"67","000","00","340","0056","0809","400","168","232","4","404","936","0","43.16","17.95"
"67","000","00","340","0056","0810","440","147","293","2","442","1030","0","42.91","14.27"
"67","000","00","350","0000","0000","63589","21057","42532","528","64117","163001","196238","39.34","12.92"
"67","000","00","350","0001","0000","1137","407","730","7","1144","2798","0","40.89","14.55"
"67","000","00","350","0001","0591","550","193","357","4","554","1403","0","39.49","13.76"
"67","000","00","350","0001","0592","587","214","373","3","590","1395","0","42.29","15.34"
"67","000","00","350","0002","0000","1905","691","1214","22","1927","4730","0","40.74","14.61"
"67","000","00","350","0002","0605","448","162","286","11","459","1194","0","38.44","13.57"
"67","000","00","350","0002","0606","465","161","304","4","469","1181","0","39.71","13.63"
"67","000","00","350","0002","0607","523","184","339","6","529","1185","0","44.64","15.53"
"67","000","00","350","0002","0608","469","184","285","1","470","1170","0","40.17","15.73"
"67","000","00","350","0003","0000","1795","619","1176","15","1810","4668","0","38.77","13.26"
"67","000","00","350","0003","0593","449","164","285","7","456","1080","0","42.22","15.19"
"67","000","00","350","0003","0594","504","169","335","4","508","1247","0","40.74","13.55"
"67","000","00","350","0003","0595","407","131","276","2","409","1167","0","35.05","11.23"
"67","000","00","350","0003","0596","435","155","280","2","437","1174","0","37.22","13.20"
"67","000","00","350","0004","0000","1973","673","1300","18","1991","5017","0","39.69","13.41"
"67","000","00","350","0004","0597","490","148","342","3","493","1196","0","41.22","12.37"
"67","000","00","350","0004","0598","554","170","384","4","558","1371","0","40.70","12.40"
"67","000","00","350","0004","0599","508","204","304","8","516","1310","0","39.39","15.57"
"67","000","00","350","0004","0600","421","151","270","3","424","1140","0","37.19","13.25"
"67","000","00","350","0005","0000","1819","615","1204","8","1827","4446","0","41.09","13.83"
"67","000","00","350","0005","0601","465","162","303","3","468","1206","0","38.81","13.43"
"67","000","00","350","0005","0602","443","156","287","2","445","1100","0","40.45","14.18"
"67","000","00","350","0005","0603","475","125","350","2","477","1137","0","41.95","10.99"
"67","000","00","350","0005","0604","436","172","264","1","437","1003","0","43.57","17.15"
"67","000","00","350","0006","0000","1180","376","804","10","1190","2762","0","43.08","13.61"
"67","000","00","350","0006","0634","610","212","398","4","614","1454","0","42.23","14.58"
"67","000","00","350","0006","0635","570","164","406","6","576","1308","0","44.04","12.54"
"67","000","00","350","0007","0000","1442","484","958","10","1452","3488","0","41.63","13.88"
"67","000","00","350","0007","0627","507","147","360","3","510","1159","0","44.00","12.68"
"67","000","00","350","0007","0628","467","150","317","5","472","1197","0","39.43","12.53"
"67","000","00","350","0007","0629","468","187","281","2","470","1132","0","41.52","16.52"
"67","000","00","350","0008","0000","1864","581","1283","24","1888","4518","0","41.79","12.86"
"67","000","00","350","0008","0614","423","153","270","4","427","1187","0","35.97","12.89"
"67","000","00","350","0008","0615","452","153","299","4","456","1057","0","43.14","14.47"
"67","000","00","350","0008","0616","486","103","383","11","497","1141","0","43.56","9.03"
"67","000","00","350","0008","0617","503","172","331","5","508","1133","0","44.84","15.18"
"67","000","00","350","0009","0000","2499","834","1665","22","2521","6006","0","41.97","13.89"
"67","000","00","350","0009","0618","530","157","373","3","533","1198","0","44.49","13.11"
"67","000","00","350","0009","0619","494","168","326","6","500","1327","0","37.68","12.66"
"67","000","00","350","0009","0620","503","162","341","7","510","1258","0","40.54","12.88"
"67","000","00","350","0009","0621","498","179","319","3","501","1103","0","45.42","16.23"
"67","000","00","350","0009","0622","474","168","306","3","477","1120","0","42.59","15.00"
"67","000","00","350","0010","0000","2498","906","1592","15","2513","6119","0","41.07","14.81"
"67","000","00","350","0010","0609","457","170","287","4","461","1230","0","37.48","13.82"
"67","000","00","350","0010","0610","574","203","371","4","578","1421","0","40.68","14.29"
"67","000","00","350","0010","0611","559","229","330","2","561","1297","0","43.25","17.66"
"67","000","00","350","0010","0612","439","128","311","1","440","1090","0","40.37","11.74"
"67","000","00","350","0010","0613","469","176","293","4","473","1081","0","43.76","16.28"
"67","000","00","350","0011","0000","866","313","553","6","872","2171","0","40.17","14.42"
"67","000","00","350","0011","0654","493","181","312","2","495","1193","0","41.49","15.17"
"67","000","00","350","0011","0655","373","132","241","4","377","978","0","38.55","13.50"
"67","000","00","350","0012","0000","736","217","519","9","745","1811","0","41.14","11.98"
"67","000","00","350","0012","0662","371","104","267","5","376","938","0","40.09","11.09"
"67","000","00","350","0012","0663","365","113","252","4","369","873","0","42.27","12.94"
"67","000","00","350","0013","0000","1838","586","1252","9","1847","4706","0","39.25","12.45"
"67","000","00","350","0013","0656","499","162","337","1","500","1373","0","36.42","11.80"
"67","000","00","350","0013","0657","412","114","298","3","415","1040","0","39.90","10.96"
"67","000","00","350","0013","0658","451","154","297","3","454","1106","0","41.05","13.92"
"67","000","00","350","0013","0659","476","156","320","2","478","1187","0","40.27","13.14"
"67","000","00","350","0014","0000","460","140","320","2","462","1148","0","40.24","12.20"
"67","000","00","350","0014","0660","460","140","320","2","462","1148","0","40.24","12.20"
"67","000","00","350","0015","0000","2004","622","1382","7","2011","5528","0","36.38","11.25"
"67","000","00","350","0015","0647","409","122","287","1","410","1307","0","31.37","9.33"
"67","000","00","350","0015","0648","537","158","379","0","537","1446","0","37.14","10.93"
"67","000","00","350","0015","0649","519","173","346","4","523","1356","0","38.57","12.76"
"67","000","00","350","0015","0650","539","169","370","2","541","1419","0","38.13","11.91"
"67","000","00","350","0016","0000","1091","384","707","6","1097","2803","0","39.14","13.70"
"67","000","00","350","0016","0677","605","210","395","6","611","1502","0","40.68","13.98"
"67","000","00","350","0016","0678","486","174","312","0","486","1301","0","37.36","13.37"
"67","000","00","350","0017","0000","1006","333","673","4","1010","2365","0","42.71","14.08"
"67","000","00","350","0017","0712","540","173","367","1","541","1290","0","41.94","13.41"
"67","000","00","350","0017","0713","466","160","306","3","469","1075","0","43.63","14.88"
"67","000","00","350","0018","0000","2674","948","1726","24","2698","7823","0","34.49","12.12"
"67","000","00","350","0018","0679","489","175","314","4","493","1371","0","35.96","12.76"
"67","000","00","350","0018","0680","489","172","317","3","492","1272","0","38.68","13.52"
"67","000","00","350","0018","0681","451","152","299","7","458","1270","0","36.06","11.97"
"67","000","00","350","0018","0682","439","146","293","3","442","1342","0","32.94","10.88"
"67","000","00","350","0018","0683","527","197","330","4","531","1323","0","40.14","14.89"
"67","000","00","350","0018","0684","279","106","173","3","282","1245","0","22.65","8.51"
"67","000","00","350","0019","0000","647","285","362","12","659","1587","0","41.52","17.96"
"67","000","00","350","0019","0730","287","121","166","6","293","796","0","36.81","15.20"
"67","000","00","350","0019","0731","360","164","196","6","366","791","0","46.27","20.73"
"67","000","00","350","0020","0000","1714","547","1167","19","1733","4730","0","36.64","11.56"
"67","000","00","350","0020","0685","416","121","295","6","422","1260","0","33.49","9.60"
"67","000","00","350","0020","0686","394","105","289","4","398","1105","0","36.02","9.50"
"67","000","00","350","0020","0687","443","144","299","6","449","1135","0","39.56","12.69"
"67","000","00","350","0020","0688","461","177","284","3","464","1230","0","37.72","14.39"
"67","000","00","350","0021","0000","1149","367","782","9","1158","3591","0","32.25","10.22"
"67","000","00","350","0021","0674","421","133","288","4","425","1329","0","31.98","10.01"
"67","000","00","350","0021","0675","395","132","263","2","397","1283","0","30.94","10.29"
"67","000","00","350","0021","0676","333","102","231","3","336","979","0","34.32","10.42"
"67","000","00","350","0022","0000","1194","401","793","9","1203","3358","0","35.82","11.94"
"67","000","00","350","0022","0669","342","95","247","0","342","1040","0","32.88","9.13"
"67","000","00","350","0022","0670","366","119","247","5","371","1026","0","36.16","11.60"
"67","000","00","350","0022","0671","486","187","299","4","490","1292","0","37.93","14.47"
"67","000","00","350","0023","0000","713","233","480","8","721","2107","0","34.22","11.06"
"67","000","00","350","0023","0672","306","108","198","2","308","991","0","31.08","10.90"
"67","000","00","350","0023","0673","407","125","282","6","413","1116","0","37.01","11.20"
"67","000","00","350","0024","0000","444","141","303","6","450","1031","0","43.65","13.68"
"67","000","00","350","0024","0668","444","141","303","6","450","1031","0","43.65","13.68"
"67","000","00","350","0025","0000","645","161","484","8","653","1831","0","35.66","8.79"
"67","000","00","350","0025","0664","349","98","251","3","352","866","0","40.65","11.32"
"67","000","00","350","0025","0665","296","63","233","5","301","965","0","31.19","6.53"
"67","000","00","350","0026","0000","794","240","554","9","803","2484","0","32.33","9.66"
"67","000","00","350","0026","0666","369","132","237","4","373","1240","0","30.08","10.65"
"67","000","00","350","0026","0667","425","108","317","5","430","1244","0","34.57","8.68"
"67","000","00","350","0027","0000","526","179","347","3","529","1572","0","33.65","11.39"
"67","000","00","350","0027","0714","281","94","187","1","282","812","0","34.73","11.58"
"67","000","00","350","0027","0715","245","85","160","2","247","760","0","32.50","11.18"
"67","000","00","350","0028","0000","587","154","433","9","596","1569","0","37.99","9.82"
"67","000","00","350","0028","0721","344","81","263","4","348","905","0","38.45","8.95"
"67","000","00","350","0028","0722","243","73","170","5","248","664","0","37.35","10.99"
"67","000","00","350","0029","0000","400","152","248","5","405","1050","0","38.57","14.48"
"67","000","00","350","0029","0723","400","152","248","5","405","1050","0","38.57","14.48"
"67","000","00","350","0030","0000","1136","347","789","15","1151","3209","0","35.87","10.81"
"67","000","00","350","0030","0716","335","76","259","2","337","845","0","39.88","8.99"
"67","000","00","350","0030","0717","330","115","215","4","334","1010","0","33.07","11.39"
"67","000","00","350","0030","0718","471","156","315","9","480","1354","0","35.45","11.52"
"67","000","00","350","0031","0000","505","134","371","6","511","1442","0","35.44","9.29"
"67","000","00","350","0031","0720","505","134","371","6","511","1442","0","35.44","9.29"
"67","000","00","350","0032","0000","452","135","317","4","456","1507","0","30.26","8.96"
"67","000","00","350","0032","0719","452","135","317","4","456","1507","0","30.26","8.96"
"67","000","00","350","0033","0000","505","146","359","7","512","1292","0","39.63","11.30"
"67","000","00","350","0033","0724","237","60","177","3","240","597","0","40.20","10.05"
"67","000","00","350","0033","0725","268","86","182","4","272","695","0","39.14","12.37"
"67","000","00","350","0035","0000","280","116","164","5","285","888","0","32.09","13.06"
"67","000","00","350","0035","0727","280","116","164","5","285","888","0","32.09","13.06"
"67","000","00","350","0036","0000","741","264","477","2","743","1882","0","39.48","14.03"
"67","000","00","350","0036","0728","410","172","238","1","411","1021","0","40.25","16.85"
"67","000","00","350","0036","0729","331","92","239","1","332","861","0","38.56","10.69"
"67","000","00","350","0037","0000","893","263","630","5","898","2122","0","42.32","12.39"
"67","000","00","350","0037","0625","461","140","321","2","463","1145","0","40.44","12.23"
"67","000","00","350","0037","0626","432","123","309","3","435","977","0","44.52","12.59"
"67","000","00","350","0038","0000","1208","413","795","16","1224","2749","0","44.53","15.02"
"67","000","00","350","0038","0623","640","177","463","4","644","1394","0","46.20","12.70"
"67","000","00","350","0038","0624","568","236","332","12","580","1355","0","42.80","17.42"
"67","000","00","350","0039","0000","1883","678","1205","13","1896","4392","0","43.17","15.44"
"67","000","00","350","0039","0630","473","161","312","3","476","1089","0","43.71","14.78"
"67","000","00","350","0039","0631","510","187","323","4","514","1177","0","43.67","15.89"
"67","000","00","350","0039","0632","443","142","301","2","445","1073","0","41.47","13.23"
"67","000","00","350","0039","0633","457","188","269","4","461","1053","0","43.78","17.85"
"67","000","00","350","0040","0000","1242","377","865","7","1249","3015","0","41.43","12.50"
"67","000","00","350","0040","0692","434","142","292","2","436","1013","0","43.04","14.02"
"67","000","00","350","0040","0693","416","113","303","4","420","1038","0","40.46","10.89"
"67","000","00","350","0040","0694","392","122","270","1","393","964","0","40.77","12.66"
"67","000","00","350","0041","0000","1798","531","1267","13","1811","4278","0","42.33","12.41"
"67","000","00","350","0041","0695","591","173","418","4","595","1351","0","44.04","12.81"
"67","000","00","350","0041","0696","580","170","410","4","584","1418","0","41.18","11.99"
"67","000","00","350","0041","0697","627","188","439","5","632","1509","0","41.88","12.46"
"67","000","00","350","0042","0000","1560","442","1118","12","1572","3596","0","43.72","12.29"
"67","000","00","350","0042","0709","504","152","352","6","510","1151","0","44.31","13.21"
"67","000","00","350","0042","0710","522","154","368","2","524","1217","0","43.06","12.65"
"67","000","00","350","0042","0711","534","136","398","4","538","1228","0","43.81","11.07"
"67","000","00","350","0043","0000","1663","609","1054","7","1670","4402","0","37.94","13.83"
"67","000","00","350","0043","0636","628","239","389","2","630","1551","0","40.62","15.41"
"67","000","00","350","0043","0637","528","193","335","3","531","1483","0","35.81","13.01"
"67","000","00","350","0043","0638","507","177","330","2","509","1368","0","37.21","12.94"
"67","000","00","350","0044","0000","1616","565","1051","14","1630","4025","0","40.50","14.04"
"67","000","00","350","0044","0639","417","149","268","4","421","1057","0","39.83","14.10"
"67","000","00","350","0044","0640","474","159","315","4","478","1061","0","45.05","14.99"
"67","000","00","350","0044","0641","305","103","202","3","308","944","0","32.63","10.91"
"67","000","00","350","0044","0642","420","154","266","3","423","963","0","43.93","15.99"
"67","000","00","350","0045","0000","1907","580","1327","14","1921","4467","0","43.00","12.98"
"67","000","00","350","0045","0643","415","105","310","2","417","1115","0","37.40","9.42"
"67","000","00","350","0045","0644","480","149","331","4","484","1098","0","44.08","13.57"
"67","000","00","350","0045","0645","550","165","385","4","554","1253","0","44.21","13.17"
"67","000","00","350","0045","0646","462","161","301","4","466","1001","0","46.55","16.08"
"67","000","00","350","0046","0000","1624","591","1033","9","1633","3943","0","41.42","14.99"
"67","000","00","350","0046","0700","443","155","288","2","445","980","0","45.41","15.82"
"67","000","00","350","0046","0701","393","137","256","2","395","1034","0","38.20","13.25"
"67","000","00","350","0046","0702","406","157","249","4","410","999","0","41.04","15.72"
"67","000","00","350","0046","0703","382","142","240","1","383","930","0","41.18","15.27"
"67","000","00","350","0047","0000","1258","378","880","11","1269","3321","0","38.21","11.38"
"67","000","00","350","0047","0689","380","117","263","4","384","974","0","39.43","12.01"
"67","000","00","350","0047","0690","465","140","325","6","471","1227","0","38.39","11.41"
"67","000","00","350","0047","0691","413","121","292","1","414","1120","0","36.96","10.80"
"67","000","00","350","0048","0000","579","196","383","4","583","1480","0","39.39","13.24"
"67","000","00","350","0048","0661","579","196","383","4","583","1480","0","39.39","13.24"
"67","000","00","350","0049","0000","1143","377","766","13","1156","2718","0","42.53","13.87"
"67","000","00","350","0049","0698","482","148","334","4","486","1182","0","41.12","12.52"
"67","000","00","350","0049","0699","661","229","432","9","670","1536","0","43.62","14.91"
"67","000","00","350","0050","0000","2063","655","1408","20","2083","5393","0","38.62","12.15"
"67","000","00","350","0050","0704","350","84","266","4","354","1006","0","35.19","8.35"
"67","000","00","350","0050","0705","465","150","315","4","469","1235","0","37.98","12.15"
"67","000","00","350","0050","0706","448","161","287","6","454","1138","0","39.89","14.15"
"67","000","00","350","0050","0707","389","118","271","0","389","1094","0","35.56","10.79"
"67","000","00","350","0050","0708","411","142","269","6","417","920","0","45.33","15.43"
"67","000","00","350","0051","0000","1453","485","968","10","1463","3607","0","40.56","13.45"
"67","000","00","350","0051","0651","425","173","252","3","428","1076","0","39.78","16.08"
"67","000","00","350","0051","0652","502","164","338","2","504","1217","0","41.41","13.48"
"67","000","00","350","0051","0653","526","148","378","5","531","1314","0","40.41","11.26"
"67","000","00","350","0052","0000","480","186","294","6","486","1456","0","33.38","12.77"
"67","000","00","350","0052","0726","480","186","294","6","486","1456","0","33.38","12.77"
"67","000","00","360","0000","0000","23011","9284","13727","161","23172","56716","67297","40.86","16.37"
"67","000","00","360","0002","0000","820","374","446","9","829","2012","0","41.20","18.59"
"67","000","00","360","0002","1099","323","132","191","3","326","895","0","36.42","14.75"
"67","000","00","360","0002","1100","497","242","255","6","503","1117","0","45.03","21.67"
"67","000","00","360","0004","0000","197","72","125","3","200","435","0","45.98","16.55"
"67","000","00","360","0004","1091","197","72","125","3","200","435","0","45.98","16.55"
"67","000","00","360","0005","0000","2093","824","1269","16","2109","5116","0","41.22","16.11"
"67","000","00","360","0005","1061","478","210","268","3","481","1243","0","38.70","16.89"
"67","000","00","360","0005","1062","514","198","316","4","518","1165","0","44.46","17.00"
"67","000","00","360","0005","1063","529","195","334","5","534","1312","0","40.70","14.86"
"67","000","00","360","0005","1064","572","221","351","4","576","1396","0","41.26","15.83"
"67","000","00","360","0006","0000","1679","693","986","11","1690","4196","0","40.28","16.52"
"67","000","00","360","0006","1065","564","246","318","4","568","1458","0","38.96","16.87"
"67","000","00","360","0006","1066","553","216","337","2","555","1385","0","40.07","15.60"
"67","000","00","360","0006","1067","562","231","331","5","567","1353","0","41.91","17.07"
"67","000","00","360","0007","0000","2013","812","1201","14","2027","4827","0","41.99","16.82"
"67","000","00","360","0007","1068","532","226","306","5","537","1199","0","44.79","18.85"
"67","000","00","360","0007","1069","461","169","292","2","463","1233","0","37.55","13.71"
"67","000","00","360","0007","1070","500","217","283","0","500","1210","0","41.32","17.93"
"67","000","00","360","0007","1071","520","200","320","7","527","1185","0","44.47","16.88"
"67","000","00","360","0008","0000","2720","1111","1609","11","2731","7232","0","37.76","15.36"
"67","000","00","360","0008","1072","487","188","299","3","490","1482","0","33.06","12.69"
"67","000","00","360","0008","1073","574","247","327","3","577","1402","0","41.16","17.62"
"67","000","00","360","0008","1074","477","186","291","2","479","1393","0","34.39","13.35"
"67","000","00","360","0008","1075","567","226","341","2","569","1476","0","38.55","15.31"
"67","000","00","360","0008","1076","615","264","351","1","616","1479","0","41.65","17.85"
"67","000","00","360","0009","0000","2252","967","1285","16","2268","5000","0","45.36","19.34"
"67","000","00","360","0009","1057","524","204","320","3","527","1130","0","46.64","18.05"
"67","000","00","360","0009","1058","509","216","293","3","512","1153","0","44.41","18.73"
"67","000","00","360","0009","1059","584","251","333","3","587","1353","0","43.39","18.55"
"67","000","00","360","0009","1060","635","296","339","7","642","1364","0","47.07","21.70"
"67","000","00","360","0010","0000","3058","1254","1804","20","3078","7593","0","40.54","16.52"
"67","000","00","360","0010","1085","604","221","383","5","609","1345","0","45.28","16.43"
"67","000","00","360","0010","1086","566","250","316","1","567","1244","0","45.58","20.10"
"67","000","00","360","0010","1087","503","228","275","6","509","1252","0","40.65","18.21"
"67","000","00","360","0010","1088","555","248","307","4","559","1307","0","42.77","18.97"
"67","000","00","360","0010","1089","452","172","280","4","456","1202","0","37.94","14.31"
"67","000","00","360","0010","1090","378","135","243","0","378","1243","0","30.41","10.86"
"67","000","00","360","0011","0000","2963","1329","1634","19","2982","7951","0","37.50","16.71"
"67","000","00","360","0011","1079","480","193","287","5","485","1364","0","35.56","14.15"
"67","000","00","360","0011","1080","536","247","289","4","540","1300","0","41.54","19.00"
"67","000","00","360","0011","1081","506","250","256","2","508","1333","0","38.11","18.75"
"67","000","00","360","0011","1082","461","207","254","3","464","1286","0","36.08","16.10"
"67","000","00","360","0011","1083","526","225","301","1","527","1379","0","38.22","16.32"
"67","000","00","360","0011","1084","454","207","247","4","458","1289","0","35.53","16.06"
"67","000","00","360","0012","0000","1310","500","810","6","1316","3031","0","43.42","16.50"
"67","000","00","360","0012","1077","654","257","397","5","659","1510","0","43.64","17.02"
"67","000","00","360","0012","1078","656","243","413","1","657","1521","0","43.20","15.98"
"67","000","00","360","0015","0000","1445","517","928","13","1458","3301","0","44.17","15.66"
"67","000","00","360","0015","1092","756","290","466","7","763","1666","0","45.80","17.41"
"67","000","00","360","0015","1093","689","227","462","6","695","1635","0","42.51","13.88"
"67","000","00","360","0016","0000","1385","468","917","10","1395","3261","0","42.78","14.35"
"67","000","00","360","0016","1094","486","200","286","5","491","1105","0","44.43","18.10"
"67","000","00","360","0016","1095","433","136","297","2","435","1093","0","39.80","12.44"
"67","000","00","360","0016","1096","466","132","334","3","469","1063","0","44.12","12.42"
"67","000","00","360","0017","0000","1076","363","713","13","1089","2761","0","39.44","13.15"
"67","000","00","360","0017","1097","552","199","353","9","561","1383","0","40.56","14.39"
"67","000","00","360","0017","1098","524","164","360","4","528","1378","0","38.32","11.90"
"67","000","00","370","0000","0000","28895","10919","17976","215","29110","64466","78163","45.16","16.94"
"67","000","00","370","0005","0000","1661","585","1076","8","1669","3653","0","45.69","16.01"
"67","000","00","370","0005","1101","543","186","357","2","545","1290","0","42.25","14.42"
"67","000","00","370","0005","1102","596","231","365","4","600","1182","0","50.76","19.54"
"67","000","00","370","0005","1103","522","168","354","2","524","1181","0","44.37","14.23"
"67","000","00","370","0007","0000","1329","549","780","8","1337","3036","0","44.04","18.08"
"67","000","00","370","0007","1104","674","292","382","4","678","1552","0","43.69","18.81"
"67","000","00","370","0007","1105","655","257","398","4","659","1484","0","44.41","17.32"
"67","000","00","370","0009","0000","1233","553","680","14","1247","2678","0","46.56","20.65"
"67","000","00","370","0009","1106","594","247","347","11","605","1315","0","46.01","18.78"
"67","000","00","370","0009","1107","639","306","333","3","642","1363","0","47.10","22.45"
"67","000","00","370","0011","0000","1002","342","660","8","1010","2406","0","41.98","14.21"
"67","000","00","370","0011","1108","509","163","346","5","514","1251","0","41.09","13.03"
"67","000","00","370","0011","1109","493","179","314","3","496","1155","0","42.94","15.50"
"67","000","00","370","0016","0000","1130","431","699","14","1144","2516","0","45.47","17.13"
"67","000","00","370","0016","1110","572","230","342","10","582","1280","0","45.47","17.97"
"67","000","00","370","0016","1111","558","201","357","4","562","1236","0","45.47","16.26"
"67","000","00","370","0022","0000","1470","503","967","12","1482","3287","0","45.09","15.30"
"67","000","00","370","0022","1112","331","116","215","2","333","762","0","43.70","15.22"
"67","000","00","370","0022","1113","419","122","297","6","425","936","0","45.41","13.03"
"67","000","00","370","0022","1114","369","134","235","4","373","797","0","46.80","16.81"
"67","000","00","370","0022","1115","351","131","220","0","351","792","0","44.32","16.54"
"67","000","00","370","0025","0000","1619","560","1059","14","1633","3479","0","46.94","16.10"
"67","000","00","370","0025","1116","465","147","318","4","469","1026","0","45.71","14.33"
"67","000","00","370","0025","1117","542","190","352","3","545","1149","0","47.43","16.54"
"67","000","00","370","0025","1118","612","223","389","7","619","1304","0","47.47","17.10"
"67","000","00","370","0031","0000","1119","441","678","14","1133","2515","0","45.05","17.53"
"67","000","00","370","0031","1119","572","216","356","2","574","1289","0","44.53","16.76"
"67","000","00","370","0031","1120","547","225","322","12","559","1226","0","45.60","18.35"
"67","000","00","370","0033","0000","2632","1105","1527","22","2654","5665","0","46.85","19.51"
"67","000","00","370","0033","1121","713","316","397","5","718","1410","0","50.92","22.41"
"67","000","00","370","0033","1122","649","249","400","6","655","1394","0","46.99","17.86"
"67","000","00","370","0033","1123","693","313","380","4","697","1615","0","43.16","19.38"
"67","000","00","370","0033","1124","577","227","350","7","584","1246","0","46.87","18.22"
"67","000","00","370","0034","0000","2335","935","1400","10","2345","4932","0","47.55","18.96"
"67","000","00","370","0034","1125","623","248","375","3","626","1306","0","47.93","18.99"
"67","000","00","370","0034","1126","573","225","348","2","575","1190","0","48.32","18.91"
"67","000","00","370","0034","1127","553","212","341","4","557","1193","0","46.69","17.77"
"67","000","00","370","0034","1128","586","250","336","1","587","1243","0","47.22","20.11"
"67","000","00","370","0039","0000","1648","584","1064","13","1661","3667","0","45.30","15.93"
"67","000","00","370","0039","1129","364","149","215","3","367","870","0","42.18","17.13"
"67","000","00","370","0039","1130","397","117","280","5","402","863","0","46.58","13.56"
"67","000","00","370","0039","1131","450","178","272","3","453","1038","0","43.64","17.15"
"67","000","00","370","0039","1132","437","140","297","2","439","896","0","49.00","15.63"
"67","000","00","370","0040","0000","1374","488","886","3","1377","3143","0","43.81","15.53"
"67","000","00","370","0040","1133","482","174","308","0","482","1100","0","43.82","15.82"
"67","000","00","370","0040","1134","484","172","312","1","485","1073","0","45.20","16.03"
"67","000","00","370","0040","1135","408","142","266","2","410","970","0","42.27","14.64"
"67","000","00","370","0041","0000","1180","535","645","7","1187","2478","0","47.90","21.59"
"67","000","00","370","0041","1136","597","310","287","5","602","1252","0","48.08","24.76"
"67","000","00","370","0041","1137","583","225","358","2","585","1226","0","47.72","18.35"
"67","000","00","370","0042","0000","1342","566","776","13","1355","3070","0","44.14","18.44"
"67","000","00","370","0042","1138","480","217","263","2","482","1116","0","43.19","19.44"
"67","000","00","370","0042","1139","472","197","275","6","478","1067","0","44.80","18.46"
"67","000","00","370","0042","1140","390","152","238","5","395","887","0","44.53","17.14"
"67","000","00","370","0043","0000","875","320","555","5","880","1972","0","44.62","16.23"
"67","000","00","370","0043","1141","436","142","294","1","437","1061","0","41.19","13.38"
"67","000","00","370","0043","1142","439","178","261","4","443","911","0","48.63","19.54"
"67","000","00","370","0044","0000","1568","491","1077","18","1586","3846","0","41.24","12.77"
"67","000","00","370","0044","1143","480","157","323","6","486","1403","0","34.64","11.19"
"67","000","00","370","0044","1144","519","138","381","6","525","1199","0","43.79","11.51"
"67","000","00","370","0044","1145","569","196","373","6","575","1244","0","46.22","15.76"
"67","000","00","370","0045","0000","1070","379","691","3","1073","2485","0","43.18","15.25"
"67","000","00","370","0045","1146","566","179","387","1","567","1274","0","44.51","14.05"
"67","000","00","370","0045","1147","504","200","304","2","506","1211","0","41.78","16.52"
"67","000","00","370","0046","0000","830","291","539","7","837","1878","0","44.57","15.50"
"67","000","00","370","0046","1148","440","129","311","4","444","982","0","45.21","13.14"
"67","000","00","370","0046","1149","390","162","228","3","393","896","0","43.86","18.08"
"67","000","00","370","0047","0000","1701","571","1130","10","1711","3913","0","43.73","14.59"
"67","000","00","370","0047","1150","488","169","319","1","489","1072","0","45.62","15.76"
"67","000","00","370","0047","1151","406","129","277","5","411","855","0","48.07","15.09"
"67","000","00","370","0047","1152","413","141","272","1","414","1021","0","40.55","13.81"
"67","000","00","370","0047","1153","394","132","262","3","397","965","0","41.14","13.68"
"67","000","00","370","0048","0000","1777","690","1087","12","1789","3847","0","46.50","17.94"
"67","000","00","370","0048","1154","397","116","281","3","400","887","0","45.10","13.08"
"67","000","00","370","0048","1155","547","197","350","2","549","1144","0","47.99","17.22"
"67","000","00","370","0048","1156","474","220","254","5","479","1001","0","47.85","21.98"
"67","000","00","370","0048","1157","359","157","202","2","361","815","0","44.29","19.26"
"64","000","00","000","0000","0000","986292","397990","588302","8279","994571","2353773","2755491","42.25","16.91"
"64","000","00","010","0000","0000","9923","3638","6285","75","9998","20951","23272","47.72","17.36"
"64","000","00","010","0001","0000","626","204","422","7","633","1261","0","50.20","16.18"
"64","000","00","010","0001","1297","626","204","422","7","633","1261","0","50.20","16.18"
"64","000","00","010","0002","0000","156","58","98","0","156","321","0","48.60","18.07"
"64","000","00","010","0002","1298","156","58","98","0","156","321","0","48.60","18.07"
"64","000","00","010","0003","0000","326","102","224","5","331","626","0","52.88","16.29"
"64","000","00","010","0003","1299","326","102","224","5","331","626","0","52.88","16.29"
"64","000","00","010","0004","0000","538","246","292","8","546","1222","0","44.68","20.13"
"64","000","00","010","0004","1300","538","246","292","8","546","1222","0","44.68","20.13"
"64","000","00","010","0005","0000","597","248","349","6","603","1240","0","48.63","20.00"
"64","000","00","010","0005","1301","597","248","349","6","603","1240","0","48.63","20.00"
"64","000","00","010","0006","0000","930","356","574","6","936","1941","0","48.22","18.34"
"64","000","00","010","0006","1302","409","161","248","4","413","830","0","49.76","19.40"
"64","000","00","010","0006","1303","521","195","326","2","523","1111","0","47.07","17.55"
"64","000","00","010","0007","0000","416","171","245","0","416","805","0","51.68","21.24"
"64","000","00","010","0007","1304","416","171","245","0","416","805","0","51.68","21.24"
"64","000","00","010","0008","0000","299","100","199","3","302","569","0","53.08","17.57"
"64","000","00","010","0008","1305","299","100","199","3","302","569","0","53.08","17.57"
"64","000","00","010","0009","0000","580","190","390","5","585","1394","0","41.97","13.63"
"64","000","00","010","0009","1306","580","190","390","5","585","1394","0","41.97","13.63"
"64","000","00","010","0010","0000","361","133","228","2","363","733","0","49.52","18.14"
"64","000","00","010","0010","1307","361","133","228","2","363","733","0","49.52","18.14"
"64","000","00","010","0011","0000","788","304","484","3","791","1581","0","50.03","19.23"
"64","000","00","010","0011","1308","373","132","241","2","375","801","0","46.82","16.48"
"64","000","00","010","0011","1309","415","172","243","1","416","780","0","53.33","22.05"
"64","000","00","010","0012","0000","331","104","227","3","334","721","0","46.32","14.42"
"64","000","00","010","0012","1310","331","104","227","3","334","721","0","46.32","14.42"
"64","000","00","010","0013","0000","423","157","266","3","426","935","0","45.56","16.79"
"64","000","00","010","0013","1311","423","157","266","3","426","935","0","45.56","16.79"
"64","000","00","010","0014","0000","501","170","331","3","504","1042","0","48.37","16.31"
"64","000","00","010","0014","1312","501","170","331","3","504","1042","0","48.37","16.31"
"64","000","00","010","0015","0000","489","162","327","1","490","1023","0","47.90","15.84"
"64","000","00","010","0015","1313","489","162","327","1","490","1023","0","47.90","15.84"
"64","000","00","010","0016","0000","377","154","223","4","381","775","0","49.16","19.87"
"64","000","00","010","0016","1314","377","154","223","4","381","775","0","49.16","19.87"
"64","000","00","010","0017","0000","862","329","533","6","868","1989","0","43.64","16.54"
"64","000","00","010","0017","1315","475","188","287","3","478","1046","0","45.70","17.97"
"64","000","00","010","0017","1316","387","141","246","3","390","943","0","41.36","14.95"
"64","000","00","010","0018","0000","513","191","322","2","515","1114","0","46.23","17.15"
"64","000","00","010","0018","1317","513","191","322","2","515","1114","0","46.23","17.15"
"64","000","00","010","0019","0000","277","98","179","2","279","547","0","51.01","17.92"
"64","000","00","010","0019","1318","277","98","179","2","279","547","0","51.01","17.92"
"64","000","00","010","0020","0000","271","109","162","4","275","543","0","50.64","20.07"
"64","000","00","010","0020","1319","271","109","162","4","275","543","0","50.64","20.07"
"64","000","00","010","0021","0000","262","52","210","2","264","569","0","46.40","9.14"
"64","000","00","010","0021","1320","262","52","210","2","264","569","0","46.40","9.14"
"64","000","00","020","0000","0000","50720","22273","28447","327","51047","116097","141101","43.97","19.18"
"64","000","00","020","0001","0000","847","478","369","5","852","1923","0","44.31","24.86"
"64","000","00","020","0001","1214","422","247","175","1","423","953","0","44.39","25.92"
"64","000","00","020","0001","1215","425","231","194","4","429","970","0","44.23","23.81"
"64","000","00","020","0002","0000","823","542","281","8","831","1924","0","43.19","28.17"
"64","000","00","020","0002","1216","361","254","107","5","366","881","0","41.54","28.83"
"64","000","00","020","0002","1217","462","288","174","3","465","1043","0","44.58","27.61"
"64","000","00","020","0003","0000","1950","976","974","12","1962","4040","0","48.56","24.16"
"64","000","00","020","0003","1218","709","295","414","6","715","1453","0","49.21","20.30"
"64","000","00","020","0003","1219","660","341","319","2","662","1382","0","47.90","24.67"
"64","000","00","020","0003","1220","581","340","241","4","585","1205","0","48.55","28.22"
"64","000","00","020","0004","0000","1560","484","1076","8","1568","3318","0","47.26","14.59"
"64","000","00","020","0004","1221","472","145","327","3","475","1026","0","46.30","14.13"
"64","000","00","020","0004","1222","531","167","364","0","531","1149","0","46.21","14.53"
"64","000","00","020","0004","1223","557","172","385","5","562","1143","0","49.17","15.05"
"64","000","00","020","0005","0000","638","237","401","6","644","1257","0","51.23","18.85"
"64","000","00","020","0005","1224","638","237","401","6","644","1257","0","51.23","18.85"
"64","000","00","020","0006","0000","486","150","336","2","488","1072","0","45.52","13.99"
"64","000","00","020","0006","1225","486","150","336","2","488","1072","0","45.52","13.99"
"64","000","00","020","0007","0000","1083","437","646","8","1091","2405","0","45.36","18.17"
"64","000","00","020","0007","1226","549","213","336","2","551","1167","0","47.22","18.25"
"64","000","00","020","0007","1227","534","224","310","6","540","1238","0","43.62","18.09"
"64","000","00","020","0008","0000","1550","625","925","12","1562","3652","0","42.77","17.11"
"64","000","00","020","0008","1228","554","234","320","4","558","1259","0","44.32","18.59"
"64","000","00","020","0008","1229","449","166","283","4","453","1194","0","37.94","13.90"
"64","000","00","020","0008","1230","547","225","322","4","551","1199","0","45.95","18.77"
"64","000","00","020","0009","0000","374","340","34","1","375","703","0","53.34","48.36"
"64","000","00","020","0009","1231","374","340","34","1","375","703","0","53.34","48.36"
"64","000","00","020","0010","0000","518","198","320","4","522","1210","0","43.14","16.36"
"64","000","00","020","0010","1232","518","198","320","4","522","1210","0","43.14","16.36"
"64","000","00","020","0011","0000","854","266","588","11","865","1928","0","44.87","13.80"
"64","000","00","020","0011","1233","854","266","588","11","865","1928","0","44.87","13.80"
"64","000","00","020","0012","0000","1603","546","1057","8","1611","3346","0","48.15","16.32"
"64","000","00","020","0012","1234","796","270","526","4","800","1689","0","47.37","15.99"
"64","000","00","020","0012","1235","807","276","531","4","811","1657","0","48.94","16.66"
"64","000","00","020","0013","0000","1214","421","793","6","1220","2539","0","48.05","16.58"
"64","000","00","020","0013","1236","608","203","405","4","612","1243","0","49.24","16.33"
"64","000","00","020","0013","1237","606","218","388","2","608","1296","0","46.91","16.82"
"64","000","00","020","0014","0000","1353","469","884","10","1363","2970","0","45.89","15.79"
"64","000","00","020","0014","1238","574","214","360","6","580","1219","0","47.58","17.56"
"64","000","00","020","0014","1239","779","255","524","4","783","1751","0","44.72","14.56"
"64","000","00","020","0015","0000","6601","2987","3614","42","6643","15526","0","42.79","19.24"
"64","000","00","020","0015","1240","644","332","312","6","650","1435","0","45.30","23.14"
"64","000","00","020","0015","1241","647","259","388","7","654","1489","0","43.92","17.39"
"64","000","00","020","0015","1242","677","264","413","5","682","1517","0","44.96","17.40"
"64","000","00","020","0015","1243","667","317","350","3","670","1608","0","41.67","19.71"
"64","000","00","020","0015","1244","662","299","363","2","664","1581","0","42.00","18.91"
"64","000","00","020","0015","1245","632","328","304","4","636","1613","0","39.43","20.33"
"64","000","00","020","0015","1246","637","312","325","3","640","1582","0","40.46","19.72"
"64","000","00","020","0015","1247","706","289","417","4","710","1553","0","45.72","18.61"
"64","000","00","020","0015","1248","707","300","407","3","710","1620","0","43.83","18.52"
"64","000","00","020","0015","1249","622","287","335","5","627","1528","0","41.03","18.78"
"64","000","00","020","0016","0000","9781","4518","5263","47","9828","22850","0","43.01","19.77"
"64","000","00","020","0016","1250","672","285","387","0","672","1607","0","41.82","17.73"
"64","000","00","020","0016","1251","755","352","403","2","757","1869","0","40.50","18.83"
"64","000","00","020","0016","1252","877","434","443","4","881","2030","0","43.40","21.38"
"64","000","00","020","0016","1253","706","350","356","1","707","1661","0","42.56","21.07"
"64","000","00","020","0016","1254","764","318","446","4","768","1840","0","41.74","17.28"
"64","000","00","020","0016","1255","801","364","437","1","802","1856","0","43.21","19.61"
"64","000","00","020","0016","1256","721","322","399","4","725","1683","0","43.08","19.13"
"64","000","00","020","0016","1257","738","390","348","4","742","1710","0","43.39","22.81"
"64","000","00","020","0016","1258","831","391","440","0","831","1799","0","46.19","21.73"
"64","000","00","020","0016","1259","797","320","477","10","807","1880","0","42.93","17.02"
"64","000","00","020","0016","1260","724","335","389","6","730","1623","0","44.98","20.64"
"64","000","00","020","0016","1261","695","317","378","8","703","1642","0","42.81","19.31"
"64","000","00","020","0016","1262","700","340","360","3","703","1650","0","42.61","20.61"
"64","000","00","020","0017","0000","6795","3374","3421","31","6826","16357","0","41.73","20.63"
"64","000","00","020","0017","1263","645","319","326","5","650","1658","0","39.20","19.24"
"64","000","00","020","0017","1264","719","336","383","1","720","1699","0","42.38","19.78"
"64","000","00","020","0017","1265","652","344","308","5","657","1621","0","40.53","21.22"
"64","000","00","020","0017","1266","686","343","343","4","690","1733","0","39.82","19.79"
"64","000","00","020","0017","1267","694","328","366","2","696","1643","0","42.36","19.96"
"64","000","00","020","0017","1268","694","283","411","4","698","1562","0","44.69","18.12"
"64","000","00","020","0017","1269","676","326","350","3","679","1672","0","40.61","19.50"
"64","000","00","020","0017","1270","697","365","332","2","699","1574","0","44.41","23.19"
"64","000","00","020","0017","1271","679","387","292","2","681","1590","0","42.83","24.34"
"64","000","00","020","0017","1272","653","343","310","3","656","1605","0","40.87","21.37"
"64","000","00","020","0018","0000","1643","841","802","13","1656","3836","0","43.17","21.92"
"64","000","00","020","0018","1273","769","401","368","5","774","1830","0","42.30","21.91"
"64","000","00","020","0018","1274","874","440","434","8","882","2006","0","43.97","21.93"
"64","000","00","020","0019","0000","1430","749","681","5","1435","3144","0","45.64","23.82"
"64","000","00","020","0019","1275","701","396","305","3","704","1540","0","45.71","25.71"
"64","000","00","020","0019","1276","729","353","376","2","731","1604","0","45.57","22.01"
"64","000","00","020","0020","0000","1143","689","454","8","1151","2453","0","46.92","28.09"
"64","000","00","020","0020","1277","508","295","213","5","513","1102","0","46.55","26.77"
"64","000","00","020","0020","1278","635","394","241","3","638","1351","0","47.22","29.16"
"64","000","00","020","0021","0000","477","154","323","5","482","1125","0","42.84","13.69"
"64","000","00","020","0021","1279","477","154","323","5","482","1125","0","42.84","13.69"
"64","000","00","020","0022","0000","563","175","388","6","569","1113","0","51.12","15.72"
"64","000","00","020","0022","1280","563","175","388","6","569","1113","0","51.12","15.72"
"64","000","00","020","0023","0000","515","183","332","7","522","1920","0","27.19","9.53"
"64","000","00","020","0023","1281","515","183","332","7","522","1920","0","27.19","9.53"
"64","000","00","020","0024","0000","559","211","348","6","565","1241","0","45.53","17.00"
"64","000","00","020","0024","1282","559","211","348","6","565","1241","0","45.53","17.00"
"64","000","00","020","0025","0000","533","219","314","1","534","1207","0","44.24","18.14"
"64","000","00","020","0025","1283","533","219","314","1","534","1207","0","44.24","18.14"
"64","000","00","020","0026","0000","606","271","335","4","610","1306","0","46.71","20.75"
"64","000","00","020","0026","1284","606","271","335","4","610","1306","0","46.71","20.75"
"64","000","00","020","0027","0000","560","221","339","2","562","1301","0","43.20","16.99"
"64","000","00","020","0027","1285","560","221","339","2","562","1301","0","43.20","16.99"
"64","000","00","020","0028","0000","613","213","400","7","620","1361","0","45.55","15.65"
"64","000","00","020","0028","1286","613","213","400","7","620","1361","0","45.55","15.65"
"64","000","00","020","0029","0000","255","96","159","3","258","605","0","42.64","15.87"
"64","000","00","020","0029","1287","255","96","159","3","258","605","0","42.64","15.87"
"64","000","00","020","0030","0000","355","106","249","3","358","778","0","46.02","13.62"
"64","000","00","020","0030","1288","355","106","249","3","358","778","0","46.02","13.62"
"64","000","00","020","0031","0000","416","141","275","8","424","928","0","45.69","15.19"
"64","000","00","020","0031","1289","416","141","275","8","424","928","0","45.69","15.19"
"64","000","00","020","0032","0000","419","110","309","4","423","955","0","44.29","11.52"
"64","000","00","020","0032","1290","419","110","309","4","423","955","0","44.29","11.52"
"64","000","00","020","0033","0000","361","106","255","5","366","715","0","51.19","14.83"
"64","000","00","020","0033","1291","361","106","255","5","366","715","0","51.19","14.83"
"64","000","00","020","0034","0000","578","199","379","3","581","1190","0","48.82","16.72"
"64","000","00","020","0034","1292","578","199","379","3","581","1190","0","48.82","16.72"
"64","000","00","020","0035","0000","472","137","335","5","477","1102","0","43.28","12.43"
"64","000","00","020","0035","1293","472","137","335","5","477","1102","0","43.28","12.43"
"64","000","00","020","0036","0000","527","144","383","5","532","1307","0","40.70","11.02"
"64","000","00","020","0036","1294","527","144","383","5","532","1307","0","40.70","11.02"
"64","000","00","020","0037","0000","429","179","250","3","432","963","0","44.86","18.59"
"64","000","00","020","0037","1295","429","179","250","3","432","963","0","44.86","18.59"
"64","000","00","020","0038","0000","236","81","155","3","239","527","0","45.35","15.37"
"64","000","00","020","0038","1296","236","81","155","3","239","527","0","45.35","15.37"
"64","000","00","030","0000","0000","69540","34146","35394","520","70060","164087","196916","42.70","20.81"
"64","000","00","030","0001","0000","648","307","341","5","653","2636","0","24.77","11.65"
"64","000","00","030","0001","0651","243","125","118","2","245","1669","0","14.68","7.49"
"64","000","00","030","0001","0652","405","182","223","3","408","967","0","42.19","18.82"
"64","000","00","030","0002","0000","476","149","327","5","481","973","0","49.43","15.31"
"64","000","00","030","0002","0653","476","149","327","5","481","973","0","49.43","15.31"
"64","000","00","030","0003","0000","272","96","176","2","274","512","0","53.52","18.75"
"64","000","00","030","0003","0654","272","96","176","2","274","512","0","53.52","18.75"
"64","000","00","030","0004","0000","302","69","233","2","304","603","0","50.41","11.44"
"64","000","00","030","0004","0655","302","69","233","2","304","603","0","50.41","11.44"
"64","000","00","030","0005","0000","244","70","174","1","245","496","0","49.40","14.11"
"64","000","00","030","0005","0656","244","70","174","1","245","496","0","49.40","14.11"
"64","000","00","030","0006","0000","409","85","324","3","412","799","0","51.56","10.64"
"64","000","00","030","0006","0657","409","85","324","3","412","799","0","51.56","10.64"
"64","000","00","030","0007","0000","404","100","304","4","408","839","0","48.63","11.92"
"64","000","00","030","0007","0658","404","100","304","4","408","839","0","48.63","11.92"
"64","000","00","030","0008","0000","325","86","239","3","328","705","0","46.52","12.20"
"64","000","00","030","0008","0659","325","86","239","3","328","705","0","46.52","12.20"
"64","000","00","030","0009","0000","1400","531","869","14","1414","3265","0","43.31","16.26"
"64","000","00","030","0009","0660","643","239","404","8","651","1515","0","42.97","15.78"
"64","000","00","030","0009","0661","757","292","465","6","763","1750","0","43.60","16.69"
"64","000","00","030","0011","0000","639","445","194","13","652","1512","0","43.12","29.43"
"64","000","00","030","0011","0662","639","445","194","13","652","1512","0","43.12","29.43"
"64","000","00","030","0012","0000","148","117","31","0","148","331","0","44.71","35.35"
"64","000","00","030","0012","0663","148","117","31","0","148","331","0","44.71","35.35"
"64","000","00","030","0013","0000","189","135","54","2","191","600","0","31.83","22.50"
"64","000","00","030","0013","0664","189","135","54","2","191","600","0","31.83","22.50"
"64","000","00","030","0015","0000","732","445","287","3","735","1687","0","43.57","26.38"
"64","000","00","030","0015","0665","732","445","287","3","735","1687","0","43.57","26.38"
"64","000","00","030","0016","0000","1028","536","492","10","1038","2403","0","43.20","22.31"
"64","000","00","030","0016","0666","494","279","215","3","497","1166","0","42.62","23.93"
"64","000","00","030","0016","0667","534","257","277","7","541","1237","0","43.73","20.78"
"64","000","00","030","0017","0000","1240","1118","122","15","1255","2489","0","50.42","44.92"
"64","000","00","030","0017","0668","644","577","67","7","651","1259","0","51.71","45.83"
"64","000","00","030","0017","0669","596","541","55","8","604","1230","0","49.11","43.98"
"64","000","00","030","0019","0000","289","199","90","2","291","611","0","47.63","32.57"
"64","000","00","030","0019","0670","289","199","90","2","291","611","0","47.63","32.57"
"64","000","00","030","0021","0000","444","106","338","6","450","907","0","49.61","11.69"
"64","000","00","030","0021","0671","444","106","338","6","450","907","0","49.61","11.69"
"64","000","00","030","0022","0000","367","107","260","2","369","711","0","51.90","15.05"
"64","000","00","030","0022","0672","367","107","260","2","369","711","0","51.90","15.05"
"64","000","00","030","0023","0000","156","50","106","0","156","329","0","47.42","15.20"
"64","000","00","030","0023","0673","156","50","106","0","156","329","0","47.42","15.20"
"64","000","00","030","0024","0000","251","72","179","4","255","522","0","48.85","13.79"
"64","000","00","030","0024","0674","251","72","179","4","255","522","0","48.85","13.79"
"64","000","00","030","0025","0000","242","67","175","1","243","491","0","49.49","13.65"
"64","000","00","030","0025","0675","242","67","175","1","243","491","0","49.49","13.65"
"64","000","00","030","0026","0000","367","112","255","2","369","690","0","53.48","16.23"
"64","000","00","030","0026","0676","367","112","255","2","369","690","0","53.48","16.23"
"64","000","00","030","0027","0000","194","34","160","3","197","391","0","50.38","8.70"
"64","000","00","030","0027","0677","194","34","160","3","197","391","0","50.38","8.70"
"64","000","00","030","0028","0000","296","100","196","0","296","575","0","51.48","17.39"
"64","000","00","030","0028","0678","296","100","196","0","296","575","0","51.48","17.39"
"64","000","00","030","0029","0000","404","170","234","2","406","842","0","48.22","20.19"
"64","000","00","030","0029","0679","404","170","234","2","406","842","0","48.22","20.19"
"64","000","00","030","0030","0000","559","336","223","9","568","1260","0","45.08","26.67"
"64","000","00","030","0030","0680","559","336","223","9","568","1260","0","45.08","26.67"
"64","000","00","030","0031","0000","415","160","255","4","419","920","0","45.54","17.39"
"64","000","00","030","0031","0681","415","160","255","4","419","920","0","45.54","17.39"
"64","000","00","030","0032","0000","2708","2208","500","35","2743","5561","0","49.33","39.71"
"64","000","00","030","0032","0682","702","550","152","7","709","1439","0","49.27","38.22"
"64","000","00","030","0032","0683","508","408","100","10","518","1129","0","45.88","36.14"
"64","000","00","030","0032","0684","377","313","64","5","382","794","0","48.11","39.42"
"64","000","00","030","0032","0685","500","411","89","4","504","969","0","52.01","42.41"
"64","000","00","030","0032","0686","621","526","95","9","630","1230","0","51.22","42.76"
"64","000","00","030","0034","0000","1345","790","555","12","1357","3147","0","43.12","25.10"
"64","000","00","030","0034","0687","726","430","296","6","732","1564","0","46.80","27.49"
"64","000","00","030","0034","0688","619","360","259","6","625","1583","0","39.48","22.74"
"64","000","00","030","0035","0000","362","206","156","5","367","907","0","40.46","22.71"
"64","000","00","030","0035","0689","362","206","156","5","367","907","0","40.46","22.71"
"64","000","00","030","0036","0000","1268","997","271","6","1274","2680","0","47.54","37.20"
"64","000","00","030","0036","0690","727","630","97","5","732","1460","0","50.14","43.15"
"64","000","00","030","0036","0691","541","367","174","1","542","1220","0","44.43","30.08"
"64","000","00","030","0037","0000","695","535","160","6","701","1445","0","48.51","37.02"
"64","000","00","030","0037","0692","695","535","160","6","701","1445","0","48.51","37.02"
"64","000","00","030","0038","0000","664","523","141","5","669","1540","0","43.44","33.96"
"64","000","00","030","0038","0693","664","523","141","5","669","1540","0","43.44","33.96"
"64","000","00","030","0039","0000","5898","2909","2989","50","5948","13601","0","43.73","21.39"
"64","000","00","030","0039","0694","633","301","332","5","638","1476","0","43.22","20.39"
"64","000","00","030","0039","0695","722","338","384","8","730","1538","0","47.46","21.98"
"64","000","00","030","0039","0696","611","334","277","5","616","1363","0","45.19","24.50"
"64","000","00","030","0039","0697","622","291","331","10","632","1529","0","41.33","19.03"
"64","000","00","030","0039","0698","632","330","302","6","638","1512","0","42.20","21.83"
"64","000","00","030","0039","0699","626","325","301","1","627","1518","0","41.30","21.41"
"64","000","00","030","0039","0700","709","317","392","5","714","1562","0","45.71","20.29"
"64","000","00","030","0039","0701","675","355","320","4","679","1535","0","44.23","23.13"
"64","000","00","030","0039","0702","668","318","350","6","674","1568","0","42.98","20.28"
"64","000","00","030","0040","0000","10913","4800","6113","67","10980","25163","0","43.64","19.08"
"64","000","00","030","0040","0703","746","311","435","2","748","1524","0","49.08","20.41"
"64","000","00","030","0040","0704","766","282","484","10","776","1588","0","48.87","17.76"
"64","000","00","030","0040","0705","726","272","454","6","732","1556","0","47.04","17.48"
"64","000","00","030","0040","0706","695","272","423","2","697","1623","0","42.95","16.76"
"64","000","00","030","0040","0707","595","273","322","2","597","1468","0","40.67","18.60"
"64","000","00","030","0040","0708","627","341","286","3","630","1641","0","38.39","20.78"
"64","000","00","030","0040","0709","643","257","386","4","647","1563","0","41.39","16.44"
"64","000","00","030","0040","0710","755","322","433","3","758","1639","0","46.25","19.65"
"64","000","00","030","0040","0711","731","319","412","5","736","1605","0","45.86","19.88"
"64","000","00","030","0040","0712","710","320","390","6","716","1682","0","42.57","19.02"
"64","000","00","030","0040","0713","645","297","348","3","648","1536","0","42.19","19.34"
"64","000","00","030","0040","0714","741","299","442","6","747","1631","0","45.80","18.33"
"64","000","00","030","0040","0715","683","300","383","7","690","1674","0","41.22","17.92"
"64","000","00","030","0040","0716","617","366","251","4","621","1524","0","40.75","24.02"
"64","000","00","030","0040","0717","662","300","362","3","665","1610","0","41.30","18.63"
"64","000","00","030","0040","0718","571","269","302","1","572","1299","0","44.03","20.71"
"64","000","00","030","0041","0000","2175","658","1517","22","2197","4725","0","46.50","13.93"
"64","000","00","030","0041","0719","710","234","476","4","714","1646","0","43.38","14.22"
"64","000","00","030","0041","0720","734","188","546","6","740","1464","0","50.55","12.84"
"64","000","00","030","0041","0721","731","236","495","12","743","1615","0","46.01","14.61"
"64","000","00","030","0042","0000","5746","2659","3087","40","5786","13461","0","42.98","19.75"
"64","000","00","030","0042","0722","607","235","372","6","613","1299","0","47.19","18.09"
"64","000","00","030","0042","0723","682","288","394","3","685","1574","0","43.52","18.30"
"64","000","00","030","0042","0724","585","272","313","2","587","1453","0","40.40","18.72"
"64","000","00","030","0042","0725","644","287","357","5","649","1518","0","42.75","18.91"
"64","000","00","030","0042","0726","649","289","360","7","656","1452","0","45.18","19.90"
"64","000","00","030","0042","0727","733","351","382","6","739","1681","0","43.96","20.88"
"64","000","00","030","0042","0728","630","295","335","5","635","1514","0","41.94","19.48"
"64","000","00","030","0042","0729","578","277","301","4","582","1521","0","38.26","18.21"
"64","000","00","030","0042","0730","638","365","273","2","640","1449","0","44.17","25.19"
"64","000","00","030","0043","0000","11548","5349","6199","82","11630","28382","0","40.98","18.85"
"64","000","00","030","0043","0731","627","271","356","1","628","1523","0","41.23","17.79"
"64","000","00","030","0043","0732","626","276","350","4","630","1529","0","41.20","18.05"
"64","000","00","030","0043","0733","673","283","390","2","675","1588","0","42.51","17.82"
"64","000","00","030","0043","0734","606","220","386","6","612","1466","0","41.75","15.01"
"64","000","00","030","0043","0735","551","234","317","7","558","1463","0","38.14","15.99"
"64","000","00","030","0043","0736","589","279","310","2","591","1450","0","40.76","19.24"
"64","000","00","030","0043","0737","637","303","334","2","639","1603","0","39.86","18.90"
"64","000","00","030","0043","0738","585","257","328","3","588","1516","0","38.79","16.95"
"64","000","00","030","0043","0739","614","291","323","3","617","1505","0","41.00","19.34"
"64","000","00","030","0043","0740","659","315","344","6","665","1533","0","43.38","20.55"
"64","000","00","030","0043","0741","620","306","314","3","623","1429","0","43.60","21.41"
"64","000","00","030","0043","0742","680","331","349","5","685","1661","0","41.24","19.93"
"64","000","00","030","0043","0743","739","341","398","3","742","1778","0","41.73","19.18"
"64","000","00","030","0043","0744","706","351","355","9","715","1674","0","42.71","20.97"
"64","000","00","030","0043","0745","625","297","328","10","635","1721","0","36.90","17.26"
"64","000","00","030","0043","0746","673","345","328","7","680","1739","0","39.10","19.84"
"64","000","00","030","0043","0747","637","266","371","2","639","1566","0","40.80","16.99"
"64","000","00","030","0043","0748","701","383","318","7","708","1638","0","43.22","23.38"
"64","000","00","030","0044","0000","13778","6710","7068","73","13851","35376","0","39.15","18.97"
"64","000","00","030","0044","0749","592","306","286","2","594","1546","0","38.42","19.79"
"64","000","00","030","0044","0750","597","285","312","3","600","1625","0","36.92","17.54"
"64","000","00","030","0044","0751","581","301","280","3","584","1626","0","35.92","18.51"
"64","000","00","030","0044","0752","595","305","290","2","597","1538","0","38.82","19.83"
"64","000","00","030","0044","0753","688","403","285","6","694","1671","0","41.53","24.12"
"64","000","00","030","0044","0754","679","324","355","8","687","1654","0","41.54","19.59"
"64","000","00","030","0044","0755","600","272","328","2","602","1634","0","36.84","16.65"
"64","000","00","030","0044","0756","666","354","312","3","669","1604","0","41.71","22.07"
"64","000","00","030","0044","0757","583","278","305","2","585","1493","0","39.18","18.62"
"64","000","00","030","0044","0758","637","256","381","4","641","1613","0","39.74","15.87"
"64","000","00","030","0044","0759","613","295","318","5","618","1628","0","37.96","18.12"
"64","000","00","030","0044","0760","597","257","340","2","599","1627","0","36.82","15.80"
"64","000","00","030","0044","0761","554","277","277","4","558","1584","0","35.23","17.49"
"64","000","00","030","0044","0762","699","361","338","5","704","1732","0","40.65","20.84"
"64","000","00","030","0044","0763","632","286","346","4","636","1709","0","37.21","16.73"
"64","000","00","030","0044","0764","684","318","366","3","687","1777","0","38.66","17.90"
"64","000","00","030","0044","0765","678","327","351","5","683","1685","0","40.53","19.41"
"64","000","00","030","0044","0766","657","279","378","5","662","1605","0","41.25","17.38"
"64","000","00","030","0044","0767","541","260","281","0","541","1434","0","37.73","18.13"
"64","000","00","030","0044","0768","704","301","403","1","705","1634","0","43.15","18.42"
"64","000","00","030","0044","0769","613","351","262","1","614","1450","0","42.34","24.21"
"64","000","00","030","0044","0770","588","314","274","3","591","1507","0","39.22","20.84"
"64","000","00","040","0000","0000","64562","27627","36935","481","65043","156746","189931","41.50","17.63"
"64","000","00","040","0001","0000","8664","3447","5217","67","8731","21636","0","40.35","15.93"
"64","000","00","040","0001","0523","439","154","285","2","441","1036","0","42.57","14.86"
"64","000","00","040","0001","0524","478","159","319","4","482","1027","0","46.93","15.48"
"64","000","00","040","0001","0525","548","205","343","3","551","1244","0","44.29","16.48"
"64","000","00","040","0001","0526","469","209","260","2","471","1336","0","35.25","15.64"
"64","000","00","040","0001","0527","627","220","407","4","631","1425","0","44.28","15.44"
"64","000","00","040","0001","0528","545","220","325","5","550","1503","0","36.59","14.64"
"64","000","00","040","0001","0529","530","221","309","6","536","1292","0","41.49","17.11"
"64","000","00","040","0001","0530","499","187","312","4","503","1250","0","40.24","14.96"
"64","000","00","040","0001","0531","504","245","259","6","510","1235","0","41.30","19.84"
"64","000","00","040","0001","0532","578","234","344","6","584","1375","0","42.47","17.02"
"64","000","00","040","0001","0533","605","261","344","8","613","1418","0","43.23","18.41"
"64","000","00","040","0001","0534","491","220","271","2","493","1340","0","36.79","16.42"
"64","000","00","040","0001","0535","722","264","458","3","725","1707","0","42.47","15.47"
"64","000","00","040","0001","0536","507","202","305","3","510","1390","0","36.69","14.53"
"64","000","00","040","0001","0537","543","223","320","2","545","1437","0","37.93","15.52"
"64","000","00","040","0001","0538","579","223","356","7","586","1621","0","36.15","13.76"
"64","000","00","040","0002","0000","1754","682","1072","10","1764","4264","0","41.37","15.99"
"64","000","00","040","0002","0539","578","245","333","2","580","1373","0","42.24","17.84"
"64","000","00","040","0002","0540","551","177","374","5","556","1416","0","39.27","12.50"
"64","000","00","040","0002","0541","625","260","365","3","628","1475","0","42.58","17.63"
"64","000","00","040","0003","0000","2357","861","1496","20","2377","6356","0","37.40","13.55"
"64","000","00","040","0003","0542","542","197","345","6","548","1389","0","39.45","14.18"
"64","000","00","040","0003","0543","487","169","318","4","491","1229","0","39.95","13.75"
"64","000","00","040","0003","0544","469","163","306","5","474","1308","0","36.24","12.46"
"64","000","00","040","0003","0545","442","166","276","1","443","1245","0","35.58","13.33"
"64","000","00","040","0003","0546","417","166","251","4","421","1185","0","35.53","14.01"
"64","000","00","040","0004","0000","1268","440","828","7","1275","3150","0","40.48","13.97"
"64","000","00","040","0004","0547","432","127","305","2","434","1008","0","43.06","12.60"
"64","000","00","040","0004","0548","422","160","262","4","426","1075","0","39.63","14.88"
"64","000","00","040","0004","0549","414","153","261","1","415","1067","0","38.89","14.34"
"64","000","00","040","0005","0000","1327","426","901","17","1344","3252","0","41.33","13.10"
"64","000","00","040","0005","0553","654","224","430","11","665","1642","0","40.50","13.64"
"64","000","00","040","0005","0554","673","202","471","6","679","1610","0","42.17","12.55"
"64","000","00","040","0006","0000","1042","371","671","8","1050","3163","0","33.20","11.73"
"64","000","00","040","0006","0550","295","74","221","1","296","1231","0","24.05","6.01"
"64","000","00","040","0006","0551","392","150","242","5","397","977","0","40.63","15.35"
"64","000","00","040","0006","0552","355","147","208","2","357","955","0","37.38","15.39"
"64","000","00","040","0007","0000","1731","679","1052","22","1753","3884","0","45.13","17.48"
"64","000","00","040","0007","0555","604","219","385","6","610","1266","0","48.18","17.30"
"64","000","00","040","0007","0556","575","257","318","10","585","1323","0","44.22","19.43"
"64","000","00","040","0007","0557","552","203","349","6","558","1295","0","43.09","15.68"
"64","000","00","040","0008","0000","2017","1022","995","16","2033","4669","0","43.54","21.89"
"64","000","00","040","0008","0558","475","216","259","3","478","1153","0","41.46","18.73"
"64","000","00","040","0008","0559","488","238","250","3","491","1123","0","43.72","21.19"
"64","000","00","040","0008","0560","466","242","224","4","470","1088","0","43.20","22.24"
"64","000","00","040","0008","0561","588","326","262","6","594","1305","0","45.52","24.98"
"64","000","00","040","0009","0000","1357","362","995","10","1367","2830","0","48.30","12.79"
"64","000","00","040","0009","0562","383","139","244","5","388","825","0","47.03","16.85"
"64","000","00","040","0009","0563","418","97","321","2","420","851","0","49.35","11.40"
"64","000","00","040","0009","0564","556","126","430","3","559","1154","0","48.44","10.92"
"64","000","00","040","0010","0000","1019","227","792","13","1032","2059","0","50.12","11.02"
"64","000","00","040","0010","0565","462","87","375","7","469","918","0","51.09","9.48"
"64","000","00","040","0010","0566","557","140","417","6","563","1141","0","49.34","12.27"
"64","000","00","040","0011","0000","1670","460","1210","16","1686","3828","0","44.04","12.02"
"64","000","00","040","0011","0567","527","139","388","3","530","1164","0","45.53","11.94"
"64","000","00","040","0011","0568","633","204","429","7","640","1566","0","40.87","13.03"
"64","000","00","040","0011","0569","510","117","393","6","516","1098","0","46.99","10.66"
"64","000","00","040","0012","0000","722","154","568","2","724","1375","0","52.65","11.20"
"64","000","00","040","0012","0570","722","154","568","2","724","1375","0","52.65","11.20"
"64","000","00","040","0013","0000","1392","526","866","17","1409","3487","0","40.41","15.08"
"64","000","00","040","0013","0571","443","144","299","2","445","1061","0","41.94","13.57"
"64","000","00","040","0013","0572","512","195","317","11","523","1268","0","41.25","15.38"
"64","000","00","040","0013","0573","437","187","250","4","441","1158","0","38.08","16.15"
"64","000","00","040","0014","0000","6099","3153","2946","35","6134","16189","0","37.89","19.48"
"64","000","00","040","0014","0574","571","287","284","3","574","1565","0","36.68","18.34"
"64","000","00","040","0014","0575","560","350","210","2","562","1554","0","36.16","22.52"
"64","000","00","040","0014","0576","528","277","251","3","531","1449","0","36.65","19.12"
"64","000","00","040","0014","0577","603","308","295","3","606","1502","0","40.35","20.51"
"64","000","00","040","0014","0578","565","284","281","7","572","1444","0","39.61","19.67"
"64","000","00","040","0014","0579","567","299","268","4","571","1455","0","39.24","20.55"
"64","000","00","040","0014","0580","547","271","276","3","550","1394","0","39.45","19.44"
"64","000","00","040","0014","0581","530","248","282","6","536","1444","0","37.12","17.17"
"64","000","00","040","0014","0582","492","241","251","1","493","1441","0","34.21","16.72"
"64","000","00","040","0014","0583","547","318","229","2","549","1434","0","38.28","22.18"
"64","000","00","040","0014","0584","589","270","319","1","590","1507","0","39.15","17.92"
"64","000","00","040","0015","0000","356","194","162","3","359","657","0","54.64","29.53"
"64","000","00","040","0015","0585","356","194","162","3","359","657","0","54.64","29.53"
"64","000","00","040","0016","0000","1057","478","579","5","1062","2064","0","51.45","23.16"
"64","000","00","040","0016","0586","517","245","272","4","521","1040","0","50.10","23.56"
"64","000","00","040","0016","0587","540","233","307","1","541","1024","0","52.83","22.75"
"64","000","00","040","0017","0000","1084","572","512","2","1086","2417","0","44.93","23.67"
"64","000","00","040","0017","0588","495","239","256","1","496","956","0","51.88","25.00"
"64","000","00","040","0017","0589","589","333","256","1","590","1461","0","40.38","22.79"
"64","000","00","040","0018","0000","1266","580","686","14","1280","2885","0","44.37","20.10"
"64","000","00","040","0018","0590","655","247","408","11","666","1446","0","46.06","17.08"
"64","000","00","040","0018","0591","611","333","278","3","614","1439","0","42.67","23.14"
"64","000","00","040","0019","0000","1065","501","564","8","1073","2765","0","38.81","18.12"
"64","000","00","040","0019","0592","564","273","291","3","567","1487","0","38.13","18.36"
"64","000","00","040","0019","0593","501","228","273","5","506","1278","0","39.59","17.84"
"64","000","00","040","0020","0000","770","355","415","11","781","2046","0","38.17","17.35"
"64","000","00","040","0020","0594","371","153","218","8","379","994","0","38.13","15.39"
"64","000","00","040","0020","0595","399","202","197","3","402","1052","0","38.21","19.20"
"64","000","00","040","0021","0000","963","360","603","8","971","2023","0","48.00","17.80"
"64","000","00","040","0021","0596","438","158","280","2","440","911","0","48.30","17.34"
"64","000","00","040","0021","0597","525","202","323","6","531","1112","0","47.75","18.17"
"64","000","00","040","0022","0000","2316","1146","1170","14","2330","5347","0","43.58","21.43"
"64","000","00","040","0022","0598","614","301","313","4","618","1318","0","46.89","22.84"
"64","000","00","040","0022","0599","574","268","306","3","577","1416","0","40.75","18.93"
"64","000","00","040","0022","0600","544","266","278","4","548","1273","0","43.05","20.90"
"64","000","00","040","0022","0601","584","311","273","3","587","1340","0","43.81","23.21"
"64","000","00","040","0023","0000","562","222","340","6","568","1397","0","40.66","15.89"
"64","000","00","040","0023","0602","562","222","340","6","568","1397","0","40.66","15.89"
"64","000","00","040","0024","0000","1807","739","1068","15","1822","4314","0","42.23","17.13"
"64","000","00","040","0024","0603","424","174","250","5","429","1042","0","41.17","16.70"
"64","000","00","040","0024","0604","475","181","294","3","478","1102","0","43.38","16.42"
"64","000","00","040","0024","0605","414","186","228","6","420","1050","0","40.00","17.71"
"64","000","00","040","0024","0606","494","198","296","1","495","1120","0","44.20","17.68"
"64","000","00","040","0025","0000","1073","502","571","4","1077","2534","0","42.50","19.81"
"64","000","00","040","0025","0607","543","229","314","2","545","1262","0","43.19","18.15"
"64","000","00","040","0025","0608","530","273","257","2","532","1272","0","41.82","21.46"
"64","000","00","040","0026","0000","1395","664","731","6","1401","3221","0","43.50","20.61"
"64","000","00","040","0026","0609","528","253","275","1","529","1156","0","45.76","21.89"
"64","000","00","040","0026","0610","390","160","230","2","392","924","0","42.42","17.32"
"64","000","00","040","0026","0611","477","251","226","3","480","1141","0","42.07","22.00"
"64","000","00","040","0027","0000","888","416","472","5","893","1997","0","44.72","20.83"
"64","000","00","040","0027","0612","447","199","248","4","451","957","0","47.13","20.79"
"64","000","00","040","0027","0613","441","217","224","1","442","1040","0","42.50","20.87"
"64","000","00","040","0028","0000","1538","748","790","6","1544","3122","0","49.46","23.96"
"64","000","00","040","0028","0614","549","292","257","3","552","1112","0","49.64","26.26"
"64","000","00","040","0028","0615","491","258","233","3","494","1000","0","49.40","25.80"
"64","000","00","040","0028","0616","498","198","300","0","498","1010","0","49.31","19.60"
"64","000","00","040","0029","0000","1391","656","735","12","1403","3235","0","43.37","20.28"
"64","000","00","040","0029","0617","463","208","255","3","466","1088","0","42.83","19.12"
"64","000","00","040","0029","0618","453","196","257","7","460","1053","0","43.68","18.61"
"64","000","00","040","0029","0619","475","252","223","2","477","1094","0","43.60","23.03"
"64","000","00","040","0030","0000","946","475","471","6","952","2104","0","45.25","22.58"
"64","000","00","040","0030","0620","456","217","239","2","458","1048","0","43.70","20.71"
"64","000","00","040","0030","0621","490","258","232","4","494","1056","0","46.78","24.43"
"64","000","00","040","0031","0000","1849","781","1068","14","1863","4652","0","40.05","16.79"
"64","000","00","040","0031","0622","492","177","315","4","496","1164","0","42.61","15.21"
"64","000","00","040","0031","0623","408","189","219","2","410","1194","0","34.34","15.83"
"64","000","00","040","0031","0624","460","187","273","6","466","1157","0","40.28","16.16"
"64","000","00","040","0031","0625","489","228","261","2","491","1137","0","43.18","20.05"
"64","000","00","040","0032","0000","1429","624","805","9","1438","3394","0","42.37","18.39"
"64","000","00","040","0032","0626","494","213","281","3","497","1161","0","42.81","18.35"
"64","000","00","040","0032","0627","447","201","246","4","451","1074","0","41.99","18.72"
"64","000","00","040","0032","0628","488","210","278","2","490","1159","0","42.28","18.12"
"64","000","00","040","0033","0000","3347","1710","1637","23","3370","8252","0","40.84","20.72"
"64","000","00","040","0033","0629","395","187","208","1","396","953","0","41.55","19.62"
"64","000","00","040","0033","0630","488","258","230","3","491","1107","0","44.35","23.31"
"64","000","00","040","0033","0631","460","236","224","4","464","1085","0","42.76","21.75"
"64","000","00","040","0033","0632","392","198","194","3","395","988","0","39.98","20.04"
"64","000","00","040","0033","0633","405","197","208","4","409","1028","0","39.79","19.16"
"64","000","00","040","0033","0634","401","223","178","1","402","1059","0","37.96","21.06"
"64","000","00","040","0033","0635","385","196","189","3","388","1026","0","37.82","19.10"
"64","000","00","040","0033","0636","421","215","206","4","425","1006","0","42.25","21.37"
"64","000","00","040","0034","0000","1934","992","942","12","1946","4959","0","39.24","20.00"
"64","000","00","040","0034","0637","498","253","245","4","502","1294","0","38.79","19.55"
"64","000","00","040","0034","0638","514","263","251","4","518","1310","0","39.54","20.08"
"64","000","00","040","0034","0639","468","232","236","2","470","1249","0","37.63","18.57"
"64","000","00","040","0034","0640","454","244","210","2","456","1106","0","41.23","22.06"
"64","000","00","040","0035","0000","2976","1353","1623","22","2998","7507","0","39.94","18.02"
"64","000","00","040","0035","0641","489","225","264","4","493","1201","0","41.05","18.73"
"64","000","00","040","0035","0642","564","259","305","3","567","1287","0","44.06","20.12"
"64","000","00","040","0035","0643","611","288","323","3","614","1375","0","44.65","20.95"
"64","000","00","040","0035","0644","526","223","303","4","530","1418","0","37.38","15.73"
"64","000","00","040","0035","0645","380","173","207","5","385","1112","0","34.62","15.56"
"64","000","00","040","0035","0646","406","185","221","3","409","1114","0","36.71","16.61"
"64","000","00","040","0036","0000","697","227","470","6","703","1558","0","45.12","14.57"
"64","000","00","040","0036","0647","697","227","470","6","703","1558","0","45.12","14.57"
"64","000","00","040","0037","0000","1434","522","912","10","1444","4154","0","34.76","12.57"
"64","000","00","040","0037","0648","479","146","333","5","484","1197","0","40.43","12.20"
"64","000","00","040","0037","0649","458","162","296","3","461","1300","0","35.46","12.46"
"64","000","00","040","0037","0650","497","214","283","2","499","1657","0","30.11","12.91"
"64","000","00","050","0000","0000","124654","48914","75740","856","125510","285944","334725","43.89","17.11"
"64","000","00","050","0001","0000","1543","543","1000","11","1554","3804","0","40.85","14.27"
"64","000","00","050","0001","0998","449","165","284","2","451","1213","0","37.18","13.60"
"64","000","00","050","0001","0999","542","209","333","3","545","1302","0","41.86","16.05"
"64","000","00","050","0001","1000","552","169","383","6","558","1289","0","43.29","13.11"
"64","000","00","050","0002","0000","3009","1248","1761","20","3029","7370","0","41.10","16.93"
"64","000","00","050","0002","1001","679","293","386","3","682","1617","0","42.18","18.12"
"64","000","00","050","0002","1002","653","276","377","3","656","1521","0","43.13","18.15"
"64","000","00","050","0002","1003","590","249","341","7","597","1452","0","41.12","17.15"
"64","000","00","050","0002","1004","567","240","327","2","569","1569","0","36.27","15.30"
"64","000","00","050","0002","1005","520","190","330","5","525","1211","0","43.35","15.69"
"64","000","00","050","0003","0000","1626","599","1027","10","1636","3793","0","43.13","15.79"
"64","000","00","050","0003","1006","585","192","393","4","589","1344","0","43.82","14.29"
"64","000","00","050","0003","1007","547","192","355","3","550","1305","0","42.15","14.71"
"64","000","00","050","0003","1008","494","215","279","3","497","1144","0","43.44","18.79"
"64","000","00","050","0004","0000","1698","665","1033","9","1707","3884","0","43.95","17.12"
"64","000","00","050","0004","1009","575","234","341","6","581","1449","0","40.10","16.15"
"64","000","00","050","0004","1010","669","256","413","1","670","1446","0","46.33","17.70"
"64","000","00","050","0004","1011","454","175","279","2","456","989","0","46.11","17.69"
"64","000","00","050","0005","0000","2837","1071","1766","17","2854","7030","0","40.60","15.23"
"64","000","00","050","0005","1012","598","260","338","5","603","1391","0","43.35","18.69"
"64","000","00","050","0005","1013","554","184","370","3","557","1321","0","42.17","13.93"
"64","000","00","050","0005","1014","555","191","364","3","558","1395","0","40.00","13.69"
"64","000","00","050","0005","1015","604","235","369","3","607","1498","0","40.52","15.69"
"64","000","00","050","0005","1016","526","201","325","3","529","1425","0","37.12","14.11"
"64","000","00","050","0006","0000","1588","521","1067","11","1599","3436","0","46.54","15.16"
"64","000","00","050","0006","1017","480","134","346","5","485","1011","0","47.97","13.25"
"64","000","00","050","0006","1018","526","180","346","3","529","1114","0","47.49","16.16"
"64","000","00","050","0006","1019","582","207","375","3","585","1311","0","44.62","15.79"
"64","000","00","050","0007","0000","9185","4225","4960","65","9250","20899","0","44.26","20.22"
"64","000","00","050","0007","1020","627","208","419","4","631","1480","0","42.64","14.05"
"64","000","00","050","0007","1021","586","287","299","7","593","1474","0","40.23","19.47"
"64","000","00","050","0007","1022","649","317","332","5","654","1497","0","43.69","21.18"
"64","000","00","050","0007","1023","626","277","349","1","627","1399","0","44.82","19.80"
"64","000","00","050","0007","1024","634","217","417","4","638","1469","0","43.43","14.77"
"64","000","00","050","0007","1025","634","216","418","10","644","1494","0","43.11","14.46"
"64","000","00","050","0007","1026","643","279","364","4","647","1509","0","42.88","18.49"
"64","000","00","050","0007","1027","627","259","368","0","627","1509","0","41.55","17.16"
"64","000","00","050","0007","1028","682","341","341","3","685","1517","0","45.15","22.48"
"64","000","00","050","0007","1029","718","377","341","10","728","1501","0","48.50","25.12"
"64","000","00","050","0007","1030","663","328","335","4","667","1516","0","44.00","21.64"
"64","000","00","050","0007","1031","775","405","370","6","781","1510","0","51.72","26.82"
"64","000","00","050","0007","1032","627","349","278","4","631","1490","0","42.35","23.42"
"64","000","00","050","0007","1033","694","365","329","3","697","1534","0","45.44","23.79"
"64","000","00","050","0008","0000","3542","1374","2168","12","3554","8380","0","42.41","16.40"
"64","000","00","050","0008","1034","759","266","493","3","762","1732","0","44.00","15.36"
"64","000","00","050","0008","1035","777","317","460","4","781","1709","0","45.70","18.55"
"64","000","00","050","0008","1036","679","285","394","1","680","1535","0","44.30","18.57"
"64","000","00","050","0008","1037","623","222","401","4","627","1601","0","39.16","13.87"
"64","000","00","050","0008","1038","704","284","420","0","704","1803","0","39.05","15.75"
"64","000","00","050","0009","0000","3039","1212","1827","18","3057","6992","0","43.72","17.33"
"64","000","00","050","0009","1039","642","232","410","2","644","1372","0","46.94","16.91"
"64","000","00","050","0009","1040","633","266","367","3","636","1434","0","44.35","18.55"
"64","000","00","050","0009","1041","613","235","378","6","619","1367","0","45.28","17.19"
"64","000","00","050","0009","1042","554","205","349","3","557","1376","0","40.48","14.90"
"64","000","00","050","0009","1043","597","274","323","4","601","1443","0","41.65","18.99"
"64","000","00","050","0010","0000","867","340","527","8","875","1915","0","45.69","17.75"
"64","000","00","050","0010","1044","424","185","239","5","429","1017","0","42.18","18.19"
"64","000","00","050","0010","1045","443","155","288","3","446","898","0","49.67","17.26"
"64","000","00","050","0011","0000","715","237","478","3","718","1561","0","46.00","15.18"
"64","000","00","050","0011","1046","394","128","266","2","396","858","0","46.15","14.92"
"64","000","00","050","0011","1047","321","109","212","1","322","703","0","45.80","15.50"
"64","000","00","050","0012","0000","2191","889","1302","19","2210","4987","0","44.32","17.83"
"64","000","00","050","0012","1048","553","240","313","4","557","1309","0","42.55","18.33"
"64","000","00","050","0012","1049","541","184","357","0","541","1161","0","46.60","15.85"
"64","000","00","050","0012","1050","573","242","331","10","583","1301","0","44.81","18.60"
"64","000","00","050","0012","1051","524","223","301","5","529","1216","0","43.50","18.34"
"64","000","00","050","0013","0000","1930","838","1092","7","1937","4277","0","45.29","19.59"
"64","000","00","050","0013","1052","643","287","356","2","645","1476","0","43.70","19.44"
"64","000","00","050","0013","1053","624","275","349","2","626","1357","0","46.13","20.27"
"64","000","00","050","0013","1054","663","276","387","3","666","1444","0","46.12","19.11"
"64","000","00","050","0014","0000","1973","877","1096","11","1984","4461","0","44.47","19.66"
"64","000","00","050","0014","1055","643","284","359","3","646","1524","0","42.39","18.64"
"64","000","00","050","0014","1056","642","284","358","5","647","1454","0","44.50","19.53"
"64","000","00","050","0014","1057","688","309","379","3","691","1483","0","46.59","20.84"
"64","000","00","050","0015","0000","3227","1370","1857","19","3246","7143","0","45.44","19.18"
"64","000","00","050","0015","1058","738","294","444","1","739","1488","0","49.66","19.76"
"64","000","00","050","0015","1059","647","292","355","2","649","1521","0","42.67","19.20"
"64","000","00","050","0015","1060","634","273","361","5","639","1403","0","45.55","19.46"
"64","000","00","050","0015","1061","597","267","330","4","601","1308","0","45.95","20.41"
"64","000","00","050","0015","1062","611","244","367","7","618","1423","0","43.43","17.15"
"64","000","00","050","0016","0000","1625","645","980","4","1629","3486","0","46.73","18.50"
"64","000","00","050","0016","1063","433","179","254","2","435","1021","0","42.61","17.53"
"64","000","00","050","0016","1064","627","253","374","1","628","1291","0","48.64","19.60"
"64","000","00","050","0016","1065","565","213","352","1","566","1174","0","48.21","18.14"
"64","000","00","050","0017","0000","2078","804","1274","13","2091","4824","0","43.35","16.67"
"64","000","00","050","0017","1066","568","260","308","3","571","1249","0","45.72","20.82"
"64","000","00","050","0017","1067","453","205","248","2","455","1252","0","36.34","16.37"
"64","000","00","050","0017","1068","548","186","362","5","553","1171","0","47.22","15.88"
"64","000","00","050","0017","1069","509","153","356","3","512","1152","0","44.44","13.28"
"64","000","00","050","0018","0000","1524","562","962","13","1537","3831","0","40.12","14.67"
"64","000","00","050","0018","1070","502","185","317","6","508","1300","0","39.08","14.23"
"64","000","00","050","0018","1071","508","185","323","3","511","1224","0","41.75","15.11"
"64","000","00","050","0018","1072","514","192","322","4","518","1307","0","39.63","14.69"
"64","000","00","050","0019","0000","2746","1071","1675","16","2762","6396","0","43.18","16.74"
"64","000","00","050","0019","1073","653","235","418","5","658","1506","0","43.69","15.60"
"64","000","00","050","0019","1074","696","255","441","5","701","1569","0","44.68","16.25"
"64","000","00","050","0019","1075","705","302","403","1","706","1674","0","42.17","18.04"
"64","000","00","050","0019","1076","692","279","413","5","697","1647","0","42.32","16.94"
"64","000","00","050","0020","0000","1225","443","782","8","1233","2807","0","43.93","15.78"
"64","000","00","050","0020","1077","626","222","404","2","628","1481","0","42.40","14.99"
"64","000","00","050","0020","1078","599","221","378","6","605","1326","0","45.63","16.67"
"64","000","00","050","0021","0000","1349","620","729","9","1358","3089","0","43.96","20.07"
"64","000","00","050","0021","1079","674","326","348","3","677","1507","0","44.92","21.63"
"64","000","00","050","0021","1080","675","294","381","6","681","1582","0","43.05","18.58"
"64","000","00","050","0022","0000","3204","1334","1870","19","3223","7514","0","42.89","17.75"
"64","000","00","050","0022","1081","606","268","338","4","610","1433","0","42.57","18.70"
"64","000","00","050","0022","1082","574","221","353","5","579","1515","0","38.22","14.59"
"64","000","00","050","0022","1083","627","239","388","3","630","1486","0","42.40","16.08"
"64","000","00","050","0022","1084","680","305","375","3","683","1523","0","44.85","20.03"
"64","000","00","050","0022","1085","717","301","416","4","721","1557","0","46.31","19.33"
"64","000","00","050","0023","0000","1222","530","692","11","1233","3030","0","40.69","17.49"
"64","000","00","050","0023","1086","628","249","379","8","636","1554","0","40.93","16.02"
"64","000","00","050","0023","1087","594","281","313","3","597","1476","0","40.45","19.04"
"64","000","00","050","0024","0000","1082","428","654","7","1089","2557","0","42.59","16.74"
"64","000","00","050","0024","1088","545","235","310","3","548","1272","0","43.08","18.47"
"64","000","00","050","0024","1089","537","193","344","4","541","1285","0","42.10","15.02"
"64","000","00","050","0025","0000","2429","1003","1426","12","2441","5630","0","43.36","17.82"
"64","000","00","050","0025","1090","589","219","370","6","595","1406","0","42.32","15.58"
"64","000","00","050","0025","1091","532","194","338","0","532","1245","0","42.73","15.58"
"64","000","00","050","0025","1092","548","240","308","3","551","1245","0","44.26","19.28"
"64","000","00","050","0025","1093","760","350","410","3","763","1734","0","44.00","20.18"
"64","000","00","050","0026","0000","2261","963","1298","20","2281","4748","0","48.04","20.28"
"64","000","00","050","0026","1094","801","310","491","10","811","1605","0","50.53","19.31"
"64","000","00","050","0026","1095","651","268","383","3","654","1432","0","45.67","18.72"
"64","000","00","050","0026","1096","809","385","424","7","816","1711","0","47.69","22.50"
"64","000","00","050","0027","0000","2798","1229","1569","24","2822","6808","0","41.45","18.05"
"64","000","00","050","0027","1097","570","225","345","4","574","1276","0","44.98","17.63"
"64","000","00","050","0027","1098","560","265","295","7","567","1336","0","42.44","19.84"
"64","000","00","050","0027","1099","517","235","282","6","523","1348","0","38.80","17.43"
"64","000","00","050","0027","1100","567","255","312","3","570","1427","0","39.94","17.87"
"64","000","00","050","0027","1101","584","249","335","4","588","1421","0","41.38","17.52"
"64","000","00","050","0028","0000","1890","757","1133","13","1903","3982","0","47.79","19.01"
"64","000","00","050","0028","1102","628","206","422","6","634","1365","0","46.45","15.09"
"64","000","00","050","0028","1103","766","371","395","2","768","1488","0","51.61","24.93"
"64","000","00","050","0028","1104","496","180","316","5","501","1129","0","44.38","15.94"
"64","000","00","050","0029","0000","2264","894","1370","10","2274","6719","0","33.84","13.31"
"64","000","00","050","0029","1105","742","303","439","4","746","3284","0","22.72","9.23"
"64","000","00","050","0029","1106","839","357","482","3","842","1758","0","47.90","20.31"
"64","000","00","050","0029","1107","683","234","449","3","686","1677","0","40.91","13.95"
"64","000","00","050","0030","0000","3290","1384","1906","18","3308","7920","0","41.77","17.47"
"64","000","00","050","0030","1108","697","269","428","3","700","1660","0","42.17","16.20"
"64","000","00","050","0030","1109","670","295","375","1","671","1525","0","44.00","19.34"
"64","000","00","050","0030","1110","589","255","334","5","594","1471","0","40.38","17.34"
"64","000","00","050","0030","1111","700","299","401","6","706","1642","0","43.00","18.21"
"64","000","00","050","0030","1112","634","266","368","3","637","1622","0","39.27","16.40"
"64","000","00","050","0031","0000","1506","617","889","7","1513","3836","0","39.44","16.08"
"64","000","00","050","0031","1113","502","174","328","5","507","1271","0","39.89","13.69"
"64","000","00","050","0031","1114","522","206","316","1","523","1311","0","39.89","15.71"
"64","000","00","050","0031","1115","482","237","245","1","483","1254","0","38.52","18.90"
"64","000","00","050","0032","0000","1011","359","652","15","1026","2898","0","35.40","12.39"
"64","000","00","050","0032","1116","452","156","296","4","456","1388","0","32.85","11.24"
"64","000","00","050","0032","1117","559","203","356","11","570","1510","0","37.75","13.44"
"64","000","00","050","0033","0000","2023","717","1306","15","2038","5297","0","38.47","13.54"
"64","000","00","050","0033","1118","642","208","434","3","645","1708","0","37.76","12.18"
"64","000","00","050","0033","1119","723","256","467","8","731","1817","0","40.23","14.09"
"64","000","00","050","0033","1120","658","253","405","4","662","1772","0","37.36","14.28"
"64","000","00","050","0034","0000","1049","410","639","7","1056","2586","0","40.84","15.85"
"64","000","00","050","0034","1121","463","169","294","6","469","1182","0","39.68","14.30"
"64","000","00","050","0034","1122","586","241","345","1","587","1404","0","41.81","17.17"
"64","000","00","050","0035","0000","771","213","558","8","779","1821","0","42.78","11.70"
"64","000","00","050","0035","1123","343","99","244","3","346","906","0","38.19","10.93"
"64","000","00","050","0035","1124","428","114","314","5","433","915","0","47.32","12.46"
"64","000","00","050","0036","0000","1428","418","1010","5","1433","3021","0","47.43","13.84"
"64","000","00","050","0036","1125","732","246","486","2","734","1594","0","46.05","15.43"
"64","000","00","050","0036","1126","696","172","524","3","699","1427","0","48.98","12.05"
"64","000","00","050","0037","0000","1379","532","847","11","1390","3493","0","39.79","15.23"
"64","000","00","050","0037","1127","419","169","250","1","420","1062","0","39.55","15.91"
"64","000","00","050","0037","1128","519","178","341","4","523","1159","0","45.13","15.36"
"64","000","00","050","0037","1129","441","185","256","6","447","1272","0","35.14","14.54"
"64","000","00","050","0038","0000","4713","2006","2707","39","4752","11804","0","40.26","16.99"
"64","000","00","050","0038","1130","601","221","380","5","606","1476","0","41.06","14.97"
"64","000","00","050","0038","1131","587","219","368","5","592","1544","0","38.34","14.18"
"64","000","00","050","0038","1132","601","288","313","5","606","1495","0","40.54","19.26"
"64","000","00","050","0038","1133","570","179","391","7","577","1385","0","41.66","12.92"
"64","000","00","050","0038","1134","630","295","335","3","633","1572","0","40.27","18.77"
"64","000","00","050","0038","1135","604","275","329","5","609","1501","0","40.57","18.32"
"64","000","00","050","0038","1136","590","275","315","8","598","1468","0","40.74","18.73"
"64","000","00","050","0038","1137","530","254","276","1","531","1363","0","38.96","18.64"
"64","000","00","050","0039","0000","1678","677","1001","7","1685","3743","0","45.02","18.09"
"64","000","00","050","0039","1138","572","228","344","4","576","1273","0","45.25","17.91"
"64","000","00","050","0039","1139","602","257","345","0","602","1306","0","46.09","19.68"
"64","000","00","050","0039","1140","504","192","312","3","507","1164","0","43.56","16.49"
"64","000","00","050","0040","0000","798","273","525","9","807","1778","0","45.39","15.35"
"64","000","00","050","0040","1141","385","154","231","6","391","866","0","45.15","17.78"
"64","000","00","050","0040","1142","413","119","294","3","416","912","0","45.61","13.05"
"64","000","00","050","0041","0000","1015","405","610","7","1022","2499","0","40.90","16.21"
"64","000","00","050","0041","1143","553","247","306","4","557","1330","0","41.88","18.57"
"64","000","00","050","0041","1144","462","158","304","3","465","1169","0","39.78","13.52"
"64","000","00","050","0042","0000","1026","358","668","8","1034","2682","0","38.55","13.35"
"64","000","00","050","0042","1145","503","171","332","4","507","1379","0","36.77","12.40"
"64","000","00","050","0042","1146","523","187","336","4","527","1303","0","40.45","14.35"
"64","000","00","050","0043","0000","773","271","502","11","784","1744","0","44.95","15.54"
"64","000","00","050","0043","1147","371","111","260","6","377","832","0","45.31","13.34"
"64","000","00","050","0043","1148","402","160","242","5","407","912","0","44.63","17.54"
"64","000","00","050","0044","0000","1851","781","1070","14","1865","4294","0","43.43","18.19"
"64","000","00","050","0044","1149","535","262","273","4","539","1315","0","40.99","19.92"
"64","000","00","050","0044","1150","648","262","386","4","652","1454","0","44.84","18.02"
"64","000","00","050","0044","1151","668","257","411","6","674","1525","0","44.20","16.85"
"64","000","00","050","0045","0000","1912","759","1153","11","1923","4233","0","45.43","17.93"
"64","000","00","050","0045","1152","647","291","356","3","650","1414","0","45.97","20.58"
"64","000","00","050","0045","1153","617","233","384","3","620","1348","0","45.99","17.28"
"64","000","00","050","0045","1154","648","235","413","5","653","1471","0","44.39","15.98"
"64","000","00","050","0046","0000","1416","489","927","7","1423","2893","0","49.19","16.90"
"64","000","00","050","0046","1155","698","240","458","2","700","1425","0","49.12","16.84"
"64","000","00","050","0046","1156","718","249","469","5","723","1468","0","49.25","16.96"
"64","000","00","050","0047","0000","1162","377","785","11","1173","2309","0","50.80","16.33"
"64","000","00","050","0047","1157","516","161","355","4","520","1035","0","50.24","15.56"
"64","000","00","050","0047","1158","646","216","430","7","653","1274","0","51.26","16.95"
"64","000","00","050","0048","0000","641","211","430","2","643","1208","0","53.23","17.47"
"64","000","00","050","0048","1159","641","211","430","2","643","1208","0","53.23","17.47"
"64","000","00","050","0049","0000","718","240","478","9","727","1482","0","49.06","16.19"
"64","000","00","050","0049","1160","718","240","478","9","727","1482","0","49.06","16.19"
"64","000","00","050","0050","0000","660","227","433","6","666","1379","0","48.30","16.46"
"64","000","00","050","0050","1161","660","227","433","6","666","1379","0","48.30","16.46"
"64","000","00","050","0051","0000","404","147","257","2","406","882","0","46.03","16.67"
"64","000","00","050","0051","1162","404","147","257","2","406","882","0","46.03","16.67"
"64","000","00","050","0052","0000","1303","471","832","11","1314","2589","0","50.75","18.19"
"64","000","00","050","0052","1163","700","256","444","5","705","1399","0","50.39","18.30"
"64","000","00","050","0052","1164","603","215","388","6","609","1190","0","51.18","18.07"
"64","000","00","050","0053","0000","989","380","609","7","996","2030","0","49.06","18.72"
"64","000","00","050","0053","1165","502","186","316","5","507","966","0","52.48","19.25"
"64","000","00","050","0053","1166","487","194","293","2","489","1064","0","45.96","18.23"
"64","000","00","050","0054","0000","871","331","540","5","876","1812","0","48.34","18.27"
"64","000","00","050","0054","1167","432","168","264","3","435","917","0","47.44","18.32"
"64","000","00","050","0054","1168","439","163","276","2","441","895","0","49.27","18.21"
"64","000","00","050","0055","0000","693","224","469","6","699","1339","0","52.20","16.73"
"64","000","00","050","0055","1169","693","224","469","6","699","1339","0","52.20","16.73"
"64","000","00","050","0056","0000","394","127","267","2","396","748","0","52.94","16.98"
"64","000","00","050","0056","1170","394","127","267","2","396","748","0","52.94","16.98"
"64","000","00","050","0057","0000","571","195","376","4","575","1023","0","56.21","19.06"
"64","000","00","050","0057","1171","571","195","376","4","575","1023","0","56.21","19.06"
"64","000","00","050","0058","0000","698","250","448","3","701","1448","0","48.41","17.27"
"64","000","00","050","0058","1172","698","250","448","3","701","1448","0","48.41","17.27"
"64","000","00","050","0059","0000","1006","330","676","5","1011","1900","0","53.21","17.37"
"64","000","00","050","0059","1173","487","154","333","4","491","946","0","51.90","16.28"
"64","000","00","050","0059","1174","519","176","343","1","520","954","0","54.51","18.45"
"64","000","00","050","0060","0000","1465","492","973","10","1475","2953","0","49.95","16.66"
"64","000","00","050","0060","1175","745","242","503","5","750","1530","0","49.02","15.82"
"64","000","00","050","0060","1176","720","250","470","5","725","1423","0","50.95","17.57"
"64","000","00","050","0061","0000","1653","651","1002","23","1676","3633","0","46.13","17.92"
"64","000","00","050","0061","1177","533","217","316","9","542","1137","0","47.67","19.09"
"64","000","00","050","0061","1178","600","213","387","11","611","1287","0","47.47","16.55"
"64","000","00","050","0061","1179","520","221","299","3","523","1209","0","43.26","18.28"
"64","000","00","050","0062","0000","1719","616","1103","14","1733","3606","0","48.06","17.08"
"64","000","00","050","0062","1180","540","200","340","3","543","1222","0","44.44","16.37"
"64","000","00","050","0062","1181","637","201","436","7","644","1264","0","50.95","15.90"
"64","000","00","050","0062","1182","542","215","327","4","546","1120","0","48.75","19.20"
"64","000","00","050","0063","0000","753","233","520","2","755","1671","0","45.18","13.94"
"64","000","00","050","0063","1183","753","233","520","2","755","1671","0","45.18","13.94"
"64","000","00","050","0064","0000","831","294","537","6","837","1690","0","49.53","17.40"
"64","000","00","050","0064","1184","449","164","285","1","450","907","0","49.61","18.08"
"64","000","00","050","0064","1185","382","130","252","5","387","783","0","49.43","16.60"
"64","000","00","050","0065","0000","932","361","571","6","938","1992","0","47.09","18.12"
"64","000","00","050","0065","1186","531","203","328","5","536","1127","0","47.56","18.01"
"64","000","00","050","0065","1187","401","158","243","1","402","865","0","46.47","18.27"
"64","000","00","050","0066","0000","336","105","231","3","339","659","0","51.44","15.93"
"64","000","00","050","0066","1188","336","105","231","3","339","659","0","51.44","15.93"
"64","000","00","050","0067","0000","385","122","263","1","386","914","0","42.23","13.35"
"64","000","00","050","0067","1189","385","122","263","1","386","914","0","42.23","13.35"
"64","000","00","050","0068","0000","590","197","393","4","594","1341","0","44.30","14.69"
"64","000","00","050","0068","1190","590","197","393","4","594","1341","0","44.30","14.69"
"64","000","00","050","0069","0000","628","262","366","3","631","1337","0","47.20","19.60"
"64","000","00","050","0069","1191","628","262","366","3","631","1337","0","47.20","19.60"
"64","000","00","050","0070","0000","333","125","208","3","336","760","0","44.21","16.45"
"64","000","00","050","0070","1192","333","125","208","3","336","760","0","44.21","16.45"
"64","000","00","050","0072","0000","537","214","323","6","543","1126","0","48.22","19.01"
"64","000","00","050","0072","1193","537","214","323","6","543","1126","0","48.22","19.01"
"64","000","00","050","0073","0000","1835","713","1122","16","1851","3922","0","47.20","18.18"
"64","000","00","050","0073","1194","584","232","352","6","590","1299","0","45.42","17.86"
"64","000","00","050","0073","1195","618","214","404","5","623","1300","0","47.92","16.46"
"64","000","00","050","0073","1196","633","267","366","5","638","1323","0","48.22","20.18"
"64","000","00","050","0074","0000","420","182","238","6","426","1008","0","42.26","18.06"
"64","000","00","050","0074","1197","420","182","238","6","426","1008","0","42.26","18.06"
"64","000","00","050","0075","0000","449","198","251","1","450","1147","0","39.23","17.26"
"64","000","00","050","0075","1198","449","198","251","1","450","1147","0","39.23","17.26"
"64","000","00","050","0076","0000","862","360","502","8","870","1905","0","45.67","18.90"
"64","000","00","050","0076","1199","422","165","257","5","427","915","0","46.67","18.03"
"64","000","00","050","0076","1200","440","195","245","3","443","990","0","44.75","19.70"
"64","000","00","050","0077","0000","457","139","318","6","463","886","0","52.26","15.69"
"64","000","00","050","0077","1201","457","139","318","6","463","886","0","52.26","15.69"
"64","000","00","050","0078","0000","656","207","449","8","664","1307","0","50.80","15.84"
"64","000","00","050","0078","1202","656","207","449","8","664","1307","0","50.80","15.84"
"64","000","00","050","0079","0000","426","166","260","5","431","998","0","43.19","16.63"
"64","000","00","050","0079","1203","426","166","260","5","431","998","0","43.19","16.63"
"64","000","00","050","0081","0000","974","339","635","7","981","2347","0","41.80","14.44"
"64","000","00","050","0081","1204","487","168","319","3","490","1206","0","40.63","13.93"
"64","000","00","050","0081","1205","487","171","316","4","491","1141","0","43.03","14.99"
"64","000","00","050","0082","0000","526","190","336","3","529","1212","0","43.65","15.68"
"64","000","00","050","0082","1206","526","190","336","3","529","1212","0","43.65","15.68"
"64","000","00","050","0083","0000","504","195","309","3","507","1226","0","41.35","15.91"
"64","000","00","050","0083","1207","504","195","309","3","507","1226","0","41.35","15.91"
"64","000","00","050","0084","0000","494","186","308","2","496","1046","0","47.42","17.78"
"64","000","00","050","0084","1208","494","186","308","2","496","1046","0","47.42","17.78"
"64","000","00","050","0085","0000","576","225","351","8","584","1082","0","53.97","20.79"
"64","000","00","050","0085","1209","576","225","351","8","584","1082","0","53.97","20.79"
"64","000","00","050","0086","0000","559","218","341","1","560","1156","0","48.44","18.86"
"64","000","00","050","0086","1210","559","218","341","1","560","1156","0","48.44","18.86"
"64","000","00","050","0087","0000","460","154","306","3","463","1009","0","45.89","15.26"
"64","000","00","050","0087","1211","460","154","306","3","463","1009","0","45.89","15.26"
"64","000","00","050","0088","0000","878","299","579","7","885","1967","0","44.99","15.20"
"64","000","00","050","0088","1212","423","144","279","2","425","925","0","45.95","15.57"
"64","000","00","050","0088","1213","455","155","300","5","460","1042","0","44.15","14.88"
"64","000","00","060","0000","0000","20096","8295","11801","137","20233","43307","49925","46.72","19.15"
"64","000","00","060","0001","0000","838","405","433","2","840","1749","0","48.03","23.16"
"64","000","00","060","0001","1346","392","192","200","0","392","794","0","49.37","24.18"
"64","000","00","060","0001","1347","446","213","233","2","448","955","0","46.91","22.30"
"64","000","00","060","0002","0000","484","211","273","2","486","1026","0","47.37","20.57"
"64","000","00","060","0002","1348","484","211","273","2","486","1026","0","47.37","20.57"
"64","000","00","060","0003","0000","1302","580","722","9","1311","2842","0","46.13","20.41"
"64","000","00","060","0003","1349","664","275","389","6","670","1394","0","48.06","19.73"
"64","000","00","060","0003","1350","638","305","333","3","641","1448","0","44.27","21.06"
"64","000","00","060","0004","0000","493","224","269","3","496","1011","0","49.06","22.16"
"64","000","00","060","0004","1351","493","224","269","3","496","1011","0","49.06","22.16"
"64","000","00","060","0005","0000","645","274","371","4","649","1282","0","50.62","21.37"
"64","000","00","060","0005","1352","645","274","371","4","649","1282","0","50.62","21.37"
"64","000","00","060","0006","0000","301","158","143","6","307","626","0","49.04","25.24"
"64","000","00","060","0006","1353","301","158","143","6","307","626","0","49.04","25.24"
"64","000","00","060","0007","0000","417","164","253","4","421","979","0","43.00","16.75"
"64","000","00","060","0007","1354","417","164","253","4","421","979","0","43.00","16.75"
"64","000","00","060","0008","0000","828","343","485","4","832","1808","0","46.02","18.97"
"64","000","00","060","0008","1355","434","188","246","3","437","883","0","49.49","21.29"
"64","000","00","060","0008","1356","394","155","239","1","395","925","0","42.70","16.76"
"64","000","00","060","0009","0000","407","148","259","3","410","902","0","45.45","16.41"
"64","000","00","060","0009","1357","407","148","259","3","410","902","0","45.45","16.41"
"64","000","00","060","0010","0000","358","146","212","7","365","706","0","51.70","20.68"
"64","000","00","060","0010","1358","358","146","212","7","365","706","0","51.70","20.68"
"64","000","00","060","0011","0000","593","221","372","7","600","1289","0","46.55","17.15"
"64","000","00","060","0011","1359","593","221","372","7","600","1289","0","46.55","17.15"
"64","000","00","060","0012","0000","315","117","198","3","318","736","0","43.21","15.90"
"64","000","00","060","0012","1360","315","117","198","3","318","736","0","43.21","15.90"
"64","000","00","060","0013","0000","855","335","520","2","857","1998","0","42.89","16.77"
"64","000","00","060","0013","1361","459","168","291","2","461","1026","0","44.93","16.37"
"64","000","00","060","0013","1362","396","167","229","0","396","972","0","40.74","17.18"
"64","000","00","060","0014","0000","1326","557","769","3","1329","2739","0","48.52","20.34"
"64","000","00","060","0014","1363","733","312","421","1","734","1469","0","49.97","21.24"
"64","000","00","060","0014","1364","593","245","348","2","595","1270","0","46.85","19.29"
"64","000","00","060","0015","0000","1053","467","586","7","1060","2197","0","48.25","21.26"
"64","000","00","060","0015","1365","537","213","324","4","541","1173","0","46.12","18.16"
"64","000","00","060","0015","1366","516","254","262","3","519","1024","0","50.68","24.80"
"64","000","00","060","0016","0000","782","346","436","9","791","1572","0","50.32","22.01"
"64","000","00","060","0016","1367","360","165","195","4","364","697","0","52.22","23.67"
"64","000","00","060","0016","1368","422","181","241","5","427","875","0","48.80","20.69"
"64","000","00","060","0017","0000","1583","693","890","8","1591","3254","0","48.89","21.30"
"64","000","00","060","0017","1369","494","230","264","4","498","1064","0","46.80","21.62"
"64","000","00","060","0017","1370","508","214","294","2","510","1108","0","46.03","19.31"
"64","000","00","060","0017","1371","581","249","332","2","583","1082","0","53.88","23.01"
"64","000","00","060","0018","0000","588","298","290","2","590","1299","0","45.42","22.94"
"64","000","00","060","0018","1372","588","298","290","2","590","1299","0","45.42","22.94"
"64","000","00","060","0019","0000","454","160","294","6","460","1074","0","42.83","14.90"
"64","000","00","060","0019","1373","454","160","294","6","460","1074","0","42.83","14.90"
"64","000","00","060","0020","0000","382","146","236","6","388","801","0","48.44","18.23"
"64","000","00","060","0020","1374","382","146","236","6","388","801","0","48.44","18.23"
"64","000","00","060","0021","0000","437","167","270","2","439","996","0","44.08","16.77"
"64","000","00","060","0021","1375","437","167","270","2","439","996","0","44.08","16.77"
"64","000","00","060","0022","0000","988","328","660","8","996","1859","0","53.58","17.64"
"64","000","00","060","0022","1376","487","152","335","3","490","901","0","54.38","16.87"
"64","000","00","060","0022","1377","501","176","325","5","506","958","0","52.82","18.37"
"64","000","00","060","0023","0000","1075","476","599","4","1079","2712","0","39.79","17.55"
"64","000","00","060","0023","1378","449","194","255","3","452","1363","0","33.16","14.23"
"64","000","00","060","0023","1379","626","282","344","1","627","1349","0","46.48","20.90"
"64","000","00","060","0024","0000","308","114","194","1","309","692","0","44.65","16.47"
"64","000","00","060","0024","1380","308","114","194","1","309","692","0","44.65","16.47"
"64","000","00","060","0025","0000","473","180","293","6","479","1021","0","46.91","17.63"
"64","000","00","060","0025","1381","473","180","293","6","479","1021","0","46.91","17.63"
"64","000","00","060","0026","0000","415","155","260","4","419","960","0","43.65","16.15"
"64","000","00","060","0026","1382","415","155","260","4","419","960","0","43.65","16.15"
"64","000","00","060","0027","0000","386","152","234","6","392","934","0","41.97","16.27"
"64","000","00","060","0027","1383","386","152","234","6","392","934","0","41.97","16.27"
"64","000","00","060","0028","0000","386","142","244","1","387","919","0","42.11","15.45"
"64","000","00","060","0028","1384","386","142","244","1","387","919","0","42.11","15.45"
"64","000","00","060","0029","0000","388","123","265","3","391","785","0","49.81","15.67"
"64","000","00","060","0029","1385","388","123","265","3","391","785","0","49.81","15.67"
"64","000","00","060","0030","0000","328","118","210","1","329","685","0","48.03","17.23"
"64","000","00","060","0030","1386","328","118","210","1","329","685","0","48.03","17.23"
"64","000","00","060","0031","0000","333","160","173","1","334","702","0","47.58","22.79"
"64","000","00","060","0031","1387","333","160","173","1","334","702","0","47.58","22.79"
"64","000","00","060","0032","0000","575","187","388","3","578","1152","0","50.17","16.23"
"64","000","00","060","0032","1388","575","187","388","3","578","1152","0","50.17","16.23"
"64","000","00","070","0000","0000","11104","4633","6471","74","11178","23787","26498","46.99","19.48"
"64","000","00","070","0001","0000","324","88","236","4","328","658","0","49.85","13.37"
"64","000","00","070","0001","1321","324","88","236","4","328","658","0","49.85","13.37"
"64","000","00","070","0002","0000","487","223","264","4","491","983","0","49.95","22.69"
"64","000","00","070","0002","1322","487","223","264","4","491","983","0","49.95","22.69"
"64","000","00","070","0003","0000","580","202","378","6","586","1310","0","44.73","15.42"
"64","000","00","070","0003","1323","580","202","378","6","586","1310","0","44.73","15.42"
"64","000","00","070","0004","0000","372","136","236","1","373","809","0","46.11","16.81"
"64","000","00","070","0004","1324","372","136","236","1","373","809","0","46.11","16.81"
"64","000","00","070","0005","0000","473","171","302","1","474","957","0","49.53","17.87"
"64","000","00","070","0005","1325","473","171","302","1","474","957","0","49.53","17.87"
"64","000","00","070","0006","0000","1629","743","886","6","1635","3581","0","45.66","20.75"
"64","000","00","070","0006","1326","565","281","284","5","570","1215","0","46.91","23.13"
"64","000","00","070","0006","1327","587","246","341","1","588","1234","0","47.65","19.94"
"64","000","00","070","0006","1328","477","216","261","0","477","1132","0","42.14","19.08"
"64","000","00","070","0007","0000","309","136","173","2","311","662","0","46.98","20.54"
"64","000","00","070","0007","1329","309","136","173","2","311","662","0","46.98","20.54"
"64","000","00","070","0008","0000","531","230","301","4","535","1150","0","46.52","20.00"
"64","000","00","070","0008","1330","531","230","301","4","535","1150","0","46.52","20.00"
"64","000","00","070","0009","0000","810","320","490","11","821","1817","0","45.18","17.61"
"64","000","00","070","0009","1331","409","166","243","7","416","895","0","46.48","18.55"
"64","000","00","070","0009","1332","401","154","247","4","405","922","0","43.93","16.70"
"64","000","00","070","0010","0000","350","160","190","1","351","778","0","45.12","20.57"
"64","000","00","070","0010","1333","350","160","190","1","351","778","0","45.12","20.57"
"64","000","00","070","0011","0000","477","203","274","3","480","992","0","48.39","20.46"
"64","000","00","070","0011","1334","477","203","274","3","480","992","0","48.39","20.46"
"64","000","00","070","0012","0000","403","143","260","3","406","1030","0","39.42","13.88"
"64","000","00","070","0012","1335","403","143","260","3","406","1030","0","39.42","13.88"
"64","000","00","070","0013","0000","412","165","247","2","414","901","0","45.95","18.31"
"64","000","00","070","0013","1336","412","165","247","2","414","901","0","45.95","18.31"
"64","000","00","070","0014","0000","678","319","359","4","682","1424","0","47.89","22.40"
"64","000","00","070","0014","1337","325","166","159","0","325","698","0","46.56","23.78"
"64","000","00","070","0014","1338","353","153","200","4","357","726","0","49.17","21.07"
"64","000","00","070","0015","0000","507","238","269","3","510","1017","0","50.15","23.40"
"64","000","00","070","0015","1339","507","238","269","3","510","1017","0","50.15","23.40"
"64","000","00","070","0016","0000","465","191","274","2","467","986","0","47.36","19.37"
"64","000","00","070","0016","1340","465","191","274","2","467","986","0","47.36","19.37"
"64","000","00","070","0017","0000","823","375","448","3","826","1640","0","50.37","22.87"
"64","000","00","070","0017","1341","424","198","226","2","426","863","0","49.36","22.94"
"64","000","00","070","0017","1342","399","177","222","1","400","777","0","51.48","22.78"
"64","000","00","070","0018","0000","487","198","289","4","491","1043","0","47.08","18.98"
"64","000","00","070","0018","1343","487","198","289","4","491","1043","0","47.08","18.98"
"64","000","00","070","0019","0000","448","170","278","5","453","941","0","48.14","18.07"
"64","000","00","070","0019","1344","448","170","278","5","453","941","0","48.14","18.07"
"64","000","00","070","0020","0000","539","222","317","5","544","1108","0","49.10","20.04"
"64","000","00","070","0020","1345","539","222","317","5","544","1108","0","49.10","20.04"
"64","000","00","080","0000","0000","64792","27605","37187","483","65275","143752","166008","45.41","19.20"
"64","000","00","080","0001","0000","337","158","179","4","341","681","0","50.07","23.20"
"64","000","00","080","0001","1389","337","158","179","4","341","681","0","50.07","23.20"
"64","000","00","080","0002","0000","623","292","331","7","630","1496","0","42.11","19.52"
"64","000","00","080","0002","1390","329","156","173","6","335","785","0","42.68","19.87"
"64","000","00","080","0002","1391","294","136","158","1","295","711","0","41.49","19.13"
"64","000","00","080","0003","0000","503","215","288","5","508","1147","0","44.29","18.74"
"64","000","00","080","0003","1392","503","215","288","5","508","1147","0","44.29","18.74"
"64","000","00","080","0004","0000","704","272","432","10","714","1552","0","46.01","17.53"
"64","000","00","080","0004","1393","330","140","190","5","335","739","0","45.33","18.94"
"64","000","00","080","0004","1394","374","132","242","5","379","813","0","46.62","16.24"
"64","000","00","080","0005","0000","607","277","330","4","611","1384","0","44.15","20.01"
"64","000","00","080","0005","1395","295","140","155","1","296","681","0","43.47","20.56"
"64","000","00","080","0005","1396","312","137","175","3","315","703","0","44.81","19.49"
"64","000","00","080","0006","0000","602","204","398","2","604","1405","0","42.99","14.52"
"64","000","00","080","0006","1397","321","99","222","1","322","720","0","44.72","13.75"
"64","000","00","080","0006","1398","281","105","176","1","282","685","0","41.17","15.33"
"64","000","00","080","0007","0000","659","273","386","3","662","1540","0","42.99","17.73"
"64","000","00","080","0007","1399","314","154","160","1","315","773","0","40.75","19.92"
"64","000","00","080","0007","1400","345","119","226","2","347","767","0","45.24","15.51"
"64","000","00","080","0008","0000","258","102","156","2","260","506","0","51.38","20.16"
"64","000","00","080","0008","1401","258","102","156","2","260","506","0","51.38","20.16"
"64","000","00","080","0009","0000","797","334","463","9","806","1861","0","43.31","17.95"
"64","000","00","080","0009","1402","378","170","208","5","383","919","0","41.68","18.50"
"64","000","00","080","0009","1403","419","164","255","4","423","942","0","44.90","17.41"
"64","000","00","080","0010","0000","1385","657","728","9","1394","3663","0","38.06","17.94"
"64","000","00","080","0010","1404","465","201","264","1","466","1119","0","41.64","17.96"
"64","000","00","080","0010","1405","473","230","243","3","476","1305","0","36.48","17.62"
"64","000","00","080","0010","1406","447","226","221","5","452","1239","0","36.48","18.24"
"64","000","00","080","0011","0000","411","150","261","1","412","878","0","46.92","17.08"
"64","000","00","080","0011","1407","411","150","261","1","412","878","0","46.92","17.08"
"64","000","00","080","0012","0000","605","258","347","8","613","1259","0","48.69","20.49"
"64","000","00","080","0012","1408","605","258","347","8","613","1259","0","48.69","20.49"
"64","000","00","080","0013","0000","719","286","433","8","727","1714","0","42.42","16.69"
"64","000","00","080","0013","1409","367","140","227","4","371","881","0","42.11","15.89"
"64","000","00","080","0013","1410","352","146","206","4","356","833","0","42.74","17.53"
"64","000","00","080","0014","0000","634","288","346","5","639","1191","0","53.65","24.18"
"64","000","00","080","0014","1411","634","288","346","5","639","1191","0","53.65","24.18"
"64","000","00","080","0015","0000","817","293","524","5","822","1686","0","48.75","17.38"
"64","000","00","080","0015","1412","419","156","263","5","424","866","0","48.96","18.01"
"64","000","00","080","0015","1413","398","137","261","0","398","820","0","48.54","16.71"
"64","000","00","080","0016","0000","490","208","282","4","494","1085","0","45.53","19.17"
"64","000","00","080","0016","1414","490","208","282","4","494","1085","0","45.53","19.17"
"64","000","00","080","0017","0000","1374","587","787","9","1383","2948","0","46.91","19.91"
"64","000","00","080","0017","1415","479","199","280","3","482","959","0","50.26","20.75"
"64","000","00","080","0017","1416","469","192","277","3","472","987","0","47.82","19.45"
"64","000","00","080","0017","1417","426","196","230","3","429","1002","0","42.81","19.56"
"64","000","00","080","0018","0000","1002","390","612","3","1005","2080","0","48.32","18.75"
"64","000","00","080","0018","1418","519","173","346","2","521","1045","0","49.86","16.56"
"64","000","00","080","0018","1419","483","217","266","1","484","1035","0","46.76","20.97"
"64","000","00","080","0019","0000","1391","570","821","5","1396","2971","0","46.99","19.19"
"64","000","00","080","0019","1420","485","185","300","0","485","1006","0","48.21","18.39"
"64","000","00","080","0019","1421","443","197","246","1","444","960","0","46.25","20.52"
"64","000","00","080","0019","1422","463","188","275","4","467","1005","0","46.47","18.71"
"64","000","00","080","0020","0000","900","392","508","4","904","1962","0","46.08","19.98"
"64","000","00","080","0020","1423","451","223","228","2","453","971","0","46.65","22.97"
"64","000","00","080","0020","1424","449","169","280","2","451","991","0","45.51","17.05"
"64","000","00","080","0021","0000","754","330","424","4","758","2551","0","29.71","12.94"
"64","000","00","080","0021","1425","567","241","326","3","570","1215","0","46.91","19.84"
"64","000","00","080","0021","1426","187","89","98","1","188","1336","0","14.07","6.66"
"64","000","00","080","0022","0000","1567","689","878","10","1577","3394","0","46.46","20.30"
"64","000","00","080","0022","1427","547","257","290","4","551","1116","0","49.37","23.03"
"64","000","00","080","0022","1428","558","236","322","3","561","1267","0","44.28","18.63"
"64","000","00","080","0022","1429","462","196","266","3","465","1011","0","45.99","19.39"
"64","000","00","080","0023","0000","1030","444","586","6","1036","2101","0","49.31","21.13"
"64","000","00","080","0023","1430","575","218","357","4","579","1182","0","48.98","18.44"
"64","000","00","080","0023","1431","455","226","229","2","457","919","0","49.73","24.59"
"64","000","00","080","0024","0000","1061","514","547","5","1066","2233","0","47.74","23.02"
"64","000","00","080","0024","1432","541","283","258","4","545","1113","0","48.97","25.43"
"64","000","00","080","0024","1433","520","231","289","1","521","1120","0","46.52","20.63"
"64","000","00","080","0025","0000","650","312","338","2","652","1434","0","45.47","21.76"
"64","000","00","080","0025","1434","319","139","180","1","320","702","0","45.58","19.80"
"64","000","00","080","0025","1435","331","173","158","1","332","732","0","45.36","23.63"
"64","000","00","080","0026","0000","318","106","212","5","323","666","0","48.50","15.92"
"64","000","00","080","0026","1436","318","106","212","5","323","666","0","48.50","15.92"
"64","000","00","080","0027","0000","556","166","390","3","559","1226","0","45.60","13.54"
"64","000","00","080","0027","1437","285","90","195","0","285","590","0","48.31","15.25"
"64","000","00","080","0027","1438","271","76","195","3","274","636","0","43.08","11.95"
"64","000","00","080","0028","0000","1215","456","759","6","1221","2632","0","46.39","17.33"
"64","000","00","080","0028","1439","397","136","261","1","398","846","0","47.04","16.08"
"64","000","00","080","0028","1440","427","155","272","2","429","873","0","49.14","17.75"
"64","000","00","080","0028","1441","391","165","226","3","394","913","0","43.15","18.07"
"64","000","00","080","0029","0000","665","276","389","2","667","1516","0","44.00","18.21"
"64","000","00","080","0029","1442","339","141","198","1","340","777","0","43.76","18.15"
"64","000","00","080","0029","1443","326","135","191","1","327","739","0","44.25","18.27"
"64","000","00","080","0030","0000","1250","504","746","9","1259","2734","0","46.05","18.43"
"64","000","00","080","0030","1444","450","173","277","2","452","975","0","46.36","17.74"
"64","000","00","080","0030","1445","404","154","250","6","410","904","0","45.35","17.04"
"64","000","00","080","0030","1446","396","177","219","1","397","855","0","46.43","20.70"
"64","000","00","080","0031","0000","876","423","453","5","881","1845","0","47.75","22.93"
"64","000","00","080","0031","1447","437","193","244","3","440","899","0","48.94","21.47"
"64","000","00","080","0031","1448","439","230","209","2","441","946","0","46.62","24.31"
"64","000","00","080","0032","0000","1308","655","653","6","1314","2771","0","47.42","23.64"
"64","000","00","080","0032","1449","412","222","190","2","414","866","0","47.81","25.64"
"64","000","00","080","0032","1450","445","228","217","1","446","905","0","49.28","25.19"
"64","000","00","080","0032","1451","451","205","246","3","454","1000","0","45.40","20.50"
"64","000","00","080","0033","0000","1263","558","705","14","1277","2724","0","46.88","20.48"
"64","000","00","080","0033","1452","449","212","237","4","453","923","0","49.08","22.97"
"64","000","00","080","0033","1453","397","174","223","4","401","855","0","46.90","20.35"
"64","000","00","080","0033","1454","417","172","245","6","423","946","0","44.71","18.18"
"64","000","00","080","0034","0000","691","294","397","9","700","1480","0","47.30","19.86"
"64","000","00","080","0034","1455","357","149","208","6","363","756","0","48.02","19.71"
"64","000","00","080","0034","1456","334","145","189","3","337","724","0","46.55","20.03"
"64","000","00","080","0035","0000","987","472","515","8","995","2090","0","47.61","22.58"
"64","000","00","080","0035","1457","467","237","230","2","469","1021","0","45.94","23.21"
"64","000","00","080","0035","1458","520","235","285","6","526","1069","0","49.20","21.98"
"64","000","00","080","0036","0000","940","496","444","2","942","2096","0","44.94","23.66"
"64","000","00","080","0036","1459","487","242","245","1","488","1054","0","46.30","22.96"
"64","000","00","080","0036","1460","453","254","199","1","454","1042","0","43.57","24.38"
"64","000","00","080","0037","0000","1103","482","621","11","1114","2380","0","46.81","20.25"
"64","000","00","080","0037","1461","594","242","352","6","600","1274","0","47.10","19.00"
"64","000","00","080","0037","1462","509","240","269","5","514","1106","0","46.47","21.70"
"64","000","00","080","0038","0000","710","338","372","7","717","1489","0","48.15","22.70"
"64","000","00","080","0038","1463","321","154","167","3","324","697","0","46.48","22.09"
"64","000","00","080","0038","1464","389","184","205","4","393","792","0","49.62","23.23"
"64","000","00","080","0039","0000","680","212","468","6","686","1389","0","49.39","15.26"
"64","000","00","080","0039","1465","326","106","220","4","330","705","0","46.81","15.04"
"64","000","00","080","0039","1466","354","106","248","2","356","684","0","52.05","15.50"
"64","000","00","080","0040","0000","787","301","486","10","797","1620","0","49.20","18.58"
"64","000","00","080","0040","1467","371","132","239","5","376","765","0","49.15","17.25"
"64","000","00","080","0040","1468","416","169","247","5","421","855","0","49.24","19.77"
"64","000","00","080","0041","0000","1093","483","610","11","1104","2086","0","52.92","23.15"
"64","000","00","080","0041","1469","587","254","333","6","593","1110","0","53.42","22.88"
"64","000","00","080","0041","1470","506","229","277","5","511","976","0","52.36","23.46"
"64","000","00","080","0042","0000","1732","731","1001","16","1748","3752","0","46.59","19.48"
"64","000","00","080","0042","1471","445","179","266","7","452","914","0","49.45","19.58"
"64","000","00","080","0042","1472","384","155","229","3","387","851","0","45.48","18.21"
"64","000","00","080","0042","1473","415","157","258","2","417","923","0","45.18","17.01"
"64","000","00","080","0042","1474","488","240","248","4","492","1064","0","46.24","22.56"
"64","000","00","080","0043","0000","832","370","462","4","836","1742","0","47.99","21.24"
"64","000","00","080","0043","1475","452","215","237","3","455","931","0","48.87","23.09"
"64","000","00","080","0043","1476","380","155","225","1","381","811","0","46.98","19.11"
"64","000","00","080","0044","0000","775","338","437","6","781","1748","0","44.68","19.34"
"64","000","00","080","0044","1477","397","187","210","2","399","855","0","46.67","21.87"
"64","000","00","080","0044","1478","378","151","227","4","382","893","0","42.78","16.91"
"64","000","00","080","0045","0000","1663","762","901","12","1675","3776","0","44.36","20.18"
"64","000","00","080","0045","1479","557","290","267","5","562","1250","0","44.96","23.20"
"64","000","00","080","0045","1480","606","259","347","4","610","1284","0","47.51","20.17"
"64","000","00","080","0045","1481","500","213","287","3","503","1242","0","40.50","17.15"
"64","000","00","080","0046","0000","812","307","505","10","822","1791","0","45.90","17.14"
"64","000","00","080","0046","1482","401","161","240","4","405","894","0","45.30","18.01"
"64","000","00","080","0046","1483","411","146","265","6","417","897","0","46.49","16.28"
"64","000","00","080","0047","0000","731","419","312","12","743","1489","0","49.90","28.14"
"64","000","00","080","0047","1484","367","191","176","9","376","774","0","48.58","24.68"
"64","000","00","080","0047","1485","364","228","136","3","367","715","0","51.33","31.89"
"64","000","00","080","0048","0000","618","245","373","4","622","1371","0","45.37","17.87"
"64","000","00","080","0048","1486","325","123","202","3","328","714","0","45.94","17.23"
"64","000","00","080","0048","1487","293","122","171","1","294","657","0","44.75","18.57"
"64","000","00","080","0049","0000","1129","398","731","11","1140","2410","0","47.30","16.51"
"64","000","00","080","0049","1488","561","210","351","3","564","1205","0","46.80","17.43"
"64","000","00","080","0049","1489","568","188","380","8","576","1205","0","47.80","15.60"
"64","000","00","080","0050","0000","527","240","287","3","530","1158","0","45.77","20.73"
"64","000","00","080","0050","1490","527","240","287","3","530","1158","0","45.77","20.73"
"64","000","00","080","0051","0000","456","232","224","1","457","1023","0","44.67","22.68"
"64","000","00","080","0051","1491","456","232","224","1","457","1023","0","44.67","22.68"
"64","000","00","080","0052","0000","853","285","568","8","861","1787","0","48.18","15.95"
"64","000","00","080","0052","1492","429","127","302","6","435","907","0","47.96","14.00"
"64","000","00","080","0052","1493","424","158","266","2","426","880","0","48.41","17.95"
"64","000","00","080","0053","0000","822","346","476","7","829","1974","0","42.00","17.53"
"64","000","00","080","0053","1494","446","179","267","5","451","1084","0","41.61","16.51"
"64","000","00","080","0053","1495","376","167","209","2","378","890","0","42.47","18.76"
"64","000","00","080","0054","0000","1067","446","621","13","1080","2537","0","42.57","17.58"
"64","000","00","080","0054","1496","514","197","317","5","519","1276","0","40.67","15.44"
"64","000","00","080","0054","1497","553","249","304","8","561","1261","0","44.49","19.75"
"64","000","00","080","0055","0000","1065","372","693","3","1068","2583","0","41.35","14.40"
"64","000","00","080","0055","1498","482","177","305","2","484","1278","0","37.87","13.85"
"64","000","00","080","0055","1499","583","195","388","1","584","1305","0","44.75","14.94"
"64","000","00","080","0056","0000","1093","466","627","9","1102","2521","0","43.71","18.48"
"64","000","00","080","0056","1500","498","198","300","4","502","1165","0","43.09","17.00"
"64","000","00","080","0056","1501","595","268","327","5","600","1356","0","44.25","19.76"
"64","000","00","080","0057","0000","781","288","493","7","788","1685","0","46.77","17.09"
"64","000","00","080","0057","1502","391","143","248","2","393","809","0","48.58","17.68"
"64","000","00","080","0057","1503","390","145","245","5","395","876","0","45.09","16.55"
"64","000","00","080","0058","0000","983","440","543","6","989","2051","0","48.22","21.45"
"64","000","00","080","0058","1504","530","239","291","3","533","1035","0","51.50","23.09"
"64","000","00","080","0058","1505","453","201","252","3","456","1016","0","44.88","19.78"
"64","000","00","080","0059","0000","991","412","579","6","997","2240","0","44.51","18.39"
"64","000","00","080","0059","1506","485","209","276","3","488","1092","0","44.69","19.14"
"64","000","00","080","0059","1507","506","203","303","3","509","1148","0","44.34","17.68"
"64","000","00","080","0060","0000","1202","513","689","7","1209","2641","0","45.78","19.42"
"64","000","00","080","0060","1508","406","191","215","4","410","872","0","47.02","21.90"
"64","000","00","080","0060","1509","331","148","183","1","332","772","0","43.01","19.17"
"64","000","00","080","0060","1510","465","174","291","2","467","997","0","46.84","17.45"
"64","000","00","080","0061","0000","1996","966","1030","16","2012","4822","0","41.73","20.03"
"64","000","00","080","0061","1511","542","284","258","4","546","1250","0","43.68","22.72"
"64","000","00","080","0061","1512","462","223","239","5","467","1057","0","44.18","21.10"
"64","000","00","080","0061","1513","491","206","285","3","494","1239","0","39.87","16.63"
"64","000","00","080","0061","1514","501","253","248","4","505","1276","0","39.58","19.83"
"64","000","00","080","0062","0000","1630","700","930","18","1648","3581","0","46.02","19.55"
"64","000","00","080","0062","1515","591","280","311","5","596","1189","0","50.13","23.55"
"64","000","00","080","0062","1516","501","206","295","8","509","1167","0","43.62","17.65"
"64","000","00","080","0062","1517","538","214","324","5","543","1225","0","44.33","17.47"
"64","000","00","080","0063","0000","1596","709","887","9","1605","3399","0","47.22","20.86"
"64","000","00","080","0063","1518","534","232","302","6","540","1149","0","47.00","20.19"
"64","000","00","080","0063","1519","508","220","288","1","509","1137","0","44.77","19.35"
"64","000","00","080","0063","1520","554","257","297","2","556","1113","0","49.96","23.09"
"64","000","00","080","0064","0000","1721","733","988","11","1732","4055","0","42.71","18.08"
"64","000","00","080","0064","1521","576","246","330","5","581","1372","0","42.35","17.93"
"64","000","00","080","0064","1522","536","222","314","5","541","1318","0","41.05","16.84"
"64","000","00","080","0064","1523","609","265","344","1","610","1365","0","44.69","19.41"
"64","000","00","080","0065","0000","1159","429","730","5","1164","2329","0","49.98","18.42"
"64","000","00","080","0065","1524","546","196","350","3","549","1155","0","47.53","16.97"
"64","000","00","080","0065","1525","613","233","380","2","615","1174","0","52.39","19.85"
"64","000","00","080","0066","0000","1007","454","553","5","1012","2409","0","42.01","18.85"
"64","000","00","080","0066","1526","484","208","276","3","487","1188","0","40.99","17.51"
"64","000","00","080","0066","1527","523","246","277","2","525","1221","0","43.00","20.15"
"64","000","00","080","0067","0000","1544","557","987","14","1558","3573","0","43.60","15.59"
"64","000","00","080","0067","1528","535","179","356","11","546","1192","0","45.81","15.02"
"64","000","00","080","0067","1529","501","194","307","1","502","1202","0","41.76","16.14"
"64","000","00","080","0067","1530","508","184","324","2","510","1179","0","43.26","15.61"
"64","000","00","080","0068","0000","801","307","494","5","806","1945","0","41.44","15.78"
"64","000","00","080","0068","1531","376","135","241","2","378","920","0","41.09","14.67"
"64","000","00","080","0068","1532","425","172","253","3","428","1025","0","41.76","16.78"
"64","000","00","080","0069","0000","884","423","461","7","891","1894","0","47.04","22.33"
"64","000","00","080","0069","1533","449","208","241","1","450","957","0","47.02","21.73"
"64","000","00","080","0069","1534","435","215","220","6","441","937","0","47.07","22.95"
"64","000","00","090","0000","0000","70064","27618","42446","573","70637","159582","184355","44.26","17.31"
"64","000","00","090","0001","0000","3572","1141","2431","42","3614","9285","0","38.92","12.29"
"64","000","00","090","0001","1787","419","133","286","8","427","956","0","44.67","13.91"
"64","000","00","090","0001","1788","205","72","133","8","213","419","0","50.84","17.18"
"64","000","00","090","0001","1789","491","165","326","6","497","1290","0","38.53","12.79"
"64","000","00","090","0001","1790","513","180","333","7","520","1318","0","39.45","13.66"
"64","000","00","090","0001","1791","457","140","317","6","463","1342","0","34.50","10.43"
"64","000","00","090","0001","1792","440","139","301","3","443","1252","0","35.38","11.10"
"64","000","00","090","0001","1793","500","159","341","2","502","1316","0","38.15","12.08"
"64","000","00","090","0001","1794","547","153","394","2","549","1392","0","39.44","10.99"
"64","000","00","090","0002","0000","980","309","671","8","988","2288","0","43.18","13.51"
"64","000","00","090","0002","1795","373","122","251","5","378","821","0","46.04","14.86"
"64","000","00","090","0002","1796","351","106","245","1","352","831","0","42.36","12.76"
"64","000","00","090","0002","1797","256","81","175","2","258","636","0","40.57","12.74"
"64","000","00","090","0003","0000","2216","728","1488","22","2238","4994","0","44.81","14.58"
"64","000","00","090","0003","1798","502","159","343","5","507","1106","0","45.84","14.38"
"64","000","00","090","0003","1799","443","161","282","4","447","1037","0","43.11","15.53"
"64","000","00","090","0003","1800","479","134","345","6","485","1066","0","45.50","12.57"
"64","000","00","090","0003","1801","340","117","223","2","342","718","0","47.63","16.30"
"64","000","00","090","0003","1802","452","157","295","5","457","1067","0","42.83","14.71"
"64","000","00","090","0004","0000","982","344","638","7","989","2203","0","44.89","15.62"
"64","000","00","090","0004","1803","477","205","272","4","481","1030","0","46.70","19.90"
"64","000","00","090","0004","1804","505","139","366","3","508","1173","0","43.31","11.85"
"64","000","00","090","0005","0000","569","159","410","4","573","1263","0","45.37","12.59"
"64","000","00","090","0005","1805","569","159","410","4","573","1263","0","45.37","12.59"
"64","000","00","090","0006","0000","731","280","451","8","739","1891","0","39.08","14.81"
"64","000","00","090","0006","1806","386","125","261","3","389","914","0","42.56","13.68"
"64","000","00","090","0006","1807","345","155","190","5","350","977","0","35.82","15.86"
"64","000","00","090","0007","0000","853","273","580","10","863","2883","0","29.93","9.47"
"64","000","00","090","0007","1808","475","136","339","10","485","1163","0","41.70","11.69"
"64","000","00","090","0007","1809","378","137","241","0","378","1720","0","21.98","7.97"
"64","000","00","090","0008","0000","243","59","184","4","247","606","0","40.76","9.74"
"64","000","00","090","0008","1810","243","59","184","4","247","606","0","40.76","9.74"
"64","000","00","090","0009","0000","622","160","462","10","632","1420","0","44.51","11.27"
"64","000","00","090","0009","1811","622","160","462","10","632","1420","0","44.51","11.27"
"64","000","00","090","0010","0000","632","178","454","8","640","1365","0","46.89","13.04"
"64","000","00","090","0010","1812","632","178","454","8","640","1365","0","46.89","13.04"
"64","000","00","090","0011","0000","915","309","606","8","923","2203","0","41.90","14.03"
"64","000","00","090","0011","1813","394","130","264","4","398","929","0","42.84","13.99"
"64","000","00","090","0011","1814","521","179","342","4","525","1274","0","41.21","14.05"
"64","000","00","090","0012","0000","444","114","330","5","449","1033","0","43.47","11.04"
"64","000","00","090","0012","1815","444","114","330","5","449","1033","0","43.47","11.04"
"64","000","00","090","0013","0000","313","100","213","4","317","656","0","48.32","15.24"
"64","000","00","090","0013","1816","313","100","213","4","317","656","0","48.32","15.24"
"64","000","00","090","0014","0000","311","74","237","0","311","673","0","46.21","11.00"
"64","000","00","090","0014","1817","311","74","237","0","311","673","0","46.21","11.00"
"64","000","00","090","0015","0000","596","175","421","8","604","1293","0","46.71","13.53"
"64","000","00","090","0015","1818","596","175","421","8","604","1293","0","46.71","13.53"
"64","000","00","090","0016","0000","829","238","591","7","836","1636","0","51.10","14.55"
"64","000","00","090","0016","1819","434","140","294","4","438","827","0","52.96","16.93"
"64","000","00","090","0016","1820","395","98","297","3","398","809","0","49.20","12.11"
"64","000","00","090","0017","0000","911","265","646","10","921","2041","0","45.12","12.98"
"64","000","00","090","0017","1821","466","132","334","8","474","1000","0","47.40","13.20"
"64","000","00","090","0017","1822","445","133","312","2","447","1041","0","42.94","12.78"
"64","000","00","090","0018","0000","856","269","587","8","864","1918","0","45.05","14.03"
"64","000","00","090","0018","1823","446","134","312","4","450","1022","0","44.03","13.11"
"64","000","00","090","0018","1824","410","135","275","4","414","896","0","46.21","15.07"
"64","000","00","090","0019","0000","1753","646","1107","11","1764","3979","0","44.33","16.24"
"64","000","00","090","0019","1825","546","179","367","3","549","1316","0","41.72","13.60"
"64","000","00","090","0019","1826","662","244","418","4","666","1396","0","47.71","17.48"
"64","000","00","090","0019","1827","545","223","322","4","549","1267","0","43.33","17.60"
"64","000","00","090","0020","0000","399","154","245","4","403","902","0","44.68","17.07"
"64","000","00","090","0020","1828","399","154","245","4","403","902","0","44.68","17.07"
"64","000","00","090","0021","0000","1249","572","677","9","1258","2779","0","45.27","20.58"
"64","000","00","090","0021","1829","648","312","336","3","651","1413","0","46.07","22.08"
"64","000","00","090","0021","1830","601","260","341","6","607","1366","0","44.44","19.03"
"64","000","00","090","0022","0000","367","127","240","0","367","802","0","45.76","15.84"
"64","000","00","090","0022","1831","367","127","240","0","367","802","0","45.76","15.84"
"64","000","00","090","0023","0000","498","183","315","7","505","1077","0","46.89","16.99"
"64","000","00","090","0023","1832","498","183","315","7","505","1077","0","46.89","16.99"
"64","000","00","090","0024","0000","2522","1732","790","28","2550","5166","0","49.36","33.53"
"64","000","00","090","0024","1833","613","523","90","16","629","1218","0","51.64","42.94"
"64","000","00","090","0024","1834","700","554","146","6","706","1393","0","50.68","39.77"
"64","000","00","090","0024","1835","545","392","153","3","548","1113","0","49.24","35.22"
"64","000","00","090","0024","1836","664","263","401","3","667","1442","0","46.26","18.24"
"64","000","00","090","0025","0000","983","814","169","15","998","1970","0","50.66","41.32"
"64","000","00","090","0025","1837","564","464","100","11","575","1023","0","56.21","45.36"
"64","000","00","090","0025","1838","419","350","69","4","423","947","0","44.67","36.96"
"64","000","00","090","0028","0000","1470","666","804","6","1476","3261","0","45.26","20.42"
"64","000","00","090","0028","1839","434","169","265","3","437","1006","0","43.44","16.80"
"64","000","00","090","0028","1840","514","230","284","0","514","1105","0","46.52","20.81"
"64","000","00","090","0028","1841","522","267","255","3","525","1150","0","45.65","23.22"
"64","000","00","090","0029","0000","1925","981","944","14","1939","3898","0","49.74","25.17"
"64","000","00","090","0029","1842","661","317","344","7","668","1253","0","53.31","25.30"
"64","000","00","090","0029","1843","689","354","335","5","694","1358","0","51.10","26.07"
"64","000","00","090","0029","1844","575","310","265","2","577","1287","0","44.83","24.09"
"64","000","00","090","0030","0000","584","265","319","8","592","1249","0","47.40","21.22"
"64","000","00","090","0030","1845","584","265","319","8","592","1249","0","47.40","21.22"
"64","000","00","090","0031","0000","1005","470","535","5","1010","2251","0","44.87","20.88"
"64","000","00","090","0031","1846","472","208","264","3","475","1077","0","44.10","19.31"
"64","000","00","090","0031","1847","533","262","271","2","535","1174","0","45.57","22.32"
"64","000","00","090","0032","0000","1358","716","642","4","1362","2750","0","49.53","26.04"
"64","000","00","090","0032","1848","719","358","361","2","721","1426","0","50.56","25.11"
"64","000","00","090","0032","1849","639","358","281","2","641","1324","0","48.41","27.04"
"64","000","00","090","0033","0000","902","334","568","10","912","2053","0","44.42","16.27"
"64","000","00","090","0033","1850","486","177","309","7","493","1007","0","48.96","17.58"
"64","000","00","090","0033","1851","416","157","259","3","419","1046","0","40.06","15.01"
"64","000","00","090","0034","0000","1112","541","571","2","1114","2633","0","42.31","20.55"
"64","000","00","090","0034","1852","589","299","290","2","591","1345","0","43.94","22.23"
"64","000","00","090","0034","1853","523","242","281","0","523","1288","0","40.61","18.79"
"64","000","00","090","0035","0000","1303","530","773","7","1310","2968","0","44.14","17.86"
"64","000","00","090","0035","1854","671","266","405","5","676","1474","0","45.86","18.05"
"64","000","00","090","0035","1855","632","264","368","2","634","1494","0","42.44","17.67"
"64","000","00","090","0036","0000","1304","548","756","6","1310","2985","0","43.89","18.36"
"64","000","00","090","0036","1856","472","208","264","3","475","1047","0","45.37","19.87"
"64","000","00","090","0036","1857","487","200","287","0","487","963","0","50.57","20.77"
"64","000","00","090","0036","1858","345","140","205","3","348","975","0","35.69","14.36"
"64","000","00","090","0037","0000","2493","1096","1397","12","2505","5492","0","45.61","19.96"
"64","000","00","090","0037","1859","598","212","386","4","602","1329","0","45.30","15.95"
"64","000","00","090","0037","1860","584","286","298","6","590","1249","0","47.24","22.90"
"64","000","00","090","0037","1861","628","248","380","0","628","1506","0","41.70","16.47"
"64","000","00","090","0037","1862","683","350","333","2","685","1408","0","48.65","24.86"
"64","000","00","090","0038","0000","1376","662","714","9","1385","2994","0","46.26","22.11"
"64","000","00","090","0038","1863","728","366","362","2","730","1606","0","45.45","22.79"
"64","000","00","090","0038","1864","648","296","352","7","655","1388","0","47.19","21.33"
"64","000","00","090","0039","0000","1177","446","731","9","1186","2585","0","45.88","17.25"
"64","000","00","090","0039","1865","541","178","363","4","545","1299","0","41.96","13.70"
"64","000","00","090","0039","1866","636","268","368","5","641","1286","0","49.84","20.84"
"64","000","00","090","0040","0000","1238","413","825","15","1253","2634","0","47.57","15.68"
"64","000","00","090","0040","1867","597","199","398","8","605","1323","0","45.73","15.04"
"64","000","00","090","0040","1868","641","214","427","7","648","1311","0","49.43","16.32"
"64","000","00","090","0041","0000","924","363","561","3","927","2104","0","44.06","17.25"
"64","000","00","090","0041","1869","434","165","269","1","435","1002","0","43.41","16.47"
"64","000","00","090","0041","1870","490","198","292","2","492","1102","0","44.65","17.97"
"64","000","00","090","0042","0000","2893","1245","1648","15","2908","6665","0","43.63","18.68"
"64","000","00","090","0042","1871","642","222","420","2","644","1470","0","43.81","15.10"
"64","000","00","090","0042","1872","667","267","400","6","673","1512","0","44.51","17.66"
"64","000","00","090","0042","1873","495","220","275","3","498","1038","0","47.98","21.19"
"64","000","00","090","0042","1874","575","266","309","2","577","1401","0","41.18","18.99"
"64","000","00","090","0042","1875","514","270","244","2","516","1244","0","41.48","21.70"
"64","000","00","090","0043","0000","997","415","582","11","1008","2331","0","43.24","17.80"
"64","000","00","090","0043","1876","506","216","290","3","509","1111","0","45.81","19.44"
"64","000","00","090","0043","1877","491","199","292","8","499","1220","0","40.90","16.31"
"64","000","00","090","0044","0000","1830","796","1034","11","1841","3965","0","46.43","20.08"
"64","000","00","090","0044","1878","640","244","396","5","645","1382","0","46.67","17.66"
"64","000","00","090","0044","1879","614","255","359","2","616","1278","0","48.20","19.95"
"64","000","00","090","0044","1880","576","297","279","4","580","1305","0","44.44","22.76"
"64","000","00","090","0045","0000","1533","636","897","9","1542","3340","0","46.17","19.04"
"64","000","00","090","0045","1881","490","228","262","2","492","1172","0","41.98","19.45"
"64","000","00","090","0045","1882","468","197","271","4","472","977","0","48.31","20.16"
"64","000","00","090","0045","1883","575","211","364","3","578","1191","0","48.53","17.72"
"64","000","00","090","0046","0000","644","229","415","6","650","1563","0","41.59","14.65"
"64","000","00","090","0046","1884","362","102","260","4","366","822","0","44.53","12.41"
"64","000","00","090","0046","1885","282","127","155","2","284","741","0","38.33","17.14"
"64","000","00","090","0047","0000","1917","656","1261","12","1929","4567","0","42.24","14.36"
"64","000","00","090","0047","1886","406","130","276","1","407","1080","0","37.69","12.04"
"64","000","00","090","0047","1887","506","147","359","4","510","1224","0","41.67","12.01"
"64","000","00","090","0047","1888","423","149","274","4","427","963","0","44.34","15.47"
"64","000","00","090","0047","1889","582","230","352","3","585","1300","0","45.00","17.69"
"64","000","00","090","0048","0000","1084","391","693","10","1094","2650","0","41.28","14.75"
"64","000","00","090","0048","1890","547","191","356","5","552","1341","0","41.16","14.24"
"64","000","00","090","0048","1891","537","200","337","5","542","1309","0","41.41","15.28"
"64","000","00","090","0049","0000","1889","741","1148","14","1903","4492","0","42.36","16.50"
"64","000","00","090","0049","1892","440","155","285","4","444","1083","0","41.00","14.31"
"64","000","00","090","0049","1893","525","207","318","2","527","1254","0","42.03","16.51"
"64","000","00","090","0049","1894","439","169","270","6","445","1033","0","43.08","16.36"
"64","000","00","090","0049","1895","485","210","275","2","487","1122","0","43.40","18.72"
"64","000","00","090","0050","0000","936","297","639","9","945","2252","0","41.96","13.19"
"64","000","00","090","0050","1896","492","171","321","8","500","1202","0","41.60","14.23"
"64","000","00","090","0050","1897","444","126","318","1","445","1050","0","42.38","12.00"
"64","000","00","090","0051","0000","788","249","539","6","794","1810","0","43.87","13.76"
"64","000","00","090","0051","1898","404","139","265","4","408","933","0","43.73","14.90"
"64","000","00","090","0051","1899","384","110","274","2","386","877","0","44.01","12.54"
"64","000","00","090","0052","0000","1596","588","1008","14","1610","3473","0","46.36","16.93"
"64","000","00","090","0052","1900","554","192","362","4","558","1118","0","49.91","17.17"
"64","000","00","090","0052","1901","513","159","354","4","517","1067","0","48.45","14.90"
"64","000","00","090","0052","1902","529","237","292","6","535","1288","0","41.54","18.40"
"64","000","00","090","0053","0000","1493","540","953","11","1504","3408","0","44.13","15.85"
"64","000","00","090","0053","1903","498","163","335","6","504","1127","0","44.72","14.46"
"64","000","00","090","0053","1904","415","156","259","3","418","958","0","43.63","16.28"
"64","000","00","090","0053","1905","580","221","359","2","582","1323","0","43.99","16.70"
"64","000","00","090","0054","0000","1350","445","905","15","1365","3140","0","43.47","14.17"
"64","000","00","090","0054","1906","661","192","469","7","668","1547","0","43.18","12.41"
"64","000","00","090","0054","1907","689","253","436","8","697","1593","0","43.75","15.88"
"64","000","00","090","0055","0000","1059","299","760","14","1073","2484","0","43.20","12.04"
"64","000","00","090","0055","1908","517","163","354","6","523","1248","0","41.91","13.06"
"64","000","00","090","0055","1909","542","136","406","8","550","1236","0","44.50","11.00"
"64","000","00","090","0056","0000","1139","395","744","7","1146","2474","0","46.32","15.97"
"64","000","00","090","0056","1910","539","197","342","6","545","1138","0","47.89","17.31"
"64","000","00","090","0056","1911","600","198","402","1","601","1336","0","44.99","14.82"
"64","000","00","090","0057","0000","1077","336","741","10","1087","2446","0","44.44","13.74"
"64","000","00","090","0057","1912","536","170","366","6","542","1193","0","45.43","14.25"
"64","000","00","090","0057","1913","541","166","375","4","545","1253","0","43.50","13.25"
"64","000","00","090","0058","0000","1066","422","644","11","1077","2518","0","42.77","16.76"
"64","000","00","090","0058","1914","583","233","350","9","592","1338","0","44.25","17.41"
"64","000","00","090","0058","1915","483","189","294","2","485","1180","0","41.10","16.02"
"64","000","00","090","0059","0000","988","311","677","6","994","2355","0","42.21","13.21"
"64","000","00","090","0059","1916","464","159","305","5","469","1144","0","41.00","13.90"
"64","000","00","090","0059","1917","524","152","372","1","525","1211","0","43.35","12.55"
"64","000","00","090","0060","0000","1954","764","1190","15","1969","4394","0","44.81","17.39"
"64","000","00","090","0060","1918","601","258","343","5","606","1372","0","44.17","18.80"
"64","000","00","090","0060","1919","646","192","454","5","651","1456","0","44.71","13.19"
"64","000","00","090","0060","1920","707","314","393","5","712","1566","0","45.47","20.05"
"64","000","00","090","0061","0000","1314","429","885","10","1324","3072","0","43.10","13.96"
"64","000","00","090","0061","1921","393","128","265","4","397","970","0","40.93","13.20"
"64","000","00","090","0061","1922","406","108","298","4","410","911","0","45.01","11.86"
"64","000","00","090","0061","1923","515","193","322","2","517","1191","0","43.41","16.20"
"64","000","00","100","0000","0000","9193","2736","6457","92","9285","24346","27515","38.14","11.24"
"64","000","00","100","0001","0000","510","138","372","5","515","1181","0","43.61","11.69"
"64","000","00","100","0001","1767","510","138","372","5","515","1181","0","43.61","11.69"
"64","000","00","100","0002","0000","384","141","243","4","388","1056","0","36.74","13.35"
"64","000","00","100","0002","1768","384","141","243","4","388","1056","0","36.74","13.35"
"64","000","00","100","0003","0000","619","180","439","9","628","1544","0","40.67","11.66"
"64","000","00","100","0003","1769","619","180","439","9","628","1544","0","40.67","11.66"
"64","000","00","100","0004","0000","790","229","561","5","795","2240","0","35.49","10.22"
"64","000","00","100","0004","1770","416","136","280","4","420","1157","0","36.30","11.75"
"64","000","00","100","0004","1771","374","93","281","1","375","1083","0","34.63","8.59"
"64","000","00","100","0005","0000","985","411","574","16","1001","2922","0","34.26","14.07"
"64","000","00","100","0005","1772","483","182","301","6","489","1437","0","34.03","12.67"
"64","000","00","100","0005","1773","502","229","273","10","512","1485","0","34.48","15.42"
"64","000","00","100","0006","0000","639","172","467","2","641","1497","0","42.82","11.49"
"64","000","00","100","0006","1774","639","172","467","2","641","1497","0","42.82","11.49"
"64","000","00","100","0007","0000","505","308","197","9","514","1394","0","36.87","22.09"
"64","000","00","100","0007","1775","505","308","197","9","514","1394","0","36.87","22.09"
"64","000","00","100","0008","0000","866","280","586","12","878","2620","0","33.51","10.69"
"64","000","00","100","0008","1776","422","151","271","5","427","1346","0","31.72","11.22"
"64","000","00","100","0008","1777","444","129","315","7","451","1274","0","35.40","10.13"
"64","000","00","100","0009","0000","777","129","648","11","788","2021","0","38.99","6.38"
"64","000","00","100","0009","1778","356","108","248","4","360","952","0","37.82","11.34"
"64","000","00","100","0009","1779","421","21","400","7","428","1069","0","40.04","1.96"
"64","000","00","100","0010","0000","1033","231","802","9","1042","2749","0","37.90","8.40"
"64","000","00","100","0010","1780","431","91","340","3","434","1092","0","39.74","8.33"
"64","000","00","100","0010","1781","602","140","462","6","608","1657","0","36.69","8.45"
"64","000","00","100","0011","0000","740","198","542","4","744","1802","0","41.29","10.99"
"64","000","00","100","0011","1782","443","114","329","2","445","1033","0","43.08","11.04"
"64","000","00","100","0011","1783","297","84","213","2","299","769","0","38.88","10.92"
"64","000","00","100","0012","0000","331","63","268","1","332","863","0","38.47","7.30"
"64","000","00","100","0012","1784","331","63","268","1","332","863","0","38.47","7.30"
"64","000","00","100","0013","0000","1014","256","758","5","1019","2457","0","41.47","10.42"
"64","000","00","100","0013","1785","533","115","418","1","534","1184","0","45.10","9.71"
"64","000","00","100","0013","1786","481","141","340","4","485","1273","0","38.10","11.08"
"64","000","00","110","0000","0000","52846","19612","33234","427","53273","132828","156580","40.11","14.76"
"64","000","00","110","0001","0000","979","366","613","8","987","2204","0","44.78","16.61"
"64","000","00","110","0001","1924","521","235","286","4","525","1075","0","48.84","21.86"
"64","000","00","110","0001","1925","458","131","327","4","462","1129","0","40.92","11.60"
"64","000","00","110","0002","0000","1374","638","736","8","1382","3080","0","44.87","20.71"
"64","000","00","110","0002","1926","721","327","394","1","722","1483","0","48.69","22.05"
"64","000","00","110","0002","1927","653","311","342","7","660","1597","0","41.33","19.47"
"64","000","00","110","0003","0000","1001","480","521","5","1006","2455","0","40.98","19.55"
"64","000","00","110","0003","1928","459","241","218","0","459","1061","0","43.26","22.71"
"64","000","00","110","0003","1929","542","239","303","5","547","1394","0","39.24","17.14"
"64","000","00","110","0004","0000","658","248","410","3","661","1658","0","39.87","14.96"
"64","000","00","110","0004","1930","658","248","410","3","661","1658","0","39.87","14.96"
"64","000","00","110","0005","0000","1120","400","720","10","1130","3006","0","37.59","13.31"
"64","000","00","110","0005","1931","591","186","405","5","596","1561","0","38.18","11.92"
"64","000","00","110","0005","1932","529","214","315","5","534","1445","0","36.96","14.81"
"64","000","00","110","0006","0000","1090","394","696","5","1095","2482","0","44.12","15.87"
"64","000","00","110","0006","1933","514","173","341","2","516","1158","0","44.56","14.94"
"64","000","00","110","0006","1934","576","221","355","3","579","1324","0","43.73","16.69"
"64","000","00","110","0007","0000","901","324","577","3","904","2715","0","33.30","11.93"
"64","000","00","110","0007","1935","384","131","253","2","386","1434","0","26.92","9.14"
"64","000","00","110","0007","1936","517","193","324","1","518","1281","0","40.44","15.07"
"64","000","00","110","0008","0000","1012","378","634","8","1020","2209","0","46.17","17.11"
"64","000","00","110","0008","1937","541","200","341","5","546","1146","0","47.64","17.45"
"64","000","00","110","0008","1938","471","178","293","3","474","1063","0","44.59","16.75"
"64","000","00","110","0009","0000","990","338","652","9","999","2601","0","38.41","13.00"
"64","000","00","110","0009","1939","534","194","340","4","538","1405","0","38.29","13.81"
"64","000","00","110","0009","1940","456","144","312","5","461","1196","0","38.55","12.04"
"64","000","00","110","0010","0000","2247","805","1442","19","2266","5620","0","40.32","14.32"
"64","000","00","110","0010","1941","646","207","439","8","654","1560","0","41.92","13.27"
"64","000","00","110","0010","1942","487","171","316","3","490","1215","0","40.33","14.07"
"64","000","00","110","0010","1943","506","201","305","4","510","1422","0","35.86","14.14"
"64","000","00","110","0010","1944","608","226","382","4","612","1423","0","43.01","15.88"
"64","000","00","110","0011","0000","1051","402","649","10","1061","2419","0","43.86","16.62"
"64","000","00","110","0011","1945","508","191","317","2","510","1183","0","43.11","16.15"
"64","000","00","110","0011","1946","543","211","332","8","551","1236","0","44.58","17.07"
"64","000","00","110","0012","0000","1411","455","956","12","1423","3563","0","39.94","12.77"
"64","000","00","110","0012","1947","507","177","330","4","511","1301","0","39.28","13.60"
"64","000","00","110","0012","1948","450","149","301","4","454","1118","0","40.61","13.33"
"64","000","00","110","0012","1949","454","129","325","4","458","1144","0","40.03","11.28"
"64","000","00","110","0013","0000","1188","438","750","7","1195","2779","0","43.00","15.76"
"64","000","00","110","0013","1950","554","203","351","3","557","1394","0","39.96","14.56"
"64","000","00","110","0013","1951","634","235","399","4","638","1385","0","46.06","16.97"
"64","000","00","110","0014","0000","1471","633","838","12","1483","3906","0","37.97","16.21"
"64","000","00","110","0014","1952","503","219","284","5","508","1387","0","36.63","15.79"
"64","000","00","110","0014","1953","473","211","262","5","478","1227","0","38.96","17.20"
"64","000","00","110","0014","1954","495","203","292","2","497","1292","0","38.47","15.71"
"64","000","00","110","0015","0000","1716","684","1032","15","1731","4344","0","39.85","15.75"
"64","000","00","110","0015","1955","591","207","384","7","598","1495","0","40.00","13.85"
"64","000","00","110","0015","1956","561","227","334","4","565","1437","0","39.32","15.80"
"64","000","00","110","0015","1957","564","250","314","4","568","1412","0","40.23","17.71"
"64","000","00","110","0016","0000","1085","409","676","7","1092","2502","0","43.65","16.35"
"64","000","00","110","0016","1958","505","161","344","4","509","1227","0","41.48","13.12"
"64","000","00","110","0016","1959","580","248","332","3","583","1275","0","45.73","19.45"
"64","000","00","110","0017","0000","1212","456","756","6","1218","3165","0","38.48","14.41"
"64","000","00","110","0017","1960","608","248","360","3","611","1609","0","37.97","15.41"
"64","000","00","110","0017","1961","604","208","396","3","607","1556","0","39.01","13.37"
"64","000","00","110","0018","0000","1142","540","602","6","1148","2869","0","40.01","18.82"
"64","000","00","110","0018","1962","573","260","313","4","577","1423","0","40.55","18.27"
"64","000","00","110","0018","1963","569","280","289","2","571","1446","0","39.49","19.36"
"64","000","00","110","0019","0000","1003","598","405","12","1015","2305","0","44.03","25.94"
"64","000","00","110","0019","1964","498","327","171","7","505","1078","0","46.85","30.33"
"64","000","00","110","0019","1965","505","271","234","5","510","1227","0","41.56","22.09"
"64","000","00","110","0020","0000","1661","785","876","15","1676","4066","0","41.22","19.31"
"64","000","00","110","0020","1966","631","298","333","6","637","1441","0","44.21","20.68"
"64","000","00","110","0020","1967","575","285","290","4","579","1435","0","40.35","19.86"
"64","000","00","110","0020","1968","455","202","253","5","460","1190","0","38.66","16.97"
"64","000","00","110","0021","0000","1332","490","842","12","1344","3176","0","42.32","15.43"
"64","000","00","110","0021","1969","665","255","410","6","671","1549","0","43.32","16.46"
"64","000","00","110","0021","1970","667","235","432","6","673","1627","0","41.36","14.44"
"64","000","00","110","0022","0000","4224","1472","2752","35","4259","11217","0","37.97","13.12"
"64","000","00","110","0022","1971","439","135","304","3","442","1297","0","34.08","10.41"
"64","000","00","110","0022","1972","584","205","379","1","585","1352","0","43.27","15.16"
"64","000","00","110","0022","1973","515","179","336","6","521","1327","0","39.26","13.49"
"64","000","00","110","0022","1974","627","212","415","5","632","1605","0","39.38","13.21"
"64","000","00","110","0022","1975","509","166","343","7","516","1266","0","40.76","13.11"
"64","000","00","110","0022","1976","472","198","274","2","474","1322","0","35.85","14.98"
"64","000","00","110","0022","1977","561","173","388","6","567","1404","0","40.38","12.32"
"64","000","00","110","0022","1978","517","204","313","5","522","1644","0","31.75","12.41"
"64","000","00","110","0023","0000","1596","571","1025","10","1606","4154","0","38.66","13.75"
"64","000","00","110","0023","1979","466","171","295","4","470","1296","0","36.27","13.19"
"64","000","00","110","0023","1980","583","205","378","4","587","1467","0","40.01","13.97"
"64","000","00","110","0023","1981","547","195","352","2","549","1391","0","39.47","14.02"
"64","000","00","110","0024","0000","1006","362","644","6","1012","2549","0","39.70","14.20"
"64","000","00","110","0024","1982","478","180","298","3","481","1207","0","39.85","14.91"
"64","000","00","110","0024","1983","528","182","346","3","531","1342","0","39.57","13.56"
"64","000","00","110","0025","0000","1324","520","804","18","1342","3066","0","43.77","16.96"
"64","000","00","110","0025","1984","729","282","447","7","736","1598","0","46.06","17.65"
"64","000","00","110","0025","1985","595","238","357","11","606","1468","0","41.28","16.21"
"64","000","00","110","0026","0000","1116","371","745","12","1128","2844","0","39.66","13.05"
"64","000","00","110","0026","1986","531","163","368","7","538","1262","0","42.63","12.92"
"64","000","00","110","0026","1987","585","208","377","5","590","1582","0","37.29","13.15"
"64","000","00","110","0027","0000","2183","764","1419","15","2198","6006","0","36.60","12.72"
"64","000","00","110","0027","1988","486","163","323","5","491","1214","0","40.44","13.43"
"64","000","00","110","0027","1989","402","146","256","1","403","1201","0","33.56","12.16"
"64","000","00","110","0027","1990","494","163","331","2","496","1181","0","42.00","13.80"
"64","000","00","110","0027","1991","322","111","211","3","325","1036","0","31.37","10.71"
"64","000","00","110","0027","1992","479","181","298","4","483","1374","0","35.15","13.17"
"64","000","00","110","0028","0000","1930","724","1206","17","1947","4655","0","41.83","15.55"
"64","000","00","110","0028","1993","605","190","415","7","612","1210","0","50.58","15.70"
"64","000","00","110","0028","1994","472","171","301","4","476","1209","0","39.37","14.14"
"64","000","00","110","0028","1995","486","229","257","5","491","1244","0","39.47","18.41"
"64","000","00","110","0028","1996","367","134","233","1","368","992","0","37.10","13.51"
"64","000","00","110","0029","0000","1475","583","892","21","1496","3839","0","38.97","15.19"
"64","000","00","110","0029","1997","549","238","311","9","558","1396","0","39.97","17.05"
"64","000","00","110","0029","1998","483","148","335","10","493","1096","0","44.98","13.50"
"64","000","00","110","0029","1999","443","197","246","2","445","1347","0","33.04","14.63"
"64","000","00","110","0030","0000","1146","383","763","5","1151","2569","0","44.80","14.91"
"64","000","00","110","0030","2000","541","181","360","2","543","1179","0","46.06","15.35"
"64","000","00","110","0030","2001","605","202","403","3","608","1390","0","43.74","14.53"
"64","000","00","110","0031","0000","3069","1089","1980","25","3094","7687","0","40.25","14.17"
"64","000","00","110","0031","2002","599","162","437","5","604","1467","0","41.17","11.04"
"64","000","00","110","0031","2003","646","228","418","6","652","1572","0","41.48","14.50"
"64","000","00","110","0031","2004","625","234","391","5","630","1545","0","40.78","15.15"
"64","000","00","110","0031","2005","584","223","361","4","588","1512","0","38.89","14.75"
"64","000","00","110","0031","2006","615","242","373","5","620","1591","0","38.97","15.21"
"64","000","00","110","0032","0000","1362","507","855","9","1371","3630","0","37.77","13.97"
"64","000","00","110","0032","2007","424","153","271","3","427","1076","0","39.68","14.22"
"64","000","00","110","0032","2008","505","176","329","3","508","1356","0","37.46","12.98"
"64","000","00","110","0032","2009","433","178","255","3","436","1198","0","36.39","14.86"
"64","000","00","110","0033","0000","1212","427","785","17","1229","3132","0","39.24","13.63"
"64","000","00","110","0033","2010","561","197","364","10","571","1415","0","40.35","13.92"
"64","000","00","110","0033","2011","651","230","421","7","658","1717","0","38.32","13.40"
"64","000","00","110","0034","0000","1190","396","794","7","1197","3059","0","39.13","12.95"
"64","000","00","110","0034","2012","591","174","417","5","596","1505","0","39.60","11.56"
"64","000","00","110","0034","2013","599","222","377","2","601","1554","0","38.67","14.29"
"64","000","00","110","0035","0000","896","249","647","8","904","2196","0","41.17","11.34"
"64","000","00","110","0035","2014","436","108","328","5","441","1069","0","41.25","10.10"
"64","000","00","110","0035","2015","460","141","319","3","463","1127","0","41.08","12.51"
"64","000","00","110","0036","0000","1208","342","866","6","1214","3013","0","40.29","11.35"
"64","000","00","110","0036","2016","612","171","441","3","615","1475","0","41.69","11.59"
"64","000","00","110","0036","2017","596","171","425","3","599","1538","0","38.95","11.12"
"64","000","00","110","0037","0000","925","264","661","10","935","2483","0","37.66","10.63"
"64","000","00","110","0037","2018","492","140","352","3","495","1249","0","39.63","11.21"
"64","000","00","110","0037","2019","433","124","309","7","440","1234","0","35.66","10.05"
"64","000","00","110","0038","0000","1340","327","1013","14","1354","3605","0","37.56","9.07"
"64","000","00","110","0038","2020","441","115","326","4","445","1067","0","41.71","10.78"
"64","000","00","110","0038","2021","470","112","358","5","475","1292","0","36.76","8.67"
"64","000","00","110","0038","2022","429","100","329","5","434","1246","0","34.83","8.03"
"64","000","00","120","0000","0000","127552","55079","72473","994","128546","302069","358785","42.56","18.23"
"64","000","00","120","0001","0000","174","68","106","2","176","406","0","43.35","16.75"
"64","000","00","120","0001","1587","174","68","106","2","176","406","0","43.35","16.75"
"64","000","00","120","0002","0000","275","99","176","6","281","599","0","46.91","16.53"
"64","000","00","120","0002","1586","275","99","176","6","281","599","0","46.91","16.53"
"64","000","00","120","0003","0000","570","233","337","8","578","1288","0","44.88","18.09"
"64","000","00","120","0003","1588","570","233","337","8","578","1288","0","44.88","18.09"
"64","000","00","120","0004","0000","428","213","215","2","430","847","0","50.77","25.15"
"64","000","00","120","0004","1601","428","213","215","2","430","847","0","50.77","25.15"
"64","000","00","120","0005","0000","414","161","253","1","415","864","0","48.03","18.63"
"64","000","00","120","0005","1594","414","161","253","1","415","864","0","48.03","18.63"
"64","000","00","120","0006","0000","964","450","514","6","970","2199","0","44.11","20.46"
"64","000","00","120","0006","1589","349","164","185","4","353","712","0","49.58","23.03"
"64","000","00","120","0006","1590","615","286","329","2","617","1487","0","41.49","19.23"
"64","000","00","120","0007","0000","491","236","255","3","494","1023","0","48.29","23.07"
"64","000","00","120","0007","1535","491","236","255","3","494","1023","0","48.29","23.07"
"64","000","00","120","0008","0000","1591","804","787","9","1600","3304","0","48.43","24.33"
"64","000","00","120","0008","1614","540","234","306","4","544","1132","0","48.06","20.67"
"64","000","00","120","0008","1615","505","295","210","4","509","1118","0","45.53","26.39"
"64","000","00","120","0008","1616","546","275","271","1","547","1054","0","51.90","26.09"
"64","000","00","120","0009","0000","3716","1486","2230","29","3745","10134","0","36.95","14.66"
"64","000","00","120","0009","1546","613","218","395","7","620","1472","0","42.12","14.81"
"64","000","00","120","0009","1547","446","174","272","2","448","1439","0","31.13","12.09"
"64","000","00","120","0009","1548","635","280","355","3","638","1718","0","37.14","16.30"
"64","000","00","120","0009","1549","412","172","240","5","417","1249","0","33.39","13.77"
"64","000","00","120","0009","1550","520","207","313","2","522","1462","0","35.70","14.16"
"64","000","00","120","0009","1551","441","203","238","6","447","1360","0","32.87","14.93"
"64","000","00","120","0009","1552","649","232","417","4","653","1434","0","45.54","16.18"
"64","000","00","120","0010","0000","360","177","183","1","361","800","0","45.13","22.13"
"64","000","00","120","0010","1536","360","177","183","1","361","800","0","45.13","22.13"
"64","000","00","120","0011","0000","1508","610","898","15","1523","3583","0","42.51","17.02"
"64","000","00","120","0011","1557","551","183","368","9","560","1263","0","44.34","14.49"
"64","000","00","120","0011","1558","468","193","275","3","471","1071","0","43.98","18.02"
"64","000","00","120","0011","1559","489","234","255","3","492","1249","0","39.39","18.73"
"64","000","00","120","0012","0000","2155","904","1251","18","2173","4831","0","44.98","18.71"
"64","000","00","120","0012","1539","536","230","306","7","543","1150","0","47.22","20.00"
"64","000","00","120","0012","1540","525","207","318","5","530","1202","0","44.09","17.22"
"64","000","00","120","0012","1541","570","236","334","3","573","1306","0","43.87","18.07"
"64","000","00","120","0012","1542","524","231","293","3","527","1173","0","44.93","19.69"
"64","000","00","120","0013","0000","957","399","558","2","959","2419","0","39.64","16.49"
"64","000","00","120","0013","1622","477","214","263","2","479","1268","0","37.78","16.88"
"64","000","00","120","0013","1623","480","185","295","0","480","1151","0","41.70","16.07"
"64","000","00","120","0014","0000","2506","1233","1273","18","2524","5862","0","43.06","21.03"
"64","000","00","120","0014","1645","634","251","383","3","637","1501","0","42.44","16.72"
"64","000","00","120","0014","1646","547","227","320","6","553","1355","0","40.81","16.75"
"64","000","00","120","0014","1647","654","374","280","1","655","1511","0","43.35","24.75"
"64","000","00","120","0014","1648","671","381","290","8","679","1495","0","45.42","25.48"
"64","000","00","120","0015","0000","1868","1518","350","24","1892","4101","0","46.14","37.02"
"64","000","00","120","0015","1649","508","341","167","7","515","1178","0","43.72","28.95"
"64","000","00","120","0015","1650","686","582","104","10","696","1617","0","43.04","35.99"
"64","000","00","120","0015","1651","674","595","79","7","681","1306","0","52.14","45.56"
"64","000","00","120","0016","0000","1965","741","1224","22","1987","4690","0","42.37","15.80"
"64","000","00","120","0016","1729","548","207","341","7","555","1243","0","44.65","16.65"
"64","000","00","120","0016","1730","419","179","240","6","425","980","0","43.37","18.27"
"64","000","00","120","0016","1731","511","192","319","4","515","1337","0","38.52","14.36"
"64","000","00","120","0016","1732","487","163","324","5","492","1130","0","43.54","14.42"
"64","000","00","120","0017","0000","2792","933","1859","20","2812","6676","0","42.12","13.98"
"64","000","00","120","0017","1690","548","178","370","4","552","1280","0","43.13","13.91"
"64","000","00","120","0017","1691","678","231","447","3","681","1584","0","42.99","14.58"
"64","000","00","120","0017","1692","680","221","459","9","689","1622","0","42.48","13.63"
"64","000","00","120","0017","1693","448","154","294","1","449","1137","0","39.49","13.54"
"64","000","00","120","0017","1694","438","149","289","3","441","1053","0","41.88","14.15"
"64","000","00","120","0018","0000","2121","990","1131","14","2135","5045","0","42.32","19.62"
"64","000","00","120","0018","1624","518","223","295","3","521","1193","0","43.67","18.69"
"64","000","00","120","0018","1625","509","226","283","2","511","1197","0","42.69","18.88"
"64","000","00","120","0018","1626","525","283","242","2","527","1285","0","41.01","22.02"
"64","000","00","120","0018","1627","569","258","311","7","576","1370","0","42.04","18.83"
"64","000","00","120","0019","0000","2046","959","1087","22","2068","4468","0","46.28","21.46"
"64","000","00","120","0019","1605","426","196","230","3","429","951","0","45.11","20.61"
"64","000","00","120","0019","1606","401","191","210","6","407","939","0","43.34","20.34"
"64","000","00","120","0019","1607","539","311","228","2","541","1243","0","43.52","25.02"
"64","000","00","120","0019","1608","680","261","419","11","691","1335","0","51.76","19.55"
"64","000","00","120","0020","0000","1683","890","793","14","1697","3708","0","45.77","24.00"
"64","000","00","120","0020","1617","537","268","269","4","541","1210","0","44.71","22.15"
"64","000","00","120","0020","1618","609","343","266","5","614","1259","0","48.77","27.24"
"64","000","00","120","0020","1619","537","279","258","5","542","1239","0","43.74","22.52"
"64","000","00","120","0021","0000","712","281","431","7","719","3408","0","21.10","8.25"
"64","000","00","120","0021","1596","506","180","326","7","513","1041","0","49.28","17.29"
"64","000","00","120","0021","1597","206","101","105","0","206","2367","0","8.70","4.27"
"64","000","00","120","0022","0000","1256","715","541","8","1264","2855","0","44.27","25.04"
"64","000","00","120","0022","1652","591","339","252","2","593","1352","0","43.86","25.07"
"64","000","00","120","0022","1653","665","376","289","6","671","1503","0","44.64","25.02"
"64","000","00","120","0024","0000","1492","578","914","12","1504","3386","0","44.42","17.07"
"64","000","00","120","0024","1555","697","253","444","6","703","1628","0","43.18","15.54"
"64","000","00","120","0024","1556","795","325","470","6","801","1758","0","45.56","18.49"
"64","000","00","120","0025","0000","1334","520","814","19","1353","2970","0","45.56","17.51"
"64","000","00","120","0025","1670","687","270","417","10","697","1474","0","47.29","18.32"
"64","000","00","120","0025","1671","647","250","397","9","656","1496","0","43.85","16.71"
"64","000","00","120","0026","0000","2005","772","1233","14","2019","4656","0","43.36","16.58"
"64","000","00","120","0026","1666","423","160","263","5","428","952","0","44.96","16.81"
"64","000","00","120","0026","1667","533","203","330","3","536","1185","0","45.23","17.13"
"64","000","00","120","0026","1668","490","193","297","2","492","1155","0","42.60","16.71"
"64","000","00","120","0026","1669","559","216","343","4","563","1364","0","41.28","15.84"
"64","000","00","120","0027","0000","2610","900","1710","21","2631","6047","0","43.51","14.88"
"64","000","00","120","0027","1711","554","223","331","6","560","1375","0","40.73","16.22"
"64","000","00","120","0027","1712","471","143","328","1","472","1070","0","44.11","13.36"
"64","000","00","120","0027","1713","544","188","356","6","550","1212","0","45.38","15.51"
"64","000","00","120","0027","1714","487","166","321","3","490","1194","0","41.04","13.90"
"64","000","00","120","0027","1715","554","180","374","5","559","1196","0","46.74","15.05"
"64","000","00","120","0028","0000","1261","408","853","8","1269","3158","0","40.18","12.92"
"64","000","00","120","0028","1721","364","102","262","2","366","905","0","40.44","11.27"
"64","000","00","120","0028","1722","475","152","323","5","480","1177","0","40.78","12.91"
"64","000","00","120","0028","1723","422","154","268","1","423","1076","0","39.31","14.31"
"64","000","00","120","0029","0000","2329","790","1539","23","2352","5638","0","41.72","14.01"
"64","000","00","120","0029","1757","439","167","272","3","442","984","0","44.92","16.97"
"64","000","00","120","0029","1758","465","146","319","4","469","1089","0","43.07","13.41"
"64","000","00","120","0029","1759","520","158","362","6","526","1250","0","42.08","12.64"
"64","000","00","120","0029","1760","497","170","327","6","503","1229","0","40.93","13.83"
"64","000","00","120","0029","1761","408","149","259","4","412","1086","0","37.94","13.72"
"64","000","00","120","0030","0000","2216","1220","996","25","2241","5295","0","42.32","23.04"
"64","000","00","120","0030","1631","493","244","249","6","499","1355","0","36.83","18.01"
"64","000","00","120","0030","1632","620","491","129","7","627","1247","0","50.28","39.37"
"64","000","00","120","0030","1633","519","241","278","3","522","1273","0","41.01","18.93"
"64","000","00","120","0030","1634","584","244","340","9","593","1420","0","41.76","17.18"
"64","000","00","120","0031","0000","2016","1031","985","16","2032","4791","0","42.41","21.52"
"64","000","00","120","0031","1628","636","314","322","4","640","1497","0","42.75","20.98"
"64","000","00","120","0031","1629","600","360","240","5","605","1565","0","38.66","23.00"
"64","000","00","120","0031","1630","780","357","423","7","787","1729","0","45.52","20.65"
"64","000","00","120","0032","0000","1506","533","973","7","1513","3443","0","43.94","15.48"
"64","000","00","120","0032","1749","501","164","337","3","504","1117","0","45.12","14.68"
"64","000","00","120","0032","1750","503","203","300","1","504","1176","0","42.86","17.26"
"64","000","00","120","0032","1751","502","166","336","3","505","1150","0","43.91","14.43"
"64","000","00","120","0033","0000","2309","954","1355","11","2320","5183","0","44.76","18.41"
"64","000","00","120","0033","1680","606","221","385","1","607","1404","0","43.23","15.74"
"64","000","00","120","0033","1681","504","190","314","3","507","1188","0","42.68","15.99"
"64","000","00","120","0033","1682","648","267","381","5","653","1422","0","45.92","18.78"
"64","000","00","120","0033","1683","551","276","275","2","553","1169","0","47.31","23.61"
"64","000","00","120","0034","0000","1588","718","870","15","1603","3682","0","43.54","19.50"
"64","000","00","120","0034","1654","493","215","278","5","498","1162","0","42.86","18.50"
"64","000","00","120","0034","1655","522","244","278","7","529","1201","0","44.05","20.32"
"64","000","00","120","0034","1656","573","259","314","3","576","1319","0","43.67","19.64"
"64","000","00","120","0035","0000","2671","1195","1476","26","2697","6156","0","43.81","19.41"
"64","000","00","120","0035","1641","627","268","359","8","635","1397","0","45.45","19.18"
"64","000","00","120","0035","1642","671","286","385","8","679","1578","0","43.03","18.12"
"64","000","00","120","0035","1643","654","294","360","7","661","1528","0","43.26","19.24"
"64","000","00","120","0035","1644","719","347","372","3","722","1653","0","43.68","20.99"
"64","000","00","120","0036","0000","1646","609","1037","8","1654","3986","0","41.50","15.28"
"64","000","00","120","0036","1687","484","178","306","2","486","1195","0","40.67","14.90"
"64","000","00","120","0036","1688","563","172","391","3","566","1318","0","42.94","13.05"
"64","000","00","120","0036","1689","599","259","340","3","602","1473","0","40.87","17.58"
"64","000","00","120","0037","0000","1481","661","820","7","1488","3202","0","46.47","20.64"
"64","000","00","120","0037","1657","484","214","270","2","486","1074","0","45.25","19.93"
"64","000","00","120","0037","1658","506","216","290","4","510","1110","0","45.95","19.46"
"64","000","00","120","0037","1659","491","231","260","1","492","1018","0","48.33","22.69"
"64","000","00","120","0038","0000","1065","363","702","8","1073","2412","0","44.49","15.05"
"64","000","00","120","0038","1660","536","169","367","4","540","1177","0","45.88","14.36"
"64","000","00","120","0038","1661","529","194","335","4","533","1235","0","43.16","15.71"
"64","000","00","120","0039","0000","3793","1840","1953","22","3815","8807","0","43.32","20.89"
"64","000","00","120","0039","1571","631","313","318","1","632","1397","0","45.24","22.41"
"64","000","00","120","0039","1572","652","367","285","3","655","1414","0","46.32","25.95"
"64","000","00","120","0039","1573","621","276","345","1","622","1444","0","43.07","19.11"
"64","000","00","120","0039","1574","647","314","333","9","656","1536","0","42.71","20.44"
"64","000","00","120","0039","1575","600","273","327","5","605","1525","0","39.67","17.90"
"64","000","00","120","0039","1576","642","297","345","3","645","1491","0","43.26","19.92"
"64","000","00","120","0040","0000","5101","2126","2975","32","5133","13720","0","37.41","15.50"
"64","000","00","120","0040","1703","623","249","374","7","630","1730","0","36.42","14.39"
"64","000","00","120","0040","1704","620","257","363","2","622","1675","0","37.13","15.34"
"64","000","00","120","0040","1705","655","276","379","6","661","1703","0","38.81","16.21"
"64","000","00","120","0040","1706","613","208","405","5","618","1703","0","36.29","12.21"
"64","000","00","120","0040","1707","620","305","315","3","623","1713","0","36.37","17.81"
"64","000","00","120","0040","1708","673","311","362","1","674","1734","0","38.87","17.94"
"64","000","00","120","0040","1709","664","295","369","3","667","1668","0","39.99","17.69"
"64","000","00","120","0040","1710","633","225","408","5","638","1794","0","35.56","12.54"
"64","000","00","120","0041","0000","873","409","464","10","883","1878","0","47.02","21.78"
"64","000","00","120","0041","1537","411","183","228","5","416","845","0","49.23","21.66"
"64","000","00","120","0041","1538","462","226","236","5","467","1033","0","45.21","21.88"
"64","000","00","120","0042","0000","1518","659","859","13","1531","3300","0","46.39","19.97"
"64","000","00","120","0042","1598","480","243","237","1","481","1073","0","44.83","22.65"
"64","000","00","120","0042","1599","524","206","318","8","532","1112","0","47.84","18.53"
"64","000","00","120","0042","1600","514","210","304","4","518","1115","0","46.46","18.83"
"64","000","00","120","0043","0000","1320","490","830","13","1333","2954","0","45.13","16.59"
"64","000","00","120","0043","1755","695","251","444","6","701","1515","0","46.27","16.57"
"64","000","00","120","0043","1756","625","239","386","7","632","1439","0","43.92","16.61"
"64","000","00","120","0044","0000","2446","1149","1297","13","2459","5599","0","43.92","20.52"
"64","000","00","120","0044","1609","470","198","272","5","475","1162","0","40.88","17.04"
"64","000","00","120","0044","1610","439","205","234","1","440","983","0","44.76","20.85"
"64","000","00","120","0044","1611","480","241","239","1","481","1095","0","43.93","22.01"
"64","000","00","120","0044","1612","578","271","307","2","580","1305","0","44.44","20.77"
"64","000","00","120","0044","1613","479","234","245","4","483","1054","0","45.83","22.20"
"64","000","00","120","0045","0000","890","496","394","9","899","1995","0","45.06","24.86"
"64","000","00","120","0045","1620","470","261","209","3","473","1017","0","46.51","25.66"
"64","000","00","120","0045","1621","420","235","185","6","426","978","0","43.56","24.03"
"64","000","00","120","0046","0000","2045","881","1164","11","2056","4606","0","44.64","19.13"
"64","000","00","120","0046","1591","713","306","407","4","717","1536","0","46.68","19.92"
"64","000","00","120","0046","1592","665","280","385","5","670","1542","0","43.45","18.16"
"64","000","00","120","0046","1593","667","295","372","2","669","1528","0","43.78","19.31"
"64","000","00","120","0047","0000","1464","775","689","17","1481","3154","0","46.96","24.57"
"64","000","00","120","0047","1602","463","206","257","6","469","997","0","47.04","20.66"
"64","000","00","120","0047","1603","465","285","180","5","470","1011","0","46.49","28.19"
"64","000","00","120","0047","1604","536","284","252","6","542","1146","0","47.29","24.78"
"64","000","00","120","0048","0000","2711","1051","1660","22","2733","6154","0","44.41","17.08"
"64","000","00","120","0048","1566","528","212","316","5","533","1297","0","41.09","16.35"
"64","000","00","120","0048","1567","661","271","390","2","663","1505","0","44.05","18.01"
"64","000","00","120","0048","1568","469","139","330","4","473","1044","0","45.31","13.31"
"64","000","00","120","0048","1569","551","175","376","6","557","1215","0","45.84","14.40"
"64","000","00","120","0048","1570","502","254","248","5","507","1093","0","46.39","23.24"
"64","000","00","120","0049","0000","1963","726","1237","18","1981","4554","0","43.50","15.94"
"64","000","00","120","0049","1764","640","238","402","7","647","1464","0","44.19","16.26"
"64","000","00","120","0049","1765","668","283","385","2","670","1625","0","41.23","17.42"
"64","000","00","120","0049","1766","655","205","450","9","664","1465","0","45.32","13.99"
"64","000","00","120","0050","0000","1010","567","443","15","1025","2537","0","40.40","22.35"
"64","000","00","120","0050","1635","531","310","221","12","543","1258","0","43.16","24.64"
"64","000","00","120","0050","1636","479","257","222","3","482","1279","0","37.69","20.09"
"64","000","00","120","0051","0000","505","216","289","7","512","1040","0","49.23","20.77"
"64","000","00","120","0051","1595","505","216","289","7","512","1040","0","49.23","20.77"
"64","000","00","120","0053","0000","1666","662","1004","16","1682","3969","0","42.38","16.68"
"64","000","00","120","0053","1543","627","262","365","6","633","1454","0","43.54","18.02"
"64","000","00","120","0053","1544","525","211","314","5","530","1268","0","41.80","16.64"
"64","000","00","120","0053","1545","514","189","325","5","519","1247","0","41.62","15.16"
"64","000","00","120","0054","0000","729","282","447","9","738","1831","0","40.31","15.40"
"64","000","00","120","0054","1733","392","155","237","3","395","950","0","41.58","16.32"
"64","000","00","120","0054","1734","337","127","210","6","343","881","0","38.93","14.42"
"64","000","00","120","0055","0000","3515","1217","2298","28","3543","8197","0","43.22","14.85"
"64","000","00","120","0055","1743","558","165","393","1","559","1298","0","43.07","12.71"
"64","000","00","120","0055","1744","574","197","377","5","579","1256","0","46.10","15.68"
"64","000","00","120","0055","1745","595","218","377","6","601","1626","0","36.96","13.41"
"64","000","00","120","0055","1746","621","227","394","6","627","1405","0","44.63","16.16"
"64","000","00","120","0055","1747","596","211","385","7","603","1399","0","43.10","15.08"
"64","000","00","120","0055","1748","571","199","372","3","574","1213","0","47.32","16.41"
"64","000","00","120","0056","0000","3602","1916","1686","32","3634","8181","0","44.42","23.42"
"64","000","00","120","0056","1560","707","594","113","13","720","1615","0","44.58","36.78"
"64","000","00","120","0056","1561","542","222","320","8","550","1162","0","47.33","19.10"
"64","000","00","120","0056","1562","572","236","336","2","574","1262","0","45.48","18.70"
"64","000","00","120","0056","1563","553","275","278","2","555","1488","0","37.30","18.48"
"64","000","00","120","0056","1564","556","289","267","4","560","1158","0","48.36","24.96"
"64","000","00","120","0056","1565","672","300","372","3","675","1496","0","45.12","20.05"
"64","000","00","120","0057","0000","1701","599","1102","17","1718","4349","0","39.50","13.77"
"64","000","00","120","0057","1752","521","187","334","6","527","1394","0","37.80","13.41"
"64","000","00","120","0057","1753","557","186","371","8","565","1408","0","40.13","13.21"
"64","000","00","120","0057","1754","623","226","397","3","626","1547","0","40.47","14.61"
"64","000","00","120","0058","0000","1049","414","635","4","1053","2612","0","40.31","15.85"
"64","000","00","120","0058","1553","625","257","368","2","627","1420","0","44.15","18.10"
"64","000","00","120","0058","1554","424","157","267","2","426","1192","0","35.74","13.17"
"64","000","00","120","0059","0000","1684","773","911","10","1694","4036","0","41.97","19.15"
"64","000","00","120","0059","1577","481","251","230","3","484","1266","0","38.23","19.83"
"64","000","00","120","0059","1578","609","256","353","6","615","1409","0","43.65","18.17"
"64","000","00","120","0059","1579","594","266","328","1","595","1361","0","43.72","19.54"
"64","000","00","120","0060","0000","4071","1952","2119","30","4101","9452","0","43.39","20.65"
"64","000","00","120","0060","1580","812","418","394","6","818","1790","0","45.70","23.35"
"64","000","00","120","0060","1581","720","318","402","4","724","1681","0","43.07","18.92"
"64","000","00","120","0060","1582","630","317","313","5","635","1565","0","40.58","20.26"
"64","000","00","120","0060","1583","656","286","370","3","659","1445","0","45.61","19.79"
"64","000","00","120","0060","1584","588","297","291","6","594","1353","0","43.90","21.95"
"64","000","00","120","0060","1585","665","316","349","6","671","1618","0","41.47","19.53"
"64","000","00","120","0061","0000","811","511","300","8","819","2046","0","40.03","24.98"
"64","000","00","120","0061","1637","339","177","162","4","343","804","0","42.66","22.01"
"64","000","00","120","0061","1638","472","334","138","4","476","1242","0","38.33","26.89"
"64","000","00","120","0062","0000","1070","598","472","10","1080","2686","0","40.21","22.26"
"64","000","00","120","0062","1639","581","345","236","9","590","1490","0","39.60","23.15"
"64","000","00","120","0062","1640","489","253","236","1","490","1196","0","40.97","21.15"
"64","000","00","120","0063","0000","1181","581","600","5","1186","2531","0","46.86","22.96"
"64","000","00","120","0063","1662","605","287","318","3","608","1330","0","45.71","21.58"
"64","000","00","120","0063","1663","576","294","282","2","578","1201","0","48.13","24.48"
"64","000","00","120","0064","0000","1010","401","609","6","1016","2292","0","44.33","17.50"
"64","000","00","120","0064","1664","507","189","318","4","511","1098","0","46.54","17.21"
"64","000","00","120","0064","1665","503","212","291","2","505","1194","0","42.29","17.76"
"64","000","00","120","0065","0000","1670","686","984","13","1683","3737","0","45.04","18.36"
"64","000","00","120","0065","1684","441","154","287","4","445","1085","0","41.01","14.19"
"64","000","00","120","0065","1685","522","201","321","5","527","1162","0","45.35","17.30"
"64","000","00","120","0065","1686","707","331","376","4","711","1490","0","47.72","22.21"
"64","000","00","120","0066","0000","1042","359","683","11","1053","2353","0","44.75","15.26"
"64","000","00","120","0066","1672","577","196","381","5","582","1271","0","45.79","15.42"
"64","000","00","120","0066","1673","465","163","302","6","471","1082","0","43.53","15.06"
"64","000","00","120","0067","0000","1819","764","1055","2","1821","4273","0","42.62","17.88"
"64","000","00","120","0067","1677","542","218","324","0","542","1334","0","40.63","16.34"
"64","000","00","120","0067","1678","586","237","349","0","586","1382","0","42.40","17.15"
"64","000","00","120","0067","1679","691","309","382","2","693","1557","0","44.51","19.85"
"64","000","00","120","0068","0000","1638","731","907","10","1648","4006","0","41.14","18.25"
"64","000","00","120","0068","1674","581","232","349","3","584","1449","0","40.30","16.01"
"64","000","00","120","0068","1675","556","275","281","2","558","1329","0","41.99","20.69"
"64","000","00","120","0068","1676","501","224","277","5","506","1228","0","41.21","18.24"
"64","000","00","120","0069","0000","1067","482","585","5","1072","2454","0","43.68","19.64"
"64","000","00","120","0069","1698","526","249","277","0","526","1174","0","44.80","21.21"
"64","000","00","120","0069","1699","541","233","308","5","546","1280","0","42.66","18.20"
"64","000","00","120","0070","0000","1744","745","999","9","1753","4441","0","39.47","16.78"
"64","000","00","120","0070","1700","554","254","300","3","557","1447","0","38.49","17.55"
"64","000","00","120","0070","1701","607","255","352","3","610","1411","0","43.23","18.07"
"64","000","00","120","0070","1702","583","236","347","3","586","1583","0","37.02","14.91"
"64","000","00","120","0071","0000","1829","682","1147","19","1848","4469","0","41.35","15.26"
"64","000","00","120","0071","1695","635","267","368","10","645","1487","0","43.38","17.96"
"64","000","00","120","0071","1696","601","203","398","4","605","1543","0","39.21","13.16"
"64","000","00","120","0071","1697","593","212","381","5","598","1439","0","41.56","14.73"
"64","000","00","120","0072","0000","1918","708","1210","14","1932","4472","0","43.20","15.83"
"64","000","00","120","0072","1724","635","210","425","6","641","1452","0","44.15","14.46"
"64","000","00","120","0072","1725","618","241","377","1","619","1425","0","43.44","16.91"
"64","000","00","120","0072","1726","665","257","408","7","672","1595","0","42.13","16.11"
"64","000","00","120","0073","0000","1133","374","759","5","1138","2740","0","41.53","13.65"
"64","000","00","120","0073","1727","570","193","377","3","573","1336","0","42.89","14.45"
"64","000","00","120","0073","1728","563","181","382","2","565","1404","0","40.24","12.89"
"64","000","00","120","0074","0000","985","388","597","7","992","2367","0","41.91","16.39"
"64","000","00","120","0074","1739","456","160","296","5","461","1058","0","43.57","15.12"
"64","000","00","120","0074","1740","529","228","301","2","531","1309","0","40.57","17.42"
"64","000","00","120","0075","0000","2062","782","1280","16","2078","5524","0","37.62","14.16"
"64","000","00","120","0075","1735","457","186","271","2","459","1280","0","35.86","14.53"
"64","000","00","120","0075","1736","483","199","284","3","486","1368","0","35.53","14.55"
"64","000","00","120","0075","1737","559","183","376","7","566","1454","0","38.93","12.59"
"64","000","00","120","0075","1738","563","214","349","4","567","1422","0","39.87","15.05"
"64","000","00","120","0076","0000","1101","396","705","10","1111","2597","0","42.78","15.25"
"64","000","00","120","0076","1741","582","193","389","8","590","1373","0","42.97","14.06"
"64","000","00","120","0076","1742","519","203","316","2","521","1224","0","42.57","16.58"
"64","000","00","120","0077","0000","1095","338","757","6","1101","2652","0","41.52","12.75"
"64","000","00","120","0077","1762","547","136","411","5","552","1314","0","42.01","10.35"
"64","000","00","120","0077","1763","548","202","346","1","549","1338","0","41.03","15.10"
"64","000","00","120","0078","0000","2640","1001","1639","19","2659","6389","0","41.62","15.67"
"64","000","00","120","0078","1716","572","207","365","5","577","1337","0","43.16","15.48"
"64","000","00","120","0078","1717","591","238","353","1","592","1334","0","44.38","17.84"
"64","000","00","120","0078","1718","521","191","330","6","527","1298","0","40.60","14.71"
"64","000","00","120","0078","1719","504","187","317","5","509","1176","0","43.28","15.90"
"64","000","00","120","0078","1720","452","178","274","2","454","1244","0","36.50","14.31"
"64","000","00","130","0000","0000","22942","7324","15618","270","23212","59161","69161","39.24","12.38"
"64","000","00","130","0001","0000","1017","321","696","10","1027","2799","0","36.69","11.47"
"64","000","00","130","0001","0947","501","173","328","7","508","1213","0","41.88","14.26"
"64","000","00","130","0001","0948","516","148","368","3","519","1586","0","32.72","9.33"
"64","000","00","130","0002","0000","1244","429","815","17","1261","3070","0","41.07","13.97"
"64","000","00","130","0002","0949","422","151","271","4","426","1074","0","39.66","14.06"
"64","000","00","130","0002","0950","375","128","247","3","378","981","0","38.53","13.05"
"64","000","00","130","0002","0951","447","150","297","10","457","1015","0","45.02","14.78"
"64","000","00","130","0003","0000","1532","476","1056","21","1553","4129","0","37.61","11.53"
"64","000","00","130","0003","0952","539","157","382","7","546","1369","0","39.88","11.47"
"64","000","00","130","0003","0953","482","158","324","4","486","1244","0","39.07","12.70"
"64","000","00","130","0003","0954","511","161","350","10","521","1516","0","34.37","10.62"
"64","000","00","130","0004","0000","1061","400","661","17","1078","2749","0","39.21","14.55"
"64","000","00","130","0004","0955","585","213","372","10","595","1414","0","42.08","15.06"
"64","000","00","130","0004","0956","476","187","289","7","483","1335","0","36.18","14.01"
"64","000","00","130","0005","0000","1235","479","756","19","1254","2981","0","42.07","16.07"
"64","000","00","130","0005","0957","598","186","412","11","609","1479","0","41.18","12.58"
"64","000","00","130","0005","0958","637","293","344","8","645","1502","0","42.94","19.51"
"64","000","00","130","0006","0000","985","334","651","16","1001","2474","0","40.46","13.50"
"64","000","00","130","0006","0959","477","172","305","6","483","1230","0","39.27","13.98"
"64","000","00","130","0006","0960","508","162","346","10","518","1244","0","41.64","13.02"
"64","000","00","130","0007","0000","1769","542","1227","22","1791","4546","0","39.40","11.92"
"64","000","00","130","0007","0961","437","130","307","4","441","1118","0","39.45","11.63"
"64","000","00","130","0007","0962","517","157","360","3","520","1357","0","38.32","11.57"
"64","000","00","130","0007","0963","368","117","251","6","374","909","0","41.14","12.87"
"64","000","00","130","0007","0964","447","138","309","9","456","1162","0","39.24","11.88"
"64","000","00","130","0008","0000","751","205","546","11","762","1795","0","42.45","11.42"
"64","000","00","130","0008","0965","376","103","273","3","379","939","0","40.36","10.97"
"64","000","00","130","0008","0966","375","102","273","8","383","856","0","44.74","11.92"
"64","000","00","130","0009","0000","1299","341","958","19","1318","3401","0","38.75","10.03"
"64","000","00","130","0009","0967","393","101","292","4","397","1083","0","36.66","9.33"
"64","000","00","130","0009","0968","427","116","311","8","435","1067","0","40.77","10.87"
"64","000","00","130","0009","0969","479","124","355","7","486","1251","0","38.85","9.91"
"64","000","00","130","0010","0000","704","174","530","9","713","1671","0","42.67","10.41"
"64","000","00","130","0010","0970","704","174","530","9","713","1671","0","42.67","10.41"
"64","000","00","130","0011","0000","527","190","337","3","530","1576","0","33.63","12.06"
"64","000","00","130","0011","0971","197","103","94","3","200","581","0","34.42","17.73"
"64","000","00","130","0011","0972","330","87","243","0","330","995","0","33.17","8.74"
"64","000","00","130","0012","0000","717","314","403","6","723","1960","0","36.89","16.02"
"64","000","00","130","0012","0973","417","150","267","3","420","981","0","42.81","15.29"
"64","000","00","130","0012","0974","300","164","136","3","303","979","0","30.95","16.75"
"64","000","00","130","0013","0000","1618","596","1022","12","1630","4087","0","39.88","14.58"
"64","000","00","130","0013","0975","623","228","395","5","628","1603","0","39.18","14.22"
"64","000","00","130","0013","0976","509","187","322","5","514","1294","0","39.72","14.45"
"64","000","00","130","0013","0977","486","181","305","2","488","1190","0","41.01","15.21"
"64","000","00","130","0014","0000","481","160","321","1","482","1274","0","37.83","12.56"
"64","000","00","130","0014","0978","481","160","321","1","482","1274","0","37.83","12.56"
"64","000","00","130","0015","0000","854","245","609","5","859","1939","0","44.30","12.64"
"64","000","00","130","0015","0979","452","135","317","2","454","1055","0","43.03","12.80"
"64","000","00","130","0015","0980","402","110","292","3","405","884","0","45.81","12.44"
"64","000","00","130","0016","0000","713","182","531","8","721","1726","0","41.77","10.54"
"64","000","00","130","0016","0981","354","70","284","4","358","820","0","43.66","8.54"
"64","000","00","130","0016","0982","359","112","247","4","363","906","0","40.07","12.36"
"64","000","00","130","0017","0000","693","161","532","8","701","1767","0","39.67","9.11"
"64","000","00","130","0017","0983","379","78","301","4","383","998","0","38.38","7.82"
"64","000","00","130","0017","0984","314","83","231","4","318","769","0","41.35","10.79"
"64","000","00","130","0018","0000","320","94","226","1","321","883","0","36.35","10.65"
"64","000","00","130","0018","0985","320","94","226","1","321","883","0","36.35","10.65"
"64","000","00","130","0019","0000","263","64","199","1","264","729","0","36.21","8.78"
"64","000","00","130","0019","0986","263","64","199","1","264","729","0","36.21","8.78"
"64","000","00","130","0020","0000","1199","353","846","13","1212","2918","0","41.54","12.10"
"64","000","00","130","0020","0987","660","198","462","4","664","1445","0","45.95","13.70"
"64","000","00","130","0020","0988","539","155","384","9","548","1473","0","37.20","10.52"
"64","000","00","130","0021","0000","1009","397","612","14","1023","2393","0","42.75","16.59"
"64","000","00","130","0021","0989","564","242","322","8","572","1368","0","41.81","17.69"
"64","000","00","130","0021","0990","445","155","290","6","451","1025","0","44.00","15.12"
"64","000","00","130","0022","0000","1333","435","898","17","1350","3366","0","40.11","12.92"
"64","000","00","130","0022","0991","491","156","335","7","498","1180","0","42.20","13.22"
"64","000","00","130","0022","0992","409","125","284","5","414","1113","0","37.20","11.23"
"64","000","00","130","0022","0993","433","154","279","5","438","1073","0","40.82","14.35"
"64","000","00","130","0023","0000","852","271","581","9","861","2660","0","32.37","10.19"
"64","000","00","130","0023","0994","487","173","314","5","492","1359","0","36.20","12.73"
"64","000","00","130","0023","0995","365","98","267","4","369","1301","0","28.36","7.53"
"64","000","00","130","0024","0000","766","161","605","11","777","2268","0","34.26","7.10"
"64","000","00","130","0024","0996","420","85","335","4","424","1134","0","37.39","7.50"
"64","000","00","130","0024","0997","346","76","270","7","353","1134","0","31.13","6.70"
"64","000","00","140","0000","0000","39081","14618","24463","404","39485","97638","112129","40.44","14.97"
"64","000","00","140","0001","0000","588","158","430","9","597","1391","0","42.92","11.36"
"64","000","00","140","0001","0861","292","69","223","3","295","691","0","42.69","9.99"
"64","000","00","140","0001","0862","296","89","207","6","302","700","0","43.14","12.71"
"64","000","00","140","0002","0000","2102","816","1286","16","2118","5790","0","36.58","14.09"
"64","000","00","140","0002","0863","511","166","345","2","513","1246","0","41.17","13.32"
"64","000","00","140","0002","0864","323","120","203","3","326","909","0","35.86","13.20"
"64","000","00","140","0002","0865","284","100","184","4","288","756","0","38.10","13.23"
"64","000","00","140","0002","0866","174","67","107","1","175","425","0","41.18","15.76"
"64","000","00","140","0002","0867","468","191","277","5","473","1233","0","38.36","15.49"
"64","000","00","140","0002","0868","342","172","170","1","343","1221","0","28.09","14.09"
"64","000","00","140","0003","0000","2388","753","1635","38","2426","6676","0","36.34","11.28"
"64","000","00","140","0003","0869","448","150","298","5","453","1302","0","34.79","11.52"
"64","000","00","140","0003","0870","499","165","334","6","505","1389","0","36.36","11.88"
"64","000","00","140","0003","0871","538","186","352","9","547","1469","0","37.24","12.66"
"64","000","00","140","0003","0872","479","123","356","10","489","1399","0","34.95","8.79"
"64","000","00","140","0003","0873","424","129","295","8","432","1117","0","38.68","11.55"
"64","000","00","140","0004","0000","981","276","705","11","992","2414","0","41.09","11.43"
"64","000","00","140","0004","0874","480","140","340","5","485","1208","0","40.15","11.59"
"64","000","00","140","0004","0875","501","136","365","6","507","1206","0","42.04","11.28"
"64","000","00","140","0005","0000","1877","627","1250","13","1890","4615","0","40.95","13.59"
"64","000","00","140","0005","0876","562","184","378","3","565","1362","0","41.48","13.51"
"64","000","00","140","0005","0877","480","168","312","2","482","1196","0","40.30","14.05"
"64","000","00","140","0005","0878","432","169","263","4","436","1075","0","40.56","15.72"
"64","000","00","140","0005","0879","403","106","297","4","407","982","0","41.45","10.79"
"64","000","00","140","0006","0000","1970","569","1401","18","1988","4639","0","42.85","12.27"
"64","000","00","140","0006","0880","557","166","391","4","561","1307","0","42.92","12.70"
"64","000","00","140","0006","0881","753","227","526","5","758","1733","0","43.74","13.10"
"64","000","00","140","0006","0882","660","176","484","9","669","1599","0","41.84","11.01"
"64","000","00","140","0007","0000","1752","461","1291","16","1768","3885","0","45.51","11.87"
"64","000","00","140","0007","0883","571","162","409","6","577","1235","0","46.72","13.12"
"64","000","00","140","0007","0884","607","157","450","5","612","1382","0","44.28","11.36"
"64","000","00","140","0007","0885","574","142","432","5","579","1268","0","45.66","11.20"
"64","000","00","140","0008","0000","1081","453","628","16","1097","2318","0","47.33","19.54"
"64","000","00","140","0008","0886","595","286","309","7","602","1286","0","46.81","22.24"
"64","000","00","140","0008","0887","486","167","319","9","495","1032","0","47.97","16.18"
"64","000","00","140","0009","0000","4179","1488","2691","40","4219","10756","0","39.22","13.83"
"64","000","00","140","0009","0888","567","182","385","4","571","1357","0","42.08","13.41"
"64","000","00","140","0009","0889","483","189","294","5","488","1287","0","37.92","14.69"
"64","000","00","140","0009","0890","449","169","280","8","457","1283","0","35.62","13.17"
"64","000","00","140","0009","0891","542","192","350","4","546","1421","0","38.42","13.51"
"64","000","00","140","0009","0892","568","209","359","3","571","1381","0","41.35","15.13"
"64","000","00","140","0009","0893","503","182","321","4","507","1283","0","39.52","14.19"
"64","000","00","140","0009","0894","540","215","325","8","548","1365","0","40.15","15.75"
"64","000","00","140","0009","0895","527","150","377","4","531","1379","0","38.51","10.88"
"64","000","00","140","0010","0000","3081","1247","1834","32","3113","7626","0","40.82","16.35"
"64","000","00","140","0010","0896","522","204","318","5","527","1238","0","42.57","16.48"
"64","000","00","140","0010","0897","336","143","193","1","337","910","0","37.03","15.71"
"64","000","00","140","0010","0898","467","196","271","7","474","1127","0","42.06","17.39"
"64","000","00","140","0010","0899","317","124","193","2","319","719","0","44.37","17.25"
"64","000","00","140","0010","0900","368","166","202","2","370","963","0","38.42","17.24"
"64","000","00","140","0010","0901","547","224","323","9","556","1349","0","41.22","16.60"
"64","000","00","140","0010","0902","524","190","334","6","530","1320","0","40.15","14.39"
"64","000","00","140","0011","0000","752","223","529","8","760","1803","0","42.15","12.37"
"64","000","00","140","0011","0903","456","143","313","5","461","1045","0","44.11","13.68"
"64","000","00","140","0011","0904","296","80","216","3","299","758","0","39.45","10.55"
"64","000","00","140","0012","0000","592","183","409","7","599","1666","0","35.95","10.98"
"64","000","00","140","0012","0905","316","117","199","4","320","928","0","34.48","12.61"
"64","000","00","140","0012","0906","276","66","210","3","279","738","0","37.80","8.94"
"64","000","00","140","0013","0000","995","328","667","8","1003","2472","0","40.57","13.27"
"64","000","00","140","0013","0907","470","152","318","5","475","1200","0","39.58","12.67"
"64","000","00","140","0013","0908","525","176","349","3","528","1272","0","41.51","13.84"
"64","000","00","140","0014","0000","1184","316","868","13","1197","2917","0","41.04","10.83"
"64","000","00","140","0014","0909","398","110","288","5","403","988","0","40.79","11.13"
"64","000","00","140","0014","0910","342","77","265","3","345","934","0","36.94","8.24"
"64","000","00","140","0014","0911","444","129","315","5","449","995","0","45.13","12.96"
"64","000","00","140","0015","0000","592","202","390","3","595","1538","0","38.69","13.13"
"64","000","00","140","0015","0912","326","105","221","1","327","826","0","39.59","12.71"
"64","000","00","140","0015","0913","266","97","169","2","268","712","0","37.64","13.62"
"64","000","00","140","0016","0000","2343","992","1351","19","2362","6229","0","37.92","15.93"
"64","000","00","140","0016","0914","433","155","278","2","435","1152","0","37.76","13.45"
"64","000","00","140","0016","0915","502","188","314","3","505","1212","0","41.67","15.51"
"64","000","00","140","0016","0916","469","200","269","1","470","1130","0","41.59","17.70"
"64","000","00","140","0016","0917","368","172","196","2","370","1338","0","27.65","12.86"
"64","000","00","140","0016","0918","571","277","294","11","582","1397","0","41.66","19.83"
"64","000","00","140","0017","0000","2962","1452","1510","32","2994","7455","0","40.16","19.48"
"64","000","00","140","0017","0919","443","136","307","3","446","1061","0","42.04","12.82"
"64","000","00","140","0017","0920","436","199","237","4","440","1236","0","35.60","16.10"
"64","000","00","140","0017","0921","508","280","228","3","511","1159","0","44.09","24.16"
"64","000","00","140","0017","0922","519","289","230","9","528","1271","0","41.54","22.74"
"64","000","00","140","0017","0923","558","274","284","4","562","1518","0","37.02","18.05"
"64","000","00","140","0017","0924","498","274","224","9","507","1210","0","41.90","22.64"
"64","000","00","140","0018","0000","246","159","87","2","248","541","0","45.84","29.39"
"64","000","00","140","0018","0925","246","159","87","2","248","541","0","45.84","29.39"
"64","000","00","140","0019","0000","2765","1043","1722","24","2789","6812","0","40.94","15.31"
"64","000","00","140","0019","0926","378","161","217","5","383","1050","0","36.48","15.33"
"64","000","00","140","0019","0927","527","209","318","4","531","1241","0","42.79","16.84"
"64","000","00","140","0019","0928","450","179","271","5","455","1038","0","43.83","17.24"
"64","000","00","140","0019","0929","498","165","333","3","501","1219","0","41.10","13.54"
"64","000","00","140","0019","0930","455","171","284","4","459","1097","0","41.84","15.59"
"64","000","00","140","0019","0931","457","158","299","3","460","1167","0","39.42","13.54"
"64","000","00","140","0020","0000","954","281","673","13","967","2201","0","43.93","12.77"
"64","000","00","140","0020","0932","430","116","314","7","437","972","0","44.96","11.93"
"64","000","00","140","0020","0933","524","165","359","6","530","1229","0","43.12","13.43"
"64","000","00","140","0021","0000","677","227","450","5","682","1545","0","44.14","14.69"
"64","000","00","140","0021","0934","305","93","212","3","308","713","0","43.20","13.04"
"64","000","00","140","0021","0935","372","134","238","2","374","832","0","44.95","16.11"
"64","000","00","140","0022","0000","824","260","564","7","831","1851","0","44.89","14.05"
"64","000","00","140","0022","0936","426","133","293","4","430","930","0","46.24","14.30"
"64","000","00","140","0022","0937","398","127","271","3","401","921","0","43.54","13.79"
"64","000","00","140","0023","0000","1402","417","985","11","1413","3723","0","37.95","11.20"
"64","000","00","140","0023","0938","491","138","353","4","495","1272","0","38.92","10.85"
"64","000","00","140","0023","0939","443","124","319","5","448","1164","0","38.49","10.65"
"64","000","00","140","0023","0940","468","155","313","2","470","1287","0","36.52","12.04"
"64","000","00","140","0024","0000","41","28","13","5","46","111","0","41.44","25.23"
"64","000","00","140","0024","0941","41","28","13","5","46","111","0","41.44","25.23"
"64","000","00","140","0025","0000","2753","1659","1094","38","2791","6664","0","41.88","24.89"
"64","000","00","140","0025","0942","577","406","171","9","586","1392","0","42.10","29.17"
"64","000","00","140","0025","0943","614","359","255","7","621","1376","0","45.13","26.09"
"64","000","00","140","0025","0944","516","305","211","7","523","1327","0","39.41","22.98"
"64","000","00","140","0025","0945","545","280","265","8","553","1299","0","42.57","21.56"
"64","000","00","140","0025","0946","501","309","192","7","508","1270","0","40.00","24.33"
"64","000","00","150","0000","0000","14935","4784","10151","178","15113","36462","41549","41.45","13.12"
"64","000","00","150","0001","0000","1118","422","696","8","1126","2680","0","42.01","15.75"
"64","000","00","150","0001","0198","542","179","363","6","548","1328","0","41.27","13.48"
"64","000","00","150","0001","0199","576","243","333","2","578","1352","0","42.75","17.97"
"64","000","00","150","0002","0000","1893","750","1143","33","1926","5186","0","37.14","14.46"
"64","000","00","150","0002","0200","432","170","262","4","436","1273","0","34.25","13.35"
"64","000","00","150","0002","0201","414","158","256","7","421","1228","0","34.28","12.87"
"64","000","00","150","0002","0202","540","206","334","10","550","1351","0","40.71","15.25"
"64","000","00","150","0002","0203","507","216","291","12","519","1334","0","38.91","16.19"
"64","000","00","150","0003","0000","1731","687","1044","22","1753","4079","0","42.98","16.84"
"64","000","00","150","0003","0204","586","262","324","5","591","1411","0","41.89","18.57"
"64","000","00","150","0003","0205","577","225","352","8","585","1315","0","44.49","17.11"
"64","000","00","150","0003","0206","568","200","368","9","577","1353","0","42.65","14.78"
"64","000","00","150","0004","0000","1018","316","702","18","1036","2313","0","44.79","13.66"
"64","000","00","150","0004","0207","448","112","336","8","456","1076","0","42.38","10.41"
"64","000","00","150","0004","0208","570","204","366","10","580","1237","0","46.89","16.49"
"64","000","00","150","0005","0000","1016","288","728","6","1022","2219","0","46.06","12.98"
"64","000","00","150","0005","0209","484","141","343","4","488","1113","0","43.85","12.67"
"64","000","00","150","0005","0210","532","147","385","2","534","1106","0","48.28","13.29"
"64","000","00","150","0006","0000","1345","425","920","12","1357","3451","0","39.32","12.32"
"64","000","00","150","0006","0211","473","142","331","6","479","1261","0","37.99","11.26"
"64","000","00","150","0006","0212","428","151","277","1","429","1065","0","40.28","14.18"
"64","000","00","150","0006","0213","444","132","312","5","449","1125","0","39.91","11.73"
"64","000","00","150","0007","0000","419","78","341","2","421","1026","0","41.03","7.60"
"64","000","00","150","0007","0214","419","78","341","2","421","1026","0","41.03","7.60"
"64","000","00","150","0008","0000","402","105","297","4","406","994","0","40.85","10.56"
"64","000","00","150","0008","0215","402","105","297","4","406","994","0","40.85","10.56"
"64","000","00","150","0009","0000","436","110","326","5","441","962","0","45.84","11.43"
"64","000","00","150","0009","0216","436","110","326","5","441","962","0","45.84","11.43"
"64","000","00","150","0010","0000","567","178","389","4","571","1434","0","39.82","12.41"
"64","000","00","150","0010","0217","567","178","389","4","571","1434","0","39.82","12.41"
"64","000","00","150","0011","0000","652","146","506","5","657","1505","0","43.65","9.70"
"64","000","00","150","0011","0218","322","70","252","3","325","741","0","43.86","9.45"
"64","000","00","150","0011","0219","330","76","254","2","332","764","0","43.46","9.95"
"64","000","00","150","0012","0000","560","178","382","14","574","1311","0","43.78","13.58"
"64","000","00","150","0012","0220","560","178","382","14","574","1311","0","43.78","13.58"
"64","000","00","150","0013","0000","759","127","632","16","775","1752","0","44.24","7.25"
"64","000","00","150","0013","0221","432","69","363","10","442","879","0","50.28","7.85"
"64","000","00","150","0013","0222","327","58","269","6","333","873","0","38.14","6.64"
"64","000","00","150","0014","0000","997","263","734","13","1010","2492","0","40.53","10.55"
"64","000","00","150","0014","0223","497","131","366","2","499","1262","0","39.54","10.38"
"64","000","00","150","0014","0224","500","132","368","11","511","1230","0","41.54","10.73"
"64","000","00","150","0015","0000","378","140","238","2","380","994","0","38.23","14.08"
"64","000","00","150","0015","0225","378","140","238","2","380","994","0","38.23","14.08"
"64","000","00","150","0016","0000","629","165","464","4","633","1539","0","41.13","10.72"
"64","000","00","150","0016","0226","313","92","221","1","314","792","0","39.65","11.62"
"64","000","00","150","0016","0227","316","73","243","3","319","747","0","42.70","9.77"
"64","000","00","150","0017","0000","751","320","431","8","759","1855","0","40.92","17.25"
"64","000","00","150","0017","0228","426","117","309","1","427","980","0","43.57","11.94"
"64","000","00","150","0017","0229","325","203","122","7","332","875","0","37.94","23.20"
"64","000","00","150","0018","0000","264","86","178","2","266","670","0","39.70","12.84"
"64","000","00","150","0018","0230","264","86","178","2","266","670","0","39.70","12.84"
"64","000","00","160","0000","0000","12607","4227","8380","138","12745","30109","34208","42.33","14.04"
"64","000","00","160","0001","0000","321","120","201","0","321","899","0","35.71","13.35"
"64","000","00","160","0001","0231","321","120","201","0","321","899","0","35.71","13.35"
"64","000","00","160","0002","0000","1414","507","907","18","1432","3267","0","43.83","15.52"
"64","000","00","160","0002","0232","478","145","333","6","484","1026","0","47.17","14.13"
"64","000","00","160","0002","0233","464","197","267","5","469","1115","0","42.06","17.67"
"64","000","00","160","0002","0234","472","165","307","7","479","1126","0","42.54","14.65"
"64","000","00","160","0003","0000","2046","737","1309","16","2062","4936","0","41.77","14.93"
"64","000","00","160","0003","0235","423","151","272","2","425","1034","0","41.10","14.60"
"64","000","00","160","0003","0236","355","104","251","4","359","1005","0","35.72","10.35"
"64","000","00","160","0003","0237","460","147","313","1","461","1041","0","44.28","14.12"
"64","000","00","160","0003","0238","468","183","285","5","473","1030","0","45.92","17.77"
"64","000","00","160","0003","0239","340","152","188","4","344","826","0","41.65","18.40"
"64","000","00","160","0004","0000","693","203","490","6","699","1648","0","42.42","12.32"
"64","000","00","160","0004","0258","300","66","234","4","304","697","0","43.62","9.47"
"64","000","00","160","0004","0259","393","137","256","2","395","951","0","41.54","14.41"
"64","000","00","160","0005","0000","1169","372","797","19","1188","2706","0","43.90","13.75"
"64","000","00","160","0005","0243","429","153","276","7","436","1062","0","41.05","14.41"
"64","000","00","160","0005","0244","376","117","259","6","382","882","0","43.31","13.27"
"64","000","00","160","0005","0245","364","102","262","6","370","762","0","48.56","13.39"
"64","000","00","160","0006","0000","2411","751","1660","26","2437","5416","0","45.00","13.87"
"64","000","00","160","0006","0246","559","174","385","13","572","1111","0","51.49","15.66"
"64","000","00","160","0006","0247","485","154","331","5","490","1158","0","42.31","13.30"
"64","000","00","160","0006","0248","450","124","326","6","456","1079","0","42.26","11.49"
"64","000","00","160","0006","0249","462","164","298","2","464","1034","0","44.87","15.86"
"64","000","00","160","0006","0250","455","135","320","0","455","1034","0","44.00","13.06"
"64","000","00","160","0007","0000","1914","677","1237","15","1929","4948","0","38.99","13.68"
"64","000","00","160","0007","0251","505","166","339","2","507","1270","0","39.92","13.07"
"64","000","00","160","0007","0252","497","184","313","6","503","1270","0","39.61","14.49"
"64","000","00","160","0007","0253","514","184","330","4","518","1248","0","41.51","14.74"
"64","000","00","160","0007","0254","398","143","255","3","401","1160","0","34.57","12.33"
"64","000","00","160","0008","0000","1329","459","870","19","1348","3171","0","42.51","14.47"
"64","000","00","160","0008","0255","497","148","349","7","504","1108","0","45.49","13.36"
"64","000","00","160","0008","0256","442","173","269","7","449","1153","0","38.94","15.00"
"64","000","00","160","0008","0257","390","138","252","5","395","910","0","43.41","15.16"
"64","000","00","160","0009","0000","1310","401","909","19","1329","3118","0","42.62","12.86"
"64","000","00","160","0009","0240","420","136","284","5","425","1053","0","40.36","12.92"
"64","000","00","160","0009","0241","451","152","299","6","457","1048","0","43.61","14.50"
"64","000","00","160","0009","0242","439","113","326","8","447","1017","0","43.95","11.11"
"64","000","00","170","0000","0000","32171","11810","20361","240","32411","78723","92846","41.17","15.00"
"64","000","00","170","0001","0000","1836","662","1174","9","1845","4416","0","41.78","14.99"
"64","000","00","170","0001","0771","654","228","426","2","656","1456","0","45.05","15.66"
"64","000","00","170","0001","0772","628","228","400","4","632","1568","0","40.31","14.54"
"64","000","00","170","0001","0773","554","206","348","3","557","1392","0","40.01","14.80"
"64","000","00","170","0002","0000","3153","1147","2006","19","3172","7950","0","39.90","14.43"
"64","000","00","170","0002","0774","563","188","375","3","566","1398","0","40.49","13.45"
"64","000","00","170","0002","0775","505","155","350","2","507","1202","0","42.18","12.90"
"64","000","00","170","0002","0776","489","145","344","5","494","1203","0","41.06","12.05"
"64","000","00","170","0002","0777","479","173","306","2","481","1330","0","36.17","13.01"
"64","000","00","170","0002","0778","528","216","312","2","530","1316","0","40.27","16.41"
"64","000","00","170","0002","0779","589","270","319","5","594","1501","0","39.57","17.99"
"64","000","00","170","0003","0000","1215","477","738","9","1224","2625","0","46.63","18.17"
"64","000","00","170","0003","0780","587","220","367","4","591","1319","0","44.81","16.68"
"64","000","00","170","0003","0781","628","257","371","5","633","1306","0","48.47","19.68"
"64","000","00","170","0004","0000","1368","496","872","13","1381","3764","0","36.69","13.18"
"64","000","00","170","0004","0782","450","180","270","5","455","1194","0","38.11","15.08"
"64","000","00","170","0004","0783","371","110","261","5","376","1182","0","31.81","9.31"
"64","000","00","170","0004","0784","547","206","341","3","550","1388","0","39.63","14.84"
"64","000","00","170","0005","0000","323","107","216","9","332","849","0","39.10","12.60"
"64","000","00","170","0005","0785","323","107","216","9","332","849","0","39.10","12.60"
"64","000","00","170","0006","0000","2038","669","1369","17","2055","5452","0","37.69","12.27"
"64","000","00","170","0006","0786","561","190","371","7","568","1372","0","41.40","13.85"
"64","000","00","170","0006","0787","397","153","244","0","397","1387","0","28.62","11.03"
"64","000","00","170","0006","0788","584","159","425","5","589","1364","0","43.18","11.66"
"64","000","00","170","0006","0789","496","167","329","5","501","1329","0","37.70","12.57"
"64","000","00","170","0007","0000","3773","1312","2461","20","3793","9055","0","41.89","14.49"
"64","000","00","170","0007","0790","697","200","497","4","701","1596","0","43.92","12.53"
"64","000","00","170","0007","0791","648","244","404","2","650","1609","0","40.40","15.16"
"64","000","00","170","0007","0792","603","193","410","2","605","1455","0","41.58","13.26"
"64","000","00","170","0007","0793","628","263","365","4","632","1501","0","42.11","17.52"
"64","000","00","170","0007","0794","611","229","382","3","614","1392","0","44.11","16.45"
"64","000","00","170","0007","0795","586","183","403","5","591","1502","0","39.35","12.18"
"64","000","00","170","0008","0000","1016","236","780","9","1025","2172","0","47.19","10.87"
"64","000","00","170","0008","0796","509","108","401","3","512","1031","0","49.66","10.48"
"64","000","00","170","0008","0797","507","128","379","6","513","1141","0","44.96","11.22"
"64","000","00","170","0009","0000","7036","2824","4212","56","7092","17709","0","40.05","15.95"
"64","000","00","170","0009","0798","573","178","395","5","578","1358","0","42.56","13.11"
"64","000","00","170","0009","0799","660","248","412","3","663","1495","0","44.35","16.59"
"64","000","00","170","0009","0800","610","268","342","5","615","1460","0","42.12","18.36"
"64","000","00","170","0009","0801","608","231","377","3","611","1445","0","42.28","15.99"
"64","000","00","170","0009","0802","507","206","301","4","511","1315","0","38.86","15.67"
"64","000","00","170","0009","0803","555","216","339","5","560","1455","0","38.49","14.85"
"64","000","00","170","0009","0804","510","226","284","0","510","1417","0","35.99","15.95"
"64","000","00","170","0009","0805","578","253","325","8","586","1421","0","41.24","17.80"
"64","000","00","170","0009","0806","564","225","339","3","567","1392","0","40.73","16.16"
"64","000","00","170","0009","0807","598","291","307","4","602","1418","0","42.45","20.52"
"64","000","00","170","0009","0808","557","189","368","11","568","1415","0","40.14","13.36"
"64","000","00","170","0009","0809","716","293","423","5","721","2118","0","34.04","13.83"
"64","000","00","170","0010","0000","1088","402","686","13","1101","2610","0","42.18","15.40"
"64","000","00","170","0010","0810","574","195","379","7","581","1363","0","42.63","14.31"
"64","000","00","170","0010","0811","514","207","307","6","520","1247","0","41.70","16.60"
"64","000","00","170","0011","0000","1068","277","791","5","1073","2542","0","42.21","10.90"
"64","000","00","170","0011","0812","539","144","395","2","541","1237","0","43.73","11.64"
"64","000","00","170","0011","0813","529","133","396","3","532","1305","0","40.77","10.19"
"64","000","00","170","0012","0000","646","263","383","4","650","1606","0","40.47","16.38"
"64","000","00","170","0012","0814","646","263","383","4","650","1606","0","40.47","16.38"
"64","000","00","170","0013","0000","1996","735","1261","14","2010","5171","0","38.87","14.21"
"64","000","00","170","0013","0815","459","156","303","2","461","1249","0","36.91","12.49"
"64","000","00","170","0013","0816","494","168","326","1","495","1234","0","40.11","13.61"
"64","000","00","170","0013","0817","498","220","278","3","501","1327","0","37.75","16.58"
"64","000","00","170","0013","0818","545","191","354","8","553","1361","0","40.63","14.03"
"64","000","00","170","0014","0000","1698","650","1048","14","1712","3838","0","44.61","16.94"
"64","000","00","170","0014","0819","576","218","358","5","581","1268","0","45.82","17.19"
"64","000","00","170","0014","0820","545","210","335","4","549","1277","0","42.99","16.44"
"64","000","00","170","0014","0821","577","222","355","5","582","1293","0","45.01","17.17"
"64","000","00","170","0015","0000","2854","1131","1723","19","2873","6762","0","42.49","16.73"
"64","000","00","170","0015","0822","602","220","382","4","606","1390","0","43.60","15.83"
"64","000","00","170","0015","0823","562","211","351","3","565","1341","0","42.13","15.73"
"64","000","00","170","0015","0824","556","246","310","3","559","1330","0","42.03","18.50"
"64","000","00","170","0015","0825","553","235","318","5","558","1318","0","42.34","17.83"
"64","000","00","170","0015","0826","581","219","362","4","585","1383","0","42.30","15.84"
"64","000","00","170","0016","0000","1063","422","641","10","1073","2202","0","48.73","19.16"
"64","000","00","170","0016","0827","518","211","307","7","525","1077","0","48.75","19.59"
"64","000","00","170","0016","0828","545","211","334","3","548","1125","0","48.71","18.76"
"64","000","00","180","0000","0000","17999","6956","11043","117","18116","39800","44727","45.52","17.48"
"64","000","00","180","0001","0000","4417","1776","2641","41","4458","10418","0","42.79","17.05"
"64","000","00","180","0001","0829","532","210","322","3","535","1207","0","44.32","17.40"
"64","000","00","180","0001","0830","591","243","348","0","591","1254","0","47.13","19.38"
"64","000","00","180","0001","0831","550","213","337","1","551","1301","0","42.35","16.37"
"64","000","00","180","0001","0832","618","258","360","7","625","1342","0","46.57","19.23"
"64","000","00","180","0001","0833","532","230","302","10","542","1420","0","38.17","16.20"
"64","000","00","180","0001","0834","531","245","286","6","537","1295","0","41.47","18.92"
"64","000","00","180","0001","0835","521","203","318","7","528","1283","0","41.15","15.82"
"64","000","00","180","0001","0836","542","174","368","7","549","1316","0","41.72","13.22"
"64","000","00","180","0002","0000","2315","948","1367","8","2323","4917","0","47.24","19.28"
"64","000","00","180","0002","0837","685","284","401","2","687","1419","0","48.41","20.01"
"64","000","00","180","0002","0838","580","186","394","2","582","1159","0","50.22","16.05"
"64","000","00","180","0002","0839","465","214","251","3","468","1101","0","42.51","19.44"
"64","000","00","180","0002","0840","585","264","321","1","586","1238","0","47.33","21.32"
"64","000","00","180","0003","0000","4818","2088","2730","21","4839","9866","0","49.05","21.16"
"64","000","00","180","0003","0841","653","221","432","4","657","1243","0","52.86","17.78"
"64","000","00","180","0003","0842","646","300","346","0","646","1337","0","48.32","22.44"
"64","000","00","180","0003","0843","619","267","352","2","621","1285","0","48.33","20.78"
"64","000","00","180","0003","0844","553","234","319","1","554","1156","0","47.92","20.24"
"64","000","00","180","0003","0845","483","246","237","5","488","1070","0","45.61","22.99"
"64","000","00","180","0003","0846","667","295","372","0","667","1319","0","50.57","22.37"
"64","000","00","180","0003","0847","618","229","389","5","623","1207","0","51.62","18.97"
"64","000","00","180","0003","0848","579","296","283","4","583","1249","0","46.68","23.70"
"64","000","00","180","0004","0000","1635","561","1074","8","1643","3551","0","46.27","15.80"
"64","000","00","180","0004","0849","559","194","365","1","560","1211","0","46.24","16.02"
"64","000","00","180","0004","0850","557","212","345","5","562","1213","0","46.33","17.48"
"64","000","00","180","0004","0851","519","155","364","2","521","1127","0","46.23","13.75"
"64","000","00","180","0005","0000","2748","846","1902","25","2773","6496","0","42.69","13.02"
"64","000","00","180","0005","0852","565","138","427","3","568","1245","0","45.62","11.08"
"64","000","00","180","0005","0853","674","209","465","3","677","1502","0","45.07","13.91"
"64","000","00","180","0005","0854","531","160","371","5","536","1387","0","38.64","11.54"
"64","000","00","180","0005","0855","536","196","340","7","543","1313","0","41.36","14.93"
"64","000","00","180","0005","0856","442","143","299","7","449","1049","0","42.80","13.63"
"64","000","00","180","0006","0000","333","96","237","4","337","678","0","49.71","14.16"
"64","000","00","180","0006","0857","333","96","237","4","337","678","0","49.71","14.16"
"64","000","00","180","0007","0000","1733","641","1092","10","1743","3874","0","44.99","16.55"
"64","000","00","180","0007","0858","594","197","397","5","599","1345","0","44.54","14.65"
"64","000","00","180","0007","0859","528","212","316","2","530","1248","0","42.47","16.99"
"64","000","00","180","0007","0860","611","232","379","3","614","1281","0","47.93","18.11"
"64","000","00","190","0000","0000","34565","14731","19834","322","34887","81201","96433","42.96","18.14"
"64","000","00","190","0001","0000","469","196","273","7","476","1073","0","44.36","18.27"
"64","000","00","190","0001","0375","469","196","273","7","476","1073","0","44.36","18.27"
"64","000","00","190","0002","0000","1670","648","1022","12","1682","4363","0","38.55","14.85"
"64","000","00","190","0002","0368","559","258","301","4","563","1338","0","42.08","19.28"
"64","000","00","190","0002","0369","359","109","250","0","359","1084","0","33.12","10.06"
"64","000","00","190","0002","0370","384","161","223","4","388","1056","0","36.74","15.25"
"64","000","00","190","0002","0371","368","120","248","4","372","885","0","42.03","13.56"
"64","000","00","190","0003","0000","1435","658","777","13","1448","3149","0","45.98","20.90"
"64","000","00","190","0003","0372","413","167","246","3","416","893","0","46.58","18.70"
"64","000","00","190","0003","0373","475","211","264","4","479","1063","0","45.06","19.85"
"64","000","00","190","0003","0374","547","280","267","6","553","1193","0","46.35","23.47"
"64","000","00","190","0004","0000","417","142","275","3","420","985","0","42.64","14.42"
"64","000","00","190","0004","0376","417","142","275","3","420","985","0","42.64","14.42"
"64","000","00","190","0005","0000","1691","817","874","21","1712","4134","0","41.41","19.76"
"64","000","00","190","0005","0381","557","200","357","10","567","1346","0","42.12","14.86"
"64","000","00","190","0005","0382","589","268","321","3","592","1369","0","43.24","19.58"
"64","000","00","190","0005","0383","545","349","196","8","553","1419","0","38.97","24.59"
"64","000","00","190","0006","0000","631","169","462","13","644","1366","0","47.14","12.37"
"64","000","00","190","0006","0377","631","169","462","13","644","1366","0","47.14","12.37"
"64","000","00","190","0007","0000","1318","1025","293","19","1337","2810","0","47.58","36.48"
"64","000","00","190","0007","0433","590","472","118","8","598","1316","0","45.44","35.87"
"64","000","00","190","0007","0434","560","478","82","10","570","1163","0","49.01","41.10"
"64","000","00","190","0007","0435","168","75","93","1","169","331","0","51.06","22.66"
"64","000","00","190","0008","0000","152","72","80","2","154","300","0","51.33","24.00"
"64","000","00","190","0008","0440","152","72","80","2","154","300","0","51.33","24.00"
"64","000","00","190","0009","0000","1189","468","721","10","1199","2809","0","42.68","16.66"
"64","000","00","190","0009","0401","564","225","339","5","569","1296","0","43.90","17.36"
"64","000","00","190","0009","0402","625","243","382","5","630","1513","0","41.64","16.06"
"64","000","00","190","0010","0000","703","220","483","11","714","1401","0","50.96","15.70"
"64","000","00","190","0010","0417","703","220","483","11","714","1401","0","50.96","15.70"
"64","000","00","190","0011","0000","1612","684","928","23","1635","3572","0","45.77","19.15"
"64","000","00","190","0011","0412","543","241","302","10","553","1283","0","43.10","18.78"
"64","000","00","190","0011","0413","489","231","258","4","493","1014","0","48.62","22.78"
"64","000","00","190","0011","0414","580","212","368","9","589","1275","0","46.20","16.63"
"64","000","00","190","0012","0000","2229","1047","1182","17","2246","5458","0","41.15","19.18"
"64","000","00","190","0012","0408","519","214","305","6","525","1271","0","41.31","16.84"
"64","000","00","190","0012","0409","603","271","332","3","606","1376","0","44.04","19.69"
"64","000","00","190","0012","0410","581","294","287","2","583","1330","0","43.83","22.11"
"64","000","00","190","0012","0411","526","268","258","6","532","1481","0","35.92","18.10"
"64","000","00","190","0013","0000","658","370","288","3","661","1556","0","42.48","23.78"
"64","000","00","190","0013","0438","357","197","160","2","359","828","0","43.36","23.79"
"64","000","00","190","0013","0439","301","173","128","1","302","728","0","41.48","23.76"
"64","000","00","190","0014","0000","335","87","248","5","340","761","0","44.68","11.43"
"64","000","00","190","0014","0428","335","87","248","5","340","761","0","44.68","11.43"
"64","000","00","190","0015","0000","364","86","278","5","369","867","0","42.56","9.92"
"64","000","00","190","0015","0431","364","86","278","5","369","867","0","42.56","9.92"
"64","000","00","190","0016","0000","1501","634","867","13","1514","3290","0","46.02","19.27"
"64","000","00","190","0016","0405","492","173","319","3","495","1036","0","47.78","16.70"
"64","000","00","190","0016","0406","508","215","293","7","515","1055","0","48.82","20.38"
"64","000","00","190","0016","0407","501","246","255","3","504","1199","0","42.04","20.52"
"64","000","00","190","0017","0000","1541","631","910","12","1553","3822","0","40.63","16.51"
"64","000","00","190","0017","0384","467","193","274","4","471","1258","0","37.44","15.34"
"64","000","00","190","0017","0385","494","201","293","5","499","1199","0","41.62","16.76"
"64","000","00","190","0017","0386","580","237","343","3","583","1365","0","42.71","17.36"
"64","000","00","190","0018","0000","1715","789","926","16","1731","4091","0","42.31","19.29"
"64","000","00","190","0018","0378","540","217","323","5","545","1301","0","41.89","16.68"
"64","000","00","190","0018","0379","599","284","315","3","602","1380","0","43.62","20.58"
"64","000","00","190","0018","0380","576","288","288","8","584","1410","0","41.42","20.43"
"64","000","00","190","0019","0000","2659","1060","1599","13","2672","6810","0","39.24","15.57"
"64","000","00","190","0019","0387","456","204","252","2","458","1257","0","36.44","16.23"
"64","000","00","190","0019","0388","551","189","362","3","554","1310","0","42.29","14.43"
"64","000","00","190","0019","0389","543","231","312","2","545","1341","0","40.64","17.23"
"64","000","00","190","0019","0390","570","232","338","2","572","1421","0","40.25","16.33"
"64","000","00","190","0019","0391","539","204","335","4","543","1481","0","36.66","13.77"
"64","000","00","190","0020","0000","2311","863","1448","14","2325","5811","0","40.01","14.85"
"64","000","00","190","0020","0392","647","242","405","4","651","1569","0","41.49","15.42"
"64","000","00","190","0020","0393","655","250","405","2","657","1647","0","39.89","15.18"
"64","000","00","190","0020","0394","528","207","321","4","532","1423","0","37.39","14.55"
"64","000","00","190","0020","0395","481","164","317","4","485","1172","0","41.38","13.99"
"64","000","00","190","0021","0000","768","276","492","5","773","1862","0","41.51","14.82"
"64","000","00","190","0021","0397","403","157","246","3","406","1000","0","40.60","15.70"
"64","000","00","190","0021","0398","365","119","246","2","367","862","0","42.58","13.81"
"64","000","00","190","0022","0000","783","313","470","5","788","1933","0","40.77","16.19"
"64","000","00","190","0022","0418","387","115","272","1","388","867","0","44.75","13.26"
"64","000","00","190","0022","0419","396","198","198","4","400","1066","0","37.52","18.57"
"64","000","00","190","0023","0000","884","323","561","8","892","1850","0","48.22","17.46"
"64","000","00","190","0023","0420","385","104","281","3","388","845","0","45.92","12.31"
"64","000","00","190","0023","0421","499","219","280","5","504","1005","0","50.15","21.79"
"64","000","00","190","0024","0000","468","173","295","7","475","1048","0","45.32","16.51"
"64","000","00","190","0024","0422","468","173","295","7","475","1048","0","45.32","16.51"
"64","000","00","190","0025","0000","678","219","459","4","682","1683","0","40.52","13.01"
"64","000","00","190","0025","0399","331","103","228","3","334","821","0","40.68","12.55"
"64","000","00","190","0025","0400","347","116","231","1","348","862","0","40.37","13.46"
"64","000","00","190","0026","0000","1397","378","1019","11","1408","3339","0","42.17","11.32"
"64","000","00","190","0026","0423","440","120","320","5","445","1013","0","43.93","11.85"
"64","000","00","190","0026","0424","411","120","291","1","412","996","0","41.37","12.05"
"64","000","00","190","0026","0425","546","138","408","5","551","1330","0","41.43","10.38"
"64","000","00","190","0027","0000","774","279","495","11","785","1747","0","44.93","15.97"
"64","000","00","190","0027","0426","622","233","389","8","630","1442","0","43.69","16.16"
"64","000","00","190","0027","0427","152","46","106","3","155","305","0","50.82","15.08"
"64","000","00","190","0028","0000","749","138","611","7","756","1567","0","48.25","8.81"
"64","000","00","190","0028","0429","341","73","268","3","344","723","0","47.58","10.10"
"64","000","00","190","0028","0430","408","65","343","4","412","844","0","48.82","7.70"
"64","000","00","190","0029","0000","364","133","231","2","366","984","0","37.20","13.52"
"64","000","00","190","0029","0432","364","133","231","2","366","984","0","37.20","13.52"
"64","000","00","190","0030","0000","868","450","418","2","870","2090","0","41.63","21.53"
"64","000","00","190","0030","0415","362","184","178","0","362","875","0","41.37","21.03"
"64","000","00","190","0030","0416","506","266","240","2","508","1215","0","41.81","21.89"
"64","000","00","190","0031","0000","290","86","204","3","293","631","0","46.43","13.63"
"64","000","00","190","0031","0396","290","86","204","3","293","631","0","46.43","13.63"
"64","000","00","190","0032","0000","967","439","528","5","972","2230","0","43.59","19.69"
"64","000","00","190","0032","0403","418","163","255","3","421","954","0","44.13","17.09"
"64","000","00","190","0032","0404","549","276","273","2","551","1276","0","43.18","21.63"
"64","000","00","190","0033","0000","975","858","117","20","995","1809","0","55.00","47.43"
"64","000","00","190","0033","0436","475","426","49","14","489","887","0","55.13","48.03"
"64","000","00","190","0033","0437","500","432","68","6","506","922","0","54.88","46.85"
"64","000","00","200","0000","0000","15828","5212","10616","158","15986","34350","39528","46.54","15.17"
"64","000","00","200","0001","0000","945","356","589","6","951","2052","0","46.35","17.35"
"64","000","00","200","0001","0489","452","160","292","5","457","944","0","48.41","16.95"
"64","000","00","200","0001","0490","493","196","297","1","494","1108","0","44.58","17.69"
"64","000","00","200","0002","0000","542","174","368","4","546","1060","0","51.51","16.42"
"64","000","00","200","0002","0491","542","174","368","4","546","1060","0","51.51","16.42"
"64","000","00","200","0003","0000","1128","362","766","10","1138","2289","0","49.72","15.81"
"64","000","00","200","0003","0492","591","201","390","6","597","1211","0","49.30","16.60"
"64","000","00","200","0003","0493","537","161","376","4","541","1078","0","50.19","14.94"
"64","000","00","200","0004","0000","1253","468","785","9","1262","2597","0","48.59","18.02"
"64","000","00","200","0004","0494","637","246","391","4","641","1338","0","47.91","18.39"
"64","000","00","200","0004","0495","616","222","394","5","621","1259","0","49.32","17.63"
"64","000","00","200","0005","0000","558","171","387","4","562","1196","0","46.99","14.30"
"64","000","00","200","0005","0496","558","171","387","4","562","1196","0","46.99","14.30"
"64","000","00","200","0006","0000","1077","289","788","9","1086","2294","0","47.34","12.60"
"64","000","00","200","0006","0497","481","130","351","4","485","1025","0","47.32","12.68"
"64","000","00","200","0006","0498","596","159","437","5","601","1269","0","47.36","12.53"
"64","000","00","200","0007","0000","650","168","482","7","657","1371","0","47.92","12.25"
"64","000","00","200","0007","0499","333","75","258","4","337","668","0","50.45","11.23"
"64","000","00","200","0007","0500","317","93","224","3","320","703","0","45.52","13.23"
"64","000","00","200","0008","0000","1438","513","925","15","1453","3241","0","44.83","15.83"
"64","000","00","200","0008","0501","530","159","371","5","535","1274","0","41.99","12.48"
"64","000","00","200","0008","0502","553","203","350","4","557","1230","0","45.28","16.50"
"64","000","00","200","0008","0503","355","151","204","6","361","737","0","48.98","20.49"
"64","000","00","200","0009","0000","728","212","516","6","734","1506","0","48.74","14.08"
"64","000","00","200","0009","0504","424","115","309","5","429","918","0","46.73","12.53"
"64","000","00","200","0009","0505","304","97","207","1","305","588","0","51.87","16.50"
"64","000","00","200","0010","0000","1860","727","1133","14","1874","4359","0","42.99","16.68"
"64","000","00","200","0010","0506","407","115","292","4","411","803","0","51.18","14.32"
"64","000","00","200","0010","0507","165","42","123","5","170","334","0","50.90","12.57"
"64","000","00","200","0010","0508","527","229","298","1","528","1367","0","38.62","16.75"
"64","000","00","200","0010","0509","363","166","197","0","363","888","0","40.88","18.69"
"64","000","00","200","0010","0510","398","175","223","4","402","967","0","41.57","18.10"
"64","000","00","200","0011","0000","924","330","594","22","946","2139","0","44.23","15.43"
"64","000","00","200","0011","0511","541","182","359","16","557","1208","0","46.11","15.07"
"64","000","00","200","0011","0512","383","148","235","6","389","931","0","41.78","15.90"
"64","000","00","200","0012","0000","1067","345","722","18","1085","2401","0","45.19","14.37"
"64","000","00","200","0012","0513","519","163","356","12","531","1196","0","44.40","13.63"
"64","000","00","200","0012","0514","548","182","366","6","554","1205","0","45.98","15.10"
"64","000","00","200","0013","0000","591","191","400","6","597","1340","0","44.55","14.25"
"64","000","00","200","0013","0515","591","191","400","6","597","1340","0","44.55","14.25"
"64","000","00","200","0014","0000","283","58","225","2","285","662","0","43.05","8.76"
"64","000","00","200","0014","0516","283","58","225","2","285","662","0","43.05","8.76"
"64","000","00","200","0015","0000","1761","556","1205","18","1779","3625","0","49.08","15.34"
"64","000","00","200","0015","0517","587","175","412","8","595","1212","0","49.09","14.44"
"64","000","00","200","0015","0518","603","183","420","4","607","1234","0","49.19","14.83"
"64","000","00","200","0015","0519","571","198","373","6","577","1179","0","48.94","16.79"
"64","000","00","200","0016","0000","668","212","456","6","674","1442","0","46.74","14.70"
"64","000","00","200","0016","0520","400","130","270","4","404","816","0","49.51","15.93"
"64","000","00","200","0016","0521","268","82","186","2","270","626","0","43.13","13.10"
"64","000","00","200","0017","0000","355","80","275","2","357","776","0","46.01","10.31"
"64","000","00","200","0017","0522","355","80","275","2","357","776","0","46.01","10.31"
"64","000","00","210","0000","0000","10321","3716","6605","129","10450","25855","29312","40.42","14.37"
"64","000","00","210","0001","0000","432","129","303","3","435","1096","0","39.69","11.77"
"64","000","00","210","0001","0173","432","129","303","3","435","1096","0","39.69","11.77"
"64","000","00","210","0002","0000","912","297","615","10","922","2055","0","44.87","14.45"
"64","000","00","210","0002","0174","504","168","336","6","510","1110","0","45.95","15.14"
"64","000","00","210","0002","0175","408","129","279","4","412","945","0","43.60","13.65"
"64","000","00","210","0003","0000","1390","465","925","22","1412","3308","0","42.68","14.06"
"64","000","00","210","0003","0176","456","125","331","4","460","1011","0","45.50","12.36"
"64","000","00","210","0003","0177","424","143","281","1","425","1072","0","39.65","13.34"
"64","000","00","210","0003","0178","409","117","292","6","415","1011","0","41.05","11.57"
"64","000","00","210","0003","0179","101","80","21","11","112","214","0","52.34","37.38"
"64","000","00","210","0004","0000","1141","452","689","17","1158","2690","0","43.05","16.80"
"64","000","00","210","0004","0180","438","189","249","9","447","935","0","47.81","20.21"
"64","000","00","210","0004","0181","268","65","203","4","272","620","0","43.87","10.48"
"64","000","00","210","0004","0182","435","198","237","4","439","1135","0","38.68","17.44"
"64","000","00","210","0005","0000","1047","367","680","12","1059","2471","0","42.86","14.85"
"64","000","00","210","0005","0183","474","138","336","4","478","1097","0","43.57","12.58"
"64","000","00","210","0005","0184","573","229","344","8","581","1374","0","42.29","16.67"
"64","000","00","210","0006","0000","167","80","87","4","171","464","0","36.85","17.24"
"64","000","00","210","0006","0185","167","80","87","4","171","464","0","36.85","17.24"
"64","000","00","210","0007","0000","874","293","581","8","882","2315","0","38.10","12.66"
"64","000","00","210","0007","0186","436","132","304","4","440","1191","0","36.94","11.08"
"64","000","00","210","0007","0187","438","161","277","4","442","1124","0","39.32","14.32"
"64","000","00","210","0008","0000","1494","631","863","19","1513","3871","0","39.09","16.30"
"64","000","00","210","0008","0188","470","180","290","7","477","1131","0","42.18","15.92"
"64","000","00","210","0008","0189","504","234","270","7","511","1389","0","36.79","16.85"
"64","000","00","210","0008","0190","520","217","303","5","525","1351","0","38.86","16.06"
"64","000","00","210","0009","0000","1279","458","821","11","1290","3315","0","38.91","13.82"
"64","000","00","210","0009","0191","411","142","269","6","417","958","0","43.53","14.82"
"64","000","00","210","0009","0192","428","159","269","5","433","1081","0","40.06","14.71"
"64","000","00","210","0009","0193","440","157","283","0","440","1276","0","34.48","12.30"
"64","000","00","210","0010","0000","697","242","455","11","708","1874","0","37.78","12.91"
"64","000","00","210","0010","0194","310","94","216","5","315","763","0","41.28","12.32"
"64","000","00","210","0010","0195","387","148","239","6","393","1111","0","35.37","13.32"
"64","000","00","210","0011","0000","888","302","586","12","900","2396","0","37.56","12.60"
"64","000","00","210","0011","0196","547","184","363","6","553","1371","0","40.34","13.42"
"64","000","00","210","0011","0197","341","118","223","6","347","1025","0","33.85","11.51"
"64","000","00","220","0000","0000","2319","723","1596","38","2357","6357","6860","37.08","11.37"
"64","000","00","220","0001","0000","142","49","93","0","142","347","0","40.92","14.12"
"64","000","00","220","0001","0161","142","49","93","0","142","347","0","40.92","14.12"
"64","000","00","220","0002","0000","364","113","251","10","374","1016","0","36.81","11.12"
"64","000","00","220","0002","0162","216","81","135","3","219","637","0","34.38","12.72"
"64","000","00","220","0002","0163","148","32","116","7","155","379","0","40.90","8.44"
"64","000","00","220","0003","0000","142","30","112","1","143","364","0","39.29","8.24"
"64","000","00","220","0003","0164","142","30","112","1","143","364","0","39.29","8.24"
"64","000","00","220","0004","0000","128","34","94","1","129","364","0","35.44","9.34"
"64","000","00","220","0004","0165","128","34","94","1","129","364","0","35.44","9.34"
"64","000","00","220","0005","0000","224","56","168","3","227","594","0","38.22","9.43"
"64","000","00","220","0005","0166","224","56","168","3","227","594","0","38.22","9.43"
"64","000","00","220","0006","0000","345","146","199","3","348","914","0","38.07","15.97"
"64","000","00","220","0006","0167","345","146","199","3","348","914","0","38.07","15.97"
"64","000","00","220","0007","0000","255","94","161","6","261","777","0","33.59","12.10"
"64","000","00","220","0007","0168","255","94","161","6","261","777","0","33.59","12.10"
"64","000","00","220","0008","0000","110","41","69","2","112","333","0","33.63","12.31"
"64","000","00","220","0008","0169","110","41","69","2","112","333","0","33.63","12.31"
"64","000","00","220","0009","0000","157","41","116","5","162","484","0","33.47","8.47"
"64","000","00","220","0009","0170","157","41","116","5","162","484","0","33.47","8.47"
"64","000","00","220","0010","0000","452","119","333","7","459","1164","0","39.43","10.22"
"64","000","00","220","0010","0171","217","48","169","4","221","574","0","38.50","8.36"
"64","000","00","220","0010","0172","235","71","164","3","238","590","0","40.34","12.03"
"64","000","00","230","0000","0000","9352","3079","6273","107","9459","24309","28170","38.91","12.67"
"64","000","00","230","0001","0000","485","128","357","4","489","1283","0","38.11","9.98"
"64","000","00","230","0001","0137","485","128","357","4","489","1283","0","38.11","9.98"
"64","000","00","230","0002","0000","823","174","649","12","835","1973","0","42.32","8.82"
"64","000","00","230","0002","0138","452","94","358","5","457","1086","0","42.08","8.66"
"64","000","00","230","0002","0139","371","80","291","7","378","887","0","42.62","9.02"
"64","000","00","230","0003","0000","461","126","335","5","466","1209","0","38.54","10.42"
"64","000","00","230","0003","0140","461","126","335","5","466","1209","0","38.54","10.42"
"64","000","00","230","0004","0000","865","364","501","12","877","2122","0","41.33","17.15"
"64","000","00","230","0004","0141","289","129","160","1","290","682","0","42.52","18.91"
"64","000","00","230","0004","0142","339","144","195","6","345","876","0","39.38","16.44"
"64","000","00","230","0004","0143","237","91","146","5","242","564","0","42.91","16.13"
"64","000","00","230","0005","0000","273","103","170","6","279","761","0","36.66","13.53"
"64","000","00","230","0005","0144","273","103","170","6","279","761","0","36.66","13.53"
"64","000","00","230","0006","0000","1790","593","1197","18","1808","4888","0","36.99","12.13"
"64","000","00","230","0006","0145","456","144","312","5","461","1226","0","37.60","11.75"
"64","000","00","230","0006","0146","442","158","284","4","446","1153","0","38.68","13.70"
"64","000","00","230","0006","0147","411","126","285","3","414","1222","0","33.88","10.31"
"64","000","00","230","0006","0148","481","165","316","6","487","1287","0","37.84","12.82"
"64","000","00","230","0007","0000","953","304","649","11","964","2590","0","37.22","11.74"
"64","000","00","230","0007","0149","307","88","219","2","309","893","0","34.60","9.85"
"64","000","00","230","0007","0150","310","91","219","4","314","831","0","37.79","10.95"
"64","000","00","230","0007","0151","336","125","211","5","341","866","0","39.38","14.43"
"64","000","00","230","0008","0000","916","279","637","12","928","2291","0","40.51","12.18"
"64","000","00","230","0008","0152","424","132","292","5","429","1057","0","40.59","12.49"
"64","000","00","230","0008","0153","492","147","345","7","499","1234","0","40.44","11.91"
"64","000","00","230","0009","0000","563","218","345","4","567","1541","0","36.79","14.15"
"64","000","00","230","0009","0154","563","218","345","4","567","1541","0","36.79","14.15"
"64","000","00","230","0010","0000","630","217","413","10","640","1648","0","38.83","13.17"
"64","000","00","230","0010","0155","324","84","240","5","329","852","0","38.62","9.86"
"64","000","00","230","0010","0156","306","133","173","5","311","796","0","39.07","16.71"
"64","000","00","230","0011","0000","459","111","348","7","466","1043","0","44.68","10.64"
"64","000","00","230","0011","0157","459","111","348","7","466","1043","0","44.68","10.64"
"64","000","00","230","0012","0000","1134","462","672","6","1140","2960","0","38.51","15.61"
"64","000","00","230","0012","0158","411","150","261","0","411","1082","0","37.99","13.86"
"64","000","00","230","0012","0159","372","160","212","4","376","1054","0","35.67","15.18"
"64","000","00","230","0012","0160","351","152","199","2","353","824","0","42.84","18.45"
"64","000","00","240","0000","0000","17134","6571","10563","164","17298","43320","51490","39.93","15.17"
"64","000","00","240","0001","0000","1152","443","709","7","1159","3254","0","35.62","13.61"
"64","000","00","240","0001","0311","383","144","239","2","385","1004","0","38.35","14.34"
"64","000","00","240","0001","0312","357","111","246","2","359","1055","0","34.03","10.52"
"64","000","00","240","0001","0313","412","188","224","3","415","1195","0","34.73","15.73"
"64","000","00","240","0002","0000","469","179","290","6","475","1144","0","41.52","15.65"
"64","000","00","240","0002","0314","469","179","290","6","475","1144","0","41.52","15.65"
"64","000","00","240","0003","0000","442","167","275","7","449","1195","0","37.57","13.97"
"64","000","00","240","0003","0315","442","167","275","7","449","1195","0","37.57","13.97"
"64","000","00","240","0004","0000","433","152","281","4","437","1098","0","39.80","13.84"
"64","000","00","240","0004","0316","433","152","281","4","437","1098","0","39.80","13.84"
"64","000","00","240","0005","0000","567","191","376","7","574","1220","0","47.05","15.66"
"64","000","00","240","0005","0317","567","191","376","7","574","1220","0","47.05","15.66"
"64","000","00","240","0006","0000","897","345","552","12","909","2211","0","41.11","15.60"
"64","000","00","240","0006","0318","419","174","245","3","422","1120","0","37.68","15.54"
"64","000","00","240","0006","0319","478","171","307","9","487","1091","0","44.64","15.67"
"64","000","00","240","0007","0000","819","290","529","7","826","2084","0","39.64","13.92"
"64","000","00","240","0007","0320","408","151","257","3","411","942","0","43.63","16.03"
"64","000","00","240","0007","0321","411","139","272","4","415","1142","0","36.34","12.17"
"64","000","00","240","0008","0000","1196","531","665","15","1211","3276","0","36.97","16.21"
"64","000","00","240","0008","0322","389","166","223","2","391","1014","0","38.56","16.37"
"64","000","00","240","0008","0323","401","196","205","6","407","996","0","40.86","19.68"
"64","000","00","240","0008","0324","406","169","237","7","413","1266","0","32.62","13.35"
"64","000","00","240","0009","0000","964","316","648","12","976","2623","0","37.21","12.05"
"64","000","00","240","0009","0325","323","110","213","3","326","854","0","38.17","12.88"
"64","000","00","240","0009","0326","303","113","190","4","307","827","0","37.12","13.66"
"64","000","00","240","0009","0327","338","93","245","5","343","942","0","36.41","9.87"
"64","000","00","240","0010","0000","653","195","458","9","662","1825","0","36.27","10.68"
"64","000","00","240","0010","0328","279","94","185","4","283","787","0","35.96","11.94"
"64","000","00","240","0010","0329","374","101","273","5","379","1038","0","36.51","9.73"
"64","000","00","240","0011","0000","1383","563","820","11","1394","3439","0","40.54","16.37"
"64","000","00","240","0011","0330","373","141","232","0","373","912","0","40.90","15.46"
"64","000","00","240","0011","0331","323","138","185","4","327","717","0","45.61","19.25"
"64","000","00","240","0011","0332","330","134","196","3","333","914","0","36.43","14.66"
"64","000","00","240","0011","0333","357","150","207","4","361","896","0","40.29","16.74"
"64","000","00","240","0012","0000","871","365","506","5","876","2163","0","40.50","16.87"
"64","000","00","240","0012","0334","392","153","239","4","396","1026","0","38.60","14.91"
"64","000","00","240","0012","0335","479","212","267","1","480","1137","0","42.22","18.65"
"64","000","00","240","0013","0000","1147","411","736","10","1157","2976","0","38.88","13.81"
"64","000","00","240","0013","0336","377","127","250","1","378","952","0","39.71","13.34"
"64","000","00","240","0013","0337","417","168","249","6","423","1036","0","40.83","16.22"
"64","000","00","240","0013","0338","353","116","237","3","356","988","0","36.03","11.74"
"64","000","00","240","0014","0000","1016","416","600","7","1023","2337","0","43.77","17.80"
"64","000","00","240","0014","0339","511","197","314","5","516","1234","0","41.82","15.96"
"64","000","00","240","0014","0340","505","219","286","2","507","1103","0","45.97","19.85"
"64","000","00","240","0015","0000","357","183","174","3","360","841","0","42.81","21.76"
"64","000","00","240","0015","0341","357","183","174","3","360","841","0","42.81","21.76"
"64","000","00","240","0016","0000","772","283","489","7","779","1908","0","40.83","14.83"
"64","000","00","240","0016","0342","430","164","266","4","434","971","0","44.70","16.89"
"64","000","00","240","0016","0343","342","119","223","3","345","937","0","36.82","12.70"
"64","000","00","240","0017","0000","682","221","461","7","689","1711","0","40.27","12.92"
"64","000","00","240","0017","0344","303","102","201","1","304","823","0","36.94","12.39"
"64","000","00","240","0017","0345","379","119","260","6","385","888","0","43.36","13.40"
"64","000","00","240","0018","0000","329","111","218","4","333","846","0","39.36","13.12"
"64","000","00","240","0018","0346","329","111","218","4","333","846","0","39.36","13.12"
"64","000","00","240","0019","0000","1170","475","695","6","1176","2643","0","44.49","17.97"
"64","000","00","240","0019","0347","417","159","258","1","418","921","0","45.39","17.26"
"64","000","00","240","0019","0348","385","168","217","3","388","849","0","45.70","19.79"
"64","000","00","240","0019","0349","368","148","220","2","370","873","0","42.38","16.95"
"64","000","00","240","0020","0000","1815","734","1081","18","1833","4526","0","40.50","16.22"
"64","000","00","240","0020","0350","385","133","252","4","389","902","0","43.13","14.75"
"64","000","00","240","0020","0351","368","146","222","5","373","858","0","43.47","17.02"
"64","000","00","240","0020","0352","311","122","189","3","314","913","0","34.39","13.36"
"64","000","00","240","0020","0353","349","149","200","3","352","894","0","39.37","16.67"
"64","000","00","240","0020","0354","402","184","218","3","405","959","0","42.23","19.19"
"64","000","00","250","0000","0000","10015","3415","6600","93","10108","25813","29772","39.16","13.23"
"64","000","00","250","0001","0000","476","155","321","4","480","1070","0","44.86","14.49"
"64","000","00","250","0001","0284","476","155","321","4","480","1070","0","44.86","14.49"
"64","000","00","250","0002","0000","392","116","276","3","395","981","0","40.27","11.82"
"64","000","00","250","0002","0285","392","116","276","3","395","981","0","40.27","11.82"
"64","000","00","250","0003","0000","356","94","262","4","360","768","0","46.88","12.24"
"64","000","00","250","0003","0286","356","94","262","4","360","768","0","46.88","12.24"
"64","000","00","250","0004","0000","857","303","554","5","862","2214","0","38.93","13.69"
"64","000","00","250","0004","0287","420","143","277","4","424","1104","0","38.41","12.95"
"64","000","00","250","0004","0288","437","160","277","1","438","1110","0","39.46","14.41"
"64","000","00","250","0005","0000","1028","291","737","6","1034","2648","0","39.05","10.99"
"64","000","00","250","0005","0289","352","92","260","0","352","889","0","39.60","10.35"
"64","000","00","250","0005","0290","338","93","245","4","342","876","0","39.04","10.62"
"64","000","00","250","0005","0291","338","106","232","2","340","883","0","38.51","12.00"
"64","000","00","250","0006","0000","1438","566","872","13","1451","3677","0","39.46","15.39"
"64","000","00","250","0006","0292","319","122","197","4","323","882","0","36.62","13.83"
"64","000","00","250","0006","0293","387","122","265","3","390","914","0","42.67","13.35"
"64","000","00","250","0006","0294","379","163","216","3","382","930","0","41.08","17.53"
"64","000","00","250","0006","0295","353","159","194","3","356","951","0","37.43","16.72"
"64","000","00","250","0007","0000","402","155","247","1","403","997","0","40.42","15.55"
"64","000","00","250","0007","0296","402","155","247","1","403","997","0","40.42","15.55"
"64","000","00","250","0008","0000","1470","570","900","17","1487","3781","0","39.33","15.08"
"64","000","00","250","0008","0297","321","126","195","4","325","795","0","40.88","15.85"
"64","000","00","250","0008","0298","357","106","251","6","363","778","0","46.66","13.62"
"64","000","00","250","0008","0299","374","162","212","6","380","1059","0","35.88","15.30"
"64","000","00","250","0008","0300","418","176","242","1","419","1149","0","36.47","15.32"
"64","000","00","250","0009","0000","716","204","512","9","725","1752","0","41.38","11.64"
"64","000","00","250","0009","0301","412","110","302","3","415","913","0","45.45","12.05"
"64","000","00","250","0009","0302","304","94","210","6","310","839","0","36.95","11.20"
"64","000","00","250","0010","0000","480","146","334","5","485","1198","0","40.48","12.19"
"64","000","00","250","0010","0303","480","146","334","5","485","1198","0","40.48","12.19"
"64","000","00","250","0011","0000","765","209","556","7","772","2155","0","35.82","9.70"
"64","000","00","250","0011","0304","368","94","274","1","369","1074","0","34.36","8.75"
"64","000","00","250","0011","0305","397","115","282","6","403","1081","0","37.28","10.64"
"64","000","00","250","0012","0000","426","118","308","4","430","1133","0","37.95","10.41"
"64","000","00","250","0012","0306","426","118","308","4","430","1133","0","37.95","10.41"
"64","000","00","250","0013","0000","275","90","185","2","277","700","0","39.57","12.86"
"64","000","00","250","0013","0307","275","90","185","2","277","700","0","39.57","12.86"
"64","000","00","250","0014","0000","934","398","536","13","947","2739","0","34.57","14.53"
"64","000","00","250","0014","0308","341","151","190","7","348","935","0","37.22","16.15"
"64","000","00","250","0014","0309","328","149","179","4","332","961","0","34.55","15.50"
"64","000","00","250","0014","0310","265","98","167","2","267","843","0","31.67","11.63"
"64","000","00","260","0000","0000","9743","3235","6508","87","9830","26119","29883","37.64","12.39"
"64","000","00","260","0001","0000","420","113","307","4","424","955","0","44.40","11.83"
"64","000","00","260","0001","0260","420","113","307","4","424","955","0","44.40","11.83"
"64","000","00","260","0002","0000","333","105","228","4","337","854","0","39.46","12.30"
"64","000","00","260","0002","0261","333","105","228","4","337","854","0","39.46","12.30"
"64","000","00","260","0003","0000","684","272","412","5","689","1718","0","40.10","15.83"
"64","000","00","260","0003","0262","375","153","222","3","378","899","0","42.05","17.02"
"64","000","00","260","0003","0263","309","119","190","2","311","819","0","37.97","14.53"
"64","000","00","260","0004","0000","1452","471","981","9","1461","3784","0","38.61","12.45"
"64","000","00","260","0004","0264","411","142","269","4","415","1247","0","33.28","11.39"
"64","000","00","260","0004","0265","542","174","368","2","544","1323","0","41.12","13.15"
"64","000","00","260","0004","0266","499","155","344","3","502","1214","0","41.35","12.77"
"64","000","00","260","0005","0000","668","252","416","3","671","1771","0","37.89","14.23"
"64","000","00","260","0005","0267","340","143","197","0","340","945","0","35.98","15.13"
"64","000","00","260","0005","0268","328","109","219","3","331","826","0","40.07","13.20"
"64","000","00","260","0006","0000","419","113","306","4","423","1100","0","38.45","10.27"
"64","000","00","260","0006","0274","419","113","306","4","423","1100","0","38.45","10.27"
"64","000","00","260","0007","0000","1113","328","785","8","1121","2955","0","37.94","11.10"
"64","000","00","260","0007","0275","519","149","370","5","524","1303","0","40.21","11.44"
"64","000","00","260","0007","0276","594","179","415","3","597","1652","0","36.14","10.84"
"64","000","00","260","0008","0000","304","103","201","4","308","919","0","33.51","11.21"
"64","000","00","260","0008","0278","304","103","201","4","308","919","0","33.51","11.21"
"64","000","00","260","0009","0000","342","125","217","2","344","1060","0","32.45","11.79"
"64","000","00","260","0009","0277","342","125","217","2","344","1060","0","32.45","11.79"
"64","000","00","260","0010","0000","433","115","318","5","438","1114","0","39.32","10.32"
"64","000","00","260","0010","0279","433","115","318","5","438","1114","0","39.32","10.32"
"64","000","00","260","0011","0000","761","267","494","8","769","2061","0","37.31","12.95"
"64","000","00","260","0011","0269","301","111","190","4","305","823","0","37.06","13.49"
"64","000","00","260","0011","0270","460","156","304","4","464","1238","0","37.48","12.60"
"64","000","00","260","0012","0000","380","105","275","4","384","1067","0","35.99","9.84"
"64","000","00","260","0012","0271","380","105","275","4","384","1067","0","35.99","9.84"
"64","000","00","260","0013","0000","313","99","214","3","316","966","0","32.71","10.25"
"64","000","00","260","0013","0272","313","99","214","3","316","966","0","32.71","10.25"
"64","000","00","260","0014","0000","457","143","314","4","461","1116","0","41.31","12.81"
"64","000","00","260","0014","0273","457","143","314","4","461","1116","0","41.31","12.81"
"64","000","00","260","0015","0000","1664","624","1040","20","1684","4679","0","35.99","13.34"
"64","000","00","260","0015","0280","425","183","242","9","434","1073","0","40.45","17.05"
"64","000","00","260","0015","0281","425","155","270","9","434","1133","0","38.31","13.68"
"64","000","00","260","0015","0282","372","130","242","1","373","1135","0","32.86","11.45"
"64","000","00","260","0015","0283","442","156","286","1","443","1338","0","33.11","11.66"
"64","000","00","270","0000","0000","4593","1694","2899","43","4636","11982","13609","38.69","14.14"
"64","000","00","270","0001","0000","635","259","376","7","642","1558","0","41.21","16.62"
"64","000","00","270","0001","0355","335","135","200","3","338","751","0","45.01","17.98"
"64","000","00","270","0001","0356","300","124","176","4","304","807","0","37.67","15.37"
"64","000","00","270","0002","0000","734","275","459","7","741","1799","0","41.19","15.29"
"64","000","00","270","0002","0357","375","139","236","6","381","849","0","44.88","16.37"
"64","000","00","270","0002","0358","359","136","223","1","360","950","0","37.89","14.32"
"64","000","00","270","0003","0000","883","299","584","9","892","2291","0","38.93","13.05"
"64","000","00","270","0003","0359","319","102","217","3","322","818","0","39.36","12.47"
"64","000","00","270","0003","0360","314","89","225","3","317","832","0","38.10","10.70"
"64","000","00","270","0003","0361","250","108","142","3","253","641","0","39.47","16.85"
"64","000","00","270","0004","0000","141","36","105","1","142","374","0","37.97","9.63"
"64","000","00","270","0004","0362","141","36","105","1","142","374","0","37.97","9.63"
"64","000","00","270","0005","0000","945","390","555","8","953","2564","0","37.17","15.21"
"64","000","00","270","0005","0363","492","209","283","5","497","1343","0","37.01","15.56"
"64","000","00","270","0005","0364","453","181","272","3","456","1221","0","37.35","14.82"
"64","000","00","270","0006","0000","1255","435","820","11","1266","3396","0","37.28","12.81"
"64","000","00","270","0006","0365","442","123","319","6","448","1137","0","39.40","10.82"
"64","000","00","270","0006","0366","404","127","277","1","405","1085","0","37.33","11.71"
"64","000","00","270","0006","0367","409","185","224","4","413","1174","0","35.18","15.76"
"64","000","00","280","0000","0000","6559","2622","3937","85","6644","16271","18759","40.83","16.11"
"64","000","00","280","0001","0000","498","162","336","7","505","1250","0","40.40","12.96"
"64","000","00","280","0001","0441","498","162","336","7","505","1250","0","40.40","12.96"
"64","000","00","280","0002","0000","777","293","484","10","787","1846","0","42.63","15.87"
"64","000","00","280","0002","0442","397","153","244","4","401","893","0","44.90","17.13"
"64","000","00","280","0002","0443","380","140","240","6","386","953","0","40.50","14.69"
"64","000","00","280","0003","0000","212","100","112","3","215","533","0","40.34","18.76"
"64","000","00","280","0003","0444","212","100","112","3","215","533","0","40.34","18.76"
"64","000","00","280","0004","0000","342","161","181","3","345","738","0","46.75","21.82"
"64","000","00","280","0004","0445","342","161","181","3","345","738","0","46.75","21.82"
"64","000","00","280","0005","0000","730","320","410","13","743","1710","0","43.45","18.71"
"64","000","00","280","0005","0446","357","168","189","8","365","815","0","44.79","20.61"
"64","000","00","280","0005","0447","373","152","221","5","378","895","0","42.23","16.98"
"64","000","00","280","0006","0000","619","230","389","10","629","1565","0","40.19","14.70"
"64","000","00","280","0006","0448","299","110","189","4","303","761","0","39.82","14.45"
"64","000","00","280","0006","0449","320","120","200","6","326","804","0","40.55","14.93"
"64","000","00","280","0007","0000","672","246","426","9","681","1681","0","40.51","14.63"
"64","000","00","280","0007","0450","340","125","215","2","342","858","0","39.86","14.57"
"64","000","00","280","0007","0451","332","121","211","7","339","823","0","41.19","14.70"
"64","000","00","280","0008","0000","807","308","499","3","810","2007","0","40.36","15.35"
"64","000","00","280","0008","0453","403","143","260","3","406","1000","0","40.60","14.30"
"64","000","00","280","0008","0454","404","165","239","0","404","1007","0","40.12","16.39"
"64","000","00","280","0009","0000","358","136","222","6","364","918","0","39.65","14.81"
"64","000","00","280","0009","0452","358","136","222","6","364","918","0","39.65","14.81"
"64","000","00","280","0010","0000","292","123","169","5","297","804","0","36.94","15.30"
"64","000","00","280","0010","0455","292","123","169","5","297","804","0","36.94","15.30"
"64","000","00","280","0011","0000","453","227","226","5","458","1134","0","40.39","20.02"
"64","000","00","280","0011","0456","453","227","226","5","458","1134","0","40.39","20.02"
"64","000","00","280","0012","0000","799","316","483","11","810","2085","0","38.85","15.16"
"64","000","00","280","0012","0457","477","206","271","8","485","1228","0","39.50","16.78"
"64","000","00","280","0012","0458","322","110","212","3","325","857","0","37.92","12.84"
"64","000","00","290","0000","0000","12969","4121","8848","122","13091","30908","35292","42.35","13.33"
"64","000","00","290","0001","0000","914","256","658","2","916","2095","0","43.72","12.22"
"64","000","00","290","0001","0459","441","120","321","1","442","1053","0","41.98","11.40"
"64","000","00","290","0001","0460","473","136","337","1","474","1042","0","45.49","13.05"
"64","000","00","290","0002","0000","825","261","564","5","830","2030","0","40.89","12.86"
"64","000","00","290","0002","0461","400","114","286","2","402","942","0","42.68","12.10"
"64","000","00","290","0002","0462","425","147","278","3","428","1088","0","39.34","13.51"
"64","000","00","290","0003","0000","1090","334","756","9","1099","2213","0","49.66","15.09"
"64","000","00","290","0003","0463","386","124","262","4","390","814","0","47.91","15.23"
"64","000","00","290","0003","0464","310","88","222","0","310","632","0","49.05","13.92"
"64","000","00","290","0003","0465","394","122","272","5","399","767","0","52.02","15.91"
"64","000","00","290","0004","0000","660","184","476","10","670","1476","0","45.39","12.47"
"64","000","00","290","0004","0466","660","184","476","10","670","1476","0","45.39","12.47"
"64","000","00","290","0005","0000","560","184","376","3","563","1154","0","48.79","15.94"
"64","000","00","290","0005","0467","560","184","376","3","563","1154","0","48.79","15.94"
"64","000","00","290","0006","0000","763","224","539","11","774","1791","0","43.22","12.51"
"64","000","00","290","0006","0472","466","147","319","7","473","1102","0","42.92","13.34"
"64","000","00","290","0006","0473","297","77","220","4","301","689","0","43.69","11.18"
"64","000","00","290","0007","0000","800","201","599","6","806","2055","0","39.22","9.78"
"64","000","00","290","0007","0477","411","94","317","2","413","1033","0","39.98","9.10"
"64","000","00","290","0007","0478","389","107","282","4","393","1022","0","38.45","10.47"
"64","000","00","290","0008","0000","1121","376","745","9","1130","2858","0","39.54","13.16"
"64","000","00","290","0008","0479","442","109","333","3","445","1216","0","36.60","8.96"
"64","000","00","290","0008","0480","312","101","211","5","317","787","0","40.28","12.83"
"64","000","00","290","0008","0481","367","166","201","1","368","855","0","43.04","19.42"
"64","000","00","290","0009","0000","873","312","561","9","882","2313","0","38.13","13.49"
"64","000","00","290","0009","0482","282","103","179","2","284","814","0","34.89","12.65"
"64","000","00","290","0009","0483","591","209","382","7","598","1499","0","39.89","13.94"
"64","000","00","290","0010","0000","384","133","251","5","389","970","0","40.10","13.71"
"64","000","00","290","0010","0468","384","133","251","5","389","970","0","40.10","13.71"
"64","000","00","290","0011","0000","1524","472","1052","18","1542","3701","0","41.66","12.75"
"64","000","00","290","0011","0469","581","162","419","9","590","1353","0","43.61","11.97"
"64","000","00","290","0011","0470","520","175","345","2","522","1270","0","41.10","13.78"
"64","000","00","290","0011","0471","423","135","288","7","430","1078","0","39.89","12.52"
"64","000","00","290","0012","0000","910","265","645","7","917","2221","0","41.29","11.93"
"64","000","00","290","0012","0474","507","141","366","4","511","1290","0","39.61","10.93"
"64","000","00","290","0012","0475","403","124","279","3","406","931","0","43.61","13.32"
"64","000","00","290","0013","0000","339","127","212","8","347","801","0","43.32","15.86"
"64","000","00","290","0013","0476","339","127","212","8","347","801","0","43.32","15.86"
"64","000","00","290","0014","0000","907","309","598","8","915","2258","0","40.52","13.68"
"64","000","00","290","0014","0484","516","178","338","3","519","1142","0","45.45","15.59"
"64","000","00","290","0014","0485","391","131","260","5","396","1116","0","35.48","11.74"
"64","000","00","290","0015","0000","1299","483","816","12","1311","2972","0","44.11","16.25"
"64","000","00","290","0015","0486","541","164","377","3","544","1230","0","44.23","13.33"
"64","000","00","290","0015","0487","312","80","232","5","317","764","0","41.49","10.47"
"64","000","00","290","0015","0488","446","239","207","4","450","978","0","46.01","24.44"
"64","000","00","300","0000","0000","11712","4464","7248","163","11875","31152","35449","38.12","14.33"
"64","000","00","300","0001","0000","833","349","484","8","841","2165","0","38.85","16.12"
"64","000","00","300","0001","0064","458","187","271","1","459","1066","0","43.06","17.54"
"64","000","00","300","0001","0065","375","162","213","7","382","1099","0","34.76","14.74"
"64","000","00","300","0002","0000","920","427","493","11","931","2273","0","40.96","18.79"
"64","000","00","300","0002","0066","412","196","216","3","415","1071","0","38.75","18.30"
"64","000","00","300","0002","0067","508","231","277","8","516","1202","0","42.93","19.22"
"64","000","00","300","0003","0000","580","212","368","5","585","1578","0","37.07","13.43"
"64","000","00","300","0003","0068","305","120","185","3","308","874","0","35.24","13.73"
"64","000","00","300","0003","0069","275","92","183","2","277","704","0","39.35","13.07"
"64","000","00","300","0004","0000","584","231","353","11","595","1802","0","33.02","12.82"
"64","000","00","300","0004","0070","358","134","224","8","366","1071","0","34.17","12.51"
"64","000","00","300","0004","0071","226","97","129","3","229","731","0","31.33","13.27"
"64","000","00","300","0005","0000","455","215","240","5","460","1418","0","32.44","15.16"
"64","000","00","300","0005","0072","340","133","207","2","342","1075","0","31.81","12.37"
"64","000","00","300","0005","0073","115","82","33","3","118","343","0","34.40","23.91"
"64","000","00","300","0006","0000","413","190","223","8","421","1338","0","31.46","14.20"
"64","000","00","300","0006","0074","254","94","160","6","260","840","0","30.95","11.19"
"64","000","00","300","0006","0075","159","96","63","2","161","498","0","32.33","19.28"
"64","000","00","300","0007","0000","382","91","291","5","387","1008","0","38.39","9.03"
"64","000","00","300","0007","0076","382","91","291","5","387","1008","0","38.39","9.03"
"64","000","00","300","0008","0000","319","122","197","7","326","759","0","42.95","16.07"
"64","000","00","300","0008","0077","319","122","197","7","326","759","0","42.95","16.07"
"64","000","00","300","0009","0000","839","256","583","15","854","2092","0","40.82","12.24"
"64","000","00","300","0009","0078","395","124","271","8","403","917","0","43.95","13.52"
"64","000","00","300","0009","0079","444","132","312","7","451","1175","0","38.38","11.23"
"64","000","00","300","0010","0000","66","19","47","2","68","179","0","37.99","10.61"
"64","000","00","300","0010","0080","66","19","47","2","68","179","0","37.99","10.61"
"64","000","00","300","0011","0000","804","321","483","13","817","1924","0","42.46","16.68"
"64","000","00","300","0011","0082","398","178","220","6","404","926","0","43.63","19.22"
"64","000","00","300","0011","0083","406","143","263","7","413","998","0","41.38","14.33"
"64","000","00","300","0012","0000","389","183","206","3","392","983","0","39.88","18.62"
"64","000","00","300","0012","0081","389","183","206","3","392","983","0","39.88","18.62"
"64","000","00","300","0013","0000","572","250","322","5","577","1544","0","37.37","16.19"
"64","000","00","300","0013","0084","337","140","197","3","340","876","0","38.81","15.98"
"64","000","00","300","0013","0085","235","110","125","2","237","668","0","35.48","16.47"
"64","000","00","300","0014","0000","754","284","470","7","761","1999","0","38.07","14.21"
"64","000","00","300","0014","0086","365","118","247","1","366","943","0","38.81","12.51"
"64","000","00","300","0014","0087","389","166","223","6","395","1056","0","37.41","15.72"
"64","000","00","300","0015","0000","1105","397","708","15","1120","3245","0","34.51","12.23"
"64","000","00","300","0015","0088","418","143","275","7","425","1085","0","39.17","13.18"
"64","000","00","300","0015","0089","312","133","179","3","315","1056","0","29.83","12.59"
"64","000","00","300","0015","0090","375","121","254","5","380","1104","0","34.42","10.96"
"64","000","00","300","0016","0000","832","329","503","7","839","2216","0","37.86","14.85"
"64","000","00","300","0016","0091","346","168","178","3","349","949","0","36.78","17.70"
"64","000","00","300","0016","0092","238","95","143","3","241","608","0","39.64","15.63"
"64","000","00","300","0016","0093","248","66","182","1","249","659","0","37.78","10.02"
"64","000","00","300","0017","0000","322","63","259","6","328","705","0","46.52","8.94"
"64","000","00","300","0017","0094","322","63","259","6","328","705","0","46.52","8.94"
"64","000","00","300","0018","0000","481","148","333","6","487","1254","0","38.84","11.80"
"64","000","00","300","0018","0095","481","148","333","6","487","1254","0","38.84","11.80"
"64","000","00","300","0019","0000","324","87","237","6","330","797","0","41.41","10.92"
"64","000","00","300","0019","0096","324","87","237","6","330","797","0","41.41","10.92"
"64","000","00","300","0020","0000","518","171","347","12","530","1262","0","42.00","13.55"
"64","000","00","300","0020","0097","518","171","347","12","530","1262","0","42.00","13.55"
"64","000","00","300","0021","0000","220","119","101","6","226","611","0","36.99","19.48"
"64","000","00","300","0021","0098","220","119","101","6","226","611","0","36.99","19.48"
"64","000","00","310","0000","0000","12613","6097","6516","152","12765","34303","38209","37.21","17.77"
"64","000","00","310","0001","0000","982","456","526","12","994","2547","0","39.03","17.90"
"64","000","00","310","0001","0099","464","222","242","5","469","1141","0","41.10","19.46"
"64","000","00","310","0001","0100","231","110","121","4","235","689","0","34.11","15.97"
"64","000","00","310","0001","0101","287","124","163","3","290","717","0","40.45","17.29"
"64","000","00","310","0002","0000","832","445","387","10","842","2321","0","36.28","19.17"
"64","000","00","310","0002","0102","356","183","173","5","361","958","0","37.68","19.10"
"64","000","00","310","0002","0103","240","124","116","1","241","655","0","36.79","18.93"
"64","000","00","310","0002","0104","236","138","98","4","240","708","0","33.90","19.49"
"64","000","00","310","0003","0000","966","499","467","17","983","2552","0","38.52","19.55"
"64","000","00","310","0003","0105","477","234","243","11","488","1295","0","37.68","18.07"
"64","000","00","310","0003","0106","489","265","224","6","495","1257","0","39.38","21.08"
"64","000","00","310","0004","0000","699","374","325","7","706","1978","0","35.69","18.91"
"64","000","00","310","0004","0107","344","189","155","3","347","968","0","35.85","19.52"
"64","000","00","310","0004","0108","355","185","170","4","359","1010","0","35.54","18.32"
"64","000","00","310","0005","0000","539","323","216","7","546","1462","0","37.35","22.09"
"64","000","00","310","0005","0109","539","323","216","7","546","1462","0","37.35","22.09"
"64","000","00","310","0006","0000","686","342","344","13","699","2113","0","33.08","16.19"
"64","000","00","310","0006","0110","355","177","178","9","364","1105","0","32.94","16.02"
"64","000","00","310","0006","0111","331","165","166","4","335","1008","0","33.23","16.37"
"64","000","00","310","0007","0000","959","427","532","10","969","2433","0","39.83","17.55"
"64","000","00","310","0007","0112","542","220","322","7","549","1428","0","38.45","15.41"
"64","000","00","310","0007","0113","417","207","210","3","420","1005","0","41.79","20.60"
"64","000","00","310","0008","0000","531","254","277","6","537","1382","0","38.86","18.38"
"64","000","00","310","0008","0114","274","138","136","3","277","646","0","42.88","21.36"
"64","000","00","310","0008","0115","257","116","141","3","260","736","0","35.33","15.76"
"64","000","00","310","0009","0000","464","203","261","9","473","1299","0","36.41","15.63"
"64","000","00","310","0009","0116","464","203","261","9","473","1299","0","36.41","15.63"
"64","000","00","310","0010","0000","426","176","250","6","432","1158","0","37.31","15.20"
"64","000","00","310","0010","0117","426","176","250","6","432","1158","0","37.31","15.20"
"64","000","00","310","0011","0000","756","398","358","8","764","2066","0","36.98","19.26"
"64","000","00","310","0011","0118","344","161","183","3","347","880","0","39.43","18.30"
"64","000","00","310","0011","0119","412","237","175","5","417","1186","0","35.16","19.98"
"64","000","00","310","0012","0000","428","186","242","3","431","1184","0","36.40","15.71"
"64","000","00","310","0012","0120","428","186","242","3","431","1184","0","36.40","15.71"
"64","000","00","310","0013","0000","610","321","289","5","615","1527","0","40.28","21.02"
"64","000","00","310","0013","0121","276","128","148","3","279","718","0","38.86","17.83"
"64","000","00","310","0013","0122","334","193","141","2","336","809","0","41.53","23.86"
"64","000","00","310","0014","0000","791","372","419","5","796","2186","0","36.41","17.02"
"64","000","00","310","0014","0123","368","163","205","0","368","1066","0","34.52","15.29"
"64","000","00","310","0014","0124","423","209","214","5","428","1120","0","38.21","18.66"
"64","000","00","310","0015","0000","661","317","344","4","665","1720","0","38.66","18.43"
"64","000","00","310","0015","0125","334","163","171","4","338","944","0","35.81","17.27"
"64","000","00","310","0015","0126","327","154","173","0","327","776","0","42.14","19.85"
"64","000","00","310","0016","0000","686","308","378","5","691","1826","0","37.84","16.87"
"64","000","00","310","0016","0127","322","151","171","4","326","918","0","35.51","16.45"
"64","000","00","310","0016","0128","364","157","207","1","365","908","0","40.20","17.29"
"64","000","00","310","0017","0000","497","253","244","5","502","1334","0","37.63","18.97"
"64","000","00","310","0017","0129","497","253","244","5","502","1334","0","37.63","18.97"
"64","000","00","310","0018","0000","589","217","372","9","598","1779","0","33.61","12.20"
"64","000","00","310","0018","0130","309","122","187","3","312","903","0","34.55","13.51"
"64","000","00","310","0018","0131","280","95","185","6","286","876","0","32.65","10.84"
"64","000","00","310","0019","0000","511","226","285","11","522","1436","0","36.35","15.74"
"64","000","00","310","0019","0132","296","135","161","9","305","782","0","39.00","17.26"
"64","000","00","310","0019","0133","215","91","124","2","217","654","0","33.18","13.91"
"64","000","00","320","0000","0000","3211","1257","1954","61","3272","10933","12236","29.93","11.50"
"64","000","00","320","0001","0000","227","80","147","5","232","714","0","32.49","11.20"
"64","000","00","320","0001","0021","227","80","147","5","232","714","0","32.49","11.20"
"64","000","00","320","0002","0000","193","63","130","2","195","649","0","30.05","9.71"
"64","000","00","320","0002","0022","193","63","130","2","195","649","0","30.05","9.71"
"64","000","00","320","0003","0000","238","83","155","4","242","626","0","38.66","13.26"
"64","000","00","320","0003","0023","238","83","155","4","242","626","0","38.66","13.26"
"64","000","00","320","0004","0000","220","83","137","6","226","926","0","24.41","8.96"
"64","000","00","320","0004","0024","220","83","137","6","226","926","0","24.41","8.96"
"64","000","00","320","0005","0000","328","113","215","6","334","1359","0","24.58","8.31"
"64","000","00","320","0005","0025","328","113","215","6","334","1359","0","24.58","8.31"
"64","000","00","320","0006","0000","234","79","155","8","242","942","0","25.69","8.39"
"64","000","00","320","0006","0026","234","79","155","8","242","942","0","25.69","8.39"
"64","000","00","320","0007","0000","351","151","200","4","355","1029","0","34.50","14.67"
"64","000","00","320","0007","0027","351","151","200","4","355","1029","0","34.50","14.67"
"64","000","00","320","0008","0000","223","64","159","4","227","785","0","28.92","8.15"
"64","000","00","320","0008","0028","223","64","159","4","227","785","0","28.92","8.15"
"64","000","00","320","0009","0000","460","247","213","10","470","1363","0","34.48","18.12"
"64","000","00","320","0009","0029","460","247","213","10","470","1363","0","34.48","18.12"
"64","000","00","320","0010","0000","244","100","144","2","246","858","0","28.67","11.66"
"64","000","00","320","0010","0030","244","100","144","2","246","858","0","28.67","11.66"
"64","000","00","320","0011","0000","369","149","220","8","377","1379","0","27.34","10.80"
"64","000","00","320","0011","0031","369","149","220","8","377","1379","0","27.34","10.80"
"64","000","00","320","0012","0000","124","45","79","2","126","303","0","41.58","14.85"
"64","000","00","320","0012","0032","124","45","79","2","126","303","0","41.58","14.85"
"64","000","00","330","0000","0000","1684","841","843","27","1711","5257","5798","32.55","16.00"
"64","000","00","330","0001","0000","109","56","53","3","112","445","0","25.17","12.58"
"64","000","00","330","0001","0013","109","56","53","3","112","445","0","25.17","12.58"
"64","000","00","330","0002","0000","353","230","123","3","356","835","0","42.63","27.54"
"64","000","00","330","0002","0014","353","230","123","3","356","835","0","42.63","27.54"
"64","000","00","330","0003","0000","233","143","90","1","234","668","0","35.03","21.41"
"64","000","00","330","0003","0015","233","143","90","1","234","668","0","35.03","21.41"
"64","000","00","330","0004","0000","439","205","234","9","448","1557","0","28.77","13.17"
"64","000","00","330","0004","0016","168","60","108","5","173","657","0","26.33","9.13"
"64","000","00","330","0004","0017","271","145","126","4","275","900","0","30.56","16.11"
"64","000","00","330","0005","0000","221","69","152","4","225","651","0","34.56","10.60"
"64","000","00","330","0005","0018","221","69","152","4","225","651","0","34.56","10.60"
"64","000","00","330","0006","0000","199","79","120","5","204","587","0","34.75","13.46"
"64","000","00","330","0006","0019","199","79","120","5","204","587","0","34.75","13.46"
"64","000","00","330","0007","0000","130","59","71","2","132","514","0","25.68","11.48"
"64","000","00","330","0007","0020","130","59","71","2","132","514","0","25.68","11.48"
"64","000","00","340","0000","0000","3037","1285","1752","53","3090","10258","11365","30.12","12.53"
"64","000","00","340","0001","0000","167","53","114","2","169","597","0","28.31","8.88"
"64","000","00","340","0001","0033","167","53","114","2","169","597","0","28.31","8.88"
"64","000","00","340","0002","0000","156","50","106","2","158","655","0","24.12","7.63"
"64","000","00","340","0002","0034","156","50","106","2","158","655","0","24.12","7.63"
"64","000","00","340","0003","0000","327","102","225","2","329","1230","0","26.75","8.29"
"64","000","00","340","0003","0035","327","102","225","2","329","1230","0","26.75","8.29"
"64","000","00","340","0004","0000","476","221","255","13","489","1464","0","33.40","15.10"
"64","000","00","340","0004","0036","296","164","132","6","302","984","0","30.69","16.67"
"64","000","00","340","0004","0037","180","57","123","7","187","480","0","38.96","11.88"
"64","000","00","340","0005","0000","463","217","246","9","472","1537","0","30.71","14.12"
"64","000","00","340","0005","0038","310","163","147","7","317","975","0","32.51","16.72"
"64","000","00","340","0005","0039","153","54","99","2","155","562","0","27.58","9.61"
"64","000","00","340","0006","0000","550","276","274","8","558","1603","0","34.81","17.22"
"64","000","00","340","0006","0040","367","211","156","6","373","996","0","37.45","21.18"
"64","000","00","340","0006","0041","183","65","118","2","185","607","0","30.48","10.71"
"64","000","00","340","0007","0000","382","153","229","10","392","1207","0","32.48","12.68"
"64","000","00","340","0007","0044","382","153","229","10","392","1207","0","32.48","12.68"
"64","000","00","340","0008","0000","516","213","303","7","523","1965","0","26.62","10.84"
"64","000","00","340","0008","0042","306","92","214","5","311","979","0","31.77","9.40"
"64","000","00","340","0008","0043","210","121","89","2","212","986","0","21.50","12.27"
"64","000","00","350","0000","0000","3940","1570","2370","63","4003","12595","13870","31.78","12.47"
"64","000","00","350","0001","0000","245","90","155","4","249","931","0","26.75","9.67"
"64","000","00","350","0001","0045","245","90","155","4","249","931","0","26.75","9.67"
"64","000","00","350","0002","0000","203","67","136","6","209","627","0","33.33","10.69"
"64","000","00","350","0002","0046","203","67","136","6","209","627","0","33.33","10.69"
"64","000","00","350","0003","0000","284","117","167","8","292","955","0","30.58","12.25"
"64","000","00","350","0003","0047","284","117","167","8","292","955","0","30.58","12.25"
"64","000","00","350","0004","0000","119","55","64","1","120","413","0","29.06","13.32"
"64","000","00","350","0004","0048","119","55","64","1","120","413","0","29.06","13.32"
"64","000","00","350","0005","0000","119","46","73","2","121","384","0","31.51","11.98"
"64","000","00","350","0005","0049","119","46","73","2","121","384","0","31.51","11.98"
"64","000","00","350","0006","0000","118","46","72","0","118","493","0","23.94","9.33"
"64","000","00","350","0006","0050","118","46","72","0","118","493","0","23.94","9.33"
"64","000","00","350","0007","0000","363","166","197","5","368","963","0","38.21","17.24"
"64","000","00","350","0007","0051","363","166","197","5","368","963","0","38.21","17.24"
"64","000","00","350","0008","0000","365","138","227","4","369","1176","0","31.38","11.73"
"64","000","00","350","0008","0052","365","138","227","4","369","1176","0","31.38","11.73"
"64","000","00","350","0009","0000","560","252","308","7","567","1682","0","33.71","14.98"
"64","000","00","350","0009","0053","267","114","153","3","270","822","0","32.85","13.87"
"64","000","00","350","0009","0054","293","138","155","4","297","860","0","34.53","16.05"
"64","000","00","350","0010","0000","177","106","71","0","177","537","0","32.96","19.74"
"64","000","00","350","0010","0055","177","106","71","0","177","537","0","32.96","19.74"
"64","000","00","350","0011","0000","280","103","177","5","285","765","0","37.25","13.46"
"64","000","00","350","0011","0056","280","103","177","5","285","765","0","37.25","13.46"
"64","000","00","350","0012","0000","101","42","59","2","103","403","0","25.56","10.42"
"64","000","00","350","0012","0057","101","42","59","2","103","403","0","25.56","10.42"
"64","000","00","350","0013","0000","150","53","97","2","152","474","0","32.07","11.18"
"64","000","00","350","0013","0058","150","53","97","2","152","474","0","32.07","11.18"
"64","000","00","350","0014","0000","196","69","127","5","201","638","0","31.50","10.82"
"64","000","00","350","0014","0059","196","69","127","5","201","638","0","31.50","10.82"
"64","000","00","350","0015","0000","184","52","132","4","188","589","0","31.92","8.83"
"64","000","00","350","0015","0060","184","52","132","4","188","589","0","31.92","8.83"
"64","000","00","350","0016","0000","165","26","139","3","168","602","0","27.91","4.32"
"64","000","00","350","0016","0061","165","26","139","3","168","602","0","27.91","4.32"
"64","000","00","350","0017","0000","118","60","58","4","122","318","0","38.36","18.87"
"64","000","00","350","0017","0062","118","60","58","4","122","318","0","38.36","18.87"
"64","000","00","350","0018","0000","193","82","111","1","194","645","0","30.08","12.71"
"64","000","00","350","0018","0063","193","82","111","1","194","645","0","30.08","12.71"
"64","000","00","360","0000","0000","505","394","111","7","512","1559","1879","32.84","25.27"
"64","000","00","360","0001","0000","225","178","47","1","226","712","0","31.74","25.00"
"64","000","00","360","0001","0136","225","178","47","1","226","712","0","31.74","25.00"
"64","000","00","360","0002","0000","133","93","40","3","136","356","0","38.20","26.12"
"64","000","00","360","0002","0135","133","93","40","3","136","356","0","38.20","26.12"
"64","000","00","360","0003","0000","147","123","24","3","150","491","0","30.55","25.05"
"64","000","00","360","0003","0134","147","123","24","3","150","491","0","30.55","25.05"
"64","000","00","370","0000","0000","722","551","171","14","736","3415","4205","21.55","16.13"
"64","000","00","370","0001","0000","143","119","24","3","146","766","0","19.06","15.54"
"64","000","00","370","0001","0005","143","119","24","3","146","766","0","19.06","15.54"
"64","000","00","370","0002","0000","100","81","19","5","105","458","0","22.93","17.69"
"64","000","00","370","0002","0008","100","81","19","5","105","458","0","22.93","17.69"
"64","000","00","370","0003","0000","98","67","31","2","100","587","0","17.04","11.41"
"64","000","00","370","0003","0007","98","67","31","2","100","587","0","17.04","11.41"
"64","000","00","370","0004","0000","133","105","28","0","133","620","0","21.45","16.94"
"64","000","00","370","0004","0006","133","105","28","0","133","620","0","21.45","16.94"
"64","000","00","370","0005","0000","45","30","15","1","46","212","0","21.70","14.15"
"64","000","00","370","0005","0004","45","30","15","1","46","212","0","21.70","14.15"
"64","000","00","370","0006","0000","61","57","4","1","62","287","0","21.60","19.86"
"64","000","00","370","0006","0003","61","57","4","1","62","287","0","21.60","19.86"
"64","000","00","370","0007","0000","71","40","31","1","72","230","0","31.30","17.39"
"64","000","00","370","0007","0002","71","40","31","1","72","230","0","31.30","17.39"
"64","000","00","370","0008","0000","71","52","19","1","72","255","0","28.24","20.39"
"64","000","00","370","0008","0001","71","52","19","1","72","255","0","28.24","20.39"
"64","000","00","380","0000","0000","689","517","172","5","694","2427","3141","28.59","21.30"
"64","000","00","380","0001","0000","335","271","64","4","339","1343","0","25.24","20.18"
"64","000","00","380","0001","0009","178","150","28","1","179","747","0","23.96","20.08"
"64","000","00","380","0001","0010","157","121","36","3","160","596","0","26.85","20.30"
"64","000","00","380","0002","0000","202","174","28","0","202","602","0","33.55","28.90"
"64","000","00","380","0002","0011","202","174","28","0","202","602","0","33.55","28.90"
"64","000","00","380","0003","0000","152","72","80","1","153","482","0","31.74","14.94"
"64","000","00","380","0003","0012","152","72","80","1","153","482","0","31.74","14.94"
"10","004","00","000","0000","0000","178112","111253","66859","1798","179910","461638","573385","38.97","24.10"
"10","004","00","010","0000","0000","62574","35737","26837","527","63101","150431","203904","41.95","23.76"
"10","004","00","010","0001","0000","3000","1734","1266","14","3014","6791","0","44.38","25.53"
"10","004","00","010","0001","0053","594","338","256","3","597","1344","0","44.42","25.15"
"10","004","00","010","0001","0054","554","310","244","0","554","1272","0","43.55","24.37"
"10","004","00","010","0001","0055","605","356","249","6","611","1269","0","48.15","28.05"
"10","004","00","010","0001","0056","585","352","233","2","587","1290","0","45.50","27.29"
"10","004","00","010","0001","0057","662","378","284","3","665","1616","0","41.15","23.39"
"10","004","00","010","0002","0000","4848","2750","2098","36","4884","10611","0","46.03","25.92"
"10","004","00","010","0002","0001","589","342","247","5","594","1244","0","47.75","27.49"
"10","004","00","010","0002","0002","564","316","248","5","569","1275","0","44.63","24.78"
"10","004","00","010","0002","0003","564","357","207","4","568","1289","0","44.07","27.70"
"10","004","00","010","0002","0004","629","360","269","2","631","1292","0","48.84","27.86"
"10","004","00","010","0002","0005","568","318","250","2","570","1324","0","43.05","24.02"
"10","004","00","010","0002","0006","615","356","259","9","624","1357","0","45.98","26.23"
"10","004","00","010","0002","0007","726","376","350","3","729","1480","0","49.26","25.41"
"10","004","00","010","0002","0008","593","325","268","6","599","1350","0","44.37","24.07"
"10","004","00","010","0003","0000","5440","2833","2607","39","5479","11738","0","46.68","24.14"
"10","004","00","010","0003","0009","510","267","243","9","519","1107","0","46.88","24.12"
"10","004","00","010","0003","0010","566","319","247","4","570","1201","0","47.46","26.56"
"10","004","00","010","0003","0011","542","289","253","3","545","1187","0","45.91","24.35"
"10","004","00","010","0003","0012","500","260","240","1","501","1133","0","44.22","22.95"
"10","004","00","010","0003","0013","536","298","238","6","542","1215","0","44.61","24.53"
"10","004","00","010","0003","0014","624","325","299","3","627","1324","0","47.36","24.55"
"10","004","00","010","0003","0015","577","283","294","5","582","1205","0","48.30","23.49"
"10","004","00","010","0003","0016","590","297","293","1","591","1193","0","49.54","24.90"
"10","004","00","010","0003","0017","481","243","238","5","486","1023","0","47.51","23.75"
"10","004","00","010","0003","0018","514","252","262","2","516","1150","0","44.87","21.91"
"10","004","00","010","0004","0000","3796","2091","1705","31","3827","8015","0","47.75","26.09"
"10","004","00","010","0004","0019","668","348","320","5","673","1490","0","45.17","23.36"
"10","004","00","010","0004","0020","613","340","273","4","617","1251","0","49.32","27.18"
"10","004","00","010","0004","0021","700","383","317","4","704","1430","0","49.23","26.78"
"10","004","00","010","0004","0022","679","360","319","6","685","1373","0","49.89","26.22"
"10","004","00","010","0004","0023","641","338","303","6","647","1249","0","51.80","27.06"
"10","004","00","010","0004","0024","495","322","173","6","501","1222","0","41.00","26.35"
"10","004","00","010","0005","0000","1312","740","572","9","1321","2974","0","44.42","24.88"
"10","004","00","010","0005","0025","483","292","191","1","484","1086","0","44.57","26.89"
"10","004","00","010","0005","0026","459","255","204","3","462","1022","0","45.21","24.95"
"10","004","00","010","0005","0027","370","193","177","5","375","866","0","43.30","22.29"
"10","004","00","010","0006","0000","1099","762","337","12","1111","2997","0","37.07","25.43"
"10","004","00","010","0006","0028","366","246","120","2","368","1019","0","36.11","24.14"
"10","004","00","010","0006","0029","397","284","113","4","401","1061","0","37.79","26.77"
"10","004","00","010","0006","0030","336","232","104","6","342","917","0","37.30","25.30"
"10","004","00","010","0007","0000","2896","1772","1124","18","2914","7661","0","38.04","23.13"
"10","004","00","010","0007","0071","527","306","221","3","530","1255","0","42.23","24.38"
"10","004","00","010","0007","0072","442","297","145","4","446","1309","0","34.07","22.69"
"10","004","00","010","0007","0073","547","329","218","3","550","1605","0","34.27","20.50"
"10","004","00","010","0007","0074","418","256","162","3","421","1190","0","35.38","21.51"
"10","004","00","010","0007","0075","496","291","205","2","498","1112","0","44.78","26.17"
"10","004","00","010","0007","0076","466","293","173","3","469","1190","0","39.41","24.62"
"10","004","00","010","0008","0000","3526","2219","1307","31","3557","8745","0","40.67","25.37"
"10","004","00","010","0008","0077","392","261","131","4","396","1040","0","38.08","25.10"
"10","004","00","010","0008","0078","405","260","145","2","407","1068","0","38.11","24.34"
"10","004","00","010","0008","0079","426","281","145","4","430","1151","0","37.36","24.41"
"10","004","00","010","0008","0080","451","293","158","5","456","1101","0","41.42","26.61"
"10","004","00","010","0008","0081","485","253","232","3","488","1090","0","44.77","23.21"
"10","004","00","010","0008","0082","535","338","197","7","542","1185","0","45.74","28.52"
"10","004","00","010","0008","0083","416","257","159","3","419","1064","0","39.38","24.15"
"10","004","00","010","0008","0084","416","276","140","3","419","1046","0","40.06","26.39"
"10","004","00","010","0009","0000","2073","1267","806","21","2094","5860","0","35.73","21.62"
"10","004","00","010","0009","0088","526","316","210","7","533","1331","0","40.05","23.74"
"10","004","00","010","0009","0089","379","224","155","4","383","1088","0","35.20","20.59"
"10","004","00","010","0009","0090","475","310","165","4","479","1163","0","41.19","26.66"
"10","004","00","010","0009","0091","430","260","170","3","433","1129","0","38.35","23.03"
"10","004","00","010","0009","0092","263","157","106","3","266","1149","0","23.15","13.66"
"10","004","00","010","0010","0000","2231","1407","824","22","2253","5932","0","37.98","23.72"
"10","004","00","010","0010","0093","508","315","193","6","514","1336","0","38.47","23.58"
"10","004","00","010","0010","0094","504","308","196","8","512","1260","0","40.63","24.44"
"10","004","00","010","0010","0095","390","253","137","2","392","1078","0","36.36","23.47"
"10","004","00","010","0010","0096","432","285","147","3","435","1222","0","35.60","23.32"
"10","004","00","010","0010","0097","397","246","151","3","400","1036","0","38.61","23.75"
"10","004","00","010","0011","0000","2681","1631","1050","33","2714","7074","0","38.37","23.06"
"10","004","00","010","0011","0098","481","311","170","6","487","1191","0","40.89","26.11"
"10","004","00","010","0011","0099","477","294","183","6","483","1166","0","41.42","25.21"
"10","004","00","010","0011","0100","428","261","167","8","436","1151","0","37.88","22.68"
"10","004","00","010","0011","0101","386","225","161","1","387","1022","0","37.87","22.02"
"10","004","00","010","0011","0102","413","255","158","8","421","1171","0","35.95","21.78"
"10","004","00","010","0011","0103","496","285","211","4","500","1373","0","36.42","20.76"
"10","004","00","010","0012","0000","1772","1057","715","21","1793","4441","0","40.37","23.80"
"10","004","00","010","0012","0109","398","241","157","5","403","1092","0","36.90","22.07"
"10","004","00","010","0012","0110","349","210","139","5","354","862","0","41.07","24.36"
"10","004","00","010","0012","0111","524","300","224","5","529","1259","0","42.02","23.83"
"10","004","00","010","0012","0112","501","306","195","6","507","1228","0","41.29","24.92"
"10","004","00","010","0013","0000","749","408","341","8","757","1986","0","38.12","20.54"
"10","004","00","010","0013","0113","340","176","164","3","343","859","0","39.93","20.49"
"10","004","00","010","0013","0114","409","232","177","5","414","1127","0","36.73","20.59"
"10","004","00","010","0014","0000","1036","539","497","10","1046","2468","0","42.38","21.84"
"10","004","00","010","0014","0115","476","254","222","1","477","1097","0","43.48","23.15"
"10","004","00","010","0014","0116","560","285","275","9","569","1371","0","41.50","20.79"
"10","004","00","010","0015","0000","795","408","387","18","813","2202","0","36.92","18.53"
"10","004","00","010","0015","0118","339","182","157","12","351","984","0","35.67","18.50"
"10","004","00","010","0015","0119","456","226","230","6","462","1218","0","37.93","18.56"
"10","004","00","010","0016","0000","496","195","301","7","503","1218","0","41.30","16.01"
"10","004","00","010","0016","0120","496","195","301","7","503","1218","0","41.30","16.01"
"10","004","00","010","0017","0000","640","265","375","4","644","1607","0","40.07","16.49"
"10","004","00","010","0017","0123","384","164","220","1","385","940","0","40.96","17.45"
"10","004","00","010","0017","0124","256","101","155","3","259","667","0","38.83","15.14"
"10","004","00","010","0018","0000","750","285","465","6","756","1914","0","39.50","14.89"
"10","004","00","010","0018","0127","391","155","236","4","395","966","0","40.89","16.05"
"10","004","00","010","0018","0128","359","130","229","2","361","948","0","38.08","13.71"
"10","004","00","010","0019","0000","693","398","295","8","701","1741","0","40.26","22.86"
"10","004","00","010","0019","0121","369","202","167","4","373","935","0","39.89","21.60"
"10","004","00","010","0019","0122","324","196","128","4","328","806","0","40.69","24.32"
"10","004","00","010","0020","0000","621","252","369","8","629","1683","0","37.37","14.97"
"10","004","00","010","0020","0125","326","118","208","2","328","832","0","39.42","14.18"
"10","004","00","010","0020","0126","295","134","161","6","301","851","0","35.37","15.75"
"10","004","00","010","0021","0000","3045","1704","1341","27","3072","6632","0","46.32","25.69"
"10","004","00","010","0021","0041","576","311","265","4","580","1203","0","48.21","25.85"
"10","004","00","010","0021","0042","538","314","224","8","546","1095","0","49.86","28.68"
"10","004","00","010","0021","0043","509","273","236","6","515","1102","0","46.73","24.77"
"10","004","00","010","0021","0044","598","336","262","2","600","1257","0","47.73","26.73"
"10","004","00","010","0021","0045","434","243","191","4","438","1009","0","43.41","24.08"
"10","004","00","010","0021","0046","390","227","163","3","393","966","0","40.68","23.50"
"10","004","00","010","0022","0000","2320","1297","1023","13","2333","6000","0","38.88","21.62"
"10","004","00","010","0022","0104","457","274","183","2","459","1110","0","41.35","24.68"
"10","004","00","010","0022","0105","447","238","209","1","448","1209","0","37.06","19.69"
"10","004","00","010","0022","0106","415","229","186","6","421","1165","0","36.14","19.66"
"10","004","00","010","0022","0107","483","256","227","3","486","1295","0","37.53","19.77"
"10","004","00","010","0022","0108","518","300","218","1","519","1221","0","42.51","24.57"
"10","004","00","010","0023","0000","398","227","171","6","404","1064","0","37.97","21.33"
"10","004","00","010","0023","0117","398","227","171","6","404","1064","0","37.97","21.33"
"10","004","00","010","0024","0000","1650","1032","618","15","1665","3833","0","43.44","26.92"
"10","004","00","010","0024","0063","520","309","211","8","528","1196","0","44.15","25.84"
"10","004","00","010","0024","0064","603","382","221","5","608","1366","0","44.51","27.96"
"10","004","00","010","0024","0065","527","341","186","2","529","1271","0","41.62","26.83"
"10","004","00","010","0025","0000","2521","1465","1056","26","2547","6255","0","40.72","23.42"
"10","004","00","010","0025","0066","453","282","171","6","459","1187","0","38.67","23.76"
"10","004","00","010","0025","0067","556","329","227","7","563","1312","0","42.91","25.08"
"10","004","00","010","0025","0068","503","277","226","3","506","1191","0","42.49","23.26"
"10","004","00","010","0025","0069","551","323","228","4","555","1239","0","44.79","26.07"
"10","004","00","010","0025","0070","458","254","204","6","464","1326","0","34.99","19.16"
"10","004","00","010","0026","0000","1345","838","507","13","1358","3262","0","41.63","25.69"
"10","004","00","010","0026","0085","428","277","151","5","433","1027","0","42.16","26.97"
"10","004","00","010","0026","0086","506","305","201","3","509","1130","0","45.04","26.99"
"10","004","00","010","0026","0087","411","256","155","5","416","1105","0","37.65","23.17"
"10","004","00","010","0027","0000","2850","1498","1352","22","2872","7126","0","40.30","21.02"
"10","004","00","010","0027","0031","465","251","214","6","471","1182","0","39.85","21.24"
"10","004","00","010","0027","0032","489","306","183","4","493","1198","0","41.15","25.54"
"10","004","00","010","0027","0033","508","230","278","4","512","1202","0","42.60","19.13"
"10","004","00","010","0027","0034","489","223","266","3","492","1285","0","38.29","17.35"
"10","004","00","010","0027","0035","486","245","241","3","489","1123","0","43.54","21.82"
"10","004","00","010","0027","0036","413","243","170","2","415","1136","0","36.53","21.39"
"10","004","00","010","0028","0000","2189","1147","1042","12","2201","5571","0","39.51","20.59"
"10","004","00","010","0028","0037","584","313","271","1","585","1430","0","40.91","21.89"
"10","004","00","010","0028","0038","516","266","250","2","518","1361","0","38.06","19.54"
"10","004","00","010","0028","0039","538","287","251","2","540","1427","0","37.84","20.11"
"10","004","00","010","0028","0040","551","281","270","7","558","1353","0","41.24","20.77"
"10","004","00","010","0029","0000","1476","907","569","10","1486","3538","0","42.00","25.64"
"10","004","00","010","0029","0047","488","300","188","4","492","1202","0","40.93","24.96"
"10","004","00","010","0029","0048","495","300","195","3","498","1125","0","44.27","26.67"
"10","004","00","010","0029","0049","493","307","186","3","496","1211","0","40.96","25.35"
"10","004","00","010","0030","0000","1499","917","582","15","1514","3337","0","45.37","27.48"
"10","004","00","010","0030","0050","518","314","204","8","526","1136","0","46.30","27.64"
"10","004","00","010","0030","0051","472","304","168","5","477","1041","0","45.82","29.20"
"10","004","00","010","0030","0052","509","299","210","2","511","1160","0","44.05","25.78"
"10","004","00","010","0031","0000","2827","1692","1135","12","2839","6155","0","46.13","27.49"
"10","004","00","010","0031","0058","602","407","195","1","603","1221","0","49.39","33.33"
"10","004","00","010","0031","0059","555","329","226","2","557","1176","0","47.36","27.98"
"10","004","00","010","0031","0060","495","261","234","4","499","1201","0","41.55","21.73"
"10","004","00","010","0031","0061","539","335","204","3","542","1200","0","45.17","27.92"
"10","004","00","010","0031","0062","636","360","276","2","638","1357","0","47.02","26.53"
"10","004","00","020","0000","0000","29947","20361","9586","287","30234","80187","96850","37.70","25.39"
"10","004","00","020","0001","0000","100","76","24","0","100","303","0","33.00","25.08"
"10","004","00","020","0001","0129","100","76","24","0","100","303","0","33.00","25.08"
"10","004","00","020","0002","0000","133","85","48","4","137","402","0","34.08","21.14"
"10","004","00","020","0002","0130","133","85","48","4","137","402","0","34.08","21.14"
"10","004","00","020","0003","0000","132","86","46","2","134","369","0","36.31","23.31"
"10","004","00","020","0003","0131","132","86","46","2","134","369","0","36.31","23.31"
"10","004","00","020","0004","0000","837","612","225","2","839","2251","0","37.27","27.19"
"10","004","00","020","0004","0132","377","265","112","1","378","1092","0","34.62","24.27"
"10","004","00","020","0004","0133","460","347","113","1","461","1159","0","39.78","29.94"
"10","004","00","020","0005","0000","1253","892","361","11","1264","3227","0","39.17","27.64"
"10","004","00","020","0005","0142","380","289","91","4","384","995","0","38.59","29.05"
"10","004","00","020","0005","0143","407","287","120","4","411","1185","0","34.68","24.22"
"10","004","00","020","0005","0144","466","316","150","3","469","1047","0","44.79","30.18"
"10","004","00","020","0006","0000","3267","2323","944","35","3302","9255","0","35.68","25.10"
"10","004","00","020","0006","0134","424","295","129","8","432","1189","0","36.33","24.81"
"10","004","00","020","0006","0135","484","349","135","3","487","1217","0","40.02","28.68"
"10","004","00","020","0006","0136","475","346","129","8","483","1278","0","37.79","27.07"
"10","004","00","020","0006","0137","336","238","98","2","338","1345","0","25.13","17.70"
"10","004","00","020","0006","0138","413","306","107","4","417","1204","0","34.63","25.42"
"10","004","00","020","0006","0139","387","282","105","2","389","917","0","42.42","30.75"
"10","004","00","020","0006","0140","328","199","129","3","331","939","0","35.25","21.19"
"10","004","00","020","0006","0141","420","308","112","5","425","1166","0","36.45","26.42"
"10","004","00","020","0007","0000","1599","1120","479","20","1619","4597","0","35.22","24.36"
"10","004","00","020","0007","0147","357","226","131","4","361","1125","0","32.09","20.09"
"10","004","00","020","0007","0148","342","247","95","7","349","1044","0","33.43","23.66"
"10","004","00","020","0007","0149","475","337","138","6","481","1266","0","37.99","26.62"
"10","004","00","020","0007","0150","425","310","115","3","428","1162","0","36.83","26.68"
"10","004","00","020","0008","0000","311","213","98","0","311","643","0","48.37","33.13"
"10","004","00","020","0008","0154","311","213","98","0","311","643","0","48.37","33.13"
"10","004","00","020","0009","0000","987","724","263","7","994","3051","0","32.58","23.73"
"10","004","00","020","0009","0155","279","206","73","1","280","984","0","28.46","20.93"
"10","004","00","020","0009","0156","401","305","96","2","403","969","0","41.59","31.48"
"10","004","00","020","0009","0157","307","213","94","4","311","1098","0","28.32","19.40"
"10","004","00","020","0010","0000","581","356","225","7","588","1321","0","44.51","26.95"
"10","004","00","020","0010","0158","277","173","104","3","280","579","0","48.36","29.88"
"10","004","00","020","0010","0159","304","183","121","4","308","742","0","41.51","24.66"
"10","004","00","020","0011","0000","595","414","181","3","598","1352","0","44.23","30.62"
"10","004","00","020","0011","0169","305","216","89","2","307","693","0","44.30","31.17"
"10","004","00","020","0011","0170","290","198","92","1","291","659","0","44.16","30.05"
"10","004","00","020","0012","0000","1368","955","413","6","1374","3726","0","36.88","25.63"
"10","004","00","020","0012","0162","321","226","95","1","322","923","0","34.89","24.49"
"10","004","00","020","0012","0163","301","209","92","2","303","949","0","31.93","22.02"
"10","004","00","020","0012","0164","330","257","73","1","331","901","0","36.74","28.52"
"10","004","00","020","0012","0165","416","263","153","2","418","953","0","43.86","27.60"
"10","004","00","020","0013","0000","1273","867","406","9","1282","3284","0","39.04","26.40"
"10","004","00","020","0013","0166","383","270","113","3","386","962","0","40.12","28.07"
"10","004","00","020","0013","0167","437","302","135","3","440","1159","0","37.96","26.06"
"10","004","00","020","0013","0168","453","295","158","3","456","1163","0","39.21","25.37"
"10","004","00","020","0014","0000","2417","1610","807","16","2433","7516","0","32.37","21.42"
"10","004","00","020","0014","0177","379","243","136","4","383","1248","0","30.69","19.47"
"10","004","00","020","0014","0178","299","185","114","1","300","1254","0","23.92","14.75"
"10","004","00","020","0014","0179","414","282","132","5","419","1219","0","34.37","23.13"
"10","004","00","020","0014","0180","331","213","118","0","331","1139","0","29.06","18.70"
"10","004","00","020","0014","0181","592","396","196","2","594","1554","0","38.22","25.48"
"10","004","00","020","0014","0182","402","291","111","4","406","1102","0","36.84","26.41"
"10","004","00","020","0015","0000","2372","1578","794","21","2393","6371","0","37.56","24.77"
"10","004","00","020","0015","0184","384","261","123","1","385","1078","0","35.71","24.21"
"10","004","00","020","0015","0185","316","204","112","0","316","1061","0","29.78","19.23"
"10","004","00","020","0015","0186","377","239","138","7","384","977","0","39.30","24.46"
"10","004","00","020","0015","0187","394","258","136","2","396","1090","0","36.33","23.67"
"10","004","00","020","0015","0188","443","289","154","5","448","1086","0","41.25","26.61"
"10","004","00","020","0015","0189","458","327","131","6","464","1079","0","43.00","30.31"
"10","004","00","020","0016","0000","1893","1225","668","18","1911","4492","0","42.54","27.27"
"10","004","00","020","0016","0200","478","300","178","5","483","1108","0","43.59","27.08"
"10","004","00","020","0016","0201","498","334","164","4","502","1181","0","42.51","28.28"
"10","004","00","020","0016","0202","474","302","172","3","477","1124","0","42.44","26.87"
"10","004","00","020","0016","0203","443","289","154","6","449","1079","0","41.61","26.78"
"10","004","00","020","0017","0000","774","493","281","8","782","1905","0","41.05","25.88"
"10","004","00","020","0017","0204","374","220","154","4","378","989","0","38.22","22.24"
"10","004","00","020","0017","0205","400","273","127","4","404","916","0","44.10","29.80"
"10","004","00","020","0018","0000","232","144","88","3","235","585","0","40.17","24.62"
"10","004","00","020","0018","0206","232","144","88","3","235","585","0","40.17","24.62"
"10","004","00","020","0019","0000","4404","2804","1600","41","4445","11579","0","38.39","24.22"
"10","004","00","020","0019","0190","507","334","173","6","513","1184","0","43.33","28.21"
"10","004","00","020","0019","0191","320","198","122","3","323","907","0","35.61","21.83"
"10","004","00","020","0019","0192","804","518","286","10","814","1559","0","52.21","33.23"
"10","004","00","020","0019","0193","267","140","127","1","268","847","0","31.64","16.53"
"10","004","00","020","0019","0194","311","169","142","5","316","946","0","33.40","17.86"
"10","004","00","020","0019","0195","487","271","216","2","489","1282","0","38.14","21.14"
"10","004","00","020","0019","0196","426","287","139","2","428","1186","0","36.09","24.20"
"10","004","00","020","0019","0197","333","219","114","1","334","1228","0","27.20","17.83"
"10","004","00","020","0019","0198","440","310","130","5","445","1202","0","37.02","25.79"
"10","004","00","020","0019","0199","509","358","151","6","515","1238","0","41.60","28.92"
"10","004","00","020","0020","0000","638","461","177","13","651","1672","0","38.94","27.57"
"10","004","00","020","0020","0151","285","216","69","9","294","812","0","36.21","26.60"
"10","004","00","020","0020","0152","353","245","108","4","357","860","0","41.51","28.49"
"10","004","00","020","0021","0000","832","543","289","15","847","2198","0","38.54","24.70"
"10","004","00","020","0021","0145","347","231","116","8","355","895","0","39.66","25.81"
"10","004","00","020","0021","0146","485","312","173","7","492","1303","0","37.76","23.94"
"10","004","00","020","0022","0000","435","296","139","1","436","1002","0","43.51","29.54"
"10","004","00","020","0022","0153","435","296","139","1","436","1002","0","43.51","29.54"
"10","004","00","020","0023","0000","2712","1929","783","33","2745","6974","0","39.36","27.66"
"10","004","00","020","0023","0171","444","336","108","7","451","1165","0","38.71","28.84"
"10","004","00","020","0023","0172","463","322","141","6","469","1119","0","41.91","28.78"
"10","004","00","020","0023","0173","447","324","123","6","453","1135","0","39.91","28.55"
"10","004","00","020","0023","0174","486","345","141","4","490","1219","0","40.20","28.30"
"10","004","00","020","0023","0175","450","314","136","6","456","1213","0","37.59","25.89"
"10","004","00","020","0023","0176","422","288","134","4","426","1123","0","37.93","25.65"
"10","004","00","020","0024","0000","558","387","171","8","566","1533","0","36.92","25.24"
"10","004","00","020","0024","0160","271","180","91","6","277","730","0","37.95","24.66"
"10","004","00","020","0024","0161","287","207","80","2","289","803","0","35.99","25.78"
"10","004","00","020","0025","0000","244","168","76","4","248","579","0","42.83","29.02"
"10","004","00","020","0025","0183","244","168","76","4","248","579","0","42.83","29.02"
"10","004","00","030","0000","0000","11854","7069","4785","133","11987","29144","32991","41.13","24.26"
"10","004","00","030","0001","0000","409","233","176","8","417","1106","0","37.70","21.07"
"10","004","00","030","0001","0227","409","233","176","8","417","1106","0","37.70","21.07"
"10","004","00","030","0002","0000","368","232","136","5","373","857","0","43.52","27.07"
"10","004","00","030","0002","0228","368","232","136","5","373","857","0","43.52","27.07"
"10","004","00","030","0003","0000","1815","1135","680","14","1829","4469","0","40.93","25.40"
"10","004","00","030","0003","0229","380","234","146","3","383","1052","0","36.41","22.24"
"10","004","00","030","0003","0230","429","263","166","5","434","1008","0","43.06","26.09"
"10","004","00","030","0003","0231","390","267","123","2","392","1010","0","38.81","26.44"
"10","004","00","030","0003","0232","616","371","245","4","620","1399","0","44.32","26.52"
"10","004","00","030","0004","0000","726","470","256","5","731","1976","0","36.99","23.79"
"10","004","00","030","0004","0216","375","246","129","4","379","979","0","38.71","25.13"
"10","004","00","030","0004","0217","351","224","127","1","352","997","0","35.31","22.47"
"10","004","00","030","0005","0000","1385","791","594","8","1393","3266","0","42.65","24.22"
"10","004","00","030","0005","0218","543","334","209","5","548","1174","0","46.68","28.45"
"10","004","00","030","0005","0219","457","267","190","2","459","1110","0","41.35","24.05"
"10","004","00","030","0005","0220","385","190","195","1","386","982","0","39.31","19.35"
"10","004","00","030","0006","0000","683","418","265","6","689","1753","0","39.30","23.84"
"10","004","00","030","0006","0214","347","227","120","2","349","894","0","39.04","25.39"
"10","004","00","030","0006","0215","336","191","145","4","340","859","0","39.58","22.24"
"10","004","00","030","0007","0000","1256","818","438","11","1267","3147","0","40.26","25.99"
"10","004","00","030","0007","0210","366","256","110","2","368","908","0","40.53","28.19"
"10","004","00","030","0007","0211","279","189","90","1","280","707","0","39.60","26.73"
"10","004","00","030","0007","0212","400","237","163","6","406","1025","0","39.61","23.12"
"10","004","00","030","0007","0213","211","136","75","2","213","507","0","42.01","26.82"
"10","004","00","030","0008","0000","400","253","147","7","407","964","0","42.22","26.24"
"10","004","00","030","0008","0207","400","253","147","7","407","964","0","42.22","26.24"
"10","004","00","030","0009","0000","251","133","118","2","253","558","0","45.34","23.84"
"10","004","00","030","0009","0208","251","133","118","2","253","558","0","45.34","23.84"
"10","004","00","030","0010","0000","454","306","148","3","457","1011","0","45.20","30.27"
"10","004","00","030","0010","0209","454","306","148","3","457","1011","0","45.20","30.27"
"10","004","00","030","0011","0000","701","420","281","14","715","1823","0","39.22","23.04"
"10","004","00","030","0011","0233","389","211","178","5","394","960","0","41.04","21.98"
"10","004","00","030","0011","0234","312","209","103","9","321","863","0","37.20","24.22"
"10","004","00","030","0012","0000","1050","620","430","13","1063","2507","0","42.40","24.73"
"10","004","00","030","0012","0235","368","211","157","3","371","828","0","44.81","25.48"
"10","004","00","030","0012","0236","349","208","141","5","354","807","0","43.87","25.77"
"10","004","00","030","0012","0237","333","201","132","5","338","872","0","38.76","23.05"
"10","004","00","030","0013","0000","427","245","182","9","436","977","0","44.63","25.08"
"10","004","00","030","0013","0238","427","245","182","9","436","977","0","44.63","25.08"
"10","004","00","030","0014","0000","257","143","114","3","260","642","0","40.50","22.27"
"10","004","00","030","0014","0239","257","143","114","3","260","642","0","40.50","22.27"
"10","004","00","030","0015","0000","491","234","257","6","497","1082","0","45.93","21.63"
"10","004","00","030","0015","0226","491","234","257","6","497","1082","0","45.93","21.63"
"10","004","00","030","0016","0000","475","265","210","11","486","1332","0","36.49","19.89"
"10","004","00","030","0016","0221","237","115","122","6","243","730","0","33.29","15.75"
"10","004","00","030","0016","0222","238","150","88","5","243","602","0","40.37","24.92"
"10","004","00","030","0017","0000","190","96","94","0","190","403","0","47.15","23.82"
"10","004","00","030","0017","0223","190","96","94","0","190","403","0","47.15","23.82"
"10","004","00","030","0018","0000","278","128","150","2","280","701","0","39.94","18.26"
"10","004","00","030","0018","0224","278","128","150","2","280","701","0","39.94","18.26"
"10","004","00","030","0019","0000","238","129","109","6","244","570","0","42.81","22.63"
"10","004","00","030","0019","0225","238","129","109","6","244","570","0","42.81","22.63"
"10","004","00","040","0000","0000","9229","5902","3327","132","9361","24047","27521","38.93","24.54"
"10","004","00","040","0001","0000","221","165","56","3","224","472","0","47.46","34.96"
"10","004","00","040","0001","0240","221","165","56","3","224","472","0","47.46","34.96"
"10","004","00","040","0002","0000","766","546","220","5","771","1896","0","40.66","28.80"
"10","004","00","040","0002","0241","361","260","101","3","364","896","0","40.63","29.02"
"10","004","00","040","0002","0242","405","286","119","2","407","1000","0","40.70","28.60"
"10","004","00","040","0003","0000","291","197","94","3","294","677","0","43.43","29.10"
"10","004","00","040","0003","0243","291","197","94","3","294","677","0","43.43","29.10"
"10","004","00","040","0004","0000","1444","958","486","20","1464","3579","0","40.91","26.77"
"10","004","00","040","0004","0244","512","334","178","6","518","1144","0","45.28","29.20"
"10","004","00","040","0004","0245","487","320","167","5","492","1170","0","42.05","27.35"
"10","004","00","040","0004","0246","445","304","141","9","454","1265","0","35.89","24.03"
"10","004","00","040","0005","0000","401","245","156","6","407","960","0","42.40","25.52"
"10","004","00","040","0005","0248","401","245","156","6","407","960","0","42.40","25.52"
"10","004","00","040","0006","0000","322","181","141","2","324","756","0","42.86","23.94"
"10","004","00","040","0006","0247","322","181","141","2","324","756","0","42.86","23.94"
"10","004","00","040","0007","0000","344","197","147","15","359","1025","0","35.02","19.22"
"10","004","00","040","0007","0249","344","197","147","15","359","1025","0","35.02","19.22"
"10","004","00","040","0008","0000","1308","860","448","13","1321","3726","0","35.45","23.08"
"10","004","00","040","0008","0250","418","273","145","5","423","1200","0","35.25","22.75"
"10","004","00","040","0008","0251","470","316","154","3","473","1290","0","36.67","24.50"
"10","004","00","040","0008","0252","420","271","149","5","425","1236","0","34.39","21.93"
"10","004","00","040","0009","0000","445","277","168","8","453","1248","0","36.30","22.20"
"10","004","00","040","0009","0254","445","277","168","8","453","1248","0","36.30","22.20"
"10","004","00","040","0010","0000","169","96","73","4","173","529","0","32.70","18.15"
"10","004","00","040","0010","0256","169","96","73","4","173","529","0","32.70","18.15"
"10","004","00","040","0011","0000","207","138","69","2","209","549","0","38.07","25.14"
"10","004","00","040","0011","0258","207","138","69","2","209","549","0","38.07","25.14"
"10","004","00","040","0012","0000","285","197","88","3","288","904","0","31.86","21.79"
"10","004","00","040","0012","0259","285","197","88","3","288","904","0","31.86","21.79"
"10","004","00","040","0013","0000","129","63","66","3","132","431","0","30.63","14.62"
"10","004","00","040","0013","0257","129","63","66","3","132","431","0","30.63","14.62"
"10","004","00","040","0014","0000","348","171","177","2","350","787","0","44.47","21.73"
"10","004","00","040","0014","0260","348","171","177","2","350","787","0","44.47","21.73"
"10","004","00","040","0015","0000","654","407","247","8","662","1735","0","38.16","23.46"
"10","004","00","040","0015","0261","353","237","116","4","357","861","0","41.46","27.53"
"10","004","00","040","0015","0262","301","170","131","4","305","874","0","34.90","19.45"
"10","004","00","040","0016","0000","325","211","114","6","331","798","0","41.48","26.44"
"10","004","00","040","0016","0264","325","211","114","6","331","798","0","41.48","26.44"
"10","004","00","040","0017","0000","214","153","61","3","217","537","0","40.41","28.49"
"10","004","00","040","0017","0265","214","153","61","3","217","537","0","40.41","28.49"
"10","004","00","040","0018","0000","310","179","131","10","320","799","0","40.05","22.40"
"10","004","00","040","0018","0266","310","179","131","10","320","799","0","40.05","22.40"
"10","004","00","040","0019","0000","323","193","130","7","330","824","0","40.05","23.42"
"10","004","00","040","0019","0253","323","193","130","7","330","824","0","40.05","23.42"
"10","004","00","040","0020","0000","315","214","101","4","319","889","0","35.88","24.07"
"10","004","00","040","0020","0255","315","214","101","4","319","889","0","35.88","24.07"
"10","004","00","040","0021","0000","408","254","154","5","413","926","0","44.60","27.43"
"10","004","00","040","0021","0263","408","254","154","5","413","926","0","44.60","27.43"
"10","004","00","050","0000","0000","23492","15384","8108","246","23738","65720","79420","36.12","23.41"
"10","004","00","050","0001","0000","519","337","182","4","523","1181","0","44.28","28.54"
"10","004","00","050","0001","0280","519","337","182","4","523","1181","0","44.28","28.54"
"10","004","00","050","0002","0000","379","241","138","3","382","855","0","44.68","28.19"
"10","004","00","050","0002","0279","379","241","138","3","382","855","0","44.68","28.19"
"10","004","00","050","0003","0000","1562","1009","553","19","1581","3959","0","39.93","25.49"
"10","004","00","050","0003","0276","499","294","205","6","505","1347","0","37.49","21.83"
"10","004","00","050","0003","0277","549","384","165","10","559","1295","0","43.17","29.65"
"10","004","00","050","0003","0278","514","331","183","3","517","1317","0","39.26","25.13"
"10","004","00","050","0004","0000","1939","1242","697","23","1962","5246","0","37.40","23.68"
"10","004","00","050","0004","0285","500","315","185","7","507","1441","0","35.18","21.86"
"10","004","00","050","0004","0286","467","296","171","2","469","1148","0","40.85","25.78"
"10","004","00","050","0004","0287","452","286","166","5","457","1367","0","33.43","20.92"
"10","004","00","050","0004","0288","520","345","175","9","529","1290","0","41.01","26.74"
"10","004","00","050","0005","0000","1244","795","449","14","1258","3221","0","39.06","24.68"
"10","004","00","050","0005","0281","724","473","251","6","730","1946","0","37.51","24.31"
"10","004","00","050","0005","0282","520","322","198","8","528","1275","0","41.41","25.25"
"10","004","00","050","0006","0000","1671","1054","617","14","1685","4921","0","34.24","21.42"
"10","004","00","050","0006","0272","404","264","140","6","410","1124","0","36.48","23.49"
"10","004","00","050","0006","0273","483","285","198","3","486","1307","0","37.18","21.81"
"10","004","00","050","0006","0274","371","244","127","2","373","1200","0","31.08","20.33"
"10","004","00","050","0006","0275","413","261","152","3","416","1290","0","32.25","20.23"
"10","004","00","050","0007","0000","1023","605","418","5","1028","2816","0","36.51","21.48"
"10","004","00","050","0007","0267","465","251","214","1","466","1317","0","35.38","19.06"
"10","004","00","050","0007","0268","558","354","204","4","562","1499","0","37.49","23.62"
"10","004","00","050","0008","0000","1112","725","387","15","1127","3163","0","35.63","22.92"
"10","004","00","050","0008","0294","425","286","139","6","431","1177","0","36.62","24.30"
"10","004","00","050","0008","0295","305","198","107","8","313","785","0","39.87","25.22"
"10","004","00","050","0008","0296","382","241","141","1","383","1201","0","31.89","20.07"
"10","004","00","050","0009","0000","370","226","144","2","372","1045","0","35.60","21.63"
"10","004","00","050","0009","0297","370","226","144","2","372","1045","0","35.60","21.63"
"10","004","00","050","0010","0000","1063","677","386","10","1073","2753","0","38.98","24.59"
"10","004","00","050","0010","0298","474","320","154","5","479","1302","0","36.79","24.58"
"10","004","00","050","0010","0299","589","357","232","5","594","1451","0","40.94","24.60"
"10","004","00","050","0011","0000","999","732","267","18","1017","2452","0","41.48","29.85"
"10","004","00","050","0011","0300","516","363","153","10","526","1227","0","42.87","29.58"
"10","004","00","050","0011","0301","483","369","114","8","491","1225","0","40.08","30.12"
"10","004","00","050","0012","0000","605","419","186","7","612","1495","0","40.94","28.03"
"10","004","00","050","0012","0302","605","419","186","7","612","1495","0","40.94","28.03"
"10","004","00","050","0013","0000","741","460","281","11","752","2217","0","33.92","20.75"
"10","004","00","050","0013","0292","355","203","152","8","363","1088","0","33.36","18.66"
"10","004","00","050","0013","0293","386","257","129","3","389","1129","0","34.46","22.76"
"10","004","00","050","0014","0000","1621","1042","579","19","1640","5086","0","32.25","20.49"
"10","004","00","050","0014","0308","336","244","92","5","341","1050","0","32.48","23.24"
"10","004","00","050","0014","0309","372","216","156","6","378","1289","0","29.33","16.76"
"10","004","00","050","0014","0310","447","297","150","4","451","1279","0","35.26","23.22"
"10","004","00","050","0014","0311","466","285","181","4","470","1468","0","32.02","19.41"
"10","004","00","050","0015","0000","1172","841","331","10","1182","3248","0","36.39","25.89"
"10","004","00","050","0015","0315","345","229","116","2","347","1076","0","32.25","21.28"
"10","004","00","050","0015","0316","481","374","107","5","486","1196","0","40.64","31.27"
"10","004","00","050","0015","0317","346","238","108","3","349","976","0","35.76","24.39"
"10","004","00","050","0016","0000","1885","1351","534","19","1904","6149","0","30.96","21.97"
"10","004","00","050","0016","0303","434","344","90","5","439","1387","0","31.65","24.80"
"10","004","00","050","0016","0304","337","269","68","3","340","1016","0","33.46","26.48"
"10","004","00","050","0016","0305","372","244","128","5","377","1196","0","31.52","20.40"
"10","004","00","050","0016","0306","402","273","129","4","406","1403","0","28.94","19.46"
"10","004","00","050","0016","0307","340","221","119","2","342","1147","0","29.82","19.27"
"10","004","00","050","0017","0000","1414","897","517","14","1428","3854","0","37.05","23.27"
"10","004","00","050","0017","0289","387","240","147","6","393","966","0","40.68","24.84"
"10","004","00","050","0017","0290","390","226","164","3","393","1164","0","33.76","19.42"
"10","004","00","050","0017","0291","637","431","206","5","642","1724","0","37.24","25.00"
"10","004","00","050","0018","0000","1346","853","493","11","1357","3485","0","38.94","24.48"
"10","004","00","050","0018","0283","612","365","247","5","617","1458","0","42.32","25.03"
"10","004","00","050","0018","0284","734","488","246","6","740","2027","0","36.51","24.07"
"10","004","00","050","0019","0000","1468","922","546","9","1477","4375","0","33.76","21.07"
"10","004","00","050","0019","0269","398","238","160","1","399","1220","0","32.70","19.51"
"10","004","00","050","0019","0270","486","309","177","4","490","1551","0","31.59","19.92"
"10","004","00","050","0019","0271","584","375","209","4","588","1604","0","36.66","23.38"
"10","004","00","050","0020","0000","1359","956","403","19","1378","4199","0","32.82","22.77"
"10","004","00","050","0020","0312","511","340","171","4","515","1475","0","34.92","23.05"
"10","004","00","050","0020","0313","429","298","131","6","435","1439","0","30.23","20.71"
"10","004","00","050","0020","0314","419","318","101","9","428","1285","0","33.31","24.75"
"10","004","00","060","0000","0000","16880","10401","6479","182","17062","46779","57654","36.47","22.23"
"10","004","00","060","0001","0000","400","234","166","9","409","1086","0","37.66","21.55"
"10","004","00","060","0001","0318","400","234","166","9","409","1086","0","37.66","21.55"
"10","004","00","060","0002","0000","625","348","277","11","636","1798","0","35.37","19.35"
"10","004","00","060","0002","0326","264","141","123","7","271","795","0","34.09","17.74"
"10","004","00","060","0002","0327","361","207","154","4","365","1003","0","36.39","20.64"
"10","004","00","060","0003","0000","648","383","265","10","658","1867","0","35.24","20.51"
"10","004","00","060","0003","0319","289","174","115","5","294","883","0","33.30","19.71"
"10","004","00","060","0003","0320","359","209","150","5","364","984","0","36.99","21.24"
"10","004","00","060","0004","0000","1020","454","566","4","1024","2772","0","36.94","16.38"
"10","004","00","060","0004","0329","334","158","176","2","336","995","0","33.77","15.88"
"10","004","00","060","0004","0330","333","141","192","1","334","858","0","38.93","16.43"
"10","004","00","060","0004","0331","353","155","198","1","354","919","0","38.52","16.87"
"10","004","00","060","0005","0000","573","345","228","6","579","1847","0","31.35","18.68"
"10","004","00","060","0005","0324","330","201","129","3","333","956","0","34.83","21.03"
"10","004","00","060","0005","0325","243","144","99","3","246","891","0","27.61","16.16"
"10","004","00","060","0006","0000","310","128","182","3","313","833","0","37.58","15.37"
"10","004","00","060","0006","0328","310","128","182","3","313","833","0","37.58","15.37"
"10","004","00","060","0007","0000","1094","695","399","12","1106","3202","0","34.54","21.71"
"10","004","00","060","0007","0321","378","240","138","1","379","990","0","38.28","24.24"
"10","004","00","060","0007","0322","370","243","127","4","374","1123","0","33.30","21.64"
"10","004","00","060","0007","0323","346","212","134","7","353","1089","0","32.42","19.47"
"10","004","00","060","0008","0000","1751","1130","621","26","1777","5247","0","33.87","21.54"
"10","004","00","060","0008","0346","364","233","131","4","368","977","0","37.67","23.85"
"10","004","00","060","0008","0347","404","260","144","6","410","1054","0","38.90","24.67"
"10","004","00","060","0008","0348","301","193","108","3","304","1062","0","28.63","18.17"
"10","004","00","060","0008","0349","314","204","110","7","321","1013","0","31.69","20.14"
"10","004","00","060","0008","0350","368","240","128","6","374","1141","0","32.78","21.03"
"10","004","00","060","0009","0000","729","333","396","4","733","2073","0","35.36","16.06"
"10","004","00","060","0009","0332","331","128","203","2","333","1022","0","32.58","12.52"
"10","004","00","060","0009","0333","398","205","193","2","400","1051","0","38.06","19.51"
"10","004","00","060","0010","0000","988","675","313","4","992","2634","0","37.66","25.63"
"10","004","00","060","0010","0334","507","350","157","3","510","1352","0","37.72","25.89"
"10","004","00","060","0010","0335","481","325","156","1","482","1282","0","37.60","25.35"
"10","004","00","060","0011","0000","1708","1122","586","15","1723","4372","0","39.41","25.66"
"10","004","00","060","0011","0354","451","300","151","5","456","1117","0","40.82","26.86"
"10","004","00","060","0011","0355","390","261","129","3","393","1052","0","37.36","24.81"
"10","004","00","060","0011","0356","448","291","157","4","452","1201","0","37.64","24.23"
"10","004","00","060","0011","0357","419","270","149","3","422","1002","0","42.12","26.95"
"10","004","00","060","0012","0000","572","368","204","11","583","1508","0","38.66","24.40"
"10","004","00","060","0012","0343","275","167","108","7","282","758","0","37.20","22.03"
"10","004","00","060","0012","0344","297","201","96","4","301","750","0","40.13","26.80"
"10","004","00","060","0013","0000","397","244","153","6","403","1044","0","38.60","23.37"
"10","004","00","060","0013","0345","397","244","153","6","403","1044","0","38.60","23.37"
"10","004","00","060","0014","0000","1342","875","467","14","1356","3558","0","38.11","24.59"
"10","004","00","060","0014","0336","472","311","161","3","475","1308","0","36.31","23.78"
"10","004","00","060","0014","0337","454","283","171","3","457","1124","0","40.66","25.18"
"10","004","00","060","0014","0338","416","281","135","8","424","1126","0","37.66","24.96"
"10","004","00","060","0015","0000","1705","1125","580","18","1723","4427","0","38.92","25.41"
"10","004","00","060","0015","0339","391","267","124","4","395","1114","0","35.46","23.97"
"10","004","00","060","0015","0340","387","263","124","2","389","1007","0","38.63","26.12"
"10","004","00","060","0015","0341","426","274","152","6","432","1065","0","40.56","25.73"
"10","004","00","060","0015","0342","501","321","180","6","507","1241","0","40.85","25.87"
"10","004","00","060","0016","0000","2023","1297","726","15","2038","5803","0","35.12","22.35"
"10","004","00","060","0016","0358","428","264","164","5","433","1107","0","39.11","23.85"
"10","004","00","060","0016","0359","428","260","168","2","430","1175","0","36.60","22.13"
"10","004","00","060","0016","0360","417","288","129","3","420","1184","0","35.47","24.32"
"10","004","00","060","0016","0361","347","242","105","1","348","1016","0","34.25","23.82"
"10","004","00","060","0016","0362","403","243","160","4","407","1321","0","30.81","18.40"
"10","004","00","060","0017","0000","995","645","350","14","1009","2708","0","37.26","23.82"
"10","004","00","060","0017","0351","307","206","101","3","310","926","0","33.48","22.25"
"10","004","00","060","0017","0352","281","178","103","6","287","820","0","35.00","21.71"
"10","004","00","060","0017","0353","407","261","146","5","412","962","0","42.83","27.13"
"10","004","00","070","0000","0000","7081","4708","2373","90","7171","17504","19888","40.97","26.90"
"10","004","00","070","0001","0000","199","141","58","1","200","491","0","40.73","28.72"
"10","004","00","070","0001","0364","199","141","58","1","200","491","0","40.73","28.72"
"10","004","00","070","0002","0000","166","116","50","3","169","384","0","44.01","30.21"
"10","004","00","070","0002","0363","166","116","50","3","169","384","0","44.01","30.21"
"10","004","00","070","0003","0000","363","274","89","5","368","934","0","39.40","29.34"
"10","004","00","070","0003","0365","363","274","89","5","368","934","0","39.40","29.34"
"10","004","00","070","0004","0000","156","118","38","3","159","409","0","38.88","28.85"
"10","004","00","070","0004","0366","156","118","38","3","159","409","0","38.88","28.85"
"10","004","00","070","0005","0000","1017","692","325","10","1027","2655","0","38.68","26.06"
"10","004","00","070","0005","0367","508","356","152","2","510","1267","0","40.25","28.10"
"10","004","00","070","0005","0368","509","336","173","8","517","1388","0","37.25","24.21"
"10","004","00","070","0006","0000","587","374","213","10","597","1577","0","37.86","23.72"
"10","004","00","070","0006","0369","300","184","116","6","306","787","0","38.88","23.38"
"10","004","00","070","0006","0370","287","190","97","4","291","790","0","36.84","24.05"
"10","004","00","070","0007","0000","240","172","68","3","243","626","0","38.82","27.48"
"10","004","00","070","0007","0371","240","172","68","3","243","626","0","38.82","27.48"
"10","004","00","070","0008","0000","307","191","116","7","314","779","0","40.31","24.52"
"10","004","00","070","0008","0372","307","191","116","7","314","779","0","40.31","24.52"
"10","004","00","070","0009","0000","924","647","277","12","936","2349","0","39.85","27.54"
"10","004","00","070","0009","0373","444","289","155","7","451","1261","0","35.77","22.92"
"10","004","00","070","0009","0374","480","358","122","5","485","1088","0","44.58","32.90"
"10","004","00","070","0010","0000","654","401","253","11","665","1559","0","42.66","25.72"
"10","004","00","070","0010","0375","289","176","113","8","297","681","0","43.61","25.84"
"10","004","00","070","0010","0376","365","225","140","3","368","878","0","41.91","25.63"
"10","004","00","070","0011","0000","1987","1272","715","19","2006","4643","0","43.20","27.40"
"10","004","00","070","0011","0377","507","335","172","7","514","1165","0","44.12","28.76"
"10","004","00","070","0011","0378","573","372","201","7","580","1366","0","42.46","27.23"
"10","004","00","070","0011","0379","524","308","216","2","526","1047","0","50.24","29.42"
"10","004","00","070","0011","0380","383","257","126","3","386","1065","0","36.24","24.13"
"10","004","00","070","0012","0000","481","310","171","6","487","1098","0","44.35","28.23"
"10","004","00","070","0012","0381","481","310","171","6","487","1098","0","44.35","28.23"
"10","004","00","080","0000","0000","4315","3069","1246","71","4386","11007","12408","39.85","27.88"
"10","004","00","080","0001","0000","1219","858","361","19","1238","3300","0","37.52","26.00"
"10","004","00","080","0001","0382","478","334","144","8","486","1176","0","41.33","28.40"
"10","004","00","080","0001","0383","370","260","110","6","376","1021","0","36.83","25.47"
"10","004","00","080","0001","0384","371","264","107","5","376","1103","0","34.09","23.93"
"10","004","00","080","0002","0000","341","217","124","6","347","847","0","40.97","25.62"
"10","004","00","080","0002","0385","341","217","124","6","347","847","0","40.97","25.62"
"10","004","00","080","0003","0000","79","57","22","1","80","180","0","44.44","31.67"
"10","004","00","080","0003","0386","79","57","22","1","80","180","0","44.44","31.67"
"10","004","00","080","0004","0000","75","43","32","2","77","203","0","37.93","21.18"
"10","004","00","080","0004","0387","75","43","32","2","77","203","0","37.93","21.18"
"10","004","00","080","0005","0000","121","86","35","1","122","320","0","38.13","26.88"
"10","004","00","080","0005","0388","121","86","35","1","122","320","0","38.13","26.88"
"10","004","00","080","0006","0000","343","241","102","7","350","882","0","39.68","27.32"
"10","004","00","080","0006","0389","343","241","102","7","350","882","0","39.68","27.32"
"10","004","00","080","0007","0000","164","106","58","2","166","419","0","39.62","25.30"
"10","004","00","080","0007","0392","164","106","58","2","166","419","0","39.62","25.30"
"10","004","00","080","0008","0000","411","271","140","7","418","938","0","44.56","28.89"
"10","004","00","080","0008","0393","293","198","95","7","300","675","0","44.44","29.33"
"10","004","00","080","0008","0394","118","73","45","0","118","263","0","44.87","27.76"
"10","004","00","080","0009","0000","623","466","157","11","634","1488","0","42.61","31.32"
"10","004","00","080","0009","0395","271","205","66","4","275","661","0","41.60","31.01"
"10","004","00","080","0009","0396","352","261","91","7","359","827","0","43.41","31.56"
"10","004","00","080","0010","0000","603","477","126","9","612","1628","0","37.59","29.30"
"10","004","00","080","0010","0397","314","255","59","4","318","832","0","38.22","30.65"
"10","004","00","080","0010","0398","289","222","67","5","294","796","0","36.93","27.89"
"10","004","00","080","0011","0000","336","247","89","6","342","802","0","42.64","30.80"
"10","004","00","080","0011","0390","141","101","40","1","142","273","0","52.01","37.00"
"10","004","00","080","0011","0391","195","146","49","5","200","529","0","37.81","27.60"
"10","004","00","090","0000","0000","2940","2001","939","28","2968","7870","8864","37.71","25.43"
"10","004","00","090","0001","0000","414","275","139","1","415","1117","0","37.15","24.62"
"10","004","00","090","0001","0399","414","275","139","1","415","1117","0","37.15","24.62"
"10","004","00","090","0002","0000","414","295","119","8","422","1142","0","36.95","25.83"
"10","004","00","090","0002","0400","414","295","119","8","422","1142","0","36.95","25.83"
"10","004","00","090","0003","0000","932","621","311","11","943","2547","0","37.02","24.38"
"10","004","00","090","0003","0402","357","239","118","4","361","918","0","39.32","26.03"
"10","004","00","090","0003","0403","286","192","94","3","289","793","0","36.44","24.21"
"10","004","00","090","0003","0404","289","190","99","4","293","836","0","35.05","22.73"
"10","004","00","090","0004","0000","280","179","101","2","282","818","0","34.47","21.88"
"10","004","00","090","0004","0405","280","179","101","2","282","818","0","34.47","21.88"
"10","004","00","090","0005","0000","181","129","52","0","181","363","0","49.86","35.54"
"10","004","00","090","0005","0406","181","129","52","0","181","363","0","49.86","35.54"
"10","004","00","090","0006","0000","271","199","72","1","272","720","0","37.78","27.64"
"10","004","00","090","0006","0407","271","199","72","1","272","720","0","37.78","27.64"
"10","004","00","090","0007","0000","185","133","52","2","187","541","0","34.57","24.58"
"10","004","00","090","0007","0401","185","133","52","2","187","541","0","34.57","24.58"
"10","004","00","090","0008","0000","142","97","45","2","144","325","0","44.31","29.85"
"10","004","00","090","0008","0408","142","97","45","2","144","325","0","44.31","29.85"
"10","004","00","090","0009","0000","121","73","48","1","122","297","0","41.08","24.58"
"10","004","00","090","0009","0409","121","73","48","1","122","297","0","41.08","24.58"
"10","004","00","100","0000","0000","5143","3241","1902","42","5185","13015","14570","39.84","24.90"
"10","004","00","100","0001","0000","1014","619","395","8","1022","2659","0","38.44","23.28"
"10","004","00","100","0001","0410","393","242","151","0","393","1101","0","35.69","21.98"
"10","004","00","100","0001","0411","621","377","244","8","629","1558","0","40.37","24.20"
"10","004","00","100","0002","0000","873","550","323","7","880","2006","0","43.87","27.42"
"10","004","00","100","0002","0414","460","302","158","2","462","975","0","47.38","30.97"
"10","004","00","100","0002","0415","413","248","165","5","418","1031","0","40.54","24.05"
"10","004","00","100","0003","0000","399","249","150","5","404","1015","0","39.80","24.53"
"10","004","00","100","0003","0416","399","249","150","5","404","1015","0","39.80","24.53"
"10","004","00","100","0004","0000","426","259","167","4","430","1168","0","36.82","22.17"
"10","004","00","100","0004","0417","426","259","167","4","430","1168","0","36.82","22.17"
"10","004","00","100","0005","0000","326","211","115","1","327","794","0","41.18","26.57"
"10","004","00","100","0005","0419","326","211","115","1","327","794","0","41.18","26.57"
"10","004","00","100","0006","0000","229","155","74","4","233","731","0","31.87","21.20"
"10","004","00","100","0006","0418","229","155","74","4","233","731","0","31.87","21.20"
"10","004","00","100","0007","0000","249","154","95","0","249","541","0","46.03","28.47"
"10","004","00","100","0007","0422","249","154","95","0","249","541","0","46.03","28.47"
"10","004","00","100","0008","0000","344","228","116","3","347","847","0","40.97","26.92"
"10","004","00","100","0008","0420","344","228","116","3","347","847","0","40.97","26.92"
"10","004","00","100","0009","0000","251","166","85","1","252","578","0","43.60","28.72"
"10","004","00","100","0009","0421","251","166","85","1","252","578","0","43.60","28.72"
"10","004","00","100","0010","0000","1032","650","382","9","1041","2676","0","38.90","24.29"
"10","004","00","100","0010","0412","585","353","232","5","590","1507","0","39.15","23.42"
"10","004","00","100","0010","0413","447","297","150","4","451","1169","0","38.58","25.41"
"10","004","00","110","0000","0000","1947","1246","701","21","1968","4838","5323","40.68","25.75"
"10","004","00","110","0001","0000","368","261","107","7","375","815","0","46.01","32.02"
"10","004","00","110","0001","0423","368","261","107","7","375","815","0","46.01","32.02"
"10","004","00","110","0002","0000","269","153","116","4","273","665","0","41.05","23.01"
"10","004","00","110","0002","0424","269","153","116","4","273","665","0","41.05","23.01"
"10","004","00","110","0003","0000","241","161","80","1","242","563","0","42.98","28.60"
"10","004","00","110","0003","0425","241","161","80","1","242","563","0","42.98","28.60"
"10","004","00","110","0004","0000","492","325","167","4","496","1340","0","37.01","24.25"
"10","004","00","110","0004","0428","239","170","69","3","242","646","0","37.46","26.32"
"10","004","00","110","0004","0429","253","155","98","1","254","694","0","36.60","22.33"
"10","004","00","110","0005","0000","246","157","89","3","249","605","0","41.16","25.95"
"10","004","00","110","0005","0426","140","92","48","3","143","343","0","41.69","26.82"
"10","004","00","110","0005","0427","106","65","41","0","106","262","0","40.46","24.81"
"10","004","00","110","0006","0000","331","189","142","2","333","850","0","39.18","22.24"
"10","004","00","110","0006","0430","187","111","76","0","187","448","0","41.74","24.78"
"10","004","00","110","0006","0431","144","78","66","2","146","402","0","36.32","19.40"
"10","004","00","120","0000","0000","1706","1349","357","23","1729","7360","9561","23.49","18.33"
"10","004","00","120","0001","0000","166","123","43","3","169","587","0","28.79","20.95"
"10","004","00","120","0001","0434","69","45","24","0","69","217","0","31.80","20.74"
"10","004","00","120","0001","0435","97","78","19","3","100","370","0","27.03","21.08"
"10","004","00","120","0002","0000","268","214","54","3","271","818","0","33.13","26.16"
"10","004","00","120","0002","0432","145","119","26","2","147","457","0","32.17","26.04"
"10","004","00","120","0002","0433","123","95","28","1","124","361","0","34.35","26.32"
"10","004","00","120","0003","0000","313","270","43","5","318","1210","0","26.28","22.31"
"10","004","00","120","0003","0436","206","176","30","4","210","734","0","28.61","23.98"
"10","004","00","120","0003","0437","107","94","13","1","108","476","0","22.69","19.75"
"10","004","00","120","0004","0000","201","169","32","3","204","626","0","32.59","27.00"
"10","004","00","120","0004","0440","201","169","32","3","204","626","0","32.59","27.00"
"10","004","00","120","0005","0000","257","212","45","1","258","1161","0","22.22","18.26"
"10","004","00","120","0005","0438","110","90","20","1","111","532","0","20.86","16.92"
"10","004","00","120","0005","0439","147","122","25","0","147","629","0","23.37","19.40"
"10","004","00","120","0006","0000","241","163","78","3","244","1329","0","18.36","12.26"
"10","004","00","120","0006","0441","110","86","24","1","111","613","0","18.11","14.03"
"10","004","00","120","0006","0442","84","58","26","2","86","589","0","14.60","9.85"
"10","004","00","120","0006","0443","47","19","28","0","47","127","0","37.01","14.96"
"10","004","00","120","0007","0000","260","198","62","5","265","1629","0","16.27","12.15"
"10","004","00","120","0007","0444","92","80","12","1","93","488","0","19.06","16.39"
"10","004","00","120","0007","0445","109","87","22","3","112","825","0","13.58","10.55"
"10","004","00","120","0007","0446","59","31","28","1","60","316","0","18.99","9.81"
"10","004","00","130","0000","0000","1004","785","219","16","1020","3736","4431","27.30","21.01"
"10","004","00","130","0001","0000","343","300","43","7","350","1281","0","27.32","23.42"
"10","004","00","130","0001","0447","171","155","16","3","174","632","0","27.53","24.53"
"10","004","00","130","0001","0448","172","145","27","4","176","649","0","27.12","22.34"
"10","004","00","130","0002","0000","204","154","50","2","206","711","0","28.97","21.66"
"10","004","00","130","0002","0451","204","154","50","2","206","711","0","28.97","21.66"
"10","004","00","130","0003","0000","99","79","20","1","100","377","0","26.53","20.95"
"10","004","00","130","0003","0452","99","79","20","1","100","377","0","26.53","20.95"
"10","004","00","130","0004","0000","358","252","106","6","364","1367","0","26.63","18.43"
"10","004","00","130","0004","0449","143","101","42","2","145","535","0","27.10","18.88"
"10","004","00","130","0004","0450","215","151","64","4","219","832","0","26.32","18.15"
"10","005","00","000","0000","0000","169803","106512","63291","1752","171555","457991","540312","37.46","23.26"
"10","005","00","010","0000","0000","29539","20716","8823","249","29788","73644","87384","40.45","28.13"
"10","005","00","010","0001","0000","478","337","141","1","479","1116","0","42.92","30.20"
"10","005","00","010","0001","0001","478","337","141","1","479","1116","0","42.92","30.20"
"10","005","00","010","0002","0000","1697","1228","469","9","1706","4048","0","42.14","30.34"
"10","005","00","010","0002","0049","410","296","114","0","410","1004","0","40.84","29.48"
"10","005","00","010","0002","0050","453","305","148","0","453","997","0","45.44","30.59"
"10","005","00","010","0002","0051","392","290","102","5","397","1050","0","37.81","27.62"
"10","005","00","010","0002","0052","442","337","105","4","446","997","0","44.73","33.80"
"10","005","00","010","0003","0000","360","240","120","5","365","1005","0","36.32","23.88"
"10","005","00","010","0003","0002","360","240","120","5","365","1005","0","36.32","23.88"
"10","005","00","010","0004","0000","1032","764","268","7","1039","2166","0","47.97","35.27"
"10","005","00","010","0004","0009","521","381","140","5","526","1082","0","48.61","35.21"
"10","005","00","010","0004","0010","511","383","128","2","513","1084","0","47.32","35.33"
"10","005","00","010","0005","0000","1532","1130","402","14","1546","3579","0","43.20","31.57"
"10","005","00","010","0005","0011","435","294","141","4","439","1096","0","40.05","26.82"
"10","005","00","010","0005","0012","528","409","119","5","533","1248","0","42.71","32.77"
"10","005","00","010","0005","0013","569","427","142","5","574","1235","0","46.48","34.57"
"10","005","00","010","0006","0000","1495","1095","400","16","1511","3590","0","42.09","30.50"
"10","005","00","010","0006","0006","524","387","137","8","532","1189","0","44.74","32.55"
"10","005","00","010","0006","0007","522","400","122","0","522","1272","0","41.04","31.45"
"10","005","00","010","0006","0008","449","308","141","8","457","1129","0","40.48","27.28"
"10","005","00","010","0007","0000","1229","905","324","7","1236","3260","0","37.91","27.76"
"10","005","00","010","0007","0003","412","317","95","2","414","1093","0","37.88","29.00"
"10","005","00","010","0007","0004","414","305","109","2","416","1088","0","38.24","28.03"
"10","005","00","010","0007","0005","403","283","120","3","406","1079","0","37.63","26.23"
"10","005","00","010","0008","0000","320","229","91","3","323","805","0","40.12","28.45"
"10","005","00","010","0008","0014","320","229","91","3","323","805","0","40.12","28.45"
"10","005","00","010","0009","0000","1210","842","368","3","1213","3216","0","37.72","26.18"
"10","005","00","010","0009","0015","353","242","111","0","353","963","0","36.66","25.13"
"10","005","00","010","0009","0016","411","282","129","2","413","1117","0","36.97","25.25"
"10","005","00","010","0009","0017","446","318","128","1","447","1136","0","39.35","27.99"
"10","005","00","010","0010","0000","362","218","144","6","368","856","0","42.99","25.47"
"10","005","00","010","0010","0019","362","218","144","6","368","856","0","42.99","25.47"
"10","005","00","010","0011","0000","230","151","79","4","234","497","0","47.08","30.38"
"10","005","00","010","0011","0020","230","151","79","4","234","497","0","47.08","30.38"
"10","005","00","010","0012","0000","355","217","138","2","357","841","0","42.45","25.80"
"10","005","00","010","0012","0018","355","217","138","2","357","841","0","42.45","25.80"
"10","005","00","010","0013","0000","1650","1137","513","10","1660","3843","0","43.20","29.59"
"10","005","00","010","0013","0024","505","344","161","3","508","1203","0","42.23","28.60"
"10","005","00","010","0013","0025","482","345","137","2","484","1112","0","43.53","31.03"
"10","005","00","010","0013","0026","360","261","99","1","361","772","0","46.76","33.81"
"10","005","00","010","0013","0027","303","187","116","4","307","756","0","40.61","24.74"
"10","005","00","010","0014","0000","504","333","171","4","508","1333","0","38.11","24.98"
"10","005","00","010","0014","0021","504","333","171","4","508","1333","0","38.11","24.98"
"10","005","00","010","0015","0000","668","434","234","11","679","1503","0","45.18","28.88"
"10","005","00","010","0015","0031","271","196","75","7","278","574","0","48.43","34.15"
"10","005","00","010","0015","0032","397","238","159","4","401","929","0","43.16","25.62"
"10","005","00","010","0016","0000","2062","1428","634","28","2090","5025","0","41.59","28.42"
"10","005","00","010","0016","0033","508","359","149","5","513","1192","0","43.04","30.12"
"10","005","00","010","0016","0034","548","366","182","8","556","1433","0","38.80","25.54"
"10","005","00","010","0016","0035","483","339","144","8","491","1165","0","42.15","29.10"
"10","005","00","010","0016","0036","523","364","159","7","530","1235","0","42.91","29.47"
"10","005","00","010","0017","0000","1385","965","420","12","1397","3087","0","45.25","31.26"
"10","005","00","010","0017","0028","416","283","133","3","419","1000","0","41.90","28.30"
"10","005","00","010","0017","0029","513","373","140","7","520","1128","0","46.10","33.07"
"10","005","00","010","0017","0030","456","309","147","2","458","959","0","47.76","32.22"
"10","005","00","010","0018","0000","1380","979","401","13","1393","3365","0","41.40","29.09"
"10","005","00","010","0018","0037","489","348","141","7","496","1177","0","42.14","29.57"
"10","005","00","010","0018","0038","431","293","138","4","435","1042","0","41.75","28.12"
"10","005","00","010","0018","0039","460","338","122","2","462","1146","0","40.31","29.49"
"10","005","00","010","0019","0000","1574","1065","509","13","1587","4152","0","38.22","25.65"
"10","005","00","010","0019","0040","547","372","175","4","551","1409","0","39.11","26.40"
"10","005","00","010","0019","0041","504","348","156","2","506","1342","0","37.70","25.93"
"10","005","00","010","0019","0042","523","345","178","7","530","1401","0","37.83","24.63"
"10","005","00","010","0020","0000","440","301","139","8","448","1166","0","38.42","25.81"
"10","005","00","010","0020","0063","440","301","139","8","448","1166","0","38.42","25.81"
"10","005","00","010","0021","0000","1606","1110","496","7","1613","4041","0","39.92","27.47"
"10","005","00","010","0021","0057","530","368","162","3","533","1307","0","40.78","28.16"
"10","005","00","010","0021","0058","517","341","176","2","519","1350","0","38.44","25.26"
"10","005","00","010","0021","0059","559","401","158","2","561","1384","0","40.53","28.97"
"10","005","00","010","0022","0000","2051","1477","574","14","2065","5344","0","38.64","27.64"
"10","005","00","010","0022","0053","412","297","115","2","414","1079","0","38.37","27.53"
"10","005","00","010","0022","0054","464","347","117","0","464","1165","0","39.83","29.79"
"10","005","00","010","0022","0055","625","448","177","9","634","1484","0","42.72","30.19"
"10","005","00","010","0022","0056","550","385","165","3","553","1616","0","34.22","23.82"
"10","005","00","010","0023","0000","939","647","292","9","948","2448","0","38.73","26.43"
"10","005","00","010","0023","0022","518","352","166","5","523","1382","0","37.84","25.47"
"10","005","00","010","0023","0023","421","295","126","4","425","1066","0","39.87","27.67"
"10","005","00","010","0024","0000","570","382","188","6","576","1664","0","34.62","22.96"
"10","005","00","010","0024","0066","265","197","68","4","269","793","0","33.92","24.84"
"10","005","00","010","0024","0067","305","185","120","2","307","871","0","35.25","21.24"
"10","005","00","010","0025","0000","1260","881","379","8","1268","3443","0","36.83","25.59"
"10","005","00","010","0025","0043","467","310","157","3","470","1250","0","37.60","24.80"
"10","005","00","010","0025","0044","394","279","115","2","396","984","0","40.24","28.35"
"10","005","00","010","0025","0045","399","292","107","3","402","1209","0","33.25","24.15"
"10","005","00","010","0026","0000","1242","899","343","12","1254","2769","0","45.29","32.47"
"10","005","00","010","0026","0046","396","289","107","3","399","998","0","39.98","28.96"
"10","005","00","010","0026","0047","400","298","102","8","408","835","0","48.86","35.69"
"10","005","00","010","0026","0048","446","312","134","1","447","936","0","47.76","33.33"
"10","005","00","010","0027","0000","644","455","189","6","650","1926","0","33.75","23.62"
"10","005","00","010","0027","0064","349","241","108","2","351","1039","0","33.78","23.20"
"10","005","00","010","0027","0065","295","214","81","4","299","887","0","33.71","24.13"
"10","005","00","010","0028","0000","1264","867","397","11","1275","3556","0","35.85","24.38"
"10","005","00","010","0028","0060","492","355","137","4","496","1274","0","38.93","27.86"
"10","005","00","010","0028","0061","472","319","153","4","476","1390","0","34.24","22.95"
"10","005","00","010","0028","0062","300","193","107","3","303","892","0","33.97","21.64"
"10","005","00","020","0000","0000","13642","6133","7509","124","13766","38502","44437","35.75","15.93"
"10","005","00","020","0001","0000","817","385","432","10","827","2145","0","38.55","17.95"
"10","005","00","020","0001","0068","354","173","181","7","361","847","0","42.62","20.43"
"10","005","00","020","0001","0069","463","212","251","3","466","1298","0","35.90","16.33"
"10","005","00","020","0002","0000","603","280","323","2","605","1435","0","42.16","19.51"
"10","005","00","020","0002","0070","354","169","185","1","355","754","0","47.08","22.41"
"10","005","00","020","0002","0071","249","111","138","1","250","681","0","36.71","16.30"
"10","005","00","020","0003","0000","366","160","206","1","367","878","0","41.80","18.22"
"10","005","00","020","0003","0072","366","160","206","1","367","878","0","41.80","18.22"
"10","005","00","020","0004","0000","572","228","344","6","578","1612","0","35.86","14.14"
"10","005","00","020","0004","0073","294","142","152","3","297","832","0","35.70","17.07"
"10","005","00","020","0004","0074","278","86","192","3","281","780","0","36.03","11.03"
"10","005","00","020","0005","0000","417","129","288","6","423","1191","0","35.52","10.83"
"10","005","00","020","0005","0075","417","129","288","6","423","1191","0","35.52","10.83"
"10","005","00","020","0006","0000","707","304","403","8","715","1961","0","36.46","15.50"
"10","005","00","020","0006","0076","420","193","227","6","426","1130","0","37.70","17.08"
"10","005","00","020","0006","0077","287","111","176","2","289","831","0","34.78","13.36"
"10","005","00","020","0007","0000","342","139","203","4","346","1037","0","33.37","13.40"
"10","005","00","020","0007","0078","342","139","203","4","346","1037","0","33.37","13.40"
"10","005","00","020","0008","0000","774","360","414","3","777","2186","0","35.54","16.47"
"10","005","00","020","0008","0079","391","191","200","0","391","1098","0","35.61","17.40"
"10","005","00","020","0008","0080","383","169","214","3","386","1088","0","35.48","15.53"
"10","005","00","020","0009","0000","1517","701","816","12","1529","3952","0","38.69","17.74"
"10","005","00","020","0009","0081","518","238","280","4","522","1415","0","36.89","16.82"
"10","005","00","020","0009","0082","479","218","261","5","484","1285","0","37.67","16.96"
"10","005","00","020","0009","0083","520","245","275","3","523","1252","0","41.77","19.57"
"10","005","00","020","0010","0000","712","321","391","5","717","2128","0","33.69","15.08"
"10","005","00","020","0010","0084","359","158","201","3","362","1054","0","34.35","14.99"
"10","005","00","020","0010","0085","353","163","190","2","355","1074","0","33.05","15.18"
"10","005","00","020","0011","0000","285","101","184","0","285","912","0","31.25","11.07"
"10","005","00","020","0011","0086","285","101","184","0","285","912","0","31.25","11.07"
"10","005","00","020","0012","0000","221","77","144","3","224","628","0","35.67","12.26"
"10","005","00","020","0012","0087","221","77","144","3","224","628","0","35.67","12.26"
"10","005","00","020","0013","0000","535","257","278","6","541","1353","0","39.99","18.99"
"10","005","00","020","0013","0088","535","257","278","6","541","1353","0","39.99","18.99"
"10","005","00","020","0014","0000","483","227","256","3","486","1350","0","36.00","16.81"
"10","005","00","020","0014","0089","241","85","156","1","242","665","0","36.39","12.78"
"10","005","00","020","0014","0090","242","142","100","2","244","685","0","35.62","20.73"
"10","005","00","020","0015","0000","623","294","329","10","633","1788","0","35.40","16.44"
"10","005","00","020","0015","0091","321","144","177","6","327","893","0","36.62","16.13"
"10","005","00","020","0015","0092","302","150","152","4","306","895","0","34.19","16.76"
"10","005","00","020","0016","0000","427","196","231","3","430","1235","0","34.82","15.87"
"10","005","00","020","0016","0093","427","196","231","3","430","1235","0","34.82","15.87"
"10","005","00","020","0017","0000","186","96","90","1","187","546","0","34.25","17.58"
"10","005","00","020","0017","0094","186","96","90","1","187","546","0","34.25","17.58"
"10","005","00","020","0018","0000","276","149","127","1","277","770","0","35.97","19.35"
"10","005","00","020","0018","0095","276","149","127","1","277","770","0","35.97","19.35"
"10","005","00","020","0019","0000","771","345","426","9","780","2413","0","32.32","14.30"
"10","005","00","020","0019","0103","362","171","191","5","367","1137","0","32.28","15.04"
"10","005","00","020","0019","0104","409","174","235","4","413","1276","0","32.37","13.64"
"10","005","00","020","0020","0000","567","211","356","7","574","1649","0","34.81","12.80"
"10","005","00","020","0020","0097","298","111","187","2","300","881","0","34.05","12.60"
"10","005","00","020","0020","0098","269","100","169","5","274","768","0","35.68","13.02"
"10","005","00","020","0021","0000","562","282","280","8","570","1604","0","35.54","17.58"
"10","005","00","020","0021","0099","270","173","97","4","274","781","0","35.08","22.15"
"10","005","00","020","0021","0100","292","109","183","4","296","823","0","35.97","13.24"
"10","005","00","020","0022","0000","557","254","303","5","562","1758","0","31.97","14.45"
"10","005","00","020","0022","0101","273","109","164","1","274","827","0","33.13","13.18"
"10","005","00","020","0022","0102","284","145","139","4","288","931","0","30.93","15.57"
"10","005","00","020","0023","0000","221","85","136","4","225","680","0","33.09","12.50"
"10","005","00","020","0023","0096","221","85","136","4","225","680","0","33.09","12.50"
"10","005","00","020","0024","0000","438","226","212","5","443","1419","0","31.22","15.93"
"10","005","00","020","0024","0105","438","226","212","5","443","1419","0","31.22","15.93"
"10","005","00","020","0025","0000","663","326","337","2","665","1872","0","35.52","17.41"
"10","005","00","020","0025","0106","356","191","165","1","357","987","0","36.17","19.35"
"10","005","00","020","0025","0107","307","135","172","1","308","885","0","34.80","15.25"
"10","005","00","030","0000","0000","9722","4646","5076","118","9840","28819","32701","34.14","16.12"
"10","005","00","030","0001","0000","405","188","217","6","411","1064","0","38.63","17.67"
"10","005","00","030","0001","0108","405","188","217","6","411","1064","0","38.63","17.67"
"10","005","00","030","0002","0000","791","370","421","7","798","1916","0","41.65","19.31"
"10","005","00","030","0002","0109","381","163","218","6","387","864","0","44.79","18.87"
"10","005","00","030","0002","0110","410","207","203","1","411","1052","0","39.07","19.68"
"10","005","00","030","0003","0000","719","318","401","9","728","1805","0","40.33","17.62"
"10","005","00","030","0003","0111","366","152","214","3","369","973","0","37.92","15.62"
"10","005","00","030","0003","0112","353","166","187","6","359","832","0","43.15","19.95"
"10","005","00","030","0004","0000","518","222","296","5","523","1531","0","34.16","14.50"
"10","005","00","030","0004","0116","262","129","133","4","266","737","0","36.09","17.50"
"10","005","00","030","0004","0117","256","93","163","1","257","794","0","32.37","11.71"
"10","005","00","030","0005","0000","247","112","135","3","250","676","0","36.98","16.57"
"10","005","00","030","0005","0115","247","112","135","3","250","676","0","36.98","16.57"
"10","005","00","030","0006","0000","877","421","456","4","881","2637","0","33.41","15.97"
"10","005","00","030","0006","0118","345","171","174","0","345","929","0","37.14","18.41"
"10","005","00","030","0006","0119","304","134","170","4","308","938","0","32.84","14.29"
"10","005","00","030","0006","0120","228","116","112","0","228","770","0","29.61","15.06"
"10","005","00","030","0007","0000","223","103","120","4","227","658","0","34.50","15.65"
"10","005","00","030","0007","0127","223","103","120","4","227","658","0","34.50","15.65"
"10","005","00","030","0008","0000","311","137","174","11","322","903","0","35.66","15.17"
"10","005","00","030","0008","0128","311","137","174","11","322","903","0","35.66","15.17"
"10","005","00","030","0009","0000","291","120","171","3","294","769","0","38.23","15.60"
"10","005","00","030","0009","0129","291","120","171","3","294","769","0","38.23","15.60"
"10","005","00","030","0010","0000","224","118","106","5","229","622","0","36.82","18.97"
"10","005","00","030","0010","0130","224","118","106","5","229","622","0","36.82","18.97"
"10","005","00","030","0011","0000","395","221","174","5","400","1189","0","33.64","18.59"
"10","005","00","030","0011","0131","395","221","174","5","400","1189","0","33.64","18.59"
"10","005","00","030","0012","0000","441","217","224","5","446","1325","0","33.66","16.38"
"10","005","00","030","0012","0132","441","217","224","5","446","1325","0","33.66","16.38"
"10","005","00","030","0013","0000","458","198","260","4","462","1379","0","33.50","14.36"
"10","005","00","030","0013","0133","245","121","124","1","246","628","0","39.17","19.27"
"10","005","00","030","0013","0134","213","77","136","3","216","751","0","28.76","10.25"
"10","005","00","030","0014","0000","528","255","273","4","532","1822","0","29.20","14.00"
"10","005","00","030","0014","0121","205","90","115","1","206","734","0","28.07","12.26"
"10","005","00","030","0014","0122","323","165","158","3","326","1088","0","29.96","15.17"
"10","005","00","030","0015","0000","145","80","65","0","145","415","0","34.94","19.28"
"10","005","00","030","0015","0123","145","80","65","0","145","415","0","34.94","19.28"
"10","005","00","030","0016","0000","292","189","103","4","296","856","0","34.58","22.08"
"10","005","00","030","0016","0124","292","189","103","4","296","856","0","34.58","22.08"
"10","005","00","030","0017","0000","123","78","45","1","124","385","0","32.21","20.26"
"10","005","00","030","0017","0125","123","78","45","1","124","385","0","32.21","20.26"
"10","005","00","030","0018","0000","226","122","104","4","230","770","0","29.87","15.84"
"10","005","00","030","0018","0126","226","122","104","4","230","770","0","29.87","15.84"
"10","005","00","030","0019","0000","624","312","312","9","633","2187","0","28.94","14.27"
"10","005","00","030","0019","0135","321","149","172","3","324","1075","0","30.14","13.86"
"10","005","00","030","0019","0136","303","163","140","6","309","1112","0","27.79","14.66"
"10","005","00","030","0020","0000","334","116","218","6","340","1078","0","31.54","10.76"
"10","005","00","030","0020","0137","334","116","218","6","340","1078","0","31.54","10.76"
"10","005","00","030","0021","0000","221","94","127","2","223","709","0","31.45","13.26"
"10","005","00","030","0021","0138","221","94","127","2","223","709","0","31.45","13.26"
"10","005","00","030","0022","0000","425","225","200","5","430","1405","0","30.60","16.01"
"10","005","00","030","0022","0139","224","121","103","3","227","607","0","37.40","19.93"
"10","005","00","030","0022","0140","201","104","97","2","203","798","0","25.44","13.03"
"10","005","00","030","0023","0000","227","109","118","4","231","709","0","32.58","15.37"
"10","005","00","030","0023","0141","227","109","118","4","231","709","0","32.58","15.37"
"10","005","00","030","0024","0000","677","321","356","8","685","2009","0","34.10","15.98"
"10","005","00","030","0024","0113","356","174","182","1","357","1023","0","34.90","17.01"
"10","005","00","030","0024","0114","321","147","174","7","328","986","0","33.27","14.91"
"10","005","00","040","0000","0000","26340","14959","11381","250","26590","70266","87307","37.84","21.29"
"10","005","00","040","0001","0000","813","463","350","2","815","1893","0","43.05","24.46"
"10","005","00","040","0001","0142","431","234","197","0","431","987","0","43.67","23.71"
"10","005","00","040","0001","0143","382","229","153","2","384","906","0","42.38","25.28"
"10","005","00","040","0002","0000","1437","786","651","17","1454","3293","0","44.15","23.87"
"10","005","00","040","0002","0144","414","214","200","3","417","998","0","41.78","21.44"
"10","005","00","040","0002","0145","585","362","223","7","592","1310","0","45.19","27.63"
"10","005","00","040","0002","0146","438","210","228","7","445","985","0","45.18","21.32"
"10","005","00","040","0003","0000","972","517","455","3","975","2715","0","35.91","19.04"
"10","005","00","040","0003","0147","541","285","256","1","542","1453","0","37.30","19.61"
"10","005","00","040","0003","0148","431","232","199","2","433","1262","0","34.31","18.38"
"10","005","00","040","0004","0000","1998","1128","870","23","2021","4759","0","42.47","23.70"
"10","005","00","040","0004","0149","470","262","208","5","475","1184","0","40.12","22.13"
"10","005","00","040","0004","0150","476","292","184","4","480","1125","0","42.67","25.96"
"10","005","00","040","0004","0151","496","279","217","2","498","1162","0","42.86","24.01"
"10","005","00","040","0004","0152","556","295","261","12","568","1288","0","44.10","22.90"
"10","005","00","040","0005","0000","2102","1294","808","21","2123","5205","0","40.79","24.86"
"10","005","00","040","0005","0153","522","288","234","4","526","1227","0","42.87","23.47"
"10","005","00","040","0005","0154","466","290","176","5","471","1235","0","38.14","23.48"
"10","005","00","040","0005","0155","319","201","118","5","324","667","0","48.58","30.13"
"10","005","00","040","0005","0156","439","272","167","6","445","1123","0","39.63","24.22"
"10","005","00","040","0005","0157","356","243","113","1","357","953","0","37.46","25.50"
"10","005","00","040","0006","0000","1328","692","636","12","1340","3484","0","38.46","19.86"
"10","005","00","040","0006","0158","389","180","209","3","392","1039","0","37.73","17.32"
"10","005","00","040","0006","0159","470","251","219","5","475","1134","0","41.89","22.13"
"10","005","00","040","0006","0160","469","261","208","4","473","1311","0","36.08","19.91"
"10","005","00","040","0007","0000","1366","793","573","9","1375","3366","0","40.85","23.56"
"10","005","00","040","0007","0161","471","267","204","3","474","1179","0","40.20","22.65"
"10","005","00","040","0007","0162","415","258","157","1","416","1066","0","39.02","24.20"
"10","005","00","040","0007","0163","480","268","212","5","485","1121","0","43.26","23.91"
"10","005","00","040","0008","0000","1047","587","460","9","1056","3259","0","32.40","18.01"
"10","005","00","040","0008","0164","407","250","157","5","412","1246","0","33.07","20.06"
"10","005","00","040","0008","0165","301","169","132","2","303","956","0","31.69","17.68"
"10","005","00","040","0008","0166","339","168","171","2","341","1057","0","32.26","15.89"
"10","005","00","040","0009","0000","752","434","318","4","756","2041","0","37.04","21.26"
"10","005","00","040","0009","0171","365","211","154","2","367","1040","0","35.29","20.29"
"10","005","00","040","0009","0172","387","223","164","2","389","1001","0","38.86","22.28"
"10","005","00","040","0010","0000","1654","1025","629","19","1673","4916","0","34.03","20.85"
"10","005","00","040","0010","0173","380","220","160","3","383","1238","0","30.94","17.77"
"10","005","00","040","0010","0174","432","270","162","5","437","1034","0","42.26","26.11"
"10","005","00","040","0010","0175","401","265","136","5","406","1376","0","29.51","19.26"
"10","005","00","040","0010","0176","441","270","171","6","447","1268","0","35.25","21.29"
"10","005","00","040","0011","0000","404","224","180","4","408","1080","0","37.78","20.74"
"10","005","00","040","0011","0180","404","224","180","4","408","1080","0","37.78","20.74"
"10","005","00","040","0012","0000","1157","652","505","9","1166","2759","0","42.26","23.63"
"10","005","00","040","0012","0181","331","162","169","2","333","817","0","40.76","19.83"
"10","005","00","040","0012","0182","295","189","106","3","298","795","0","37.48","23.77"
"10","005","00","040","0012","0183","531","301","230","4","535","1147","0","46.64","26.24"
"10","005","00","040","0013","0000","538","316","222","1","539","1520","0","35.46","20.79"
"10","005","00","040","0013","0184","294","164","130","1","295","820","0","35.98","20.00"
"10","005","00","040","0013","0185","244","152","92","0","244","700","0","34.86","21.71"
"10","005","00","040","0014","0000","723","426","297","2","725","1941","0","37.35","21.95"
"10","005","00","040","0014","0186","377","223","154","0","377","973","0","38.75","22.92"
"10","005","00","040","0014","0187","346","203","143","2","348","968","0","35.95","20.97"
"10","005","00","040","0015","0000","438","228","210","4","442","1207","0","36.62","18.89"
"10","005","00","040","0015","0188","438","228","210","4","442","1207","0","36.62","18.89"
"10","005","00","040","0016","0000","1350","763","587","12","1362","4107","0","33.16","18.58"
"10","005","00","040","0016","0189","499","286","213","4","503","1463","0","34.38","19.55"
"10","005","00","040","0016","0190","439","250","189","6","445","1404","0","31.70","17.81"
"10","005","00","040","0016","0191","412","227","185","2","414","1240","0","33.39","18.31"
"10","005","00","040","0017","0000","824","458","366","10","834","2198","0","37.94","20.84"
"10","005","00","040","0017","0192","310","191","119","2","312","892","0","34.98","21.41"
"10","005","00","040","0017","0193","309","160","149","3","312","767","0","40.68","20.86"
"10","005","00","040","0017","0194","205","107","98","5","210","539","0","38.96","19.85"
"10","005","00","040","0018","0000","375","248","127","6","381","1138","0","33.48","21.79"
"10","005","00","040","0018","0195","375","248","127","6","381","1138","0","33.48","21.79"
"10","005","00","040","0019","0000","1558","868","690","12","1570","4771","0","32.91","18.19"
"10","005","00","040","0019","0196","702","412","290","6","708","2138","0","33.12","19.27"
"10","005","00","040","0019","0197","470","270","200","2","472","1483","0","31.83","18.21"
"10","005","00","040","0019","0198","386","186","200","4","390","1150","0","33.91","16.17"
"10","005","00","040","0020","0000","797","413","384","13","810","2066","0","39.21","19.99"
"10","005","00","040","0020","0199","417","199","218","7","424","1091","0","38.86","18.24"
"10","005","00","040","0020","0200","380","214","166","6","386","975","0","39.59","21.95"
"10","005","00","040","0021","0000","1402","774","628","15","1417","3817","0","37.12","20.28"
"10","005","00","040","0021","0201","213","125","88","1","214","529","0","40.45","23.63"
"10","005","00","040","0021","0202","389","231","158","6","395","1074","0","36.78","21.51"
"10","005","00","040","0021","0203","327","139","188","3","330","845","0","39.05","16.45"
"10","005","00","040","0021","0204","473","279","194","5","478","1369","0","34.92","20.38"
"10","005","00","040","0022","0000","362","198","164","7","369","1009","0","36.57","19.62"
"10","005","00","040","0022","0205","362","198","164","7","369","1009","0","36.57","19.62"
"10","005","00","040","0023","0000","1193","652","541","21","1214","3241","0","37.46","20.12"
"10","005","00","040","0023","0177","447","239","208","2","449","1141","0","39.35","20.95"
"10","005","00","040","0023","0178","391","228","163","10","401","1104","0","36.32","20.65"
"10","005","00","040","0023","0179","355","185","170","9","364","996","0","36.55","18.57"
"10","005","00","040","0024","0000","838","519","319","9","847","2154","0","39.32","24.09"
"10","005","00","040","0024","0169","491","323","168","5","496","1297","0","38.24","24.90"
"10","005","00","040","0024","0170","347","196","151","4","351","857","0","40.96","22.87"
"10","005","00","040","0025","0000","912","501","411","6","918","2327","0","39.45","21.53"
"10","005","00","040","0025","0167","462","256","206","2","464","1178","0","39.39","21.73"
"10","005","00","040","0025","0168","450","245","205","4","454","1149","0","39.51","21.32"
"10","005","00","050","0000","0000","31853","21724","10129","310","32163","85736","104902","37.51","25.34"
"10","005","00","050","0001","0000","708","482","226","9","717","2182","0","32.86","22.09"
"10","005","00","050","0001","0206","359","229","130","4","363","1109","0","32.73","20.65"
"10","005","00","050","0001","0207","349","253","96","5","354","1073","0","32.99","23.58"
"10","005","00","050","0002","0000","620","424","196","4","624","1710","0","36.49","24.80"
"10","005","00","050","0002","0208","317","238","79","2","319","886","0","36.00","26.86"
"10","005","00","050","0002","0209","303","186","117","2","305","824","0","37.01","22.57"
"10","005","00","050","0003","0000","1086","783","303","7","1093","2890","0","37.82","27.09"
"10","005","00","050","0003","0210","397","292","105","3","400","1058","0","37.81","27.60"
"10","005","00","050","0003","0211","369","273","96","1","370","934","0","39.61","29.23"
"10","005","00","050","0003","0212","320","218","102","3","323","898","0","35.97","24.28"
"10","005","00","050","0004","0000","1404","1025","379","24","1428","3743","0","38.15","27.38"
"10","005","00","050","0004","0213","470","340","130","10","480","1160","0","41.38","29.31"
"10","005","00","050","0004","0214","338","255","83","2","340","1030","0","33.01","24.76"
"10","005","00","050","0004","0215","596","430","166","12","608","1553","0","39.15","27.69"
"10","005","00","050","0005","0000","1631","1105","526","12","1643","4464","0","36.81","24.75"
"10","005","00","050","0005","0216","336","231","105","3","339","915","0","37.05","25.25"
"10","005","00","050","0005","0217","390","246","144","1","391","1209","0","32.34","20.35"
"10","005","00","050","0005","0218","536","386","150","7","543","1474","0","36.84","26.19"
"10","005","00","050","0005","0219","369","242","127","1","370","866","0","42.73","27.94"
"10","005","00","050","0006","0000","913","652","261","15","928","2565","0","36.18","25.42"
"10","005","00","050","0006","0220","544","398","146","6","550","1360","0","40.44","29.26"
"10","005","00","050","0006","0221","369","254","115","9","378","1205","0","31.37","21.08"
"10","005","00","050","0007","0000","367","236","131","6","373","1018","0","36.64","23.18"
"10","005","00","050","0007","0222","367","236","131","6","373","1018","0","36.64","23.18"
"10","005","00","050","0008","0000","1177","806","371","14","1191","3264","0","36.49","24.69"
"10","005","00","050","0008","0223","358","237","121","1","359","1061","0","33.84","22.34"
"10","005","00","050","0008","0224","413","313","100","9","422","1049","0","40.23","29.84"
"10","005","00","050","0008","0225","406","256","150","4","410","1154","0","35.53","22.18"
"10","005","00","050","0009","0000","1290","934","356","11","1301","3066","0","42.43","30.46"
"10","005","00","050","0009","0226","472","355","117","6","478","1018","0","46.95","34.87"
"10","005","00","050","0009","0227","421","296","125","4","425","1043","0","40.75","28.38"
"10","005","00","050","0009","0228","397","283","114","1","398","1005","0","39.60","28.16"
"10","005","00","050","0010","0000","575","380","195","4","579","1574","0","36.79","24.14"
"10","005","00","050","0010","0232","268","168","100","0","268","773","0","34.67","21.73"
"10","005","00","050","0010","0233","307","212","95","4","311","801","0","38.83","26.47"
"10","005","00","050","0011","0000","334","214","120","7","341","977","0","34.90","21.90"
"10","005","00","050","0011","0231","334","214","120","7","341","977","0","34.90","21.90"
"10","005","00","050","0012","0000","489","305","184","4","493","1036","0","47.59","29.44"
"10","005","00","050","0012","0238","489","305","184","4","493","1036","0","47.59","29.44"
"10","005","00","050","0013","0000","789","560","229","11","800","2007","0","39.86","27.90"
"10","005","00","050","0013","0261","392","287","105","6","398","998","0","39.88","28.76"
"10","005","00","050","0013","0262","397","273","124","5","402","1009","0","39.84","27.06"
"10","005","00","050","0014","0000","1539","1048","491","9","1548","4392","0","35.25","23.86"
"10","005","00","050","0014","0265","546","389","157","2","548","1497","0","36.61","25.99"
"10","005","00","050","0014","0266","486","334","152","7","493","1434","0","34.38","23.29"
"10","005","00","050","0014","0267","507","325","182","0","507","1461","0","34.70","22.25"
"10","005","00","050","0015","0000","1723","1084","639","9","1732","4339","0","39.92","24.98"
"10","005","00","050","0015","0242","566","353","213","4","570","1356","0","42.04","26.03"
"10","005","00","050","0015","0243","569","376","193","2","571","1486","0","38.43","25.30"
"10","005","00","050","0015","0244","588","355","233","3","591","1497","0","39.48","23.71"
"10","005","00","050","0016","0000","1535","1032","503","17","1552","4022","0","38.59","25.66"
"10","005","00","050","0016","0239","555","368","187","7","562","1294","0","43.43","28.44"
"10","005","00","050","0016","0240","504","325","179","5","509","1424","0","35.74","22.82"
"10","005","00","050","0016","0241","476","339","137","5","481","1304","0","36.89","26.00"
"10","005","00","050","0017","0000","1179","792","387","8","1187","3306","0","35.90","23.96"
"10","005","00","050","0017","0252","435","278","157","3","438","1129","0","38.80","24.62"
"10","005","00","050","0017","0253","413","300","113","3","416","1152","0","36.11","26.04"
"10","005","00","050","0017","0254","331","214","117","2","333","1025","0","32.49","20.88"
"10","005","00","050","0018","0000","1411","943","468","6","1417","3987","0","35.54","23.65"
"10","005","00","050","0018","0268","450","312","138","1","451","1266","0","35.62","24.64"
"10","005","00","050","0018","0269","480","309","171","4","484","1341","0","36.09","23.04"
"10","005","00","050","0018","0270","481","322","159","1","482","1380","0","34.93","23.33"
"10","005","00","050","0019","0000","500","291","209","7","507","1289","0","39.33","22.58"
"10","005","00","050","0019","0273","500","291","209","7","507","1289","0","39.33","22.58"
"10","005","00","050","0020","0000","643","412","231","11","654","2144","0","30.50","19.22"
"10","005","00","050","0020","0234","355","237","118","5","360","938","0","38.38","25.27"
"10","005","00","050","0020","0235","288","175","113","6","294","1206","0","24.38","14.51"
"10","005","00","050","0021","0000","887","603","284","8","895","2511","0","35.64","24.01"
"10","005","00","050","0021","0236","406","280","126","7","413","1185","0","34.85","23.63"
"10","005","00","050","0021","0237","481","323","158","1","482","1326","0","36.35","24.36"
"10","005","00","050","0022","0000","520","358","162","7","527","1295","0","40.69","27.64"
"10","005","00","050","0022","0274","520","358","162","7","527","1295","0","40.69","27.64"
"10","005","00","050","0023","0000","916","654","262","6","922","2511","0","36.72","26.05"
"10","005","00","050","0023","0276","472","356","116","4","476","1278","0","37.25","27.86"
"10","005","00","050","0023","0277","444","298","146","2","446","1233","0","36.17","24.17"
"10","005","00","050","0024","0000","364","259","105","8","372","878","0","42.37","29.50"
"10","005","00","050","0024","0275","364","259","105","8","372","878","0","42.37","29.50"
"10","005","00","050","0025","0000","824","597","227","13","837","2216","0","37.77","26.94"
"10","005","00","050","0025","0278","398","299","99","7","405","1068","0","37.92","28.00"
"10","005","00","050","0025","0279","426","298","128","6","432","1148","0","37.63","25.96"
"10","005","00","050","0026","0000","864","549","315","3","867","2277","0","38.08","24.11"
"10","005","00","050","0026","0263","447","288","159","0","447","1137","0","39.31","25.33"
"10","005","00","050","0026","0264","417","261","156","3","420","1140","0","36.84","22.89"
"10","005","00","050","0027","0000","822","555","267","11","833","2362","0","35.27","23.50"
"10","005","00","050","0027","0271","392","273","119","8","400","1222","0","32.73","22.34"
"10","005","00","050","0027","0272","430","282","148","3","433","1140","0","37.98","24.74"
"10","005","00","050","0028","0000","1377","1025","352","14","1391","3387","0","41.07","30.26"
"10","005","00","050","0028","0255","485","317","168","4","489","1261","0","38.78","25.14"
"10","005","00","050","0028","0256","456","406","50","3","459","1115","0","41.17","36.41"
"10","005","00","050","0028","0257","436","302","134","7","443","1011","0","43.82","29.87"
"10","005","00","050","0029","0000","1316","936","380","15","1331","3570","0","37.28","26.22"
"10","005","00","050","0029","0258","447","334","113","7","454","1144","0","39.69","29.20"
"10","005","00","050","0029","0259","466","312","154","3","469","1278","0","36.70","24.41"
"10","005","00","050","0029","0260","403","290","113","5","408","1148","0","35.54","25.26"
"10","005","00","050","0030","0000","782","516","266","2","784","1951","0","40.18","26.45"
"10","005","00","050","0030","0229","412","265","147","1","413","948","0","43.57","27.95"
"10","005","00","050","0030","0230","370","251","119","1","371","1003","0","36.99","25.02"
"10","005","00","050","0031","0000","917","625","292","9","926","2514","0","36.83","24.86"
"10","005","00","050","0031","0245","415","289","126","7","422","1206","0","34.99","23.96"
"10","005","00","050","0031","0246","502","336","166","2","504","1308","0","38.53","25.69"
"10","005","00","050","0032","0000","1341","854","487","13","1354","3515","0","38.52","24.30"
"10","005","00","050","0032","0247","400","271","129","2","402","1115","0","36.05","24.30"
"10","005","00","050","0032","0248","475","282","193","2","477","1131","0","42.18","24.93"
"10","005","00","050","0032","0249","466","301","165","9","475","1269","0","37.43","23.72"
"10","005","00","050","0033","0000","1010","685","325","6","1016","2774","0","36.63","24.69"
"10","005","00","050","0033","0250","526","393","133","3","529","1400","0","37.79","28.07"
"10","005","00","050","0033","0251","484","292","192","3","487","1374","0","35.44","21.25"
"10","005","00","060","0000","0000","10171","5532","4639","140","10311","30244","34941","34.09","18.29"
"10","005","00","060","0001","0000","456","250","206","10","466","1399","0","33.31","17.87"
"10","005","00","060","0001","0280","174","104","70","4","178","573","0","31.06","18.15"
"10","005","00","060","0001","0281","282","146","136","6","288","826","0","34.87","17.68"
"10","005","00","060","0002","0000","312","164","148","6","318","731","0","43.50","22.44"
"10","005","00","060","0002","0282","312","164","148","6","318","731","0","43.50","22.44"
"10","005","00","060","0003","0000","498","247","251","6","504","1248","0","40.38","19.79"
"10","005","00","060","0003","0283","248","110","138","3","251","623","0","40.29","17.66"
"10","005","00","060","0003","0284","250","137","113","3","253","625","0","40.48","21.92"
"10","005","00","060","0004","0000","1468","833","635","14","1482","4216","0","35.15","19.76"
"10","005","00","060","0004","0285","379","216","163","5","384","1108","0","34.66","19.49"
"10","005","00","060","0004","0286","430","230","200","5","435","1258","0","34.58","18.28"
"10","005","00","060","0004","0287","352","200","152","1","353","983","0","35.91","20.35"
"10","005","00","060","0004","0288","307","187","120","3","310","867","0","35.76","21.57"
"10","005","00","060","0005","0000","689","391","298","12","701","2258","0","31.05","17.32"
"10","005","00","060","0005","0303","329","189","140","4","333","1062","0","31.36","17.80"
"10","005","00","060","0005","0304","360","202","158","8","368","1196","0","30.77","16.89"
"10","005","00","060","0006","0000","512","362","150","4","516","1219","0","42.33","29.70"
"10","005","00","060","0006","0293","512","362","150","4","516","1219","0","42.33","29.70"
"10","005","00","060","0007","0000","393","275","118","5","398","1026","0","38.79","26.80"
"10","005","00","060","0007","0294","393","275","118","5","398","1026","0","38.79","26.80"
"10","005","00","060","0008","0000","847","484","363","14","861","2669","0","32.26","18.13"
"10","005","00","060","0008","0295","296","163","133","5","301","936","0","32.16","17.41"
"10","005","00","060","0008","0296","306","162","144","5","311","899","0","34.59","18.02"
"10","005","00","060","0008","0297","245","159","86","4","249","834","0","29.86","19.06"
"10","005","00","060","0009","0000","491","286","205","5","496","1304","0","38.04","21.93"
"10","005","00","060","0009","0298","264","151","113","2","266","685","0","38.83","22.04"
"10","005","00","060","0009","0299","227","135","92","3","230","619","0","37.16","21.81"
"10","005","00","060","0010","0000","241","117","124","2","243","679","0","35.79","17.23"
"10","005","00","060","0010","0300","241","117","124","2","243","679","0","35.79","17.23"
"10","005","00","060","0011","0000","444","221","223","5","449","1462","0","30.71","15.12"
"10","005","00","060","0011","0289","197","87","110","3","200","649","0","30.82","13.41"
"10","005","00","060","0011","0290","247","134","113","2","249","813","0","30.63","16.48"
"10","005","00","060","0012","0000","493","240","253","7","500","1503","0","33.27","15.97"
"10","005","00","060","0012","0301","246","123","123","2","248","723","0","34.30","17.01"
"10","005","00","060","0012","0302","247","117","130","5","252","780","0","32.31","15.00"
"10","005","00","060","0013","0000","378","178","200","10","388","1231","0","31.52","14.46"
"10","005","00","060","0013","0291","378","178","200","10","388","1231","0","31.52","14.46"
"10","005","00","060","0014","0000","307","146","161","4","311","957","0","32.50","15.26"
"10","005","00","060","0014","0292","307","146","161","4","311","957","0","32.50","15.26"
"10","005","00","060","0015","0000","302","186","116","3","305","982","0","31.06","18.94"
"10","005","00","060","0015","0305","302","186","116","3","305","982","0","31.06","18.94"
"10","005","00","060","0016","0000","270","124","146","4","274","897","0","30.55","13.82"
"10","005","00","060","0016","0306","270","124","146","4","274","897","0","30.55","13.82"
"10","005","00","060","0017","0000","242","116","126","1","243","682","0","35.63","17.01"
"10","005","00","060","0017","0307","242","116","126","1","243","682","0","35.63","17.01"
"10","005","00","060","0018","0000","336","168","168","7","343","1023","0","33.53","16.42"
"10","005","00","060","0018","0308","336","168","168","7","343","1023","0","33.53","16.42"
"10","005","00","060","0019","0000","209","112","97","4","213","591","0","36.04","18.95"
"10","005","00","060","0019","0309","209","112","97","4","213","591","0","36.04","18.95"
"10","005","00","060","0020","0000","406","183","223","7","413","1251","0","33.01","14.63"
"10","005","00","060","0020","0310","406","183","223","7","413","1251","0","33.01","14.63"
"10","005","00","060","0021","0000","214","107","107","2","216","718","0","30.08","14.90"
"10","005","00","060","0021","0311","214","107","107","2","216","718","0","30.08","14.90"
"10","005","00","060","0022","0000","305","168","137","5","310","1010","0","30.69","16.63"
"10","005","00","060","0022","0312","118","60","58","1","119","405","0","29.38","14.81"
"10","005","00","060","0022","0313","187","108","79","4","191","605","0","31.57","17.85"
"10","005","00","060","0023","0000","358","174","184","3","361","1188","0","30.39","14.65"
"10","005","00","060","0023","0314","219","120","99","3","222","720","0","30.83","16.67"
"10","005","00","060","0023","0315","139","54","85","0","139","468","0","29.70","11.54"
"10","005","00","070","0000","0000","5308","2718","2590","49","5357","14189","16007","37.75","19.16"
"10","005","00","070","0001","0000","318","161","157","0","318","698","0","45.56","23.07"
"10","005","00","070","0001","0319","318","161","157","0","318","698","0","45.56","23.07"
"10","005","00","070","0002","0000","597","325","272","10","607","1479","0","41.04","21.97"
"10","005","00","070","0002","0320","309","180","129","4","313","765","0","40.92","23.53"
"10","005","00","070","0002","0321","288","145","143","6","294","714","0","41.18","20.31"
"10","005","00","070","0003","0000","756","364","392","5","761","1991","0","38.22","18.28"
"10","005","00","070","0003","0325","297","138","159","2","299","842","0","35.51","16.39"
"10","005","00","070","0003","0326","299","128","171","1","300","787","0","38.12","16.26"
"10","005","00","070","0003","0327","160","98","62","2","162","362","0","44.75","27.07"
"10","005","00","070","0004","0000","349","167","182","8","357","937","0","38.10","17.82"
"10","005","00","070","0004","0322","349","167","182","8","357","937","0","38.10","17.82"
"10","005","00","070","0005","0000","239","133","106","0","239","674","0","35.46","19.73"
"10","005","00","070","0005","0323","239","133","106","0","239","674","0","35.46","19.73"
"10","005","00","070","0006","0000","273","161","112","2","275","923","0","29.79","17.44"
"10","005","00","070","0006","0333","273","161","112","2","275","923","0","29.79","17.44"
"10","005","00","070","0007","0000","741","376","365","9","750","1876","0","39.98","20.04"
"10","005","00","070","0007","0316","371","188","183","6","377","895","0","42.12","21.01"
"10","005","00","070","0007","0317","370","188","182","3","373","981","0","38.02","19.16"
"10","005","00","070","0008","0000","425","186","239","5","430","1056","0","40.72","17.61"
"10","005","00","070","0008","0318","425","186","239","5","430","1056","0","40.72","17.61"
"10","005","00","070","0009","0000","741","362","379","3","744","2071","0","35.92","17.48"
"10","005","00","070","0009","0328","237","109","128","1","238","640","0","37.19","17.03"
"10","005","00","070","0009","0329","256","110","146","1","257","746","0","34.45","14.75"
"10","005","00","070","0009","0330","248","143","105","1","249","685","0","36.35","20.88"
"10","005","00","070","0010","0000","268","129","139","2","270","702","0","38.46","18.38"
"10","005","00","070","0010","0324","268","129","139","2","270","702","0","38.46","18.38"
"10","005","00","070","0011","0000","347","189","158","2","349","1067","0","32.71","17.71"
"10","005","00","070","0011","0331","347","189","158","2","349","1067","0","32.71","17.71"
"10","005","00","070","0012","0000","254","165","89","3","257","715","0","35.94","23.08"
"10","005","00","070","0012","0332","254","165","89","3","257","715","0","35.94","23.08"
"10","005","00","080","0000","0000","4113","2851","1262","47","4160","12068","13686","34.47","23.62"
"10","005","00","080","0001","0000","632","466","166","6","638","1539","0","41.46","30.28"
"10","005","00","080","0001","0334","305","222","83","4","309","696","0","44.40","31.90"
"10","005","00","080","0001","0335","327","244","83","2","329","843","0","39.03","28.94"
"10","005","00","080","0002","0000","256","204","52","1","257","557","0","46.14","36.62"
"10","005","00","080","0002","0336","256","204","52","1","257","557","0","46.14","36.62"
"10","005","00","080","0003","0000","594","443","151","9","603","1714","0","35.18","25.85"
"10","005","00","080","0003","0338","262","203","59","5","267","840","0","31.79","24.17"
"10","005","00","080","0003","0339","332","240","92","4","336","874","0","38.44","27.46"
"10","005","00","080","0004","0000","392","246","146","4","396","1323","0","29.93","18.59"
"10","005","00","080","0004","0340","392","246","146","4","396","1323","0","29.93","18.59"
"10","005","00","080","0005","0000","170","128","42","5","175","529","0","33.08","24.20"
"10","005","00","080","0005","0341","170","128","42","5","175","529","0","33.08","24.20"
"10","005","00","080","0006","0000","424","292","132","3","427","1155","0","36.97","25.28"
"10","005","00","080","0006","0337","424","292","132","3","427","1155","0","36.97","25.28"
"10","005","00","080","0007","0000","221","144","77","1","222","599","0","37.06","24.04"
"10","005","00","080","0007","0342","221","144","77","1","222","599","0","37.06","24.04"
"10","005","00","080","0008","0000","429","273","156","7","436","1448","0","30.11","18.85"
"10","005","00","080","0008","0345","186","113","73","0","186","621","0","29.95","18.20"
"10","005","00","080","0008","0346","243","160","83","7","250","827","0","30.23","19.35"
"10","005","00","080","0009","0000","234","158","76","3","237","739","0","32.07","21.38"
"10","005","00","080","0009","0343","234","158","76","3","237","739","0","32.07","21.38"
"10","005","00","080","0010","0000","181","133","48","3","184","484","0","38.02","27.48"
"10","005","00","080","0010","0344","181","133","48","3","184","484","0","38.02","27.48"
"10","005","00","080","0011","0000","279","183","96","3","282","988","0","28.54","18.52"
"10","005","00","080","0011","0347","279","183","96","3","282","988","0","28.54","18.52"
"10","005","00","080","0012","0000","301","181","120","2","303","993","0","30.51","18.23"
"10","005","00","080","0012","0348","301","181","120","2","303","993","0","30.51","18.23"
"10","005","00","090","0000","0000","10606","7143","3463","119","10725","27661","32119","38.77","25.82"
"10","005","00","090","0001","0000","640","409","231","9","649","1507","0","43.07","27.14"
"10","005","00","090","0001","0349","335","202","133","4","339","751","0","45.14","26.90"
"10","005","00","090","0001","0350","305","207","98","5","310","756","0","41.01","27.38"
"10","005","00","090","0002","0000","931","657","274","8","939","2286","0","41.08","28.74"
"10","005","00","090","0002","0351","425","311","114","5","430","1064","0","40.41","29.23"
"10","005","00","090","0002","0352","506","346","160","3","509","1222","0","41.65","28.31"
"10","005","00","090","0003","0000","1259","862","397","15","1274","3412","0","37.34","25.26"
"10","005","00","090","0003","0353","435","305","130","5","440","1142","0","38.53","26.71"
"10","005","00","090","0003","0354","419","282","137","6","425","1176","0","36.14","23.98"
"10","005","00","090","0003","0355","405","275","130","4","409","1094","0","37.39","25.14"
"10","005","00","090","0004","0000","349","216","133","5","354","921","0","38.44","23.45"
"10","005","00","090","0004","0360","349","216","133","5","354","921","0","38.44","23.45"
"10","005","00","090","0005","0000","767","514","253","8","775","2259","0","34.31","22.75"
"10","005","00","090","0005","0356","419","304","115","5","424","1175","0","36.09","25.87"
"10","005","00","090","0005","0357","348","210","138","3","351","1084","0","32.38","19.37"
"10","005","00","090","0006","0000","923","602","321","4","927","2296","0","40.37","26.22"
"10","005","00","090","0006","0358","508","332","176","3","511","1248","0","40.95","26.60"
"10","005","00","090","0006","0359","415","270","145","1","416","1048","0","39.69","25.76"
"10","005","00","090","0007","0000","518","371","147","6","524","1448","0","36.19","25.62"
"10","005","00","090","0007","0365","270","191","79","3","273","684","0","39.91","27.92"
"10","005","00","090","0007","0366","248","180","68","3","251","764","0","32.85","23.56"
"10","005","00","090","0008","0000","391","285","106","6","397","995","0","39.90","28.64"
"10","005","00","090","0008","0361","391","285","106","6","397","995","0","39.90","28.64"
"10","005","00","090","0009","0000","787","533","254","10","797","2019","0","39.47","26.40"
"10","005","00","090","0009","0363","326","227","99","3","329","820","0","40.12","27.68"
"10","005","00","090","0009","0364","461","306","155","7","468","1199","0","39.03","25.52"
"10","005","00","090","0010","0000","103","80","23","3","106","280","0","37.86","28.57"
"10","005","00","090","0010","0367","103","80","23","3","106","280","0","37.86","28.57"
"10","005","00","090","0011","0000","161","88","73","1","162","339","0","47.79","25.96"
"10","005","00","090","0011","0362","161","88","73","1","162","339","0","47.79","25.96"
"10","005","00","090","0012","0000","859","534","325","15","874","2213","0","39.49","24.13"
"10","005","00","090","0012","0368","507","323","184","11","518","1304","0","39.72","24.77"
"10","005","00","090","0012","0369","352","211","141","4","356","909","0","39.16","23.21"
"10","005","00","090","0013","0000","529","366","163","11","540","1453","0","37.16","25.19"
"10","005","00","090","0013","0370","300","212","88","8","308","731","0","42.13","29.00"
"10","005","00","090","0013","0371","229","154","75","3","232","722","0","32.13","21.33"
"10","005","00","090","0014","0000","647","448","199","3","650","1579","0","41.17","28.37"
"10","005","00","090","0014","0372","337","238","99","2","339","871","0","38.92","27.32"
"10","005","00","090","0014","0373","310","210","100","1","311","708","0","43.93","29.66"
"10","005","00","090","0015","0000","536","366","170","4","540","1427","0","37.84","25.65"
"10","005","00","090","0015","0374","224","154","70","1","225","678","0","33.19","22.71"
"10","005","00","090","0015","0375","312","212","100","3","315","749","0","42.06","28.30"
"10","005","00","090","0016","0000","479","326","153","3","482","1270","0","37.95","25.67"
"10","005","00","090","0016","0378","479","326","153","3","482","1270","0","37.95","25.67"
"10","005","00","090","0017","0000","536","347","189","6","542","1415","0","38.30","24.52"
"10","005","00","090","0017","0376","272","176","96","3","275","705","0","39.01","24.96"
"10","005","00","090","0017","0377","264","171","93","3","267","710","0","37.61","24.08"
"10","005","00","090","0018","0000","87","71","16","2","89","213","0","41.78","33.33"
"10","005","00","090","0018","0379","87","71","16","2","89","213","0","41.78","33.33"
"10","005","00","090","0019","0000","104","68","36","0","104","329","0","31.61","20.67"
"10","005","00","090","0019","0380","104","68","36","0","104","329","0","31.61","20.67"
"10","005","00","100","0000","0000","5622","3975","1647","61","5683","14892","17039","38.16","26.69"
"10","005","00","100","0001","0000","409","344","65","3","412","940","0","43.83","36.60"
"10","005","00","100","0001","0387","409","344","65","3","412","940","0","43.83","36.60"
"10","005","00","100","0002","0000","1722","1229","493","16","1738","4334","0","40.10","28.36"
"10","005","00","100","0002","0381","381","274","107","8","389","850","0","45.76","32.24"
"10","005","00","100","0002","0382","453","308","145","1","454","1006","0","45.13","30.62"
"10","005","00","100","0002","0383","487","359","128","3","490","1293","0","37.90","27.76"
"10","005","00","100","0002","0384","401","288","113","4","405","1185","0","34.18","24.30"
"10","005","00","100","0003","0000","681","492","189","5","686","1617","0","42.42","30.43"
"10","005","00","100","0003","0388","379","293","86","3","382","909","0","42.02","32.23"
"10","005","00","100","0003","0389","302","199","103","2","304","708","0","42.94","28.11"
"10","005","00","100","0004","0000","404","266","138","9","413","1247","0","33.12","21.33"
"10","005","00","100","0004","0385","404","266","138","9","413","1247","0","33.12","21.33"
"10","005","00","100","0005","0000","416","297","119","6","422","1142","0","36.95","26.01"
"10","005","00","100","0005","0386","416","297","119","6","422","1142","0","36.95","26.01"
"10","005","00","100","0006","0000","331","243","88","0","331","1021","0","32.42","23.80"
"10","005","00","100","0006","0390","331","243","88","0","331","1021","0","32.42","23.80"
"10","005","00","100","0007","0000","1100","739","361","15","1115","3115","0","35.79","23.72"
"10","005","00","100","0007","0391","416","269","147","9","425","1070","0","39.72","25.14"
"10","005","00","100","0007","0392","279","197","82","1","280","830","0","33.73","23.73"
"10","005","00","100","0007","0393","405","273","132","5","410","1215","0","33.74","22.47"
"10","005","00","100","0008","0000","189","117","72","2","191","540","0","35.37","21.67"
"10","005","00","100","0008","0394","189","117","72","2","191","540","0","35.37","21.67"
"10","005","00","100","0009","0000","143","97","46","2","145","411","0","35.28","23.60"
"10","005","00","100","0009","0395","143","97","46","2","145","411","0","35.28","23.60"
"10","005","00","100","0010","0000","227","151","76","3","230","525","0","43.81","28.76"
"10","005","00","100","0010","0396","227","151","76","3","230","525","0","43.81","28.76"
"10","005","00","110","0000","0000","2855","2098","757","33","2888","8353","9430","34.57","25.12"
"10","005","00","110","0001","0000","417","309","108","4","421","1102","0","38.20","28.04"
"10","005","00","110","0001","0397","417","309","108","4","421","1102","0","38.20","28.04"
"10","005","00","110","0002","0000","223","159","64","2","225","609","0","36.95","26.11"
"10","005","00","110","0002","0398","223","159","64","2","225","609","0","36.95","26.11"
"10","005","00","110","0003","0000","371","286","85","3","374","1283","0","29.15","22.29"
"10","005","00","110","0003","0399","371","286","85","3","374","1283","0","29.15","22.29"
"10","005","00","110","0004","0000","272","181","91","5","277","793","0","34.93","22.82"
"10","005","00","110","0004","0400","272","181","91","5","277","793","0","34.93","22.82"
"10","005","00","110","0005","0000","265","186","79","3","268","793","0","33.80","23.46"
"10","005","00","110","0005","0401","265","186","79","3","268","793","0","33.80","23.46"
"10","005","00","110","0006","0000","466","338","128","6","472","1037","0","45.52","32.59"
"10","005","00","110","0006","0402","466","338","128","6","472","1037","0","45.52","32.59"
"10","005","00","110","0007","0000","383","266","117","2","385","986","0","39.05","26.98"
"10","005","00","110","0007","0403","383","266","117","2","385","986","0","39.05","26.98"
"10","005","00","110","0008","0000","231","185","46","3","234","838","0","27.92","22.08"
"10","005","00","110","0008","0404","231","185","46","3","234","838","0","27.92","22.08"
"10","005","00","110","0009","0000","227","188","39","5","232","912","0","25.44","20.61"
"10","005","00","110","0009","0405","227","188","39","5","232","912","0","25.44","20.61"
"10","005","00","120","0000","0000","3669","2562","1107","40","3709","9023","10112","41.11","28.39"
"10","005","00","120","0001","0000","981","700","281","7","988","2420","0","40.83","28.93"
"10","005","00","120","0001","0406","476","334","142","4","480","1287","0","37.30","25.95"
"10","005","00","120","0001","0407","505","366","139","3","508","1133","0","44.84","32.30"
"10","005","00","120","0002","0000","687","460","227","6","693","1786","0","38.80","25.76"
"10","005","00","120","0002","0413","305","208","97","1","306","817","0","37.45","25.46"
"10","005","00","120","0002","0414","382","252","130","5","387","969","0","39.94","26.01"
"10","005","00","120","0003","0000","244","183","61","2","246","687","0","35.81","26.64"
"10","005","00","120","0003","0410","244","183","61","2","246","687","0","35.81","26.64"
"10","005","00","120","0004","0000","648","465","183","12","660","1635","0","40.37","28.44"
"10","005","00","120","0004","0408","305","214","91","7","312","756","0","41.27","28.31"
"10","005","00","120","0004","0409","343","251","92","5","348","879","0","39.59","28.56"
"10","005","00","120","0005","0000","396","265","131","3","399","848","0","47.05","31.25"
"10","005","00","120","0005","0411","396","265","131","3","399","848","0","47.05","31.25"
"10","005","00","120","0006","0000","162","112","50","3","165","377","0","43.77","29.71"
"10","005","00","120","0006","0412","162","112","50","3","165","377","0","43.77","29.71"
"10","005","00","120","0007","0000","427","296","131","3","430","968","0","44.42","30.58"
"10","005","00","120","0007","0415","330","238","92","2","332","758","0","43.80","31.40"
"10","005","00","120","0007","0416","97","58","39","1","98","210","0","46.67","27.62"
"10","005","00","120","0008","0000","124","81","43","4","128","302","0","42.38","26.82"
"10","005","00","120","0008","0417","124","81","43","4","128","302","0","42.38","26.82"
"10","005","00","130","0000","0000","5299","3563","1736","53","5352","13373","15480","40.02","26.64"
"10","005","00","130","0001","0000","1596","1108","488","10","1606","3909","0","41.08","28.34"
"10","005","00","130","0001","0418","314","222","92","1","315","793","0","39.72","27.99"
"10","005","00","130","0001","0419","401","285","116","3","404","935","0","43.21","30.48"
"10","005","00","130","0001","0420","408","272","136","2","410","1024","0","40.04","26.56"
"10","005","00","130","0001","0421","473","329","144","4","477","1157","0","41.23","28.44"
"10","005","00","130","0002","0000","691","483","208","4","695","1787","0","38.89","27.03"
"10","005","00","130","0002","0427","365","256","109","2","367","979","0","37.49","26.15"
"10","005","00","130","0002","0428","326","227","99","2","328","808","0","40.59","28.09"
"10","005","00","130","0003","0000","485","344","141","5","490","1321","0","37.09","26.04"
"10","005","00","130","0003","0425","270","187","83","1","271","727","0","37.28","25.72"
"10","005","00","130","0003","0426","215","157","58","4","219","594","0","36.87","26.43"
"10","005","00","130","0004","0000","1323","850","473","19","1342","3286","0","40.84","25.87"
"10","005","00","130","0004","0422","358","251","107","11","369","994","0","37.12","25.25"
"10","005","00","130","0004","0423","453","276","177","2","455","1094","0","41.59","25.23"
"10","005","00","130","0004","0424","512","323","189","6","518","1198","0","43.24","26.96"
"10","005","00","130","0005","0000","570","424","146","7","577","1427","0","40.43","29.71"
"10","005","00","130","0005","0429","288","219","69","4","292","684","0","42.69","32.02"
"10","005","00","130","0005","0430","282","205","77","3","285","743","0","38.36","27.59"
"10","005","00","130","0006","0000","169","128","41","1","170","402","0","42.29","31.84"
"10","005","00","130","0006","0431","169","128","41","1","170","402","0","42.29","31.84"
"10","005","00","130","0007","0000","465","226","239","7","472","1241","0","38.03","18.21"
"10","005","00","130","0007","0432","219","112","107","2","221","619","0","35.70","18.09"
"10","005","00","130","0007","0433","246","114","132","5","251","622","0","40.35","18.33"
"10","005","00","140","0000","0000","2109","1551","558","25","2134","6133","6635","34.80","25.29"
"10","005","00","140","0001","0000","228","189","39","6","234","595","0","39.33","31.76"
"10","005","00","140","0001","0434","228","189","39","6","234","595","0","39.33","31.76"
"10","005","00","140","0002","0000","194","155","39","4","198","564","0","35.11","27.48"
"10","005","00","140","0002","0435","194","155","39","4","198","564","0","35.11","27.48"
"10","005","00","140","0003","0000","280","206","74","3","283","790","0","35.82","26.08"
"10","005","00","140","0003","0436","280","206","74","3","283","790","0","35.82","26.08"
"10","005","00","140","0004","0000","207","155","52","0","207","627","0","33.01","24.72"
"10","005","00","140","0004","0437","207","155","52","0","207","627","0","33.01","24.72"
"10","005","00","140","0005","0000","182","139","43","0","182","482","0","37.76","28.84"
"10","005","00","140","0005","0440","182","139","43","0","182","482","0","37.76","28.84"
"10","005","00","140","0006","0000","149","93","56","3","152","446","0","34.08","20.85"
"10","005","00","140","0006","0439","149","93","56","3","152","446","0","34.08","20.85"
"10","005","00","140","0007","0000","316","215","101","2","318","871","0","36.51","24.68"
"10","005","00","140","0007","0438","316","215","101","2","318","871","0","36.51","24.68"
"10","005","00","140","0008","0000","338","247","91","5","343","1112","0","30.85","22.21"
"10","005","00","140","0008","0441","338","247","91","5","343","1112","0","30.85","22.21"
"10","005","00","140","0009","0000","215","152","63","2","217","646","0","33.59","23.53"
"10","005","00","140","0009","0442","215","152","63","2","217","646","0","33.59","23.53"
"10","005","00","150","0000","0000","3900","2569","1331","44","3944","10732","12084","36.75","23.94"
"10","005","00","150","0001","0000","756","539","217","6","762","2010","0","37.91","26.82"
"10","005","00","150","0001","0443","427","305","122","2","429","1135","0","37.80","26.87"
"10","005","00","150","0001","0444","329","234","95","4","333","875","0","38.06","26.74"
"10","005","00","150","0002","0000","176","126","50","0","176","442","0","39.82","28.51"
"10","005","00","150","0002","0445","176","126","50","0","176","442","0","39.82","28.51"
"10","005","00","150","0003","0000","378","255","123","3","381","969","0","39.32","26.32"
"10","005","00","150","0003","0446","378","255","123","3","381","969","0","39.32","26.32"
"10","005","00","150","0004","0000","1198","812","386","14","1212","3315","0","36.56","24.49"
"10","005","00","150","0004","0447","418","259","159","3","421","1163","0","36.20","22.27"
"10","005","00","150","0004","0448","404","297","107","4","408","1043","0","39.12","28.48"
"10","005","00","150","0004","0449","376","256","120","7","383","1109","0","34.54","23.08"
"10","005","00","150","0005","0000","182","125","57","3","185","479","0","38.62","26.10"
"10","005","00","150","0005","0450","182","125","57","3","185","479","0","38.62","26.10"
"10","005","00","150","0006","0000","190","132","58","2","192","485","0","39.59","27.22"
"10","005","00","150","0006","0451","190","132","58","2","192","485","0","39.59","27.22"
"10","005","00","150","0007","0000","431","254","177","9","440","1252","0","35.14","20.29"
"10","005","00","150","0007","0452","431","254","177","9","440","1252","0","35.14","20.29"
"10","005","00","150","0008","0000","288","178","110","5","293","837","0","35.01","21.27"
"10","005","00","150","0008","0453","288","178","110","5","293","837","0","35.01","21.27"
"10","005","00","150","0009","0000","301","148","153","2","303","943","0","32.13","15.69"
"10","005","00","150","0009","0454","301","148","153","2","303","943","0","32.13","15.69"
"10","005","00","160","0000","0000","2132","1470","662","33","2165","5579","6259","38.81","26.35"
"10","005","00","160","0001","0000","769","525","244","6","775","2118","0","36.59","24.79"
"10","005","00","160","0001","0455","388","263","125","3","391","965","0","40.52","27.25"
"10","005","00","160","0001","0456","381","262","119","3","384","1153","0","33.30","22.72"
"10","005","00","160","0002","0000","267","190","77","6","273","613","0","44.54","31.00"
"10","005","00","160","0002","0457","267","190","77","6","273","613","0","44.54","31.00"
"10","005","00","160","0003","0000","320","236","84","5","325","822","0","39.54","28.71"
"10","005","00","160","0003","0458","320","236","84","5","325","822","0","39.54","28.71"
"10","005","00","160","0004","0000","73","46","27","1","74","227","0","32.60","20.26"
"10","005","00","160","0004","0459","73","46","27","1","74","227","0","32.60","20.26"
"10","005","00","160","0005","0000","162","102","60","4","166","517","0","32.11","19.73"
"10","005","00","160","0005","0460","162","102","60","4","166","517","0","32.11","19.73"
"10","005","00","160","0006","0000","201","135","66","3","204","523","0","39.01","25.81"
"10","005","00","160","0006","0461","201","135","66","3","204","523","0","39.01","25.81"
"10","005","00","160","0007","0000","181","120","61","3","184","391","0","47.06","30.69"
"10","005","00","160","0007","0462","181","120","61","3","184","391","0","47.06","30.69"
"10","005","00","160","0008","0000","159","116","43","5","164","368","0","44.57","31.52"
"10","005","00","160","0008","0463","159","116","43","5","164","368","0","44.57","31.52"
"10","005","00","170","0000","0000","1404","1035","369","35","1439","3782","4094","38.05","27.37"
"10","005","00","170","0001","0000","94","81","13","1","95","322","0","29.50","25.16"
"10","005","00","170","0001","0464","94","81","13","1","95","322","0","29.50","25.16"
"10","005","00","170","0002","0000","199","147","52","9","208","531","0","39.17","27.68"
"10","005","00","170","0002","0465","199","147","52","9","208","531","0","39.17","27.68"
"10","005","00","170","0003","0000","317","227","90","7","324","869","0","37.28","26.12"
"10","005","00","170","0003","0466","317","227","90","7","324","869","0","37.28","26.12"
"10","005","00","170","0004","0000","196","137","59","4","200","539","0","37.11","25.42"
"10","005","00","170","0004","0467","196","137","59","4","200","539","0","37.11","25.42"
"10","005","00","170","0005","0000","198","151","47","7","205","548","0","37.41","27.55"
"10","005","00","170","0005","0468","198","151","47","7","205","548","0","37.41","27.55"
"10","005","00","170","0006","0000","124","88","36","2","126","323","0","39.01","27.24"
"10","005","00","170","0006","0469","124","88","36","2","126","323","0","39.01","27.24"
"10","005","00","170","0007","0000","276","204","72","5","281","650","0","43.23","31.38"
"10","005","00","170","0007","0470","276","204","72","5","281","650","0","43.23","31.38"
"10","005","00","180","0000","0000","1519","1267","252","22","1541","4995","5695","30.85","25.37"
"10","005","00","180","0001","0000","85","65","20","1","86","336","0","25.60","19.35"
"10","005","00","180","0001","0471","85","65","20","1","86","336","0","25.60","19.35"
"10","005","00","180","0002","0000","314","259","55","2","316","1070","0","29.53","24.21"
"10","005","00","180","0002","0472","109","92","17","0","109","455","0","23.96","20.22"
"10","005","00","180","0002","0473","205","167","38","2","207","615","0","33.66","27.15"
"10","005","00","180","0003","0000","289","231","58","4","293","871","0","33.64","26.52"
"10","005","00","180","0003","0474","197","154","43","3","200","567","0","35.27","27.16"
"10","005","00","180","0003","0475","92","77","15","1","93","304","0","30.59","25.33"
"10","005","00","180","0004","0000","190","167","23","2","192","480","0","40.00","34.79"
"10","005","00","180","0004","0476","190","167","23","2","192","480","0","40.00","34.79"
"10","005","00","180","0005","0000","131","108","23","0","131","501","0","26.15","21.56"
"10","005","00","180","0005","0477","131","108","23","0","131","501","0","26.15","21.56"
"10","005","00","180","0006","0000","135","111","24","2","137","481","0","28.48","23.08"
"10","005","00","180","0006","0478","135","111","24","2","137","481","0","28.48","23.08"
"10","005","00","180","0007","0000","177","147","30","6","183","666","0","27.48","22.07"
"10","005","00","180","0007","0479","177","147","30","6","183","666","0","27.48","22.07"
"10","005","00","180","0008","0000","198","179","19","5","203","590","0","34.41","30.34"
"10","005","00","180","0008","0480","198","179","19","5","203","590","0","34.41","30.34"
"10","007","00","000","0000","0000","390184","190279","199905","4342","394526","1061571","1260388","37.16","17.92"
"10","007","00","010","0000","0000","79656","39921","39735","725","80381","189909","229765","42.33","21.02"
"10","007","00","010","0001","0000","530","262","268","6","536","1253","0","42.78","20.91"
"10","007","00","010","0001","0119","295","148","147","3","298","666","0","44.74","22.22"
"10","007","00","010","0001","0120","235","114","121","3","238","587","0","40.55","19.42"
"10","007","00","010","0002","0000","2127","1076","1051","11","2138","4972","0","43.00","21.64"
"10","007","00","010","0002","0127","432","216","216","1","433","1101","0","39.33","19.62"
"10","007","00","010","0002","0128","415","215","200","0","415","1020","0","40.69","21.08"
"10","007","00","010","0002","0129","451","228","223","4","455","1012","0","44.96","22.53"
"10","007","00","010","0002","0130","389","212","177","3","392","898","0","43.65","23.61"
"10","007","00","010","0002","0131","440","205","235","3","443","941","0","47.08","21.79"
"10","007","00","010","0003","0000","678","324","354","4","682","1603","0","42.55","20.21"
"10","007","00","010","0003","0114","329","165","164","1","330","753","0","43.82","21.91"
"10","007","00","010","0003","0115","349","159","190","3","352","850","0","41.41","18.71"
"10","007","00","010","0004","0000","376","178","198","4","380","760","0","50.00","23.42"
"10","007","00","010","0004","0116","376","178","198","4","380","760","0","50.00","23.42"
"10","007","00","010","0005","0000","573","300","273","6","579","1331","0","43.50","22.54"
"10","007","00","010","0005","0117","282","142","140","4","286","639","0","44.76","22.22"
"10","007","00","010","0005","0118","291","158","133","2","293","692","0","42.34","22.83"
"10","007","00","010","0006","0000","742","355","387","11","753","1723","0","43.70","20.60"
"10","007","00","010","0006","0121","380","179","201","8","388","906","0","42.83","19.76"
"10","007","00","010","0006","0122","362","176","186","3","365","817","0","44.68","21.54"
"10","007","00","010","0007","0000","1719","817","902","14","1733","3835","0","45.19","21.30"
"10","007","00","010","0007","0123","448","211","237","2","450","976","0","46.11","21.62"
"10","007","00","010","0007","0124","437","224","213","6","443","944","0","46.93","23.73"
"10","007","00","010","0007","0125","381","160","221","1","382","827","0","46.19","19.35"
"10","007","00","010","0007","0126","453","222","231","5","458","1088","0","42.10","20.40"
"10","007","00","010","0008","0000","2263","1076","1187","18","2281","5212","0","43.76","20.64"
"10","007","00","010","0008","0107","522","233","289","7","529","1170","0","45.21","19.91"
"10","007","00","010","0008","0108","397","188","209","1","398","919","0","43.31","20.46"
"10","007","00","010","0008","0109","399","168","231","2","401","943","0","42.52","17.82"
"10","007","00","010","0008","0110","396","201","195","5","401","965","0","41.55","20.83"
"10","007","00","010","0008","0111","549","286","263","3","552","1215","0","45.43","23.54"
"10","007","00","010","0009","0000","765","400","365","9","774","1718","0","45.05","23.28"
"10","007","00","010","0009","0112","363","180","183","3","366","849","0","43.11","21.20"
"10","007","00","010","0009","0113","402","220","182","6","408","869","0","46.95","25.32"
"10","007","00","010","0010","0000","833","401","432","2","835","1895","0","44.06","21.16"
"10","007","00","010","0010","0105","434","214","220","0","434","1001","0","43.36","21.38"
"10","007","00","010","0010","0106","399","187","212","2","401","894","0","44.85","20.92"
"10","007","00","010","0011","0000","343","206","137","4","347","762","0","45.54","27.03"
"10","007","00","010","0011","0104","343","206","137","4","347","762","0","45.54","27.03"
"10","007","00","010","0012","0000","645","337","308","4","649","1377","0","47.13","24.47"
"10","007","00","010","0012","0102","318","151","167","0","318","646","0","49.23","23.37"
"10","007","00","010","0012","0103","327","186","141","4","331","731","0","45.28","25.44"
"10","007","00","010","0013","0000","395","168","227","3","398","862","0","46.17","19.49"
"10","007","00","010","0013","0100","395","168","227","3","398","862","0","46.17","19.49"
"10","007","00","010","0014","0000","260","93","167","6","266","642","0","41.43","14.49"
"10","007","00","010","0014","0099","260","93","167","6","266","642","0","41.43","14.49"
"10","007","00","010","0015","0000","362","172","190","0","362","706","0","51.27","24.36"
"10","007","00","010","0015","0101","362","172","190","0","362","706","0","51.27","24.36"
"10","007","00","010","0016","0000","380","131","249","4","384","864","0","44.44","15.16"
"10","007","00","010","0016","0054","380","131","249","4","384","864","0","44.44","15.16"
"10","007","00","010","0017","0000","372","153","219","5","377","748","0","50.40","20.45"
"10","007","00","010","0017","0051","372","153","219","5","377","748","0","50.40","20.45"
"10","007","00","010","0018","0000","392","164","228","2","394","863","0","45.65","19.00"
"10","007","00","010","0018","0052","392","164","228","2","394","863","0","45.65","19.00"
"10","007","00","010","0019","0000","466","214","252","4","470","1067","0","44.05","20.06"
"10","007","00","010","0019","0053","466","214","252","4","470","1067","0","44.05","20.06"
"10","007","00","010","0020","0000","1474","747","727","5","1479","3304","0","44.76","22.61"
"10","007","00","010","0020","0056","464","215","249","3","467","1035","0","45.12","20.77"
"10","007","00","010","0020","0057","573","302","271","0","573","1251","0","45.80","24.14"
"10","007","00","010","0020","0058","437","230","207","2","439","1018","0","43.12","22.59"
"10","007","00","010","0021","0000","1550","842","708","18","1568","3585","0","43.74","23.49"
"10","007","00","010","0021","0059","534","287","247","2","536","1147","0","46.73","25.02"
"10","007","00","010","0021","0060","498","257","241","10","508","1260","0","40.32","20.40"
"10","007","00","010","0021","0061","518","298","220","6","524","1178","0","44.48","25.30"
"10","007","00","010","0022","0000","525","266","259","7","532","1129","0","47.12","23.56"
"10","007","00","010","0022","0065","525","266","259","7","532","1129","0","47.12","23.56"
"10","007","00","010","0023","0000","1328","686","642","17","1345","3158","0","42.59","21.72"
"10","007","00","010","0023","0062","457","218","239","6","463","1037","0","44.65","21.02"
"10","007","00","010","0023","0063","474","245","229","7","481","1078","0","44.62","22.73"
"10","007","00","010","0023","0064","397","223","174","4","401","1043","0","38.45","21.38"
"10","007","00","010","0024","0000","1524","784","740","16","1540","4175","0","36.89","18.78"
"10","007","00","010","0024","0066","376","191","185","8","384","1010","0","38.02","18.91"
"10","007","00","010","0024","0067","387","197","190","1","388","1081","0","35.89","18.22"
"10","007","00","010","0024","0068","353","181","172","1","354","943","0","37.54","19.19"
"10","007","00","010","0024","0069","408","215","193","6","414","1141","0","36.28","18.84"
"10","007","00","010","0025","0000","457","191","266","3","460","930","0","49.46","20.54"
"10","007","00","010","0025","0055","457","191","266","3","460","930","0","49.46","20.54"
"10","007","00","010","0026","0000","1389","665","724","14","1403","3505","0","40.03","18.97"
"10","007","00","010","0026","0091","419","199","220","3","422","1182","0","35.70","16.84"
"10","007","00","010","0026","0092","471","216","255","4","475","1074","0","44.23","20.11"
"10","007","00","010","0026","0093","499","250","249","7","506","1249","0","40.51","20.02"
"10","007","00","010","0027","0000","885","444","441","8","893","2137","0","41.79","20.78"
"10","007","00","010","0027","0089","465","243","222","5","470","1166","0","40.31","20.84"
"10","007","00","010","0027","0090","420","201","219","3","423","971","0","43.56","20.70"
"10","007","00","010","0028","0000","733","358","375","6","739","1884","0","39.23","19.00"
"10","007","00","010","0028","0087","323","135","188","1","324","839","0","38.62","16.09"
"10","007","00","010","0028","0088","410","223","187","5","415","1045","0","39.71","21.34"
"10","007","00","010","0029","0000","1320","638","682","15","1335","3079","0","43.36","20.72"
"10","007","00","010","0029","0084","370","173","197","2","372","885","0","42.03","19.55"
"10","007","00","010","0029","0085","485","255","230","7","492","1109","0","44.36","22.99"
"10","007","00","010","0029","0086","465","210","255","6","471","1085","0","43.41","19.35"
"10","007","00","010","0030","0000","1262","641","621","14","1276","3285","0","38.84","19.51"
"10","007","00","010","0030","0094","435","215","220","4","439","1190","0","36.89","18.07"
"10","007","00","010","0030","0095","443","230","213","4","447","1024","0","43.65","22.46"
"10","007","00","010","0030","0096","384","196","188","6","390","1071","0","36.41","18.30"
"10","007","00","010","0031","0000","1672","836","836","24","1696","4235","0","40.05","19.74"
"10","007","00","010","0031","0070","389","199","190","8","397","973","0","40.80","20.45"
"10","007","00","010","0031","0071","444","187","257","5","449","1136","0","39.52","16.46"
"10","007","00","010","0031","0072","424","230","194","6","430","1079","0","39.85","21.32"
"10","007","00","010","0031","0073","415","220","195","5","420","1047","0","40.11","21.01"
"10","007","00","010","0032","0000","961","475","486","7","968","2424","0","39.93","19.60"
"10","007","00","010","0032","0001","385","197","188","3","388","881","0","44.04","22.36"
"10","007","00","010","0032","0002","202","100","102","3","205","663","0","30.92","15.08"
"10","007","00","010","0032","0003","374","178","196","1","375","880","0","42.61","20.23"
"10","007","00","010","0033","0000","1093","590","503","9","1102","2437","0","45.22","24.21"
"10","007","00","010","0033","0097","517","267","250","5","522","1196","0","43.65","22.32"
"10","007","00","010","0033","0098","576","323","253","4","580","1241","0","46.74","26.03"
"10","007","00","010","0034","0000","676","323","353","7","683","1511","0","45.20","21.38"
"10","007","00","010","0034","0004","329","155","174","6","335","751","0","44.61","20.64"
"10","007","00","010","0034","0005","347","168","179","1","348","760","0","45.79","22.11"
"10","007","00","010","0035","0000","455","209","246","3","458","974","0","47.02","21.46"
"10","007","00","010","0035","0010","455","209","246","3","458","974","0","47.02","21.46"
"10","007","00","010","0036","0000","543","261","282","4","547","1169","0","46.79","22.33"
"10","007","00","010","0036","0011","543","261","282","4","547","1169","0","46.79","22.33"
"10","007","00","010","0037","0000","746","426","320","7","753","1770","0","42.54","24.07"
"10","007","00","010","0037","0008","313","193","120","3","316","741","0","42.65","26.05"
"10","007","00","010","0037","0009","433","233","200","4","437","1029","0","42.47","22.64"
"10","007","00","010","0038","0000","631","334","297","9","640","1426","0","44.88","23.42"
"10","007","00","010","0038","0006","297","181","116","5","302","699","0","43.20","25.89"
"10","007","00","010","0038","0007","334","153","181","4","338","727","0","46.49","21.05"
"10","007","00","010","0039","0000","3233","1603","1630","22","3255","7458","0","43.64","21.49"
"10","007","00","010","0039","0035","400","207","193","3","403","1022","0","39.43","20.25"
"10","007","00","010","0039","0036","490","241","249","2","492","1090","0","45.14","22.11"
"10","007","00","010","0039","0037","538","268","270","2","540","1193","0","45.26","22.46"
"10","007","00","010","0039","0038","483","227","256","5","488","1094","0","44.61","20.75"
"10","007","00","010","0039","0039","486","261","225","3","489","1105","0","44.25","23.62"
"10","007","00","010","0039","0040","403","194","209","1","404","1013","0","39.88","19.15"
"10","007","00","010","0039","0041","433","205","228","6","439","941","0","46.65","21.79"
"10","007","00","010","0040","0000","651","323","328","9","660","1470","0","44.90","21.97"
"10","007","00","010","0040","0042","327","157","170","6","333","694","0","47.98","22.62"
"10","007","00","010","0040","0043","324","166","158","3","327","776","0","42.14","21.39"
"10","007","00","010","0041","0000","2089","1041","1048","14","2103","4938","0","42.59","21.08"
"10","007","00","010","0041","0025","461","247","214","2","463","1173","0","39.47","21.06"
"10","007","00","010","0041","0026","419","215","204","0","419","1040","0","40.29","20.67"
"10","007","00","010","0041","0027","583","261","322","9","592","1350","0","43.85","19.33"
"10","007","00","010","0041","0028","626","318","308","3","629","1375","0","45.75","23.13"
"10","007","00","010","0042","0000","3128","1546","1582","26","3154","7515","0","41.97","20.57"
"10","007","00","010","0042","0029","585","274","311","8","593","1363","0","43.51","20.10"
"10","007","00","010","0042","0030","422","198","224","1","423","1063","0","39.79","18.63"
"10","007","00","010","0042","0031","484","242","242","3","487","1222","0","39.85","19.80"
"10","007","00","010","0042","0032","577","271","306","5","582","1267","0","45.94","21.39"
"10","007","00","010","0042","0033","535","291","244","3","538","1323","0","40.67","22.00"
"10","007","00","010","0042","0034","525","270","255","6","531","1277","0","41.58","21.14"
"10","007","00","010","0043","0000","1221","605","616","10","1231","2775","0","44.36","21.80"
"10","007","00","010","0043","0045","380","177","203","2","382","835","0","45.75","21.20"
"10","007","00","010","0043","0046","400","200","200","3","403","899","0","44.83","22.25"
"10","007","00","010","0043","0047","441","228","213","5","446","1041","0","42.84","21.90"
"10","007","00","010","0044","0000","1255","605","650","12","1267","2845","0","44.53","21.27"
"10","007","00","010","0044","0048","420","198","222","5","425","1011","0","42.04","19.58"
"10","007","00","010","0044","0049","377","159","218","5","382","855","0","44.68","18.60"
"10","007","00","010","0044","0050","458","248","210","2","460","979","0","46.99","25.33"
"10","007","00","010","0045","0000","638","321","317","3","641","1419","0","45.17","22.62"
"10","007","00","010","0045","0014","350","180","170","1","351","797","0","44.04","22.58"
"10","007","00","010","0045","0015","288","141","147","2","290","622","0","46.62","22.67"
"10","007","00","010","0046","0000","958","589","369","5","963","2598","0","37.07","22.67"
"10","007","00","010","0046","0016","575","394","181","3","578","1206","0","47.93","32.67"
"10","007","00","010","0046","0017","383","195","188","2","385","1392","0","27.66","14.01"
"10","007","00","010","0047","0000","3769","1966","1803","28","3797","8962","0","42.37","21.94"
"10","007","00","010","0047","0018","534","286","248","7","541","1315","0","41.14","21.75"
"10","007","00","010","0047","0019","524","271","253","3","527","1214","0","43.41","22.32"
"10","007","00","010","0047","0020","472","268","204","6","478","1157","0","41.31","23.16"
"10","007","00","010","0047","0021","492","218","274","4","496","1274","0","38.93","17.11"
"10","007","00","010","0047","0022","684","362","322","5","689","1518","0","45.39","23.85"
"10","007","00","010","0047","0023","510","256","254","2","512","1167","0","43.87","21.94"
"10","007","00","010","0047","0024","553","305","248","1","554","1317","0","42.07","23.16"
"10","007","00","010","0048","0000","1018","577","441","10","1028","2240","0","45.89","25.76"
"10","007","00","010","0048","0012","495","267","228","5","500","1082","0","46.21","24.68"
"10","007","00","010","0048","0013","523","310","213","5","528","1158","0","45.60","26.77"
"10","007","00","010","0049","0000","449","216","233","10","459","981","0","46.79","22.02"
"10","007","00","010","0049","0044","449","216","233","10","459","981","0","46.79","22.02"
"10","007","00","010","0050","0000","1314","651","663","10","1324","3193","0","41.47","20.39"
"10","007","00","010","0050","0180","419","189","230","5","424","994","0","42.66","19.01"
"10","007","00","010","0050","0181","458","257","201","2","460","1095","0","42.01","23.47"
"10","007","00","010","0050","0182","437","205","232","3","440","1104","0","39.86","18.57"
"10","007","00","010","0051","0000","634","336","298","10","644","1653","0","38.96","20.33"
"10","007","00","010","0051","0156","314","188","126","2","316","782","0","40.41","24.04"
"10","007","00","010","0051","0157","320","148","172","8","328","871","0","37.66","16.99"
"10","007","00","010","0052","0000","787","400","387","8","795","1899","0","41.86","21.06"
"10","007","00","010","0052","0177","364","194","170","3","367","930","0","39.46","20.86"
"10","007","00","010","0052","0178","423","206","217","5","428","969","0","44.17","21.26"
"10","007","00","010","0053","0000","1300","624","676","22","1322","3295","0","40.12","18.94"
"10","007","00","010","0053","0158","400","190","210","9","409","972","0","42.08","19.55"
"10","007","00","010","0053","0159","453","201","252","9","462","1172","0","39.42","17.15"
"10","007","00","010","0053","0160","447","233","214","4","451","1151","0","39.18","20.24"
"10","007","00","010","0054","0000","1242","561","681","13","1255","2951","0","42.53","19.01"
"10","007","00","010","0054","0161","393","161","232","4","397","889","0","44.66","18.11"
"10","007","00","010","0054","0162","450","219","231","5","455","1071","0","42.48","20.45"
"10","007","00","010","0054","0163","399","181","218","4","403","991","0","40.67","18.26"
"10","007","00","010","0055","0000","2712","1257","1455","32","2744","6731","0","40.77","18.67"
"10","007","00","010","0055","0171","435","220","215","5","440","1123","0","39.18","19.59"
"10","007","00","010","0055","0172","448","232","216","5","453","1253","0","36.15","18.52"
"10","007","00","010","0055","0173","488","221","267","2","490","1155","0","42.42","19.13"
"10","007","00","010","0055","0174","486","214","272","5","491","1188","0","41.33","18.01"
"10","007","00","010","0055","0175","473","204","269","8","481","1091","0","44.09","18.70"
"10","007","00","010","0055","0176","382","166","216","7","389","921","0","42.24","18.02"
"10","007","00","010","0056","0000","962","451","511","10","972","2426","0","40.07","18.59"
"10","007","00","010","0056","0154","459","234","225","4","463","1331","0","34.79","17.58"
"10","007","00","010","0056","0155","503","217","286","6","509","1095","0","46.48","19.82"
"10","007","00","010","0057","0000","437","214","223","2","439","1183","0","37.11","18.09"
"10","007","00","010","0057","0179","437","214","223","2","439","1183","0","37.11","18.09"
"10","007","00","010","0058","0000","1013","471","542","16","1029","2414","0","42.63","19.51"
"10","007","00","010","0058","0168","328","148","180","4","332","754","0","44.03","19.63"
"10","007","00","010","0058","0169","375","181","194","7","382","881","0","43.36","20.54"
"10","007","00","010","0058","0170","310","142","168","5","315","779","0","40.44","18.23"
"10","007","00","010","0059","0000","478","221","257","10","488","1222","0","39.93","18.09"
"10","007","00","010","0059","0136","478","221","257","10","488","1222","0","39.93","18.09"
"10","007","00","010","0060","0000","386","195","191","2","388","936","0","41.45","20.83"
"10","007","00","010","0060","0132","386","195","191","2","388","936","0","41.45","20.83"
"10","007","00","010","0061","0000","1240","631","609","15","1255","2915","0","43.05","21.65"
"10","007","00","010","0061","0133","406","206","200","7","413","941","0","43.89","21.89"
"10","007","00","010","0061","0134","396","182","214","6","402","956","0","42.05","19.04"
"10","007","00","010","0061","0135","438","243","195","2","440","1018","0","43.22","23.87"
"10","007","00","010","0062","0000","3344","1791","1553","26","3370","8423","0","40.01","21.26"
"10","007","00","010","0062","0140","520","288","232","1","521","1160","0","44.91","24.83"
"10","007","00","010","0062","0141","456","249","207","3","459","1317","0","34.85","18.91"
"10","007","00","010","0062","0142","465","245","220","4","469","1191","0","39.38","20.57"
"10","007","00","010","0062","0143","455","262","193","3","458","1123","0","40.78","23.33"
"10","007","00","010","0062","0144","491","268","223","6","497","1278","0","38.89","20.97"
"10","007","00","010","0062","0145","430","224","206","6","436","1157","0","37.68","19.36"
"10","007","00","010","0062","0146","527","255","272","3","530","1197","0","44.28","21.30"
"10","007","00","010","0063","0000","927","432","495","7","934","2377","0","39.29","18.17"
"10","007","00","010","0063","0137","343","157","186","5","348","799","0","43.55","19.65"
"10","007","00","010","0063","0138","329","152","177","1","330","878","0","37.59","17.31"
"10","007","00","010","0063","0139","255","123","132","1","256","700","0","36.57","17.57"
"10","007","00","010","0064","0000","1777","927","850","17","1794","4046","0","44.34","22.91"
"10","007","00","010","0064","0150","411","212","199","8","419","969","0","43.24","21.88"
"10","007","00","010","0064","0151","419","202","217","4","423","920","0","45.98","21.96"
"10","007","00","010","0064","0152","463","263","200","2","465","1095","0","42.47","24.02"
"10","007","00","010","0064","0153","484","250","234","3","487","1062","0","45.86","23.54"
"10","007","00","010","0065","0000","1125","584","541","7","1132","2634","0","42.98","22.17"
"10","007","00","010","0065","0147","402","194","208","1","403","855","0","47.13","22.69"
"10","007","00","010","0065","0148","342","175","167","4","346","851","0","40.66","20.56"
"10","007","00","010","0065","0149","381","215","166","2","383","928","0","41.27","23.17"
"10","007","00","010","0066","0000","417","207","210","6","423","1132","0","37.37","18.29"
"10","007","00","010","0066","0187","417","207","210","6","423","1132","0","37.37","18.29"
"10","007","00","010","0067","0000","469","237","232","4","473","1249","0","37.87","18.98"
"10","007","00","010","0067","0186","469","237","232","4","473","1249","0","37.87","18.98"
"10","007","00","010","0068","0000","321","142","179","3","324","840","0","38.57","16.90"
"10","007","00","010","0068","0185","321","142","179","3","324","840","0","38.57","16.90"
"10","007","00","010","0069","0000","357","171","186","3","360","885","0","40.68","19.32"
"10","007","00","010","0069","0183","357","171","186","3","360","885","0","40.68","19.32"
"10","007","00","010","0070","0000","459","211","248","2","461","1114","0","41.38","18.94"
"10","007","00","010","0070","0184","459","211","248","2","461","1114","0","41.38","18.94"
"10","007","00","010","0071","0000","1666","933","733","10","1676","4349","0","38.54","21.45"
"10","007","00","010","0071","0164","416","233","183","2","418","1032","0","40.50","22.58"
"10","007","00","010","0071","0165","401","214","187","1","402","1129","0","35.61","18.95"
"10","007","00","010","0071","0166","427","250","177","5","432","1123","0","38.47","22.26"
"10","007","00","010","0071","0167","422","236","186","2","424","1065","0","39.81","22.16"
"10","007","00","010","0072","0000","2253","1146","1107","17","2270","5297","0","42.85","21.63"
"10","007","00","010","0072","0074","521","269","252","3","524","1231","0","42.57","21.85"
"10","007","00","010","0072","0075","472","241","231","1","473","1067","0","44.33","22.59"
"10","007","00","010","0072","0076","426","226","200","5","431","1025","0","42.05","22.05"
"10","007","00","010","0072","0077","417","186","231","5","422","969","0","43.55","19.20"
"10","007","00","010","0072","0078","417","224","193","3","420","1005","0","41.79","22.29"
"10","007","00","010","0073","0000","2182","1193","989","14","2196","5234","0","41.96","22.79"
"10","007","00","010","0073","0079","513","298","215","2","515","1147","0","44.90","25.98"
"10","007","00","010","0073","0080","370","189","181","1","371","933","0","39.76","20.26"
"10","007","00","010","0073","0081","414","203","211","2","416","988","0","42.11","20.55"
"10","007","00","010","0073","0082","438","258","180","5","443","1012","0","43.77","25.49"
"10","007","00","010","0073","0083","447","245","202","4","451","1154","0","39.08","21.23"
"10","007","00","020","0000","0000","25949","11439","14510","258","26207","70613","86115","37.11","16.20"
"10","007","00","020","0001","0000","466","183","283","3","469","1109","0","42.29","16.50"
"10","007","00","020","0001","0247","466","183","283","3","469","1109","0","42.29","16.50"
"10","007","00","020","0002","0000","220","71","149","1","221","506","0","43.68","14.03"
"10","007","00","020","0002","0248","220","71","149","1","221","506","0","43.68","14.03"
"10","007","00","020","0003","0000","314","123","191","1","315","847","0","37.19","14.52"
"10","007","00","020","0003","0249","314","123","191","1","315","847","0","37.19","14.52"
"10","007","00","020","0004","0000","379","164","215","0","379","906","0","41.83","18.10"
"10","007","00","020","0004","0250","379","164","215","0","379","906","0","41.83","18.10"
"10","007","00","020","0005","0000","2875","1229","1646","29","2904","7832","0","37.08","15.69"
"10","007","00","020","0005","0308","470","173","297","6","476","1330","0","35.79","13.01"
"10","007","00","020","0005","0309","524","238","286","3","527","1348","0","39.09","17.66"
"10","007","00","020","0005","0310","499","230","269","8","507","1535","0","33.03","14.98"
"10","007","00","020","0005","0311","477","200","277","5","482","1129","0","42.69","17.71"
"10","007","00","020","0005","0312","435","184","251","4","439","1209","0","36.31","15.22"
"10","007","00","020","0005","0313","470","204","266","3","473","1281","0","36.92","15.93"
"10","007","00","020","0006","0000","1816","804","1012","14","1830","5195","0","35.23","15.48"
"10","007","00","020","0006","0304","390","189","201","5","395","1207","0","32.73","15.66"
"10","007","00","020","0006","0305","448","202","246","4","452","1192","0","37.92","16.95"
"10","007","00","020","0006","0306","452","165","287","2","454","1297","0","35.00","12.72"
"10","007","00","020","0006","0307","526","248","278","3","529","1499","0","35.29","16.54"
"10","007","00","020","0007","0000","1926","752","1174","21","1947","5046","0","38.59","14.90"
"10","007","00","020","0007","0251","361","131","230","2","363","973","0","37.31","13.46"
"10","007","00","020","0007","0252","463","168","295","4","467","1104","0","42.30","15.22"
"10","007","00","020","0007","0253","287","110","177","5","292","829","0","35.22","13.27"
"10","007","00","020","0007","0254","286","134","152","0","286","731","0","39.12","18.33"
"10","007","00","020","0007","0255","529","209","320","10","539","1409","0","38.25","14.83"
"10","007","00","020","0008","0000","1602","547","1055","10","1612","4391","0","36.71","12.46"
"10","007","00","020","0008","0258","392","121","271","3","395","1033","0","38.24","11.71"
"10","007","00","020","0008","0259","454","144","310","1","455","1098","0","41.44","13.11"
"10","007","00","020","0008","0260","361","117","244","2","363","1072","0","33.86","10.91"
"10","007","00","020","0008","0261","395","165","230","4","399","1188","0","33.59","13.89"
"10","007","00","020","0009","0000","218","77","141","0","218","521","0","41.84","14.78"
"10","007","00","020","0009","0262","218","77","141","0","218","521","0","41.84","14.78"
"10","007","00","020","0010","0000","399","133","266","1","400","837","0","47.79","15.89"
"10","007","00","020","0010","0256","399","133","266","1","400","837","0","47.79","15.89"
"10","007","00","020","0011","0000","448","171","277","4","452","1126","0","40.14","15.19"
"10","007","00","020","0011","0257","448","171","277","4","452","1126","0","40.14","15.19"
"10","007","00","020","0012","0000","472","235","237","3","475","1084","0","43.82","21.68"
"10","007","00","020","0012","0267","472","235","237","3","475","1084","0","43.82","21.68"
"10","007","00","020","0013","0000","496","220","276","3","499","1130","0","44.16","19.47"
"10","007","00","020","0013","0268","496","220","276","3","499","1130","0","44.16","19.47"
"10","007","00","020","0014","0000","124","61","63","0","124","267","0","46.44","22.85"
"10","007","00","020","0014","0269","124","61","63","0","124","267","0","46.44","22.85"
"10","007","00","020","0015","0000","278","115","163","6","284","618","0","45.95","18.61"
"10","007","00","020","0015","0271","278","115","163","6","284","618","0","45.95","18.61"
"10","007","00","020","0016","0000","250","107","143","1","251","574","0","43.73","18.64"
"10","007","00","020","0016","0270","250","107","143","1","251","574","0","43.73","18.64"
"10","007","00","020","0017","0000","403","120","283","10","413","877","0","47.09","13.68"
"10","007","00","020","0017","0272","403","120","283","10","413","877","0","47.09","13.68"
"10","007","00","020","0018","0000","999","400","599","9","1008","2170","0","46.45","18.43"
"10","007","00","020","0018","0273","505","174","331","5","510","1047","0","48.71","16.62"
"10","007","00","020","0018","0274","494","226","268","4","498","1123","0","44.35","20.12"
"10","007","00","020","0019","0000","1327","683","644","13","1340","3879","0","34.54","17.61"
"10","007","00","020","0019","0291","495","233","262","6","501","1529","0","32.77","15.24"
"10","007","00","020","0019","0292","430","232","198","5","435","1101","0","39.51","21.07"
"10","007","00","020","0019","0293","402","218","184","2","404","1249","0","32.35","17.45"
"10","007","00","020","0020","0000","904","443","461","12","916","2598","0","35.26","17.05"
"10","007","00","020","0020","0294","260","114","146","4","264","858","0","30.77","13.29"
"10","007","00","020","0020","0295","259","155","104","3","262","704","0","37.22","22.02"
"10","007","00","020","0020","0296","385","174","211","5","390","1036","0","37.64","16.80"
"10","007","00","020","0021","0000","1323","693","630","16","1339","4105","0","32.62","16.88"
"10","007","00","020","0021","0301","483","246","237","7","490","1431","0","34.24","17.19"
"10","007","00","020","0021","0302","377","220","157","3","380","1223","0","31.07","17.99"
"10","007","00","020","0021","0303","463","227","236","6","469","1451","0","32.32","15.64"
"10","007","00","020","0022","0000","1456","771","685","15","1471","4124","0","35.67","18.70"
"10","007","00","020","0022","0297","324","196","128","6","330","928","0","35.56","21.12"
"10","007","00","020","0022","0298","370","169","201","4","374","1102","0","33.94","15.34"
"10","007","00","020","0022","0299","358","212","146","2","360","882","0","40.82","24.04"
"10","007","00","020","0022","0300","404","194","210","3","407","1212","0","33.58","16.01"
"10","007","00","020","0023","0000","1166","625","541","10","1176","3189","0","36.88","19.60"
"10","007","00","020","0023","0283","377","212","165","6","383","1006","0","38.07","21.07"
"10","007","00","020","0023","0284","384","206","178","1","385","1026","0","37.52","20.08"
"10","007","00","020","0023","0285","405","207","198","3","408","1157","0","35.26","17.89"
"10","007","00","020","0024","0000","716","399","317","12","728","2191","0","33.23","18.21"
"10","007","00","020","0024","0286","340","206","134","6","346","1181","0","29.30","17.44"
"10","007","00","020","0024","0287","376","193","183","6","382","1010","0","37.82","19.11"
"10","007","00","020","0025","0000","1058","474","584","10","1068","3032","0","35.22","15.63"
"10","007","00","020","0025","0288","371","146","225","2","373","1051","0","35.49","13.89"
"10","007","00","020","0025","0289","352","155","197","6","358","1006","0","35.59","15.41"
"10","007","00","020","0025","0290","335","173","162","2","337","975","0","34.56","17.74"
"10","007","00","020","0026","0000","1182","498","684","12","1194","3575","0","33.40","13.93"
"10","007","00","020","0026","0277","430","186","244","4","434","1154","0","37.61","16.12"
"10","007","00","020","0026","0278","400","188","212","4","404","1208","0","33.44","15.56"
"10","007","00","020","0026","0279","352","124","228","4","356","1213","0","29.35","10.22"
"10","007","00","020","0027","0000","665","294","371","8","673","2076","0","32.42","14.16"
"10","007","00","020","0027","0275","412","189","223","6","418","1326","0","31.52","14.25"
"10","007","00","020","0027","0276","253","105","148","2","255","750","0","34.00","14.00"
"10","007","00","020","0028","0000","899","382","517","17","916","2425","0","37.77","15.75"
"10","007","00","020","0028","0280","309","168","141","4","313","950","0","32.95","17.68"
"10","007","00","020","0028","0281","299","110","189","11","310","735","0","42.18","14.97"
"10","007","00","020","0028","0282","291","104","187","2","293","740","0","39.59","14.05"
"10","007","00","020","0029","0000","1568","665","903","17","1585","4383","0","36.16","15.17"
"10","007","00","020","0029","0263","402","185","217","5","407","1153","0","35.30","16.05"
"10","007","00","020","0029","0264","405","166","239","6","411","1138","0","36.12","14.59"
"10","007","00","020","0029","0265","388","176","212","3","391","1066","0","36.68","16.51"
"10","007","00","020","0029","0266","373","138","235","3","376","1026","0","36.65","13.45"
"10","007","00","030","0000","0000","27342","13417","13925","293","27635","75185","89825","36.76","17.85"
"10","007","00","030","0001","0000","2144","1095","1049","17","2161","6113","0","35.35","17.91"
"10","007","00","030","0001","0386","397","194","203","3","400","1157","0","34.57","16.77"
"10","007","00","030","0001","0387","424","185","239","3","427","1327","0","32.18","13.94"
"10","007","00","030","0001","0388","473","260","213","1","474","1318","0","35.96","19.73"
"10","007","00","030","0001","0389","482","284","198","4","486","1301","0","37.36","21.83"
"10","007","00","030","0001","0390","368","172","196","6","374","1010","0","37.03","17.03"
"10","007","00","030","0002","0000","1646","797","849","12","1658","4323","0","38.35","18.44"
"10","007","00","030","0002","0391","361","164","197","5","366","1064","0","34.40","15.41"
"10","007","00","030","0002","0392","398","186","212","2","400","1007","0","39.72","18.47"
"10","007","00","030","0002","0393","399","194","205","2","401","1004","0","39.94","19.32"
"10","007","00","030","0002","0394","488","253","235","3","491","1248","0","39.34","20.27"
"10","007","00","030","0003","0000","181","105","76","0","181","398","0","45.48","26.38"
"10","007","00","030","0003","0395","181","105","76","0","181","398","0","45.48","26.38"
"10","007","00","030","0004","0000","623","299","324","7","630","1796","0","35.08","16.65"
"10","007","00","030","0004","0396","318","148","170","2","320","816","0","39.22","18.14"
"10","007","00","030","0004","0397","305","151","154","5","310","980","0","31.63","15.41"
"10","007","00","030","0005","0000","1215","599","616","14","1229","3164","0","38.84","18.93"
"10","007","00","030","0005","0398","422","203","219","6","428","1035","0","41.35","19.61"
"10","007","00","030","0005","0399","403","197","206","2","405","1094","0","37.02","18.01"
"10","007","00","030","0005","0400","390","199","191","6","396","1035","0","38.26","19.23"
"10","007","00","030","0006","0000","1016","488","528","10","1026","2785","0","36.84","17.52"
"10","007","00","030","0006","0401","521","208","313","7","528","1406","0","37.55","14.79"
"10","007","00","030","0006","0402","495","280","215","3","498","1379","0","36.11","20.30"
"10","007","00","030","0007","0000","544","283","261","6","550","1672","0","32.89","16.93"
"10","007","00","030","0007","0403","266","136","130","2","268","816","0","32.84","16.67"
"10","007","00","030","0007","0404","278","147","131","4","282","856","0","32.94","17.17"
"10","007","00","030","0008","0000","338","180","158","5","343","847","0","40.50","21.25"
"10","007","00","030","0008","0444","338","180","158","5","343","847","0","40.50","21.25"
"10","007","00","030","0009","0000","804","399","405","6","810","2119","0","38.23","18.83"
"10","007","00","030","0009","0405","507","247","260","2","509","1351","0","37.68","18.28"
"10","007","00","030","0009","0406","297","152","145","4","301","768","0","39.19","19.79"
"10","007","00","030","0010","0000","1054","513","541","16","1070","2869","0","37.30","17.88"
"10","007","00","030","0010","0407","495","244","251","11","506","1457","0","34.73","16.75"
"10","007","00","030","0010","0408","559","269","290","5","564","1412","0","39.94","19.05"
"10","007","00","030","0011","0000","466","234","232","2","468","1464","0","31.97","15.98"
"10","007","00","030","0011","0409","209","89","120","1","210","673","0","31.20","13.22"
"10","007","00","030","0011","0410","257","145","112","1","258","791","0","32.62","18.33"
"10","007","00","030","0012","0000","617","308","309","8","625","1857","0","33.66","16.59"
"10","007","00","030","0012","0411","327","162","165","2","329","970","0","33.92","16.70"
"10","007","00","030","0012","0412","290","146","144","6","296","887","0","33.37","16.46"
"10","007","00","030","0013","0000","812","392","420","6","818","2204","0","37.11","17.79"
"10","007","00","030","0013","0413","424","191","233","5","429","1151","0","37.27","16.59"
"10","007","00","030","0013","0414","388","201","187","1","389","1053","0","36.94","19.09"
"10","007","00","030","0014","0000","458","207","251","5","463","1318","0","35.13","15.71"
"10","007","00","030","0014","0415","458","207","251","5","463","1318","0","35.13","15.71"
"10","007","00","030","0015","0000","2004","1050","954","11","2015","5228","0","38.54","20.08"
"10","007","00","030","0015","0416","447","229","218","3","450","1162","0","38.73","19.71"
"10","007","00","030","0015","0417","493","266","227","2","495","1285","0","38.52","20.70"
"10","007","00","030","0015","0418","492","258","234","1","493","1248","0","39.50","20.67"
"10","007","00","030","0015","0419","572","297","275","5","577","1533","0","37.64","19.37"
"10","007","00","030","0016","0000","725","376","349","7","732","1959","0","37.37","19.19"
"10","007","00","030","0016","0422","413","210","203","3","416","1029","0","40.43","20.41"
"10","007","00","030","0016","0423","312","166","146","4","316","930","0","33.98","17.85"
"10","007","00","030","0017","0000","1061","496","565","12","1073","2669","0","40.20","18.58"
"10","007","00","030","0017","0426","519","234","285","10","529","1322","0","40.02","17.70"
"10","007","00","030","0017","0427","542","262","280","2","544","1347","0","40.39","19.45"
"10","007","00","030","0018","0000","764","375","389","8","772","2034","0","37.95","18.44"
"10","007","00","030","0018","0424","397","181","216","5","402","1016","0","39.57","17.81"
"10","007","00","030","0018","0425","367","194","173","3","370","1018","0","36.35","19.06"
"10","007","00","030","0019","0000","1179","531","648","22","1201","3450","0","34.81","15.39"
"10","007","00","030","0019","0428","396","179","217","9","405","1157","0","35.00","15.47"
"10","007","00","030","0019","0429","388","168","220","5","393","1105","0","35.57","15.20"
"10","007","00","030","0019","0430","395","184","211","8","403","1188","0","33.92","15.49"
"10","007","00","030","0020","0000","357","151","206","7","364","868","0","41.94","17.40"
"10","007","00","030","0020","0431","357","151","206","7","364","868","0","41.94","17.40"
"10","007","00","030","0021","0000","962","501","461","21","983","2388","0","41.16","20.98"
"10","007","00","030","0021","0432","440","207","233","9","449","1115","0","40.27","18.57"
"10","007","00","030","0021","0433","522","294","228","12","534","1273","0","41.95","23.10"
"10","007","00","030","0022","0000","911","404","507","17","928","2277","0","40.76","17.74"
"10","007","00","030","0022","0434","422","189","233","11","433","1077","0","40.20","17.55"
"10","007","00","030","0022","0435","489","215","274","6","495","1200","0","41.25","17.92"
"10","007","00","030","0023","0000","361","170","191","7","368","1109","0","33.18","15.33"
"10","007","00","030","0023","0436","361","170","191","7","368","1109","0","33.18","15.33"
"10","007","00","030","0024","0000","1055","492","563","10","1065","2845","0","37.43","17.29"
"10","007","00","030","0024","0437","341","158","183","5","346","914","0","37.86","17.29"
"10","007","00","030","0024","0438","359","166","193","3","362","972","0","37.24","17.08"
"10","007","00","030","0024","0439","355","168","187","2","357","959","0","37.23","17.52"
"10","007","00","030","0025","0000","1556","832","724","14","1570","4308","0","36.44","19.31"
"10","007","00","030","0025","0440","360","198","162","6","366","985","0","37.16","20.10"
"10","007","00","030","0025","0441","424","244","180","2","426","1054","0","40.42","23.15"
"10","007","00","030","0025","0442","402","205","197","3","405","1160","0","34.91","17.67"
"10","007","00","030","0025","0443","370","185","185","3","373","1109","0","33.63","16.68"
"10","007","00","030","0026","0000","590","309","281","5","595","1748","0","34.04","17.68"
"10","007","00","030","0026","0445","286","143","143","4","290","865","0","33.53","16.53"
"10","007","00","030","0026","0446","304","166","138","1","305","883","0","34.54","18.80"
"10","007","00","030","0027","0000","246","138","108","1","247","842","0","29.33","16.39"
"10","007","00","030","0027","0447","246","138","108","1","247","842","0","29.33","16.39"
"10","007","00","030","0028","0000","449","191","258","3","452","1196","0","37.79","15.97"
"10","007","00","030","0028","0448","449","191","258","3","452","1196","0","37.79","15.97"
"10","007","00","030","0029","0000","627","301","326","5","632","2038","0","31.01","14.77"
"10","007","00","030","0029","0449","379","185","194","1","380","1088","0","34.93","17.00"
"10","007","00","030","0029","0450","248","116","132","4","252","950","0","26.53","12.21"
"10","007","00","030","0030","0000","1122","501","621","15","1137","3033","0","37.49","16.52"
"10","007","00","030","0030","0451","368","155","213","7","375","1022","0","36.69","15.17"
"10","007","00","030","0030","0452","404","182","222","4","408","1006","0","40.56","18.09"
"10","007","00","030","0030","0453","350","164","186","4","354","1005","0","35.22","16.32"
"10","007","00","030","0031","0000","563","257","306","7","570","1548","0","36.82","16.60"
"10","007","00","030","0031","0454","237","110","127","2","239","684","0","34.94","16.08"
"10","007","00","030","0031","0455","326","147","179","5","331","864","0","38.31","17.01"
"10","007","00","030","0032","0000","892","443","449","7","899","2716","0","33.10","16.31"
"10","007","00","030","0032","0420","457","198","259","1","458","1363","0","33.60","14.53"
"10","007","00","030","0032","0421","435","245","190","6","441","1353","0","32.59","18.11"
"10","007","00","040","0000","0000","4843","2672","2171","52","4895","14031","16573","34.89","19.04"
"10","007","00","040","0001","0000","433","279","154","3","436","1187","0","36.73","23.50"
"10","007","00","040","0001","0485","433","279","154","3","436","1187","0","36.73","23.50"
"10","007","00","040","0002","0000","828","498","330","11","839","2276","0","36.86","21.88"
"10","007","00","040","0002","0484","387","211","176","6","393","1042","0","37.72","20.25"
"10","007","00","040","0002","0486","441","287","154","5","446","1234","0","36.14","23.26"
"10","007","00","040","0003","0000","778","417","361","10","788","2324","0","33.91","17.94"
"10","007","00","040","0003","0487","384","205","179","3","387","1195","0","32.38","17.15"
"10","007","00","040","0003","0488","394","212","182","7","401","1129","0","35.52","18.78"
"10","007","00","040","0004","0000","441","227","214","2","443","1240","0","35.73","18.31"
"10","007","00","040","0004","0489","441","227","214","2","443","1240","0","35.73","18.31"
"10","007","00","040","0005","0000","382","212","170","4","386","1223","0","31.56","17.33"
"10","007","00","040","0005","0490","382","212","170","4","386","1223","0","31.56","17.33"
"10","007","00","040","0006","0000","681","327","354","8","689","1914","0","36.00","17.08"
"10","007","00","040","0006","0491","345","160","185","4","349","966","0","36.13","16.56"
"10","007","00","040","0006","0492","336","167","169","4","340","948","0","35.86","17.62"
"10","007","00","040","0007","0000","794","436","358","9","803","2519","0","31.88","17.31"
"10","007","00","040","0007","0493","417","237","180","3","420","1233","0","34.06","19.22"
"10","007","00","040","0007","0494","377","199","178","6","383","1286","0","29.78","15.47"
"10","007","00","040","0008","0000","506","276","230","5","511","1348","0","37.91","20.47"
"10","007","00","040","0008","0495","506","276","230","5","511","1348","0","37.91","20.47"
"10","007","00","050","0000","0000","10246","5271","4975","108","10354","31273","37802","33.11","16.85"
"10","007","00","050","0001","0000","529","249","280","7","536","1748","0","30.66","14.24"
"10","007","00","050","0001","0471","295","113","182","6","301","883","0","34.09","12.80"
"10","007","00","050","0001","0472","234","136","98","1","235","865","0","27.17","15.72"
"10","007","00","050","0002","0000","417","127","290","4","421","1157","0","36.39","10.98"
"10","007","00","050","0002","0473","417","127","290","4","421","1157","0","36.39","10.98"
"10","007","00","050","0003","0000","480","236","244","6","486","1484","0","32.75","15.90"
"10","007","00","050","0003","0478","480","236","244","6","486","1484","0","32.75","15.90"
"10","007","00","050","0004","0000","693","315","378","4","697","2048","0","34.03","15.38"
"10","007","00","050","0004","0462","285","127","158","1","286","927","0","30.85","13.70"
"10","007","00","050","0004","0463","408","188","220","3","411","1121","0","36.66","16.77"
"10","007","00","050","0005","0000","675","393","282","6","681","1990","0","34.22","19.75"
"10","007","00","050","0005","0468","353","192","161","4","357","1078","0","33.12","17.81"
"10","007","00","050","0005","0469","322","201","121","2","324","912","0","35.53","22.04"
"10","007","00","050","0006","0000","454","232","222","7","461","1273","0","36.21","18.22"
"10","007","00","050","0006","0470","454","232","222","7","461","1273","0","36.21","18.22"
"10","007","00","050","0007","0000","663","337","326","8","671","1826","0","36.75","18.46"
"10","007","00","050","0007","0458","364","202","162","4","368","948","0","38.82","21.31"
"10","007","00","050","0007","0459","299","135","164","4","303","878","0","34.51","15.38"
"10","007","00","050","0008","0000","502","344","158","4","506","1714","0","29.52","20.07"
"10","007","00","050","0008","0460","252","181","71","2","254","818","0","31.05","22.13"
"10","007","00","050","0008","0461","250","163","87","2","252","896","0","28.13","18.19"
"10","007","00","050","0009","0000","840","436","404","17","857","2652","0","32.32","16.44"
"10","007","00","050","0009","0464","474","242","232","13","487","1365","0","35.68","17.73"
"10","007","00","050","0009","0465","366","194","172","4","370","1287","0","28.75","15.07"
"10","007","00","050","0010","0000","1714","872","842","12","1726","5173","0","33.37","16.86"
"10","007","00","050","0010","0474","501","251","250","1","502","1359","0","36.94","18.47"
"10","007","00","050","0010","0475","426","220","206","3","429","1345","0","31.90","16.36"
"10","007","00","050","0010","0476","370","168","202","5","375","1170","0","32.05","14.36"
"10","007","00","050","0010","0477","417","233","184","3","420","1299","0","32.33","17.94"
"10","007","00","050","0011","0000","619","375","244","6","625","2344","0","26.66","16.00"
"10","007","00","050","0011","0466","303","187","116","2","305","1101","0","27.70","16.98"
"10","007","00","050","0011","0467","316","188","128","4","320","1243","0","25.74","15.12"
"10","007","00","050","0012","0000","954","449","505","8","962","2622","0","36.69","17.12"
"10","007","00","050","0012","0456","484","236","248","4","488","1194","0","40.87","19.77"
"10","007","00","050","0012","0457","470","213","257","4","474","1428","0","33.19","14.92"
"10","007","00","050","0013","0000","983","523","460","6","989","3002","0","32.94","17.42"
"10","007","00","050","0013","0479","346","176","170","3","349","992","0","35.18","17.74"
"10","007","00","050","0013","0480","327","200","127","3","330","1008","0","32.74","19.84"
"10","007","00","050","0013","0481","310","147","163","0","310","1002","0","30.94","14.67"
"10","007","00","050","0014","0000","723","383","340","13","736","2240","0","32.86","17.10"
"10","007","00","050","0014","0482","345","172","173","4","349","1098","0","31.79","15.66"
"10","007","00","050","0014","0483","378","211","167","9","387","1142","0","33.89","18.48"
"10","007","00","060","0000","0000","13163","5714","7449","156","13319","39495","46114","33.72","14.47"
"10","007","00","060","0001","0000","530","166","364","2","532","1480","0","35.95","11.22"
"10","007","00","060","0001","0326","530","166","364","2","532","1480","0","35.95","11.22"
"10","007","00","060","0002","0000","490","199","291","5","495","1453","0","34.07","13.70"
"10","007","00","060","0002","0325","490","199","291","5","495","1453","0","34.07","13.70"
"10","007","00","060","0003","0000","448","199","249","7","455","1237","0","36.78","16.09"
"10","007","00","060","0003","0320","448","199","249","7","455","1237","0","36.78","16.09"
"10","007","00","060","0004","0000","507","205","302","6","513","1505","0","34.09","13.62"
"10","007","00","060","0004","0318","229","89","140","3","232","708","0","32.77","12.57"
"10","007","00","060","0004","0319","278","116","162","3","281","797","0","35.26","14.55"
"10","007","00","060","0005","0000","423","155","268","2","425","1168","0","36.39","13.27"
"10","007","00","060","0005","0317","423","155","268","2","425","1168","0","36.39","13.27"
"10","007","00","060","0006","0000","449","196","253","6","455","1273","0","35.74","15.40"
"10","007","00","060","0006","0316","449","196","253","6","455","1273","0","35.74","15.40"
"10","007","00","060","0007","0000","533","217","316","10","543","1360","0","39.93","15.96"
"10","007","00","060","0007","0314","533","217","316","10","543","1360","0","39.93","15.96"
"10","007","00","060","0008","0000","367","145","222","2","369","832","0","44.35","17.43"
"10","007","00","060","0008","0315","367","145","222","2","369","832","0","44.35","17.43"
"10","007","00","060","0009","0000","728","363","365","4","732","2397","0","30.54","15.14"
"10","007","00","060","0009","0321","453","214","239","2","455","1453","0","31.31","14.73"
"10","007","00","060","0009","0322","275","149","126","2","277","944","0","29.34","15.78"
"10","007","00","060","0010","0000","934","433","501","9","943","2653","0","35.54","16.32"
"10","007","00","060","0010","0323","445","206","239","7","452","1302","0","34.72","15.82"
"10","007","00","060","0010","0324","489","227","262","2","491","1351","0","36.34","16.80"
"10","007","00","060","0011","0000","815","347","468","8","823","2550","0","32.27","13.61"
"10","007","00","060","0011","0331","329","138","191","4","333","1082","0","30.78","12.75"
"10","007","00","060","0011","0332","486","209","277","4","490","1468","0","33.38","14.24"
"10","007","00","060","0012","0000","367","196","171","6","373","1172","0","31.83","16.72"
"10","007","00","060","0012","0338","367","196","171","6","373","1172","0","31.83","16.72"
"10","007","00","060","0013","0000","376","114","262","11","387","1047","0","36.96","10.89"
"10","007","00","060","0013","0339","376","114","262","11","387","1047","0","36.96","10.89"
"10","007","00","060","0014","0000","631","248","383","13","644","2180","0","29.54","11.38"
"10","007","00","060","0014","0346","312","117","195","3","315","1041","0","30.26","11.24"
"10","007","00","060","0014","0347","319","131","188","10","329","1139","0","28.88","11.50"
"10","007","00","060","0015","0000","584","291","293","9","593","1856","0","31.95","15.68"
"10","007","00","060","0015","0344","300","139","161","1","301","891","0","33.78","15.60"
"10","007","00","060","0015","0345","284","152","132","8","292","965","0","30.26","15.75"
"10","007","00","060","0016","0000","645","347","298","10","655","2276","0","28.78","15.25"
"10","007","00","060","0016","0342","296","155","141","5","301","992","0","30.34","15.63"
"10","007","00","060","0016","0343","349","192","157","5","354","1284","0","27.57","14.95"
"10","007","00","060","0017","0000","331","185","146","5","336","1276","0","26.33","14.50"
"10","007","00","060","0017","0341","331","185","146","5","336","1276","0","26.33","14.50"
"10","007","00","060","0018","0000","454","196","258","7","461","1275","0","36.16","15.37"
"10","007","00","060","0018","0340","454","196","258","7","461","1275","0","36.16","15.37"
"10","007","00","060","0019","0000","1293","542","751","10","1303","3643","0","35.77","14.88"
"10","007","00","060","0019","0333","466","185","281","2","468","1255","0","37.29","14.74"
"10","007","00","060","0019","0334","446","207","239","5","451","1273","0","35.43","16.26"
"10","007","00","060","0019","0335","381","150","231","3","384","1115","0","34.44","13.45"
"10","007","00","060","0020","0000","818","324","494","11","829","2581","0","32.12","12.55"
"10","007","00","060","0020","0336","360","107","253","4","364","1154","0","31.54","9.27"
"10","007","00","060","0020","0337","458","217","241","7","465","1427","0","32.59","15.21"
"10","007","00","060","0021","0000","750","335","415","3","753","2364","0","31.85","14.17"
"10","007","00","060","0021","0329","304","135","169","1","305","1038","0","29.38","13.01"
"10","007","00","060","0021","0330","446","200","246","2","448","1326","0","33.79","15.08"
"10","007","00","060","0022","0000","690","311","379","10","700","1917","0","36.52","16.22"
"10","007","00","060","0022","0327","298","120","178","2","300","886","0","33.86","13.54"
"10","007","00","060","0022","0328","392","191","201","8","400","1031","0","38.80","18.53"
"10","007","00","070","0000","0000","12467","5979","6488","121","12588","32451","38830","38.79","18.42"
"10","007","00","070","0001","0000","684","293","391","7","691","1676","0","41.23","17.48"
"10","007","00","070","0001","0348","314","154","160","3","317","810","0","39.14","19.01"
"10","007","00","070","0001","0349","370","139","231","4","374","866","0","43.19","16.05"
"10","007","00","070","0002","0000","850","361","489","10","860","2038","0","42.20","17.71"
"10","007","00","070","0002","0350","426","183","243","5","431","1028","0","41.93","17.80"
"10","007","00","070","0002","0351","424","178","246","5","429","1010","0","42.48","17.62"
"10","007","00","070","0003","0000","1039","585","454","8","1047","2642","0","39.63","22.14"
"10","007","00","070","0003","0352","382","205","177","3","385","981","0","39.25","20.90"
"10","007","00","070","0003","0353","301","174","127","3","304","802","0","37.91","21.70"
"10","007","00","070","0003","0354","356","206","150","2","358","859","0","41.68","23.98"
"10","007","00","070","0004","0000","636","329","307","8","644","1828","0","35.23","18.00"
"10","007","00","070","0004","0357","321","176","145","3","324","930","0","34.84","18.92"
"10","007","00","070","0004","0358","315","153","162","5","320","898","0","35.63","17.04"
"10","007","00","070","0005","0000","505","275","230","3","508","1438","0","35.33","19.12"
"10","007","00","070","0005","0355","241","121","120","2","243","680","0","35.74","17.79"
"10","007","00","070","0005","0356","264","154","110","1","265","758","0","34.96","20.32"
"10","007","00","070","0006","0000","1487","736","751","13","1500","3871","0","38.75","19.01"
"10","007","00","070","0006","0359","360","187","173","3","363","861","0","42.16","21.72"
"10","007","00","070","0006","0360","328","175","153","1","329","857","0","38.39","20.42"
"10","007","00","070","0006","0361","407","176","231","5","412","1050","0","39.24","16.76"
"10","007","00","070","0006","0362","392","198","194","4","396","1103","0","35.90","17.95"
"10","007","00","070","0007","0000","1268","597","671","11","1279","3154","0","40.55","18.93"
"10","007","00","070","0007","0363","303","145","158","0","303","717","0","42.26","20.22"
"10","007","00","070","0007","0364","397","163","234","3","400","1011","0","39.56","16.12"
"10","007","00","070","0007","0365","317","164","153","3","320","783","0","40.87","20.95"
"10","007","00","070","0007","0366","251","125","126","5","256","643","0","39.81","19.44"
"10","007","00","070","0008","0000","888","405","483","16","904","2279","0","39.67","17.77"
"10","007","00","070","0008","0367","285","140","145","4","289","732","0","39.48","19.13"
"10","007","00","070","0008","0368","257","120","137","3","260","661","0","39.33","18.15"
"10","007","00","070","0008","0369","346","145","201","9","355","886","0","40.07","16.37"
"10","007","00","070","0009","0000","509","267","242","5","514","1479","0","34.75","18.05"
"10","007","00","070","0009","0370","233","120","113","3","236","723","0","32.64","16.60"
"10","007","00","070","0009","0371","276","147","129","2","278","756","0","36.77","19.44"
"10","007","00","070","0010","0000","1682","815","867","15","1697","4523","0","37.52","18.02"
"10","007","00","070","0010","0372","320","143","177","5","325","907","0","35.83","15.77"
"10","007","00","070","0010","0373","293","141","152","3","296","827","0","35.79","17.05"
"10","007","00","070","0010","0374","298","159","139","2","300","842","0","35.63","18.88"
"10","007","00","070","0010","0375","391","186","205","3","394","1004","0","39.24","18.53"
"10","007","00","070","0010","0376","380","186","194","2","382","943","0","40.51","19.72"
"10","007","00","070","0011","0000","843","397","446","9","852","1939","0","43.94","20.47"
"10","007","00","070","0011","0377","354","166","188","4","358","855","0","41.87","19.42"
"10","007","00","070","0011","0378","489","231","258","5","494","1084","0","45.57","21.31"
"10","007","00","070","0012","0000","633","325","308","7","640","1677","0","38.16","19.38"
"10","007","00","070","0012","0379","321","161","160","3","324","892","0","36.32","18.05"
"10","007","00","070","0012","0380","312","164","148","4","316","785","0","40.25","20.89"
"10","007","00","070","0013","0000","669","273","396","4","673","1737","0","38.74","15.72"
"10","007","00","070","0013","0381","325","138","187","2","327","810","0","40.37","17.04"
"10","007","00","070","0013","0382","344","135","209","2","346","927","0","37.32","14.56"
"10","007","00","070","0014","0000","774","321","453","5","779","2170","0","35.90","14.79"
"10","007","00","070","0014","0383","230","113","117","0","230","672","0","34.23","16.82"
"10","007","00","070","0014","0384","233","126","107","2","235","660","0","35.61","19.09"
"10","007","00","070","0014","0385","311","82","229","3","314","838","0","37.47","9.79"
"10","007","00","080","0000","0000","14490","7510","6980","168","14658","38651","45018","37.92","19.43"
"10","007","00","080","0001","0000","1324","684","640","13","1337","3179","0","42.06","21.52"
"10","007","00","080","0001","0188","354","171","183","4","358","895","0","40.00","19.11"
"10","007","00","080","0001","0189","403","231","172","5","408","964","0","42.32","23.96"
"10","007","00","080","0001","0190","567","282","285","4","571","1320","0","43.26","21.36"
"10","007","00","080","0002","0000","674","328","346","15","689","1758","0","39.19","18.66"
"10","007","00","080","0002","0191","301","139","162","11","312","783","0","39.85","17.75"
"10","007","00","080","0002","0192","373","189","184","4","377","975","0","38.67","19.38"
"10","007","00","080","0003","0000","922","479","443","5","927","2329","0","39.80","20.57"
"10","007","00","080","0003","0193","436","209","227","3","439","1108","0","39.62","18.86"
"10","007","00","080","0003","0194","486","270","216","2","488","1221","0","39.97","22.11"
"10","007","00","080","0004","0000","454","197","257","10","464","1069","0","43.41","18.43"
"10","007","00","080","0004","0196","454","197","257","10","464","1069","0","43.41","18.43"
"10","007","00","080","0005","0000","559","251","308","5","564","1419","0","39.75","17.69"
"10","007","00","080","0005","0195","559","251","308","5","564","1419","0","39.75","17.69"
"10","007","00","080","0006","0000","752","385","367","11","763","1892","0","40.33","20.35"
"10","007","00","080","0006","0197","336","165","171","4","340","901","0","37.74","18.31"
"10","007","00","080","0006","0198","416","220","196","7","423","991","0","42.68","22.20"
"10","007","00","080","0007","0000","296","134","162","1","297","721","0","41.19","18.59"
"10","007","00","080","0007","0201","296","134","162","1","297","721","0","41.19","18.59"
"10","007","00","080","0008","0000","731","380","351","6","737","1803","0","40.88","21.08"
"10","007","00","080","0008","0199","480","250","230","1","481","1114","0","43.18","22.44"
"10","007","00","080","0008","0200","251","130","121","5","256","689","0","37.16","18.87"
"10","007","00","080","0009","0000","1888","1038","850","20","1908","4928","0","38.72","21.06"
"10","007","00","080","0009","0210","440","256","184","2","442","1127","0","39.22","22.72"
"10","007","00","080","0009","0211","493","248","245","7","500","1291","0","38.73","19.21"
"10","007","00","080","0009","0212","507","294","213","6","513","1279","0","40.11","22.99"
"10","007","00","080","0009","0213","448","240","208","5","453","1231","0","36.80","19.50"
"10","007","00","080","0010","0000","1134","568","566","14","1148","3092","0","37.13","18.37"
"10","007","00","080","0010","0202","369","176","193","5","374","980","0","38.16","17.96"
"10","007","00","080","0010","0203","343","178","165","3","346","956","0","36.19","18.62"
"10","007","00","080","0010","0204","422","214","208","6","428","1156","0","37.02","18.51"
"10","007","00","080","0011","0000","1711","916","795","16","1727","4602","0","37.53","19.90"
"10","007","00","080","0011","0205","406","237","169","4","410","1129","0","36.32","20.99"
"10","007","00","080","0011","0206","374","213","161","5","379","1118","0","33.90","19.05"
"10","007","00","080","0011","0207","469","220","249","6","475","1237","0","38.40","17.78"
"10","007","00","080","0011","0208","462","246","216","1","463","1118","0","41.41","22.00"
"10","007","00","080","0012","0000","516","220","296","7","523","1340","0","39.03","16.42"
"10","007","00","080","0012","0209","516","220","296","7","523","1340","0","39.03","16.42"
"10","007","00","080","0013","0000","1154","627","527","13","1167","3298","0","35.39","19.01"
"10","007","00","080","0013","0214","367","209","158","2","369","1153","0","32.00","18.13"
"10","007","00","080","0013","0215","369","197","172","2","371","1019","0","36.41","19.33"
"10","007","00","080","0013","0216","418","221","197","9","427","1126","0","37.92","19.63"
"10","007","00","080","0014","0000","308","182","126","4","312","890","0","35.06","20.45"
"10","007","00","080","0014","0217","308","182","126","4","312","890","0","35.06","20.45"
"10","007","00","080","0015","0000","336","160","176","6","342","932","0","36.70","17.17"
"10","007","00","080","0015","0218","336","160","176","6","342","932","0","36.70","17.17"
"10","007","00","080","0016","0000","661","361","300","9","670","1906","0","35.15","18.94"
"10","007","00","080","0016","0219","351","209","142","5","356","967","0","36.81","21.61"
"10","007","00","080","0016","0220","310","152","158","4","314","939","0","33.44","16.19"
"10","007","00","080","0017","0000","578","319","259","5","583","1888","0","30.88","16.90"
"10","007","00","080","0017","0221","417","230","187","5","422","1369","0","30.83","16.80"
"10","007","00","080","0017","0222","161","89","72","0","161","519","0","31.02","17.15"
"10","007","00","080","0018","0000","492","281","211","8","500","1605","0","31.15","17.51"
"10","007","00","080","0018","0223","279","170","109","6","285","891","0","31.99","19.08"
"10","007","00","080","0018","0224","213","111","102","2","215","714","0","30.11","15.55"
"10","007","00","090","0000","0000","7213","3330","3883","99","7312","20114","22927","36.35","16.56"
"10","007","00","090","0001","0000","586","286","300","10","596","1743","0","34.19","16.41"
"10","007","00","090","0001","0225","319","157","162","5","324","945","0","34.29","16.61"
"10","007","00","090","0001","0226","267","129","138","5","272","798","0","34.09","16.17"
"10","007","00","090","0002","0000","473","233","240","3","476","1387","0","34.32","16.80"
"10","007","00","090","0002","0227","230","120","110","2","232","678","0","34.22","17.70"
"10","007","00","090","0002","0228","243","113","130","1","244","709","0","34.41","15.94"
"10","007","00","090","0003","0000","677","338","339","7","684","1754","0","39.00","19.27"
"10","007","00","090","0003","0229","395","188","207","4","399","920","0","43.37","20.43"
"10","007","00","090","0003","0230","282","150","132","3","285","834","0","34.17","17.99"
"10","007","00","090","0004","0000","859","411","448","12","871","2452","0","35.52","16.76"
"10","007","00","090","0004","0232","425","202","223","7","432","1210","0","35.70","16.69"
"10","007","00","090","0004","0233","434","209","225","5","439","1242","0","35.35","16.83"
"10","007","00","090","0005","0000","890","379","511","12","902","2344","0","38.48","16.17"
"10","007","00","090","0005","0234","414","185","229","5","419","1186","0","35.33","15.60"
"10","007","00","090","0005","0235","476","194","282","7","483","1158","0","41.71","16.75"
"10","007","00","090","0006","0000","651","356","295","16","667","1622","0","41.12","21.95"
"10","007","00","090","0006","0236","414","215","199","8","422","1045","0","40.38","20.57"
"10","007","00","090","0006","0237","237","141","96","8","245","577","0","42.46","24.44"
"10","007","00","090","0007","0000","302","135","167","2","304","877","0","34.66","15.39"
"10","007","00","090","0007","0238","302","135","167","2","304","877","0","34.66","15.39"
"10","007","00","090","0008","0000","413","166","247","4","417","1142","0","36.51","14.54"
"10","007","00","090","0008","0239","413","166","247","4","417","1142","0","36.51","14.54"
"10","007","00","090","0009","0000","217","94","123","6","223","647","0","34.47","14.53"
"10","007","00","090","0009","0240","217","94","123","6","223","647","0","34.47","14.53"
"10","007","00","090","0010","0000","627","273","354","9","636","1646","0","38.64","16.59"
"10","007","00","090","0010","0241","298","126","172","5","303","807","0","37.55","15.61"
"10","007","00","090","0010","0242","329","147","182","4","333","839","0","39.69","17.52"
"10","007","00","090","0011","0000","348","184","164","1","349","965","0","36.17","19.07"
"10","007","00","090","0011","0243","348","184","164","1","349","965","0","36.17","19.07"
"10","007","00","090","0012","0000","383","150","233","6","389","1139","0","34.15","13.17"
"10","007","00","090","0012","0244","383","150","233","6","389","1139","0","34.15","13.17"
"10","007","00","090","0013","0000","258","91","167","5","263","854","0","30.80","10.66"
"10","007","00","090","0013","0245","258","91","167","5","263","854","0","30.80","10.66"
"10","007","00","090","0014","0000","327","124","203","2","329","966","0","34.06","12.84"
"10","007","00","090","0014","0246","327","124","203","2","329","966","0","34.06","12.84"
"10","007","00","090","0015","0000","202","110","92","4","206","576","0","35.76","19.10"
"10","007","00","090","0015","0231","202","110","92","4","206","576","0","35.76","19.10"
"10","007","00","100","0000","0000","40128","20250","19878","395","40523","101543","123460","39.91","19.94"
"10","007","00","100","0001","0000","408","229","179","6","414","1051","0","39.39","21.79"
"10","007","00","100","0001","0519","408","229","179","6","414","1051","0","39.39","21.79"
"10","007","00","100","0002","0000","1080","559","521","9","1089","2683","0","40.59","20.83"
"10","007","00","100","0002","0520","358","189","169","4","362","894","0","40.49","21.14"
"10","007","00","100","0002","0521","351","165","186","1","352","910","0","38.68","18.13"
"10","007","00","100","0002","0522","371","205","166","4","375","879","0","42.66","23.32"
"10","007","00","100","0003","0000","1306","694","612","10","1316","3068","0","42.89","22.62"
"10","007","00","100","0003","0543","362","205","157","4","366","835","0","43.83","24.55"
"10","007","00","100","0003","0544","491","259","232","4","495","1166","0","42.45","22.21"
"10","007","00","100","0003","0545","453","230","223","2","455","1067","0","42.64","21.56"
"10","007","00","100","0004","0000","1098","558","540","9","1107","2540","0","43.58","21.97"
"10","007","00","100","0004","0546","355","169","186","2","357","834","0","42.81","20.26"
"10","007","00","100","0004","0547","395","204","191","2","397","887","0","44.76","23.00"
"10","007","00","100","0004","0548","348","185","163","5","353","819","0","43.10","22.59"
"10","007","00","100","0005","0000","334","150","184","5","339","695","0","48.78","21.58"
"10","007","00","100","0005","0549","334","150","184","5","339","695","0","48.78","21.58"
"10","007","00","100","0006","0000","1099","570","529","14","1113","2785","0","39.96","20.47"
"10","007","00","100","0006","0550","360","198","162","5","365","860","0","42.44","23.02"
"10","007","00","100","0006","0551","358","180","178","5","363","872","0","41.63","20.64"
"10","007","00","100","0006","0552","381","192","189","4","385","1053","0","36.56","18.23"
"10","007","00","100","0007","0000","349","171","178","2","351","754","0","46.55","22.68"
"10","007","00","100","0007","0553","349","171","178","2","351","754","0","46.55","22.68"
"10","007","00","100","0008","0000","287","150","137","1","288","571","0","50.44","26.27"
"10","007","00","100","0008","0554","287","150","137","1","288","571","0","50.44","26.27"
"10","007","00","100","0009","0000","681","341","340","8","689","1808","0","38.11","18.86"
"10","007","00","100","0009","0523","306","145","161","5","311","844","0","36.85","17.18"
"10","007","00","100","0009","0524","375","196","179","3","378","964","0","39.21","20.33"
"10","007","00","100","0010","0000","2269","1094","1175","22","2291","5571","0","41.12","19.64"
"10","007","00","100","0010","0525","394","173","221","4","398","1075","0","37.02","16.09"
"10","007","00","100","0010","0526","463","228","235","5","468","1084","0","43.17","21.03"
"10","007","00","100","0010","0527","421","199","222","3","424","1048","0","40.46","18.99"
"10","007","00","100","0010","0528","533","270","263","6","539","1261","0","42.74","21.41"
"10","007","00","100","0010","0529","458","224","234","4","462","1103","0","41.89","20.31"
"10","007","00","100","0011","0000","953","442","511","9","962","2460","0","39.11","17.97"
"10","007","00","100","0011","0577","458","244","214","4","462","1206","0","38.31","20.23"
"10","007","00","100","0011","0578","495","198","297","5","500","1254","0","39.87","15.79"
"10","007","00","100","0012","0000","1744","856","888","16","1760","4122","0","42.70","20.77"
"10","007","00","100","0012","0579","559","256","303","6","565","1347","0","41.95","19.01"
"10","007","00","100","0012","0580","467","230","237","4","471","1083","0","43.49","21.24"
"10","007","00","100","0012","0581","362","191","171","1","363","802","0","45.26","23.82"
"10","007","00","100","0012","0582","356","179","177","5","361","890","0","40.56","20.11"
"10","007","00","100","0013","0000","2122","1066","1056","14","2136","5313","0","40.20","20.06"
"10","007","00","100","0013","0583","669","353","316","3","672","1640","0","40.98","21.52"
"10","007","00","100","0013","0584","497","231","266","4","501","1297","0","38.63","17.81"
"10","007","00","100","0013","0585","475","250","225","2","477","1323","0","36.05","18.90"
"10","007","00","100","0013","0586","481","232","249","5","486","1053","0","46.15","22.03"
"10","007","00","100","0014","0000","1825","967","858","17","1842","4646","0","39.65","20.81"
"10","007","00","100","0014","0587","354","150","204","1","355","835","0","42.51","17.96"
"10","007","00","100","0014","0588","318","171","147","2","320","802","0","39.90","21.32"
"10","007","00","100","0014","0589","372","213","159","5","377","931","0","40.49","22.88"
"10","007","00","100","0014","0590","364","213","151","7","371","981","0","37.82","21.71"
"10","007","00","100","0014","0591","417","220","197","2","419","1097","0","38.20","20.05"
"10","007","00","100","0015","0000","574","307","267","4","578","1675","0","34.51","18.33"
"10","007","00","100","0015","0592","312","195","117","2","314","868","0","36.18","22.47"
"10","007","00","100","0015","0593","262","112","150","2","264","807","0","32.71","13.88"
"10","007","00","100","0016","0000","740","381","359","11","751","2088","0","35.97","18.25"
"10","007","00","100","0016","0594","454","229","225","6","460","1207","0","38.11","18.97"
"10","007","00","100","0016","0595","286","152","134","5","291","881","0","33.03","17.25"
"10","007","00","100","0017","0000","1060","524","536","9","1069","2693","0","39.70","19.46"
"10","007","00","100","0017","0555","493","247","246","2","495","1307","0","37.87","18.90"
"10","007","00","100","0017","0556","567","277","290","7","574","1386","0","41.41","19.99"
"10","007","00","100","0018","0000","2373","1256","1117","15","2388","6107","0","39.10","20.57"
"10","007","00","100","0018","0561","511","286","225","2","513","1118","0","45.89","25.58"
"10","007","00","100","0018","0562","291","161","130","1","292","843","0","34.64","19.10"
"10","007","00","100","0018","0563","416","219","197","6","422","1115","0","37.85","19.64"
"10","007","00","100","0018","0564","414","222","192","4","418","1186","0","35.24","18.72"
"10","007","00","100","0018","0565","389","208","181","1","390","953","0","40.92","21.83"
"10","007","00","100","0018","0566","352","160","192","1","353","892","0","39.57","17.94"
"10","007","00","100","0019","0000","1186","621","565","13","1199","2880","0","41.63","21.56"
"10","007","00","100","0019","0567","404","189","215","3","407","952","0","42.75","19.85"
"10","007","00","100","0019","0568","423","244","179","4","427","984","0","43.39","24.80"
"10","007","00","100","0019","0569","359","188","171","6","365","944","0","38.67","19.92"
"10","007","00","100","0020","0000","688","324","364","12","700","1929","0","36.29","16.80"
"10","007","00","100","0020","0530","360","198","162","6","366","1067","0","34.30","18.56"
"10","007","00","100","0020","0531","328","126","202","6","334","862","0","38.75","14.62"
"10","007","00","100","0021","0000","1054","508","546","13","1067","2485","0","42.94","20.44"
"10","007","00","100","0021","0532","526","239","287","5","531","1303","0","40.75","18.34"
"10","007","00","100","0021","0533","528","269","259","8","536","1182","0","45.35","22.76"
"10","007","00","100","0022","0000","1377","694","683","10","1387","3290","0","42.16","21.09"
"10","007","00","100","0022","0534","415","197","218","0","415","1028","0","40.37","19.16"
"10","007","00","100","0022","0535","444","224","220","2","446","1030","0","43.30","21.75"
"10","007","00","100","0022","0536","518","273","245","8","526","1232","0","42.69","22.16"
"10","007","00","100","0023","0000","891","386","505","11","902","2363","0","38.17","16.34"
"10","007","00","100","0023","0537","508","210","298","5","513","1280","0","40.08","16.41"
"10","007","00","100","0023","0538","383","176","207","6","389","1083","0","35.92","16.25"
"10","007","00","100","0024","0000","1522","827","695","17","1539","3631","0","42.39","22.78"
"10","007","00","100","0024","0539","298","145","153","6","304","847","0","35.89","17.12"
"10","007","00","100","0024","0540","456","263","193","2","458","1097","0","41.75","23.97"
"10","007","00","100","0024","0541","384","191","193","8","392","818","0","47.92","23.35"
"10","007","00","100","0024","0542","384","228","156","1","385","869","0","44.30","26.24"
"10","007","00","100","0025","0000","874","485","389","10","884","2304","0","38.37","21.05"
"10","007","00","100","0025","0496","385","253","132","6","391","1018","0","38.41","24.85"
"10","007","00","100","0025","0497","489","232","257","4","493","1286","0","38.34","18.04"
"10","007","00","100","0026","0000","1021","570","451","6","1027","2698","0","38.07","21.13"
"10","007","00","100","0026","0498","529","269","260","2","531","1375","0","38.62","19.56"
"10","007","00","100","0026","0499","492","301","191","4","496","1323","0","37.49","22.75"
"10","007","00","100","0027","0000","963","458","505","21","984","2788","0","35.29","16.43"
"10","007","00","100","0027","0500","353","181","172","8","361","1061","0","34.02","17.06"
"10","007","00","100","0027","0501","321","166","155","5","326","955","0","34.14","17.38"
"10","007","00","100","0027","0502","289","111","178","8","297","772","0","38.47","14.38"
"10","007","00","100","0028","0000","582","226","356","7","589","1640","0","35.91","13.78"
"10","007","00","100","0028","0503","297","133","164","2","299","826","0","36.20","16.10"
"10","007","00","100","0028","0504","285","93","192","5","290","814","0","35.63","11.43"
"10","007","00","100","0029","0000","431","158","273","4","435","1187","0","36.65","13.31"
"10","007","00","100","0029","0505","431","158","273","4","435","1187","0","36.65","13.31"
"10","007","00","100","0030","0000","277","166","111","4","281","713","0","39.41","23.28"
"10","007","00","100","0030","0506","277","166","111","4","281","713","0","39.41","23.28"
"10","007","00","100","0031","0000","711","352","359","9","720","1974","0","36.47","17.83"
"10","007","00","100","0031","0507","409","216","193","3","412","1122","0","36.72","19.25"
"10","007","00","100","0031","0508","302","136","166","6","308","852","0","36.15","15.96"
"10","007","00","100","0032","0000","770","380","390","10","780","2175","0","35.86","17.47"
"10","007","00","100","0032","0509","402","206","196","5","407","1083","0","37.58","19.02"
"10","007","00","100","0032","0510","368","174","194","5","373","1092","0","34.16","15.93"
"10","007","00","100","0033","0000","712","296","416","11","723","1938","0","37.31","15.27"
"10","007","00","100","0033","0511","325","126","199","7","332","961","0","34.55","13.11"
"10","007","00","100","0033","0512","387","170","217","4","391","977","0","40.02","17.40"
"10","007","00","100","0034","0000","609","282","327","5","614","1738","0","35.33","16.23"
"10","007","00","100","0034","0513","342","168","174","4","346","980","0","35.31","17.14"
"10","007","00","100","0034","0514","267","114","153","1","268","758","0","35.36","15.04"
"10","007","00","100","0035","0000","607","317","290","6","613","1748","0","35.07","18.14"
"10","007","00","100","0035","0515","300","165","135","3","303","871","0","34.79","18.94"
"10","007","00","100","0035","0516","307","152","155","3","310","877","0","35.35","17.33"
"10","007","00","100","0036","0000","834","403","431","9","843","2262","0","37.27","17.82"
"10","007","00","100","0036","0517","405","195","210","4","409","1044","0","39.18","18.68"
"10","007","00","100","0036","0518","429","208","221","5","434","1218","0","35.63","17.08"
"10","007","00","100","0037","0000","1239","652","587","13","1252","2953","0","42.40","22.08"
"10","007","00","100","0037","0570","369","203","166","3","372","961","0","38.71","21.12"
"10","007","00","100","0037","0571","407","209","198","2","409","880","0","46.48","23.75"
"10","007","00","100","0037","0572","463","240","223","8","471","1112","0","42.36","21.58"
"10","007","00","100","0038","0000","991","549","442","3","994","2262","0","43.94","24.27"
"10","007","00","100","0038","0573","514","308","206","1","515","1213","0","42.46","25.39"
"10","007","00","100","0038","0574","477","241","236","2","479","1049","0","45.66","22.97"
"10","007","00","100","0039","0000","1106","553","553","9","1115","2449","0","45.53","22.58"
"10","007","00","100","0039","0575","555","294","261","4","559","1294","0","43.20","22.72"
"10","007","00","100","0039","0576","551","259","292","5","556","1155","0","48.14","22.42"
"10","007","00","100","0040","0000","563","288","275","3","566","1328","0","42.62","21.69"
"10","007","00","100","0040","0559","299","167","132","2","301","721","0","41.75","23.16"
"10","007","00","100","0040","0560","264","121","143","1","265","607","0","43.66","19.93"
"10","007","00","100","0041","0000","818","440","378","8","826","2178","0","37.92","20.20"
"10","007","00","100","0041","0557","497","267","230","6","503","1289","0","39.02","20.71"
"10","007","00","100","0041","0558","321","173","148","2","323","889","0","36.33","19.46"
"10","007","00","110","0000","0000","15714","7991","7723","144","15858","44726","54577","35.46","17.87"
"10","007","00","110","0001","0000","491","229","262","2","493","1156","0","42.65","19.81"
"10","007","00","110","0001","0661","491","229","262","2","493","1156","0","42.65","19.81"
"10","007","00","110","0002","0000","294","153","141","2","296","623","0","47.51","24.56"
"10","007","00","110","0002","0662","294","153","141","2","296","623","0","47.51","24.56"
"10","007","00","110","0003","0000","641","354","287","5","646","1780","0","36.29","19.89"
"10","007","00","110","0003","0663","300","156","144","4","304","801","0","37.95","19.48"
"10","007","00","110","0003","0664","341","198","143","1","342","979","0","34.93","20.22"
"10","007","00","110","0004","0000","177","110","67","1","178","420","0","42.38","26.19"
"10","007","00","110","0004","0665","177","110","67","1","178","420","0","42.38","26.19"
"10","007","00","110","0005","0000","1192","643","549","7","1199","3356","0","35.73","19.16"
"10","007","00","110","0005","0675","384","199","185","2","386","1111","0","34.74","17.91"
"10","007","00","110","0005","0676","408","225","183","2","410","1128","0","36.35","19.95"
"10","007","00","110","0005","0677","400","219","181","3","403","1117","0","36.08","19.61"
"10","007","00","110","0006","0000","845","471","374","8","853","2176","0","39.20","21.65"
"10","007","00","110","0006","0678","462","256","206","4","466","1193","0","39.06","21.46"
"10","007","00","110","0006","0679","383","215","168","4","387","983","0","39.37","21.87"
"10","007","00","110","0007","0000","1180","668","512","6","1186","3446","0","34.42","19.38"
"10","007","00","110","0007","0680","385","218","167","2","387","1189","0","32.55","18.33"
"10","007","00","110","0007","0681","344","181","163","2","346","1021","0","33.89","17.73"
"10","007","00","110","0007","0682","451","269","182","2","453","1236","0","36.65","21.76"
"10","007","00","110","0008","0000","449","206","243","5","454","1421","0","31.95","14.50"
"10","007","00","110","0008","0683","449","206","243","5","454","1421","0","31.95","14.50"
"10","007","00","110","0009","0000","994","475","519","12","1006","3018","0","33.33","15.74"
"10","007","00","110","0009","0684","328","139","189","5","333","1025","0","32.49","13.56"
"10","007","00","110","0009","0685","331","161","170","4","335","998","0","33.57","16.13"
"10","007","00","110","0009","0686","335","175","160","3","338","995","0","33.97","17.59"
"10","007","00","110","0010","0000","903","489","414","12","915","2433","0","37.61","20.10"
"10","007","00","110","0010","0687","495","268","227","8","503","1280","0","39.30","20.94"
"10","007","00","110","0010","0688","408","221","187","4","412","1153","0","35.73","19.17"
"10","007","00","110","0011","0000","828","440","388","5","833","2297","0","36.26","19.16"
"10","007","00","110","0011","0689","490","256","234","5","495","1327","0","37.30","19.29"
"10","007","00","110","0011","0690","338","184","154","0","338","970","0","34.85","18.97"
"10","007","00","110","0012","0000","286","115","171","4","290","814","0","35.63","14.13"
"10","007","00","110","0012","0691","286","115","171","4","290","814","0","35.63","14.13"
"10","007","00","110","0013","0000","606","307","299","6","612","1829","0","33.46","16.79"
"10","007","00","110","0013","0692","273","141","132","2","275","920","0","29.89","15.33"
"10","007","00","110","0013","0693","333","166","167","4","337","909","0","37.07","18.26"
"10","007","00","110","0014","0000","757","407","350","7","764","2278","0","33.54","17.87"
"10","007","00","110","0014","0670","397","215","182","1","398","1107","0","35.95","19.42"
"10","007","00","110","0014","0671","360","192","168","6","366","1171","0","31.26","16.40"
"10","007","00","110","0015","0000","299","133","166","1","300","817","0","36.72","16.28"
"10","007","00","110","0015","0674","299","133","166","1","300","817","0","36.72","16.28"
"10","007","00","110","0016","0000","454","181","273","6","460","1353","0","34.00","13.38"
"10","007","00","110","0016","0703","454","181","273","6","460","1353","0","34.00","13.38"
"10","007","00","110","0017","0000","702","347","355","6","708","1836","0","38.56","18.90"
"10","007","00","110","0017","0672","300","155","145","3","303","920","0","32.93","16.85"
"10","007","00","110","0017","0673","402","192","210","3","405","916","0","44.21","20.96"
"10","007","00","110","0018","0000","1596","801","795","21","1617","4595","0","35.19","17.43"
"10","007","00","110","0018","0666","346","151","195","3","349","1065","0","32.77","14.18"
"10","007","00","110","0018","0667","383","195","188","7","390","1129","0","34.54","17.27"
"10","007","00","110","0018","0668","414","217","197","7","421","1160","0","36.29","18.71"
"10","007","00","110","0018","0669","453","238","215","4","457","1241","0","36.83","19.18"
"10","007","00","110","0019","0000","207","113","94","0","207","641","0","32.29","17.63"
"10","007","00","110","0019","0694","207","113","94","0","207","641","0","32.29","17.63"
"10","007","00","110","0020","0000","475","257","218","3","478","1250","0","38.24","20.56"
"10","007","00","110","0020","0695","475","257","218","3","478","1250","0","38.24","20.56"
"10","007","00","110","0021","0000","235","109","126","5","240","694","0","34.58","15.71"
"10","007","00","110","0021","0696","235","109","126","5","240","694","0","34.58","15.71"
"10","007","00","110","0022","0000","445","247","198","4","449","1362","0","32.97","18.14"
"10","007","00","110","0022","0697","445","247","198","4","449","1362","0","32.97","18.14"
"10","007","00","110","0023","0000","385","151","234","5","390","1250","0","31.20","12.08"
"10","007","00","110","0023","0698","385","151","234","5","390","1250","0","31.20","12.08"
"10","007","00","110","0024","0000","708","316","392","6","714","2168","0","32.93","14.58"
"10","007","00","110","0024","0701","343","161","182","4","347","1074","0","32.31","14.99"
"10","007","00","110","0024","0702","365","155","210","2","367","1094","0","33.55","14.17"
"10","007","00","110","0025","0000","565","269","296","5","570","1713","0","33.27","15.70"
"10","007","00","110","0025","0699","325","141","184","3","328","956","0","34.31","14.75"
"10","007","00","110","0025","0700","240","128","112","2","242","757","0","31.97","16.91"
"10","007","00","120","0000","0000","12919","6405","6514","150","13069","34682","40379","37.68","18.47"
"10","007","00","120","0001","0000","268","125","143","2","270","816","0","33.09","15.32"
"10","007","00","120","0001","0766","268","125","143","2","270","816","0","33.09","15.32"
"10","007","00","120","0002","0000","368","213","155","3","371","1037","0","35.78","20.54"
"10","007","00","120","0002","0767","368","213","155","3","371","1037","0","35.78","20.54"
"10","007","00","120","0003","0000","280","148","132","2","282","748","0","37.70","19.79"
"10","007","00","120","0003","0768","280","148","132","2","282","748","0","37.70","19.79"
"10","007","00","120","0004","0000","531","295","236","10","541","1496","0","36.16","19.72"
"10","007","00","120","0004","0769","254","125","129","3","257","757","0","33.95","16.51"
"10","007","00","120","0004","0770","277","170","107","7","284","739","0","38.43","23.00"
"10","007","00","120","0005","0000","516","301","215","14","530","1448","0","36.60","20.79"
"10","007","00","120","0005","0771","256","154","102","11","267","717","0","37.24","21.48"
"10","007","00","120","0005","0772","260","147","113","3","263","731","0","35.98","20.11"
"10","007","00","120","0006","0000","459","216","243","11","470","1226","0","38.34","17.62"
"10","007","00","120","0006","0773","459","216","243","11","470","1226","0","38.34","17.62"
"10","007","00","120","0007","0000","644","290","354","4","648","1756","0","36.90","16.51"
"10","007","00","120","0007","0776","312","130","182","3","315","835","0","37.72","15.57"
"10","007","00","120","0007","0777","332","160","172","1","333","921","0","36.16","17.37"
"10","007","00","120","0008","0000","254","102","152","2","256","580","0","44.14","17.59"
"10","007","00","120","0008","0778","254","102","152","2","256","580","0","44.14","17.59"
"10","007","00","120","0009","0000","1303","695","608","14","1317","3269","0","40.29","21.26"
"10","007","00","120","0009","0779","388","201","187","3","391","1047","0","37.34","19.20"
"10","007","00","120","0009","0780","458","235","223","7","465","1116","0","41.67","21.06"
"10","007","00","120","0009","0781","457","259","198","4","461","1106","0","41.68","23.42"
"10","007","00","120","0010","0000","931","441","490","5","936","2363","0","39.61","18.66"
"10","007","00","120","0010","0782","503","236","267","3","506","1270","0","39.84","18.58"
"10","007","00","120","0010","0783","428","205","223","2","430","1093","0","39.34","18.76"
"10","007","00","120","0011","0000","402","188","214","4","406","1041","0","39.00","18.06"
"10","007","00","120","0011","0784","402","188","214","4","406","1041","0","39.00","18.06"
"10","007","00","120","0012","0000","449","210","239","5","454","1106","0","41.05","18.99"
"10","007","00","120","0012","0785","449","210","239","5","454","1106","0","41.05","18.99"
"10","007","00","120","0013","0000","806","418","388","7","813","1942","0","41.86","21.52"
"10","007","00","120","0013","0786","399","204","195","0","399","938","0","42.54","21.75"
"10","007","00","120","0013","0787","407","214","193","7","414","1004","0","41.24","21.31"
"10","007","00","120","0014","0000","939","502","437","4","943","2399","0","39.31","20.93"
"10","007","00","120","0014","0774","390","200","190","2","392","1055","0","37.16","18.96"
"10","007","00","120","0014","0775","549","302","247","2","551","1344","0","41.00","22.47"
"10","007","00","120","0015","0000","570","216","354","6","576","1560","0","36.92","13.85"
"10","007","00","120","0015","0789","311","122","189","4","315","797","0","39.52","15.31"
"10","007","00","120","0015","0790","259","94","165","2","261","763","0","34.21","12.32"
"10","007","00","120","0016","0000","443","211","232","5","448","1292","0","34.67","16.33"
"10","007","00","120","0016","0791","443","211","232","5","448","1292","0","34.67","16.33"
"10","007","00","120","0017","0000","631","297","334","12","643","1814","0","35.45","16.37"
"10","007","00","120","0017","0792","306","147","159","8","314","879","0","35.72","16.72"
"10","007","00","120","0017","0793","325","150","175","4","329","935","0","35.19","16.04"
"10","007","00","120","0018","0000","1524","788","736","20","1544","4178","0","36.96","18.86"
"10","007","00","120","0018","0794","373","210","163","9","382","1049","0","36.42","20.02"
"10","007","00","120","0018","0795","355","171","184","2","357","996","0","35.84","17.17"
"10","007","00","120","0018","0796","372","185","187","3","375","1058","0","35.44","17.49"
"10","007","00","120","0018","0797","424","222","202","6","430","1075","0","40.00","20.65"
"10","007","00","120","0019","0000","436","194","242","7","443","1271","0","34.85","15.26"
"10","007","00","120","0019","0788","436","194","242","7","443","1271","0","34.85","15.26"
"10","007","00","120","0020","0000","514","271","243","4","518","1561","0","33.18","17.36"
"10","007","00","120","0020","0798","244","124","120","3","247","766","0","32.25","16.19"
"10","007","00","120","0020","0799","270","147","123","1","271","795","0","34.09","18.49"
"10","007","00","120","0021","0000","326","149","177","3","329","913","0","36.04","16.32"
"10","007","00","120","0021","0800","326","149","177","3","329","913","0","36.04","16.32"
"10","007","00","120","0022","0000","325","135","190","6","331","866","0","38.22","15.59"
"10","007","00","120","0022","0801","325","135","190","6","331","866","0","38.22","15.59"
"10","007","00","130","0000","0000","11804","5799","6005","129","11933","33111","39085","36.04","17.51"
"10","007","00","130","0001","0000","1256","646","610","14","1270","3428","0","37.05","18.84"
"10","007","00","130","0001","0596","366","186","180","4","370","1055","0","35.07","17.63"
"10","007","00","130","0001","0597","408","210","198","3","411","1063","0","38.66","19.76"
"10","007","00","130","0001","0598","482","250","232","7","489","1310","0","37.33","19.08"
"10","007","00","130","0002","0000","582","267","315","2","584","1546","0","37.77","17.27"
"10","007","00","130","0002","0599","289","137","152","0","289","816","0","35.42","16.79"
"10","007","00","130","0002","0600","293","130","163","2","295","730","0","40.41","17.81"
"10","007","00","130","0003","0000","521","244","277","7","528","1493","0","35.37","16.34"
"10","007","00","130","0003","0604","521","244","277","7","528","1493","0","35.37","16.34"
"10","007","00","130","0004","0000","437","228","209","3","440","1209","0","36.39","18.86"
"10","007","00","130","0004","0601","437","228","209","3","440","1209","0","36.39","18.86"
"10","007","00","130","0005","0000","382","165","217","6","388","1172","0","33.11","14.08"
"10","007","00","130","0005","0611","382","165","217","6","388","1172","0","33.11","14.08"
"10","007","00","130","0006","0000","1586","830","756","16","1602","4186","0","38.27","19.83"
"10","007","00","130","0006","0614","465","269","196","7","472","1144","0","41.26","23.51"
"10","007","00","130","0006","0615","297","142","155","2","299","875","0","34.17","16.23"
"10","007","00","130","0006","0616","417","230","187","2","419","1139","0","36.79","20.19"
"10","007","00","130","0006","0618","407","189","218","5","412","1028","0","40.08","18.39"
"10","007","00","130","0007","0000","756","390","366","7","763","2092","0","36.47","18.64"
"10","007","00","130","0007","0619","431","217","214","4","435","1078","0","40.35","20.13"
"10","007","00","130","0007","0620","325","173","152","3","328","1014","0","32.35","17.06"
"10","007","00","130","0008","0000","862","419","443","11","873","2569","0","33.98","16.31"
"10","007","00","130","0008","0625","441","214","227","8","449","1232","0","36.44","17.37"
"10","007","00","130","0008","0626","421","205","216","3","424","1337","0","31.71","15.33"
"10","007","00","130","0009","0000","577","287","290","7","584","1569","0","37.22","18.29"
"10","007","00","130","0009","0602","265","124","141","4","269","692","0","38.87","17.92"
"10","007","00","130","0009","0603","312","163","149","3","315","877","0","35.92","18.59"
"10","007","00","130","0010","0000","536","261","275","5","541","1528","0","35.41","17.08"
"10","007","00","130","0010","0607","275","137","138","2","277","718","0","38.58","19.08"
"10","007","00","130","0010","0608","261","124","137","3","264","810","0","32.59","15.31"
"10","007","00","130","0011","0000","543","282","261","3","546","1420","0","38.45","19.86"
"10","007","00","130","0011","0617","543","282","261","3","546","1420","0","38.45","19.86"
"10","007","00","130","0012","0000","699","382","317","8","707","2033","0","34.78","18.79"
"10","007","00","130","0012","0605","311","195","116","5","316","832","0","37.98","23.44"
"10","007","00","130","0012","0606","388","187","201","3","391","1201","0","32.56","15.57"
"10","007","00","130","0013","0000","551","252","299","13","564","1624","0","34.73","15.52"
"10","007","00","130","0013","0609","295","155","140","4","299","806","0","37.10","19.23"
"10","007","00","130","0013","0610","256","97","159","9","265","818","0","32.40","11.86"
"10","007","00","130","0014","0000","972","467","505","12","984","2635","0","37.34","17.72"
"10","007","00","130","0014","0612","508","261","247","5","513","1353","0","37.92","19.29"
"10","007","00","130","0014","0613","464","206","258","7","471","1282","0","36.74","16.07"
"10","007","00","130","0015","0000","786","362","424","9","795","2428","0","32.74","14.91"
"10","007","00","130","0015","0621","358","157","201","5","363","1096","0","33.12","14.32"
"10","007","00","130","0015","0622","428","205","223","4","432","1332","0","32.43","15.39"
"10","007","00","130","0016","0000","758","317","441","6","764","2179","0","35.06","14.55"
"10","007","00","130","0016","0623","388","150","238","1","389","1054","0","36.91","14.23"
"10","007","00","130","0016","0624","370","167","203","5","375","1125","0","33.33","14.84"
"10","007","00","140","0000","0000","9447","5277","4170","124","9571","27733","31833","34.51","19.03"
"10","007","00","140","0001","0000","670","375","295","8","678","1664","0","40.75","22.54"
"10","007","00","140","0001","0704","357","193","164","5","362","906","0","39.96","21.30"
"10","007","00","140","0001","0705","313","182","131","3","316","758","0","41.69","24.01"
"10","007","00","140","0002","0000","545","279","266","8","553","1536","0","36.00","18.16"
"10","007","00","140","0002","0706","280","146","134","4","284","746","0","38.07","19.57"
"10","007","00","140","0002","0707","265","133","132","4","269","790","0","34.05","16.84"
"10","007","00","140","0003","0000","454","257","197","5","459","1251","0","36.69","20.54"
"10","007","00","140","0003","0708","454","257","197","5","459","1251","0","36.69","20.54"
"10","007","00","140","0004","0000","336","196","140","5","341","889","0","38.36","22.05"
"10","007","00","140","0004","0709","336","196","140","5","341","889","0","38.36","22.05"
"10","007","00","140","0005","0000","607","329","278","5","612","1750","0","34.97","18.80"
"10","007","00","140","0005","0710","320","176","144","0","320","882","0","36.28","19.95"
"10","007","00","140","0005","0711","287","153","134","5","292","868","0","33.64","17.63"
"10","007","00","140","0006","0000","330","162","168","4","334","939","0","35.57","17.25"
"10","007","00","140","0006","0712","330","162","168","4","334","939","0","35.57","17.25"
"10","007","00","140","0007","0000","446","222","224","11","457","1306","0","34.99","17.00"
"10","007","00","140","0007","0713","446","222","224","11","457","1306","0","34.99","17.00"
"10","007","00","140","0008","0000","383","198","185","4","387","1086","0","35.64","18.23"
"10","007","00","140","0008","0714","383","198","185","4","387","1086","0","35.64","18.23"
"10","007","00","140","0009","0000","272","173","99","4","276","656","0","42.07","26.37"
"10","007","00","140","0009","0715","272","173","99","4","276","656","0","42.07","26.37"
"10","007","00","140","0010","0000","419","218","201","7","426","1199","0","35.53","18.18"
"10","007","00","140","0010","0716","419","218","201","7","426","1199","0","35.53","18.18"
"10","007","00","140","0011","0000","556","315","241","1","557","1781","0","31.27","17.69"
"10","007","00","140","0011","0717","287","156","131","1","288","870","0","33.10","17.93"
"10","007","00","140","0011","0718","269","159","110","0","269","911","0","29.53","17.45"
"10","007","00","140","0012","0000","641","364","277","5","646","2059","0","31.37","17.68"
"10","007","00","140","0012","0719","303","138","165","4","307","1001","0","30.67","13.79"
"10","007","00","140","0012","0720","338","226","112","1","339","1058","0","32.04","21.36"
"10","007","00","140","0013","0000","395","202","193","5","400","1194","0","33.50","16.92"
"10","007","00","140","0013","0721","395","202","193","5","400","1194","0","33.50","16.92"
"10","007","00","140","0014","0000","183","119","64","5","188","456","0","41.23","26.10"
"10","007","00","140","0014","0722","183","119","64","5","188","456","0","41.23","26.10"
"10","007","00","140","0015","0000","377","201","176","2","379","1101","0","34.42","18.26"
"10","007","00","140","0015","0723","377","201","176","2","379","1101","0","34.42","18.26"
"10","007","00","140","0016","0000","309","168","141","7","316","848","0","37.26","19.81"
"10","007","00","140","0016","0724","309","168","141","7","316","848","0","37.26","19.81"
"10","007","00","140","0017","0000","394","193","201","5","399","1437","0","27.77","13.43"
"10","007","00","140","0017","0725","197","93","104","3","200","753","0","26.56","12.35"
"10","007","00","140","0017","0726","197","100","97","2","199","684","0","29.09","14.62"
"10","007","00","140","0018","0000","257","160","97","3","260","838","0","31.03","19.09"
"10","007","00","140","0018","0727","257","160","97","3","260","838","0","31.03","19.09"
"10","007","00","140","0019","0000","471","275","196","11","482","1538","0","31.34","17.88"
"10","007","00","140","0019","0728","230","140","90","5","235","813","0","28.91","17.22"
"10","007","00","140","0019","0729","241","135","106","6","247","725","0","34.07","18.62"
"10","007","00","140","0020","0000","507","346","161","7","514","1523","0","33.75","22.72"
"10","007","00","140","0020","0730","243","170","73","4","247","735","0","33.61","23.13"
"10","007","00","140","0020","0731","264","176","88","3","267","788","0","33.88","22.34"
"10","007","00","140","0021","0000","447","238","209","9","456","1368","0","33.33","17.40"
"10","007","00","140","0021","0732","251","132","119","6","257","709","0","36.25","18.62"
"10","007","00","140","0021","0733","196","106","90","3","199","659","0","30.20","16.08"
"10","007","00","140","0022","0000","448","287","161","3","451","1314","0","34.32","21.84"
"10","007","00","140","0022","0734","448","287","161","3","451","1314","0","34.32","21.84"
"10","007","00","150","0000","0000","10838","4919","5919","131","10969","29651","34223","36.99","16.59"
"10","007","00","150","0001","0000","1357","649","708","14","1371","3555","0","38.57","18.26"
"10","007","00","150","0001","0735","423","195","228","7","430","1109","0","38.77","17.58"
"10","007","00","150","0001","0736","444","197","247","4","448","1176","0","38.10","16.75"
"10","007","00","150","0001","0737","490","257","233","3","493","1270","0","38.82","20.24"
"10","007","00","150","0002","0000","462","197","265","5","467","1250","0","37.36","15.76"
"10","007","00","150","0002","0738","462","197","265","5","467","1250","0","37.36","15.76"
"10","007","00","150","0003","0000","612","317","295","6","618","1556","0","39.72","20.37"
"10","007","00","150","0003","0739","332","162","170","5","337","903","0","37.32","17.94"
"10","007","00","150","0003","0740","280","155","125","1","281","653","0","43.03","23.74"
"10","007","00","150","0004","0000","451","234","217","4","455","1258","0","36.17","18.60"
"10","007","00","150","0004","0741","451","234","217","4","455","1258","0","36.17","18.60"
"10","007","00","150","0005","0000","659","276","383","3","662","1740","0","38.05","15.86"
"10","007","00","150","0005","0742","218","105","113","0","218","610","0","35.74","17.21"
"10","007","00","150","0005","0743","441","171","270","3","444","1130","0","39.29","15.13"
"10","007","00","150","0006","0000","763","345","418","9","772","1976","0","39.07","17.46"
"10","007","00","150","0006","0744","417","190","227","5","422","1065","0","39.62","17.84"
"10","007","00","150","0006","0745","346","155","191","4","350","911","0","38.42","17.01"
"10","007","00","150","0007","0000","561","226","335","4","565","1422","0","39.73","15.89"
"10","007","00","150","0007","0746","293","104","189","0","293","762","0","38.45","13.65"
"10","007","00","150","0007","0747","268","122","146","4","272","660","0","41.21","18.48"
"10","007","00","150","0008","0000","656","309","347","5","661","1976","0","33.45","15.64"
"10","007","00","150","0008","0750","293","129","164","2","295","950","0","31.05","13.58"
"10","007","00","150","0008","0751","363","180","183","3","366","1026","0","35.67","17.54"
"10","007","00","150","0009","0000","885","375","510","14","899","2348","0","38.29","15.97"
"10","007","00","150","0009","0748","482","217","265","8","490","1354","0","36.19","16.03"
"10","007","00","150","0009","0749","403","158","245","6","409","994","0","41.15","15.90"
"10","007","00","150","0010","0000","228","100","128","1","229","658","0","34.80","15.20"
"10","007","00","150","0010","0752","228","100","128","1","229","658","0","34.80","15.20"
"10","007","00","150","0011","0000","434","208","226","9","443","1265","0","35.02","16.44"
"10","007","00","150","0011","0753","434","208","226","9","443","1265","0","35.02","16.44"
"10","007","00","150","0012","0000","572","257","315","5","577","1491","0","38.70","17.24"
"10","007","00","150","0012","0754","290","113","177","3","293","754","0","38.86","14.99"
"10","007","00","150","0012","0755","282","144","138","2","284","737","0","38.53","19.54"
"10","007","00","150","0013","0000","362","158","204","8","370","1065","0","34.74","14.84"
"10","007","00","150","0013","0756","362","158","204","8","370","1065","0","34.74","14.84"
"10","007","00","150","0014","0000","336","154","182","5","341","963","0","35.41","15.99"
"10","007","00","150","0014","0757","336","154","182","5","341","963","0","35.41","15.99"
"10","007","00","150","0015","0000","430","155","275","4","434","1305","0","33.26","11.88"
"10","007","00","150","0015","0760","225","79","146","3","228","667","0","34.18","11.84"
"10","007","00","150","0015","0761","205","76","129","1","206","638","0","32.29","11.91"
"10","007","00","150","0016","0000","665","278","387","6","671","1842","0","36.43","15.09"
"10","007","00","150","0016","0758","326","128","198","1","327","909","0","35.97","14.08"
"10","007","00","150","0016","0759","339","150","189","5","344","933","0","36.87","16.08"
"10","007","00","150","0017","0000","520","230","290","11","531","1436","0","36.98","16.02"
"10","007","00","150","0017","0763","520","230","290","11","531","1436","0","36.98","16.02"
"10","007","00","150","0018","0000","314","148","166","8","322","893","0","36.06","16.57"
"10","007","00","150","0018","0762","314","148","166","8","322","893","0","36.06","16.57"
"10","007","00","150","0019","0000","251","122","129","1","252","736","0","34.24","16.58"
"10","007","00","150","0019","0764","251","122","129","1","252","736","0","34.24","16.58"
"10","007","00","150","0020","0000","320","181","139","9","329","916","0","35.92","19.76"
"10","007","00","150","0020","0765","320","181","139","9","329","916","0","35.92","19.76"
"10","007","00","160","0000","0000","11373","5345","6028","147","11520","30808","36061","37.39","17.35"
"10","007","00","160","0001","0000","326","179","147","3","329","761","0","43.23","23.52"
"10","007","00","160","0001","0637","326","179","147","3","329","761","0","43.23","23.52"
"10","007","00","160","0002","0000","607","279","328","0","607","1503","0","40.39","18.56"
"10","007","00","160","0002","0638","286","126","160","0","286","695","0","41.15","18.13"
"10","007","00","160","0002","0639","321","153","168","0","321","808","0","39.73","18.94"
"10","007","00","160","0003","0000","730","372","358","8","738","1800","0","41.00","20.67"
"10","007","00","160","0003","0640","418","206","212","5","423","994","0","42.56","20.72"
"10","007","00","160","0003","0641","312","166","146","3","315","806","0","39.08","20.60"
"10","007","00","160","0004","0000","775","381","394","14","789","2147","0","36.75","17.75"
"10","007","00","160","0004","0642","412","200","212","5","417","1095","0","38.08","18.26"
"10","007","00","160","0004","0643","363","181","182","9","372","1052","0","35.36","17.21"
"10","007","00","160","0005","0000","659","300","359","9","668","1704","0","39.20","17.61"
"10","007","00","160","0005","0644","363","165","198","8","371","914","0","40.59","18.05"
"10","007","00","160","0005","0645","296","135","161","1","297","790","0","37.59","17.09"
"10","007","00","160","0006","0000","533","272","261","7","540","1438","0","37.55","18.92"
"10","007","00","160","0006","0646","312","163","149","2","314","813","0","38.62","20.05"
"10","007","00","160","0006","0647","221","109","112","5","226","625","0","36.16","17.44"
"10","007","00","160","0007","0000","382","129","253","6","388","1059","0","36.64","12.18"
"10","007","00","160","0007","0648","382","129","253","6","388","1059","0","36.64","12.18"
"10","007","00","160","0008","0000","355","207","148","6","361","1065","0","33.90","19.44"
"10","007","00","160","0008","0649","355","207","148","6","361","1065","0","33.90","19.44"
"10","007","00","160","0009","0000","973","487","486","16","989","2670","0","37.04","18.24"
"10","007","00","160","0009","0650","539","277","262","9","548","1429","0","38.35","19.38"
"10","007","00","160","0009","0651","434","210","224","7","441","1241","0","35.54","16.92"
"10","007","00","160","0010","0000","560","204","356","11","571","1368","0","41.74","14.91"
"10","007","00","160","0010","0632","248","84","164","9","257","653","0","39.36","12.86"
"10","007","00","160","0010","0633","312","120","192","2","314","715","0","43.92","16.78"
"10","007","00","160","0011","0000","363","175","188","2","365","1220","0","29.92","14.34"
"10","007","00","160","0011","0627","363","175","188","2","365","1220","0","29.92","14.34"
"10","007","00","160","0012","0000","554","229","325","7","561","1624","0","34.54","14.10"
"10","007","00","160","0012","0630","230","91","139","2","232","700","0","33.14","13.00"
"10","007","00","160","0012","0631","324","138","186","5","329","924","0","35.61","14.94"
"10","007","00","160","0013","0000","665","309","356","10","675","1908","0","35.38","16.19"
"10","007","00","160","0013","0628","321","154","167","6","327","883","0","37.03","17.44"
"10","007","00","160","0013","0629","344","155","189","4","348","1025","0","33.95","15.12"
"10","007","00","160","0014","0000","609","313","296","7","616","1558","0","39.54","20.09"
"10","007","00","160","0014","0634","270","115","155","4","274","742","0","36.93","15.50"
"10","007","00","160","0014","0635","339","198","141","3","342","816","0","41.91","24.26"
"10","007","00","160","0015","0000","515","230","285","6","521","1400","0","37.21","16.43"
"10","007","00","160","0015","0636","515","230","285","6","521","1400","0","37.21","16.43"
"10","007","00","160","0016","0000","259","130","129","3","262","825","0","31.76","15.76"
"10","007","00","160","0016","0652","259","130","129","3","262","825","0","31.76","15.76"
"10","007","00","160","0017","0000","244","119","125","2","246","710","0","34.65","16.76"
"10","007","00","160","0017","0653","244","119","125","2","246","710","0","34.65","16.76"
"10","007","00","160","0018","0000","305","123","182","4","309","736","0","41.98","16.71"
"10","007","00","160","0018","0654","305","123","182","4","309","736","0","41.98","16.71"
"10","007","00","160","0019","0000","253","117","136","3","256","654","0","39.14","17.89"
"10","007","00","160","0019","0655","253","117","136","3","256","654","0","39.14","17.89"
"10","007","00","160","0020","0000","311","150","161","4","315","847","0","37.19","17.71"
"10","007","00","160","0020","0656","311","150","161","4","315","847","0","37.19","17.71"
"10","007","00","160","0021","0000","293","140","153","6","299","809","0","36.96","17.31"
"10","007","00","160","0021","0657","293","140","153","6","299","809","0","36.96","17.31"
"10","007","00","160","0022","0000","242","129","113","4","246","637","0","38.62","20.25"
"10","007","00","160","0022","0658","242","129","113","4","246","637","0","38.62","20.25"
"10","007","00","160","0023","0000","357","195","162","2","359","1075","0","33.40","18.14"
"10","007","00","160","0023","0659","357","195","162","2","359","1075","0","33.40","18.14"
"10","007","00","160","0024","0000","503","176","327","7","510","1290","0","39.53","13.64"
"10","007","00","160","0024","0660","503","176","327","7","510","1290","0","39.53","13.64"
"10","007","00","170","0000","0000","13048","5874","7174","129","13177","35988","42279","36.61","16.32"
"10","007","00","170","0001","0000","1039","425","614","5","1044","2749","0","37.98","15.46"
"10","007","00","170","0001","0802","302","111","191","1","303","783","0","38.70","14.18"
"10","007","00","170","0001","0803","400","178","222","4","404","994","0","40.64","17.91"
"10","007","00","170","0001","0804","337","136","201","0","337","972","0","34.67","13.99"
"10","007","00","170","0002","0000","502","244","258","9","511","1460","0","35.00","16.71"
"10","007","00","170","0002","0809","267","133","134","4","271","765","0","35.42","17.39"
"10","007","00","170","0002","0810","235","111","124","5","240","695","0","34.53","15.97"
"10","007","00","170","0003","0000","429","155","274","0","429","1121","0","38.27","13.83"
"10","007","00","170","0003","0829","429","155","274","0","429","1121","0","38.27","13.83"
"10","007","00","170","0004","0000","1576","680","896","15","1591","4439","0","35.84","15.32"
"10","007","00","170","0004","0805","359","155","204","1","360","1002","0","35.93","15.47"
"10","007","00","170","0004","0806","345","160","185","5","350","1078","0","32.47","14.84"
"10","007","00","170","0004","0807","452","192","260","6","458","1191","0","38.46","16.12"
"10","007","00","170","0004","0808","420","173","247","3","423","1168","0","36.22","14.81"
"10","007","00","170","0005","0000","345","143","202","2","347","914","0","37.96","15.65"
"10","007","00","170","0005","0814","345","143","202","2","347","914","0","37.96","15.65"
"10","007","00","170","0006","0000","425","181","244","4","429","1096","0","39.14","16.51"
"10","007","00","170","0006","0836","425","181","244","4","429","1096","0","39.14","16.51"
"10","007","00","170","0007","0000","1048","519","529","4","1052","2717","0","38.72","19.10"
"10","007","00","170","0007","0822","306","157","149","4","310","704","0","44.03","22.30"
"10","007","00","170","0007","0823","334","166","168","0","334","901","0","37.07","18.42"
"10","007","00","170","0007","0824","408","196","212","0","408","1112","0","36.69","17.63"
"10","007","00","170","0008","0000","759","350","409","11","770","2068","0","37.23","16.92"
"10","007","00","170","0008","0815","396","170","226","2","398","996","0","39.96","17.07"
"10","007","00","170","0008","0816","363","180","183","9","372","1072","0","34.70","16.79"
"10","007","00","170","0009","0000","234","127","107","4","238","754","0","31.56","16.84"
"10","007","00","170","0009","0831","234","127","107","4","238","754","0","31.56","16.84"
"10","007","00","170","0010","0000","336","169","167","3","339","905","0","37.46","18.67"
"10","007","00","170","0010","0827","336","169","167","3","339","905","0","37.46","18.67"
"10","007","00","170","0011","0000","567","237","330","7","574","1712","0","33.53","13.84"
"10","007","00","170","0011","0820","266","100","166","2","268","728","0","36.81","13.74"
"10","007","00","170","0011","0821","301","137","164","5","306","984","0","31.10","13.92"
"10","007","00","170","0012","0000","296","155","141","8","304","968","0","31.40","16.01"
"10","007","00","170","0012","0835","296","155","141","8","304","968","0","31.40","16.01"
"10","007","00","170","0013","0000","459","218","241","5","464","1252","0","37.06","17.41"
"10","007","00","170","0013","0826","459","218","241","5","464","1252","0","37.06","17.41"
"10","007","00","170","0014","0000","545","246","299","6","551","1401","0","39.33","17.56"
"10","007","00","170","0014","0817","282","138","144","4","286","730","0","39.18","18.90"
"10","007","00","170","0014","0818","263","108","155","2","265","671","0","39.49","16.10"
"10","007","00","170","0015","0000","359","176","183","3","362","961","0","37.67","18.31"
"10","007","00","170","0015","0832","359","176","183","3","362","961","0","37.67","18.31"
"10","007","00","170","0016","0000","375","205","170","4","379","980","0","38.67","20.92"
"10","007","00","170","0016","0825","375","205","170","4","379","980","0","38.67","20.92"
"10","007","00","170","0017","0000","463","219","244","8","471","1204","0","39.12","18.19"
"10","007","00","170","0017","0819","463","219","244","8","471","1204","0","39.12","18.19"
"10","007","00","170","0018","0000","271","103","168","1","272","806","0","33.75","12.78"
"10","007","00","170","0018","0837","271","103","168","1","272","806","0","33.75","12.78"
"10","007","00","170","0019","0000","624","276","348","10","634","1581","0","40.10","17.46"
"10","007","00","170","0019","0812","352","141","211","5","357","867","0","41.18","16.26"
"10","007","00","170","0019","0813","272","135","137","5","277","714","0","38.80","18.91"
"10","007","00","170","0020","0000","341","139","202","2","343","977","0","35.11","14.23"
"10","007","00","170","0020","0830","341","139","202","2","343","977","0","35.11","14.23"
"10","007","00","170","0021","0000","511","210","301","5","516","1487","0","34.70","14.12"
"10","007","00","170","0021","0838","279","119","160","2","281","759","0","37.02","15.68"
"10","007","00","170","0021","0839","232","91","141","3","235","728","0","32.28","12.50"
"10","007","00","170","0022","0000","381","160","221","3","384","1028","0","37.35","15.56"
"10","007","00","170","0022","0811","381","160","221","3","384","1028","0","37.35","15.56"
"10","007","00","170","0023","0000","420","227","193","5","425","1260","0","33.73","18.02"
"10","007","00","170","0023","0828","420","227","193","5","425","1260","0","33.73","18.02"
"10","007","00","170","0024","0000","743","310","433","5","748","2148","0","34.82","14.43"
"10","007","00","170","0024","0833","390","178","212","3","393","1096","0","35.86","16.24"
"10","007","00","170","0024","0834","353","132","221","2","355","1052","0","33.75","12.55"
"10","007","00","180","0000","0000","5036","2326","2710","73","5109","12827","14488","39.83","18.13"
"10","007","00","180","0001","0000","309","142","167","2","311","821","0","37.88","17.30"
"10","007","00","180","0001","0842","309","142","167","2","311","821","0","37.88","17.30"
"10","007","00","180","0002","0000","368","151","217","10","378","916","0","41.27","16.48"
"10","007","00","180","0002","0843","368","151","217","10","378","916","0","41.27","16.48"
"10","007","00","180","0003","0000","239","116","123","2","241","610","0","39.51","19.02"
"10","007","00","180","0003","0844","239","116","123","2","241","610","0","39.51","19.02"
"10","007","00","180","0004","0000","254","117","137","1","255","609","0","41.87","19.21"
"10","007","00","180","0004","0845","254","117","137","1","255","609","0","41.87","19.21"
"10","007","00","180","0005","0000","376","175","201","5","381","883","0","43.15","19.82"
"10","007","00","180","0005","0847","376","175","201","5","381","883","0","43.15","19.82"
"10","007","00","180","0006","0000","363","194","169","3","366","933","0","39.23","20.79"
"10","007","00","180","0006","0846","363","194","169","3","366","933","0","39.23","20.79"
"10","007","00","180","0007","0000","317","146","171","6","323","776","0","41.62","18.81"
"10","007","00","180","0007","0849","317","146","171","6","323","776","0","41.62","18.81"
"10","007","00","180","0008","0000","195","125","70","5","200","438","0","45.66","28.54"
"10","007","00","180","0008","0848","195","125","70","5","200","438","0","45.66","28.54"
"10","007","00","180","0009","0000","370","177","193","2","372","996","0","37.35","17.77"
"10","007","00","180","0009","0851","370","177","193","2","372","996","0","37.35","17.77"
"10","007","00","180","0010","0000","336","142","194","4","340","801","0","42.45","17.73"
"10","007","00","180","0010","0850","336","142","194","4","340","801","0","42.45","17.73"
"10","007","00","180","0011","0000","266","100","166","1","267","776","0","34.41","12.89"
"10","007","00","180","0011","0852","266","100","166","1","267","776","0","34.41","12.89"
"10","007","00","180","0012","0000","289","152","137","2","291","779","0","37.36","19.51"
"10","007","00","180","0012","0853","289","152","137","2","291","779","0","37.36","19.51"
"10","007","00","180","0013","0000","262","107","155","6","268","665","0","40.30","16.09"
"10","007","00","180","0013","0854","262","107","155","6","268","665","0","40.30","16.09"
"10","007","00","180","0014","0000","233","113","120","6","239","597","0","40.03","18.93"
"10","007","00","180","0014","0855","233","113","120","6","239","597","0","40.03","18.93"
"10","007","00","180","0015","0000","218","103","115","1","219","562","0","38.97","18.33"
"10","007","00","180","0015","0856","218","103","115","1","219","562","0","38.97","18.33"
"10","007","00","180","0016","0000","374","151","223","13","387","1000","0","38.70","15.10"
"10","007","00","180","0016","0840","374","151","223","13","387","1000","0","38.70","15.10"
"10","007","00","180","0017","0000","267","115","152","4","271","665","0","40.75","17.29"
"10","007","00","180","0017","0841","267","115","152","4","271","665","0","40.75","17.29"
"10","007","00","190","0000","0000","10032","4895","5137","88","10120","27801","33351","36.40","17.61"
"10","007","00","190","0001","0000","681","333","348","5","686","1771","0","38.74","18.80"
"10","007","00","190","0001","0868","334","150","184","2","336","799","0","42.05","18.77"
"10","007","00","190","0001","0869","347","183","164","3","350","972","0","36.01","18.83"
"10","007","00","190","0002","0000","302","156","146","2","304","770","0","39.48","20.26"
"10","007","00","190","0002","0870","302","156","146","2","304","770","0","39.48","20.26"
"10","007","00","190","0003","0000","224","86","138","3","227","535","0","42.43","16.07"
"10","007","00","190","0003","0871","224","86","138","3","227","535","0","42.43","16.07"
"10","007","00","190","0004","0000","280","138","142","2","282","656","0","42.99","21.04"
"10","007","00","190","0004","0872","280","138","142","2","282","656","0","42.99","21.04"
"10","007","00","190","0005","0000","522","218","304","2","524","1406","0","37.27","15.50"
"10","007","00","190","0005","0873","274","113","161","0","274","648","0","42.28","17.44"
"10","007","00","190","0005","0874","248","105","143","2","250","758","0","32.98","13.85"
"10","007","00","190","0006","0000","537","328","209","3","540","1257","0","42.96","26.09"
"10","007","00","190","0006","0875","270","160","110","2","272","624","0","43.59","25.64"
"10","007","00","190","0006","0876","267","168","99","1","268","633","0","42.34","26.54"
"10","007","00","190","0007","0000","828","388","440","7","835","2278","0","36.65","17.03"
"10","007","00","190","0007","0877","410","184","226","2","412","1131","0","36.43","16.27"
"10","007","00","190","0007","0878","418","204","214","5","423","1147","0","36.88","17.79"
"10","007","00","190","0008","0000","1118","572","546","14","1132","3114","0","36.35","18.37"
"10","007","00","190","0008","0879","381","199","182","4","385","989","0","38.93","20.12"
"10","007","00","190","0008","0880","385","210","175","4","389","1068","0","36.42","19.66"
"10","007","00","190","0008","0881","352","163","189","6","358","1057","0","33.87","15.42"
"10","007","00","190","0009","0000","410","202","208","5","415","1307","0","31.75","15.46"
"10","007","00","190","0009","0882","410","202","208","5","415","1307","0","31.75","15.46"
"10","007","00","190","0010","0000","1742","847","895","16","1758","4588","0","38.32","18.46"
"10","007","00","190","0010","0862","415","214","201","2","417","1109","0","37.60","19.30"
"10","007","00","190","0010","0863","465","235","230","4","469","1080","0","43.43","21.76"
"10","007","00","190","0010","0864","465","204","261","7","472","1195","0","39.50","17.07"
"10","007","00","190","0010","0865","397","194","203","3","400","1204","0","33.22","16.11"
"10","007","00","190","0011","0000","552","293","259","4","556","1694","0","32.82","17.30"
"10","007","00","190","0011","0866","227","117","110","0","227","750","0","30.27","15.60"
"10","007","00","190","0011","0867","325","176","149","4","329","944","0","34.85","18.64"
"10","007","00","190","0012","0000","950","407","543","8","958","2702","0","35.46","15.06"
"10","007","00","190","0012","0857","333","140","193","3","336","915","0","36.72","15.30"
"10","007","00","190","0012","0858","304","130","174","3","307","918","0","33.44","14.16"
"10","007","00","190","0012","0859","313","137","176","2","315","869","0","36.25","15.77"
"10","007","00","190","0013","0000","704","294","410","4","708","1904","0","37.18","15.44"
"10","007","00","190","0013","0860","404","195","209","1","405","1103","0","36.72","17.68"
"10","007","00","190","0013","0861","300","99","201","3","303","801","0","37.83","12.36"
"10","007","00","190","0014","0000","591","303","288","7","598","2028","0","29.49","14.94"
"10","007","00","190","0014","0883","303","145","158","4","307","1086","0","28.27","13.35"
"10","007","00","190","0014","0884","288","158","130","3","291","942","0","30.89","16.77"
"10","007","00","190","0015","0000","591","330","261","6","597","1791","0","33.33","18.43"
"10","007","00","190","0015","0885","281","156","125","2","283","841","0","33.65","18.55"
"10","007","00","190","0015","0886","310","174","136","4","314","950","0","33.05","18.32"
"10","007","00","200","0000","0000","13320","7164","6156","234","13554","42339","49337","32.01","16.92"
"10","007","00","200","0001","0000","676","331","345","7","683","2094","0","32.62","15.81"
"10","007","00","200","0001","0971","286","139","147","2","288","838","0","34.37","16.59"
"10","007","00","200","0001","0972","390","192","198","5","395","1256","0","31.45","15.29"
"10","007","00","200","0002","0000","1113","650","463","14","1127","3227","0","34.92","20.14"
"10","007","00","200","0002","0973","370","208","162","4","374","1020","0","36.67","20.39"
"10","007","00","200","0002","0974","397","247","150","5","402","1125","0","35.73","21.96"
"10","007","00","200","0002","0975","346","195","151","5","351","1082","0","32.44","18.02"
"10","007","00","200","0003","0000","488","254","234","2","490","1498","0","32.71","16.96"
"10","007","00","200","0003","0976","488","254","234","2","490","1498","0","32.71","16.96"
"10","007","00","200","0004","0000","947","457","490","21","968","2966","0","32.64","15.41"
"10","007","00","200","0004","0977","321","156","165","9","330","985","0","33.50","15.84"
"10","007","00","200","0004","0978","298","130","168","7","305","1016","0","30.02","12.80"
"10","007","00","200","0004","0979","328","171","157","5","333","965","0","34.51","17.72"
"10","007","00","200","0005","0000","438","269","169","14","452","1610","0","28.07","16.71"
"10","007","00","200","0005","0980","200","122","78","6","206","660","0","31.21","18.48"
"10","007","00","200","0005","0981","238","147","91","8","246","950","0","25.89","15.47"
"10","007","00","200","0006","0000","387","212","175","6","393","1341","0","29.31","15.81"
"10","007","00","200","0006","0982","387","212","175","6","393","1341","0","29.31","15.81"
"10","007","00","200","0007","0000","297","132","165","5","302","1010","0","29.90","13.07"
"10","007","00","200","0007","0983","297","132","165","5","302","1010","0","29.90","13.07"
"10","007","00","200","0008","0000","271","145","126","4","275","976","0","28.18","14.86"
"10","007","00","200","0008","0984","271","145","126","4","275","976","0","28.18","14.86"
"10","007","00","200","0009","0000","389","232","157","8","397","1145","0","34.67","20.26"
"10","007","00","200","0009","0985","389","232","157","8","397","1145","0","34.67","20.26"
"10","007","00","200","0010","0000","517","285","232","10","527","1598","0","32.98","17.83"
"10","007","00","200","0010","0986","231","116","115","4","235","779","0","30.17","14.89"
"10","007","00","200","0010","0987","286","169","117","6","292","819","0","35.65","20.63"
"10","007","00","200","0011","0000","1119","647","472","17","1136","3312","0","34.30","19.54"
"10","007","00","200","0011","0988","299","164","135","6","305","987","0","30.90","16.62"
"10","007","00","200","0011","0989","375","230","145","4","379","1053","0","35.99","21.84"
"10","007","00","200","0011","0990","445","253","192","7","452","1272","0","35.53","19.89"
"10","007","00","200","0012","0000","741","396","345","7","748","2497","0","29.96","15.86"
"10","007","00","200","0012","0968","192","86","106","3","195","721","0","27.05","11.93"
"10","007","00","200","0012","0969","278","152","126","3","281","1003","0","28.02","15.15"
"10","007","00","200","0012","0970","271","158","113","1","272","773","0","35.19","20.44"
"10","007","00","200","0013","0000","357","203","154","15","372","1309","0","28.42","15.51"
"10","007","00","200","0013","0991","357","203","154","15","372","1309","0","28.42","15.51"
"10","007","00","200","0014","0000","463","262","201","18","481","1557","0","30.89","16.83"
"10","007","00","200","0014","0992","225","114","111","9","234","720","0","32.50","15.83"
"10","007","00","200","0014","0993","238","148","90","9","247","837","0","29.51","17.68"
"10","007","00","200","0015","0000","330","175","155","9","339","1180","0","28.73","14.83"
"10","007","00","200","0015","0994","330","175","155","9","339","1180","0","28.73","14.83"
"10","007","00","200","0016","0000","260","150","110","5","265","770","0","34.42","19.48"
"10","007","00","200","0016","0995","260","150","110","5","265","770","0","34.42","19.48"
"10","007","00","200","0017","0000","505","260","245","4","509","1485","0","34.28","17.51"
"10","007","00","200","0017","0996","319","158","161","1","320","837","0","38.23","18.88"
"10","007","00","200","0017","0997","186","102","84","3","189","648","0","29.17","15.74"
"10","007","00","200","0018","0000","353","159","194","4","357","1259","0","28.36","12.63"
"10","007","00","200","0018","0998","353","159","194","4","357","1259","0","28.36","12.63"
"10","007","00","200","0019","0000","333","177","156","7","340","1071","0","31.75","16.53"
"10","007","00","200","0019","0999","333","177","156","7","340","1071","0","31.75","16.53"
"10","007","00","200","0020","0000","1124","665","459","14","1138","3551","0","32.05","18.73"
"10","007","00","200","0020","1000","349","219","130","9","358","1171","0","30.57","18.70"
"10","007","00","200","0020","1001","440","254","186","2","442","1323","0","33.41","19.20"
"10","007","00","200","0020","1002","335","192","143","3","338","1057","0","31.98","18.16"
"10","007","00","200","0021","0000","295","153","142","8","303","958","0","31.63","15.97"
"10","007","00","200","0021","1004","295","153","142","8","303","958","0","31.63","15.97"
"10","007","00","200","0022","0000","286","169","117","13","299","1107","0","27.01","15.27"
"10","007","00","200","0022","1003","286","169","117","13","299","1107","0","27.01","15.27"
"10","007","00","200","0023","0000","246","118","128","4","250","886","0","28.22","13.32"
"10","007","00","200","0023","1005","246","118","128","4","250","886","0","28.22","13.32"
"10","007","00","200","0024","0000","487","246","241","3","490","1220","0","40.16","20.16"
"10","007","00","200","0024","1006","487","246","241","3","490","1220","0","40.16","20.16"
"10","007","00","200","0025","0000","336","173","163","4","340","1041","0","32.66","16.62"
"10","007","00","200","0025","1007","336","173","163","4","340","1041","0","32.66","16.62"
"10","007","00","200","0026","0000","361","147","214","6","367","967","0","37.95","15.20"
"10","007","00","200","0026","1008","361","147","214","6","367","967","0","37.95","15.20"
"10","007","00","200","0027","0000","201","97","104","5","206","704","0","29.26","13.78"
"10","007","00","200","0027","1009","201","97","104","5","206","704","0","29.26","13.78"
"10","007","00","210","0000","0000","8378","3925","4453","106","8484","22884","26569","37.07","17.15"
"10","007","00","210","0001","0000","493","237","256","7","500","1279","0","39.09","18.53"
"10","007","00","210","0001","0887","493","237","256","7","500","1279","0","39.09","18.53"
"10","007","00","210","0002","0000","270","148","122","3","273","793","0","34.43","18.66"
"10","007","00","210","0002","0897","270","148","122","3","273","793","0","34.43","18.66"
"10","007","00","210","0003","0000","955","507","448","12","967","2570","0","37.63","19.73"
"10","007","00","210","0003","0895","553","315","238","7","560","1396","0","40.11","22.56"
"10","007","00","210","0003","0896","402","192","210","5","407","1174","0","34.67","16.35"
"10","007","00","210","0004","0000","361","171","190","3","364","1054","0","34.54","16.22"
"10","007","00","210","0004","0906","361","171","190","3","364","1054","0","34.54","16.22"
"10","007","00","210","0005","0000","282","122","160","6","288","751","0","38.35","16.25"
"10","007","00","210","0005","0910","282","122","160","6","288","751","0","38.35","16.25"
"10","007","00","210","0006","0000","420","192","228","2","422","1022","0","41.29","18.79"
"10","007","00","210","0006","0911","420","192","228","2","422","1022","0","41.29","18.79"
"10","007","00","210","0007","0000","370","185","185","5","375","1202","0","31.20","15.39"
"10","007","00","210","0007","0908","370","185","185","5","375","1202","0","31.20","15.39"
"10","007","00","210","0008","0000","227","95","132","0","227","613","0","37.03","15.50"
"10","007","00","210","0008","0909","227","95","132","0","227","613","0","37.03","15.50"
"10","007","00","210","0009","0000","480","216","264","7","487","1329","0","36.64","16.25"
"10","007","00","210","0009","0907","480","216","264","7","487","1329","0","36.64","16.25"
"10","007","00","210","0010","0000","453","194","259","11","464","1280","0","36.25","15.16"
"10","007","00","210","0010","0894","453","194","259","11","464","1280","0","36.25","15.16"
"10","007","00","210","0011","0000","579","234","345","11","590","1535","0","38.44","15.24"
"10","007","00","210","0011","0892","250","107","143","4","254","658","0","38.60","16.26"
"10","007","00","210","0011","0893","329","127","202","7","336","877","0","38.31","14.48"
"10","007","00","210","0012","0000","442","197","245","2","444","1216","0","36.51","16.20"
"10","007","00","210","0012","0888","442","197","245","2","444","1216","0","36.51","16.20"
"10","007","00","210","0013","0000","673","295","378","5","678","1724","0","39.33","17.11"
"10","007","00","210","0013","0889","411","176","235","2","413","1027","0","40.21","17.14"
"10","007","00","210","0013","0890","262","119","143","3","265","697","0","38.02","17.07"
"10","007","00","210","0014","0000","417","219","198","4","421","941","0","44.74","23.27"
"10","007","00","210","0014","0902","417","219","198","4","421","941","0","44.74","23.27"
"10","007","00","210","0015","0000","298","137","161","5","303","870","0","34.83","15.75"
"10","007","00","210","0015","0903","298","137","161","5","303","870","0","34.83","15.75"
"10","007","00","210","0016","0000","456","209","247","2","458","1365","0","33.55","15.31"
"10","007","00","210","0016","0904","267","124","143","1","268","790","0","33.92","15.70"
"10","007","00","210","0016","0905","189","85","104","1","190","575","0","33.04","14.78"
"10","007","00","210","0017","0000","547","260","287","10","557","1594","0","34.94","16.31"
"10","007","00","210","0017","0898","221","124","97","5","226","635","0","35.59","19.53"
"10","007","00","210","0017","0899","326","136","190","5","331","959","0","34.52","14.18"
"10","007","00","210","0018","0000","93","49","44","1","94","258","0","36.43","18.99"
"10","007","00","210","0018","0900","93","49","44","1","94","258","0","36.43","18.99"
"10","007","00","210","0019","0000","224","93","131","2","226","613","0","36.87","15.17"
"10","007","00","210","0019","0901","224","93","131","2","226","613","0","36.87","15.17"
"10","007","00","210","0020","0000","338","165","173","8","346","875","0","39.54","18.86"
"10","007","00","210","0020","0891","338","165","173","8","346","875","0","39.54","18.86"
"10","007","00","220","0000","0000","8397","3990","4407","121","8518","25354","29860","33.60","15.74"
"10","007","00","220","0001","0000","771","376","395","11","782","2433","0","32.14","15.45"
"10","007","00","220","0001","0912","398","165","233","4","402","1127","0","35.67","14.64"
"10","007","00","220","0001","0913","373","211","162","7","380","1306","0","29.10","16.16"
"10","007","00","220","0002","0000","577","273","304","7","584","1785","0","32.72","15.29"
"10","007","00","220","0002","0914","330","167","163","5","335","973","0","34.43","17.16"
"10","007","00","220","0002","0915","247","106","141","2","249","812","0","30.67","13.05"
"10","007","00","220","0003","0000","575","227","348","9","584","1565","0","37.32","14.50"
"10","007","00","220","0003","0916","259","95","164","5","264","693","0","38.10","13.71"
"10","007","00","220","0003","0917","316","132","184","4","320","872","0","36.70","15.14"
"10","007","00","220","0004","0000","639","389","250","17","656","2256","0","29.08","17.24"
"10","007","00","220","0004","0918","286","164","122","4","290","1110","0","26.13","14.77"
"10","007","00","220","0004","0919","353","225","128","13","366","1146","0","31.94","19.63"
"10","007","00","220","0005","0000","409","203","206","2","411","1230","0","33.41","16.50"
"10","007","00","220","0005","0920","409","203","206","2","411","1230","0","33.41","16.50"
"10","007","00","220","0006","0000","517","242","275","14","531","1561","0","34.02","15.50"
"10","007","00","220","0006","0921","274","135","139","11","285","888","0","32.09","15.20"
"10","007","00","220","0006","0922","243","107","136","3","246","673","0","36.55","15.90"
"10","007","00","220","0007","0000","1180","662","518","5","1185","3254","0","36.42","20.34"
"10","007","00","220","0007","0923","412","215","197","1","413","1034","0","39.94","20.79"
"10","007","00","220","0007","0924","433","266","167","3","436","1319","0","33.06","20.17"
"10","007","00","220","0007","0925","335","181","154","1","336","901","0","37.29","20.09"
"10","007","00","220","0008","0000","675","363","312","11","686","2210","0","31.04","16.43"
"10","007","00","220","0008","0926","287","157","130","4","291","995","0","29.25","15.78"
"10","007","00","220","0008","0927","388","206","182","7","395","1215","0","32.51","16.95"
"10","007","00","220","0009","0000","236","101","135","4","240","710","0","33.80","14.23"
"10","007","00","220","0009","0928","236","101","135","4","240","710","0","33.80","14.23"
"10","007","00","220","0010","0000","205","90","115","1","206","558","0","36.92","16.13"
"10","007","00","220","0010","0929","205","90","115","1","206","558","0","36.92","16.13"
"10","007","00","220","0011","0000","488","262","226","9","497","1486","0","33.45","17.63"
"10","007","00","220","0011","0930","227","133","94","6","233","750","0","31.07","17.73"
"10","007","00","220","0011","0931","261","129","132","3","264","736","0","35.87","17.53"
"10","007","00","220","0012","0000","339","110","229","2","341","1021","0","33.40","10.77"
"10","007","00","220","0012","0932","339","110","229","2","341","1021","0","33.40","10.77"
"10","007","00","220","0013","0000","247","100","147","3","250","807","0","30.98","12.39"
"10","007","00","220","0013","0933","247","100","147","3","250","807","0","30.98","12.39"
"10","007","00","220","0014","0000","355","125","230","5","360","1052","0","34.22","11.88"
"10","007","00","220","0014","0934","355","125","230","5","360","1052","0","34.22","11.88"
"10","007","00","220","0015","0000","508","224","284","5","513","1457","0","35.21","15.37"
"10","007","00","220","0015","0935","253","108","145","2","255","729","0","34.98","14.81"
"10","007","00","220","0015","0936","255","116","139","3","258","728","0","35.44","15.93"
"10","007","00","220","0016","0000","333","126","207","10","343","1056","0","32.48","11.93"
"10","007","00","220","0016","0937","333","126","207","10","343","1056","0","32.48","11.93"
"10","007","00","220","0017","0000","343","117","226","6","349","913","0","38.23","12.81"
"10","007","00","220","0017","0938","343","117","226","6","349","913","0","38.23","12.81"
"10","007","00","230","0000","0000","8258","3632","4626","140","8398","28593","32372","29.37","12.70"
"10","007","00","230","0001","0000","248","90","158","9","257","928","0","27.69","9.70"
"10","007","00","230","0001","1027","248","90","158","9","257","928","0","27.69","9.70"
"10","007","00","230","0002","0000","146","62","84","3","149","395","0","37.72","15.70"
"10","007","00","230","0002","1028","146","62","84","3","149","395","0","37.72","15.70"
"10","007","00","230","0003","0000","223","121","102","3","226","735","0","30.75","16.46"
"10","007","00","230","0003","1029","223","121","102","3","226","735","0","30.75","16.46"
"10","007","00","230","0004","0000","131","64","67","3","134","522","0","25.67","12.26"
"10","007","00","230","0004","1030","131","64","67","3","134","522","0","25.67","12.26"
"10","007","00","230","0005","0000","229","122","107","5","234","949","0","24.66","12.86"
"10","007","00","230","0005","1031","229","122","107","5","234","949","0","24.66","12.86"
"10","007","00","230","0006","0000","671","309","362","10","681","2090","0","32.58","14.78"
"10","007","00","230","0006","1032","396","185","211","6","402","1248","0","32.21","14.82"
"10","007","00","230","0006","1033","275","124","151","4","279","842","0","33.14","14.73"
"10","007","00","230","0007","0000","406","204","202","4","410","1329","0","30.85","15.35"
"10","007","00","230","0007","1034","194","109","85","2","196","696","0","28.16","15.66"
"10","007","00","230","0007","1035","212","95","117","2","214","633","0","33.81","15.01"
"10","007","00","230","0008","0000","102","51","51","2","104","475","0","21.89","10.74"
"10","007","00","230","0008","1051","102","51","51","2","104","475","0","21.89","10.74"
"10","007","00","230","0009","0000","176","95","81","5","181","630","0","28.73","15.08"
"10","007","00","230","0009","1037","176","95","81","5","181","630","0","28.73","15.08"
"10","007","00","230","0010","0000","218","133","85","3","221","785","0","28.15","16.94"
"10","007","00","230","0010","1038","218","133","85","3","221","785","0","28.15","16.94"
"10","007","00","230","0011","0000","227","111","116","6","233","973","0","23.95","11.41"
"10","007","00","230","0011","1039","227","111","116","6","233","973","0","23.95","11.41"
"10","007","00","230","0012","0000","182","88","94","2","184","575","0","32.00","15.30"
"10","007","00","230","0012","1040","182","88","94","2","184","575","0","32.00","15.30"
"10","007","00","230","0013","0000","168","74","94","6","174","557","0","31.24","13.29"
"10","007","00","230","0013","1041","168","74","94","6","174","557","0","31.24","13.29"
"10","007","00","230","0014","0000","197","78","119","5","202","769","0","26.27","10.14"
"10","007","00","230","0014","1036","197","78","119","5","202","769","0","26.27","10.14"
"10","007","00","230","0015","0000","635","179","456","15","650","2116","0","30.72","8.46"
"10","007","00","230","0015","1042","339","97","242","8","347","1068","0","32.49","9.08"
"10","007","00","230","0015","1043","296","82","214","7","303","1048","0","28.91","7.82"
"10","007","00","230","0016","0000","244","72","172","4","248","673","0","36.85","10.70"
"10","007","00","230","0016","1044","244","72","172","4","248","673","0","36.85","10.70"
"10","007","00","230","0017","0000","209","82","127","6","215","727","0","29.57","11.28"
"10","007","00","230","0017","1045","209","82","127","6","215","727","0","29.57","11.28"
"10","007","00","230","0018","0000","213","71","142","3","216","665","0","32.48","10.68"
"10","007","00","230","0018","1048","213","71","142","3","216","665","0","32.48","10.68"
"10","007","00","230","0019","0000","371","117","254","8","379","1278","0","29.66","9.15"
"10","007","00","230","0019","1046","155","57","98","4","159","572","0","27.80","9.97"
"10","007","00","230","0019","1047","216","60","156","4","220","706","0","31.16","8.50"
"10","007","00","230","0020","0000","489","189","300","6","495","1656","0","29.89","11.41"
"10","007","00","230","0020","1049","226","111","115","3","229","897","0","25.53","12.37"
"10","007","00","230","0020","1050","263","78","185","3","266","759","0","35.05","10.28"
"10","007","00","230","0021","0000","447","225","222","3","450","1420","0","31.69","15.85"
"10","007","00","230","0021","1052","347","163","184","3","350","1103","0","31.73","14.78"
"10","007","00","230","0021","1053","100","62","38","0","100","317","0","31.55","19.56"
"10","007","00","230","0022","0000","234","112","122","3","237","1062","0","22.32","10.55"
"10","007","00","230","0022","1057","234","112","122","3","237","1062","0","22.32","10.55"
"10","007","00","230","0023","0000","590","265","325","2","592","2059","0","28.75","12.87"
"10","007","00","230","0023","1054","299","140","159","2","301","1100","0","27.36","12.73"
"10","007","00","230","0023","1055","291","125","166","0","291","959","0","30.34","13.03"
"10","007","00","230","0024","0000","215","120","95","7","222","762","0","29.13","15.75"
"10","007","00","230","0024","1056","215","120","95","7","222","762","0","29.13","15.75"
"10","007","00","230","0025","0000","332","146","186","7","339","1304","0","26.00","11.20"
"10","007","00","230","0025","1058","159","83","76","4","163","558","0","29.21","14.87"
"10","007","00","230","0025","1059","173","63","110","3","176","746","0","23.59","8.45"
"10","007","00","230","0026","0000","955","452","503","10","965","3159","0","30.55","14.31"
"10","007","00","230","0026","1060","272","119","153","1","273","865","0","31.56","13.76"
"10","007","00","230","0026","1061","377","179","198","4","381","1194","0","31.91","14.99"
"10","007","00","230","0026","1062","306","154","152","5","311","1100","0","28.27","14.00"
"10","007","00","240","0000","0000","3803","2103","1700","84","3887","14194","15893","27.38","14.82"
"10","007","00","240","0001","0000","317","131","186","1","318","1065","0","29.86","12.30"
"10","007","00","240","0001","1011","317","131","186","1","318","1065","0","29.86","12.30"
"10","007","00","240","0002","0000","313","190","123","8","321","1069","0","30.03","17.77"
"10","007","00","240","0002","1015","138","85","53","4","142","516","0","27.52","16.47"
"10","007","00","240","0002","1016","175","105","70","4","179","553","0","32.37","18.99"
"10","007","00","240","0003","0000","375","209","166","8","383","1296","0","29.55","16.13"
"10","007","00","240","0003","1013","375","209","166","8","383","1296","0","29.55","16.13"
"10","007","00","240","0004","0000","224","127","97","2","226","798","0","28.32","15.91"
"10","007","00","240","0004","1014","224","127","97","2","226","798","0","28.32","15.91"
"10","007","00","240","0005","0000","334","196","138","7","341","929","0","36.71","21.10"
"10","007","00","240","0005","1012","334","196","138","7","341","929","0","36.71","21.10"
"10","007","00","240","0006","0000","225","143","82","6","231","1048","0","22.04","13.65"
"10","007","00","240","0006","1022","225","143","82","6","231","1048","0","22.04","13.65"
"10","007","00","240","0007","0000","314","170","144","4","318","1256","0","25.32","13.54"
"10","007","00","240","0007","1010","314","170","144","4","318","1256","0","25.32","13.54"
"10","007","00","240","0008","0000","164","95","69","5","169","662","0","25.53","14.35"
"10","007","00","240","0008","1017","164","95","69","5","169","662","0","25.53","14.35"
"10","007","00","240","0009","0000","181","96","85","2","183","663","0","27.60","14.48"
"10","007","00","240","0009","1025","181","96","85","2","183","663","0","27.60","14.48"
"10","007","00","240","0010","0000","301","151","150","9","310","1045","0","29.67","14.45"
"10","007","00","240","0010","1018","108","69","39","2","110","373","0","29.49","18.50"
"10","007","00","240","0010","1019","193","82","111","7","200","672","0","29.76","12.20"
"10","007","00","240","0011","0000","222","119","103","8","230","861","0","26.71","13.82"
"10","007","00","240","0011","1026","222","119","103","8","230","861","0","26.71","13.82"
"10","007","00","240","0012","0000","274","170","104","4","278","1164","0","23.88","14.60"
"10","007","00","240","0012","1023","274","170","104","4","278","1164","0","23.88","14.60"
"10","007","00","240","0013","0000","236","151","85","8","244","867","0","28.14","17.42"
"10","007","00","240","0013","1024","236","151","85","8","244","867","0","28.14","17.42"
"10","007","00","240","0014","0000","214","92","122","6","220","845","0","26.04","10.89"
"10","007","00","240","0014","1020","214","92","122","6","220","845","0","26.04","10.89"
"10","007","00","240","0015","0000","109","63","46","6","115","626","0","18.37","10.06"
"10","007","00","240","0015","1021","109","63","46","6","115","626","0","18.37","10.06"
"10","007","00","250","0000","0000","4030","1783","2247","48","4078","12543","14669","32.51","14.22"
"10","007","00","250","0001","0000","382","205","177","8","390","1148","0","33.97","17.86"
"10","007","00","250","0001","1063","382","205","177","8","390","1148","0","33.97","17.86"
"10","007","00","250","0002","0000","640","350","290","8","648","1936","0","33.47","18.08"
"10","007","00","250","0002","1064","313","160","153","2","315","968","0","32.54","16.53"
"10","007","00","250","0002","1065","327","190","137","6","333","968","0","34.40","19.63"
"10","007","00","250","0003","0000","230","114","116","7","237","699","0","33.91","16.31"
"10","007","00","250","0003","1066","230","114","116","7","237","699","0","33.91","16.31"
"10","007","00","250","0004","0000","220","117","103","1","221","753","0","29.35","15.54"
"10","007","00","250","0004","1067","220","117","103","1","221","753","0","29.35","15.54"
"10","007","00","250","0005","0000","464","170","294","7","471","1527","0","30.84","11.13"
"10","007","00","250","0005","1068","235","79","156","1","236","771","0","30.61","10.25"
"10","007","00","250","0005","1069","229","91","138","6","235","756","0","31.08","12.04"
"10","007","00","250","0006","0000","210","86","124","1","211","641","0","32.92","13.42"
"10","007","00","250","0006","1070","210","86","124","1","211","641","0","32.92","13.42"
"10","007","00","250","0007","0000","326","150","176","2","328","1052","0","31.18","14.26"
"10","007","00","250","0007","1071","326","150","176","2","328","1052","0","31.18","14.26"
"10","007","00","250","0008","0000","350","134","216","2","352","1083","0","32.50","12.37"
"10","007","00","250","0008","1072","350","134","216","2","352","1083","0","32.50","12.37"
"10","007","00","250","0009","0000","173","62","111","1","174","471","0","36.94","13.16"
"10","007","00","250","0009","1073","173","62","111","1","174","471","0","36.94","13.16"
"10","007","00","250","0010","0000","237","107","130","1","238","785","0","30.32","13.63"
"10","007","00","250","0010","1074","237","107","130","1","238","785","0","30.32","13.63"
"10","007","00","250","0011","0000","219","96","123","1","220","626","0","35.14","15.34"
"10","007","00","250","0011","1075","219","96","123","1","220","626","0","35.14","15.34"
"10","007","00","250","0012","0000","187","56","131","2","189","536","0","35.26","10.45"
"10","007","00","250","0012","1076","187","56","131","2","189","536","0","35.26","10.45"
"10","007","00","250","0013","0000","247","83","164","4","251","750","0","33.47","11.07"
"10","007","00","250","0013","1077","247","83","164","4","251","750","0","33.47","11.07"
"10","007","00","250","0014","0000","145","53","92","3","148","536","0","27.61","9.89"
"10","007","00","250","0014","1078","145","53","92","3","148","536","0","27.61","9.89"
"10","007","00","260","0000","0000","8290","3348","4942","119","8409","25072","28983","33.54","13.35"
"10","007","00","260","0001","0000","597","250","347","7","604","1828","0","33.04","13.68"
"10","007","00","260","0001","0939","281","125","156","3","284","777","0","36.55","16.09"
"10","007","00","260","0001","0940","316","125","191","4","320","1051","0","30.45","11.89"
"10","007","00","260","0002","0000","493","201","292","11","504","1430","0","35.24","14.06"
"10","007","00","260","0002","0949","268","117","151","6","274","702","0","39.03","16.67"
"10","007","00","260","0002","0950","225","84","141","5","230","728","0","31.59","11.54"
"10","007","00","260","0003","0000","299","153","146","3","302","1131","0","26.70","13.53"
"10","007","00","260","0003","0955","299","153","146","3","302","1131","0","26.70","13.53"
"10","007","00","260","0004","0000","485","130","355","9","494","1499","0","32.96","8.67"
"10","007","00","260","0004","0966","191","51","140","4","195","675","0","28.89","7.56"
"10","007","00","260","0004","0967","294","79","215","5","299","824","0","36.29","9.59"
"10","007","00","260","0005","0000","249","94","155","4","253","699","0","36.19","13.45"
"10","007","00","260","0005","0941","249","94","155","4","253","699","0","36.19","13.45"
"10","007","00","260","0006","0000","462","191","271","7","469","1461","0","32.10","13.07"
"10","007","00","260","0006","0951","253","117","136","2","255","786","0","32.44","14.89"
"10","007","00","260","0006","0952","209","74","135","5","214","675","0","31.70","10.96"
"10","007","00","260","0007","0000","251","111","140","3","254","813","0","31.24","13.65"
"10","007","00","260","0007","0961","251","111","140","3","254","813","0","31.24","13.65"
"10","007","00","260","0008","0000","361","125","236","3","364","839","0","43.38","14.90"
"10","007","00","260","0008","0942","361","125","236","3","364","839","0","43.38","14.90"
"10","007","00","260","0009","0000","572","223","349","13","585","1977","0","29.59","11.28"
"10","007","00","260","0009","0953","328","124","204","7","335","1065","0","31.46","11.64"
"10","007","00","260","0009","0954","244","99","145","6","250","912","0","27.41","10.86"
"10","007","00","260","0010","0000","198","76","122","3","201","693","0","29.00","10.97"
"10","007","00","260","0010","0962","198","76","122","3","201","693","0","29.00","10.97"
"10","007","00","260","0011","0000","585","276","309","6","591","1516","0","38.98","18.21"
"10","007","00","260","0011","0943","260","113","147","1","261","632","0","41.30","17.88"
"10","007","00","260","0011","0944","325","163","162","5","330","884","0","37.33","18.44"
"10","007","00","260","0012","0000","508","207","301","6","514","1799","0","28.57","11.51"
"10","007","00","260","0012","0956","239","90","149","4","243","937","0","25.93","9.61"
"10","007","00","260","0012","0957","269","117","152","2","271","862","0","31.44","13.57"
"10","007","00","260","0013","0000","252","98","154","5","257","831","0","30.93","11.79"
"10","007","00","260","0013","0963","252","98","154","5","257","831","0","30.93","11.79"
"10","007","00","260","0014","0000","661","312","349","8","669","1827","0","36.62","17.08"
"10","007","00","260","0014","0945","341","168","173","4","345","959","0","35.97","17.52"
"10","007","00","260","0014","0946","320","144","176","4","324","868","0","37.33","16.59"
"10","007","00","260","0015","0000","550","187","363","9","559","1863","0","30.01","10.04"
"10","007","00","260","0015","0958","266","98","168","4","270","852","0","31.69","11.50"
"10","007","00","260","0015","0959","284","89","195","5","289","1011","0","28.59","8.80"
"10","007","00","260","0016","0000","436","180","256","10","446","1255","0","35.54","14.34"
"10","007","00","260","0016","0965","436","180","256","10","446","1255","0","35.54","14.34"
"10","007","00","260","0017","0000","720","308","412","5","725","1915","0","37.86","16.08"
"10","007","00","260","0017","0947","388","156","232","3","391","1077","0","36.30","14.48"
"10","007","00","260","0017","0948","332","152","180","2","334","838","0","39.86","18.14"
"10","007","00","260","0018","0000","282","158","124","5","287","850","0","33.76","18.59"
"10","007","00","260","0018","0960","282","158","124","5","287","850","0","33.76","18.59"
"10","007","00","260","0019","0000","329","68","261","2","331","846","0","39.13","8.04"
"10","007","00","260","0019","0964","329","68","261","2","331","846","0","39.13","8.04"
"10","008","00","000","0000","0000","155814","84903","70911","1754","157568","420687","487743","37.45","20.18"
"10","008","00","010","0000","0000","34654","19531","15123","335","34989","83549","98736","41.88","23.38"
"10","008","00","010","0001","0000","379","190","189","2","381","910","0","41.87","20.88"
"10","008","00","010","0001","0001","379","190","189","2","381","910","0","41.87","20.88"
"10","008","00","010","0002","0000","636","334","302","4","640","1370","0","46.72","24.38"
"10","008","00","010","0002","0002","309","171","138","4","313","624","0","50.16","27.40"
"10","008","00","010","0002","0003","327","163","164","0","327","746","0","43.83","21.85"
"10","008","00","010","0003","0000","333","175","158","0","333","772","0","43.13","22.67"
"10","008","00","010","0003","0004","333","175","158","0","333","772","0","43.13","22.67"
"10","008","00","010","0004","0000","258","105","153","2","260","486","0","53.50","21.60"
"10","008","00","010","0004","0005","258","105","153","2","260","486","0","53.50","21.60"
"10","008","00","010","0005","0000","260","123","137","3","263","574","0","45.82","21.43"
"10","008","00","010","0005","0006","260","123","137","3","263","574","0","45.82","21.43"
"10","008","00","010","0006","0000","193","88","105","3","196","366","0","53.55","24.04"
"10","008","00","010","0006","0007","193","88","105","3","196","366","0","53.55","24.04"
"10","008","00","010","0007","0000","424","212","212","4","428","933","0","45.87","22.72"
"10","008","00","010","0007","0008","424","212","212","4","428","933","0","45.87","22.72"
"10","008","00","010","0008","0000","1091","546","545","6","1097","2566","0","42.75","21.28"
"10","008","00","010","0008","0058","563","263","300","2","565","1347","0","41.95","19.52"
"10","008","00","010","0008","0059","528","283","245","4","532","1219","0","43.64","23.22"
"10","008","00","010","0009","0000","2820","1566","1254","30","2850","7006","0","40.68","22.35"
"10","008","00","010","0009","0060","513","316","197","3","516","1201","0","42.96","26.31"
"10","008","00","010","0009","0061","480","256","224","7","487","1305","0","37.32","19.62"
"10","008","00","010","0009","0062","428","207","221","6","434","1047","0","41.45","19.77"
"10","008","00","010","0009","0063","417","220","197","6","423","1029","0","41.11","21.38"
"10","008","00","010","0009","0064","507","314","193","5","512","1311","0","39.05","23.95"
"10","008","00","010","0009","0065","475","253","222","3","478","1113","0","42.95","22.73"
"10","008","00","010","0010","0000","1703","934","769","22","1725","4577","0","37.69","20.41"
"10","008","00","010","0010","0032","488","267","221","1","489","1326","0","36.88","20.14"
"10","008","00","010","0010","0033","536","296","240","15","551","1402","0","39.30","21.11"
"10","008","00","010","0010","0034","537","288","249","5","542","1497","0","36.21","19.24"
"10","008","00","010","0010","0035","142","83","59","1","143","352","0","40.63","23.58"
"10","008","00","010","0011","0000","146","65","81","4","150","376","0","39.89","17.29"
"10","008","00","010","0011","0036","146","65","81","4","150","376","0","39.89","17.29"
"10","008","00","010","0012","0000","2436","1350","1086","20","2456","6024","0","40.77","22.41"
"10","008","00","010","0012","0022","363","182","181","6","369","983","0","37.54","18.51"
"10","008","00","010","0012","0023","340","217","123","1","341","843","0","40.45","25.74"
"10","008","00","010","0012","0024","406","225","181","2","408","931","0","43.82","24.17"
"10","008","00","010","0012","0025","460","237","223","4","464","1121","0","41.39","21.14"
"10","008","00","010","0012","0026","426","231","195","4","430","980","0","43.88","23.57"
"10","008","00","010","0012","0027","441","258","183","3","444","1166","0","38.08","22.13"
"10","008","00","010","0013","0000","851","374","477","10","861","2053","0","41.94","18.22"
"10","008","00","010","0013","0028","241","115","126","4","245","597","0","41.04","19.26"
"10","008","00","010","0013","0029","301","124","177","6","307","745","0","41.21","16.64"
"10","008","00","010","0013","0030","309","135","174","0","309","711","0","43.46","18.99"
"10","008","00","010","0014","0000","400","201","199","10","410","1008","0","40.67","19.94"
"10","008","00","010","0014","0031","400","201","199","10","410","1008","0","40.67","19.94"
"10","008","00","010","0015","0000","2210","1288","922","24","2234","5330","0","41.91","24.17"
"10","008","00","010","0015","0009","500","251","249","5","505","1174","0","43.02","21.38"
"10","008","00","010","0015","0010","601","370","231","7","608","1511","0","40.24","24.49"
"10","008","00","010","0015","0011","487","299","188","3","490","1193","0","41.07","25.06"
"10","008","00","010","0015","0012","622","368","254","9","631","1452","0","43.46","25.34"
"10","008","00","010","0016","0000","1250","689","561","9","1259","2691","0","46.79","25.60"
"10","008","00","010","0016","0013","447","248","199","5","452","1023","0","44.18","24.24"
"10","008","00","010","0016","0014","300","181","119","1","301","653","0","46.09","27.72"
"10","008","00","010","0016","0015","503","260","243","3","506","1015","0","49.85","25.62"
"10","008","00","010","0017","0000","796","335","461","3","799","2109","0","37.89","15.88"
"10","008","00","010","0017","0016","423","169","254","2","425","1134","0","37.48","14.90"
"10","008","00","010","0017","0017","373","166","207","1","374","975","0","38.36","17.03"
"10","008","00","010","0018","0000","1664","889","775","22","1686","4405","0","38.27","20.18"
"10","008","00","010","0018","0018","498","293","205","10","508","1080","0","47.04","27.13"
"10","008","00","010","0018","0019","367","213","154","1","368","992","0","37.10","21.47"
"10","008","00","010","0018","0020","416","176","240","5","421","1115","0","37.76","15.78"
"10","008","00","010","0018","0021","383","207","176","6","389","1218","0","31.94","17.00"
"10","008","00","010","0019","0000","675","366","309","9","684","1866","0","36.66","19.61"
"10","008","00","010","0019","0083","332","160","172","5","337","977","0","34.49","16.38"
"10","008","00","010","0019","0084","343","206","137","4","347","889","0","39.03","23.17"
"10","008","00","010","0020","0000","253","124","129","8","261","779","0","33.50","15.92"
"10","008","00","010","0020","0081","253","124","129","8","261","779","0","33.50","15.92"
"10","008","00","010","0021","0000","199","62","137","3","202","606","0","33.33","10.23"
"10","008","00","010","0021","0082","199","62","137","3","202","606","0","33.33","10.23"
"10","008","00","010","0022","0000","340","109","231","5","345","1073","0","32.15","10.16"
"10","008","00","010","0022","0080","340","109","231","5","345","1073","0","32.15","10.16"
"10","008","00","010","0023","0000","2036","1097","939","16","2052","5387","0","38.09","20.36"
"10","008","00","010","0023","0066","568","311","257","2","570","1398","0","40.77","22.25"
"10","008","00","010","0023","0067","419","223","196","4","423","1058","0","39.98","21.08"
"10","008","00","010","0023","0068","592","314","278","6","598","1529","0","39.11","20.54"
"10","008","00","010","0023","0069","457","249","208","4","461","1402","0","32.88","17.76"
"10","008","00","010","0024","0000","1780","974","806","15","1795","4997","0","35.92","19.49"
"10","008","00","010","0024","0070","417","217","200","1","418","1057","0","39.55","20.53"
"10","008","00","010","0024","0071","455","236","219","5","460","1248","0","36.86","18.91"
"10","008","00","010","0024","0072","368","203","165","6","374","1272","0","29.40","15.96"
"10","008","00","010","0024","0073","540","318","222","3","543","1420","0","38.24","22.39"
"10","008","00","010","0025","0000","1096","562","534","8","1104","2815","0","39.22","19.96"
"10","008","00","010","0025","0074","346","189","157","1","347","823","0","42.16","22.96"
"10","008","00","010","0025","0075","375","192","183","2","377","973","0","38.75","19.73"
"10","008","00","010","0025","0076","375","181","194","5","380","1019","0","37.29","17.76"
"10","008","00","010","0026","0000","1132","546","586","10","1142","3015","0","37.88","18.11"
"10","008","00","010","0026","0077","365","178","187","1","366","957","0","38.24","18.60"
"10","008","00","010","0026","0078","388","182","206","5","393","997","0","39.42","18.25"
"10","008","00","010","0026","0079","379","186","193","4","383","1061","0","36.10","17.53"
"10","008","00","010","0027","0000","3079","2134","945","24","3103","5877","0","52.80","36.31"
"10","008","00","010","0027","0039","454","292","162","5","459","926","0","49.57","31.53"
"10","008","00","010","0027","0040","481","315","166","4","485","944","0","51.38","33.37"
"10","008","00","010","0027","0041","544","390","154","3","547","1015","0","53.89","38.42"
"10","008","00","010","0027","0042","576","420","156","2","578","1058","0","54.63","39.70"
"10","008","00","010","0027","0043","574","404","170","6","580","1079","0","53.75","37.44"
"10","008","00","010","0027","0044","450","313","137","4","454","855","0","53.10","36.61"
"10","008","00","010","0028","0000","1072","617","455","12","1084","2381","0","45.53","25.91"
"10","008","00","010","0028","0037","512","289","223","7","519","1124","0","46.17","25.71"
"10","008","00","010","0028","0038","560","328","232","5","565","1257","0","44.95","26.09"
"10","008","00","010","0029","0000","2958","1893","1065","25","2983","6642","0","44.91","28.50"
"10","008","00","010","0029","0045","489","274","215","4","493","1203","0","40.98","22.78"
"10","008","00","010","0029","0046","506","310","196","8","514","1115","0","46.10","27.80"
"10","008","00","010","0029","0047","585","353","232","5","590","1266","0","46.60","27.88"
"10","008","00","010","0029","0048","474","334","140","3","477","1095","0","43.56","30.50"
"10","008","00","010","0029","0049","624","453","171","2","626","1318","0","47.50","34.37"
"10","008","00","010","0029","0050","280","169","111","3","283","645","0","43.88","26.20"
"10","008","00","010","0030","0000","566","281","285","8","574","1402","0","40.94","20.04"
"10","008","00","010","0030","0051","278","125","153","3","281","688","0","40.84","18.17"
"10","008","00","010","0030","0052","288","156","132","5","293","714","0","41.04","21.85"
"10","008","00","010","0031","0000","359","293","66","4","363","738","0","49.19","39.70"
"10","008","00","010","0031","0057","359","293","66","4","363","738","0","49.19","39.70"
"10","008","00","010","0032","0000","504","421","83","5","509","993","0","51.26","42.40"
"10","008","00","010","0032","0054","223","193","30","3","226","469","0","48.19","41.15"
"10","008","00","010","0032","0055","281","228","53","2","283","524","0","54.01","43.51"
"10","008","00","010","0033","0000","468","399","69","2","470","908","0","51.76","43.94"
"10","008","00","010","0033","0056","468","399","69","2","470","908","0","51.76","43.94"
"10","008","00","010","0034","0000","287","189","98","3","290","514","0","56.42","36.77"
"10","008","00","010","0034","0053","287","189","98","3","290","514","0","56.42","36.77"
"10","008","00","020","0000","0000","24660","14067","10593","263","24923","67679","78732","36.83","20.78"
"10","008","00","020","0001","0000","1096","611","485","9","1105","2573","0","42.95","23.75"
"10","008","00","020","0001","0085","320","170","150","3","323","788","0","40.99","21.57"
"10","008","00","020","0001","0086","331","192","139","3","334","757","0","44.12","25.36"
"10","008","00","020","0001","0087","445","249","196","3","448","1028","0","43.58","24.22"
"10","008","00","020","0002","0000","406","205","201","2","408","785","0","51.97","26.11"
"10","008","00","020","0002","0106","406","205","201","2","408","785","0","51.97","26.11"
"10","008","00","020","0003","0000","1102","604","498","6","1108","2927","0","37.85","20.64"
"10","008","00","020","0003","0103","357","186","171","2","359","840","0","42.74","22.14"
"10","008","00","020","0003","0104","318","162","156","2","320","957","0","33.44","16.93"
"10","008","00","020","0003","0105","427","256","171","2","429","1130","0","37.96","22.65"
"10","008","00","020","0004","0000","832","515","317","6","838","2457","0","34.11","20.96"
"10","008","00","020","0004","0107","373","229","144","3","376","1216","0","30.92","18.83"
"10","008","00","020","0004","0108","459","286","173","3","462","1241","0","37.23","23.05"
"10","008","00","020","0005","0000","808","477","331","9","817","2163","0","37.77","22.05"
"10","008","00","020","0005","0122","416","235","181","5","421","1106","0","38.07","21.25"
"10","008","00","020","0005","0123","392","242","150","4","396","1057","0","37.46","22.89"
"10","008","00","020","0006","0000","474","272","202","1","475","997","0","47.64","27.28"
"10","008","00","020","0006","0127","474","272","202","1","475","997","0","47.64","27.28"
"10","008","00","020","0007","0000","1268","740","528","18","1286","3608","0","35.64","20.51"
"10","008","00","020","0007","0124","445","267","178","5","450","1103","0","40.80","24.21"
"10","008","00","020","0007","0125","458","270","188","6","464","1244","0","37.30","21.70"
"10","008","00","020","0007","0126","365","203","162","7","372","1261","0","29.50","16.10"
"10","008","00","020","0008","0000","2128","1250","878","20","2148","5729","0","37.49","21.82"
"10","008","00","020","0008","0128","295","159","136","5","300","927","0","32.36","17.15"
"10","008","00","020","0008","0129","341","201","140","2","343","955","0","35.92","21.05"
"10","008","00","020","0008","0130","428","270","158","5","433","1008","0","42.96","26.79"
"10","008","00","020","0008","0131","335","177","158","1","336","859","0","39.12","20.61"
"10","008","00","020","0008","0132","367","218","149","4","371","972","0","38.17","22.43"
"10","008","00","020","0008","0133","362","225","137","3","365","1008","0","36.21","22.32"
"10","008","00","020","0009","0000","402","178","224","2","404","931","0","43.39","19.12"
"10","008","00","020","0009","0134","402","178","224","2","404","931","0","43.39","19.12"
"10","008","00","020","0010","0000","2610","1587","1023","27","2637","7501","0","35.16","21.16"
"10","008","00","020","0010","0090","446","283","163","3","449","1276","0","35.19","22.18"
"10","008","00","020","0010","0091","331","212","119","2","333","864","0","38.54","24.54"
"10","008","00","020","0010","0092","415","218","197","8","423","1323","0","31.97","16.48"
"10","008","00","020","0010","0093","519","342","177","6","525","1310","0","40.08","26.11"
"10","008","00","020","0010","0094","453","281","172","1","454","1424","0","31.88","19.73"
"10","008","00","020","0010","0095","446","251","195","7","453","1304","0","34.74","19.25"
"10","008","00","020","0011","0000","1122","610","512","9","1131","3785","0","29.88","16.12"
"10","008","00","020","0011","0096","319","169","150","2","321","1138","0","28.21","14.85"
"10","008","00","020","0011","0097","345","190","155","3","348","1195","0","29.12","15.90"
"10","008","00","020","0011","0098","178","101","77","1","179","522","0","34.29","19.35"
"10","008","00","020","0011","0099","280","150","130","3","283","930","0","30.43","16.13"
"10","008","00","020","0012","0000","327","178","149","2","329","1019","0","32.29","17.47"
"10","008","00","020","0012","0100","327","178","149","2","329","1019","0","32.29","17.47"
"10","008","00","020","0013","0000","373","204","169","8","381","1106","0","34.45","18.44"
"10","008","00","020","0013","0101","373","204","169","8","381","1106","0","34.45","18.44"
"10","008","00","020","0014","0000","394","237","157","5","399","1116","0","35.75","21.24"
"10","008","00","020","0014","0102","394","237","157","5","399","1116","0","35.75","21.24"
"10","008","00","020","0015","0000","351","240","111","5","356","1007","0","35.35","23.83"
"10","008","00","020","0015","0135","351","240","111","5","356","1007","0","35.35","23.83"
"10","008","00","020","0016","0000","111","62","49","0","111","298","0","37.25","20.81"
"10","008","00","020","0016","0136","111","62","49","0","111","298","0","37.25","20.81"
"10","008","00","020","0017","0000","411","237","174","4","415","1324","0","31.34","17.90"
"10","008","00","020","0017","0137","411","237","174","4","415","1324","0","31.34","17.90"
"10","008","00","020","0018","0000","491","297","194","5","496","1412","0","35.13","21.03"
"10","008","00","020","0018","0138","248","152","96","3","251","691","0","36.32","22.00"
"10","008","00","020","0018","0139","243","145","98","2","245","721","0","33.98","20.11"
"10","008","00","020","0019","0000","604","338","266","7","611","1701","0","35.92","19.87"
"10","008","00","020","0019","0140","283","150","133","3","286","769","0","37.19","19.51"
"10","008","00","020","0019","0141","321","188","133","4","325","932","0","34.87","20.17"
"10","008","00","020","0020","0000","454","265","189","5","459","1348","0","34.05","19.66"
"10","008","00","020","0020","0142","320","190","130","2","322","952","0","33.82","19.96"
"10","008","00","020","0020","0143","134","75","59","3","137","396","0","34.60","18.94"
"10","008","00","020","0021","0000","261","135","126","4","265","661","0","40.09","20.42"
"10","008","00","020","0021","0144","261","135","126","4","265","661","0","40.09","20.42"
"10","008","00","020","0022","0000","393","264","129","5","398","988","0","40.28","26.72"
"10","008","00","020","0022","0145","393","264","129","5","398","988","0","40.28","26.72"
"10","008","00","020","0023","0000","362","212","150","4","366","1132","0","32.33","18.73"
"10","008","00","020","0023","0148","362","212","150","4","366","1132","0","32.33","18.73"
"10","008","00","020","0024","0000","220","136","84","2","222","580","0","38.28","23.45"
"10","008","00","020","0024","0149","220","136","84","2","222","580","0","38.28","23.45"
"10","008","00","020","0025","0000","336","133","203","3","339","962","0","35.24","13.83"
"10","008","00","020","0025","0150","336","133","203","3","339","962","0","35.24","13.83"
"10","008","00","020","0026","0000","1012","507","505","7","1019","2818","0","36.16","17.99"
"10","008","00","020","0026","0151","346","175","171","3","349","924","0","37.77","18.94"
"10","008","00","020","0026","0152","316","165","151","2","318","898","0","35.41","18.37"
"10","008","00","020","0026","0153","350","167","183","2","352","996","0","35.34","16.77"
"10","008","00","020","0027","0000","615","340","275","8","623","1661","0","37.51","20.47"
"10","008","00","020","0027","0117","265","131","134","5","270","734","0","36.78","17.85"
"10","008","00","020","0027","0118","350","209","141","3","353","927","0","38.08","22.55"
"10","008","00","020","0028","0000","866","473","393","9","875","2570","0","34.05","18.40"
"10","008","00","020","0028","0119","403","250","153","4","407","1185","0","34.35","21.10"
"10","008","00","020","0028","0120","312","158","154","3","315","938","0","33.58","16.84"
"10","008","00","020","0028","0121","151","65","86","2","153","447","0","34.23","14.54"
"10","008","00","020","0029","0000","569","264","305","10","579","1597","0","36.26","16.53"
"10","008","00","020","0029","0146","457","214","243","10","467","1300","0","35.92","16.46"
"10","008","00","020","0029","0147","112","50","62","0","112","297","0","37.71","16.84"
"10","008","00","020","0030","0000","1301","759","542","13","1314","3098","0","42.41","24.50"
"10","008","00","020","0030","0109","403","240","163","3","406","972","0","41.77","24.69"
"10","008","00","020","0030","0110","458","264","194","3","461","1099","0","41.95","24.02"
"10","008","00","020","0030","0111","440","255","185","7","447","1027","0","43.52","24.83"
"10","008","00","020","0031","0000","986","541","445","28","1014","2585","0","39.23","20.93"
"10","008","00","020","0031","0088","530","277","253","10","540","1326","0","40.72","20.89"
"10","008","00","020","0031","0089","456","264","192","18","474","1259","0","37.65","20.97"
"10","008","00","020","0032","0000","1119","675","444","12","1131","3170","0","35.68","21.29"
"10","008","00","020","0032","0112","381","243","138","6","387","1003","0","38.58","24.23"
"10","008","00","020","0032","0113","358","219","139","4","362","1062","0","34.09","20.62"
"10","008","00","020","0032","0114","380","213","167","2","382","1105","0","34.57","19.28"
"10","008","00","020","0033","0000","856","521","335","8","864","2070","0","41.74","25.17"
"10","008","00","020","0033","0115","417","262","155","4","421","1065","0","39.53","24.60"
"10","008","00","020","0033","0116","439","259","180","4","443","1005","0","44.08","25.77"
"10","008","00","030","0000","0000","33841","17831","16010","311","34152","83201","97262","41.05","21.43"
"10","008","00","030","0001","0000","903","532","371","9","912","2084","0","43.76","25.53"
"10","008","00","030","0001","0154","413","222","191","6","419","974","0","43.02","22.79"
"10","008","00","030","0001","0155","490","310","180","3","493","1110","0","44.41","27.93"
"10","008","00","030","0002","0000","923","490","433","5","928","2059","0","45.07","23.80"
"10","008","00","030","0002","0159","459","244","215","1","460","1055","0","43.60","23.13"
"10","008","00","030","0002","0160","464","246","218","4","468","1004","0","46.61","24.50"
"10","008","00","030","0003","0000","506","248","258","6","512","1084","0","47.23","22.88"
"10","008","00","030","0003","0162","506","248","258","6","512","1084","0","47.23","22.88"
"10","008","00","030","0004","0000","2489","1372","1117","25","2514","6414","0","39.20","21.39"
"10","008","00","030","0004","0165","474","264","210","10","484","1243","0","38.94","21.24"
"10","008","00","030","0004","0166","413","255","158","2","415","1222","0","33.96","20.87"
"10","008","00","030","0004","0167","481","244","237","7","488","1232","0","39.61","19.81"
"10","008","00","030","0004","0168","563","301","262","4","567","1456","0","38.94","20.67"
"10","008","00","030","0004","0169","558","308","250","2","560","1261","0","44.41","24.43"
"10","008","00","030","0005","0000","3341","2027","1314","26","3367","7515","0","44.80","26.97"
"10","008","00","030","0005","0170","590","340","250","11","601","1196","0","50.25","28.43"
"10","008","00","030","0005","0171","473","293","180","1","474","1226","0","38.66","23.90"
"10","008","00","030","0005","0172","535","334","201","5","540","1186","0","45.53","28.16"
"10","008","00","030","0005","0173","502","317","185","1","503","1172","0","42.92","27.05"
"10","008","00","030","0005","0174","634","391","243","5","639","1373","0","46.54","28.48"
"10","008","00","030","0005","0175","607","352","255","3","610","1362","0","44.79","25.84"
"10","008","00","030","0006","0000","2532","1294","1238","21","2553","6652","0","38.38","19.45"
"10","008","00","030","0006","0209","554","282","272","3","557","1568","0","35.52","17.98"
"10","008","00","030","0006","0210","495","263","232","3","498","1229","0","40.52","21.40"
"10","008","00","030","0006","0211","395","192","203","2","397","1022","0","38.85","18.79"
"10","008","00","030","0006","0212","334","163","171","4","338","1036","0","32.63","15.73"
"10","008","00","030","0006","0213","482","272","210","6","488","1141","0","42.77","23.84"
"10","008","00","030","0006","0214","272","122","150","3","275","656","0","41.92","18.60"
"10","008","00","030","0007","0000","2387","1223","1164","28","2415","6108","0","39.54","20.02"
"10","008","00","030","0007","0191","553","309","244","6","559","1372","0","40.74","22.52"
"10","008","00","030","0007","0192","491","260","231","6","497","1157","0","42.96","22.47"
"10","008","00","030","0007","0193","539","290","249","5","544","1334","0","40.78","21.74"
"10","008","00","030","0007","0194","322","149","173","3","325","868","0","37.44","17.17"
"10","008","00","030","0007","0195","482","215","267","8","490","1377","0","35.58","15.61"
"10","008","00","030","0008","0000","1591","802","789","28","1619","4032","0","40.15","19.89"
"10","008","00","030","0008","0196","413","232","181","12","425","1000","0","42.50","23.20"
"10","008","00","030","0008","0197","435","249","186","2","437","1068","0","40.92","23.31"
"10","008","00","030","0008","0198","346","150","196","6","352","1002","0","35.13","14.97"
"10","008","00","030","0008","0199","397","171","226","8","405","962","0","42.10","17.78"
"10","008","00","030","0009","0000","1676","844","832","17","1693","4524","0","37.42","18.66"
"10","008","00","030","0009","0182","376","192","184","9","385","1062","0","36.25","18.08"
"10","008","00","030","0009","0183","439","221","218","3","442","1070","0","41.31","20.65"
"10","008","00","030","0009","0184","412","203","209","2","414","1149","0","36.03","17.67"
"10","008","00","030","0009","0185","449","228","221","3","452","1243","0","36.36","18.34"
"10","008","00","030","0010","0000","1045","616","429","4","1049","2446","0","42.89","25.18"
"10","008","00","030","0010","0186","623","362","261","1","624","1415","0","44.10","25.58"
"10","008","00","030","0010","0187","422","254","168","3","425","1031","0","41.22","24.64"
"10","008","00","030","0011","0000","1212","641","571","10","1222","2862","0","42.70","22.40"
"10","008","00","030","0011","0188","479","252","227","3","482","1057","0","45.60","23.84"
"10","008","00","030","0011","0189","355","180","175","4","359","856","0","41.94","21.03"
"10","008","00","030","0011","0190","378","209","169","3","381","949","0","40.15","22.02"
"10","008","00","030","0012","0000","1425","832","593","10","1435","3175","0","45.20","26.20"
"10","008","00","030","0012","0179","530","310","220","6","536","1141","0","46.98","27.17"
"10","008","00","030","0012","0180","434","264","170","0","434","1011","0","42.93","26.11"
"10","008","00","030","0012","0181","461","258","203","4","465","1023","0","45.45","25.22"
"10","008","00","030","0013","0000","1448","771","677","11","1459","3702","0","39.41","20.83"
"10","008","00","030","0013","0200","442","214","228","1","443","1183","0","37.45","18.09"
"10","008","00","030","0013","0201","500","288","212","4","504","1114","0","45.24","25.85"
"10","008","00","030","0013","0202","506","269","237","6","512","1405","0","36.44","19.15"
"10","008","00","030","0014","0000","1184","519","665","15","1199","2951","0","40.63","17.59"
"10","008","00","030","0014","0206","407","177","230","5","412","950","0","43.37","18.63"
"10","008","00","030","0014","0207","320","157","163","5","325","965","0","33.68","16.27"
"10","008","00","030","0014","0208","457","185","272","5","462","1036","0","44.59","17.86"
"10","008","00","030","0015","0000","582","291","291","4","586","1502","0","39.01","19.37"
"10","008","00","030","0015","0205","582","291","291","4","586","1502","0","39.01","19.37"
"10","008","00","030","0016","0000","937","422","515","7","944","2217","0","42.58","19.03"
"10","008","00","030","0016","0203","391","177","214","0","391","919","0","42.55","19.26"
"10","008","00","030","0016","0204","546","245","301","7","553","1298","0","42.60","18.88"
"10","008","00","030","0017","0000","723","334","389","12","735","1858","0","39.56","17.98"
"10","008","00","030","0017","0215","283","138","145","5","288","689","0","41.80","20.03"
"10","008","00","030","0017","0216","260","109","151","1","261","668","0","39.07","16.32"
"10","008","00","030","0017","0217","180","87","93","6","186","501","0","37.13","17.37"
"10","008","00","030","0018","0000","898","357","541","6","904","2029","0","44.55","17.59"
"10","008","00","030","0018","0218","471","182","289","4","475","1159","0","40.98","15.70"
"10","008","00","030","0018","0219","427","175","252","2","429","870","0","49.31","20.11"
"10","008","00","030","0019","0000","1553","719","834","7","1560","4072","0","38.31","17.66"
"10","008","00","030","0019","0220","418","199","219","2","420","1100","0","38.18","18.09"
"10","008","00","030","0019","0221","372","164","208","2","374","933","0","40.09","17.58"
"10","008","00","030","0019","0222","352","176","176","2","354","956","0","37.03","18.41"
"10","008","00","030","0019","0223","411","180","231","1","412","1083","0","38.04","16.62"
"10","008","00","030","0020","0000","598","355","243","6","604","1658","0","36.43","21.41"
"10","008","00","030","0020","0225","241","160","81","4","245","641","0","38.22","24.96"
"10","008","00","030","0020","0226","357","195","162","2","359","1017","0","35.30","19.17"
"10","008","00","030","0021","0000","397","207","190","2","399","1017","0","39.23","20.35"
"10","008","00","030","0021","0224","397","207","190","2","399","1017","0","39.23","20.35"
"10","008","00","030","0022","0000","694","348","346","12","706","2247","0","31.42","15.49"
"10","008","00","030","0022","0228","362","176","186","6","368","1160","0","31.72","15.17"
"10","008","00","030","0022","0229","332","172","160","6","338","1087","0","31.09","15.82"
"10","008","00","030","0023","0000","407","227","180","4","411","1070","0","38.41","21.21"
"10","008","00","030","0023","0227","407","227","180","4","411","1070","0","38.41","21.21"
"10","008","00","030","0024","0000","306","160","146","6","312","664","0","46.99","24.10"
"10","008","00","030","0024","0161","306","160","146","6","312","664","0","46.99","24.10"
"10","008","00","030","0025","0000","1098","527","571","6","1104","2330","0","47.38","22.62"
"10","008","00","030","0025","0163","461","246","215","2","463","939","0","49.31","26.20"
"10","008","00","030","0025","0164","637","281","356","4","641","1391","0","46.08","20.20"
"10","008","00","030","0026","0000","1555","844","711","16","1571","3714","0","42.30","22.72"
"10","008","00","030","0026","0156","633","327","306","5","638","1402","0","45.51","23.32"
"10","008","00","030","0026","0157","400","196","204","5","405","1071","0","37.82","18.30"
"10","008","00","030","0026","0158","522","321","201","6","528","1241","0","42.55","25.87"
"10","008","00","030","0027","0000","1431","829","602","8","1439","3215","0","44.76","25.79"
"10","008","00","030","0027","0176","435","233","202","3","438","974","0","44.97","23.92"
"10","008","00","030","0027","0177","591","382","209","1","592","1331","0","44.48","28.70"
"10","008","00","030","0027","0178","405","214","191","4","409","910","0","44.95","23.52"
"10","008","00","040","0000","0000","16488","8312","8176","201","16689","46058","53033","36.23","18.05"
"10","008","00","040","0001","0000","850","445","405","6","856","1957","0","43.74","22.74"
"10","008","00","040","0001","0230","484","263","221","5","489","1155","0","42.34","22.77"
"10","008","00","040","0001","0231","366","182","184","1","367","802","0","45.76","22.69"
"10","008","00","040","0002","0000","232","118","114","1","233","614","0","37.95","19.22"
"10","008","00","040","0002","0232","232","118","114","1","233","614","0","37.95","19.22"
"10","008","00","040","0003","0000","1683","869","814","16","1699","4553","0","37.32","19.09"
"10","008","00","040","0003","0233","355","168","187","4","359","884","0","40.61","19.00"
"10","008","00","040","0003","0234","393","195","198","0","393","1127","0","34.87","17.30"
"10","008","00","040","0003","0235","419","240","179","7","426","1196","0","35.62","20.07"
"10","008","00","040","0003","0236","516","266","250","5","521","1346","0","38.71","19.76"
"10","008","00","040","0004","0000","1329","719","610","11","1340","3463","0","38.69","20.76"
"10","008","00","040","0004","0237","446","253","193","6","452","1131","0","39.96","22.37"
"10","008","00","040","0004","0238","414","205","209","2","416","1073","0","38.77","19.11"
"10","008","00","040","0004","0239","469","261","208","3","472","1259","0","37.49","20.73"
"10","008","00","040","0005","0000","642","328","314","10","652","1752","0","37.21","18.72"
"10","008","00","040","0005","0271","287","148","139","4","291","790","0","36.84","18.73"
"10","008","00","040","0005","0272","355","180","175","6","361","962","0","37.53","18.71"
"10","008","00","040","0006","0000","460","251","209","12","472","1189","0","39.70","21.11"
"10","008","00","040","0006","0245","197","101","96","8","205","490","0","41.84","20.61"
"10","008","00","040","0006","0246","263","150","113","4","267","699","0","38.20","21.46"
"10","008","00","040","0007","0000","1268","642","626","18","1286","3652","0","35.21","17.58"
"10","008","00","040","0007","0242","458","235","223","8","466","1279","0","36.43","18.37"
"10","008","00","040","0007","0243","442","234","208","8","450","1324","0","33.99","17.67"
"10","008","00","040","0007","0244","368","173","195","2","370","1049","0","35.27","16.49"
"10","008","00","040","0008","0000","325","107","218","4","329","894","0","36.80","11.97"
"10","008","00","040","0008","0247","325","107","218","4","329","894","0","36.80","11.97"
"10","008","00","040","0009","0000","449","234","215","7","456","1401","0","32.55","16.70"
"10","008","00","040","0009","0248","449","234","215","7","456","1401","0","32.55","16.70"
"10","008","00","040","0010","0000","335","192","143","4","339","878","0","38.61","21.87"
"10","008","00","040","0010","0273","142","74","68","3","145","367","0","39.51","20.16"
"10","008","00","040","0010","0274","193","118","75","1","194","511","0","37.96","23.09"
"10","008","00","040","0011","0000","951","429","522","18","969","2802","0","34.58","15.31"
"10","008","00","040","0011","0261","395","188","207","8","403","1293","0","31.17","14.54"
"10","008","00","040","0011","0262","356","177","179","6","362","944","0","38.35","18.75"
"10","008","00","040","0011","0263","200","64","136","4","204","565","0","36.11","11.33"
"10","008","00","040","0012","0000","532","261","271","11","543","1678","0","32.36","15.55"
"10","008","00","040","0012","0259","269","135","134","5","274","891","0","30.75","15.15"
"10","008","00","040","0012","0260","263","126","137","6","269","787","0","34.18","16.01"
"10","008","00","040","0013","0000","316","153","163","4","320","839","0","38.14","18.24"
"10","008","00","040","0013","0264","316","153","163","4","320","839","0","38.14","18.24"
"10","008","00","040","0014","0000","1720","864","856","12","1732","4860","0","35.64","17.78"
"10","008","00","040","0014","0252","481","247","234","1","482","1435","0","33.59","17.21"
"10","008","00","040","0014","0253","457","233","224","2","459","1289","0","35.61","18.08"
"10","008","00","040","0014","0254","395","201","194","4","399","1085","0","36.77","18.53"
"10","008","00","040","0014","0255","387","183","204","5","392","1051","0","37.30","17.41"
"10","008","00","040","0015","0000","593","276","317","8","601","1818","0","33.06","15.18"
"10","008","00","040","0015","0265","389","174","215","4","393","1171","0","33.56","14.86"
"10","008","00","040","0015","0266","204","102","102","4","208","647","0","32.15","15.77"
"10","008","00","040","0016","0000","467","226","241","11","478","1312","0","36.43","17.23"
"10","008","00","040","0016","0267","467","226","241","11","478","1312","0","36.43","17.23"
"10","008","00","040","0017","0000","380","174","206","4","384","1132","0","33.92","15.37"
"10","008","00","040","0017","0268","380","174","206","4","384","1132","0","33.92","15.37"
"10","008","00","040","0018","0000","232","124","108","3","235","595","0","39.50","20.84"
"10","008","00","040","0018","0269","232","124","108","3","235","595","0","39.50","20.84"
"10","008","00","040","0019","0000","132","78","54","0","132","422","0","31.28","18.48"
"10","008","00","040","0019","0251","132","78","54","0","132","422","0","31.28","18.48"
"10","008","00","040","0020","0000","180","95","85","3","183","577","0","31.72","16.46"
"10","008","00","040","0020","0270","180","95","85","3","183","577","0","31.72","16.46"
"10","008","00","040","0021","0000","216","130","86","7","223","591","0","37.73","22.00"
"10","008","00","040","0021","0275","75","58","17","2","77","194","0","39.69","29.90"
"10","008","00","040","0021","0276","141","72","69","5","146","397","0","36.78","18.14"
"10","008","00","040","0022","0000","215","107","108","1","216","733","0","29.47","14.60"
"10","008","00","040","0022","0277","133","67","66","0","133","454","0","29.30","14.76"
"10","008","00","040","0022","0278","82","40","42","1","83","279","0","29.75","14.34"
"10","008","00","040","0023","0000","179","86","93","1","180","562","0","32.03","15.30"
"10","008","00","040","0023","0280","179","86","93","1","180","562","0","32.03","15.30"
"10","008","00","040","0024","0000","162","83","79","0","162","446","0","36.32","18.61"
"10","008","00","040","0024","0279","162","83","79","0","162","446","0","36.32","18.61"
"10","008","00","040","0025","0000","223","101","122","10","233","865","0","26.94","11.68"
"10","008","00","040","0025","0281","128","57","71","8","136","486","0","27.98","11.73"
"10","008","00","040","0025","0282","95","44","51","2","97","379","0","25.59","11.61"
"10","008","00","040","0026","0000","262","120","142","4","266","674","0","39.47","17.80"
"10","008","00","040","0026","0249","80","41","39","0","80","217","0","36.87","18.89"
"10","008","00","040","0026","0250","182","79","103","4","186","457","0","40.70","17.29"
"10","008","00","040","0027","0000","1324","655","669","8","1332","3551","0","37.51","18.45"
"10","008","00","040","0027","0256","471","234","237","2","473","1284","0","36.84","18.22"
"10","008","00","040","0027","0257","377","182","195","3","380","1034","0","36.75","17.60"
"10","008","00","040","0027","0258","476","239","237","3","479","1233","0","38.85","19.38"
"10","008","00","040","0028","0000","831","445","386","7","838","2248","0","37.28","19.80"
"10","008","00","040","0028","0240","428","225","203","2","430","1079","0","39.85","20.85"
"10","008","00","040","0028","0241","403","220","183","5","408","1169","0","34.90","18.82"
"10","008","00","050","0000","0000","3390","1858","1532","47","3437","9241","10350","37.19","20.11"
"10","008","00","050","0001","0000","448","270","178","5","453","1076","0","42.10","25.09"
"10","008","00","050","0001","0283","448","270","178","5","453","1076","0","42.10","25.09"
"10","008","00","050","0002","0000","328","181","147","8","336","872","0","38.53","20.76"
"10","008","00","050","0002","0284","328","181","147","8","336","872","0","38.53","20.76"
"10","008","00","050","0003","0000","197","98","99","2","199","549","0","36.25","17.85"
"10","008","00","050","0003","0285","197","98","99","2","199","549","0","36.25","17.85"
"10","008","00","050","0004","0000","384","191","193","8","392","1141","0","34.36","16.74"
"10","008","00","050","0004","0286","206","104","102","5","211","611","0","34.53","17.02"
"10","008","00","050","0004","0287","178","87","91","3","181","530","0","34.15","16.42"
"10","008","00","050","0005","0000","163","73","90","1","164","463","0","35.42","15.77"
"10","008","00","050","0005","0288","163","73","90","1","164","463","0","35.42","15.77"
"10","008","00","050","0006","0000","174","99","75","0","174","472","0","36.86","20.97"
"10","008","00","050","0006","0289","174","99","75","0","174","472","0","36.86","20.97"
"10","008","00","050","0007","0000","341","204","137","5","346","877","0","39.45","23.26"
"10","008","00","050","0007","0290","341","204","137","5","346","877","0","39.45","23.26"
"10","008","00","050","0008","0000","519","281","238","6","525","1415","0","37.10","19.86"
"10","008","00","050","0008","0291","306","167","139","2","308","756","0","40.74","22.09"
"10","008","00","050","0008","0292","213","114","99","4","217","659","0","32.93","17.30"
"10","008","00","050","0009","0000","353","178","175","4","357","943","0","37.86","18.88"
"10","008","00","050","0009","0293","353","178","175","4","357","943","0","37.86","18.88"
"10","008","00","050","0010","0000","191","105","86","3","194","544","0","35.66","19.30"
"10","008","00","050","0010","0296","191","105","86","3","194","544","0","35.66","19.30"
"10","008","00","050","0011","0000","292","178","114","5","297","889","0","33.41","20.02"
"10","008","00","050","0011","0294","168","103","65","5","173","489","0","35.38","21.06"
"10","008","00","050","0011","0295","124","75","49","0","124","400","0","31.00","18.75"
"10","008","00","060","0000","0000","12248","5499","6749","160","12408","32758","37230","37.88","16.79"
"10","008","00","060","0001","0000","421","211","210","2","423","1008","0","41.96","20.93"
"10","008","00","060","0001","0297","421","211","210","2","423","1008","0","41.96","20.93"
"10","008","00","060","0002","0000","1322","638","684","12","1334","3391","0","39.34","18.81"
"10","008","00","060","0002","0298","367","167","200","2","369","906","0","40.73","18.43"
"10","008","00","060","0002","0299","284","129","155","5","289","701","0","41.23","18.40"
"10","008","00","060","0002","0300","332","170","162","4","336","862","0","38.98","19.72"
"10","008","00","060","0002","0301","339","172","167","1","340","922","0","36.88","18.66"
"10","008","00","060","0003","0000","770","390","380","5","775","2202","0","35.20","17.71"
"10","008","00","060","0003","0302","343","187","156","4","347","1043","0","33.27","17.93"
"10","008","00","060","0003","0303","427","203","224","1","428","1159","0","36.93","17.52"
"10","008","00","060","0004","0000","609","280","329","5","614","1540","0","39.87","18.18"
"10","008","00","060","0004","0304","301","136","165","1","302","788","0","38.32","17.26"
"10","008","00","060","0004","0305","308","144","164","4","312","752","0","41.49","19.15"
"10","008","00","060","0005","0000","319","140","179","3","322","978","0","32.92","14.31"
"10","008","00","060","0005","0307","319","140","179","3","322","978","0","32.92","14.31"
"10","008","00","060","0006","0000","369","154","215","9","378","957","0","39.50","16.09"
"10","008","00","060","0006","0306","369","154","215","9","378","957","0","39.50","16.09"
"10","008","00","060","0007","0000","1587","715","872","22","1609","4169","0","38.59","17.15"
"10","008","00","060","0007","0308","330","139","191","4","334","896","0","37.28","15.51"
"10","008","00","060","0007","0309","394","180","214","6","400","1011","0","39.56","17.80"
"10","008","00","060","0007","0310","381","160","221","5","386","1003","0","38.48","15.95"
"10","008","00","060","0007","0311","482","236","246","7","489","1259","0","38.84","18.75"
"10","008","00","060","0008","0000","590","271","319","12","602","1625","0","37.05","16.68"
"10","008","00","060","0008","0312","279","114","165","6","285","734","0","38.83","15.53"
"10","008","00","060","0008","0313","311","157","154","6","317","891","0","35.58","17.62"
"10","008","00","060","0009","0000","368","147","221","4","372","922","0","40.35","15.94"
"10","008","00","060","0009","0315","368","147","221","4","372","922","0","40.35","15.94"
"10","008","00","060","0010","0000","437","175","262","2","439","1233","0","35.60","14.19"
"10","008","00","060","0010","0316","437","175","262","2","439","1233","0","35.60","14.19"
"10","008","00","060","0011","0000","710","242","468","14","724","1828","0","39.61","13.24"
"10","008","00","060","0011","0318","355","114","241","8","363","949","0","38.25","12.01"
"10","008","00","060","0011","0319","355","128","227","6","361","879","0","41.07","14.56"
"10","008","00","060","0012","0000","309","110","199","1","310","900","0","34.44","12.22"
"10","008","00","060","0012","0320","309","110","199","1","310","900","0","34.44","12.22"
"10","008","00","060","0013","0000","249","94","155","2","251","729","0","34.43","12.89"
"10","008","00","060","0013","0317","249","94","155","2","251","729","0","34.43","12.89"
"10","008","00","060","0014","0000","339","129","210","9","348","911","0","38.20","14.16"
"10","008","00","060","0014","0323","339","129","210","9","348","911","0","38.20","14.16"
"10","008","00","060","0015","0000","452","180","272","8","460","1160","0","39.66","15.52"
"10","008","00","060","0015","0321","275","118","157","7","282","641","0","43.99","18.41"
"10","008","00","060","0015","0322","177","62","115","1","178","519","0","34.30","11.95"
"10","008","00","060","0016","0000","535","230","305","4","539","1538","0","35.05","14.95"
"10","008","00","060","0016","0324","374","175","199","2","376","1102","0","34.12","15.88"
"10","008","00","060","0016","0325","161","55","106","2","163","436","0","37.39","12.61"
"10","008","00","060","0017","0000","567","239","328","9","576","1468","0","39.24","16.28"
"10","008","00","060","0017","0326","344","143","201","7","351","868","0","40.44","16.47"
"10","008","00","060","0017","0327","223","96","127","2","225","600","0","37.50","16.00"
"10","008","00","060","0018","0000","418","172","246","8","426","1137","0","37.47","15.13"
"10","008","00","060","0018","0328","418","172","246","8","426","1137","0","37.47","15.13"
"10","008","00","060","0019","0000","324","150","174","4","328","845","0","38.82","17.75"
"10","008","00","060","0019","0330","324","150","174","4","328","845","0","38.82","17.75"
"10","008","00","060","0020","0000","315","197","118","6","321","874","0","36.73","22.54"
"10","008","00","060","0020","0329","315","197","118","6","321","874","0","36.73","22.54"
"10","008","00","060","0021","0000","297","158","139","6","303","739","0","41.00","21.38"
"10","008","00","060","0021","0331","297","158","139","6","303","739","0","41.00","21.38"
"10","008","00","060","0022","0000","610","280","330","8","618","1737","0","35.58","16.12"
"10","008","00","060","0022","0332","283","113","170","4","287","761","0","37.71","14.85"
"10","008","00","060","0022","0333","327","167","160","4","331","976","0","33.91","17.11"
"10","008","00","060","0023","0000","331","197","134","5","336","867","0","38.75","22.72"
"10","008","00","060","0023","0314","331","197","134","5","336","867","0","38.75","22.72"
"10","008","00","070","0000","0000","5313","2908","2405","72","5385","15417","16983","34.93","18.86"
"10","008","00","070","0001","0000","657","350","307","6","663","1813","0","36.57","19.31"
"10","008","00","070","0001","0334","333","204","129","3","336","910","0","36.92","22.42"
"10","008","00","070","0001","0335","324","146","178","3","327","903","0","36.21","16.17"
"10","008","00","070","0002","0000","491","274","217","7","498","1402","0","35.52","19.54"
"10","008","00","070","0002","0350","237","139","98","3","240","709","0","33.85","19.61"
"10","008","00","070","0002","0351","254","135","119","4","258","693","0","37.23","19.48"
"10","008","00","070","0003","0000","464","287","177","6","470","1294","0","36.32","22.18"
"10","008","00","070","0003","0336","318","206","112","4","322","854","0","37.70","24.12"
"10","008","00","070","0003","0337","146","81","65","2","148","440","0","33.64","18.41"
"10","008","00","070","0004","0000","687","395","292","7","694","1909","0","36.35","20.69"
"10","008","00","070","0004","0338","309","186","123","2","311","807","0","38.54","23.05"
"10","008","00","070","0004","0339","378","209","169","5","383","1102","0","34.75","18.97"
"10","008","00","070","0005","0000","329","184","145","7","336","997","0","33.70","18.46"
"10","008","00","070","0005","0344","167","92","75","5","172","559","0","30.77","16.46"
"10","008","00","070","0005","0345","162","92","70","2","164","438","0","37.44","21.00"
"10","008","00","070","0006","0000","463","252","211","7","470","1463","0","32.13","17.22"
"10","008","00","070","0006","0347","206","100","106","4","210","700","0","30.00","14.29"
"10","008","00","070","0006","0348","257","152","105","3","260","763","0","34.08","19.92"
"10","008","00","070","0007","0000","328","201","127","5","333","902","0","36.92","22.28"
"10","008","00","070","0007","0349","328","201","127","5","333","902","0","36.92","22.28"
"10","008","00","070","0008","0000","221","151","70","4","225","620","0","36.29","24.35"
"10","008","00","070","0008","0346","221","151","70","4","225","620","0","36.29","24.35"
"10","008","00","070","0009","0000","463","216","247","3","466","1309","0","35.60","16.50"
"10","008","00","070","0009","0342","288","146","142","1","289","769","0","37.58","18.99"
"10","008","00","070","0009","0343","175","70","105","2","177","540","0","32.78","12.96"
"10","008","00","070","0010","0000","544","304","240","8","552","1562","0","35.34","19.46"
"10","008","00","070","0010","0340","261","162","99","4","265","726","0","36.50","22.31"
"10","008","00","070","0010","0341","283","142","141","4","287","836","0","34.33","16.99"
"10","008","00","070","0011","0000","213","87","126","7","220","747","0","29.45","11.65"
"10","008","00","070","0011","0352","213","87","126","7","220","747","0","29.45","11.65"
"10","008","00","070","0012","0000","255","125","130","2","257","689","0","37.30","18.14"
"10","008","00","070","0012","0353","255","125","130","2","257","689","0","37.30","18.14"
"10","008","00","070","0013","0000","198","82","116","3","201","710","0","28.31","11.55"
"10","008","00","070","0013","0354","198","82","116","3","201","710","0","28.31","11.55"
"10","008","00","080","0000","0000","4270","2140","2130","68","4338","12820","14137","33.84","16.69"
"10","008","00","080","0001","0000","256","96","160","6","262","773","0","33.89","12.42"
"10","008","00","080","0001","0355","256","96","160","6","262","773","0","33.89","12.42"
"10","008","00","080","0002","0000","171","96","75","3","174","470","0","37.02","20.43"
"10","008","00","080","0002","0356","95","48","47","1","96","251","0","38.25","19.12"
"10","008","00","080","0002","0357","76","48","28","2","78","219","0","35.62","21.92"
"10","008","00","080","0003","0000","267","136","131","3","270","773","0","34.93","17.59"
"10","008","00","080","0003","0358","142","72","70","1","143","344","0","41.57","20.93"
"10","008","00","080","0003","0359","125","64","61","2","127","429","0","29.60","14.92"
"10","008","00","080","0004","0000","196","101","95","3","199","639","0","31.14","15.81"
"10","008","00","080","0004","0362","196","101","95","3","199","639","0","31.14","15.81"
"10","008","00","080","0005","0000","220","114","106","3","223","683","0","32.65","16.69"
"10","008","00","080","0005","0360","112","60","52","2","114","373","0","30.56","16.09"
"10","008","00","080","0005","0361","108","54","54","1","109","310","0","35.16","17.42"
"10","008","00","080","0006","0000","546","284","262","7","553","1678","0","32.96","16.92"
"10","008","00","080","0006","0364","294","152","142","6","300","948","0","31.65","16.03"
"10","008","00","080","0006","0365","252","132","120","1","253","730","0","34.66","18.08"
"10","008","00","080","0007","0000","103","55","48","1","104","287","0","36.24","19.16"
"10","008","00","080","0007","0363","103","55","48","1","104","287","0","36.24","19.16"
"10","008","00","080","0008","0000","214","131","83","5","219","624","0","35.10","20.99"
"10","008","00","080","0008","0366","214","131","83","5","219","624","0","35.10","20.99"
"10","008","00","080","0009","0000","151","56","95","2","153","491","0","31.16","11.41"
"10","008","00","080","0009","0367","151","56","95","2","153","491","0","31.16","11.41"
"10","008","00","080","0010","0000","420","248","172","5","425","1319","0","32.22","18.80"
"10","008","00","080","0010","0368","102","57","45","2","104","325","0","32.00","17.54"
"10","008","00","080","0010","0369","318","191","127","3","321","994","0","32.29","19.22"
"10","008","00","080","0011","0000","370","173","197","3","373","1049","0","35.56","16.49"
"10","008","00","080","0011","0370","157","66","91","0","157","442","0","35.52","14.93"
"10","008","00","080","0011","0371","213","107","106","3","216","607","0","35.58","17.63"
"10","008","00","080","0012","0000","240","115","125","10","250","847","0","29.52","13.58"
"10","008","00","080","0012","0372","240","115","125","10","250","847","0","29.52","13.58"
"10","008","00","080","0013","0000","236","85","151","4","240","666","0","36.04","12.76"
"10","008","00","080","0013","0374","236","85","151","4","240","666","0","36.04","12.76"
"10","008","00","080","0014","0000","221","113","108","2","223","637","0","35.01","17.74"
"10","008","00","080","0014","0376","221","113","108","2","223","637","0","35.01","17.74"
"10","008","00","080","0015","0000","170","96","74","3","173","499","0","34.67","19.24"
"10","008","00","080","0015","0378","170","96","74","3","173","499","0","34.67","19.24"
"10","008","00","080","0016","0000","164","78","86","1","165","454","0","36.34","17.18"
"10","008","00","080","0016","0373","164","78","86","1","165","454","0","36.34","17.18"
"10","008","00","080","0017","0000","150","74","76","5","155","454","0","34.14","16.30"
"10","008","00","080","0017","0377","150","74","76","5","155","454","0","34.14","16.30"
"10","008","00","080","0018","0000","175","89","86","2","177","477","0","37.11","18.66"
"10","008","00","080","0018","0375","175","89","86","2","177","477","0","37.11","18.66"
"10","008","00","090","0000","0000","4462","2313","2149","62","4524","13636","15251","33.18","16.96"
"10","008","00","090","0001","0000","546","292","254","4","550","1550","0","35.48","18.84"
"10","008","00","090","0001","0381","228","128","100","4","232","724","0","32.04","17.68"
"10","008","00","090","0001","0382","318","164","154","0","318","826","0","38.50","19.85"
"10","008","00","090","0002","0000","663","345","318","7","670","1908","0","35.12","18.08"
"10","008","00","090","0002","0379","291","152","139","3","294","893","0","32.92","17.02"
"10","008","00","090","0002","0380","372","193","179","4","376","1015","0","37.04","19.01"
"10","008","00","090","0003","0000","307","147","160","4","311","994","0","31.29","14.79"
"10","008","00","090","0003","0397","160","72","88","2","162","573","0","28.27","12.57"
"10","008","00","090","0003","0398","147","75","72","2","149","421","0","35.39","17.81"
"10","008","00","090","0004","0000","449","214","235","6","455","1333","0","34.13","16.05"
"10","008","00","090","0004","0390","257","127","130","2","259","784","0","33.04","16.20"
"10","008","00","090","0004","0391","94","36","58","1","95","282","0","33.69","12.77"
"10","008","00","090","0004","0392","98","51","47","3","101","267","0","37.83","19.10"
"10","008","00","090","0005","0000","339","144","195","10","349","1061","0","32.89","13.57"
"10","008","00","090","0005","0383","166","61","105","7","173","485","0","35.67","12.58"
"10","008","00","090","0005","0384","173","83","90","3","176","576","0","30.56","14.41"
"10","008","00","090","0006","0000","332","170","162","3","335","1242","0","26.97","13.69"
"10","008","00","090","0006","0385","144","73","71","2","146","603","0","24.21","12.11"
"10","008","00","090","0006","0386","188","97","91","1","189","639","0","29.58","15.18"
"10","008","00","090","0007","0000","154","63","91","1","155","501","0","30.94","12.57"
"10","008","00","090","0007","0387","98","30","68","1","99","299","0","33.11","10.03"
"10","008","00","090","0007","0389","56","33","23","0","56","202","0","27.72","16.34"
"10","008","00","090","0008","0000","205","100","105","2","207","625","0","33.12","16.00"
"10","008","00","090","0008","0393","87","39","48","2","89","268","0","33.21","14.55"
"10","008","00","090","0008","0394","118","61","57","0","118","357","0","33.05","17.09"
"10","008","00","090","0009","0000","232","129","103","3","235","718","0","32.73","17.97"
"10","008","00","090","0009","0395","153","89","64","3","156","546","0","28.57","16.30"
"10","008","00","090","0009","0396","79","40","39","0","79","172","0","45.93","23.26"
"10","008","00","090","0010","0000","300","200","100","2","302","823","0","36.70","24.30"
"10","008","00","090","0010","0399","300","200","100","2","302","823","0","36.70","24.30"
"10","008","00","090","0011","0000","253","125","128","8","261","917","0","28.46","13.63"
"10","008","00","090","0011","0401","105","57","48","3","108","396","0","27.27","14.39"
"10","008","00","090","0011","0402","148","68","80","5","153","521","0","29.37","13.05"
"10","008","00","090","0012","0000","186","115","71","5","191","574","0","33.28","20.03"
"10","008","00","090","0012","0403","105","65","40","3","108","335","0","32.24","19.40"
"10","008","00","090","0012","0404","81","50","31","2","83","239","0","34.73","20.92"
"10","008","00","090","0013","0000","307","171","136","4","311","849","0","36.63","20.14"
"10","008","00","090","0013","0400","307","171","136","4","311","849","0","36.63","20.14"
"10","008","00","090","0014","0000","189","98","91","3","192","541","0","35.49","18.11"
"10","008","00","090","0014","0388","189","98","91","3","192","541","0","35.49","18.11"
"10","008","00","100","0000","0000","4986","2818","2168","80","5066","15914","17685","31.83","17.71"
"10","008","00","100","0001","0000","547","282","265","15","562","1641","0","34.25","17.18"
"10","008","00","100","0001","0405","303","152","151","11","314","942","0","33.33","16.14"
"10","008","00","100","0001","0406","244","130","114","4","248","699","0","35.48","18.60"
"10","008","00","100","0002","0000","554","333","221","6","560","1676","0","33.41","19.87"
"10","008","00","100","0002","0407","256","150","106","4","260","777","0","33.46","19.31"
"10","008","00","100","0002","0408","298","183","115","2","300","899","0","33.37","20.36"
"10","008","00","100","0003","0000","183","95","88","3","186","641","0","29.02","14.82"
"10","008","00","100","0003","0409","183","95","88","3","186","641","0","29.02","14.82"
"10","008","00","100","0004","0000","527","260","267","5","532","1823","0","29.18","14.26"
"10","008","00","100","0004","0414","294","150","144","2","296","987","0","29.99","15.20"
"10","008","00","100","0004","0415","233","110","123","3","236","836","0","28.23","13.16"
"10","008","00","100","0005","0000","367","227","140","8","375","1346","0","27.86","16.86"
"10","008","00","100","0005","0410","180","106","74","3","183","645","0","28.37","16.43"
"10","008","00","100","0005","0411","187","121","66","5","192","701","0","27.39","17.26"
"10","008","00","100","0006","0000","218","124","94","0","218","688","0","31.69","18.02"
"10","008","00","100","0006","0413","218","124","94","0","218","688","0","31.69","18.02"
"10","008","00","100","0007","0000","608","340","268","7","615","1766","0","34.82","19.25"
"10","008","00","100","0007","0416","316","183","133","4","320","877","0","36.49","20.87"
"10","008","00","100","0007","0417","292","157","135","3","295","889","0","33.18","17.66"
"10","008","00","100","0008","0000","249","135","114","7","256","789","0","32.45","17.11"
"10","008","00","100","0008","0418","249","135","114","7","256","789","0","32.45","17.11"
"10","008","00","100","0009","0000","370","231","139","2","372","1117","0","33.30","20.68"
"10","008","00","100","0009","0419","370","231","139","2","372","1117","0","33.30","20.68"
"10","008","00","100","0010","0000","497","253","244","12","509","1459","0","34.89","17.34"
"10","008","00","100","0010","0421","347","184","163","10","357","1056","0","33.81","17.42"
"10","008","00","100","0010","0422","150","69","81","2","152","403","0","37.72","17.12"
"10","008","00","100","0011","0000","474","298","176","12","486","1547","0","31.42","19.26"
"10","008","00","100","0011","0423","317","203","114","9","326","1002","0","32.53","20.26"
"10","008","00","100","0011","0424","157","95","62","3","160","545","0","29.36","17.43"
"10","008","00","100","0012","0000","209","117","92","1","210","691","0","30.39","16.93"
"10","008","00","100","0012","0420","209","117","92","1","210","691","0","30.39","16.93"
"10","008","00","100","0013","0000","183","123","60","2","185","730","0","25.34","16.85"
"10","008","00","100","0013","0412","183","123","60","2","185","730","0","25.34","16.85"
"10","008","00","110","0000","0000","5065","2837","2228","64","5129","14915","16810","34.39","19.02"
"10","008","00","110","0001","0000","221","127","94","0","221","726","0","30.44","17.49"
"10","008","00","110","0001","0425","221","127","94","0","221","726","0","30.44","17.49"
"10","008","00","110","0002","0000","186","92","94","1","187","420","0","44.52","21.90"
"10","008","00","110","0002","0430","186","92","94","1","187","420","0","44.52","21.90"
"10","008","00","110","0003","0000","449","230","219","5","454","1475","0","30.78","15.59"
"10","008","00","110","0003","0426","175","81","94","2","177","518","0","34.17","15.64"
"10","008","00","110","0003","0427","274","149","125","3","277","957","0","28.94","15.57"
"10","008","00","110","0004","0000","233","145","88","3","236","596","0","39.60","24.33"
"10","008","00","110","0004","0428","233","145","88","3","236","596","0","39.60","24.33"
"10","008","00","110","0005","0000","342","208","134","3","345","839","0","41.12","24.79"
"10","008","00","110","0005","0429","342","208","134","3","345","839","0","41.12","24.79"
"10","008","00","110","0006","0000","366","205","161","4","370","1004","0","36.85","20.42"
"10","008","00","110","0006","0433","366","205","161","4","370","1004","0","36.85","20.42"
"10","008","00","110","0007","0000","364","202","162","3","367","922","0","39.80","21.91"
"10","008","00","110","0007","0436","364","202","162","3","367","922","0","39.80","21.91"
"10","008","00","110","0008","0000","433","234","199","9","442","1346","0","32.84","17.38"
"10","008","00","110","0008","0437","238","108","130","4","242","759","0","31.88","14.23"
"10","008","00","110","0008","0438","195","126","69","5","200","587","0","34.07","21.47"
"10","008","00","110","0009","0000","374","198","176","7","381","1172","0","32.51","16.89"
"10","008","00","110","0009","0440","374","198","176","7","381","1172","0","32.51","16.89"
"10","008","00","110","0010","0000","164","104","60","5","169","436","0","38.76","23.85"
"10","008","00","110","0010","0431","164","104","60","5","169","436","0","38.76","23.85"
"10","008","00","110","0011","0000","155","109","46","3","158","621","0","25.44","17.55"
"10","008","00","110","0011","0432","155","109","46","3","158","621","0","25.44","17.55"
"10","008","00","110","0012","0000","73","43","30","0","73","203","0","35.96","21.18"
"10","008","00","110","0012","0441","73","43","30","0","73","203","0","35.96","21.18"
"10","008","00","110","0013","0000","127","82","45","1","128","318","0","40.25","25.79"
"10","008","00","110","0013","0442","127","82","45","1","128","318","0","40.25","25.79"
"10","008","00","110","0014","0000","344","211","133","6","350","1065","0","32.86","19.81"
"10","008","00","110","0014","0443","344","211","133","6","350","1065","0","32.86","19.81"
"10","008","00","110","0015","0000","247","115","132","6","253","841","0","30.08","13.67"
"10","008","00","110","0015","0439","247","115","132","6","253","841","0","30.08","13.67"
"10","008","00","110","0016","0000","125","51","74","2","127","313","0","40.58","16.29"
"10","008","00","110","0016","0445","125","51","74","2","127","313","0","40.58","16.29"
"10","008","00","110","0017","0000","252","148","104","2","254","813","0","31.24","18.20"
"10","008","00","110","0017","0446","252","148","104","2","254","813","0","31.24","18.20"
"10","008","00","110","0018","0000","95","53","42","2","97","278","0","34.89","19.06"
"10","008","00","110","0018","0444","95","53","42","2","97","278","0","34.89","19.06"
"10","008","00","110","0019","0000","515","280","235","2","517","1527","0","33.86","18.34"
"10","008","00","110","0019","0434","242","135","107","1","243","725","0","33.52","18.62"
"10","008","00","110","0019","0435","273","145","128","1","274","802","0","34.16","18.08"
"10","008","00","120","0000","0000","3293","2216","1077","48","3341","13002","15798","25.70","17.04"
"10","008","00","120","0001","0000","224","175","49","8","232","1166","0","19.90","15.01"
"10","008","00","120","0001","0464","169","141","28","3","172","906","0","18.98","15.56"
"10","008","00","120","0001","0465","55","34","21","5","60","260","0","23.08","13.08"
"10","008","00","120","0002","0000","255","211","44","3","258","920","0","28.04","22.93"
"10","008","00","120","0002","0466","255","211","44","3","258","920","0","28.04","22.93"
"10","008","00","120","0003","0000","125","115","10","0","125","558","0","22.40","20.61"
"10","008","00","120","0003","0468","125","115","10","0","125","558","0","22.40","20.61"
"10","008","00","120","0004","0000","503","345","158","6","509","1469","0","34.65","23.49"
"10","008","00","120","0004","0447","189","138","51","4","193","548","0","35.22","25.18"
"10","008","00","120","0004","0448","212","136","76","0","212","607","0","34.93","22.41"
"10","008","00","120","0004","0449","102","71","31","2","104","314","0","33.12","22.61"
"10","008","00","120","0005","0000","140","86","54","0","140","481","0","29.11","17.88"
"10","008","00","120","0005","0450","140","86","54","0","140","481","0","29.11","17.88"
"10","008","00","120","0006","0000","209","102","107","5","214","713","0","30.01","14.31"
"10","008","00","120","0006","0451","113","61","52","4","117","408","0","28.68","14.95"
"10","008","00","120","0006","0452","96","41","55","1","97","305","0","31.80","13.44"
"10","008","00","120","0007","0000","339","252","87","3","342","1338","0","25.56","18.83"
"10","008","00","120","0007","0455","145","96","49","2","147","658","0","22.34","14.59"
"10","008","00","120","0007","0456","194","156","38","1","195","680","0","28.68","22.94"
"10","008","00","120","0008","0000","325","205","120","5","330","1516","0","21.77","13.52"
"10","008","00","120","0008","0457","222","146","76","4","226","981","0","23.04","14.88"
"10","008","00","120","0008","0458","103","59","44","1","104","535","0","19.44","11.03"
"10","008","00","120","0009","0000","410","221","189","7","417","1399","0","29.81","15.80"
"10","008","00","120","0009","0459","295","160","135","4","299","925","0","32.32","17.30"
"10","008","00","120","0009","0460","115","61","54","3","118","474","0","24.89","12.87"
"10","008","00","120","0010","0000","160","97","63","5","165","629","0","26.23","15.42"
"10","008","00","120","0010","0461","108","58","50","4","112","484","0","23.14","11.98"
"10","008","00","120","0010","0462","52","39","13","1","53","145","0","36.55","26.90"
"10","008","00","120","0011","0000","218","150","68","2","220","988","0","22.27","15.18"
"10","008","00","120","0011","0463","218","150","68","2","220","988","0","22.27","15.18"
"10","008","00","120","0012","0000","78","56","22","1","79","610","0","12.95","9.18"
"10","008","00","120","0012","0467","78","56","22","1","79","610","0","12.95","9.18"
"10","008","00","120","0013","0000","150","116","34","1","151","587","0","25.72","19.76"
"10","008","00","120","0013","0454","150","116","34","1","151","587","0","25.72","19.76"
"10","008","00","120","0014","0000","157","85","72","2","159","628","0","25.32","13.54"
"10","008","00","120","0014","0453","157","85","72","2","159","628","0","25.32","13.54"
"10","008","00","130","0000","0000","3144","2573","571","43","3187","12497","15736","25.50","20.59"
"10","008","00","130","0001","0000","167","126","41","4","171","801","0","21.35","15.73"
"10","008","00","130","0001","0488","167","126","41","4","171","801","0","21.35","15.73"
"10","008","00","130","0002","0000","212","184","28","4","216","907","0","23.81","20.29"
"10","008","00","130","0002","0489","212","184","28","4","216","907","0","23.81","20.29"
"10","008","00","130","0003","0000","351","310","41","7","358","1143","0","31.32","27.12"
"10","008","00","130","0003","0490","196","174","22","5","201","693","0","29.00","25.11"
"10","008","00","130","0003","0491","155","136","19","2","157","450","0","34.89","30.22"
"10","008","00","130","0004","0000","162","145","17","1","163","398","0","40.95","36.43"
"10","008","00","130","0004","0492","162","145","17","1","163","398","0","40.95","36.43"
"10","008","00","130","0005","0000","96","79","17","4","100","504","0","19.84","15.67"
"10","008","00","130","0005","0481","96","79","17","4","100","504","0","19.84","15.67"
"10","008","00","130","0006","0000","140","113","27","3","143","749","0","19.09","15.09"
"10","008","00","130","0006","0479","97","76","21","2","99","376","0","26.33","20.21"
"10","008","00","130","0006","0480","43","37","6","1","44","373","0","11.80","9.92"
"10","008","00","130","0008","0000","249","207","42","1","250","1118","0","22.36","18.52"
"10","008","00","130","0008","0484","142","121","21","0","142","595","0","23.87","20.34"
"10","008","00","130","0008","0485","56","45","11","1","57","387","0","14.73","11.63"
"10","008","00","130","0008","0486","51","41","10","0","51","136","0","37.50","30.15"
"10","008","00","130","0009","0000","543","414","129","5","548","1616","0","33.91","25.62"
"10","008","00","130","0009","0471","230","174","56","5","235","838","0","28.04","20.76"
"10","008","00","130","0009","0472","177","140","37","0","177","470","0","37.66","29.79"
"10","008","00","130","0009","0473","136","100","36","0","136","308","0","44.16","32.47"
"10","008","00","130","0010","0000","379","298","81","2","381","1223","0","31.15","24.37"
"10","008","00","130","0010","0469","270","229","41","1","271","856","0","31.66","26.75"
"10","008","00","130","0010","0470","109","69","40","1","110","367","0","29.97","18.80"
"10","008","00","130","0011","0000","240","198","42","3","243","955","0","25.45","20.73"
"10","008","00","130","0011","0475","240","198","42","3","243","955","0","25.45","20.73"
"10","008","00","130","0012","0000","163","134","29","4","167","647","0","25.81","20.71"
"10","008","00","130","0012","0476","163","134","29","4","167","647","0","25.81","20.71"
"10","008","00","130","0013","0000","110","90","20","1","111","633","0","17.54","14.22"
"10","008","00","130","0013","0487","110","90","20","1","111","633","0","17.54","14.22"
"10","008","00","130","0014","0000","22","22","0","0","22","55","0","40.00","40.00"
"10","008","00","130","0014","0474","22","22","0","0","22","55","0","40.00","40.00"
"10","008","00","130","0015","0000","106","77","29","2","108","507","0","21.30","15.19"
"10","008","00","130","0015","0482","61","52","9","1","62","331","0","18.73","15.71"
"10","008","00","130","0015","0483","45","25","20","1","46","176","0","26.14","14.20"
"10","008","00","130","0016","0000","111","99","12","2","113","627","0","18.02","15.79"
"10","008","00","130","0016","0477","111","99","12","2","113","627","0","18.02","15.79"
"10","008","00","130","0017","0000","93","77","16","0","93","614","0","15.15","12.54"
"10","008","00","130","0017","0478","93","77","16","0","93","614","0","15.15","12.54"
"10","009","00","000","0000","0000","200965","87535","113430","2644","203609","577564","673309","35.25","15.16"
"10","009","00","010","0000","0000","36317","18739","17578","370","36687","90244","108508","40.65","20.76"
"10","009","00","010","0001","0000","629","330","299","6","635","1390","0","45.68","23.74"
"10","009","00","010","0001","0470","629","330","299","6","635","1390","0","45.68","23.74"
"10","009","00","010","0002","0000","478","210","268","3","481","1065","0","45.16","19.72"
"10","009","00","010","0002","0471","478","210","268","3","481","1065","0","45.16","19.72"
"10","009","00","010","0003","0000","307","140","167","2","309","609","0","50.74","22.99"
"10","009","00","010","0003","0445","307","140","167","2","309","609","0","50.74","22.99"
"10","009","00","010","0004","0000","274","126","148","7","281","599","0","46.91","21.04"
"10","009","00","010","0004","0446","274","126","148","7","281","599","0","46.91","21.04"
"10","009","00","010","0005","0000","337","179","158","4","341","756","0","45.11","23.68"
"10","009","00","010","0005","0447","337","179","158","4","341","756","0","45.11","23.68"
"10","009","00","010","0006","0000","341","142","199","2","343","767","0","44.72","18.51"
"10","009","00","010","0006","0448","341","142","199","2","343","767","0","44.72","18.51"
"10","009","00","010","0007","0000","311","151","160","3","314","707","0","44.41","21.36"
"10","009","00","010","0007","0449","311","151","160","3","314","707","0","44.41","21.36"
"10","009","00","010","0008","0000","1988","1112","876","22","2010","4843","0","41.50","22.96"
"10","009","00","010","0008","0458","513","294","219","6","519","1194","0","43.47","24.62"
"10","009","00","010","0008","0459","569","319","250","10","579","1309","0","44.23","24.37"
"10","009","00","010","0008","0460","483","276","207","3","486","1284","0","37.85","21.50"
"10","009","00","010","0008","0461","423","223","200","3","426","1056","0","40.34","21.12"
"10","009","00","010","0009","0000","1242","645","597","24","1266","3154","0","40.14","20.45"
"10","009","00","010","0009","0472","374","215","159","14","388","855","0","45.38","25.15"
"10","009","00","010","0009","0473","468","234","234","5","473","1272","0","37.19","18.40"
"10","009","00","010","0009","0474","400","196","204","5","405","1027","0","39.44","19.08"
"10","009","00","010","0010","0000","1163","666","497","11","1174","2723","0","43.11","24.46"
"10","009","00","010","0010","0465","504","259","245","7","511","1183","0","43.20","21.89"
"10","009","00","010","0010","0466","374","222","152","1","375","895","0","41.90","24.80"
"10","009","00","010","0010","0467","285","185","100","3","288","645","0","44.65","28.68"
"10","009","00","010","0011","0000","772","402","370","7","779","1734","0","44.93","23.18"
"10","009","00","010","0011","0489","365","179","186","3","368","804","0","45.77","22.26"
"10","009","00","010","0011","0490","407","223","184","4","411","930","0","44.19","23.98"
"10","009","00","010","0012","0000","1507","838","669","9","1516","3444","0","44.02","24.33"
"10","009","00","010","0012","0484","505","276","229","3","508","1061","0","47.88","26.01"
"10","009","00","010","0012","0485","531","310","221","3","534","1249","0","42.75","24.82"
"10","009","00","010","0012","0486","471","252","219","3","474","1134","0","41.80","22.22"
"10","009","00","010","0013","0000","1575","838","737","9","1584","4187","0","37.83","20.01"
"10","009","00","010","0013","0479","590","301","289","3","593","1461","0","40.59","20.60"
"10","009","00","010","0013","0480","477","261","216","4","481","1314","0","36.61","19.86"
"10","009","00","010","0013","0481","508","276","232","2","510","1412","0","36.12","19.55"
"10","009","00","010","0014","0000","822","395","427","5","827","2303","0","35.91","17.15"
"10","009","00","010","0014","0477","444","231","213","4","448","1153","0","38.86","20.03"
"10","009","00","010","0014","0478","378","164","214","1","379","1150","0","32.96","14.26"
"10","009","00","010","0015","0000","302","178","124","4","306","657","0","46.58","27.09"
"10","009","00","010","0015","0494","302","178","124","4","306","657","0","46.58","27.09"
"10","009","00","010","0016","0000","810","398","412","3","813","2185","0","37.21","18.22"
"10","009","00","010","0016","0495","292","122","170","2","294","750","0","39.20","16.27"
"10","009","00","010","0016","0496","518","276","242","1","519","1435","0","36.17","19.23"
"10","009","00","010","0017","0000","209","91","118","4","213","538","0","39.59","16.91"
"10","009","00","010","0017","0497","209","91","118","4","213","538","0","39.59","16.91"
"10","009","00","010","0018","0000","986","600","386","7","993","2450","0","40.53","24.49"
"10","009","00","010","0018","0492","445","280","165","1","446","1135","0","39.30","24.67"
"10","009","00","010","0018","0493","541","320","221","6","547","1315","0","41.60","24.33"
"10","009","00","010","0019","0000","569","277","292","10","579","1451","0","39.90","19.09"
"10","009","00","010","0019","0491","569","277","292","10","579","1451","0","39.90","19.09"
"10","009","00","010","0020","0000","979","532","447","12","991","2391","0","41.45","22.25"
"10","009","00","010","0020","0498","565","303","262","7","572","1426","0","40.11","21.25"
"10","009","00","010","0020","0499","414","229","185","5","419","965","0","43.42","23.73"
"10","009","00","010","0021","0000","729","333","396","13","742","1873","0","39.62","17.78"
"10","009","00","010","0021","0508","521","224","297","7","528","1363","0","38.74","16.43"
"10","009","00","010","0021","0509","208","109","99","6","214","510","0","41.96","21.37"
"10","009","00","010","0022","0000","2272","1183","1089","15","2287","5409","0","42.28","21.87"
"10","009","00","010","0022","0504","571","323","248","5","576","1447","0","39.81","22.32"
"10","009","00","010","0022","0505","636","315","321","0","636","1399","0","45.46","22.52"
"10","009","00","010","0022","0506","528","278","250","2","530","1246","0","42.54","22.31"
"10","009","00","010","0022","0507","537","267","270","8","545","1317","0","41.38","20.27"
"10","009","00","010","0023","0000","1240","605","635","13","1253","3399","0","36.86","17.80"
"10","009","00","010","0023","0502","627","326","301","8","635","1734","0","36.62","18.80"
"10","009","00","010","0023","0503","613","279","334","5","618","1665","0","37.12","16.76"
"10","009","00","010","0024","0000","714","328","386","14","728","1849","0","39.37","17.74"
"10","009","00","010","0024","0517","271","118","153","4","275","698","0","39.40","16.91"
"10","009","00","010","0024","0518","443","210","233","10","453","1151","0","39.36","18.25"
"10","009","00","010","0025","0000","413","180","233","5","418","1112","0","37.59","16.19"
"10","009","00","010","0025","0519","413","180","233","5","418","1112","0","37.59","16.19"
"10","009","00","010","0026","0000","1682","804","878","22","1704","4461","0","38.20","18.02"
"10","009","00","010","0026","0510","460","224","236","8","468","1232","0","37.99","18.18"
"10","009","00","010","0026","0511","435","184","251","5","440","1110","0","39.64","16.58"
"10","009","00","010","0026","0512","429","210","219","8","437","1132","0","38.60","18.55"
"10","009","00","010","0026","0513","358","186","172","1","359","987","0","36.37","18.84"
"10","009","00","010","0027","0000","375","169","206","5","380","1076","0","35.32","15.71"
"10","009","00","010","0027","0514","375","169","206","5","380","1076","0","35.32","15.71"
"10","009","00","010","0028","0000","688","334","354","10","698","2144","0","32.56","15.58"
"10","009","00","010","0028","0515","324","163","161","4","328","910","0","36.04","17.91"
"10","009","00","010","0028","0516","364","171","193","6","370","1234","0","29.98","13.86"
"10","009","00","010","0029","0000","1183","583","600","14","1197","3219","0","37.19","18.11"
"10","009","00","010","0029","0523","417","198","219","6","423","1089","0","38.84","18.18"
"10","009","00","010","0029","0524","276","110","166","3","279","818","0","34.11","13.45"
"10","009","00","010","0029","0525","490","275","215","5","495","1312","0","37.73","20.96"
"10","009","00","010","0030","0000","1107","494","613","15","1122","3070","0","36.55","16.09"
"10","009","00","010","0030","0520","512","231","281","7","519","1317","0","39.41","17.54"
"10","009","00","010","0030","0521","352","165","187","4","356","1062","0","33.52","15.54"
"10","009","00","010","0030","0522","243","98","145","4","247","691","0","35.75","14.18"
"10","009","00","010","0031","0000","423","141","282","8","431","1106","0","38.97","12.75"
"10","009","00","010","0031","0526","423","141","282","8","431","1106","0","38.97","12.75"
"10","009","00","010","0032","0000","1029","598","431","3","1032","2279","0","45.28","26.24"
"10","009","00","010","0032","0454","567","314","253","2","569","1217","0","46.75","25.80"
"10","009","00","010","0032","0455","462","284","178","1","463","1062","0","43.60","26.74"
"10","009","00","010","0033","0000","1437","745","692","9","1446","3722","0","38.85","20.02"
"10","009","00","010","0033","0450","470","280","190","2","472","1132","0","41.70","24.73"
"10","009","00","010","0033","0451","310","151","159","5","315","766","0","41.12","19.71"
"10","009","00","010","0033","0452","375","195","180","1","376","846","0","44.44","23.05"
"10","009","00","010","0033","0453","282","119","163","1","283","978","0","28.94","12.17"
"10","009","00","010","0034","0000","1153","642","511","19","1172","2734","0","42.87","23.48"
"10","009","00","010","0034","0475","572","334","238","9","581","1359","0","42.75","24.58"
"10","009","00","010","0034","0476","581","308","273","10","591","1375","0","42.98","22.40"
"10","009","00","010","0035","0000","960","525","435","10","970","2247","0","43.17","23.36"
"10","009","00","010","0035","0487","361","185","176","4","365","840","0","43.45","22.02"
"10","009","00","010","0035","0488","599","340","259","6","605","1407","0","43.00","24.16"
"10","009","00","010","0036","0000","860","478","382","7","867","2111","0","41.07","22.64"
"10","009","00","010","0036","0468","395","204","191","3","398","974","0","40.86","20.94"
"10","009","00","010","0036","0469","465","274","191","4","469","1137","0","41.25","24.10"
"10","009","00","010","0037","0000","1481","757","724","16","1497","3620","0","41.35","20.91"
"10","009","00","010","0037","0462","564","292","272","9","573","1302","0","44.01","22.43"
"10","009","00","010","0037","0463","433","236","197","4","437","1094","0","39.95","21.57"
"10","009","00","010","0037","0464","484","229","255","3","487","1224","0","39.79","18.71"
"10","009","00","010","0038","0000","1185","612","573","6","1191","2596","0","45.88","23.57"
"10","009","00","010","0038","0482","554","301","253","2","556","1189","0","46.76","25.32"
"10","009","00","010","0038","0483","631","311","320","4","635","1407","0","45.13","22.10"
"10","009","00","010","0039","0000","965","542","423","5","970","2294","0","42.28","23.63"
"10","009","00","010","0039","0456","475","246","229","2","477","1140","0","41.84","21.58"
"10","009","00","010","0039","0457","490","296","194","3","493","1154","0","42.72","25.65"
"10","009","00","010","0040","0000","820","436","384","7","827","1970","0","41.98","22.13"
"10","009","00","010","0040","0500","451","233","218","3","454","1040","0","43.65","22.40"
"10","009","00","010","0040","0501","369","203","166","4","373","930","0","40.11","21.83"
"10","009","00","020","0000","0000","14535","6652","7883","167","14702","37622","43841","39.08","17.68"
"10","009","00","020","0001","0000","504","235","269","9","513","1125","0","45.60","20.89"
"10","009","00","020","0001","0547","504","235","269","9","513","1125","0","45.60","20.89"
"10","009","00","020","0002","0000","890","456","434","3","893","2068","0","43.18","22.05"
"10","009","00","020","0002","0548","505","277","228","1","506","1100","0","46.00","25.18"
"10","009","00","020","0002","0549","385","179","206","2","387","968","0","39.98","18.49"
"10","009","00","020","0003","0000","817","361","456","9","826","2193","0","37.67","16.46"
"10","009","00","020","0003","0553","402","180","222","6","408","1177","0","34.66","15.29"
"10","009","00","020","0003","0554","415","181","234","3","418","1016","0","41.14","17.81"
"10","009","00","020","0004","0000","612","328","284","6","618","1430","0","43.22","22.94"
"10","009","00","020","0004","0555","612","328","284","6","618","1430","0","43.22","22.94"
"10","009","00","020","0005","0000","499","214","285","2","501","1217","0","41.17","17.58"
"10","009","00","020","0005","0556","499","214","285","2","501","1217","0","41.17","17.58"
"10","009","00","020","0006","0000","1015","460","555","6","1021","2651","0","38.51","17.35"
"10","009","00","020","0006","0565","529","249","280","3","532","1310","0","40.61","19.01"
"10","009","00","020","0006","0566","486","211","275","3","489","1341","0","36.47","15.73"
"10","009","00","020","0007","0000","504","212","292","5","509","1321","0","38.53","16.05"
"10","009","00","020","0007","0557","504","212","292","5","509","1321","0","38.53","16.05"
"10","009","00","020","0008","0000","318","132","186","3","321","738","0","43.50","17.89"
"10","009","00","020","0008","0558","318","132","186","3","321","738","0","43.50","17.89"
"10","009","00","020","0009","0000","284","139","145","2","286","860","0","33.26","16.16"
"10","009","00","020","0009","0560","284","139","145","2","286","860","0","33.26","16.16"
"10","009","00","020","0010","0000","259","111","148","7","266","705","0","37.73","15.74"
"10","009","00","020","0010","0561","259","111","148","7","266","705","0","37.73","15.74"
"10","009","00","020","0011","0000","386","169","217","7","393","1113","0","35.31","15.18"
"10","009","00","020","0011","0562","386","169","217","7","393","1113","0","35.31","15.18"
"10","009","00","020","0012","0000","623","257","366","7","630","1683","0","37.43","15.27"
"10","009","00","020","0012","0563","339","133","206","3","342","833","0","41.06","15.97"
"10","009","00","020","0012","0564","284","124","160","4","288","850","0","33.88","14.59"
"10","009","00","020","0013","0000","382","162","220","7","389","970","0","40.10","16.70"
"10","009","00","020","0013","0577","382","162","220","7","389","970","0","40.10","16.70"
"10","009","00","020","0014","0000","1048","415","633","16","1064","2768","0","38.44","14.99"
"10","009","00","020","0014","0578","531","196","335","10","541","1355","0","39.93","14.46"
"10","009","00","020","0014","0579","517","219","298","6","523","1413","0","37.01","15.50"
"10","009","00","020","0015","0000","797","355","442","6","803","2175","0","36.92","16.32"
"10","009","00","020","0015","0580","462","199","263","4","466","1212","0","38.45","16.42"
"10","009","00","020","0015","0581","335","156","179","2","337","963","0","34.99","16.20"
"10","009","00","020","0016","0000","1286","631","655","15","1301","3315","0","39.25","19.03"
"10","009","00","020","0016","0567","443","236","207","2","445","1065","0","41.78","22.16"
"10","009","00","020","0016","0568","425","220","205","5","430","1142","0","37.65","19.26"
"10","009","00","020","0016","0569","418","175","243","8","426","1108","0","38.45","15.79"
"10","009","00","020","0017","0000","320","145","175","5","325","854","0","38.06","16.98"
"10","009","00","020","0017","0572","320","145","175","5","325","854","0","38.06","16.98"
"10","009","00","020","0018","0000","306","162","144","4","310","792","0","39.14","20.45"
"10","009","00","020","0018","0573","306","162","144","4","310","792","0","39.14","20.45"
"10","009","00","020","0019","0000","308","165","143","4","312","823","0","37.91","20.05"
"10","009","00","020","0019","0574","308","165","143","4","312","823","0","37.91","20.05"
"10","009","00","020","0020","0000","521","225","296","9","530","1470","0","36.05","15.31"
"10","009","00","020","0020","0575","290","127","163","4","294","827","0","35.55","15.36"
"10","009","00","020","0020","0576","231","98","133","5","236","643","0","36.70","15.24"
"10","009","00","020","0021","0000","560","181","379","9","569","1433","0","39.71","12.63"
"10","009","00","020","0021","0582","560","181","379","9","569","1433","0","39.71","12.63"
"10","009","00","020","0022","0000","329","137","192","8","337","851","0","39.60","16.10"
"10","009","00","020","0022","0559","329","137","192","8","337","851","0","39.60","16.10"
"10","009","00","020","0023","0000","1134","592","542","11","1145","2831","0","40.45","20.91"
"10","009","00","020","0023","0550","357","208","149","6","363","933","0","38.91","22.29"
"10","009","00","020","0023","0551","369","170","199","2","371","963","0","38.53","17.65"
"10","009","00","020","0023","0552","408","214","194","3","411","935","0","43.96","22.89"
"10","009","00","020","0024","0000","833","408","425","7","840","2236","0","37.57","18.25"
"10","009","00","020","0024","0570","333","146","187","0","333","918","0","36.27","15.90"
"10","009","00","020","0024","0571","500","262","238","7","507","1318","0","38.47","19.88"
"10","009","00","030","0000","0000","21333","10497","10836","219","21552","58416","70772","36.89","17.97"
"10","009","00","030","0001","0000","364","180","184","4","368","914","0","40.26","19.69"
"10","009","00","030","0001","0129","364","180","184","4","368","914","0","40.26","19.69"
"10","009","00","030","0002","0000","645","324","321","5","650","1655","0","39.27","19.58"
"10","009","00","030","0002","0123","342","170","172","3","345","756","0","45.63","22.49"
"10","009","00","030","0002","0124","303","154","149","2","305","899","0","33.93","17.13"
"10","009","00","030","0003","0000","1019","546","473","9","1028","2525","0","40.71","21.62"
"10","009","00","030","0003","0121","520","287","233","6","526","1301","0","40.43","22.06"
"10","009","00","030","0003","0122","499","259","240","3","502","1224","0","41.01","21.16"
"10","009","00","030","0004","0000","1182","623","559","9","1191","2771","0","42.98","22.48"
"10","009","00","030","0004","0125","610","305","305","5","615","1400","0","43.93","21.79"
"10","009","00","030","0004","0126","572","318","254","4","576","1371","0","42.01","23.19"
"10","009","00","030","0005","0000","940","534","406","10","950","2473","0","38.41","21.59"
"10","009","00","030","0005","0127","453","246","207","4","457","1209","0","37.80","20.35"
"10","009","00","030","0005","0128","487","288","199","6","493","1264","0","39.00","22.78"
"10","009","00","030","0006","0000","1189","651","538","11","1200","3168","0","37.88","20.55"
"10","009","00","030","0006","0130","411","236","175","3","414","1002","0","41.32","23.55"
"10","009","00","030","0006","0131","402","229","173","4","406","1051","0","38.63","21.79"
"10","009","00","030","0006","0132","376","186","190","4","380","1115","0","34.08","16.68"
"10","009","00","030","0007","0000","610","336","274","7","617","1361","0","45.33","24.69"
"10","009","00","030","0007","0136","610","336","274","7","617","1361","0","45.33","24.69"
"10","009","00","030","0008","0000","1622","873","749","10","1632","4499","0","36.27","19.40"
"10","009","00","030","0008","0137","459","246","213","4","463","1396","0","33.17","17.62"
"10","009","00","030","0008","0138","498","261","237","3","501","1487","0","33.69","17.55"
"10","009","00","030","0008","0139","665","366","299","3","668","1616","0","41.34","22.65"
"10","009","00","030","0009","0000","867","444","423","12","879","2323","0","37.84","19.11"
"10","009","00","030","0009","0140","527","281","246","4","531","1305","0","40.69","21.53"
"10","009","00","030","0009","0141","340","163","177","8","348","1018","0","34.18","16.01"
"10","009","00","030","0010","0000","1443","693","750","15","1458","3807","0","38.30","18.20"
"10","009","00","030","0010","0142","498","225","273","6","504","1319","0","38.21","17.06"
"10","009","00","030","0010","0143","482","252","230","5","487","1333","0","36.53","18.90"
"10","009","00","030","0010","0144","463","216","247","4","467","1155","0","40.43","18.70"
"10","009","00","030","0011","0000","775","387","388","6","781","2017","0","38.72","19.19"
"10","009","00","030","0011","0145","407","201","206","3","410","1112","0","36.87","18.08"
"10","009","00","030","0011","0146","368","186","182","3","371","905","0","40.99","20.55"
"10","009","00","030","0012","0000","418","210","208","4","422","1123","0","37.58","18.70"
"10","009","00","030","0012","0147","418","210","208","4","422","1123","0","37.58","18.70"
"10","009","00","030","0013","0000","473","254","219","9","482","1313","0","36.71","19.35"
"10","009","00","030","0013","0170","473","254","219","9","482","1313","0","36.71","19.35"
"10","009","00","030","0014","0000","300","154","146","3","303","828","0","36.59","18.60"
"10","009","00","030","0014","0169","300","154","146","3","303","828","0","36.59","18.60"
"10","009","00","030","0015","0000","579","242","337","9","588","1952","0","30.12","12.40"
"10","009","00","030","0015","0168","579","242","337","9","588","1952","0","30.12","12.40"
"10","009","00","030","0016","0000","505","208","297","3","508","1478","0","34.37","14.07"
"10","009","00","030","0016","0166","505","208","297","3","508","1478","0","34.37","14.07"
"10","009","00","030","0017","0000","262","75","187","1","263","872","0","30.16","8.60"
"10","009","00","030","0017","0167","262","75","187","1","263","872","0","30.16","8.60"
"10","009","00","030","0018","0000","931","380","551","7","938","2607","0","35.98","14.58"
"10","009","00","030","0018","0149","503","234","269","4","507","1365","0","37.14","17.14"
"10","009","00","030","0018","0150","428","146","282","3","431","1242","0","34.70","11.76"
"10","009","00","030","0019","0000","296","165","131","5","301","844","0","35.66","19.55"
"10","009","00","030","0019","0151","296","165","131","5","301","844","0","35.66","19.55"
"10","009","00","030","0020","0000","574","256","318","17","591","1767","0","33.45","14.49"
"10","009","00","030","0020","0152","278","119","159","7","285","870","0","32.76","13.68"
"10","009","00","030","0020","0153","296","137","159","10","306","897","0","34.11","15.27"
"10","009","00","030","0021","0000","586","281","305","8","594","1633","0","36.37","17.21"
"10","009","00","030","0021","0154","306","160","146","6","312","848","0","36.79","18.87"
"10","009","00","030","0021","0155","280","121","159","2","282","785","0","35.92","15.41"
"10","009","00","030","0022","0000","1199","491","708","6","1205","3437","0","35.06","14.29"
"10","009","00","030","0022","0156","423","179","244","2","425","1271","0","33.44","14.08"
"10","009","00","030","0022","0157","343","115","228","3","346","958","0","36.12","12.00"
"10","009","00","030","0022","0158","433","197","236","1","434","1208","0","35.93","16.31"
"10","009","00","030","0023","0000","758","325","433","15","773","2304","0","33.55","14.11"
"10","009","00","030","0023","0159","381","178","203","9","390","1247","0","31.28","14.27"
"10","009","00","030","0023","0160","377","147","230","6","383","1057","0","36.23","13.91"
"10","009","00","030","0024","0000","826","330","496","11","837","2528","0","33.11","13.05"
"10","009","00","030","0024","0161","406","165","241","6","412","1281","0","32.16","12.88"
"10","009","00","030","0024","0162","420","165","255","5","425","1247","0","34.08","13.23"
"10","009","00","030","0025","0000","486","215","271","2","488","1339","0","36.45","16.06"
"10","009","00","030","0025","0163","486","215","271","2","488","1339","0","36.45","16.06"
"10","009","00","030","0026","0000","547","256","291","7","554","1501","0","36.91","17.06"
"10","009","00","030","0026","0164","547","256","291","7","554","1501","0","36.91","17.06"
"10","009","00","030","0027","0000","165","99","66","4","169","515","0","32.82","19.22"
"10","009","00","030","0027","0148","165","99","66","4","169","515","0","32.82","19.22"
"10","009","00","030","0028","0000","1395","793","602","5","1400","3651","0","38.35","21.72"
"10","009","00","030","0028","0133","448","269","179","2","450","1145","0","39.30","23.49"
"10","009","00","030","0028","0134","484","251","233","2","486","1254","0","38.76","20.02"
"10","009","00","030","0028","0135","463","273","190","1","464","1252","0","37.06","21.81"
"10","009","00","030","0029","0000","377","172","205","5","382","1211","0","31.54","14.20"
"10","009","00","030","0029","0165","377","172","205","5","382","1211","0","31.54","14.20"
"10","009","00","040","0000","0000","13609","4961","8648","171","13780","37855","45246","36.40","13.11"
"10","009","00","040","0001","0000","533","173","360","5","538","1509","0","35.65","11.46"
"10","009","00","040","0001","0364","267","72","195","2","269","760","0","35.39","9.47"
"10","009","00","040","0001","0365","266","101","165","3","269","749","0","35.91","13.48"
"10","009","00","040","0002","0000","654","276","378","8","662","1720","0","38.49","16.05"
"10","009","00","040","0002","0366","325","140","185","4","329","823","0","39.98","17.01"
"10","009","00","040","0002","0367","329","136","193","4","333","897","0","37.12","15.16"
"10","009","00","040","0003","0000","752","361","391","6","758","2061","0","36.78","17.52"
"10","009","00","040","0003","0368","382","182","200","3","385","1041","0","36.98","17.48"
"10","009","00","040","0003","0369","370","179","191","3","373","1020","0","36.57","17.55"
"10","009","00","040","0004","0000","1108","507","601","9","1117","2893","0","38.61","17.53"
"10","009","00","040","0004","0370","376","175","201","2","378","967","0","39.09","18.10"
"10","009","00","040","0004","0371","345","131","214","0","345","844","0","40.88","15.52"
"10","009","00","040","0004","0372","387","201","186","7","394","1082","0","36.41","18.58"
"10","009","00","040","0005","0000","151","59","92","0","151","325","0","46.46","18.15"
"10","009","00","040","0005","0373","151","59","92","0","151","325","0","46.46","18.15"
"10","009","00","040","0006","0000","233","91","142","3","236","549","0","42.99","16.58"
"10","009","00","040","0006","0374","233","91","142","3","236","549","0","42.99","16.58"
"10","009","00","040","0007","0000","225","92","133","1","226","568","0","39.79","16.20"
"10","009","00","040","0007","0375","225","92","133","1","226","568","0","39.79","16.20"
"10","009","00","040","0008","0000","372","162","210","7","379","1004","0","37.75","16.14"
"10","009","00","040","0008","0376","372","162","210","7","379","1004","0","37.75","16.14"
"10","009","00","040","0009","0000","1068","444","624","6","1074","2870","0","37.42","15.47"
"10","009","00","040","0009","0377","579","250","329","5","584","1447","0","40.36","17.28"
"10","009","00","040","0009","0378","489","194","295","1","490","1423","0","34.43","13.63"
"10","009","00","040","0010","0000","1591","599","992","18","1609","4547","0","35.39","13.17"
"10","009","00","040","0010","0379","409","159","250","2","411","1080","0","38.06","14.72"
"10","009","00","040","0010","0380","346","137","209","2","348","1110","0","31.35","12.34"
"10","009","00","040","0010","0381","413","146","267","10","423","1098","0","38.52","13.30"
"10","009","00","040","0010","0382","423","157","266","4","427","1259","0","33.92","12.47"
"10","009","00","040","0011","0000","454","106","348","9","463","1277","0","36.26","8.30"
"10","009","00","040","0011","0383","454","106","348","9","463","1277","0","36.26","8.30"
"10","009","00","040","0012","0000","524","135","389","9","533","1475","0","36.14","9.15"
"10","009","00","040","0012","0384","524","135","389","9","533","1475","0","36.14","9.15"
"10","009","00","040","0013","0000","369","153","216","11","380","972","0","39.09","15.74"
"10","009","00","040","0013","0397","369","153","216","11","380","972","0","39.09","15.74"
"10","009","00","040","0014","0000","342","124","218","6","348","1105","0","31.49","11.22"
"10","009","00","040","0014","0398","342","124","218","6","348","1105","0","31.49","11.22"
"10","009","00","040","0015","0000","549","172","377","8","557","1776","0","31.36","9.68"
"10","009","00","040","0015","0399","272","86","186","3","275","909","0","30.25","9.46"
"10","009","00","040","0015","0400","277","86","191","5","282","867","0","32.53","9.92"
"10","009","00","040","0016","0000","502","137","365","12","514","1499","0","34.29","9.14"
"10","009","00","040","0016","0401","502","137","365","12","514","1499","0","34.29","9.14"
"10","009","00","040","0017","0000","564","182","382","4","568","1573","0","36.11","11.57"
"10","009","00","040","0017","0385","269","86","183","1","270","807","0","33.46","10.66"
"10","009","00","040","0017","0386","295","96","199","3","298","766","0","38.90","12.53"
"10","009","00","040","0018","0000","319","88","231","8","327","872","0","37.50","10.09"
"10","009","00","040","0018","0387","319","88","231","8","327","872","0","37.50","10.09"
"10","009","00","040","0019","0000","390","96","294","3","393","935","0","42.03","10.27"
"10","009","00","040","0019","0388","390","96","294","3","393","935","0","42.03","10.27"
"10","009","00","040","0020","0000","328","152","176","3","331","854","0","38.76","17.80"
"10","009","00","040","0020","0390","328","152","176","3","331","854","0","38.76","17.80"
"10","009","00","040","0021","0000","529","154","375","3","532","1477","0","36.02","10.43"
"10","009","00","040","0021","0389","529","154","375","3","532","1477","0","36.02","10.43"
"10","009","00","040","0022","0000","382","119","263","7","389","963","0","40.39","12.36"
"10","009","00","040","0022","0391","382","119","263","7","389","963","0","40.39","12.36"
"10","009","00","040","0023","0000","242","140","102","4","246","809","0","30.41","17.31"
"10","009","00","040","0023","0394","242","140","102","4","246","809","0","30.41","17.31"
"10","009","00","040","0024","0000","278","87","191","2","280","727","0","38.51","11.97"
"10","009","00","040","0024","0393","278","87","191","2","280","727","0","38.51","11.97"
"10","009","00","040","0025","0000","385","123","262","3","388","1287","0","30.15","9.56"
"10","009","00","040","0025","0392","385","123","262","3","388","1287","0","30.15","9.56"
"10","009","00","040","0026","0000","309","98","211","6","315","862","0","36.54","11.37"
"10","009","00","040","0026","0395","309","98","211","6","315","862","0","36.54","11.37"
"10","009","00","040","0027","0000","456","131","325","10","466","1346","0","34.62","9.73"
"10","009","00","040","0027","0396","456","131","325","10","466","1346","0","34.62","9.73"
"10","009","00","050","0000","0000","8214","3483","4731","109","8323","24096","28137","34.54","14.45"
"10","009","00","050","0001","0000","316","139","177","4","320","765","0","41.83","18.17"
"10","009","00","050","0001","0091","316","139","177","4","320","765","0","41.83","18.17"
"10","009","00","050","0002","0000","330","136","194","1","331","868","0","38.13","15.67"
"10","009","00","050","0002","0092","330","136","194","1","331","868","0","38.13","15.67"
"10","009","00","050","0003","0000","567","264","303","6","573","1345","0","42.60","19.63"
"10","009","00","050","0003","0093","263","105","158","3","266","649","0","40.99","16.18"
"10","009","00","050","0003","0094","304","159","145","3","307","696","0","44.11","22.84"
"10","009","00","050","0004","0000","449","229","220","2","451","1052","0","42.87","21.77"
"10","009","00","050","0004","0095","449","229","220","2","451","1052","0","42.87","21.77"
"10","009","00","050","0005","0000","337","142","195","7","344","1083","0","31.76","13.11"
"10","009","00","050","0005","0096","197","70","127","5","202","664","0","30.42","10.54"
"10","009","00","050","0005","0097","140","72","68","2","142","419","0","33.89","17.18"
"10","009","00","050","0006","0000","498","207","291","4","502","1401","0","35.83","14.78"
"10","009","00","050","0006","0101","214","84","130","2","216","629","0","34.34","13.35"
"10","009","00","050","0006","0102","284","123","161","2","286","772","0","37.05","15.93"
"10","009","00","050","0007","0000","401","170","231","9","410","1267","0","32.36","13.42"
"10","009","00","050","0007","0103","213","70","143","6","219","716","0","30.59","9.78"
"10","009","00","050","0007","0104","188","100","88","3","191","551","0","34.66","18.15"
"10","009","00","050","0008","0000","418","178","240","7","425","1221","0","34.81","14.58"
"10","009","00","050","0008","0105","245","86","159","6","251","707","0","35.50","12.16"
"10","009","00","050","0008","0106","173","92","81","1","174","514","0","33.85","17.90"
"10","009","00","050","0009","0000","311","126","185","4","315","854","0","36.89","14.75"
"10","009","00","050","0009","0111","311","126","185","4","315","854","0","36.89","14.75"
"10","009","00","050","0010","0000","909","427","482","11","920","2844","0","32.35","15.01"
"10","009","00","050","0010","0098","270","123","147","7","277","901","0","30.74","13.65"
"10","009","00","050","0010","0099","322","166","156","2","324","988","0","32.79","16.80"
"10","009","00","050","0010","0100","317","138","179","2","319","955","0","33.40","14.45"
"10","009","00","050","0011","0000","636","208","428","10","646","1845","0","35.01","11.27"
"10","009","00","050","0011","0112","294","96","198","6","300","886","0","33.86","10.84"
"10","009","00","050","0011","0113","342","112","230","4","346","959","0","36.08","11.68"
"10","009","00","050","0012","0000","615","290","325","6","621","1750","0","35.49","16.57"
"10","009","00","050","0012","0114","345","148","197","2","347","884","0","39.25","16.74"
"10","009","00","050","0012","0115","270","142","128","4","274","866","0","31.64","16.40"
"10","009","00","050","0013","0000","281","98","183","6","287","830","0","34.58","11.81"
"10","009","00","050","0013","0118","281","98","183","6","287","830","0","34.58","11.81"
"10","009","00","050","0014","0000","573","225","348","9","582","1773","0","32.83","12.69"
"10","009","00","050","0014","0116","302","123","179","6","308","890","0","34.61","13.82"
"10","009","00","050","0014","0117","271","102","169","3","274","883","0","31.03","11.55"
"10","009","00","050","0015","0000","682","283","399","7","689","2272","0","30.33","12.46"
"10","009","00","050","0015","0107","350","154","196","2","352","1177","0","29.91","13.08"
"10","009","00","050","0015","0108","332","129","203","5","337","1095","0","30.78","11.78"
"10","009","00","050","0016","0000","437","182","255","9","446","1501","0","29.71","12.13"
"10","009","00","050","0016","0109","255","102","153","6","261","811","0","32.18","12.58"
"10","009","00","050","0016","0110","182","80","102","3","185","690","0","26.81","11.59"
"10","009","00","050","0017","0000","454","179","275","7","461","1425","0","32.35","12.56"
"10","009","00","050","0017","0119","248","93","155","3","251","751","0","33.42","12.38"
"10","009","00","050","0017","0120","206","86","120","4","210","674","0","31.16","12.76"
"10","009","00","060","0000","0000","12532","4807","7725","147","12679","33096","38748","38.31","14.52"
"10","009","00","060","0001","0000","308","106","202","5","313","692","0","45.23","15.32"
"10","009","00","060","0001","0274","308","106","202","5","313","692","0","45.23","15.32"
"10","009","00","060","0002","0000","276","88","188","2","278","655","0","42.44","13.44"
"10","009","00","060","0002","0275","276","88","188","2","278","655","0","42.44","13.44"
"10","009","00","060","0003","0000","181","76","105","1","182","437","0","41.65","17.39"
"10","009","00","060","0003","0276","181","76","105","1","182","437","0","41.65","17.39"
"10","009","00","060","0004","0000","372","133","239","7","379","831","0","45.61","16.00"
"10","009","00","060","0004","0277","372","133","239","7","379","831","0","45.61","16.00"
"10","009","00","060","0005","0000","148","52","96","1","149","329","0","45.29","15.81"
"10","009","00","060","0005","0278","148","52","96","1","149","329","0","45.29","15.81"
"10","009","00","060","0006","0000","157","77","80","0","157","385","0","40.78","20.00"
"10","009","00","060","0006","0279","157","77","80","0","157","385","0","40.78","20.00"
"10","009","00","060","0007","0000","152","45","107","2","154","355","0","43.38","12.68"
"10","009","00","060","0007","0280","152","45","107","2","154","355","0","43.38","12.68"
"10","009","00","060","0008","0000","366","147","219","4","370","907","0","40.79","16.21"
"10","009","00","060","0008","0281","366","147","219","4","370","907","0","40.79","16.21"
"10","009","00","060","0009","0000","200","75","125","2","202","469","0","43.07","15.99"
"10","009","00","060","0009","0282","200","75","125","2","202","469","0","43.07","15.99"
"10","009","00","060","0010","0000","143","53","90","1","144","312","0","46.15","16.99"
"10","009","00","060","0010","0283","143","53","90","1","144","312","0","46.15","16.99"
"10","009","00","060","0011","0000","205","79","126","1","206","525","0","39.24","15.05"
"10","009","00","060","0011","0284","205","79","126","1","206","525","0","39.24","15.05"
"10","009","00","060","0012","0000","437","168","269","3","440","1132","0","38.87","14.84"
"10","009","00","060","0012","0285","188","77","111","2","190","415","0","45.78","18.55"
"10","009","00","060","0012","0286","249","91","158","1","250","717","0","34.87","12.69"
"10","009","00","060","0013","0000","203","90","113","4","207","425","0","48.71","21.18"
"10","009","00","060","0013","0287","203","90","113","4","207","425","0","48.71","21.18"
"10","009","00","060","0014","0000","1910","776","1134","23","1933","4762","0","40.59","16.30"
"10","009","00","060","0014","0288","451","191","260","6","457","1131","0","40.41","16.89"
"10","009","00","060","0014","0289","489","196","293","2","491","1181","0","41.57","16.60"
"10","009","00","060","0014","0290","407","156","251","7","414","1161","0","35.66","13.44"
"10","009","00","060","0014","0291","563","233","330","8","571","1289","0","44.30","18.08"
"10","009","00","060","0015","0000","633","311","322","2","635","1679","0","37.82","18.52"
"10","009","00","060","0015","0292","280","137","143","2","282","708","0","39.83","19.35"
"10","009","00","060","0015","0293","353","174","179","0","353","971","0","36.35","17.92"
"10","009","00","060","0016","0000","2353","1059","1294","25","2378","6248","0","38.06","16.95"
"10","009","00","060","0016","0296","507","223","284","7","514","1328","0","38.70","16.79"
"10","009","00","060","0016","0297","408","158","250","6","414","1075","0","38.51","14.70"
"10","009","00","060","0016","0298","605","315","290","5","610","1553","0","39.28","20.28"
"10","009","00","060","0016","0299","443","200","243","1","444","1144","0","38.81","17.48"
"10","009","00","060","0016","0300","390","163","227","6","396","1148","0","34.49","14.20"
"10","009","00","060","0017","0000","397","124","273","6","403","1122","0","35.92","11.05"
"10","009","00","060","0017","0301","397","124","273","6","403","1122","0","35.92","11.05"
"10","009","00","060","0018","0000","232","108","124","3","235","794","0","29.60","13.60"
"10","009","00","060","0018","0305","232","108","124","3","235","794","0","29.60","13.60"
"10","009","00","060","0019","0000","397","107","290","4","401","1344","0","29.84","7.96"
"10","009","00","060","0019","0306","194","58","136","1","195","614","0","31.76","9.45"
"10","009","00","060","0019","0307","203","49","154","3","206","730","0","28.22","6.71"
"10","009","00","060","0020","0000","383","119","264","5","388","1120","0","34.64","10.63"
"10","009","00","060","0020","0308","383","119","264","5","388","1120","0","34.64","10.63"
"10","009","00","060","0021","0000","338","111","227","5","343","969","0","35.40","11.46"
"10","009","00","060","0021","0302","145","47","98","4","149","541","0","27.54","8.69"
"10","009","00","060","0021","0303","193","64","129","1","194","428","0","45.33","14.95"
"10","009","00","060","0022","0000","227","68","159","10","237","760","0","31.18","8.95"
"10","009","00","060","0022","0309","227","68","159","10","237","760","0","31.18","8.95"
"10","009","00","060","0023","0000","173","47","126","4","177","537","0","32.96","8.75"
"10","009","00","060","0023","0310","173","47","126","4","177","537","0","32.96","8.75"
"10","009","00","060","0024","0000","533","191","342","10","543","1571","0","34.56","12.16"
"10","009","00","060","0024","0311","324","107","217","6","330","1009","0","32.71","10.60"
"10","009","00","060","0024","0312","209","84","125","4","213","562","0","37.90","14.95"
"10","009","00","060","0025","0000","1112","416","696","6","1118","2928","0","38.18","14.21"
"10","009","00","060","0025","0313","351","85","266","1","352","895","0","39.33","9.50"
"10","009","00","060","0025","0314","361","165","196","4","365","1007","0","36.25","16.39"
"10","009","00","060","0025","0315","400","166","234","1","401","1026","0","39.08","16.18"
"10","009","00","060","0026","0000","417","81","336","4","421","958","0","43.95","8.46"
"10","009","00","060","0026","0294","417","81","336","4","421","958","0","43.95","8.46"
"10","009","00","060","0027","0000","150","48","102","3","153","470","0","32.55","10.21"
"10","009","00","060","0027","0295","150","48","102","3","153","470","0","32.55","10.21"
"10","009","00","060","0028","0000","129","52","77","4","133","380","0","35.00","13.68"
"10","009","00","060","0028","0304","129","52","77","4","133","380","0","35.00","13.68"
"10","009","00","070","0000","0000","9504","4162","5342","140","9644","27042","30632","35.66","15.39"
"10","009","00","070","0001","0000","432","190","242","4","436","1190","0","36.64","15.97"
"10","009","00","070","0001","0593","432","190","242","4","436","1190","0","36.64","15.97"
"10","009","00","070","0002","0000","418","228","190","3","421","1080","0","38.98","21.11"
"10","009","00","070","0002","0594","418","228","190","3","421","1080","0","38.98","21.11"
"10","009","00","070","0003","0000","399","162","237","5","404","1106","0","36.53","14.65"
"10","009","00","070","0003","0592","399","162","237","5","404","1106","0","36.53","14.65"
"10","009","00","070","0004","0000","491","232","259","7","498","1397","0","35.65","16.61"
"10","009","00","070","0004","0590","398","176","222","4","402","1086","0","37.02","16.21"
"10","009","00","070","0004","0591","93","56","37","3","96","311","0","30.87","18.01"
"10","009","00","070","0005","0000","1047","449","598","12","1059","3146","0","33.66","14.27"
"10","009","00","070","0005","0587","354","164","190","3","357","938","0","38.06","17.48"
"10","009","00","070","0005","0588","380","164","216","5","385","1150","0","33.48","14.26"
"10","009","00","070","0005","0589","313","121","192","4","317","1058","0","29.96","11.44"
"10","009","00","070","0006","0000","585","228","357","8","593","1472","0","40.29","15.49"
"10","009","00","070","0006","0585","336","133","203","4","340","863","0","39.40","15.41"
"10","009","00","070","0006","0586","249","95","154","4","253","609","0","41.54","15.60"
"10","009","00","070","0007","0000","692","247","445","17","709","2048","0","34.62","12.06"
"10","009","00","070","0007","0583","361","137","224","5","366","1080","0","33.89","12.69"
"10","009","00","070","0007","0584","331","110","221","12","343","968","0","35.43","11.36"
"10","009","00","070","0008","0000","216","79","137","2","218","708","0","30.79","11.16"
"10","009","00","070","0008","0608","216","79","137","2","218","708","0","30.79","11.16"
"10","009","00","070","0009","0000","105","30","75","0","105","278","0","37.77","10.79"
"10","009","00","070","0009","0607","105","30","75","0","105","278","0","37.77","10.79"
"10","009","00","070","0010","0000","680","305","375","13","693","2109","0","32.86","14.46"
"10","009","00","070","0010","0601","329","143","186","5","334","976","0","34.22","14.65"
"10","009","00","070","0010","0602","351","162","189","8","359","1133","0","31.69","14.30"
"10","009","00","070","0011","0000","342","99","243","2","344","1061","0","32.42","9.33"
"10","009","00","070","0011","0609","342","99","243","2","344","1061","0","32.42","9.33"
"10","009","00","070","0012","0000","358","179","179","8","366","1155","0","31.69","15.50"
"10","009","00","070","0012","0606","358","179","179","8","366","1155","0","31.69","15.50"
"10","009","00","070","0013","0000","105","50","55","0","105","429","0","24.48","11.66"
"10","009","00","070","0013","0610","105","50","55","0","105","429","0","24.48","11.66"
"10","009","00","070","0014","0000","198","82","116","1","199","543","0","36.65","15.10"
"10","009","00","070","0014","0611","198","82","116","1","199","543","0","36.65","15.10"
"10","009","00","070","0015","0000","747","334","413","13","760","2065","0","36.80","16.17"
"10","009","00","070","0015","0603","401","172","229","9","410","1116","0","36.74","15.41"
"10","009","00","070","0015","0604","346","162","184","4","350","949","0","36.88","17.07"
"10","009","00","070","0016","0000","324","117","207","11","335","761","0","44.02","15.37"
"10","009","00","070","0016","0605","324","117","207","11","335","761","0","44.02","15.37"
"10","009","00","070","0017","0000","776","390","386","12","788","2241","0","35.16","17.40"
"10","009","00","070","0017","0595","403","207","196","8","411","1131","0","36.34","18.30"
"10","009","00","070","0017","0596","373","183","190","4","377","1110","0","33.96","16.49"
"10","009","00","070","0018","0000","762","387","375","14","776","2080","0","37.31","18.61"
"10","009","00","070","0018","0597","345","172","173","4","349","948","0","36.81","18.14"
"10","009","00","070","0018","0598","417","215","202","10","427","1132","0","37.72","18.99"
"10","009","00","070","0019","0000","580","258","322","4","584","1501","0","38.91","17.19"
"10","009","00","070","0019","0599","580","258","322","4","584","1501","0","38.91","17.19"
"10","009","00","070","0020","0000","247","116","131","4","251","672","0","37.35","17.26"
"10","009","00","070","0020","0600","247","116","131","4","251","672","0","37.35","17.26"
"10","009","00","080","0000","0000","5800","2310","3490","86","5886","16313","18555","36.08","14.16"
"10","009","00","080","0001","0000","289","123","166","2","291","737","0","39.48","16.69"
"10","009","00","080","0001","0527","289","123","166","2","291","737","0","39.48","16.69"
"10","009","00","080","0002","0000","807","317","490","10","817","2148","0","38.04","14.76"
"10","009","00","080","0002","0531","376","161","215","5","381","957","0","39.81","16.82"
"10","009","00","080","0002","0532","209","75","134","3","212","593","0","35.75","12.65"
"10","009","00","080","0002","0533","222","81","141","2","224","598","0","37.46","13.55"
"10","009","00","080","0003","0000","351","155","196","4","355","959","0","37.02","16.16"
"10","009","00","080","0003","0534","351","155","196","4","355","959","0","37.02","16.16"
"10","009","00","080","0004","0000","320","83","237","10","330","908","0","36.34","9.14"
"10","009","00","080","0004","0535","320","83","237","10","330","908","0","36.34","9.14"
"10","009","00","080","0005","0000","661","260","401","15","676","1893","0","35.71","13.73"
"10","009","00","080","0005","0538","498","185","313","12","510","1443","0","35.34","12.82"
"10","009","00","080","0005","0539","163","75","88","3","166","450","0","36.89","16.67"
"10","009","00","080","0006","0000","675","296","379","7","682","1830","0","37.27","16.17"
"10","009","00","080","0006","0540","482","226","256","4","486","1321","0","36.79","17.11"
"10","009","00","080","0006","0541","193","70","123","3","196","509","0","38.51","13.75"
"10","009","00","080","0007","0000","574","249","325","11","585","1532","0","38.19","16.25"
"10","009","00","080","0007","0536","237","93","144","7","244","555","0","43.96","16.76"
"10","009","00","080","0007","0537","337","156","181","4","341","977","0","34.90","15.97"
"10","009","00","080","0008","0000","385","142","243","5","390","1179","0","33.08","12.04"
"10","009","00","080","0008","0542","385","142","243","5","390","1179","0","33.08","12.04"
"10","009","00","080","0009","0000","238","83","155","5","243","716","0","33.94","11.59"
"10","009","00","080","0009","0528","238","83","155","5","243","716","0","33.94","11.59"
"10","009","00","080","0010","0000","198","94","104","2","200","583","0","34.31","16.12"
"10","009","00","080","0010","0529","198","94","104","2","200","583","0","34.31","16.12"
"10","009","00","080","0011","0000","325","123","202","4","329","1045","0","31.48","11.77"
"10","009","00","080","0011","0530","325","123","202","4","329","1045","0","31.48","11.77"
"10","009","00","080","0012","0000","275","124","151","1","276","743","0","37.15","16.69"
"10","009","00","080","0012","0543","275","124","151","1","276","743","0","37.15","16.69"
"10","009","00","080","0013","0000","246","86","160","2","248","670","0","37.01","12.84"
"10","009","00","080","0013","0544","246","86","160","2","248","670","0","37.01","12.84"
"10","009","00","080","0014","0000","236","84","152","3","239","669","0","35.72","12.56"
"10","009","00","080","0014","0545","236","84","152","3","239","669","0","35.72","12.56"
"10","009","00","080","0015","0000","220","91","129","5","225","701","0","32.10","12.98"
"10","009","00","080","0015","0546","220","91","129","5","225","701","0","32.10","12.98"
"10","009","00","090","0000","0000","9290","3503","5787","112","9402","24348","28143","38.62","14.39"
"10","009","00","090","0001","0000","1671","665","1006","17","1688","4116","0","41.01","16.16"
"10","009","00","090","0001","0402","375","168","207","8","383","989","0","38.73","16.99"
"10","009","00","090","0001","0403","317","116","201","1","318","895","0","35.53","12.96"
"10","009","00","090","0001","0404","433","170","263","1","434","943","0","46.02","18.03"
"10","009","00","090","0001","0405","546","211","335","7","553","1289","0","42.90","16.37"
"10","009","00","090","0002","0000","335","94","241","4","339","864","0","39.24","10.88"
"10","009","00","090","0002","0406","335","94","241","4","339","864","0","39.24","10.88"
"10","009","00","090","0003","0000","591","168","423","5","596","1530","0","38.95","10.98"
"10","009","00","090","0003","0407","335","84","251","3","338","774","0","43.67","10.85"
"10","009","00","090","0003","0408","256","84","172","2","258","756","0","34.13","11.11"
"10","009","00","090","0004","0000","500","198","302","7","507","1177","0","43.08","16.82"
"10","009","00","090","0004","0409","231","96","135","5","236","572","0","41.26","16.78"
"10","009","00","090","0004","0410","269","102","167","2","271","605","0","44.79","16.86"
"10","009","00","090","0005","0000","378","125","253","5","383","1068","0","35.86","11.70"
"10","009","00","090","0005","0411","378","125","253","5","383","1068","0","35.86","11.70"
"10","009","00","090","0006","0000","747","247","500","11","758","2015","0","37.62","12.26"
"10","009","00","090","0006","0412","382","147","235","6","388","1023","0","37.93","14.37"
"10","009","00","090","0006","0413","365","100","265","5","370","992","0","37.30","10.08"
"10","009","00","090","0007","0000","1197","526","671","2","1199","3053","0","39.27","17.23"
"10","009","00","090","0007","0414","422","200","222","1","423","1071","0","39.50","18.67"
"10","009","00","090","0007","0415","347","151","196","1","348","925","0","37.62","16.32"
"10","009","00","090","0007","0416","428","175","253","0","428","1057","0","40.49","16.56"
"10","009","00","090","0008","0000","524","200","324","6","530","1250","0","42.40","16.00"
"10","009","00","090","0008","0417","524","200","324","6","530","1250","0","42.40","16.00"
"10","009","00","090","0009","0000","396","158","238","5","401","1135","0","35.33","13.92"
"10","009","00","090","0009","0420","396","158","238","5","401","1135","0","35.33","13.92"
"10","009","00","090","0010","0000","684","264","420","14","698","1882","0","37.09","14.03"
"10","009","00","090","0010","0418","295","142","153","8","303","875","0","34.63","16.23"
"10","009","00","090","0010","0419","389","122","267","6","395","1007","0","39.23","12.12"
"10","009","00","090","0011","0000","627","271","356","8","635","1725","0","36.81","15.71"
"10","009","00","090","0011","0421","302","117","185","4","306","852","0","35.92","13.73"
"10","009","00","090","0011","0422","325","154","171","4","329","873","0","37.69","17.64"
"10","009","00","090","0012","0000","497","199","298","11","508","1453","0","34.96","13.70"
"10","009","00","090","0012","0423","299","112","187","7","306","932","0","32.83","12.02"
"10","009","00","090","0012","0424","198","87","111","4","202","521","0","38.77","16.70"
"10","009","00","090","0013","0000","465","169","296","7","472","1313","0","35.95","12.87"
"10","009","00","090","0013","0425","185","52","133","1","186","448","0","41.52","11.61"
"10","009","00","090","0013","0426","280","117","163","6","286","865","0","33.06","13.53"
"10","009","00","090","0014","0000","678","219","459","10","688","1767","0","38.94","12.39"
"10","009","00","090","0014","0427","436","115","321","6","442","1133","0","39.01","10.15"
"10","009","00","090","0014","0428","242","104","138","4","246","634","0","38.80","16.40"
"10","009","00","100","0000","0000","5278","2402","2876","95","5373","15106","17408","35.57","15.90"
"10","009","00","100","0001","0000","359","177","182","5","364","1004","0","36.25","17.63"
"10","009","00","100","0001","0429","359","177","182","5","364","1004","0","36.25","17.63"
"10","009","00","100","0002","0000","1290","599","691","23","1313","3548","0","37.01","16.88"
"10","009","00","100","0002","0430","456","190","266","10","466","1210","0","38.51","15.70"
"10","009","00","100","0002","0431","296","145","151","2","298","836","0","35.65","17.34"
"10","009","00","100","0002","0432","284","149","135","3","287","835","0","34.37","17.84"
"10","009","00","100","0002","0433","254","115","139","8","262","667","0","39.28","17.24"
"10","009","00","100","0003","0000","758","314","444","15","773","2097","0","36.86","14.97"
"10","009","00","100","0003","0434","480","241","239","12","492","1377","0","35.73","17.50"
"10","009","00","100","0003","0435","278","73","205","3","281","720","0","39.03","10.14"
"10","009","00","100","0004","0000","170","93","77","5","175","505","0","34.65","18.42"
"10","009","00","100","0004","0436","170","93","77","5","175","505","0","34.65","18.42"
"10","009","00","100","0005","0000","288","151","137","4","292","802","0","36.41","18.83"
"10","009","00","100","0005","0437","288","151","137","4","292","802","0","36.41","18.83"
"10","009","00","100","0006","0000","823","379","444","17","840","2594","0","32.38","14.61"
"10","009","00","100","0006","0438","414","191","223","11","425","1305","0","32.57","14.64"
"10","009","00","100","0006","0439","409","188","221","6","415","1289","0","32.20","14.58"
"10","009","00","100","0007","0000","227","87","140","1","228","627","0","36.36","13.88"
"10","009","00","100","0007","0440","227","87","140","1","228","627","0","36.36","13.88"
"10","009","00","100","0008","0000","380","178","202","11","391","1115","0","35.07","15.96"
"10","009","00","100","0008","0441","380","178","202","11","391","1115","0","35.07","15.96"
"10","009","00","100","0009","0000","343","192","151","6","349","1016","0","34.35","18.90"
"10","009","00","100","0009","0442","343","192","151","6","349","1016","0","34.35","18.90"
"10","009","00","100","0010","0000","640","232","408","8","648","1798","0","36.04","12.90"
"10","009","00","100","0010","0443","343","106","237","5","348","950","0","36.63","11.16"
"10","009","00","100","0010","0444","297","126","171","3","300","848","0","35.38","14.86"
"10","009","00","110","0000","0000","7893","2672","5221","103","7996","22786","25808","35.09","11.73"
"10","009","00","110","0001","0000","526","218","308","6","532","1442","0","36.89","15.12"
"10","009","00","110","0001","0337","290","120","170","4","294","838","0","35.08","14.32"
"10","009","00","110","0001","0338","236","98","138","2","238","604","0","39.40","16.23"
"10","009","00","110","0002","0000","626","272","354","7","633","1698","0","37.28","16.02"
"10","009","00","110","0002","0339","350","152","198","5","355","922","0","38.50","16.49"
"10","009","00","110","0002","0340","276","120","156","2","278","776","0","35.82","15.46"
"10","009","00","110","0003","0000","526","170","356","4","530","1596","0","33.21","10.65"
"10","009","00","110","0003","0341","162","51","111","0","162","603","0","26.87","8.46"
"10","009","00","110","0003","0342","364","119","245","4","368","993","0","37.06","11.98"
"10","009","00","110","0004","0000","503","168","335","11","514","1474","0","34.87","11.40"
"10","009","00","110","0004","0343","160","59","101","1","161","441","0","36.51","13.38"
"10","009","00","110","0004","0344","343","109","234","10","353","1033","0","34.17","10.55"
"10","009","00","110","0005","0000","414","190","224","4","418","1126","0","37.12","16.87"
"10","009","00","110","0005","0345","414","190","224","4","418","1126","0","37.12","16.87"
"10","009","00","110","0006","0000","647","238","409","4","651","1839","0","35.40","12.94"
"10","009","00","110","0006","0346","356","122","234","1","357","1019","0","35.03","11.97"
"10","009","00","110","0006","0347","291","116","175","3","294","820","0","35.85","14.15"
"10","009","00","110","0007","0000","301","108","193","6","307","861","0","35.66","12.54"
"10","009","00","110","0007","0348","301","108","193","6","307","861","0","35.66","12.54"
"10","009","00","110","0008","0000","342","91","251","2","344","873","0","39.40","10.42"
"10","009","00","110","0008","0351","342","91","251","2","344","873","0","39.40","10.42"
"10","009","00","110","0009","0000","279","54","225","4","283","748","0","37.83","7.22"
"10","009","00","110","0009","0352","279","54","225","4","283","748","0","37.83","7.22"
"10","009","00","110","0010","0000","456","111","345","7","463","1464","0","31.63","7.58"
"10","009","00","110","0010","0353","213","66","147","4","217","652","0","33.28","10.12"
"10","009","00","110","0010","0354","243","45","198","3","246","812","0","30.30","5.54"
"10","009","00","110","0011","0000","614","181","433","11","625","1782","0","35.07","10.16"
"10","009","00","110","0011","0355","366","84","282","9","375","1127","0","33.27","7.45"
"10","009","00","110","0011","0356","248","97","151","2","250","655","0","38.17","14.81"
"10","009","00","110","0012","0000","272","78","194","4","276","821","0","33.62","9.50"
"10","009","00","110","0012","0357","272","78","194","4","276","821","0","33.62","9.50"
"10","009","00","110","0013","0000","649","245","404","9","658","1719","0","38.28","14.25"
"10","009","00","110","0013","0358","433","190","243","9","442","1042","0","42.42","18.23"
"10","009","00","110","0013","0359","216","55","161","0","216","677","0","31.91","8.12"
"10","009","00","110","0014","0000","407","127","280","8","415","1223","0","33.93","10.38"
"10","009","00","110","0014","0360","407","127","280","8","415","1223","0","33.93","10.38"
"10","009","00","110","0015","0000","229","69","160","3","232","907","0","25.58","7.61"
"10","009","00","110","0015","0361","229","69","160","3","232","907","0","25.58","7.61"
"10","009","00","110","0016","0000","278","84","194","5","283","824","0","34.34","10.19"
"10","009","00","110","0016","0362","278","84","194","5","283","824","0","34.34","10.19"
"10","009","00","110","0017","0000","265","100","165","3","268","983","0","27.26","10.17"
"10","009","00","110","0017","0363","265","100","165","3","268","983","0","27.26","10.17"
"10","009","00","110","0018","0000","559","168","391","5","564","1406","0","40.11","11.95"
"10","009","00","110","0018","0349","321","94","227","3","324","798","0","40.60","11.78"
"10","009","00","110","0018","0350","238","74","164","2","240","608","0","39.47","12.17"
"10","009","00","120","0000","0000","6793","2733","4060","107","6900","20647","23741","33.42","13.24"
"10","009","00","120","0001","0000","422","174","248","2","424","1134","0","37.39","15.34"
"10","009","00","120","0001","0316","422","174","248","2","424","1134","0","37.39","15.34"
"10","009","00","120","0002","0000","505","227","278","7","512","1437","0","35.63","15.80"
"10","009","00","120","0002","0317","505","227","278","7","512","1437","0","35.63","15.80"
"10","009","00","120","0003","0000","833","381","452","3","836","2263","0","36.94","16.84"
"10","009","00","120","0003","0318","399","164","235","2","401","1093","0","36.69","15.00"
"10","009","00","120","0003","0319","434","217","217","1","435","1170","0","37.18","18.55"
"10","009","00","120","0004","0000","731","254","477","11","742","2078","0","35.71","12.22"
"10","009","00","120","0004","0320","404","147","257","7","411","1082","0","37.99","13.59"
"10","009","00","120","0004","0321","327","107","220","4","331","996","0","33.23","10.74"
"10","009","00","120","0005","0000","738","262","476","16","754","2042","0","36.92","12.83"
"10","009","00","120","0005","0322","344","145","199","12","356","958","0","37.16","15.14"
"10","009","00","120","0005","0323","394","117","277","4","398","1084","0","36.72","10.79"
"10","009","00","120","0006","0000","420","123","297","8","428","1250","0","34.24","9.84"
"10","009","00","120","0006","0324","420","123","297","8","428","1250","0","34.24","9.84"
"10","009","00","120","0007","0000","588","265","323","10","598","2022","0","29.57","13.11"
"10","009","00","120","0007","0325","239","127","112","4","243","1023","0","23.75","12.41"
"10","009","00","120","0007","0326","349","138","211","6","355","999","0","35.54","13.81"
"10","009","00","120","0008","0000","257","167","90","8","265","782","0","33.89","21.36"
"10","009","00","120","0008","0327","257","167","90","8","265","782","0","33.89","21.36"
"10","009","00","120","0009","0000","433","184","249","12","445","1484","0","29.99","12.40"
"10","009","00","120","0009","0328","180","71","109","3","183","686","0","26.68","10.35"
"10","009","00","120","0009","0329","253","113","140","9","262","798","0","32.83","14.16"
"10","009","00","120","0010","0000","499","183","316","9","508","1710","0","29.71","10.70"
"10","009","00","120","0010","0330","272","89","183","2","274","859","0","31.90","10.36"
"10","009","00","120","0010","0331","227","94","133","7","234","851","0","27.50","11.05"
"10","009","00","120","0011","0000","426","193","233","5","431","1413","0","30.50","13.66"
"10","009","00","120","0011","0332","203","93","110","2","205","668","0","30.69","13.92"
"10","009","00","120","0011","0333","223","100","123","3","226","745","0","30.34","13.42"
"10","009","00","120","0012","0000","266","110","156","6","272","1102","0","24.68","9.98"
"10","009","00","120","0012","0334","266","110","156","6","272","1102","0","24.68","9.98"
"10","009","00","120","0013","0000","440","115","325","8","448","1181","0","37.93","9.74"
"10","009","00","120","0013","0335","440","115","325","8","448","1181","0","37.93","9.74"
"10","009","00","120","0014","0000","235","95","140","2","237","749","0","31.64","12.68"
"10","009","00","120","0014","0336","235","95","140","2","237","749","0","31.64","12.68"
"10","009","00","130","0000","0000","9800","4892","4908","120","9920","39270","48001","25.26","12.46"
"10","009","00","130","0001","0000","1122","607","515","11","1133","4277","0","26.49","14.19"
"10","009","00","130","0001","0007","320","164","156","5","325","1135","0","28.63","14.45"
"10","009","00","130","0001","0008","263","137","126","3","266","957","0","27.80","14.32"
"10","009","00","130","0001","0009","304","175","129","2","306","1158","0","26.42","15.11"
"10","009","00","130","0001","0010","235","131","104","1","236","1027","0","22.98","12.76"
"10","009","00","130","0002","0000","1936","1047","889","17","1953","7460","0","26.18","14.03"
"10","009","00","130","0002","0001","318","175","143","2","320","1356","0","23.60","12.91"
"10","009","00","130","0002","0002","286","163","123","2","288","1247","0","23.10","13.07"
"10","009","00","130","0002","0003","380","200","180","3","383","1260","0","30.40","15.87"
"10","009","00","130","0002","0004","388","212","176","4","392","1494","0","26.24","14.19"
"10","009","00","130","0002","0005","313","155","158","4","317","1082","0","29.30","14.33"
"10","009","00","130","0002","0006","251","142","109","2","253","1021","0","24.78","13.91"
"10","009","00","130","0003","0000","513","206","307","10","523","1968","0","26.58","10.47"
"10","009","00","130","0003","0011","181","73","108","3","184","739","0","24.90","9.88"
"10","009","00","130","0003","0012","332","133","199","7","339","1229","0","27.58","10.82"
"10","009","00","130","0004","0000","754","325","429","11","765","2867","0","26.68","11.34"
"10","009","00","130","0004","0013","321","146","175","3","324","1178","0","27.50","12.39"
"10","009","00","130","0004","0014","261","104","157","3","264","1013","0","26.06","10.27"
"10","009","00","130","0004","0015","172","75","97","5","177","676","0","26.18","11.09"
"10","009","00","130","0005","0000","637","348","289","5","642","2721","0","23.59","12.79"
"10","009","00","130","0005","0025","323","189","134","1","324","1339","0","24.20","14.12"
"10","009","00","130","0005","0026","314","159","155","4","318","1382","0","23.01","11.51"
"10","009","00","130","0006","0000","659","384","275","9","668","3051","0","21.89","12.59"
"10","009","00","130","0006","0018","253","133","120","2","255","1075","0","23.72","12.37"
"10","009","00","130","0006","0019","205","141","64","4","209","942","0","22.19","14.97"
"10","009","00","130","0006","0020","201","110","91","3","204","1034","0","19.73","10.64"
"10","009","00","130","0007","0000","509","264","245","5","514","2216","0","23.19","11.91"
"10","009","00","130","0007","0016","249","132","117","3","252","1215","0","20.74","10.86"
"10","009","00","130","0007","0017","260","132","128","2","262","1001","0","26.17","13.19"
"10","009","00","130","0008","0000","517","236","281","5","522","2141","0","24.38","11.02"
"10","009","00","130","0008","0023","236","112","124","4","240","1001","0","23.98","11.19"
"10","009","00","130","0008","0024","281","124","157","1","282","1140","0","24.74","10.88"
"10","009","00","130","0009","0000","1007","474","533","14","1021","4026","0","25.36","11.77"
"10","009","00","130","0009","0027","283","152","131","5","288","1218","0","23.65","12.48"
"10","009","00","130","0009","0028","232","105","127","5","237","951","0","24.92","11.04"
"10","009","00","130","0009","0029","239","98","141","1","240","908","0","26.43","10.79"
"10","009","00","130","0009","0030","253","119","134","3","256","949","0","26.98","12.54"
"10","009","00","130","0010","0000","302","139","163","3","305","1156","0","26.38","12.02"
"10","009","00","130","0010","0031","302","139","163","3","305","1156","0","26.38","12.02"
"10","009","00","130","0011","0000","931","403","528","16","947","3617","0","26.18","11.14"
"10","009","00","130","0011","0032","356","166","190","7","363","1244","0","29.18","13.34"
"10","009","00","130","0011","0033","304","101","203","6","310","1255","0","24.70","8.05"
"10","009","00","130","0011","0034","271","136","135","3","274","1118","0","24.51","12.16"
"10","009","00","130","0012","0000","544","273","271","12","556","2222","0","25.02","12.29"
"10","009","00","130","0012","0035","325","177","148","5","330","1193","0","27.66","14.84"
"10","009","00","130","0012","0036","219","96","123","7","226","1029","0","21.96","9.33"
"10","009","00","130","0013","0000","369","186","183","2","371","1548","0","23.97","12.02"
"10","009","00","130","0013","0021","183","100","83","2","185","808","0","22.90","12.38"
"10","009","00","130","0013","0022","186","86","100","0","186","740","0","25.14","11.62"
"10","009","00","140","0000","0000","4002","1784","2218","65","4067","12612","13963","32.25","14.15"
"10","009","00","140","0001","0000","557","299","258","8","565","1442","0","39.18","20.74"
"10","009","00","140","0001","0065","328","173","155","4","332","863","0","38.47","20.05"
"10","009","00","140","0001","0066","229","126","103","4","233","579","0","40.24","21.76"
"10","009","00","140","0002","0000","383","188","195","5","388","1155","0","33.59","16.28"
"10","009","00","140","0002","0067","383","188","195","5","388","1155","0","33.59","16.28"
"10","009","00","140","0003","0000","437","186","251","6","443","1536","0","28.84","12.11"
"10","009","00","140","0003","0063","213","76","137","3","216","864","0","25.00","8.80"
"10","009","00","140","0003","0064","224","110","114","3","227","672","0","33.78","16.37"
"10","009","00","140","0004","0000","199","88","111","1","200","511","0","39.14","17.22"
"10","009","00","140","0004","0062","199","88","111","1","200","511","0","39.14","17.22"
"10","009","00","140","0005","0000","338","125","213","5","343","1160","0","29.57","10.78"
"10","009","00","140","0005","0061","338","125","213","5","343","1160","0","29.57","10.78"
"10","009","00","140","0006","0000","182","81","101","2","184","532","0","34.59","15.23"
"10","009","00","140","0006","0069","182","81","101","2","184","532","0","34.59","15.23"
"10","009","00","140","0007","0000","263","77","186","8","271","778","0","34.83","9.90"
"10","009","00","140","0007","0068","263","77","186","8","271","778","0","34.83","9.90"
"10","009","00","140","0008","0000","212","92","120","2","214","812","0","26.35","11.33"
"10","009","00","140","0008","0071","212","92","120","2","214","812","0","26.35","11.33"
"10","009","00","140","0009","0000","277","111","166","6","283","825","0","34.30","13.45"
"10","009","00","140","0009","0070","277","111","166","6","283","825","0","34.30","13.45"
"10","009","00","140","0010","0000","552","264","288","15","567","1857","0","30.53","14.22"
"10","009","00","140","0010","0072","268","137","131","7","275","888","0","30.97","15.43"
"10","009","00","140","0010","0073","284","127","157","8","292","969","0","30.13","13.11"
"10","009","00","140","0011","0000","314","143","171","1","315","1015","0","31.03","14.09"
"10","009","00","140","0011","0076","314","143","171","1","315","1015","0","31.03","14.09"
"10","009","00","140","0012","0000","288","130","158","6","294","989","0","29.73","13.14"
"10","009","00","140","0012","0074","162","95","67","4","166","590","0","28.14","16.10"
"10","009","00","140","0012","0075","126","35","91","2","128","399","0","32.08","8.77"
"10","009","00","150","0000","0000","3960","1687","2273","50","4010","10933","12368","36.68","15.43"
"10","009","00","150","0001","0000","701","313","388","5","706","1848","0","38.20","16.94"
"10","009","00","150","0001","0077","335","150","185","3","338","882","0","38.32","17.01"
"10","009","00","150","0001","0078","366","163","203","2","368","966","0","38.10","16.87"
"10","009","00","150","0002","0000","525","244","281","5","530","1415","0","37.46","17.24"
"10","009","00","150","0002","0079","267","119","148","5","272","726","0","37.47","16.39"
"10","009","00","150","0002","0080","258","125","133","0","258","689","0","37.45","18.14"
"10","009","00","150","0003","0000","518","216","302","6","524","1455","0","36.01","14.85"
"10","009","00","150","0003","0081","248","100","148","4","252","733","0","34.38","13.64"
"10","009","00","150","0003","0082","270","116","154","2","272","722","0","37.67","16.07"
"10","009","00","150","0004","0000","437","165","272","8","445","1158","0","38.43","14.25"
"10","009","00","150","0004","0085","178","69","109","2","180","453","0","39.74","15.23"
"10","009","00","150","0004","0086","259","96","163","6","265","705","0","37.59","13.62"
"10","009","00","150","0005","0000","503","191","312","12","515","1437","0","35.84","13.29"
"10","009","00","150","0005","0083","178","71","107","3","181","468","0","38.68","15.17"
"10","009","00","150","0005","0084","325","120","205","9","334","969","0","34.47","12.38"
"10","009","00","150","0006","0000","296","111","185","3","299","806","0","37.10","13.77"
"10","009","00","150","0006","0087","296","111","185","3","299","806","0","37.10","13.77"
"10","009","00","150","0007","0000","281","127","154","1","282","774","0","36.43","16.41"
"10","009","00","150","0007","0088","281","127","154","1","282","774","0","36.43","16.41"
"10","009","00","150","0008","0000","390","189","201","4","394","1187","0","33.19","15.92"
"10","009","00","150","0008","0089","390","189","201","4","394","1187","0","33.19","15.92"
"10","009","00","150","0009","0000","309","131","178","6","315","853","0","36.93","15.36"
"10","009","00","150","0009","0090","309","131","178","6","315","853","0","36.93","15.36"
"10","009","00","160","0000","0000","5488","2880","2608","105","5593","20367","22792","27.46","14.14"
"10","009","00","160","0001","0000","415","255","160","7","422","1177","0","35.85","21.67"
"10","009","00","160","0001","0037","415","255","160","7","422","1177","0","35.85","21.67"
"10","009","00","160","0002","0000","321","178","143","6","327","1060","0","30.85","16.79"
"10","009","00","160","0002","0039","321","178","143","6","327","1060","0","30.85","16.79"
"10","009","00","160","0003","0000","312","165","147","5","317","1093","0","29.00","15.10"
"10","009","00","160","0003","0038","312","165","147","5","317","1093","0","29.00","15.10"
"10","009","00","160","0004","0000","492","291","201","9","501","1980","0","25.30","14.70"
"10","009","00","160","0004","0040","227","122","105","3","230","988","0","23.28","12.35"
"10","009","00","160","0004","0041","265","169","96","6","271","992","0","27.32","17.04"
"10","009","00","160","0005","0000","363","165","198","8","371","1449","0","25.60","11.39"
"10","009","00","160","0005","0043","176","86","90","5","181","706","0","25.64","12.18"
"10","009","00","160","0005","0044","187","79","108","3","190","743","0","25.57","10.63"
"10","009","00","160","0006","0000","454","193","261","13","467","1828","0","25.55","10.56"
"10","009","00","160","0006","0045","301","113","188","9","310","1133","0","27.36","9.97"
"10","009","00","160","0006","0046","153","80","73","4","157","695","0","22.59","11.51"
"10","009","00","160","0007","0000","158","74","84","2","160","592","0","27.03","12.50"
"10","009","00","160","0007","0047","158","74","84","2","160","592","0","27.03","12.50"
"10","009","00","160","0008","0000","220","110","110","4","224","672","0","33.33","16.37"
"10","009","00","160","0008","0049","220","110","110","4","224","672","0","33.33","16.37"
"10","009","00","160","0009","0000","139","39","100","4","143","450","0","31.78","8.67"
"10","009","00","160","0009","0048","139","39","100","4","143","450","0","31.78","8.67"
"10","009","00","160","0010","0000","211","126","85","2","213","811","0","26.26","15.54"
"10","009","00","160","0010","0042","211","126","85","2","213","811","0","26.26","15.54"
"10","009","00","160","0011","0000","387","207","180","3","390","1466","0","26.60","14.12"
"10","009","00","160","0011","0052","278","132","146","2","280","1020","0","27.45","12.94"
"10","009","00","160","0011","0053","109","75","34","1","110","446","0","24.66","16.82"
"10","009","00","160","0012","0000","368","194","174","5","373","1332","0","28.00","14.56"
"10","009","00","160","0012","0054","215","122","93","3","218","775","0","28.13","15.74"
"10","009","00","160","0012","0055","153","72","81","2","155","557","0","27.83","12.93"
"10","009","00","160","0013","0000","760","375","385","18","778","2935","0","26.51","12.78"
"10","009","00","160","0013","0056","301","167","134","8","309","1031","0","29.97","16.20"
"10","009","00","160","0013","0057","259","121","138","5","264","960","0","27.50","12.60"
"10","009","00","160","0013","0058","200","87","113","5","205","944","0","21.72","9.22"
"10","009","00","160","0014","0000","429","253","176","9","438","1741","0","25.16","14.53"
"10","009","00","160","0014","0059","290","147","143","6","296","1162","0","25.47","12.65"
"10","009","00","160","0014","0060","139","106","33","3","142","579","0","24.53","18.31"
"10","009","00","160","0015","0000","459","255","204","10","469","1781","0","26.33","14.32"
"10","009","00","160","0015","0050","325","167","158","7","332","1214","0","27.35","13.76"
"10","009","00","160","0015","0051","134","88","46","3","137","567","0","24.16","15.52"
"10","009","00","170","0000","0000","6686","2470","4216","93","6779","21835","24426","31.05","11.31"
"10","009","00","170","0001","0000","1022","398","624","8","1030","3218","0","32.01","12.37"
"10","009","00","170","0001","0196","282","101","181","3","285","882","0","32.31","11.45"
"10","009","00","170","0001","0197","391","167","224","3","394","1238","0","31.83","13.49"
"10","009","00","170","0001","0198","349","130","219","2","351","1098","0","31.97","11.84"
"10","009","00","170","0002","0000","486","187","299","9","495","1454","0","34.04","12.86"
"10","009","00","170","0002","0199","234","86","148","3","237","698","0","33.95","12.32"
"10","009","00","170","0002","0200","252","101","151","6","258","756","0","34.13","13.36"
"10","009","00","170","0003","0000","408","148","260","6","414","1308","0","31.65","11.31"
"10","009","00","170","0003","0201","408","148","260","6","414","1308","0","31.65","11.31"
"10","009","00","170","0004","0000","228","71","157","7","235","705","0","33.33","10.07"
"10","009","00","170","0004","0202","228","71","157","7","235","705","0","33.33","10.07"
"10","009","00","170","0005","0000","288","121","167","6","294","936","0","31.41","12.93"
"10","009","00","170","0005","0203","288","121","167","6","294","936","0","31.41","12.93"
"10","009","00","170","0006","0000","297","100","197","5","302","1030","0","29.32","9.71"
"10","009","00","170","0006","0204","297","100","197","5","302","1030","0","29.32","9.71"
"10","009","00","170","0007","0000","286","131","155","6","292","890","0","32.81","14.72"
"10","009","00","170","0007","0205","286","131","155","6","292","890","0","32.81","14.72"
"10","009","00","170","0008","0000","259","68","191","7","266","715","0","37.20","9.51"
"10","009","00","170","0008","0206","259","68","191","7","266","715","0","37.20","9.51"
"10","009","00","170","0009","0000","176","87","89","3","179","570","0","31.40","15.26"
"10","009","00","170","0009","0207","176","87","89","3","179","570","0","31.40","15.26"
"10","009","00","170","0010","0000","221","110","111","1","222","836","0","26.56","13.16"
"10","009","00","170","0010","0208","221","110","111","1","222","836","0","26.56","13.16"
"10","009","00","170","0011","0000","138","30","108","2","140","351","0","39.89","8.55"
"10","009","00","170","0011","0209","138","30","108","2","140","351","0","39.89","8.55"
"10","009","00","170","0012","0000","289","106","183","8","297","1112","0","26.71","9.53"
"10","009","00","170","0012","0210","289","106","183","8","297","1112","0","26.71","9.53"
"10","009","00","170","0013","0000","438","174","264","8","446","1457","0","30.61","11.94"
"10","009","00","170","0013","0211","145","45","100","2","147","565","0","26.02","7.96"
"10","009","00","170","0013","0212","293","129","164","6","299","892","0","33.52","14.46"
"10","009","00","170","0014","0000","317","77","240","0","317","958","0","33.09","8.04"
"10","009","00","170","0014","0213","317","77","240","0","317","958","0","33.09","8.04"
"10","009","00","170","0015","0000","249","92","157","4","253","813","0","31.12","11.32"
"10","009","00","170","0015","0214","249","92","157","4","253","813","0","31.12","11.32"
"10","009","00","170","0016","0000","311","113","198","0","311","1127","0","27.60","10.03"
"10","009","00","170","0016","0215","311","113","198","0","311","1127","0","27.60","10.03"
"10","009","00","170","0017","0000","265","106","159","3","268","816","0","32.84","12.99"
"10","009","00","170","0017","0216","265","106","159","3","268","816","0","32.84","12.99"
"10","009","00","170","0018","0000","413","129","284","4","417","1472","0","28.33","8.76"
"10","009","00","170","0018","0217","179","55","124","3","182","645","0","28.22","8.53"
"10","009","00","170","0018","0218","234","74","160","1","235","827","0","28.42","8.95"
"10","009","00","170","0019","0000","171","51","120","2","173","578","0","29.93","8.82"
"10","009","00","170","0019","0219","171","51","120","2","173","578","0","29.93","8.82"
"10","009","00","170","0020","0000","197","76","121","3","200","803","0","24.91","9.46"
"10","009","00","170","0020","0220","197","76","121","3","200","803","0","24.91","9.46"
"10","009","00","170","0021","0000","227","95","132","1","228","686","0","33.24","13.85"
"10","009","00","170","0021","0221","227","95","132","1","228","686","0","33.24","13.85"
"10","009","00","180","0000","0000","5450","2359","3091","100","5550","20121","22100","27.58","11.72"
"10","009","00","180","0001","0000","583","262","321","6","589","1728","0","34.09","15.16"
"10","009","00","180","0001","0171","328","145","183","2","330","1061","0","31.10","13.67"
"10","009","00","180","0001","0172","255","117","138","4","259","667","0","38.83","17.54"
"10","009","00","180","0002","0000","184","67","117","2","186","626","0","29.71","10.70"
"10","009","00","180","0002","0176","184","67","117","2","186","626","0","29.71","10.70"
"10","009","00","180","0003","0000","257","104","153","2","259","902","0","28.71","11.53"
"10","009","00","180","0003","0177","257","104","153","2","259","902","0","28.71","11.53"
"10","009","00","180","0004","0000","258","101","157","5","263","883","0","29.78","11.44"
"10","009","00","180","0004","0178","258","101","157","5","263","883","0","29.78","11.44"
"10","009","00","180","0005","0000","749","391","358","15","764","2201","0","34.71","17.76"
"10","009","00","180","0005","0173","304","179","125","4","308","846","0","36.41","21.16"
"10","009","00","180","0005","0174","131","28","103","4","135","459","0","29.41","6.10"
"10","009","00","180","0005","0175","314","184","130","7","321","896","0","35.83","20.54"
"10","009","00","180","0006","0000","291","140","151","3","294","1152","0","25.52","12.15"
"10","009","00","180","0006","0181","291","140","151","3","294","1152","0","25.52","12.15"
"10","009","00","180","0007","0000","184","74","110","7","191","712","0","26.83","10.39"
"10","009","00","180","0007","0180","184","74","110","7","191","712","0","26.83","10.39"
"10","009","00","180","0008","0000","211","92","119","2","213","828","0","25.72","11.11"
"10","009","00","180","0008","0179","211","92","119","2","213","828","0","25.72","11.11"
"10","009","00","180","0009","0000","226","114","112","1","227","846","0","26.83","13.48"
"10","009","00","180","0009","0185","226","114","112","1","227","846","0","26.83","13.48"
"10","009","00","180","0010","0000","86","34","52","0","86","352","0","24.43","9.66"
"10","009","00","180","0010","0186","86","34","52","0","86","352","0","24.43","9.66"
"10","009","00","180","0011","0000","188","65","123","4","192","743","0","25.84","8.75"
"10","009","00","180","0011","0183","188","65","123","4","192","743","0","25.84","8.75"
"10","009","00","180","0012","0000","219","98","121","8","227","898","0","25.28","10.91"
"10","009","00","180","0012","0182","219","98","121","8","227","898","0","25.28","10.91"
"10","009","00","180","0013","0000","381","175","206","3","384","1669","0","23.01","10.49"
"10","009","00","180","0013","0187","180","81","99","3","183","872","0","20.99","9.29"
"10","009","00","180","0013","0188","201","94","107","0","201","797","0","25.22","11.79"
"10","009","00","180","0014","0000","179","87","92","1","180","782","0","23.02","11.13"
"10","009","00","180","0014","0189","179","87","92","1","180","782","0","23.02","11.13"
"10","009","00","180","0015","0000","134","71","63","4","138","683","0","20.20","10.40"
"10","009","00","180","0015","0190","134","71","63","4","138","683","0","20.20","10.40"
"10","009","00","180","0016","0000","238","76","162","6","244","878","0","27.79","8.66"
"10","009","00","180","0016","0191","238","76","162","6","244","878","0","27.79","8.66"
"10","009","00","180","0017","0000","277","107","170","7","284","1016","0","27.95","10.53"
"10","009","00","180","0017","0193","277","107","170","7","284","1016","0","27.95","10.53"
"10","009","00","180","0018","0000","214","106","108","11","225","958","0","23.49","11.06"
"10","009","00","180","0018","0194","214","106","108","11","225","958","0","23.49","11.06"
"10","009","00","180","0019","0000","164","85","79","5","169","724","0","23.34","11.74"
"10","009","00","180","0019","0195","164","85","79","5","169","724","0","23.34","11.74"
"10","009","00","180","0020","0000","157","55","102","3","160","533","0","30.02","10.32"
"10","009","00","180","0020","0184","157","55","102","3","160","533","0","30.02","10.32"
"10","009","00","180","0021","0000","270","55","215","5","275","1007","0","27.31","5.46"
"10","009","00","180","0021","0192","270","55","215","5","275","1007","0","27.31","5.46"
"10","009","00","190","0000","0000","7417","2400","5017","136","7553","23413","26186","32.26","10.25"
"10","009","00","190","0001","0000","378","165","213","5","383","1198","0","31.97","13.77"
"10","009","00","190","0001","0223","378","165","213","5","383","1198","0","31.97","13.77"
"10","009","00","190","0002","0000","350","156","194","5","355","1068","0","33.24","14.61"
"10","009","00","190","0002","0222","350","156","194","5","355","1068","0","33.24","14.61"
"10","009","00","190","0003","0000","167","75","92","0","167","614","0","27.20","12.21"
"10","009","00","190","0003","0224","167","75","92","0","167","614","0","27.20","12.21"
"10","009","00","190","0004","0000","262","80","182","3","265","851","0","31.14","9.40"
"10","009","00","190","0004","0226","262","80","182","3","265","851","0","31.14","9.40"
"10","009","00","190","0005","0000","252","83","169","6","258","694","0","37.18","11.96"
"10","009","00","190","0005","0225","252","83","169","6","258","694","0","37.18","11.96"
"10","009","00","190","0006","0000","343","85","258","10","353","973","0","36.28","8.74"
"10","009","00","190","0006","0227","343","85","258","10","353","973","0","36.28","8.74"
"10","009","00","190","0007","0000","400","112","288","15","415","1405","0","29.54","7.97"
"10","009","00","190","0007","0228","400","112","288","15","415","1405","0","29.54","7.97"
"10","009","00","190","0008","0000","548","180","368","6","554","2020","0","27.43","8.91"
"10","009","00","190","0008","0229","213","65","148","0","213","843","0","25.27","7.71"
"10","009","00","190","0008","0230","335","115","220","6","341","1177","0","28.97","9.77"
"10","009","00","190","0009","0000","404","138","266","7","411","1473","0","27.90","9.37"
"10","009","00","190","0009","0231","206","67","139","3","209","729","0","28.67","9.19"
"10","009","00","190","0009","0232","198","71","127","4","202","744","0","27.15","9.54"
"10","009","00","190","0010","0000","396","157","239","8","404","1410","0","28.65","11.13"
"10","009","00","190","0010","0233","396","157","239","8","404","1410","0","28.65","11.13"
"10","009","00","190","0011","0000","139","38","101","5","144","511","0","28.18","7.44"
"10","009","00","190","0011","0234","139","38","101","5","144","511","0","28.18","7.44"
"10","009","00","190","0012","0000","426","163","263","8","434","1493","0","29.07","10.92"
"10","009","00","190","0012","0235","426","163","263","8","434","1493","0","29.07","10.92"
"10","009","00","190","0013","0000","255","92","163","5","260","806","0","32.26","11.41"
"10","009","00","190","0013","0236","255","92","163","5","260","806","0","32.26","11.41"
"10","009","00","190","0014","0000","637","101","536","9","646","1888","0","34.22","5.35"
"10","009","00","190","0014","0237","128","26","102","3","131","361","0","36.29","7.20"
"10","009","00","190","0014","0238","234","40","194","3","237","754","0","31.43","5.31"
"10","009","00","190","0014","0239","275","35","240","3","278","773","0","35.96","4.53"
"10","009","00","190","0015","0000","283","101","182","4","287","896","0","32.03","11.27"
"10","009","00","190","0015","0240","283","101","182","4","287","896","0","32.03","11.27"
"10","009","00","190","0016","0000","296","75","221","6","302","980","0","30.82","7.65"
"10","009","00","190","0016","0246","296","75","221","6","302","980","0","30.82","7.65"
"10","009","00","190","0017","0000","324","122","202","13","337","925","0","36.43","13.19"
"10","009","00","190","0017","0244","324","122","202","13","337","925","0","36.43","13.19"
"10","009","00","190","0018","0000","228","82","146","4","232","686","0","33.82","11.95"
"10","009","00","190","0018","0245","228","82","146","4","232","686","0","33.82","11.95"
"10","009","00","190","0019","0000","663","204","459","5","668","1773","0","37.68","11.51"
"10","009","00","190","0019","0241","364","95","269","4","368","920","0","40.00","10.33"
"10","009","00","190","0019","0242","299","109","190","1","300","853","0","35.17","12.78"
"10","009","00","190","0020","0000","483","113","370","6","489","1154","0","42.37","9.79"
"10","009","00","190","0020","0243","483","113","370","6","489","1154","0","42.37","9.79"
"10","009","00","190","0021","0000","183","78","105","6","189","595","0","31.76","13.11"
"10","009","00","190","0021","0247","183","78","105","6","189","595","0","31.76","13.11"
"10","009","00","200","0000","0000","7064","2142","4922","149","7213","21442","23934","33.64","9.99"
"10","009","00","200","0001","0000","652","226","426","6","658","2131","0","30.88","10.61"
"10","009","00","200","0001","0248","369","126","243","3","372","1274","0","29.20","9.89"
"10","009","00","200","0001","0249","283","100","183","3","286","857","0","33.37","11.67"
"10","009","00","200","0002","0000","721","244","477","9","730","1971","0","37.04","12.38"
"10","009","00","200","0002","0250","449","152","297","2","451","1238","0","36.43","12.28"
"10","009","00","200","0002","0251","272","92","180","7","279","733","0","38.06","12.55"
"10","009","00","200","0003","0000","354","86","268","7","361","969","0","37.25","8.88"
"10","009","00","200","0003","0271","354","86","268","7","361","969","0","37.25","8.88"
"10","009","00","200","0004","0000","409","95","314","4","413","1149","0","35.94","8.27"
"10","009","00","200","0004","0272","409","95","314","4","413","1149","0","35.94","8.27"
"10","009","00","200","0005","0000","314","92","222","7","321","944","0","34.00","9.75"
"10","009","00","200","0005","0258","314","92","222","7","321","944","0","34.00","9.75"
"10","009","00","200","0006","0000","196","80","116","3","199","598","0","33.28","13.38"
"10","009","00","200","0006","0259","196","80","116","3","199","598","0","33.28","13.38"
"10","009","00","200","0007","0000","182","68","114","4","186","597","0","31.16","11.39"
"10","009","00","200","0007","0260","182","68","114","4","186","597","0","31.16","11.39"
"10","009","00","200","0008","0000","298","81","217","5","303","943","0","32.13","8.59"
"10","009","00","200","0008","0261","298","81","217","5","303","943","0","32.13","8.59"
"10","009","00","200","0009","0000","175","83","92","7","182","603","0","30.18","13.76"
"10","009","00","200","0009","0262","175","83","92","7","182","603","0","30.18","13.76"
"10","009","00","200","0010","0000","288","106","182","3","291","905","0","32.15","11.71"
"10","009","00","200","0010","0263","288","106","182","3","291","905","0","32.15","11.71"
"10","009","00","200","0011","0000","209","53","156","5","214","680","0","31.47","7.79"
"10","009","00","200","0011","0252","209","53","156","5","214","680","0","31.47","7.79"
"10","009","00","200","0012","0000","202","47","155","2","204","627","0","32.54","7.50"
"10","009","00","200","0012","0253","202","47","155","2","204","627","0","32.54","7.50"
"10","009","00","200","0013","0000","360","99","261","7","367","1006","0","36.48","9.84"
"10","009","00","200","0013","0256","360","99","261","7","367","1006","0","36.48","9.84"
"10","009","00","200","0014","0000","338","101","237","9","347","967","0","35.88","10.44"
"10","009","00","200","0014","0254","338","101","237","9","347","967","0","35.88","10.44"
"10","009","00","200","0015","0000","264","79","185","7","271","803","0","33.75","9.84"
"10","009","00","200","0015","0255","264","79","185","7","271","803","0","33.75","9.84"
"10","009","00","200","0016","0000","319","92","227","6","325","927","0","35.06","9.92"
"10","009","00","200","0016","0264","319","92","227","6","325","927","0","35.06","9.92"
"10","009","00","200","0017","0000","244","66","178","7","251","776","0","32.35","8.51"
"10","009","00","200","0017","0265","244","66","178","7","251","776","0","32.35","8.51"
"10","009","00","200","0018","0000","280","111","169","11","291","989","0","29.42","11.22"
"10","009","00","200","0018","0266","280","111","169","11","291","989","0","29.42","11.22"
"10","009","00","200","0019","0000","188","47","141","1","189","484","0","39.05","9.71"
"10","009","00","200","0019","0267","188","47","141","1","189","484","0","39.05","9.71"
"10","009","00","200","0020","0000","193","41","152","7","200","647","0","30.91","6.34"
"10","009","00","200","0020","0268","193","41","152","7","200","647","0","30.91","6.34"
"10","009","00","200","0021","0000","223","39","184","6","229","655","0","34.96","5.95"
"10","009","00","200","0021","0269","223","39","184","6","229","655","0","34.96","5.95"
"10","009","00","200","0022","0000","188","40","148","5","193","653","0","29.56","6.13"
"10","009","00","200","0022","0270","188","40","148","5","193","653","0","29.56","6.13"
"10","009","00","200","0023","0000","225","75","150","6","231","653","0","35.38","11.49"
"10","009","00","200","0023","0257","225","75","150","6","231","653","0","35.38","11.49"
"10","009","00","200","0024","0000","242","91","151","15","257","765","0","33.59","11.90"
"10","009","00","200","0024","0273","242","91","151","15","257","765","0","33.59","11.90"
"10","010","00","000","0000","0000","163888","63301","100587","2060","165948","436894","496440","37.98","14.49"
"10","010","00","010","0000","0000","12478","4754","7724","113","12591","32207","38651","39.09","14.76"
"10","010","00","010","0001","0000","869","409","460","12","881","2315","0","38.06","17.67"
"10","010","00","010","0001","0094","471","244","227","5","476","1259","0","37.81","19.38"
"10","010","00","010","0001","0095","398","165","233","7","405","1056","0","38.35","15.63"
"10","010","00","010","0002","0000","190","46","144","0","190","466","0","40.77","9.87"
"10","010","00","010","0002","0096","190","46","144","0","190","466","0","40.77","9.87"
"10","010","00","010","0003","0000","616","200","416","6","622","1453","0","42.81","13.76"
"10","010","00","010","0003","0097","320","109","211","1","321","719","0","44.65","15.16"
"10","010","00","010","0003","0098","296","91","205","5","301","734","0","41.01","12.40"
"10","010","00","010","0004","0000","725","282","443","11","736","1685","0","43.68","16.74"
"10","010","00","010","0004","0099","356","131","225","6","362","754","0","48.01","17.37"
"10","010","00","010","0004","0100","369","151","218","5","374","931","0","40.17","16.22"
"10","010","00","010","0005","0000","474","189","285","7","481","1133","0","42.45","16.68"
"10","010","00","010","0005","0101","321","131","190","4","325","748","0","43.45","17.51"
"10","010","00","010","0005","0102","153","58","95","3","156","385","0","40.52","15.06"
"10","010","00","010","0006","0000","382","121","261","3","385","1105","0","34.84","10.95"
"10","010","00","010","0006","0103","382","121","261","3","385","1105","0","34.84","10.95"
"10","010","00","010","0007","0000","329","136","193","4","333","817","0","40.76","16.65"
"10","010","00","010","0007","0104","329","136","193","4","333","817","0","40.76","16.65"
"10","010","00","010","0008","0000","768","344","424","5","773","1799","0","42.97","19.12"
"10","010","00","010","0008","0109","372","148","224","2","374","916","0","40.83","16.16"
"10","010","00","010","0008","0110","396","196","200","3","399","883","0","45.19","22.20"
"10","010","00","010","0009","0000","489","152","337","8","497","1244","0","39.95","12.22"
"10","010","00","010","0009","0111","239","74","165","4","243","631","0","38.51","11.73"
"10","010","00","010","0009","0112","250","78","172","4","254","613","0","41.44","12.72"
"10","010","00","010","0010","0000","910","341","569","6","916","2556","0","35.84","13.34"
"10","010","00","010","0010","0113","296","95","201","1","297","818","0","36.31","11.61"
"10","010","00","010","0010","0114","614","246","368","5","619","1738","0","35.62","14.15"
"10","010","00","010","0011","0000","293","108","185","1","294","724","0","40.61","14.92"
"10","010","00","010","0011","0115","191","66","125","1","192","483","0","39.75","13.66"
"10","010","00","010","0011","0116","102","42","60","0","102","241","0","42.32","17.43"
"10","010","00","010","0012","0000","217","89","128","4","221","547","0","40.40","16.27"
"10","010","00","010","0012","0117","120","36","84","4","124","300","0","41.33","12.00"
"10","010","00","010","0012","0118","97","53","44","0","97","247","0","39.27","21.46"
"10","010","00","010","0013","0000","1394","489","905","11","1405","3489","0","40.27","14.02"
"10","010","00","010","0013","0119","455","122","333","4","459","1084","0","42.34","11.25"
"10","010","00","010","0013","0120","330","129","201","2","332","824","0","40.29","15.66"
"10","010","00","010","0013","0121","356","130","226","3","359","968","0","37.09","13.43"
"10","010","00","010","0013","0122","253","108","145","2","255","613","0","41.60","17.62"
"10","010","00","010","0014","0000","1680","624","1056","13","1693","4625","0","36.61","13.49"
"10","010","00","010","0014","0123","310","115","195","0","310","945","0","32.80","12.17"
"10","010","00","010","0014","0124","387","129","258","1","388","893","0","43.45","14.45"
"10","010","00","010","0014","0125","349","135","214","6","355","936","0","37.93","14.42"
"10","010","00","010","0014","0126","328","141","187","3","331","971","0","34.09","14.52"
"10","010","00","010","0014","0127","306","104","202","3","309","880","0","35.11","11.82"
"10","010","00","010","0015","0000","712","219","493","4","716","1819","0","39.36","12.04"
"10","010","00","010","0015","0128","316","91","225","2","318","811","0","39.21","11.22"
"10","010","00","010","0015","0129","396","128","268","2","398","1008","0","39.48","12.70"
"10","010","00","010","0016","0000","1117","394","723","10","1127","3112","0","36.21","12.66"
"10","010","00","010","0016","0130","446","133","313","3","449","1189","0","37.76","11.19"
"10","010","00","010","0016","0131","379","155","224","3","382","1142","0","33.45","13.57"
"10","010","00","010","0016","0132","292","106","186","4","296","781","0","37.90","13.57"
"10","010","00","010","0017","0000","271","107","164","3","274","679","0","40.35","15.76"
"10","010","00","010","0017","0133","271","107","164","3","274","679","0","40.35","15.76"
"10","010","00","010","0018","0000","1042","504","538","5","1047","2639","0","39.67","19.10"
"10","010","00","010","0018","0105","66","23","43","1","67","212","0","31.60","10.85"
"10","010","00","010","0018","0106","287","94","193","1","288","706","0","40.79","13.31"
"10","010","00","010","0018","0107","350","208","142","2","352","893","0","39.42","23.29"
"10","010","00","010","0018","0108","339","179","160","1","340","828","0","41.06","21.62"
"10","010","00","020","0000","0000","13479","5201","8278","149","13628","34834","41439","39.12","14.93"
"10","010","00","020","0001","0000","721","356","365","6","727","1887","0","38.53","18.87"
"10","010","00","020","0001","0058","439","229","210","3","442","1140","0","38.77","20.09"
"10","010","00","020","0001","0059","282","127","155","3","285","747","0","38.15","17.00"
"10","010","00","020","0002","0000","946","428","518","6","952","2322","0","41.00","18.43"
"10","010","00","020","0002","0060","474","221","253","4","478","1219","0","39.21","18.13"
"10","010","00","020","0002","0061","472","207","265","2","474","1103","0","42.97","18.77"
"10","010","00","020","0003","0000","482","177","305","2","484","1092","0","44.32","16.21"
"10","010","00","020","0003","0062","482","177","305","2","484","1092","0","44.32","16.21"
"10","010","00","020","0004","0000","178","63","115","1","179","377","0","47.48","16.71"
"10","010","00","020","0004","0063","178","63","115","1","179","377","0","47.48","16.71"
"10","010","00","020","0005","0000","262","109","153","1","263","610","0","43.11","17.87"
"10","010","00","020","0005","0064","262","109","153","1","263","610","0","43.11","17.87"
"10","010","00","020","0006","0000","293","131","162","5","298","618","0","48.22","21.20"
"10","010","00","020","0006","0065","293","131","162","5","298","618","0","48.22","21.20"
"10","010","00","020","0007","0000","327","139","188","2","329","819","0","40.17","16.97"
"10","010","00","020","0007","0066","327","139","188","2","329","819","0","40.17","16.97"
"10","010","00","020","0008","0000","704","309","395","5","709","1676","0","42.30","18.44"
"10","010","00","020","0008","0067","309","125","184","4","313","748","0","41.84","16.71"
"10","010","00","020","0008","0068","395","184","211","1","396","928","0","42.67","19.83"
"10","010","00","020","0009","0000","934","318","616","9","943","2498","0","37.75","12.73"
"10","010","00","020","0009","0069","444","177","267","2","446","1110","0","40.18","15.95"
"10","010","00","020","0009","0070","490","141","349","7","497","1388","0","35.81","10.16"
"10","010","00","020","0010","0000","1732","758","974","15","1747","4243","0","41.17","17.86"
"10","010","00","020","0010","0071","581","289","292","5","586","1536","0","38.15","18.82"
"10","010","00","020","0010","0072","496","192","304","5","501","1222","0","41.00","15.71"
"10","010","00","020","0010","0073","655","277","378","5","660","1485","0","44.44","18.65"
"10","010","00","020","0011","0000","241","85","156","0","241","669","0","36.02","12.71"
"10","010","00","020","0011","0074","241","85","156","0","241","669","0","36.02","12.71"
"10","010","00","020","0012","0000","187","65","122","5","192","608","0","31.58","10.69"
"10","010","00","020","0012","0075","187","65","122","5","192","608","0","31.58","10.69"
"10","010","00","020","0013","0000","270","87","183","5","275","768","0","35.81","11.33"
"10","010","00","020","0013","0076","270","87","183","5","275","768","0","35.81","11.33"
"10","010","00","020","0014","0000","410","110","300","4","414","1015","0","40.79","10.84"
"10","010","00","020","0014","0077","410","110","300","4","414","1015","0","40.79","10.84"
"10","010","00","020","0015","0000","671","288","383","5","676","1769","0","38.21","16.28"
"10","010","00","020","0015","0078","671","288","383","5","676","1769","0","38.21","16.28"
"10","010","00","020","0016","0000","1104","422","682","19","1123","3190","0","35.20","13.23"
"10","010","00","020","0016","0079","469","189","280","14","483","1385","0","34.87","13.65"
"10","010","00","020","0016","0080","323","146","177","0","323","888","0","36.37","16.44"
"10","010","00","020","0016","0081","312","87","225","5","317","917","0","34.57","9.49"
"10","010","00","020","0017","0000","1087","465","622","8","1095","2926","0","37.42","15.89"
"10","010","00","020","0017","0082","551","182","369","5","556","1583","0","35.12","11.50"
"10","010","00","020","0017","0083","536","283","253","3","539","1343","0","40.13","21.07"
"10","010","00","020","0018","0000","248","87","161","4","252","742","0","33.96","11.73"
"10","010","00","020","0018","0084","248","87","161","4","252","742","0","33.96","11.73"
"10","010","00","020","0019","0000","412","160","252","4","416","1040","0","40.00","15.38"
"10","010","00","020","0019","0085","412","160","252","4","416","1040","0","40.00","15.38"
"10","010","00","020","0020","0000","323","103","220","11","334","870","0","38.39","11.84"
"10","010","00","020","0020","0086","323","103","220","11","334","870","0","38.39","11.84"
"10","010","00","020","0021","0000","110","38","72","5","115","246","0","46.75","15.45"
"10","010","00","020","0021","0088","110","38","72","5","115","246","0","46.75","15.45"
"10","010","00","020","0022","0000","268","81","187","7","275","709","0","38.79","11.42"
"10","010","00","020","0022","0087","268","81","187","7","275","709","0","38.79","11.42"
"10","010","00","020","0023","0000","263","84","179","3","266","767","0","34.68","10.95"
"10","010","00","020","0023","0089","263","84","179","3","266","767","0","34.68","10.95"
"10","010","00","020","0024","0000","269","122","147","4","273","678","0","40.27","17.99"
"10","010","00","020","0024","0090","269","122","147","4","273","678","0","40.27","17.99"
"10","010","00","020","0025","0000","417","84","333","5","422","1019","0","41.41","8.24"
"10","010","00","020","0025","0091","417","84","333","5","422","1019","0","41.41","8.24"
"10","010","00","020","0026","0000","425","99","326","4","429","1190","0","36.05","8.32"
"10","010","00","020","0026","0092","425","99","326","4","429","1190","0","36.05","8.32"
"10","010","00","020","0027","0000","195","33","162","4","199","486","0","40.95","6.79"
"10","010","00","020","0027","0093","195","33","162","4","199","486","0","40.95","6.79"
"10","010","00","030","0000","0000","8328","3241","5087","133","8461","23144","25692","36.56","14.00"
"10","010","00","030","0001","0000","231","112","119","3","234","593","0","39.46","18.89"
"10","010","00","030","0001","0134","231","112","119","3","234","593","0","39.46","18.89"
"10","010","00","030","0002","0000","144","75","69","3","147","356","0","41.29","21.07"
"10","010","00","030","0002","0135","144","75","69","3","147","356","0","41.29","21.07"
"10","010","00","030","0003","0000","791","353","438","11","802","2143","0","37.42","16.47"
"10","010","00","030","0003","0136","341","155","186","10","351","918","0","38.24","16.88"
"10","010","00","030","0003","0137","450","198","252","1","451","1225","0","36.82","16.16"
"10","010","00","030","0004","0000","385","167","218","4","389","1064","0","36.56","15.70"
"10","010","00","030","0004","0138","385","167","218","4","389","1064","0","36.56","15.70"
"10","010","00","030","0005","0000","679","309","370","11","690","1593","0","43.31","19.40"
"10","010","00","030","0005","0139","392","178","214","6","398","939","0","42.39","18.96"
"10","010","00","030","0005","0140","287","131","156","5","292","654","0","44.65","20.03"
"10","010","00","030","0006","0000","301","106","195","1","302","860","0","35.12","12.33"
"10","010","00","030","0006","0141","301","106","195","1","302","860","0","35.12","12.33"
"10","010","00","030","0007","0000","196","92","104","9","205","683","0","30.01","13.47"
"10","010","00","030","0007","0142","196","92","104","9","205","683","0","30.01","13.47"
"10","010","00","030","0008","0000","229","99","130","3","232","742","0","31.27","13.34"
"10","010","00","030","0008","0143","229","99","130","3","232","742","0","31.27","13.34"
"10","010","00","030","0009","0000","387","105","282","14","401","920","0","43.59","11.41"
"10","010","00","030","0009","0158","387","105","282","14","401","920","0","43.59","11.41"
"10","010","00","030","0010","0000","381","146","235","4","385","1287","0","29.91","11.34"
"10","010","00","030","0010","0159","381","146","235","4","385","1287","0","29.91","11.34"
"10","010","00","030","0011","0000","758","281","477","7","765","2276","0","33.61","12.35"
"10","010","00","030","0011","0160","357","136","221","2","359","1070","0","33.55","12.71"
"10","010","00","030","0011","0161","401","145","256","5","406","1206","0","33.67","12.02"
"10","010","00","030","0012","0000","333","125","208","7","340","1106","0","30.74","11.30"
"10","010","00","030","0012","0162","333","125","208","7","340","1106","0","30.74","11.30"
"10","010","00","030","0013","0000","363","168","195","6","369","1090","0","33.85","15.41"
"10","010","00","030","0013","0151","363","168","195","6","369","1090","0","33.85","15.41"
"10","010","00","030","0014","0000","683","231","452","13","696","1861","0","37.40","12.41"
"10","010","00","030","0014","0152","342","99","243","5","347","924","0","37.55","10.71"
"10","010","00","030","0014","0153","341","132","209","8","349","937","0","37.25","14.09"
"10","010","00","030","0015","0000","106","45","61","0","106","281","0","37.72","16.01"
"10","010","00","030","0015","0154","106","45","61","0","106","281","0","37.72","16.01"
"10","010","00","030","0016","0000","139","57","82","4","143","385","0","37.14","14.81"
"10","010","00","030","0016","0155","139","57","82","4","143","385","0","37.14","14.81"
"10","010","00","030","0017","0000","127","45","82","0","127","288","0","44.10","15.63"
"10","010","00","030","0017","0156","57","23","34","0","57","117","0","48.72","19.66"
"10","010","00","030","0017","0157","70","22","48","0","70","171","0","40.94","12.87"
"10","010","00","030","0018","0000","237","124","113","5","242","713","0","33.94","17.39"
"10","010","00","030","0018","0144","237","124","113","5","242","713","0","33.94","17.39"
"10","010","00","030","0019","0000","420","165","255","6","426","1117","0","38.14","14.77"
"10","010","00","030","0019","0145","420","165","255","6","426","1117","0","38.14","14.77"
"10","010","00","030","0020","0000","540","168","372","6","546","1286","0","42.46","13.06"
"10","010","00","030","0020","0147","540","168","372","6","546","1286","0","42.46","13.06"
"10","010","00","030","0021","0000","470","139","331","6","476","1350","0","35.26","10.30"
"10","010","00","030","0021","0146","470","139","331","6","476","1350","0","35.26","10.30"
"10","010","00","030","0022","0000","193","67","126","6","199","518","0","38.42","12.93"
"10","010","00","030","0022","0148","116","41","75","2","118","270","0","43.70","15.19"
"10","010","00","030","0022","0149","77","26","51","4","81","248","0","32.66","10.48"
"10","010","00","030","0023","0000","235","62","173","4","239","632","0","37.82","9.81"
"10","010","00","030","0023","0150","235","62","173","4","239","632","0","37.82","9.81"
"10","010","00","040","0000","0000","10588","4344","6244","118","10706","26546","30237","40.33","16.36"
"10","010","00","040","0001","0000","216","89","127","1","217","467","0","46.47","19.06"
"10","010","00","040","0001","0274","216","89","127","1","217","467","0","46.47","19.06"
"10","010","00","040","0002","0000","813","344","469","5","818","1816","0","45.04","18.94"
"10","010","00","040","0002","0275","375","156","219","3","378","892","0","42.38","17.49"
"10","010","00","040","0002","0276","438","188","250","2","440","924","0","47.62","20.35"
"10","010","00","040","0003","0000","385","181","204","2","387","885","0","43.73","20.45"
"10","010","00","040","0003","0277","385","181","204","2","387","885","0","43.73","20.45"
"10","010","00","040","0004","0000","2380","1081","1299","15","2395","5889","0","40.67","18.36"
"10","010","00","040","0004","0278","592","241","351","3","595","1407","0","42.29","17.13"
"10","010","00","040","0004","0279","546","258","288","5","551","1394","0","39.53","18.51"
"10","010","00","040","0004","0280","611","249","362","3","614","1520","0","40.39","16.38"
"10","010","00","040","0004","0281","631","333","298","4","635","1568","0","40.50","21.24"
"10","010","00","040","0005","0000","477","169","308","9","486","1127","0","43.12","15.00"
"10","010","00","040","0005","0282","477","169","308","9","486","1127","0","43.12","15.00"
"10","010","00","040","0006","0000","657","297","360","8","665","1783","0","37.30","16.66"
"10","010","00","040","0006","0283","657","297","360","8","665","1783","0","37.30","16.66"
"10","010","00","040","0007","0000","268","68","200","1","269","595","0","45.21","11.43"
"10","010","00","040","0007","0284","268","68","200","1","269","595","0","45.21","11.43"
"10","010","00","040","0008","0000","258","64","194","4","262","703","0","37.27","9.10"
"10","010","00","040","0008","0285","258","64","194","4","262","703","0","37.27","9.10"
"10","010","00","040","0009","0000","266","93","173","3","269","612","0","43.95","15.20"
"10","010","00","040","0009","0286","266","93","173","3","269","612","0","43.95","15.20"
"10","010","00","040","0010","0000","73","39","34","2","75","184","0","40.76","21.20"
"10","010","00","040","0010","0287","73","39","34","2","75","184","0","40.76","21.20"
"10","010","00","040","0011","0000","552","243","309","5","557","1563","0","35.64","15.55"
"10","010","00","040","0011","0288","552","243","309","5","557","1563","0","35.64","15.55"
"10","010","00","040","0012","0000","522","203","319","10","532","1405","0","37.86","14.45"
"10","010","00","040","0012","0289","522","203","319","10","532","1405","0","37.86","14.45"
"10","010","00","040","0013","0000","528","204","324","6","534","1327","0","40.24","15.37"
"10","010","00","040","0013","0290","399","163","236","5","404","979","0","41.27","16.65"
"10","010","00","040","0013","0291","129","41","88","1","130","348","0","37.36","11.78"
"10","010","00","040","0014","0000","316","131","185","7","323","793","0","40.73","16.52"
"10","010","00","040","0014","0292","316","131","185","7","323","793","0","40.73","16.52"
"10","010","00","040","0015","0000","639","197","442","13","652","1546","0","42.17","12.74"
"10","010","00","040","0015","0293","639","197","442","13","652","1546","0","42.17","12.74"
"10","010","00","040","0016","0000","732","309","423","8","740","2009","0","36.83","15.38"
"10","010","00","040","0016","0294","367","171","196","4","371","961","0","38.61","17.79"
"10","010","00","040","0016","0295","365","138","227","4","369","1048","0","35.21","13.17"
"10","010","00","040","0017","0000","346","122","224","4","350","905","0","38.67","13.48"
"10","010","00","040","0017","0296","346","122","224","4","350","905","0","38.67","13.48"
"10","010","00","040","0018","0000","255","123","132","3","258","656","0","39.33","18.75"
"10","010","00","040","0018","0297","255","123","132","3","258","656","0","39.33","18.75"
"10","010","00","040","0019","0000","272","128","144","5","277","644","0","43.01","19.88"
"10","010","00","040","0019","0298","272","128","144","5","277","644","0","43.01","19.88"
"10","010","00","040","0020","0000","293","129","164","3","296","817","0","36.23","15.79"
"10","010","00","040","0020","0299","293","129","164","3","296","817","0","36.23","15.79"
"10","010","00","040","0021","0000","340","130","210","4","344","820","0","41.95","15.85"
"10","010","00","040","0021","0300","340","130","210","4","344","820","0","41.95","15.85"
"10","010","00","050","0000","0000","24030","9618","14412","275","24305","61483","71044","39.53","15.64"
"10","010","00","050","0001","0000","938","411","527","6","944","2300","0","41.04","17.87"
"10","010","00","050","0001","0358","558","244","314","4","562","1280","0","43.91","19.06"
"10","010","00","050","0001","0359","380","167","213","2","382","1020","0","37.45","16.37"
"10","010","00","050","0002","0000","676","329","347","7","683","1528","0","44.70","21.53"
"10","010","00","050","0002","0360","676","329","347","7","683","1528","0","44.70","21.53"
"10","010","00","050","0003","0000","1398","543","855","11","1409","3338","0","42.21","16.27"
"10","010","00","050","0003","0361","739","286","453","5","744","1664","0","44.71","17.19"
"10","010","00","050","0003","0362","659","257","402","6","665","1674","0","39.73","15.35"
"10","010","00","050","0004","0000","874","339","535","9","883","2158","0","40.92","15.71"
"10","010","00","050","0004","0363","474","150","324","5","479","1080","0","44.35","13.89"
"10","010","00","050","0004","0364","400","189","211","4","404","1078","0","37.48","17.53"
"10","010","00","050","0005","0000","676","233","443","9","685","1567","0","43.71","14.87"
"10","010","00","050","0005","0365","676","233","443","9","685","1567","0","43.71","14.87"
"10","010","00","050","0006","0000","641","260","381","8","649","1827","0","35.52","14.23"
"10","010","00","050","0006","0366","236","91","145","5","241","701","0","34.38","12.98"
"10","010","00","050","0006","0367","405","169","236","3","408","1126","0","36.23","15.01"
"10","010","00","050","0007","0000","565","244","321","8","573","1469","0","39.01","16.61"
"10","010","00","050","0007","0368","565","244","321","8","573","1469","0","39.01","16.61"
"10","010","00","050","0008","0000","688","189","499","11","699","1708","0","40.93","11.07"
"10","010","00","050","0008","0369","387","110","277","8","395","956","0","41.32","11.51"
"10","010","00","050","0008","0370","301","79","222","3","304","752","0","40.43","10.51"
"10","010","00","050","0009","0000","365","162","203","4","369","962","0","38.36","16.84"
"10","010","00","050","0009","0371","365","162","203","4","369","962","0","38.36","16.84"
"10","010","00","050","0010","0000","349","119","230","4","353","817","0","43.21","14.57"
"10","010","00","050","0010","0372","349","119","230","4","353","817","0","43.21","14.57"
"10","010","00","050","0011","0000","347","99","248","2","349","821","0","42.51","12.06"
"10","010","00","050","0011","0373","347","99","248","2","349","821","0","42.51","12.06"
"10","010","00","050","0012","0000","834","373","461","10","844","2163","0","39.02","17.24"
"10","010","00","050","0012","0374","661","304","357","6","667","1752","0","38.07","17.35"
"10","010","00","050","0012","0375","173","69","104","4","177","411","0","43.07","16.79"
"10","010","00","050","0013","0000","604","247","357","4","608","1346","0","45.17","18.35"
"10","010","00","050","0013","0376","604","247","357","4","608","1346","0","45.17","18.35"
"10","010","00","050","0014","0000","208","85","123","1","209","523","0","39.96","16.25"
"10","010","00","050","0014","0377","208","85","123","1","209","523","0","39.96","16.25"
"10","010","00","050","0015","0000","461","183","278","9","470","1154","0","40.73","15.86"
"10","010","00","050","0015","0378","461","183","278","9","470","1154","0","40.73","15.86"
"10","010","00","050","0016","0000","668","251","417","5","673","1837","0","36.64","13.66"
"10","010","00","050","0016","0396","317","116","201","2","319","955","0","33.40","12.15"
"10","010","00","050","0016","0397","351","135","216","3","354","882","0","40.14","15.31"
"10","010","00","050","0017","0000","930","379","551","13","943","2740","0","34.42","13.83"
"10","010","00","050","0017","0398","465","183","282","7","472","1292","0","36.53","14.16"
"10","010","00","050","0017","0399","465","196","269","6","471","1448","0","32.53","13.54"
"10","010","00","050","0018","0000","845","311","534","13","858","1995","0","43.01","15.59"
"10","010","00","050","0018","0402","414","152","262","7","421","907","0","46.42","16.76"
"10","010","00","050","0018","0403","431","159","272","6","437","1088","0","40.17","14.61"
"10","010","00","050","0019","0000","987","438","549","18","1005","2450","0","41.02","17.88"
"10","010","00","050","0019","0404","550","221","329","10","560","1361","0","41.15","16.24"
"10","010","00","050","0019","0405","437","217","220","8","445","1089","0","40.86","19.93"
"10","010","00","050","0020","0000","1372","487","885","26","1398","3513","0","39.80","13.86"
"10","010","00","050","0020","0406","471","148","323","7","478","1232","0","38.80","12.01"
"10","010","00","050","0020","0407","473","175","298","4","477","1148","0","41.55","15.24"
"10","010","00","050","0020","0408","428","164","264","15","443","1133","0","39.10","14.47"
"10","010","00","050","0021","0000","510","165","345","10","520","1281","0","40.59","12.88"
"10","010","00","050","0021","0409","510","165","345","10","520","1281","0","40.59","12.88"
"10","010","00","050","0022","0000","1936","798","1138","13","1949","5279","0","36.92","15.12"
"10","010","00","050","0022","0379","616","232","384","2","618","1494","0","41.37","15.53"
"10","010","00","050","0022","0380","591","257","334","5","596","1633","0","36.50","15.74"
"10","010","00","050","0022","0381","267","103","164","4","271","750","0","36.13","13.73"
"10","010","00","050","0022","0382","462","206","256","2","464","1402","0","33.10","14.69"
"10","010","00","050","0023","0000","952","466","486","12","964","2449","0","39.36","19.03"
"10","010","00","050","0023","0383","469","226","243","9","478","1211","0","39.47","18.66"
"10","010","00","050","0023","0384","483","240","243","3","486","1238","0","39.26","19.39"
"10","010","00","050","0024","0000","884","362","522","9","893","2361","0","37.82","15.33"
"10","010","00","050","0024","0390","381","153","228","5","386","1014","0","38.07","15.09"
"10","010","00","050","0024","0391","503","209","294","4","507","1347","0","37.64","15.52"
"10","010","00","050","0025","0000","1029","340","689","16","1045","2602","0","40.16","13.07"
"10","010","00","050","0025","0392","631","202","429","9","640","1639","0","39.05","12.32"
"10","010","00","050","0025","0393","398","138","260","7","405","963","0","42.06","14.33"
"10","010","00","050","0026","0000","591","228","363","5","596","1690","0","35.27","13.49"
"10","010","00","050","0026","0394","388","138","250","4","392","1051","0","37.30","13.13"
"10","010","00","050","0026","0395","203","90","113","1","204","639","0","31.92","14.08"
"10","010","00","050","0027","0000","1135","470","665","10","1145","2956","0","38.73","15.90"
"10","010","00","050","0027","0400","519","185","334","6","525","1372","0","38.27","13.48"
"10","010","00","050","0027","0401","616","285","331","4","620","1584","0","39.14","17.99"
"10","010","00","050","0028","0000","2567","1107","1460","22","2589","6649","0","38.94","16.65"
"10","010","00","050","0028","0385","486","229","257","4","490","1301","0","37.66","17.60"
"10","010","00","050","0028","0386","516","245","271","3","519","1338","0","38.79","18.31"
"10","010","00","050","0028","0387","535","226","309","2","537","1390","0","38.63","16.26"
"10","010","00","050","0028","0388","488","214","274","5","493","1281","0","38.49","16.71"
"10","010","00","050","0028","0389","542","193","349","8","550","1339","0","41.08","14.41"
"10","010","00","060","0000","0000","4786","1481","3305","66","4852","12575","13890","38.58","11.78"
"10","010","00","060","0001","0000","513","194","319","5","518","1277","0","40.56","15.19"
"10","010","00","060","0001","0257","513","194","319","5","518","1277","0","40.56","15.19"
"10","010","00","060","0002","0000","292","100","192","3","295","653","0","45.18","15.31"
"10","010","00","060","0002","0258","292","100","192","3","295","653","0","45.18","15.31"
"10","010","00","060","0003","0000","231","79","152","5","236","636","0","37.11","12.42"
"10","010","00","060","0003","0259","135","39","96","3","138","382","0","36.13","10.21"
"10","010","00","060","0003","0260","96","40","56","2","98","254","0","38.58","15.75"
"10","010","00","060","0004","0000","395","105","290","4","399","952","0","41.91","11.03"
"10","010","00","060","0004","0273","395","105","290","4","399","952","0","41.91","11.03"
"10","010","00","060","0005","0000","258","54","204","5","263","656","0","40.09","8.23"
"10","010","00","060","0005","0272","258","54","204","5","263","656","0","40.09","8.23"
"10","010","00","060","0006","0000","279","88","191","5","284","758","0","37.47","11.61"
"10","010","00","060","0006","0266","279","88","191","5","284","758","0","37.47","11.61"
"10","010","00","060","0007","0000","259","65","194","5","264","803","0","32.88","8.09"
"10","010","00","060","0007","0267","259","65","194","5","264","803","0","32.88","8.09"
"10","010","00","060","0008","0000","362","86","276","11","373","1113","0","33.51","7.73"
"10","010","00","060","0008","0268","362","86","276","11","373","1113","0","33.51","7.73"
"10","010","00","060","0009","0000","332","103","229","3","335","971","0","34.50","10.61"
"10","010","00","060","0009","0269","332","103","229","3","335","971","0","34.50","10.61"
"10","010","00","060","0010","0000","369","130","239","4","373","921","0","40.50","14.12"
"10","010","00","060","0010","0270","217","69","148","2","219","538","0","40.71","12.83"
"10","010","00","060","0010","0271","152","61","91","2","154","383","0","40.21","15.93"
"10","010","00","060","0011","0000","501","168","333","6","507","1264","0","40.11","13.29"
"10","010","00","060","0011","0261","342","135","207","5","347","885","0","39.21","15.25"
"10","010","00","060","0011","0262","159","33","126","1","160","379","0","42.22","8.71"
"10","010","00","060","0012","0000","395","123","272","3","398","1013","0","39.29","12.14"
"10","010","00","060","0012","0263","395","123","272","3","398","1013","0","39.29","12.14"
"10","010","00","060","0013","0000","243","75","168","2","245","680","0","36.03","11.03"
"10","010","00","060","0013","0264","243","75","168","2","245","680","0","36.03","11.03"
"10","010","00","060","0014","0000","357","111","246","5","362","878","0","41.23","12.64"
"10","010","00","060","0014","0265","357","111","246","5","362","878","0","41.23","12.64"
"10","010","00","070","0000","0000","10841","3446","7395","147","10988","27120","30952","40.52","12.71"
"10","010","00","070","0001","0000","984","421","563","8","992","2204","0","45.01","19.10"
"10","010","00","070","0001","0324","479","186","293","3","482","1059","0","45.51","17.56"
"10","010","00","070","0001","0325","505","235","270","5","510","1145","0","44.54","20.52"
"10","010","00","070","0002","0000","651","222","429","9","660","1541","0","42.83","14.41"
"10","010","00","070","0002","0326","312","116","196","1","313","701","0","44.65","16.55"
"10","010","00","070","0002","0327","339","106","233","8","347","840","0","41.31","12.62"
"10","010","00","070","0003","0000","587","210","377","4","591","1424","0","41.50","14.75"
"10","010","00","070","0003","0328","269","109","160","2","271","666","0","40.69","16.37"
"10","010","00","070","0003","0329","318","101","217","2","320","758","0","42.22","13.32"
"10","010","00","070","0004","0000","632","251","381","10","642","1618","0","39.68","15.51"
"10","010","00","070","0004","0330","320","134","186","3","323","783","0","41.25","17.11"
"10","010","00","070","0004","0331","312","117","195","7","319","835","0","38.20","14.01"
"10","010","00","070","0005","0000","528","110","418","9","537","1375","0","39.05","8.00"
"10","010","00","070","0005","0332","258","62","196","6","264","689","0","38.32","9.00"
"10","010","00","070","0005","0333","270","48","222","3","273","686","0","39.80","7.00"
"10","010","00","070","0006","0000","639","184","455","14","653","1582","0","41.28","11.63"
"10","010","00","070","0006","0334","305","96","209","5","310","742","0","41.78","12.94"
"10","010","00","070","0006","0335","334","88","246","9","343","840","0","40.83","10.48"
"10","010","00","070","0007","0000","630","183","447","8","638","1618","0","39.43","11.31"
"10","010","00","070","0007","0336","309","81","228","5","314","782","0","40.15","10.36"
"10","010","00","070","0007","0337","321","102","219","3","324","836","0","38.76","12.20"
"10","010","00","070","0008","0000","379","140","239","5","384","931","0","41.25","15.04"
"10","010","00","070","0008","0338","379","140","239","5","384","931","0","41.25","15.04"
"10","010","00","070","0009","0000","213","57","156","4","217","549","0","39.53","10.38"
"10","010","00","070","0009","0339","213","57","156","4","217","549","0","39.53","10.38"
"10","010","00","070","0010","0000","360","54","306","7","367","886","0","41.42","6.09"
"10","010","00","070","0010","0340","360","54","306","7","367","886","0","41.42","6.09"
"10","010","00","070","0011","0000","166","29","137","6","172","465","0","36.99","6.24"
"10","010","00","070","0011","0341","166","29","137","6","172","465","0","36.99","6.24"
"10","010","00","070","0012","0000","194","63","131","3","197","486","0","40.53","12.96"
"10","010","00","070","0012","0342","194","63","131","3","197","486","0","40.53","12.96"
"10","010","00","070","0013","0000","752","200","552","11","763","1627","0","46.90","12.29"
"10","010","00","070","0013","0343","348","87","261","6","354","785","0","45.10","11.08"
"10","010","00","070","0013","0344","404","113","291","5","409","842","0","48.57","13.42"
"10","010","00","070","0014","0000","587","158","429","6","593","1538","0","38.56","10.27"
"10","010","00","070","0014","0345","284","72","212","4","288","798","0","36.09","9.02"
"10","010","00","070","0014","0346","303","86","217","2","305","740","0","41.22","11.62"
"10","010","00","070","0015","0000","506","150","356","8","514","1308","0","39.30","11.47"
"10","010","00","070","0015","0347","257","76","181","2","259","624","0","41.51","12.18"
"10","010","00","070","0015","0348","249","74","175","6","255","684","0","37.28","10.82"
"10","010","00","070","0016","0000","556","237","319","5","561","1492","0","37.60","15.88"
"10","010","00","070","0016","0351","244","93","151","4","248","599","0","41.40","15.53"
"10","010","00","070","0016","0352","312","144","168","1","313","893","0","35.05","16.13"
"10","010","00","070","0017","0000","405","157","248","6","411","1023","0","40.18","15.35"
"10","010","00","070","0017","0350","405","157","248","6","411","1023","0","40.18","15.35"
"10","010","00","070","0018","0000","372","125","247","5","377","947","0","39.81","13.20"
"10","010","00","070","0018","0349","372","125","247","5","377","947","0","39.81","13.20"
"10","010","00","070","0019","0000","356","80","276","6","362","985","0","36.75","8.12"
"10","010","00","070","0019","0353","356","80","276","6","362","985","0","36.75","8.12"
"10","010","00","070","0020","0000","428","131","297","5","433","1118","0","38.73","11.72"
"10","010","00","070","0020","0354","428","131","297","5","433","1118","0","38.73","11.72"
"10","010","00","070","0021","0000","383","115","268","2","385","1017","0","37.86","11.31"
"10","010","00","070","0021","0355","383","115","268","2","385","1017","0","37.86","11.31"
"10","010","00","070","0022","0000","207","61","146","2","209","548","0","38.14","11.13"
"10","010","00","070","0022","0356","207","61","146","2","209","548","0","38.14","11.13"
"10","010","00","070","0023","0000","326","108","218","4","330","838","0","39.38","12.89"
"10","010","00","070","0023","0357","326","108","218","4","330","838","0","39.38","12.89"
"10","010","00","080","0000","0000","7343","2359","4984","116","7459","20088","21914","37.13","11.74"
"10","010","00","080","0001","0000","440","183","257","0","440","1127","0","39.04","16.24"
"10","010","00","080","0001","0001","440","183","257","0","440","1127","0","39.04","16.24"
"10","010","00","080","0002","0000","272","99","173","4","276","788","0","35.03","12.56"
"10","010","00","080","0002","0002","272","99","173","4","276","788","0","35.03","12.56"
"10","010","00","080","0003","0000","321","95","226","4","325","829","0","39.20","11.46"
"10","010","00","080","0003","0003","321","95","226","4","325","829","0","39.20","11.46"
"10","010","00","080","0004","0000","99","65","34","1","100","211","0","47.39","30.81"
"10","010","00","080","0004","0004","99","65","34","1","100","211","0","47.39","30.81"
"10","010","00","080","0005","0000","420","145","275","10","430","1153","0","37.29","12.58"
"10","010","00","080","0005","0005","420","145","275","10","430","1153","0","37.29","12.58"
"10","010","00","080","0006","0000","366","165","201","7","373","1165","0","32.02","14.16"
"10","010","00","080","0006","0006","366","165","201","7","373","1165","0","32.02","14.16"
"10","010","00","080","0007","0000","325","96","229","10","335","861","0","38.91","11.15"
"10","010","00","080","0007","0007","325","96","229","10","335","861","0","38.91","11.15"
"10","010","00","080","0008","0000","242","72","170","9","251","615","0","40.81","11.71"
"10","010","00","080","0008","0008","242","72","170","9","251","615","0","40.81","11.71"
"10","010","00","080","0009","0000","260","65","195","5","265","725","0","36.55","8.97"
"10","010","00","080","0009","0009","198","52","146","4","202","557","0","36.27","9.34"
"10","010","00","080","0009","0010","62","13","49","1","63","168","0","37.50","7.74"
"10","010","00","080","0010","0000","264","48","216","6","270","677","0","39.88","7.09"
"10","010","00","080","0010","0016","264","48","216","6","270","677","0","39.88","7.09"
"10","010","00","080","0011","0000","394","117","277","5","399","996","0","40.06","11.75"
"10","010","00","080","0011","0017","394","117","277","5","399","996","0","40.06","11.75"
"10","010","00","080","0012","0000","306","92","214","6","312","905","0","34.48","10.17"
"10","010","00","080","0012","0018","306","92","214","6","312","905","0","34.48","10.17"
"10","010","00","080","0013","0000","355","113","242","7","362","1019","0","35.53","11.09"
"10","010","00","080","0013","0019","355","113","242","7","362","1019","0","35.53","11.09"
"10","010","00","080","0014","0000","486","143","343","4","490","1433","0","34.19","9.98"
"10","010","00","080","0014","0020","486","143","343","4","490","1433","0","34.19","9.98"
"10","010","00","080","0015","0000","202","64","138","2","204","594","0","34.34","10.77"
"10","010","00","080","0015","0021","202","64","138","2","204","594","0","34.34","10.77"
"10","010","00","080","0016","0000","147","36","111","3","150","467","0","32.12","7.71"
"10","010","00","080","0016","0022","147","36","111","3","150","467","0","32.12","7.71"
"10","010","00","080","0017","0000","212","68","144","3","215","611","0","35.19","11.13"
"10","010","00","080","0017","0023","212","68","144","3","215","611","0","35.19","11.13"
"10","010","00","080","0018","0000","291","107","184","3","294","838","0","35.08","12.77"
"10","010","00","080","0018","0024","291","107","184","3","294","838","0","35.08","12.77"
"10","010","00","080","0019","0000","594","156","438","8","602","1392","0","43.25","11.21"
"10","010","00","080","0019","0011","103","17","86","1","104","204","0","50.98","8.33"
"10","010","00","080","0019","0012","114","26","88","2","116","235","0","49.36","11.06"
"10","010","00","080","0019","0013","134","40","94","0","134","362","0","37.02","11.05"
"10","010","00","080","0019","0014","243","73","170","5","248","591","0","41.96","12.35"
"10","010","00","080","0020","0000","214","62","152","7","221","578","0","38.24","10.73"
"10","010","00","080","0020","0015","214","62","152","7","221","578","0","38.24","10.73"
"10","010","00","080","0021","0000","269","118","151","2","271","734","0","36.92","16.08"
"10","010","00","080","0021","0025","269","118","151","2","271","734","0","36.92","16.08"
"10","010","00","080","0022","0000","169","58","111","5","174","521","0","33.40","11.13"
"10","010","00","080","0022","0026","169","58","111","5","174","521","0","33.40","11.13"
"10","010","00","080","0023","0000","237","72","165","2","239","627","0","38.12","11.48"
"10","010","00","080","0023","0027","237","72","165","2","239","627","0","38.12","11.48"
"10","010","00","080","0024","0000","265","56","209","1","266","659","0","40.36","8.50"
"10","010","00","080","0024","0028","265","56","209","1","266","659","0","40.36","8.50"
"10","010","00","080","0025","0000","193","64","129","2","195","563","0","34.64","11.37"
"10","010","00","080","0025","0029","154","50","104","2","156","440","0","35.45","11.36"
"10","010","00","080","0025","0030","39","14","25","0","39","123","0","31.71","11.38"
"10","010","00","090","0000","0000","7228","2785","4443","141","7369","21235","23594","34.70","13.12"
"10","010","00","090","0001","0000","668","239","429","14","682","1898","0","35.93","12.59"
"10","010","00","090","0001","0031","668","239","429","14","682","1898","0","35.93","12.59"
"10","010","00","090","0002","0000","296","110","186","10","306","922","0","33.19","11.93"
"10","010","00","090","0002","0032","296","110","186","10","306","922","0","33.19","11.93"
"10","010","00","090","0003","0000","419","161","258","4","423","1320","0","32.05","12.20"
"10","010","00","090","0003","0033","419","161","258","4","423","1320","0","32.05","12.20"
"10","010","00","090","0004","0000","543","242","301","5","548","1622","0","33.79","14.92"
"10","010","00","090","0004","0034","543","242","301","5","548","1622","0","33.79","14.92"
"10","010","00","090","0005","0000","323","125","198","10","333","1120","0","29.73","11.16"
"10","010","00","090","0005","0035","323","125","198","10","333","1120","0","29.73","11.16"
"10","010","00","090","0006","0000","208","88","120","4","212","701","0","30.24","12.55"
"10","010","00","090","0006","0036","208","88","120","4","212","701","0","30.24","12.55"
"10","010","00","090","0007","0000","139","55","84","5","144","388","0","37.11","14.18"
"10","010","00","090","0007","0037","139","55","84","5","144","388","0","37.11","14.18"
"10","010","00","090","0008","0000","291","164","127","12","303","839","0","36.11","19.55"
"10","010","00","090","0008","0038","291","164","127","12","303","839","0","36.11","19.55"
"10","010","00","090","0009","0000","317","107","210","7","324","857","0","37.81","12.49"
"10","010","00","090","0009","0039","317","107","210","7","324","857","0","37.81","12.49"
"10","010","00","090","0010","0000","252","72","180","8","260","714","0","36.41","10.08"
"10","010","00","090","0010","0040","252","72","180","8","260","714","0","36.41","10.08"
"10","010","00","090","0011","0000","143","53","90","1","144","368","0","39.13","14.40"
"10","010","00","090","0011","0041","78","27","51","0","78","169","0","46.15","15.98"
"10","010","00","090","0011","0042","65","26","39","1","66","199","0","33.17","13.07"
"10","010","00","090","0012","0000","260","149","111","4","264","957","0","27.59","15.57"
"10","010","00","090","0012","0043","260","149","111","4","264","957","0","27.59","15.57"
"10","010","00","090","0013","0000","469","169","300","9","478","1185","0","40.34","14.26"
"10","010","00","090","0013","0047","469","169","300","9","478","1185","0","40.34","14.26"
"10","010","00","090","0014","0000","271","91","180","8","279","821","0","33.98","11.08"
"10","010","00","090","0014","0048","271","91","180","8","279","821","0","33.98","11.08"
"10","010","00","090","0015","0000","221","84","137","0","221","650","0","34.00","12.92"
"10","010","00","090","0015","0049","221","84","137","0","221","650","0","34.00","12.92"
"10","010","00","090","0016","0000","243","86","157","9","252","795","0","31.70","10.82"
"10","010","00","090","0016","0050","243","86","157","9","252","795","0","31.70","10.82"
"10","010","00","090","0017","0000","227","87","140","8","235","670","0","35.07","12.99"
"10","010","00","090","0017","0051","122","47","75","5","127","358","0","35.47","13.13"
"10","010","00","090","0017","0052","105","40","65","3","108","312","0","34.62","12.82"
"10","010","00","090","0018","0000","409","145","264","8","417","1074","0","38.83","13.50"
"10","010","00","090","0018","0053","409","145","264","8","417","1074","0","38.83","13.50"
"10","010","00","090","0019","0000","331","82","249","4","335","893","0","37.51","9.18"
"10","010","00","090","0019","0054","331","82","249","4","335","893","0","37.51","9.18"
"10","010","00","090","0020","0000","372","159","213","4","376","1167","0","32.22","13.62"
"10","010","00","090","0020","0055","372","159","213","4","376","1167","0","32.22","13.62"
"10","010","00","090","0021","0000","326","137","189","1","327","757","0","43.20","18.10"
"10","010","00","090","0021","0056","171","56","115","1","172","414","0","41.55","13.53"
"10","010","00","090","0021","0057","155","81","74","0","155","343","0","45.19","23.62"
"10","010","00","090","0022","0000","84","35","49","2","86","284","0","30.28","12.32"
"10","010","00","090","0022","0044","84","35","49","2","86","284","0","30.28","12.32"
"10","010","00","090","0023","0000","416","145","271","4","420","1233","0","34.06","11.76"
"10","010","00","090","0023","0045","319","108","211","3","322","1008","0","31.94","10.71"
"10","010","00","090","0023","0046","97","37","60","1","98","225","0","43.56","16.44"
"10","010","00","100","0000","0000","6187","2264","3923","122","6309","15973","17439","39.50","14.17"
"10","010","00","100","0001","0000","259","94","165","7","266","663","0","40.12","14.18"
"10","010","00","100","0001","0163","166","59","107","5","171","444","0","38.51","13.29"
"10","010","00","100","0001","0164","93","35","58","2","95","219","0","43.38","15.98"
"10","010","00","100","0002","0000","600","205","395","14","614","1416","0","43.36","14.48"
"10","010","00","100","0002","0165","362","118","244","6","368","782","0","47.06","15.09"
"10","010","00","100","0002","0166","238","87","151","8","246","634","0","38.80","13.72"
"10","010","00","100","0003","0000","454","195","259","7","461","1125","0","40.98","17.33"
"10","010","00","100","0003","0167","454","195","259","7","461","1125","0","40.98","17.33"
"10","010","00","100","0004","0000","355","159","196","3","358","829","0","43.18","19.18"
"10","010","00","100","0004","0168","355","159","196","3","358","829","0","43.18","19.18"
"10","010","00","100","0005","0000","280","108","172","7","287","749","0","38.32","14.42"
"10","010","00","100","0005","0169","280","108","172","7","287","749","0","38.32","14.42"
"10","010","00","100","0006","0000","463","150","313","12","475","1195","0","39.75","12.55"
"10","010","00","100","0006","0170","463","150","313","12","475","1195","0","39.75","12.55"
"10","010","00","100","0007","0000","148","54","94","1","149","368","0","40.49","14.67"
"10","010","00","100","0007","0171","148","54","94","1","149","368","0","40.49","14.67"
"10","010","00","100","0008","0000","171","81","90","6","177","412","0","42.96","19.66"
"10","010","00","100","0008","0172","128","60","68","2","130","312","0","41.67","19.23"
"10","010","00","100","0008","0173","43","21","22","4","47","100","0","47.00","21.00"
"10","010","00","100","0009","0000","321","137","184","8","329","721","0","45.63","19.00"
"10","010","00","100","0009","0174","321","137","184","8","329","721","0","45.63","19.00"
"10","010","00","100","0010","0000","173","53","120","1","174","422","0","41.23","12.56"
"10","010","00","100","0010","0175","173","53","120","1","174","422","0","41.23","12.56"
"10","010","00","100","0011","0000","183","83","100","5","188","417","0","45.08","19.90"
"10","010","00","100","0011","0176","183","83","100","5","188","417","0","45.08","19.90"
"10","010","00","100","0012","0000","246","96","150","6","252","591","0","42.64","16.24"
"10","010","00","100","0012","0177","246","96","150","6","252","591","0","42.64","16.24"
"10","010","00","100","0013","0000","479","179","300","6","485","1447","0","33.52","12.37"
"10","010","00","100","0013","0178","180","63","117","4","184","537","0","34.26","11.73"
"10","010","00","100","0013","0179","299","116","183","2","301","910","0","33.08","12.75"
"10","010","00","100","0014","0000","241","92","149","4","245","826","0","29.66","11.14"
"10","010","00","100","0014","0180","241","92","149","4","245","826","0","29.66","11.14"
"10","010","00","100","0015","0000","263","69","194","2","265","777","0","34.11","8.88"
"10","010","00","100","0015","0181","263","69","194","2","265","777","0","34.11","8.88"
"10","010","00","100","0016","0000","286","58","228","11","297","796","0","37.31","7.29"
"10","010","00","100","0016","0182","286","58","228","11","297","796","0","37.31","7.29"
"10","010","00","100","0017","0000","148","50","98","2","150","422","0","35.55","11.85"
"10","010","00","100","0017","0183","148","50","98","2","150","422","0","35.55","11.85"
"10","010","00","100","0018","0000","182","92","90","8","190","520","0","36.54","17.69"
"10","010","00","100","0018","0184","182","92","90","8","190","520","0","36.54","17.69"
"10","010","00","100","0019","0000","292","98","194","3","295","724","0","40.75","13.54"
"10","010","00","100","0019","0185","239","82","157","2","241","589","0","40.92","13.92"
"10","010","00","100","0019","0186","53","16","37","1","54","135","0","40.00","11.85"
"10","010","00","100","0020","0000","151","54","97","1","152","363","0","41.87","14.88"
"10","010","00","100","0020","0187","151","54","97","1","152","363","0","41.87","14.88"
"10","010","00","100","0021","0000","196","68","128","5","201","554","0","36.28","12.27"
"10","010","00","100","0021","0188","196","68","128","5","201","554","0","36.28","12.27"
"10","010","00","100","0022","0000","296","89","207","3","299","636","0","47.01","13.99"
"10","010","00","100","0022","0189","231","77","154","3","234","518","0","45.17","14.86"
"10","010","00","100","0022","0190","65","12","53","0","65","118","0","55.08","10.17"
"10","010","00","110","0000","0000","5038","1743","3295","65","5103","13469","14778","37.89","12.94"
"10","010","00","110","0001","0000","177","49","128","3","180","512","0","35.16","9.57"
"10","010","00","110","0001","0191","177","49","128","3","180","512","0","35.16","9.57"
"10","010","00","110","0002","0000","218","61","157","2","220","540","0","40.74","11.30"
"10","010","00","110","0002","0192","218","61","157","2","220","540","0","40.74","11.30"
"10","010","00","110","0003","0000","463","169","294","3","466","1289","0","36.15","13.11"
"10","010","00","110","0003","0193","463","169","294","3","466","1289","0","36.15","13.11"
"10","010","00","110","0004","0000","479","208","271","5","484","1319","0","36.69","15.77"
"10","010","00","110","0004","0194","479","208","271","5","484","1319","0","36.69","15.77"
"10","010","00","110","0005","0000","178","80","98","2","180","736","0","24.46","10.87"
"10","010","00","110","0005","0195","108","43","65","2","110","322","0","34.16","13.35"
"10","010","00","110","0005","0196","70","37","33","0","70","414","0","16.91","8.94"
"10","010","00","110","0006","0000","396","126","270","3","399","1002","0","39.82","12.57"
"10","010","00","110","0006","0197","396","126","270","3","399","1002","0","39.82","12.57"
"10","010","00","110","0007","0000","157","42","115","4","161","427","0","37.70","9.84"
"10","010","00","110","0007","0198","157","42","115","4","161","427","0","37.70","9.84"
"10","010","00","110","0008","0000","325","85","240","8","333","799","0","41.68","10.64"
"10","010","00","110","0008","0199","325","85","240","8","333","799","0","41.68","10.64"
"10","010","00","110","0009","0000","384","108","276","3","387","982","0","39.41","11.00"
"10","010","00","110","0009","0200","384","108","276","3","387","982","0","39.41","11.00"
"10","010","00","110","0010","0000","333","140","193","2","335","937","0","35.75","14.94"
"10","010","00","110","0010","0201","333","140","193","2","335","937","0","35.75","14.94"
"10","010","00","110","0011","0000","297","127","170","3","300","927","0","32.36","13.70"
"10","010","00","110","0011","0202","297","127","170","3","300","927","0","32.36","13.70"
"10","010","00","110","0012","0000","342","88","254","8","350","895","0","39.11","9.83"
"10","010","00","110","0012","0203","237","62","175","7","244","639","0","38.18","9.70"
"10","010","00","110","0012","0204","105","26","79","1","106","256","0","41.41","10.16"
"10","010","00","110","0013","0000","437","150","287","6","443","1126","0","39.34","13.32"
"10","010","00","110","0013","0205","304","100","204","4","308","842","0","36.58","11.88"
"10","010","00","110","0013","0206","133","50","83","2","135","284","0","47.54","17.61"
"10","010","00","110","0014","0000","576","187","389","9","585","1379","0","42.42","13.56"
"10","010","00","110","0014","0207","414","122","292","9","423","1004","0","42.13","12.15"
"10","010","00","110","0014","0208","162","65","97","0","162","375","0","43.20","17.33"
"10","010","00","110","0015","0000","276","123","153","4","280","599","0","46.74","20.53"
"10","010","00","110","0015","0209","144","71","73","1","145","323","0","44.89","21.98"
"10","010","00","110","0015","0210","132","52","80","3","135","276","0","48.91","18.84"
"10","010","00","120","0000","0000","17332","7001","10331","175","17507","43700","48786","40.06","16.02"
"10","010","00","120","0001","0000","1624","728","896","18","1642","4025","0","40.80","18.09"
"10","010","00","120","0001","0211","375","171","204","5","380","1017","0","37.36","16.81"
"10","010","00","120","0001","0212","453","195","258","4","457","1070","0","42.71","18.22"
"10","010","00","120","0001","0213","400","170","230","6","406","1069","0","37.98","15.90"
"10","010","00","120","0001","0214","396","192","204","3","399","869","0","45.91","22.09"
"10","010","00","120","0002","0000","1050","475","575","11","1061","2466","0","43.03","19.26"
"10","010","00","120","0002","0215","472","203","269","4","476","1129","0","42.16","17.98"
"10","010","00","120","0002","0216","578","272","306","7","585","1337","0","43.75","20.34"
"10","010","00","120","0003","0000","779","251","528","6","785","1615","0","48.61","15.54"
"10","010","00","120","0003","0224","318","114","204","0","318","613","0","51.88","18.60"
"10","010","00","120","0003","0225","309","93","216","4","313","640","0","48.91","14.53"
"10","010","00","120","0003","0226","152","44","108","2","154","362","0","42.54","12.15"
"10","010","00","120","0004","0000","789","266","523","4","793","2073","0","38.25","12.83"
"10","010","00","120","0004","0227","380","128","252","3","383","1025","0","37.37","12.49"
"10","010","00","120","0004","0228","409","138","271","1","410","1048","0","39.12","13.17"
"10","010","00","120","0005","0000","344","104","240","4","348","782","0","44.50","13.30"
"10","010","00","120","0005","0229","344","104","240","4","348","782","0","44.50","13.30"
"10","010","00","120","0006","0000","607","273","334","10","617","1540","0","40.06","17.73"
"10","010","00","120","0006","0217","483","221","262","6","489","1235","0","39.60","17.89"
"10","010","00","120","0006","0218","124","52","72","4","128","305","0","41.97","17.05"
"10","010","00","120","0007","0000","745","335","410","9","754","1867","0","40.39","17.94"
"10","010","00","120","0007","0219","274","120","154","5","279","653","0","42.73","18.38"
"10","010","00","120","0007","0220","471","215","256","4","475","1214","0","39.13","17.71"
"10","010","00","120","0008","0000","679","323","356","6","685","1779","0","38.50","18.16"
"10","010","00","120","0008","0221","351","163","188","6","357","1023","0","34.90","15.93"
"10","010","00","120","0008","0222","328","160","168","0","328","756","0","43.39","21.16"
"10","010","00","120","0009","0000","181","83","98","3","184","427","0","43.09","19.44"
"10","010","00","120","0009","0223","181","83","98","3","184","427","0","43.09","19.44"
"10","010","00","120","0010","0000","241","149","92","4","245","614","0","39.90","24.27"
"10","010","00","120","0010","0233","241","149","92","4","245","614","0","39.90","24.27"
"10","010","00","120","0011","0000","213","92","121","1","214","384","0","55.73","23.96"
"10","010","00","120","0011","0234","213","92","121","1","214","384","0","55.73","23.96"
"10","010","00","120","0012","0000","520","179","341","3","523","1345","0","38.88","13.31"
"10","010","00","120","0012","0235","332","118","214","2","334","758","0","44.06","15.57"
"10","010","00","120","0012","0236","188","61","127","1","189","587","0","32.20","10.39"
"10","010","00","120","0013","0000","838","259","579","5","843","1915","0","44.02","13.52"
"10","010","00","120","0013","0230","449","134","315","3","452","1029","0","43.93","13.02"
"10","010","00","120","0013","0231","389","125","264","2","391","886","0","44.13","14.11"
"10","010","00","120","0014","0000","427","139","288","5","432","1028","0","42.02","13.52"
"10","010","00","120","0014","0232","427","139","288","5","432","1028","0","42.02","13.52"
"10","010","00","120","0015","0000","715","284","431","11","726","2028","0","35.80","14.00"
"10","010","00","120","0015","0239","302","121","181","8","310","893","0","34.71","13.55"
"10","010","00","120","0015","0240","413","163","250","3","416","1135","0","36.65","14.36"
"10","010","00","120","0016","0000","799","271","528","6","805","1983","0","40.60","13.67"
"10","010","00","120","0016","0241","469","162","307","4","473","1068","0","44.29","15.17"
"10","010","00","120","0016","0242","330","109","221","2","332","915","0","36.28","11.91"
"10","010","00","120","0017","0000","684","327","357","8","692","1782","0","38.83","18.35"
"10","010","00","120","0017","0237","327","144","183","5","332","804","0","41.29","17.91"
"10","010","00","120","0017","0238","357","183","174","3","360","978","0","36.81","18.71"
"10","010","00","120","0018","0000","1649","655","994","18","1667","4357","0","38.26","15.03"
"10","010","00","120","0018","0244","519","189","330","9","528","1373","0","38.46","13.77"
"10","010","00","120","0018","0245","571","224","347","7","578","1473","0","39.24","15.21"
"10","010","00","120","0018","0246","559","242","317","2","561","1511","0","37.13","16.02"
"10","010","00","120","0019","0000","1210","530","680","11","1221","2967","0","41.15","17.86"
"10","010","00","120","0019","0247","632","266","366","8","640","1505","0","42.52","17.67"
"10","010","00","120","0019","0248","578","264","314","3","581","1462","0","39.74","18.06"
"10","010","00","120","0020","0000","710","314","396","9","719","1853","0","38.80","16.95"
"10","010","00","120","0020","0252","430","182","248","4","434","1067","0","40.67","17.06"
"10","010","00","120","0020","0253","280","132","148","5","285","786","0","36.26","16.79"
"10","010","00","120","0021","0000","646","270","376","4","650","1779","0","36.54","15.18"
"10","010","00","120","0021","0250","407","166","241","3","410","1170","0","35.04","14.19"
"10","010","00","120","0021","0251","239","104","135","1","240","609","0","39.41","17.08"
"10","010","00","120","0022","0000","336","128","208","3","339","910","0","37.25","14.07"
"10","010","00","120","0022","0254","336","128","208","3","339","910","0","37.25","14.07"
"10","010","00","120","0023","0000","379","140","239","6","385","971","0","39.65","14.42"
"10","010","00","120","0023","0255","379","140","239","6","385","971","0","39.65","14.42"
"10","010","00","120","0024","0000","426","132","294","5","431","1239","0","34.79","10.65"
"10","010","00","120","0024","0256","426","132","294","5","431","1239","0","34.79","10.65"
"10","010","00","120","0025","0000","433","172","261","3","436","1179","0","36.98","14.59"
"10","010","00","120","0025","0243","433","172","261","3","436","1179","0","36.98","14.59"
"10","010","00","120","0026","0000","308","122","186","2","310","792","0","39.14","15.40"
"10","010","00","120","0026","0249","308","122","186","2","310","792","0","39.14","15.40"
"10","010","00","130","0000","0000","13982","5488","8494","151","14133","38789","43935","36.44","14.15"
"10","010","00","130","0001","0000","615","230","385","6","621","1790","0","34.69","12.85"
"10","010","00","130","0001","0465","249","86","163","3","252","670","0","37.61","12.84"
"10","010","00","130","0001","0466","366","144","222","3","369","1120","0","32.95","12.86"
"10","010","00","130","0002","0000","372","154","218","3","375","935","0","40.11","16.47"
"10","010","00","130","0002","0467","372","154","218","3","375","935","0","40.11","16.47"
"10","010","00","130","0003","0000","324","140","184","2","326","787","0","41.42","17.79"
"10","010","00","130","0003","0479","324","140","184","2","326","787","0","41.42","17.79"
"10","010","00","130","0004","0000","342","85","257","4","346","862","0","40.14","9.86"
"10","010","00","130","0004","0478","342","85","257","4","346","862","0","40.14","9.86"
"10","010","00","130","0005","0000","463","188","275","5","468","1500","0","31.20","12.53"
"10","010","00","130","0005","0468","238","99","139","4","242","770","0","31.43","12.86"
"10","010","00","130","0005","0469","225","89","136","1","226","730","0","30.96","12.19"
"10","010","00","130","0006","0000","1059","421","638","11","1070","2900","0","36.90","14.52"
"10","010","00","130","0006","0448","354","159","195","4","358","1046","0","34.23","15.20"
"10","010","00","130","0006","0449","317","116","201","3","320","816","0","39.22","14.22"
"10","010","00","130","0006","0450","388","146","242","4","392","1038","0","37.76","14.07"
"10","010","00","130","0007","0000","1234","486","748","15","1249","3322","0","37.60","14.63"
"10","010","00","130","0007","0451","513","221","292","8","521","1290","0","40.39","17.13"
"10","010","00","130","0007","0452","345","136","209","1","346","872","0","39.68","15.60"
"10","010","00","130","0007","0453","376","129","247","6","382","1160","0","32.93","11.12"
"10","010","00","130","0008","0000","2666","1151","1515","16","2682","7020","0","38.21","16.40"
"10","010","00","130","0008","0454","491","214","277","4","495","1391","0","35.59","15.38"
"10","010","00","130","0008","0455","517","261","256","4","521","1253","0","41.58","20.83"
"10","010","00","130","0008","0456","395","170","225","4","399","1081","0","36.91","15.73"
"10","010","00","130","0008","0457","505","201","304","2","507","1306","0","38.82","15.39"
"10","010","00","130","0008","0458","285","111","174","0","285","785","0","36.31","14.14"
"10","010","00","130","0008","0459","473","194","279","2","475","1204","0","39.45","16.11"
"10","010","00","130","0009","0000","2018","809","1209","34","2052","5652","0","36.31","14.31"
"10","010","00","130","0009","0460","414","171","243","4","418","1176","0","35.54","14.54"
"10","010","00","130","0009","0461","477","196","281","2","479","1344","0","35.64","14.58"
"10","010","00","130","0009","0462","333","137","196","5","338","981","0","34.45","13.97"
"10","010","00","130","0009","0463","366","171","195","9","375","971","0","38.62","17.61"
"10","010","00","130","0009","0464","428","134","294","14","442","1180","0","37.46","11.36"
"10","010","00","130","0010","0000","646","273","373","5","651","1825","0","35.67","14.96"
"10","010","00","130","0010","0470","259","120","139","3","262","771","0","33.98","15.56"
"10","010","00","130","0010","0471","387","153","234","2","389","1054","0","36.91","14.52"
"10","010","00","130","0011","0000","516","159","357","4","520","1490","0","34.90","10.67"
"10","010","00","130","0011","0472","210","58","152","1","211","574","0","36.76","10.10"
"10","010","00","130","0011","0473","306","101","205","3","309","916","0","33.73","11.03"
"10","010","00","130","0012","0000","716","289","427","7","723","2097","0","34.48","13.78"
"10","010","00","130","0012","0474","136","51","85","0","136","430","0","31.63","11.86"
"10","010","00","130","0012","0475","266","106","160","4","270","770","0","35.06","13.77"
"10","010","00","130","0012","0476","314","132","182","3","317","897","0","35.34","14.72"
"10","010","00","130","0013","0000","320","107","213","3","323","1020","0","31.67","10.49"
"10","010","00","130","0013","0477","320","107","213","3","323","1020","0","31.67","10.49"
"10","010","00","130","0014","0000","412","163","249","8","420","1122","0","37.43","14.53"
"10","010","00","130","0014","0480","99","50","49","0","99","280","0","35.36","17.86"
"10","010","00","130","0014","0481","313","113","200","8","321","842","0","38.12","13.42"
"10","010","00","130","0015","0000","343","108","235","5","348","932","0","37.34","11.59"
"10","010","00","130","0015","0482","343","108","235","5","348","932","0","37.34","11.59"
"10","010","00","130","0016","0000","659","219","440","6","665","1851","0","35.93","11.83"
"10","010","00","130","0016","0483","446","154","292","5","451","1187","0","37.99","12.97"
"10","010","00","130","0016","0484","213","65","148","1","214","664","0","32.23","9.79"
"10","010","00","130","0017","0000","225","100","125","2","227","723","0","31.40","13.83"
"10","010","00","130","0017","0487","225","100","125","2","227","723","0","31.40","13.83"
"10","010","00","130","0018","0000","340","118","222","5","345","966","0","35.71","12.22"
"10","010","00","130","0018","0488","166","75","91","1","167","462","0","36.15","16.23"
"10","010","00","130","0018","0489","174","43","131","4","178","504","0","35.32","8.53"
"10","010","00","130","0019","0000","197","62","135","1","198","634","0","31.23","9.78"
"10","010","00","130","0019","0486","197","62","135","1","198","634","0","31.23","9.78"
"10","010","00","130","0020","0000","257","107","150","5","262","714","0","36.69","14.99"
"10","010","00","130","0020","0485","257","107","150","5","262","714","0","36.69","14.99"
"10","010","00","130","0021","0000","153","66","87","3","156","356","0","43.82","18.54"
"10","010","00","130","0021","0490","153","66","87","3","156","356","0","43.82","18.54"
"10","010","00","130","0022","0000","105","53","52","1","106","291","0","36.43","18.21"
"10","010","00","130","0022","0491","105","53","52","1","106","291","0","36.43","18.21"
"10","010","00","140","0000","0000","10834","4286","6548","139","10973","30617","34503","35.84","14.00"
"10","010","00","140","0001","0000","963","405","558","8","971","2455","0","39.55","16.50"
"10","010","00","140","0001","0410","491","186","305","3","494","1292","0","38.24","14.40"
"10","010","00","140","0001","0411","472","219","253","5","477","1163","0","41.01","18.83"
"10","010","00","140","0002","0000","726","273","453","11","737","2167","0","34.01","12.60"
"10","010","00","140","0002","0412","343","132","211","4","347","973","0","35.66","13.57"
"10","010","00","140","0002","0413","383","141","242","7","390","1194","0","32.66","11.81"
"10","010","00","140","0003","0000","233","101","132","3","236","750","0","31.47","13.47"
"10","010","00","140","0003","0414","233","101","132","3","236","750","0","31.47","13.47"
"10","010","00","140","0004","0000","307","82","225","7","314","813","0","38.62","10.09"
"10","010","00","140","0004","0415","307","82","225","7","314","813","0","38.62","10.09"
"10","010","00","140","0005","0000","500","165","335","10","510","1212","0","42.08","13.61"
"10","010","00","140","0005","0416","500","165","335","10","510","1212","0","42.08","13.61"
"10","010","00","140","0006","0000","295","110","185","4","299","603","0","49.59","18.24"
"10","010","00","140","0006","0417","295","110","185","4","299","603","0","49.59","18.24"
"10","010","00","140","0007","0000","309","103","206","1","310","1025","0","30.24","10.05"
"10","010","00","140","0007","0418","309","103","206","1","310","1025","0","30.24","10.05"
"10","010","00","140","0008","0000","1989","895","1094","18","2007","5214","0","38.49","17.17"
"10","010","00","140","0008","0419","500","208","292","8","508","1289","0","39.41","16.14"
"10","010","00","140","0008","0420","510","222","288","5","515","1341","0","38.40","16.55"
"10","010","00","140","0008","0421","251","115","136","2","253","634","0","39.91","18.14"
"10","010","00","140","0008","0422","517","252","265","3","520","1389","0","37.44","18.14"
"10","010","00","140","0008","0423","211","98","113","0","211","561","0","37.61","17.47"
"10","010","00","140","0009","0000","549","207","342","4","553","1401","0","39.47","14.78"
"10","010","00","140","0009","0424","549","207","342","4","553","1401","0","39.47","14.78"
"10","010","00","140","0010","0000","465","202","263","10","475","1362","0","34.88","14.83"
"10","010","00","140","0010","0425","465","202","263","10","475","1362","0","34.88","14.83"
"10","010","00","140","0011","0000","619","228","391","11","630","1562","0","40.33","14.60"
"10","010","00","140","0011","0426","619","228","391","11","630","1562","0","40.33","14.60"
"10","010","00","140","0012","0000","483","167","316","7","490","1738","0","28.19","9.61"
"10","010","00","140","0012","0427","202","81","121","4","206","759","0","27.14","10.67"
"10","010","00","140","0012","0428","281","86","195","3","284","979","0","29.01","8.78"
"10","010","00","140","0013","0000","177","76","101","3","180","611","0","29.46","12.44"
"10","010","00","140","0013","0431","177","76","101","3","180","611","0","29.46","12.44"
"10","010","00","140","0014","0000","308","129","179","4","312","998","0","31.26","12.93"
"10","010","00","140","0014","0429","101","30","71","1","102","334","0","30.54","8.98"
"10","010","00","140","0014","0430","207","99","108","3","210","664","0","31.63","14.91"
"10","010","00","140","0015","0000","295","152","143","6","301","851","0","35.37","17.86"
"10","010","00","140","0015","0432","176","79","97","2","178","464","0","38.36","17.03"
"10","010","00","140","0015","0433","119","73","46","4","123","387","0","31.78","18.86"
"10","010","00","140","0016","0000","216","91","125","2","218","624","0","34.94","14.58"
"10","010","00","140","0016","0434","216","91","125","2","218","624","0","34.94","14.58"
"10","010","00","140","0017","0000","607","183","424","9","616","1756","0","35.08","10.42"
"10","010","00","140","0017","0435","74","28","46","1","75","211","0","35.55","13.27"
"10","010","00","140","0017","0436","533","155","378","8","541","1545","0","35.02","10.03"
"10","010","00","140","0018","0000","219","87","132","5","224","626","0","35.78","13.90"
"10","010","00","140","0018","0437","219","87","132","5","224","626","0","35.78","13.90"
"10","010","00","140","0019","0000","157","63","94","0","157","416","0","37.74","15.14"
"10","010","00","140","0019","0438","157","63","94","0","157","416","0","37.74","15.14"
"10","010","00","140","0020","0000","633","226","407","9","642","1845","0","34.80","12.25"
"10","010","00","140","0020","0439","342","119","223","5","347","902","0","38.47","13.19"
"10","010","00","140","0020","0440","291","107","184","4","295","943","0","31.28","11.35"
"10","010","00","140","0021","0000","270","122","148","3","273","903","0","30.23","13.51"
"10","010","00","140","0021","0441","235","94","141","2","237","797","0","29.74","11.79"
"10","010","00","140","0021","0442","35","28","7","1","36","106","0","33.96","26.42"
"10","010","00","140","0022","0000","66","14","52","0","66","238","0","27.73","5.88"
"10","010","00","140","0022","0443","66","14","52","0","66","238","0","27.73","5.88"
"10","010","00","140","0023","0000","242","97","145","0","242","766","0","31.59","12.66"
"10","010","00","140","0023","0444","84","40","44","0","84","318","0","26.42","12.58"
"10","010","00","140","0023","0445","158","57","101","0","158","448","0","35.27","12.72"
"10","010","00","140","0024","0000","206","108","98","4","210","681","0","30.84","15.86"
"10","010","00","140","0024","0446","138","70","68","2","140","434","0","32.26","16.13"
"10","010","00","140","0024","0447","68","38","30","2","70","247","0","28.34","15.38"
"10","010","00","150","0000","0000","5627","2351","3276","73","5700","16554","18481","34.43","14.20"
"10","010","00","150","0001","0000","806","312","494","10","816","2182","0","37.40","14.30"
"10","010","00","150","0001","0301","374","147","227","3","377","962","0","39.19","15.28"
"10","010","00","150","0001","0302","432","165","267","7","439","1220","0","35.98","13.52"
"10","010","00","150","0002","0000","355","172","183","1","356","869","0","40.97","19.79"
"10","010","00","150","0002","0303","355","172","183","1","356","869","0","40.97","19.79"
"10","010","00","150","0003","0000","192","68","124","4","196","540","0","36.30","12.59"
"10","010","00","150","0003","0307","192","68","124","4","196","540","0","36.30","12.59"
"10","010","00","150","0004","0000","1542","627","915","22","1564","4337","0","36.06","14.46"
"10","010","00","150","0004","0304","447","173","274","6","453","1142","0","39.67","15.15"
"10","010","00","150","0004","0305","469","189","280","4","473","1353","0","34.96","13.97"
"10","010","00","150","0004","0306","626","265","361","12","638","1842","0","34.64","14.39"
"10","010","00","150","0005","0000","147","57","90","2","149","393","0","37.91","14.50"
"10","010","00","150","0005","0308","147","57","90","2","149","393","0","37.91","14.50"
"10","010","00","150","0006","0000","182","82","100","1","183","500","0","36.60","16.40"
"10","010","00","150","0006","0314","182","82","100","1","183","500","0","36.60","16.40"
"10","010","00","150","0007","0000","108","34","74","2","110","355","0","30.99","9.58"
"10","010","00","150","0007","0315","108","34","74","2","110","355","0","30.99","9.58"
"10","010","00","150","0008","0000","182","71","111","3","185","579","0","31.95","12.26"
"10","010","00","150","0008","0309","182","71","111","3","185","579","0","31.95","12.26"
"10","010","00","150","0009","0000","558","229","329","5","563","1618","0","34.80","14.15"
"10","010","00","150","0009","0311","279","111","168","3","282","848","0","33.25","13.09"
"10","010","00","150","0009","0312","279","118","161","2","281","770","0","36.49","15.32"
"10","010","00","150","0010","0000","205","79","126","5","210","548","0","38.32","14.42"
"10","010","00","150","0010","0310","205","79","126","5","210","548","0","38.32","14.42"
"10","010","00","150","0011","0000","223","88","135","3","226","814","0","27.76","10.81"
"10","010","00","150","0011","0313","223","88","135","3","226","814","0","27.76","10.81"
"10","010","00","150","0012","0000","139","64","75","1","140","488","0","28.69","13.11"
"10","010","00","150","0012","0316","139","64","75","1","140","488","0","28.69","13.11"
"10","010","00","150","0013","0000","84","38","46","0","84","275","0","30.55","13.82"
"10","010","00","150","0013","0319","84","38","46","0","84","275","0","30.55","13.82"
"10","010","00","150","0014","0000","152","87","65","1","153","414","0","36.96","21.01"
"10","010","00","150","0014","0317","152","87","65","1","153","414","0","36.96","21.01"
"10","010","00","150","0015","0000","208","108","100","5","213","703","0","30.30","15.36"
"10","010","00","150","0015","0320","208","108","100","5","213","703","0","30.30","15.36"
"10","010","00","150","0016","0000","181","111","70","3","184","610","0","30.16","18.20"
"10","010","00","150","0016","0321","181","111","70","3","184","610","0","30.16","18.20"
"10","010","00","150","0017","0000","238","93","145","4","242","929","0","26.05","10.01"
"10","010","00","150","0017","0322","137","36","101","3","140","525","0","26.67","6.86"
"10","010","00","150","0017","0323","101","57","44","1","102","404","0","25.25","14.11"
"10","010","00","150","0018","0000","125","31","94","1","126","400","0","31.50","7.75"
"10","010","00","150","0018","0318","125","31","94","1","126","400","0","31.50","7.75"
"10","010","00","160","0000","0000","3340","1506","1834","45","3385","9931","11097","34.09","15.16"
"10","010","00","160","0001","0000","438","228","210","6","444","1143","0","38.85","19.95"
"10","010","00","160","0001","0492","438","228","210","6","444","1143","0","38.85","19.95"
"10","010","00","160","0002","0000","168","73","95","1","169","440","0","38.41","16.59"
"10","010","00","160","0002","0493","168","73","95","1","169","440","0","38.41","16.59"
"10","010","00","160","0003","0000","410","165","245","3","413","1282","0","32.22","12.87"
"10","010","00","160","0003","0494","261","106","155","2","263","749","0","35.11","14.15"
"10","010","00","160","0003","0495","149","59","90","1","150","533","0","28.14","11.07"
"10","010","00","160","0004","0000","665","305","360","10","675","1748","0","38.62","17.45"
"10","010","00","160","0004","0496","325","152","173","7","332","898","0","36.97","16.93"
"10","010","00","160","0004","0497","340","153","187","3","343","850","0","40.35","18.00"
"10","010","00","160","0005","0000","296","117","179","3","299","835","0","35.81","14.01"
"10","010","00","160","0005","0498","296","117","179","3","299","835","0","35.81","14.01"
"10","010","00","160","0006","0000","311","143","168","3","314","849","0","36.98","16.84"
"10","010","00","160","0006","0499","311","143","168","3","314","849","0","36.98","16.84"
"10","010","00","160","0007","0000","406","172","234","7","413","1220","0","33.85","14.10"
"10","010","00","160","0007","0500","207","146","61","6","213","794","0","26.83","18.39"
"10","010","00","160","0007","0501","199","26","173","1","200","426","0","46.95","6.10"
"10","010","00","160","0008","0000","154","60","94","6","160","596","0","26.85","10.07"
"10","010","00","160","0008","0502","154","60","94","6","160","596","0","26.85","10.07"
"10","010","00","160","0009","0000","251","113","138","0","251","956","0","26.26","11.82"
"10","010","00","160","0009","0503","104","46","58","0","104","314","0","33.12","14.65"
"10","010","00","160","0009","0504","147","67","80","0","147","642","0","22.90","10.44"
"10","010","00","160","0010","0000","144","57","87","4","148","498","0","29.72","11.45"
"10","010","00","160","0010","0505","144","57","87","4","148","498","0","29.72","11.45"
"10","010","00","160","0011","0000","97","73","24","2","99","364","0","27.20","20.05"
"10","010","00","160","0011","0506","45","35","10","1","46","160","0","28.75","21.88"
"10","010","00","160","0011","0507","52","38","14","1","53","204","0","25.98","18.63"
"10","010","00","170","0000","0000","1002","443","559","12","1014","4008","4553","25.30","11.05"
"10","010","00","170","0001","0000","353","144","209","4","357","1448","0","24.65","9.94"
"10","010","00","170","0001","0521","190","83","107","2","192","723","0","26.56","11.48"
"10","010","00","170","0001","0522","163","61","102","2","165","725","0","22.76","8.41"
"10","010","00","170","0002","0000","171","59","112","3","174","650","0","26.77","9.08"
"10","010","00","170","0002","0523","76","34","42","2","78","342","0","22.81","9.94"
"10","010","00","170","0002","0524","95","25","70","1","96","308","0","31.17","8.12"
"10","010","00","170","0003","0000","118","64","54","0","118","420","0","28.10","15.24"
"10","010","00","170","0003","0525","44","25","19","0","44","181","0","24.31","13.81"
"10","010","00","170","0003","0526","74","39","35","0","74","239","0","30.96","16.32"
"10","010","00","170","0004","0000","183","82","101","5","188","923","0","20.37","8.88"
"10","010","00","170","0004","0527","93","28","65","1","94","484","0","19.42","5.79"
"10","010","00","170","0004","0528","56","37","19","0","56","196","0","28.57","18.88"
"10","010","00","170","0004","0529","34","17","17","4","38","243","0","15.64","7.00"
"10","010","00","170","0005","0000","177","94","83","0","177","567","0","31.22","16.58"
"10","010","00","170","0005","0530","177","94","83","0","177","567","0","31.22","16.58"
"10","010","00","180","0000","0000","1445","990","455","20","1465","4621","5455","31.70","21.42"
"10","010","00","180","0001","0000","110","62","48","1","111","367","0","30.25","16.89"
"10","010","00","180","0001","0508","110","62","48","1","111","367","0","30.25","16.89"
"10","010","00","180","0002","0000","62","49","13","3","65","184","0","35.33","26.63"
"10","010","00","180","0002","0509","62","49","13","3","65","184","0","35.33","26.63"
"10","010","00","180","0003","0000","42","28","14","0","42","142","0","29.58","19.72"
"10","010","00","180","0003","0510","42","28","14","0","42","142","0","29.58","19.72"
"10","010","00","180","0004","0000","82","50","32","1","83","316","0","26.27","15.82"
"10","010","00","180","0004","0511","57","33","24","0","57","235","0","24.26","14.04"
"10","010","00","180","0004","0512","25","17","8","1","26","81","0","32.10","20.99"
"10","010","00","180","0005","0000","129","99","30","1","130","292","0","44.52","33.90"
"10","010","00","180","0005","0514","129","99","30","1","130","292","0","44.52","33.90"
"10","010","00","180","0006","0000","82","51","31","1","83","303","0","27.39","16.83"
"10","010","00","180","0006","0513","82","51","31","1","83","303","0","27.39","16.83"
"10","010","00","180","0007","0000","247","192","55","4","251","819","0","30.65","23.44"
"10","010","00","180","0007","0516","247","192","55","4","251","819","0","30.65","23.44"
"10","010","00","180","0008","0000","299","178","121","8","307","939","0","32.69","18.96"
"10","010","00","180","0008","0515","299","178","121","8","307","939","0","32.69","18.96"
"10","010","00","180","0009","0000","86","70","16","0","86","244","0","35.25","28.69"
"10","010","00","180","0009","0517","86","70","16","0","86","244","0","35.25","28.69"
"10","010","00","180","0010","0000","131","103","28","0","131","472","0","27.75","21.82"
"10","010","00","180","0010","0518","131","103","28","0","131","472","0","27.75","21.82"
"10","010","00","180","0011","0000","93","68","25","1","94","289","0","32.53","23.53"
"10","010","00","180","0011","0519","93","68","25","1","94","289","0","32.53","23.53"
"10","010","00","180","0012","0000","82","40","42","0","82","254","0","32.28","15.75"
"10","010","00","180","0012","0520","82","40","42","0","82","254","0","32.28","15.75"
"10","013","00","000","0000","0000","278186","112053","166133","3104","281290","700254","807970","40.17","16.00"
"10","013","00","010","0000","0000","72417","33770","38647","679","73096","167496","196653","43.64","20.16"
"10","013","00","010","0012","0000","1142","434","708","9","1151","2604","0","44.20","16.67"
"10","013","00","010","0012","0006","568","199","369","3","571","1339","0","42.64","14.86"
"10","013","00","010","0012","0007","574","235","339","6","580","1265","0","45.85","18.58"
"10","013","00","010","0020","0000","598","262","336","5","603","1528","0","39.46","17.15"
"10","013","00","010","0020","0011","323","123","200","2","325","751","0","43.28","16.38"
"10","013","00","010","0020","0012","275","139","136","3","278","777","0","35.78","17.89"
"10","013","00","010","0021","0000","395","176","219","5","400","843","0","47.45","20.88"
"10","013","00","010","0021","0013","395","176","219","5","400","843","0","47.45","20.88"
"10","013","00","010","0022","0000","825","386","439","3","828","1836","0","45.10","21.02"
"10","013","00","010","0022","0029","416","182","234","3","419","906","0","46.25","20.09"
"10","013","00","010","0022","0030","409","204","205","0","409","930","0","43.98","21.94"
"10","013","00","010","0023","0000","1199","553","646","17","1216","2467","0","49.29","22.42"
"10","013","00","010","0023","0024","640","278","362","6","646","1277","0","50.59","21.77"
"10","013","00","010","0023","0025","559","275","284","11","570","1190","0","47.90","23.11"
"10","013","00","010","0024","0000","1641","817","824","13","1654","3454","0","47.89","23.65"
"10","013","00","010","0024","0026","460","254","206","5","465","1046","0","44.46","24.28"
"10","013","00","010","0024","0027","550","259","291","2","552","1134","0","48.68","22.84"
"10","013","00","010","0024","0028","631","304","327","6","637","1274","0","50.00","23.86"
"10","013","00","010","0025","0000","1717","811","906","9","1726","3905","0","44.20","20.77"
"10","013","00","010","0025","0021","577","268","309","2","579","1258","0","46.03","21.30"
"10","013","00","010","0025","0022","608","297","311","2","610","1325","0","46.04","22.42"
"10","013","00","010","0025","0023","532","246","286","5","537","1322","0","40.62","18.61"
"10","013","00","010","0026","0000","4207","2218","1989","29","4236","9028","0","46.92","24.57"
"10","013","00","010","0026","0014","590","310","280","3","593","1298","0","45.69","23.88"
"10","013","00","010","0026","0015","624","322","302","3","627","1358","0","46.17","23.71"
"10","013","00","010","0026","0016","635","337","298","8","643","1364","0","47.14","24.71"
"10","013","00","010","0026","0017","559","313","246","3","562","1259","0","44.64","24.86"
"10","013","00","010","0026","0018","598","326","272","2","600","1209","0","49.63","26.96"
"10","013","00","010","0026","0019","611","328","283","4","615","1281","0","48.01","25.60"
"10","013","00","010","0026","0020","590","282","308","6","596","1259","0","47.34","22.40"
"10","013","00","010","0027","0000","673","208","465","5","678","1482","0","45.75","14.04"
"10","013","00","010","0027","0037","673","208","465","5","678","1482","0","45.75","14.04"
"10","013","00","010","0028","0000","437","125","312","3","440","1032","0","42.64","12.11"
"10","013","00","010","0028","0036","437","125","312","3","440","1032","0","42.64","12.11"
"10","013","00","010","0029","0000","473","120","353","7","480","1115","0","43.05","10.76"
"10","013","00","010","0029","0038","473","120","353","7","480","1115","0","43.05","10.76"
"10","013","00","010","0030","0000","3123","1563","1560","31","3154","7115","0","44.33","21.97"
"10","013","00","010","0030","0031","634","309","325","7","641","1461","0","43.87","21.15"
"10","013","00","010","0030","0032","602","311","291","8","610","1435","0","42.51","21.67"
"10","013","00","010","0030","0033","690","354","336","4","694","1372","0","50.58","25.80"
"10","013","00","010","0030","0034","565","298","267","8","573","1426","0","40.18","20.90"
"10","013","00","010","0030","0035","632","291","341","4","636","1421","0","44.76","20.48"
"10","013","00","010","0031","0000","2269","968","1301","20","2289","5421","0","42.22","17.86"
"10","013","00","010","0031","0063","663","258","405","6","669","1449","0","46.17","17.81"
"10","013","00","010","0031","0064","580","212","368","7","587","1381","0","42.51","15.35"
"10","013","00","010","0031","0065","356","158","198","0","356","967","0","36.81","16.34"
"10","013","00","010","0031","0066","670","340","330","7","677","1624","0","41.69","20.94"
"10","013","00","010","0032","0000","238","78","160","3","241","510","0","47.25","15.29"
"10","013","00","010","0032","0067","238","78","160","3","241","510","0","47.25","15.29"
"10","013","00","010","0033","0000","1239","427","812","11","1250","2821","0","44.31","15.14"
"10","013","00","010","0033","0077","563","187","376","1","564","1223","0","46.12","15.29"
"10","013","00","010","0033","0078","676","240","436","10","686","1598","0","42.93","15.02"
"10","013","00","010","0034","0000","359","127","232","3","362","796","0","45.48","15.95"
"10","013","00","010","0034","0074","359","127","232","3","362","796","0","45.48","15.95"
"10","013","00","010","0035","0000","407","194","213","6","413","900","0","45.89","21.56"
"10","013","00","010","0035","0075","407","194","213","6","413","900","0","45.89","21.56"
"10","013","00","010","0036","0000","559","308","251","2","561","1173","0","47.83","26.26"
"10","013","00","010","0036","0079","559","308","251","2","561","1173","0","47.83","26.26"
"10","013","00","010","0037","0000","301","104","197","0","301","678","0","44.40","15.34"
"10","013","00","010","0037","0076","301","104","197","0","301","678","0","44.40","15.34"
"10","013","00","010","0038","0000","557","334","223","7","564","1104","0","51.09","30.25"
"10","013","00","010","0038","0080","557","334","223","7","564","1104","0","51.09","30.25"
"10","013","00","010","0039","0000","274","107","167","3","277","655","0","42.29","16.34"
"10","013","00","010","0039","0081","274","107","167","3","277","655","0","42.29","16.34"
"10","013","00","010","0040","0000","2903","1237","1666","28","2931","6960","0","42.11","17.77"
"10","013","00","010","0040","0082","507","184","323","5","512","1289","0","39.72","14.27"
"10","013","00","010","0040","0083","558","228","330","8","566","1403","0","40.34","16.25"
"10","013","00","010","0040","0084","641","301","340","6","647","1446","0","44.74","20.82"
"10","013","00","010","0040","0085","495","205","290","3","498","1314","0","37.90","15.60"
"10","013","00","010","0040","0086","702","319","383","6","708","1508","0","46.95","21.15"
"10","013","00","010","0041","0000","981","358","623","15","996","2467","0","40.37","14.51"
"10","013","00","010","0041","0060","560","165","395","9","569","1262","0","45.09","13.07"
"10","013","00","010","0041","0061","421","193","228","6","427","1205","0","35.44","16.02"
"10","013","00","010","0042","0000","670","200","470","9","679","1488","0","45.63","13.44"
"10","013","00","010","0042","0062","670","200","470","9","679","1488","0","45.63","13.44"
"10","013","00","010","0043","0000","931","329","602","8","939","2203","0","42.62","14.93"
"10","013","00","010","0043","0071","488","174","314","3","491","1183","0","41.50","14.71"
"10","013","00","010","0043","0072","443","155","288","5","448","1020","0","43.92","15.20"
"10","013","00","010","0044","0000","621","136","485","6","627","1481","0","42.34","9.18"
"10","013","00","010","0044","0073","621","136","485","6","627","1481","0","42.34","9.18"
"10","013","00","010","0045","0000","465","131","334","4","469","1083","0","43.31","12.10"
"10","013","00","010","0045","0068","465","131","334","4","469","1083","0","43.31","12.10"
"10","013","00","010","0046","0000","711","259","452","8","719","1791","0","40.15","14.46"
"10","013","00","010","0046","0069","338","145","193","1","339","870","0","38.97","16.67"
"10","013","00","010","0046","0070","373","114","259","7","380","921","0","41.26","12.38"
"10","013","00","010","0049","0000","839","294","545","13","852","1995","0","42.71","14.74"
"10","013","00","010","0049","0052","394","115","279","8","402","946","0","42.49","12.16"
"10","013","00","010","0049","0053","445","179","266","5","450","1049","0","42.90","17.06"
"10","013","00","010","0050","0000","449","179","270","5","454","1004","0","45.22","17.83"
"10","013","00","010","0050","0054","449","179","270","5","454","1004","0","45.22","17.83"
"10","013","00","010","0051","0000","522","133","389","8","530","1166","0","45.45","11.41"
"10","013","00","010","0051","0059","522","133","389","8","530","1166","0","45.45","11.41"
"10","013","00","010","0053","0000","3408","1572","1836","40","3448","8068","0","42.74","19.48"
"10","013","00","010","0053","0042","537","269","268","4","541","1239","0","43.66","21.71"
"10","013","00","010","0053","0043","498","235","263","4","502","1307","0","38.41","17.98"
"10","013","00","010","0053","0044","585","265","320","3","588","1390","0","42.30","19.06"
"10","013","00","010","0053","0045","587","230","357","6","593","1398","0","42.42","16.45"
"10","013","00","010","0053","0046","596","296","300","5","601","1359","0","44.22","21.78"
"10","013","00","010","0053","0047","605","277","328","18","623","1375","0","45.31","20.15"
"10","013","00","010","0054","0000","1212","443","769","12","1224","2872","0","42.62","15.42"
"10","013","00","010","0054","0057","604","231","373","6","610","1412","0","43.20","16.36"
"10","013","00","010","0054","0058","608","212","396","6","614","1460","0","42.05","14.52"
"10","013","00","010","0055","0000","1679","783","896","10","1689","4077","0","41.43","19.21"
"10","013","00","010","0055","0039","578","265","313","3","581","1334","0","43.55","19.87"
"10","013","00","010","0055","0040","531","263","268","2","533","1373","0","38.82","19.16"
"10","013","00","010","0055","0041","570","255","315","5","575","1370","0","41.97","18.61"
"10","013","00","010","0056","0000","839","301","538","6","845","1956","0","43.20","15.39"
"10","013","00","010","0056","0055","415","149","266","5","420","1031","0","40.74","14.45"
"10","013","00","010","0056","0056","424","152","272","1","425","925","0","45.95","16.43"
"10","013","00","010","0059","0000","760","378","382","2","762","1637","0","46.55","23.09"
"10","013","00","010","0059","0116","345","164","181","1","346","814","0","42.51","20.15"
"10","013","00","010","0059","0117","415","214","201","1","416","823","0","50.55","26.00"
"10","013","00","010","0060","0000","2001","1053","948","19","2020","4657","0","43.38","22.61"
"10","013","00","010","0060","0118","516","252","264","5","521","1164","0","44.76","21.65"
"10","013","00","010","0060","0119","427","215","212","1","428","1025","0","41.76","20.98"
"10","013","00","010","0060","0120","514","273","241","7","521","1229","0","42.39","22.21"
"10","013","00","010","0060","0121","544","313","231","6","550","1239","0","44.39","25.26"
"10","013","00","010","0061","0000","341","182","159","2","343","730","0","46.99","24.93"
"10","013","00","010","0061","0138","341","182","159","2","343","730","0","46.99","24.93"
"10","013","00","010","0062","0000","261","128","133","4","265","652","0","40.64","19.63"
"10","013","00","010","0062","0139","261","128","133","4","265","652","0","40.64","19.63"
"10","013","00","010","0063","0000","300","129","171","5","305","626","0","48.72","20.61"
"10","013","00","010","0063","0140","300","129","171","5","305","626","0","48.72","20.61"
"10","013","00","010","0064","0000","1972","1038","934","16","1988","4603","0","43.19","22.55"
"10","013","00","010","0064","0134","524","254","270","4","528","1118","0","47.23","22.72"
"10","013","00","010","0064","0135","490","256","234","5","495","1149","0","43.08","22.28"
"10","013","00","010","0064","0136","510","269","241","4","514","1203","0","42.73","22.36"
"10","013","00","010","0064","0137","448","259","189","3","451","1133","0","39.81","22.86"
"10","013","00","010","0065","0000","2023","1103","920","18","2041","5471","0","37.31","20.16"
"10","013","00","010","0065","0112","445","238","207","3","448","1773","0","25.27","13.42"
"10","013","00","010","0065","0113","499","283","216","3","502","1224","0","41.01","23.12"
"10","013","00","010","0065","0114","607","293","314","11","618","1310","0","47.18","22.37"
"10","013","00","010","0065","0115","472","289","183","1","473","1164","0","40.64","24.83"
"10","013","00","010","0066","0000","770","372","398","13","783","1912","0","40.95","19.46"
"10","013","00","010","0066","0106","379","177","202","8","387","913","0","42.39","19.39"
"10","013","00","010","0066","0107","391","195","196","5","396","999","0","39.64","19.52"
"10","013","00","010","0067","0000","984","456","528","14","998","2231","0","44.73","20.44"
"10","013","00","010","0067","0122","462","210","252","8","470","1085","0","43.32","19.35"
"10","013","00","010","0067","0123","522","246","276","6","528","1146","0","46.07","21.47"
"10","013","00","010","0068","0000","1085","500","585","11","1096","2284","0","47.99","21.89"
"10","013","00","010","0068","0132","613","289","324","5","618","1239","0","49.88","23.33"
"10","013","00","010","0068","0133","472","211","261","6","478","1045","0","45.74","20.19"
"10","013","00","010","0069","0000","2561","1293","1268","18","2579","6059","0","42.56","21.34"
"10","013","00","010","0069","0127","501","243","258","8","509","1220","0","41.72","19.92"
"10","013","00","010","0069","0128","546","296","250","2","548","1204","0","45.51","24.58"
"10","013","00","010","0069","0129","487","249","238","2","489","1196","0","40.89","20.82"
"10","013","00","010","0069","0130","510","276","234","2","512","1232","0","41.56","22.40"
"10","013","00","010","0069","0131","517","229","288","4","521","1207","0","43.16","18.97"
"10","013","00","010","0070","0000","1017","471","546","11","1028","2149","0","47.84","21.92"
"10","013","00","010","0070","0143","455","214","241","6","461","1001","0","46.05","21.38"
"10","013","00","010","0070","0144","562","257","305","5","567","1148","0","49.39","22.39"
"10","013","00","010","0071","0000","875","404","471","10","885","2058","0","43.00","19.63"
"10","013","00","010","0071","0110","461","182","279","8","469","1044","0","44.92","17.43"
"10","013","00","010","0071","0111","414","222","192","2","416","1014","0","41.03","21.89"
"10","013","00","010","0073","0000","5166","2972","2194","44","5210","12298","0","42.36","24.17"
"10","013","00","010","0073","0087","351","208","143","1","352","809","0","43.51","25.71"
"10","013","00","010","0073","0088","522","224","298","1","523","1266","0","41.31","17.69"
"10","013","00","010","0073","0089","501","273","228","2","503","1273","0","39.51","21.45"
"10","013","00","010","0073","0090","549","348","201","2","551","1346","0","40.94","25.85"
"10","013","00","010","0073","0091","512","273","239","10","522","1225","0","42.61","22.29"
"10","013","00","010","0073","0092","392","218","174","3","395","910","0","43.41","23.96"
"10","013","00","010","0073","0093","564","352","212","6","570","1392","0","40.95","25.29"
"10","013","00","010","0073","0094","605","358","247","7","612","1343","0","45.57","26.66"
"10","013","00","010","0073","0095","565","339","226","6","571","1310","0","43.59","25.88"
"10","013","00","010","0073","0096","605","379","226","6","611","1424","0","42.91","26.62"
"10","013","00","010","0074","0000","802","542","260","7","809","1655","0","48.88","32.75"
"10","013","00","010","0074","0108","401","263","138","3","404","810","0","49.88","32.47"
"10","013","00","010","0074","0109","401","279","122","4","405","845","0","47.93","33.02"
"10","013","00","010","0075","0000","4540","2685","1855","36","4576","11543","0","39.64","23.26"
"10","013","00","010","0075","0097","533","328","205","2","535","1434","0","37.31","22.87"
"10","013","00","010","0075","0098","456","275","181","9","465","1184","0","39.27","23.23"
"10","013","00","010","0075","0099","517","292","225","4","521","1320","0","39.47","22.12"
"10","013","00","010","0075","0100","547","329","218","4","551","1300","0","42.38","25.31"
"10","013","00","010","0075","0101","603","342","261","2","605","1430","0","42.31","23.92"
"10","013","00","010","0075","0102","502","288","214","3","505","1245","0","40.56","23.13"
"10","013","00","010","0075","0103","547","322","225","7","554","1388","0","39.91","23.20"
"10","013","00","010","0075","0104","277","178","99","4","281","773","0","36.35","23.03"
"10","013","00","010","0075","0105","558","331","227","1","559","1469","0","38.05","22.53"
"10","013","00","010","0076","0000","570","189","381","8","578","1324","0","43.66","14.27"
"10","013","00","010","0076","0124","570","189","381","8","578","1324","0","43.66","14.27"
"10","013","00","010","0077","0000","372","103","269","3","375","849","0","44.17","12.13"
"10","013","00","010","0077","0125","372","103","269","3","375","849","0","44.17","12.13"
"10","013","00","010","0078","0000","426","137","289","12","438","1089","0","40.22","12.58"
"10","013","00","010","0078","0126","426","137","289","12","438","1089","0","40.22","12.58"
"10","013","00","010","0079","0000","422","133","289","6","428","941","0","45.48","14.13"
"10","013","00","010","0079","0142","422","133","289","6","428","941","0","45.48","14.13"
"10","013","00","010","0080","0000","689","182","507","3","692","1560","0","44.36","11.67"
"10","013","00","010","0080","0141","689","182","507","3","692","1560","0","44.36","11.67"
"10","013","00","010","0081","0000","1252","928","324","12","1264","2890","0","43.74","32.11"
"10","013","00","010","0081","0048","599","486","113","6","605","1352","0","44.75","35.95"
"10","013","00","010","0081","0049","653","442","211","6","659","1538","0","42.85","28.74"
"10","013","00","010","0085","0000","538","175","363","1","539","1053","0","51.19","16.62"
"10","013","00","010","0085","0001","538","175","363","1","539","1053","0","51.19","16.62"
"10","013","00","010","0086","0000","289","150","139","7","296","675","0","43.85","22.22"
"10","013","00","010","0086","0002","289","150","139","7","296","675","0","43.85","22.22"
"10","013","00","010","0087","0000","629","262","367","6","635","1310","0","48.47","20.00"
"10","013","00","010","0087","0003","629","262","367","6","635","1310","0","48.47","20.00"
"10","013","00","010","0088","0000","555","217","338","6","561","1240","0","45.24","17.50"
"10","013","00","010","0088","0004","555","217","338","6","561","1240","0","45.24","17.50"
"10","013","00","010","0089","0000","305","100","205","2","307","654","0","46.94","15.29"
"10","013","00","010","0089","0005","305","100","205","2","307","654","0","46.94","15.29"
"10","013","00","010","0090","0000","602","207","395","5","607","1166","0","52.06","17.75"
"10","013","00","010","0090","0008","602","207","395","5","607","1166","0","52.06","17.75"
"10","013","00","010","0091","0000","487","192","295","2","489","1039","0","47.06","18.48"
"10","013","00","010","0091","0009","487","192","295","2","489","1039","0","47.06","18.48"
"10","013","00","010","0092","0000","508","185","323","7","515","1018","0","50.59","18.17"
"10","013","00","010","0092","0010","508","185","323","7","515","1018","0","50.59","18.17"
"10","013","00","010","0093","0000","216","124","92","1","217","525","0","41.33","23.62"
"10","013","00","010","0093","0050","216","124","92","1","217","525","0","41.33","23.62"
"10","013","00","010","0094","0000","236","105","131","5","241","520","0","46.35","20.19"
"10","013","00","010","0094","0051","236","105","131","5","241","520","0","46.35","20.19"
"10","013","00","020","0000","0000","18696","7607","11089","162","18858","46629","53851","40.44","16.31"
"10","013","00","020","0001","0000","224","124","100","2","226","505","0","44.75","24.55"
"10","013","00","020","0001","0145","224","124","100","2","226","505","0","44.75","24.55"
"10","013","00","020","0002","0000","297","103","194","5","302","582","0","51.89","17.70"
"10","013","00","020","0002","0151","297","103","194","5","302","582","0","51.89","17.70"
"10","013","00","020","0003","0000","547","220","327","8","555","1227","0","45.23","17.93"
"10","013","00","020","0003","0167","547","220","327","8","555","1227","0","45.23","17.93"
"10","013","00","020","0004","0000","415","160","255","2","417","983","0","42.42","16.28"
"10","013","00","020","0004","0166","415","160","255","2","417","983","0","42.42","16.28"
"10","013","00","020","0005","0000","1747","782","965","10","1757","4770","0","36.83","16.39"
"10","013","00","020","0005","0146","350","134","216","0","350","913","0","38.34","14.68"
"10","013","00","020","0005","0147","314","149","165","1","315","937","0","33.62","15.90"
"10","013","00","020","0005","0148","401","177","224","3","404","991","0","40.77","17.86"
"10","013","00","020","0005","0149","321","140","181","0","321","928","0","34.59","15.09"
"10","013","00","020","0005","0150","361","182","179","6","367","1001","0","36.66","18.18"
"10","013","00","020","0006","0000","375","108","267","3","378","859","0","44.00","12.57"
"10","013","00","020","0006","0152","375","108","267","3","378","859","0","44.00","12.57"
"10","013","00","020","0007","0000","2284","1029","1255","23","2307","5434","0","42.45","18.94"
"10","013","00","020","0007","0153","535","245","290","3","538","1261","0","42.66","19.43"
"10","013","00","020","0007","0154","683","293","390","7","690","1728","0","39.93","16.96"
"10","013","00","020","0007","0155","565","257","308","8","573","1254","0","45.69","20.49"
"10","013","00","020","0007","0156","501","234","267","5","506","1191","0","42.49","19.65"
"10","013","00","020","0008","0000","2766","1235","1531","18","2784","6463","0","43.08","19.11"
"10","013","00","020","0008","0157","508","210","298","4","512","1141","0","44.87","18.40"
"10","013","00","020","0008","0158","546","261","285","3","549","1347","0","40.76","19.38"
"10","013","00","020","0008","0159","588","270","318","3","591","1410","0","41.91","19.15"
"10","013","00","020","0008","0160","475","200","275","6","481","1097","0","43.85","18.23"
"10","013","00","020","0008","0161","649","294","355","2","651","1468","0","44.35","20.03"
"10","013","00","020","0009","0000","879","391","488","7","886","2106","0","42.07","18.57"
"10","013","00","020","0009","0162","358","155","203","4","362","868","0","41.71","17.86"
"10","013","00","020","0009","0163","521","236","285","3","524","1238","0","42.33","19.06"
"10","013","00","020","0010","0000","548","211","337","7","555","1387","0","40.01","15.21"
"10","013","00","020","0010","0168","548","211","337","7","555","1387","0","40.01","15.21"
"10","013","00","020","0011","0000","927","335","592","5","932","2401","0","38.82","13.95"
"10","013","00","020","0011","0169","523","211","312","1","524","1292","0","40.56","16.33"
"10","013","00","020","0011","0170","404","124","280","4","408","1109","0","36.79","11.18"
"10","013","00","020","0012","0000","921","360","561","7","928","2381","0","38.98","15.12"
"10","013","00","020","0012","0171","495","193","302","4","499","1336","0","37.35","14.45"
"10","013","00","020","0012","0172","426","167","259","3","429","1045","0","41.05","15.98"
"10","013","00","020","0013","0000","2667","1149","1518","18","2685","7120","0","37.71","16.14"
"10","013","00","020","0013","0173","423","157","266","1","424","1077","0","39.37","14.58"
"10","013","00","020","0013","0174","452","191","261","5","457","1240","0","36.85","15.40"
"10","013","00","020","0013","0175","474","223","251","2","476","1161","0","41.00","19.21"
"10","013","00","020","0013","0176","410","175","235","3","413","1106","0","37.34","15.82"
"10","013","00","020","0013","0177","467","196","271","2","469","1323","0","35.45","14.81"
"10","013","00","020","0013","0178","441","207","234","5","446","1213","0","36.77","17.07"
"10","013","00","020","0014","0000","452","191","261","3","455","1172","0","38.82","16.30"
"10","013","00","020","0014","0179","452","191","261","3","455","1172","0","38.82","16.30"
"10","013","00","020","0015","0000","553","215","338","8","561","1413","0","39.70","15.22"
"10","013","00","020","0015","0180","553","215","338","8","561","1413","0","39.70","15.22"
"10","013","00","020","0016","0000","313","107","206","1","314","881","0","35.64","12.15"
"10","013","00","020","0016","0181","313","107","206","1","314","881","0","35.64","12.15"
"10","013","00","020","0017","0000","169","61","108","0","169","468","0","36.11","13.03"
"10","013","00","020","0017","0182","169","61","108","0","169","468","0","36.11","13.03"
"10","013","00","020","0018","0000","623","177","446","11","634","1633","0","38.82","10.84"
"10","013","00","020","0018","0164","405","121","284","8","413","1149","0","35.94","10.53"
"10","013","00","020","0018","0165","218","56","162","3","221","484","0","45.66","11.57"
"10","013","00","020","0019","0000","695","252","443","7","702","1615","0","43.47","15.60"
"10","013","00","020","0019","0183","365","143","222","5","370","884","0","41.86","16.18"
"10","013","00","020","0019","0184","330","109","221","2","332","731","0","45.42","14.91"
"10","013","00","020","0020","0000","685","208","477","10","695","1694","0","41.03","12.28"
"10","013","00","020","0020","0185","324","93","231","6","330","900","0","36.67","10.33"
"10","013","00","020","0020","0186","361","115","246","4","365","794","0","45.97","14.48"
"10","013","00","020","0021","0000","609","189","420","7","616","1535","0","40.13","12.31"
"10","013","00","020","0021","0187","445","148","297","5","450","1185","0","37.97","12.49"
"10","013","00","020","0021","0188","164","41","123","2","166","350","0","47.43","11.71"
"10","013","00","030","0000","0000","15304","5115","10189","150","15454","39127","46590","39.50","13.07"
"10","013","00","030","0001","0000","950","309","641","7","957","1975","0","48.46","15.65"
"10","013","00","030","0001","0189","446","149","297","7","453","955","0","47.43","15.60"
"10","013","00","030","0001","0190","504","160","344","0","504","1020","0","49.41","15.69"
"10","013","00","030","0004","0000","242","92","150","1","243","631","0","38.51","14.58"
"10","013","00","030","0004","0192","242","92","150","1","243","631","0","38.51","14.58"
"10","013","00","030","0007","0000","594","164","430","9","603","1575","0","38.29","10.41"
"10","013","00","030","0007","0203","378","111","267","5","383","1022","0","37.48","10.86"
"10","013","00","030","0007","0204","216","53","163","4","220","553","0","39.78","9.58"
"10","013","00","030","0008","0000","330","113","217","3","333","734","0","45.37","15.40"
"10","013","00","030","0008","0205","330","113","217","3","333","734","0","45.37","15.40"
"10","013","00","030","0009","0000","435","145","290","6","441","1192","0","37.00","12.16"
"10","013","00","030","0009","0206","435","145","290","6","441","1192","0","37.00","12.16"
"10","013","00","030","0010","0000","239","82","157","3","242","559","0","43.29","14.67"
"10","013","00","030","0010","0207","239","82","157","3","242","559","0","43.29","14.67"
"10","013","00","030","0011","0000","490","125","365","5","495","1329","0","37.25","9.41"
"10","013","00","030","0011","0208","490","125","365","5","495","1329","0","37.25","9.41"
"10","013","00","030","0012","0000","702","180","522","8","710","1804","0","39.36","9.98"
"10","013","00","030","0012","0209","279","82","197","1","280","729","0","38.41","11.25"
"10","013","00","030","0012","0210","423","98","325","7","430","1075","0","40.00","9.12"
"10","013","00","030","0013","0000","1043","254","789","9","1052","2840","0","37.04","8.94"
"10","013","00","030","0013","0211","521","141","380","4","525","1361","0","38.57","10.36"
"10","013","00","030","0013","0212","522","113","409","5","527","1479","0","35.63","7.64"
"10","013","00","030","0014","0000","664","183","481","4","668","1680","0","39.76","10.89"
"10","013","00","030","0014","0213","333","78","255","3","336","817","0","41.13","9.55"
"10","013","00","030","0014","0214","331","105","226","1","332","863","0","38.47","12.17"
"10","013","00","030","0015","0000","530","203","327","6","536","1562","0","34.31","13.00"
"10","013","00","030","0015","0215","160","69","91","2","162","417","0","38.85","16.55"
"10","013","00","030","0015","0216","370","134","236","4","374","1145","0","32.66","11.70"
"10","013","00","030","0016","0000","2101","742","1359","17","2118","5363","0","39.49","13.84"
"10","013","00","030","0016","0217","410","123","287","6","416","1003","0","41.48","12.26"
"10","013","00","030","0016","0218","433","150","283","3","436","1017","0","42.87","14.75"
"10","013","00","030","0016","0219","354","155","199","4","358","998","0","35.87","15.53"
"10","013","00","030","0016","0220","392","150","242","1","393","1046","0","37.57","14.34"
"10","013","00","030","0016","0221","512","164","348","3","515","1299","0","39.65","12.63"
"10","013","00","030","0017","0000","787","170","617","17","804","1937","0","41.51","8.78"
"10","013","00","030","0017","0222","467","90","377","9","476","1201","0","39.63","7.49"
"10","013","00","030","0017","0223","320","80","240","8","328","736","0","44.57","10.87"
"10","013","00","030","0018","0000","594","183","411","6","600","1532","0","39.16","11.95"
"10","013","00","030","0018","0224","315","90","225","5","320","815","0","39.26","11.04"
"10","013","00","030","0018","0225","279","93","186","1","280","717","0","39.05","12.97"
"10","013","00","030","0019","0000","3483","1334","2149","24","3507","9392","0","37.34","14.20"
"10","013","00","030","0019","0193","343","134","209","2","345","896","0","38.50","14.96"
"10","013","00","030","0019","0194","424","175","249","4","428","1156","0","37.02","15.14"
"10","013","00","030","0019","0195","502","205","297","3","505","1436","0","35.17","14.28"
"10","013","00","030","0019","0196","433","185","248","0","433","1202","0","36.02","15.39"
"10","013","00","030","0019","0197","382","134","248","6","388","1110","0","34.95","12.07"
"10","013","00","030","0019","0198","449","167","282","4","453","1116","0","40.59","14.96"
"10","013","00","030","0019","0199","502","166","336","4","506","1182","0","42.81","14.04"
"10","013","00","030","0019","0200","448","168","280","1","449","1294","0","34.70","12.98"
"10","013","00","030","0020","0000","549","194","355","5","554","1324","0","41.84","14.65"
"10","013","00","030","0020","0201","549","194","355","5","554","1324","0","41.84","14.65"
"10","013","00","030","0021","0000","420","100","320","7","427","1049","0","40.71","9.53"
"10","013","00","030","0021","0226","420","100","320","7","427","1049","0","40.71","9.53"
"10","013","00","030","0022","0000","285","199","86","5","290","664","0","43.67","29.97"
"10","013","00","030","0022","0227","285","199","86","5","290","664","0","43.67","29.97"
"10","013","00","030","0029","0000","378","133","245","4","382","852","0","44.84","15.61"
"10","013","00","030","0029","0191","378","133","245","4","382","852","0","44.84","15.61"
"10","013","00","030","0030","0000","488","210","278","4","492","1133","0","43.42","18.53"
"10","013","00","030","0030","0202","488","210","278","4","492","1133","0","43.42","18.53"
"10","013","00","040","0000","0000","7391","3412","3979","88","7479","25502","30236","29.33","13.38"
"10","013","00","040","0001","0000","293","157","136","4","297","896","0","33.15","17.52"
"10","013","00","040","0001","0228","293","157","136","4","297","896","0","33.15","17.52"
"10","013","00","040","0002","0000","711","344","367","3","714","2205","0","32.38","15.60"
"10","013","00","040","0002","0229","217","102","115","1","218","706","0","30.88","14.45"
"10","013","00","040","0002","0230","259","128","131","1","260","755","0","34.44","16.95"
"10","013","00","040","0002","0231","235","114","121","1","236","744","0","31.72","15.32"
"10","013","00","040","0003","0000","321","163","158","7","328","1109","0","29.58","14.70"
"10","013","00","040","0003","0232","321","163","158","7","328","1109","0","29.58","14.70"
"10","013","00","040","0004","0000","1198","606","592","7","1205","4194","0","28.73","14.45"
"10","013","00","040","0004","0248","261","123","138","2","263","1028","0","25.58","11.96"
"10","013","00","040","0004","0249","356","189","167","0","356","1081","0","32.93","17.48"
"10","013","00","040","0004","0250","315","144","171","2","317","1035","0","30.63","13.91"
"10","013","00","040","0004","0251","266","150","116","3","269","1050","0","25.62","14.29"
"10","013","00","040","0005","0000","895","434","461","11","906","3117","0","29.07","13.92"
"10","013","00","040","0005","0233","285","134","151","2","287","1081","0","26.55","12.40"
"10","013","00","040","0005","0234","300","160","140","2","302","1011","0","29.87","15.83"
"10","013","00","040","0005","0235","310","140","170","7","317","1025","0","30.93","13.66"
"10","013","00","040","0006","0000","228","96","132","2","230","856","0","26.87","11.21"
"10","013","00","040","0006","0236","228","96","132","2","230","856","0","26.87","11.21"
"10","013","00","040","0007","0000","170","61","109","3","173","504","0","34.33","12.10"
"10","013","00","040","0007","0237","170","61","109","3","173","504","0","34.33","12.10"
"10","013","00","040","0008","0000","165","65","100","2","167","473","0","35.31","13.74"
"10","013","00","040","0008","0238","165","65","100","2","167","473","0","35.31","13.74"
"10","013","00","040","0009","0000","274","111","163","4","278","1021","0","27.23","10.87"
"10","013","00","040","0009","0239","274","111","163","4","278","1021","0","27.23","10.87"
"10","013","00","040","0010","0000","249","101","148","5","254","928","0","27.37","10.88"
"10","013","00","040","0010","0240","249","101","148","5","254","928","0","27.37","10.88"
"10","013","00","040","0011","0000","283","138","145","2","285","1079","0","26.41","12.79"
"10","013","00","040","0011","0241","283","138","145","2","285","1079","0","26.41","12.79"
"10","013","00","040","0012","0000","481","147","334","9","490","1560","0","31.41","9.42"
"10","013","00","040","0012","0242","238","54","184","6","244","776","0","31.44","6.96"
"10","013","00","040","0012","0243","243","93","150","3","246","784","0","31.38","11.86"
"10","013","00","040","0013","0000","532","266","266","9","541","2199","0","24.60","12.10"
"10","013","00","040","0013","0244","282","133","149","4","286","1089","0","26.26","12.21"
"10","013","00","040","0013","0245","250","133","117","5","255","1110","0","22.97","11.98"
"10","013","00","040","0014","0000","318","103","215","6","324","1388","0","23.34","7.42"
"10","013","00","040","0014","0246","164","55","109","2","166","683","0","24.30","8.05"
"10","013","00","040","0014","0247","154","48","106","4","158","705","0","22.41","6.81"
"10","013","00","040","0015","0000","479","255","224","5","484","1686","0","28.71","15.12"
"10","013","00","040","0015","0252","222","108","114","0","222","824","0","26.94","13.11"
"10","013","00","040","0015","0253","257","147","110","5","262","862","0","30.39","17.05"
"10","013","00","040","0016","0000","461","197","264","3","464","1205","0","38.51","16.35"
"10","013","00","040","0016","0254","257","120","137","0","257","585","0","43.93","20.51"
"10","013","00","040","0016","0255","204","77","127","3","207","620","0","33.39","12.42"
"10","013","00","040","0017","0000","333","168","165","6","339","1082","0","31.33","15.53"
"10","013","00","040","0017","0256","333","168","165","6","339","1082","0","31.33","15.53"
"10","013","00","050","0000","0000","18006","6068","11938","213","18219","43230","49955","42.14","14.04"
"10","013","00","050","0001","0000","245","81","164","1","246","587","0","41.91","13.80"
"10","013","00","050","0001","0271","245","81","164","1","246","587","0","41.91","13.80"
"10","013","00","050","0002","0000","360","135","225","3","363","817","0","44.43","16.52"
"10","013","00","050","0002","0266","360","135","225","3","363","817","0","44.43","16.52"
"10","013","00","050","0003","0000","1462","523","939","15","1477","3322","0","44.46","15.74"
"10","013","00","050","0003","0267","489","182","307","5","494","1113","0","44.38","16.35"
"10","013","00","050","0003","0268","457","182","275","6","463","1078","0","42.95","16.88"
"10","013","00","050","0003","0269","516","159","357","4","520","1131","0","45.98","14.06"
"10","013","00","050","0004","0000","240","81","159","1","241","711","0","33.90","11.39"
"10","013","00","050","0004","0270","240","81","159","1","241","711","0","33.90","11.39"
"10","013","00","050","0005","0000","611","255","356","6","617","1403","0","43.98","18.18"
"10","013","00","050","0005","0272","611","255","356","6","617","1403","0","43.98","18.18"
"10","013","00","050","0006","0000","861","350","511","6","867","2249","0","38.55","15.56"
"10","013","00","050","0006","0273","401","173","228","2","403","1090","0","36.97","15.87"
"10","013","00","050","0006","0274","460","177","283","4","464","1159","0","40.03","15.27"
"10","013","00","050","0007","0000","823","282","541","10","833","2047","0","40.69","13.78"
"10","013","00","050","0007","0275","402","136","266","5","407","969","0","42.00","14.04"
"10","013","00","050","0007","0276","421","146","275","5","426","1078","0","39.52","13.54"
"10","013","00","050","0008","0000","692","220","472","11","703","1671","0","42.07","13.17"
"10","013","00","050","0008","0277","342","121","221","6","348","862","0","40.37","14.04"
"10","013","00","050","0008","0278","350","99","251","5","355","809","0","43.88","12.24"
"10","013","00","050","0009","0000","1021","330","691","7","1028","2276","0","45.17","14.50"
"10","013","00","050","0009","0299","495","137","358","2","497","1036","0","47.97","13.22"
"10","013","00","050","0009","0300","526","193","333","5","531","1240","0","42.82","15.56"
"10","013","00","050","0010","0000","441","116","325","6","447","973","0","45.94","11.92"
"10","013","00","050","0010","0281","441","116","325","6","447","973","0","45.94","11.92"
"10","013","00","050","0011","0000","713","224","489","9","722","1835","0","39.35","12.21"
"10","013","00","050","0011","0282","375","130","245","9","384","956","0","40.17","13.60"
"10","013","00","050","0011","0283","338","94","244","0","338","879","0","38.45","10.69"
"10","013","00","050","0012","0000","681","192","489","11","692","1593","0","43.44","12.05"
"10","013","00","050","0012","0284","377","97","280","3","380","862","0","44.08","11.25"
"10","013","00","050","0012","0285","304","95","209","8","312","731","0","42.68","13.00"
"10","013","00","050","0013","0000","564","195","369","7","571","1407","0","40.58","13.86"
"10","013","00","050","0013","0286","564","195","369","7","571","1407","0","40.58","13.86"
"10","013","00","050","0014","0000","365","105","260","3","368","822","0","44.77","12.77"
"10","013","00","050","0014","0289","365","105","260","3","368","822","0","44.77","12.77"
"10","013","00","050","0015","0000","542","113","429","5","547","1248","0","43.83","9.05"
"10","013","00","050","0015","0290","542","113","429","5","547","1248","0","43.83","9.05"
"10","013","00","050","0016","0000","556","199","357","12","568","1471","0","38.61","13.53"
"10","013","00","050","0016","0291","556","199","357","12","568","1471","0","38.61","13.53"
"10","013","00","050","0017","0000","417","130","287","7","424","943","0","44.96","13.79"
"10","013","00","050","0017","0292","417","130","287","7","424","943","0","44.96","13.79"
"10","013","00","050","0018","0000","835","272","563","13","848","1968","0","43.09","13.82"
"10","013","00","050","0018","0293","351","106","245","3","354","802","0","44.14","13.22"
"10","013","00","050","0018","0294","484","166","318","10","494","1166","0","42.37","14.24"
"10","013","00","050","0019","0000","711","213","498","10","721","1666","0","43.28","12.79"
"10","013","00","050","0019","0297","415","128","287","3","418","953","0","43.86","13.43"
"10","013","00","050","0019","0298","296","85","211","7","303","713","0","42.50","11.92"
"10","013","00","050","0020","0000","717","202","515","7","724","1692","0","42.79","11.94"
"10","013","00","050","0020","0295","356","92","264","5","361","839","0","43.03","10.97"
"10","013","00","050","0020","0296","361","110","251","2","363","853","0","42.56","12.90"
"10","013","00","050","0021","0000","766","274","492","11","777","1694","0","45.87","16.17"
"10","013","00","050","0021","0279","361","127","234","4","365","800","0","45.63","15.88"
"10","013","00","050","0021","0280","405","147","258","7","412","894","0","46.09","16.44"
"10","013","00","050","0022","0000","871","341","530","7","878","2075","0","42.31","16.43"
"10","013","00","050","0022","0258","488","189","299","6","494","1168","0","42.29","16.18"
"10","013","00","050","0022","0259","383","152","231","1","384","907","0","42.34","16.76"
"10","013","00","050","0023","0000","621","214","407","9","630","1508","0","41.78","14.19"
"10","013","00","050","0023","0257","621","214","407","9","630","1508","0","41.78","14.19"
"10","013","00","050","0024","0000","451","137","314","3","454","977","0","46.47","14.02"
"10","013","00","050","0024","0287","451","137","314","3","454","977","0","46.47","14.02"
"10","013","00","050","0025","0000","724","314","410","9","733","2019","0","36.31","15.55"
"10","013","00","050","0025","0260","367","179","188","5","372","1003","0","37.09","17.85"
"10","013","00","050","0025","0261","357","135","222","4","361","1016","0","35.53","13.29"
"10","013","00","050","0026","0000","527","150","377","7","534","1343","0","39.76","11.17"
"10","013","00","050","0026","0288","527","150","377","7","534","1343","0","39.76","11.17"
"10","013","00","050","0027","0000","474","168","306","7","481","1145","0","42.01","14.67"
"10","013","00","050","0027","0263","474","168","306","7","481","1145","0","42.01","14.67"
"10","013","00","050","0028","0000","353","101","252","3","356","828","0","43.00","12.20"
"10","013","00","050","0028","0264","353","101","252","3","356","828","0","43.00","12.20"
"10","013","00","050","0029","0000","231","98","133","4","235","546","0","43.04","17.95"
"10","013","00","050","0029","0262","231","98","133","4","235","546","0","43.04","17.95"
"10","013","00","050","0030","0000","131","53","78","3","134","394","0","34.01","13.45"
"10","013","00","050","0030","0265","131","53","78","3","134","394","0","34.01","13.45"
"10","013","00","060","0000","0000","10942","4297","6645","117","11059","26079","29381","42.41","16.48"
"10","013","00","060","0001","0000","1104","461","643","15","1119","2655","0","42.15","17.36"
"10","013","00","060","0001","0301","427","152","275","4","431","1004","0","42.93","15.14"
"10","013","00","060","0001","0302","677","309","368","11","688","1651","0","41.67","18.72"
"10","013","00","060","0002","0000","1508","704","804","12","1520","3605","0","42.16","19.53"
"10","013","00","060","0002","0303","770","363","407","5","775","1846","0","41.98","19.66"
"10","013","00","060","0002","0304","738","341","397","7","745","1759","0","42.35","19.39"
"10","013","00","060","0003","0000","886","375","511","8","894","1921","0","46.54","19.52"
"10","013","00","060","0003","0305","432","206","226","4","436","966","0","45.13","21.33"
"10","013","00","060","0003","0306","454","169","285","4","458","955","0","47.96","17.70"
"10","013","00","060","0004","0000","1165","509","656","11","1176","2628","0","44.75","19.37"
"10","013","00","060","0004","0307","349","152","197","8","357","744","0","47.98","20.43"
"10","013","00","060","0004","0308","816","357","459","3","819","1884","0","43.47","18.95"
"10","013","00","060","0005","0000","476","205","271","3","479","1056","0","45.36","19.41"
"10","013","00","060","0005","0309","476","205","271","3","479","1056","0","45.36","19.41"
"10","013","00","060","0006","0000","408","161","247","2","410","859","0","47.73","18.74"
"10","013","00","060","0006","0314","408","161","247","2","410","859","0","47.73","18.74"
"10","013","00","060","0007","0000","469","164","305","3","472","1045","0","45.17","15.69"
"10","013","00","060","0007","0315","469","164","305","3","472","1045","0","45.17","15.69"
"10","013","00","060","0008","0000","663","236","427","11","674","1475","0","45.69","16.00"
"10","013","00","060","0008","0313","663","236","427","11","674","1475","0","45.69","16.00"
"10","013","00","060","0009","0000","702","301","401","3","705","1639","0","43.01","18.36"
"10","013","00","060","0009","0310","702","301","401","3","705","1639","0","43.01","18.36"
"10","013","00","060","0010","0000","521","167","354","8","529","1144","0","46.24","14.60"
"10","013","00","060","0010","0311","521","167","354","8","529","1144","0","46.24","14.60"
"10","013","00","060","0011","0000","268","72","196","5","273","743","0","36.74","9.69"
"10","013","00","060","0011","0312","268","72","196","5","273","743","0","36.74","9.69"
"10","013","00","060","0012","0000","922","238","684","8","930","2349","0","39.59","10.13"
"10","013","00","060","0012","0320","511","133","378","6","517","1218","0","42.45","10.92"
"10","013","00","060","0012","0321","411","105","306","2","413","1131","0","36.52","9.28"
"10","013","00","060","0013","0000","668","213","455","9","677","1719","0","39.38","12.39"
"10","013","00","060","0013","0316","303","95","208","2","305","813","0","37.52","11.69"
"10","013","00","060","0013","0317","365","118","247","7","372","906","0","41.06","13.02"
"10","013","00","060","0014","0000","483","156","327","7","490","1404","0","34.90","11.11"
"10","013","00","060","0014","0318","483","156","327","7","490","1404","0","34.90","11.11"
"10","013","00","060","0015","0000","396","144","252","9","405","1127","0","35.94","12.78"
"10","013","00","060","0015","0319","396","144","252","9","405","1127","0","35.94","12.78"
"10","013","00","060","0016","0000","303","191","112","3","306","710","0","43.10","26.90"
"10","013","00","060","0016","0322","303","191","112","3","306","710","0","43.10","26.90"
"10","013","00","070","0000","0000","4678","1636","3042","40","4718","9689","10711","48.69","16.89"
"10","013","00","070","0001","0000","1001","340","661","12","1013","2127","0","47.63","15.98"
"10","013","00","070","0001","0323","350","99","251","6","356","748","0","47.59","13.24"
"10","013","00","070","0001","0324","651","241","410","6","657","1379","0","47.64","17.48"
"10","013","00","070","0002","0000","436","163","273","3","439","925","0","47.46","17.62"
"10","013","00","070","0002","0325","436","163","273","3","439","925","0","47.46","17.62"
"10","013","00","070","0003","0000","736","254","482","8","744","1484","0","50.13","17.12"
"10","013","00","070","0003","0326","333","113","220","6","339","699","0","48.50","16.17"
"10","013","00","070","0003","0327","403","141","262","2","405","785","0","51.59","17.96"
"10","013","00","070","0004","0000","1180","415","765","10","1190","2480","0","47.98","16.73"
"10","013","00","070","0004","0328","559","179","380","4","563","1186","0","47.47","15.09"
"10","013","00","070","0004","0329","621","236","385","6","627","1294","0","48.45","18.24"
"10","013","00","070","0005","0000","558","183","375","2","560","1156","0","48.44","15.83"
"10","013","00","070","0005","0330","558","183","375","2","560","1156","0","48.44","15.83"
"10","013","00","070","0006","0000","417","163","254","4","421","846","0","49.76","19.27"
"10","013","00","070","0006","0331","417","163","254","4","421","846","0","49.76","19.27"
"10","013","00","070","0007","0000","350","118","232","1","351","671","0","52.31","17.59"
"10","013","00","070","0007","0332","350","118","232","1","351","671","0","52.31","17.59"
"10","013","00","080","0000","0000","8238","2373","5865","95","8333","19063","21784","43.71","12.45"
"10","013","00","080","0001","0000","599","162","437","4","603","1438","0","41.93","11.27"
"10","013","00","080","0001","0333","599","162","437","4","603","1438","0","41.93","11.27"
"10","013","00","080","0002","0000","585","154","431","7","592","1353","0","43.75","11.38"
"10","013","00","080","0002","0334","585","154","431","7","592","1353","0","43.75","11.38"
"10","013","00","080","0003","0000","788","200","588","11","799","1675","0","47.70","11.94"
"10","013","00","080","0003","0335","788","200","588","11","799","1675","0","47.70","11.94"
"10","013","00","080","0004","0000","508","146","362","12","520","1222","0","42.55","11.95"
"10","013","00","080","0004","0337","508","146","362","12","520","1222","0","42.55","11.95"
"10","013","00","080","0005","0000","473","161","312","5","478","1155","0","41.39","13.94"
"10","013","00","080","0005","0336","473","161","312","5","478","1155","0","41.39","13.94"
"10","013","00","080","0006","0000","610","140","470","4","614","1563","0","39.28","8.96"
"10","013","00","080","0006","0345","610","140","470","4","614","1563","0","39.28","8.96"
"10","013","00","080","0007","0000","801","194","607","19","820","1747","0","46.94","11.10"
"10","013","00","080","0007","0347","801","194","607","19","820","1747","0","46.94","11.10"
"10","013","00","080","0008","0000","538","142","396","7","545","1257","0","43.36","11.30"
"10","013","00","080","0008","0346","538","142","396","7","545","1257","0","43.36","11.30"
"10","013","00","080","0009","0000","620","177","443","5","625","1454","0","42.98","12.17"
"10","013","00","080","0009","0348","620","177","443","5","625","1454","0","42.98","12.17"
"10","013","00","080","0010","0000","2007","655","1352","14","2021","4613","0","43.81","14.20"
"10","013","00","080","0010","0340","320","104","216","0","320","666","0","48.05","15.62"
"10","013","00","080","0010","0341","504","141","363","3","507","1081","0","46.90","13.04"
"10","013","00","080","0010","0342","403","130","273","3","406","1001","0","40.56","12.99"
"10","013","00","080","0010","0343","469","160","309","7","476","1140","0","41.75","14.04"
"10","013","00","080","0010","0344","311","120","191","1","312","725","0","43.03","16.55"
"10","013","00","080","0011","0000","709","242","467","7","716","1586","0","45.15","15.26"
"10","013","00","080","0011","0338","415","122","293","5","420","1004","0","41.83","12.15"
"10","013","00","080","0011","0339","294","120","174","2","296","582","0","50.86","20.62"
"10","013","00","090","0000","0000","9161","2986","6175","117","9278","21985","25657","42.20","13.58"
"10","013","00","090","0001","0000","1307","419","888","13","1320","3156","0","41.83","13.28"
"10","013","00","090","0001","0349","649","209","440","4","653","1637","0","39.89","12.77"
"10","013","00","090","0001","0350","658","210","448","9","667","1519","0","43.91","13.82"
"10","013","00","090","0002","0000","473","176","297","8","481","1106","0","43.49","15.91"
"10","013","00","090","0002","0353","473","176","297","8","481","1106","0","43.49","15.91"
"10","013","00","090","0003","0000","341","104","237","2","343","840","0","40.83","12.38"
"10","013","00","090","0003","0354","341","104","237","2","343","840","0","40.83","12.38"
"10","013","00","090","0004","0000","578","191","387","4","582","1323","0","43.99","14.44"
"10","013","00","090","0004","0355","578","191","387","4","582","1323","0","43.99","14.44"
"10","013","00","090","0005","0000","817","251","566","10","827","1992","0","41.52","12.60"
"10","013","00","090","0005","0356","430","126","304","7","437","946","0","46.19","13.32"
"10","013","00","090","0005","0357","387","125","262","3","390","1046","0","37.28","11.95"
"10","013","00","090","0006","0000","596","186","410","7","603","1418","0","42.52","13.12"
"10","013","00","090","0006","0358","596","186","410","7","603","1418","0","42.52","13.12"
"10","013","00","090","0007","0000","637","180","457","8","645","1522","0","42.38","11.83"
"10","013","00","090","0007","0351","637","180","457","8","645","1522","0","42.38","11.83"
"10","013","00","090","0008","0000","596","164","432","5","601","1564","0","38.43","10.49"
"10","013","00","090","0008","0352","596","164","432","5","601","1564","0","38.43","10.49"
"10","013","00","090","0009","0000","656","167","489","10","666","1502","0","44.34","11.12"
"10","013","00","090","0009","0359","133","39","94","2","135","316","0","42.72","12.34"
"10","013","00","090","0009","0360","523","128","395","8","531","1186","0","44.77","10.79"
"10","013","00","090","0010","0000","988","238","750","14","1002","2297","0","43.62","10.36"
"10","013","00","090","0010","0361","400","97","303","8","408","973","0","41.93","9.97"
"10","013","00","090","0010","0362","588","141","447","6","594","1324","0","44.86","10.65"
"10","013","00","090","0011","0000","847","424","423","8","855","1980","0","43.18","21.41"
"10","013","00","090","0011","0363","631","243","388","6","637","1474","0","43.22","16.49"
"10","013","00","090","0011","0364","216","181","35","2","218","506","0","43.08","35.77"
"10","013","00","090","0012","0000","719","293","426","17","736","1815","0","40.55","16.14"
"10","013","00","090","0012","0365","321","140","181","7","328","813","0","40.34","17.22"
"10","013","00","090","0012","0366","398","153","245","10","408","1002","0","40.72","15.27"
"10","013","00","090","0013","0000","348","126","222","5","353","956","0","36.92","13.18"
"10","013","00","090","0013","0367","348","126","222","5","353","956","0","36.92","13.18"
"10","013","00","090","0014","0000","258","67","191","6","264","514","0","51.36","13.04"
"10","013","00","090","0014","0368","258","67","191","6","264","514","0","51.36","13.04"
"10","013","00","100","0000","0000","7675","3112","4563","119","7794","21921","24795","35.55","14.20"
"10","013","00","100","0001","0000","1072","334","738","26","1098","3077","0","35.68","10.85"
"10","013","00","100","0001","0382","354","115","239","8","362","1000","0","36.20","11.50"
"10","013","00","100","0001","0383","353","121","232","12","365","1079","0","33.83","11.21"
"10","013","00","100","0001","0384","365","98","267","6","371","998","0","37.17","9.82"
"10","013","00","100","0002","0000","901","284","617","13","914","2767","0","33.03","10.26"
"10","013","00","100","0002","0376","310","91","219","6","316","926","0","34.13","9.83"
"10","013","00","100","0002","0377","362","127","235","3","365","1031","0","35.40","12.32"
"10","013","00","100","0002","0378","229","66","163","4","233","810","0","28.77","8.15"
"10","013","00","100","0003","0000","583","269","314","6","589","1800","0","32.72","14.94"
"10","013","00","100","0003","0369","301","134","167","4","305","907","0","33.63","14.77"
"10","013","00","100","0003","0370","282","135","147","2","284","893","0","31.80","15.12"
"10","013","00","100","0004","0000","781","373","408","12","793","2311","0","34.31","16.14"
"10","013","00","100","0004","0371","357","184","173","7","364","1105","0","32.94","16.65"
"10","013","00","100","0004","0372","424","189","235","5","429","1206","0","35.57","15.67"
"10","013","00","100","0005","0000","558","263","295","8","566","1683","0","33.63","15.63"
"10","013","00","100","0005","0373","262","117","145","3","265","718","0","36.91","16.30"
"10","013","00","100","0005","0374","296","146","150","5","301","965","0","31.19","15.13"
"10","013","00","100","0006","0000","354","190","164","2","356","1022","0","34.83","18.59"
"10","013","00","100","0006","0375","354","190","164","2","356","1022","0","34.83","18.59"
"10","013","00","100","0007","0000","600","232","368","18","618","1803","0","34.28","12.87"
"10","013","00","100","0007","0379","293","106","187","15","308","874","0","35.24","12.13"
"10","013","00","100","0007","0380","307","126","181","3","310","929","0","33.37","13.56"
"10","013","00","100","0008","0000","213","59","154","3","216","537","0","40.22","10.99"
"10","013","00","100","0008","0391","213","59","154","3","216","537","0","40.22","10.99"
"10","013","00","100","0009","0000","343","147","196","8","351","908","0","38.66","16.19"
"10","013","00","100","0009","0381","343","147","196","8","351","908","0","38.66","16.19"
"10","013","00","100","0010","0000","641","257","384","7","648","1606","0","40.35","16.00"
"10","013","00","100","0010","0389","334","140","194","7","341","808","0","42.20","17.33"
"10","013","00","100","0010","0390","307","117","190","0","307","798","0","38.47","14.66"
"10","013","00","100","0011","0000","1248","548","700","11","1259","3450","0","36.49","15.88"
"10","013","00","100","0011","0385","388","182","206","2","390","1097","0","35.55","16.59"
"10","013","00","100","0011","0386","432","202","230","4","436","1139","0","38.28","17.73"
"10","013","00","100","0011","0387","428","164","264","5","433","1214","0","35.67","13.51"
"10","013","00","100","0012","0000","381","156","225","5","386","957","0","40.33","16.30"
"10","013","00","100","0012","0388","381","156","225","5","386","957","0","40.33","16.30"
"10","013","00","110","0000","0000","8496","2210","6286","139","8635","21162","23583","40.80","10.44"
"10","013","00","110","0001","0000","959","236","723","10","969","2093","0","46.30","11.28"
"10","013","00","110","0001","0392","427","112","315","4","431","877","0","49.14","12.77"
"10","013","00","110","0001","0393","532","124","408","6","538","1216","0","44.24","10.20"
"10","013","00","110","0002","0000","539","113","426","6","545","1236","0","44.09","9.14"
"10","013","00","110","0002","0394","539","113","426","6","545","1236","0","44.09","9.14"
"10","013","00","110","0003","0000","328","68","260","4","332","707","0","46.96","9.62"
"10","013","00","110","0003","0395","328","68","260","4","332","707","0","46.96","9.62"
"10","013","00","110","0004","0000","240","63","177","5","245","578","0","42.39","10.90"
"10","013","00","110","0004","0396","240","63","177","5","245","578","0","42.39","10.90"
"10","013","00","110","0005","0000","440","129","311","5","445","995","0","44.72","12.96"
"10","013","00","110","0005","0397","440","129","311","5","445","995","0","44.72","12.96"
"10","013","00","110","0006","0000","438","98","340","10","448","1135","0","39.47","8.63"
"10","013","00","110","0006","0398","438","98","340","10","448","1135","0","39.47","8.63"
"10","013","00","110","0007","0000","252","75","177","3","255","592","0","43.07","12.67"
"10","013","00","110","0007","0399","252","75","177","3","255","592","0","43.07","12.67"
"10","013","00","110","0008","0000","306","54","252","9","315","727","0","43.33","7.43"
"10","013","00","110","0008","0400","306","54","252","9","315","727","0","43.33","7.43"
"10","013","00","110","0009","0000","210","67","143","7","217","618","0","35.11","10.84"
"10","013","00","110","0009","0401","210","67","143","7","217","618","0","35.11","10.84"
"10","013","00","110","0010","0000","483","141","342","1","484","1183","0","40.91","11.92"
"10","013","00","110","0010","0402","483","141","342","1","484","1183","0","40.91","11.92"
"10","013","00","110","0011","0000","508","140","368","6","514","1416","0","36.30","9.89"
"10","013","00","110","0011","0403","266","62","204","2","268","731","0","36.66","8.48"
"10","013","00","110","0011","0404","242","78","164","4","246","685","0","35.91","11.39"
"10","013","00","110","0012","0000","654","168","486","12","666","1828","0","36.43","9.19"
"10","013","00","110","0012","0405","334","68","266","9","343","897","0","38.24","7.58"
"10","013","00","110","0012","0406","320","100","220","3","323","931","0","34.69","10.74"
"10","013","00","110","0013","0000","464","128","336","10","474","1231","0","38.51","10.40"
"10","013","00","110","0013","0407","464","128","336","10","474","1231","0","38.51","10.40"
"10","013","00","110","0014","0000","435","120","315","9","444","1041","0","42.65","11.53"
"10","013","00","110","0014","0408","435","120","315","9","444","1041","0","42.65","11.53"
"10","013","00","110","0015","0000","359","111","248","6","365","1085","0","33.64","10.23"
"10","013","00","110","0015","0409","359","111","248","6","365","1085","0","33.64","10.23"
"10","013","00","110","0016","0000","393","100","293","8","401","988","0","40.59","10.12"
"10","013","00","110","0016","0410","393","100","293","8","401","988","0","40.59","10.12"
"10","013","00","110","0017","0000","410","112","298","9","419","1054","0","39.75","10.63"
"10","013","00","110","0017","0411","410","112","298","9","419","1054","0","39.75","10.63"
"10","013","00","110","0018","0000","535","151","384","8","543","1172","0","46.33","12.88"
"10","013","00","110","0018","0412","352","72","280","4","356","698","0","51.00","10.32"
"10","013","00","110","0018","0413","183","79","104","4","187","474","0","39.45","16.67"
"10","013","00","110","0019","0000","543","136","407","11","554","1483","0","37.36","9.17"
"10","013","00","110","0019","0414","254","66","188","3","257","668","0","38.47","9.88"
"10","013","00","110","0019","0415","289","70","219","8","297","815","0","36.44","8.59"
"10","013","00","120","0000","0000","7208","2298","4910","83","7291","17504","20028","41.65","13.13"
"10","013","00","120","0001","0000","507","143","364","5","512","1171","0","43.72","12.21"
"10","013","00","120","0001","0416","507","143","364","5","512","1171","0","43.72","12.21"
"10","013","00","120","0002","0000","312","109","203","2","314","715","0","43.92","15.24"
"10","013","00","120","0002","0417","312","109","203","2","314","715","0","43.92","15.24"
"10","013","00","120","0003","0000","766","246","520","7","773","1663","0","46.48","14.79"
"10","013","00","120","0003","0418","396","124","272","2","398","912","0","43.64","13.60"
"10","013","00","120","0003","0419","370","122","248","5","375","751","0","49.93","16.25"
"10","013","00","120","0004","0000","405","118","287","5","410","885","0","46.33","13.33"
"10","013","00","120","0004","0420","405","118","287","5","410","885","0","46.33","13.33"
"10","013","00","120","0005","0000","274","72","202","2","276","530","0","52.08","13.58"
"10","013","00","120","0005","0421","274","72","202","2","276","530","0","52.08","13.58"
"10","013","00","120","0006","0000","482","190","292","10","492","1083","0","45.43","17.54"
"10","013","00","120","0006","0422","482","190","292","10","492","1083","0","45.43","17.54"
"10","013","00","120","0007","0000","477","165","312","6","483","990","0","48.79","16.67"
"10","013","00","120","0007","0423","477","165","312","6","483","990","0","48.79","16.67"
"10","013","00","120","0008","0000","578","198","380","9","587","1392","0","42.17","14.22"
"10","013","00","120","0008","0424","578","198","380","9","587","1392","0","42.17","14.22"
"10","013","00","120","0009","0000","785","226","559","10","795","1976","0","40.23","11.44"
"10","013","00","120","0009","0427","383","109","274","2","385","986","0","39.05","11.05"
"10","013","00","120","0009","0428","402","117","285","8","410","990","0","41.41","11.82"
"10","013","00","120","0010","0000","563","207","356","8","571","1657","0","34.46","12.49"
"10","013","00","120","0010","0425","290","105","185","4","294","829","0","35.46","12.67"
"10","013","00","120","0010","0426","273","102","171","4","277","828","0","33.45","12.32"
"10","013","00","120","0011","0000","623","151","472","5","628","1673","0","37.54","9.03"
"10","013","00","120","0011","0429","381","88","293","2","383","1043","0","36.72","8.44"
"10","013","00","120","0011","0430","242","63","179","3","245","630","0","38.89","10.00"
"10","013","00","120","0012","0000","527","200","327","5","532","1374","0","38.72","14.56"
"10","013","00","120","0012","0431","527","200","327","5","532","1374","0","38.72","14.56"
"10","013","00","120","0013","0000","480","118","362","6","486","1233","0","39.42","9.57"
"10","013","00","120","0013","0432","480","118","362","6","486","1233","0","39.42","9.57"
"10","013","00","120","0014","0000","429","155","274","3","432","1162","0","37.18","13.34"
"10","013","00","120","0014","0433","193","94","99","1","194","588","0","32.99","15.99"
"10","013","00","120","0014","0434","236","61","175","2","238","574","0","41.46","10.63"
"10","013","00","130","0000","0000","19087","7037","12050","208","19295","46892","52910","41.15","15.01"
"10","013","00","130","0001","0000","1621","666","955","12","1633","3943","0","41.42","16.89"
"10","013","00","130","0001","0435","550","217","333","3","553","1228","0","45.03","17.67"
"10","013","00","130","0001","0436","525","211","314","5","530","1259","0","42.10","16.76"
"10","013","00","130","0001","0437","546","238","308","4","550","1456","0","37.77","16.35"
"10","013","00","130","0002","0000","1283","490","793","14","1297","3127","0","41.48","15.67"
"10","013","00","130","0002","0438","596","219","377","5","601","1454","0","41.33","15.06"
"10","013","00","130","0002","0439","687","271","416","9","696","1673","0","41.60","16.20"
"10","013","00","130","0003","0000","595","217","378","9","604","1261","0","47.90","17.21"
"10","013","00","130","0003","0440","595","217","378","9","604","1261","0","47.90","17.21"
"10","013","00","130","0004","0000","247","87","160","2","249","565","0","44.07","15.40"
"10","013","00","130","0004","0441","247","87","160","2","249","565","0","44.07","15.40"
"10","013","00","130","0005","0000","926","357","569","10","936","2169","0","43.15","16.46"
"10","013","00","130","0005","0442","476","177","299","3","479","1113","0","43.04","15.90"
"10","013","00","130","0005","0443","450","180","270","7","457","1056","0","43.28","17.05"
"10","013","00","130","0006","0000","1138","472","666","7","1145","2795","0","40.97","16.89"
"10","013","00","130","0006","0444","566","195","371","3","569","1415","0","40.21","13.78"
"10","013","00","130","0006","0445","572","277","295","4","576","1380","0","41.74","20.07"
"10","013","00","130","0007","0000","1877","707","1170","16","1893","4356","0","43.46","16.23"
"10","013","00","130","0007","0446","665","256","409","7","672","1391","0","48.31","18.40"
"10","013","00","130","0007","0447","580","201","379","5","585","1453","0","40.26","13.83"
"10","013","00","130","0007","0448","632","250","382","4","636","1512","0","42.06","16.53"
"10","013","00","130","0008","0000","1246","456","790","14","1260","3045","0","41.38","14.98"
"10","013","00","130","0008","0449","556","192","364","4","560","1393","0","40.20","13.78"
"10","013","00","130","0008","0450","690","264","426","10","700","1652","0","42.37","15.98"
"10","013","00","130","0009","0000","763","275","488","6","769","1580","0","48.67","17.41"
"10","013","00","130","0009","0451","342","130","212","4","346","733","0","47.20","17.74"
"10","013","00","130","0009","0452","421","145","276","2","423","847","0","49.94","17.12"
"10","013","00","130","0010","0000","830","237","593","5","835","1847","0","45.21","12.83"
"10","013","00","130","0010","0453","406","116","290","2","408","939","0","43.45","12.35"
"10","013","00","130","0010","0454","424","121","303","3","427","908","0","47.03","13.33"
"10","013","00","130","0011","0000","797","258","539","8","805","1835","0","43.87","14.06"
"10","013","00","130","0011","0455","230","73","157","4","234","537","0","43.58","13.59"
"10","013","00","130","0011","0456","567","185","382","4","571","1298","0","43.99","14.25"
"10","013","00","130","0012","0000","1191","365","826","15","1206","2856","0","42.23","12.78"
"10","013","00","130","0012","0457","581","187","394","7","588","1283","0","45.83","14.58"
"10","013","00","130","0012","0458","610","178","432","8","618","1573","0","39.29","11.32"
"10","013","00","130","0013","0000","478","149","329","8","486","920","0","52.83","16.20"
"10","013","00","130","0013","0459","478","149","329","8","486","920","0","52.83","16.20"
"10","013","00","130","0014","0000","497","146","351","7","504","1079","0","46.71","13.53"
"10","013","00","130","0014","0460","497","146","351","7","504","1079","0","46.71","13.53"
"10","013","00","130","0015","0000","751","234","517","11","762","2282","0","33.39","10.25"
"10","013","00","130","0015","0461","366","116","250","6","372","1082","0","34.38","10.72"
"10","013","00","130","0015","0462","385","118","267","5","390","1200","0","32.50","9.83"
"10","013","00","130","0016","0000","556","142","414","3","559","1517","0","36.85","9.36"
"10","013","00","130","0016","0463","556","142","414","3","559","1517","0","36.85","9.36"
"10","013","00","130","0017","0000","884","414","470","13","897","2397","0","37.42","17.27"
"10","013","00","130","0017","0464","481","221","260","8","489","1200","0","40.75","18.42"
"10","013","00","130","0017","0465","403","193","210","5","408","1197","0","34.09","16.12"
"10","013","00","130","0018","0000","758","405","353","9","767","2350","0","32.64","17.23"
"10","013","00","130","0018","0466","420","214","206","7","427","1325","0","32.23","16.15"
"10","013","00","130","0018","0467","338","191","147","2","340","1025","0","33.17","18.63"
"10","013","00","130","0019","0000","362","142","220","6","368","782","0","47.06","18.16"
"10","013","00","130","0019","0468","362","142","220","6","368","782","0","47.06","18.16"
"10","013","00","130","0020","0000","701","283","418","11","712","1726","0","41.25","16.40"
"10","013","00","130","0020","0469","359","107","252","6","365","878","0","41.57","12.19"
"10","013","00","130","0020","0470","342","176","166","5","347","848","0","40.92","20.75"
"10","013","00","130","0021","0000","843","253","590","11","854","2405","0","35.51","10.52"
"10","013","00","130","0021","0471","436","143","293","2","438","1212","0","36.14","11.80"
"10","013","00","130","0021","0472","407","110","297","9","416","1193","0","34.87","9.22"
"10","013","00","130","0022","0000","414","140","274","5","419","1260","0","33.25","11.11"
"10","013","00","130","0022","0473","414","140","274","5","419","1260","0","33.25","11.11"
"10","013","00","130","0023","0000","329","142","187","6","335","795","0","42.14","17.86"
"10","013","00","130","0023","0474","329","142","187","6","335","795","0","42.14","17.86"
"10","013","00","140","0000","0000","6723","2372","4351","76","6799","14893","16409","45.65","15.93"
"10","013","00","140","0001","0000","662","246","416","3","665","1447","0","45.96","17.00"
"10","013","00","140","0001","0475","662","246","416","3","665","1447","0","45.96","17.00"
"10","013","00","140","0002","0000","409","117","292","5","414","868","0","47.70","13.48"
"10","013","00","140","0002","0476","409","117","292","5","414","868","0","47.70","13.48"
"10","013","00","140","0003","0000","333","122","211","5","338","676","0","50.00","18.05"
"10","013","00","140","0003","0477","333","122","211","5","338","676","0","50.00","18.05"
"10","013","00","140","0004","0000","276","92","184","5","281","577","0","48.70","15.94"
"10","013","00","140","0004","0478","276","92","184","5","281","577","0","48.70","15.94"
"10","013","00","140","0005","0000","572","176","396","5","577","1289","0","44.76","13.65"
"10","013","00","140","0005","0479","572","176","396","5","577","1289","0","44.76","13.65"
"10","013","00","140","0006","0000","474","165","309","3","477","969","0","49.23","17.03"
"10","013","00","140","0006","0480","474","165","309","3","477","969","0","49.23","17.03"
"10","013","00","140","0007","0000","316","120","196","2","318","621","0","51.21","19.32"
"10","013","00","140","0007","0481","316","120","196","2","318","621","0","51.21","19.32"
"10","013","00","140","0008","0000","253","76","177","1","254","459","0","55.34","16.56"
"10","013","00","140","0008","0482","253","76","177","1","254","459","0","55.34","16.56"
"10","013","00","140","0009","0000","1096","413","683","11","1107","2368","0","46.75","17.44"
"10","013","00","140","0009","0483","553","233","320","5","558","1201","0","46.46","19.40"
"10","013","00","140","0009","0484","543","180","363","6","549","1167","0","47.04","15.42"
"10","013","00","140","0010","0000","237","86","151","4","241","477","0","50.52","18.03"
"10","013","00","140","0010","0485","237","86","151","4","241","477","0","50.52","18.03"
"10","013","00","140","0011","0000","353","124","229","0","353","881","0","40.07","14.07"
"10","013","00","140","0011","0486","353","124","229","0","353","881","0","40.07","14.07"
"10","013","00","140","0012","0000","359","128","231","7","366","796","0","45.98","16.08"
"10","013","00","140","0012","0487","359","128","231","7","366","796","0","45.98","16.08"
"10","013","00","140","0013","0000","426","159","267","12","438","1099","0","39.85","14.47"
"10","013","00","140","0013","0488","426","159","267","12","438","1099","0","39.85","14.47"
"10","013","00","140","0014","0000","499","156","343","5","504","1186","0","42.50","13.15"
"10","013","00","140","0014","0489","499","156","343","5","504","1186","0","42.50","13.15"
"10","013","00","140","0015","0000","458","192","266","8","466","1180","0","39.49","16.27"
"10","013","00","140","0015","0490","458","192","266","8","466","1180","0","39.49","16.27"
"10","013","00","150","0000","0000","3378","1334","2044","44","3422","8649","9464","39.57","15.42"
"10","013","00","150","0001","0000","831","380","451","8","839","1959","0","42.83","19.40"
"10","013","00","150","0001","0491","317","147","170","3","320","717","0","44.63","20.50"
"10","013","00","150","0001","0492","375","165","210","5","380","938","0","40.51","17.59"
"10","013","00","150","0001","0493","139","68","71","0","139","304","0","45.72","22.37"
"10","013","00","150","0002","0000","533","200","333","2","535","1030","0","51.94","19.42"
"10","013","00","150","0002","0494","365","129","236","2","367","712","0","51.54","18.12"
"10","013","00","150","0002","0495","168","71","97","0","168","318","0","52.83","22.33"
"10","013","00","150","0003","0000","384","168","216","8","392","860","0","45.58","19.53"
"10","013","00","150","0003","0496","384","168","216","8","392","860","0","45.58","19.53"
"10","013","00","150","0004","0000","341","119","222","3","344","734","0","46.87","16.21"
"10","013","00","150","0004","0497","341","119","222","3","344","734","0","46.87","16.21"
"10","013","00","150","0005","0000","565","242","323","7","572","1713","0","33.39","14.13"
"10","013","00","150","0005","0498","162","51","111","0","162","368","0","44.02","13.86"
"10","013","00","150","0005","0499","216","105","111","5","221","665","0","33.23","15.79"
"10","013","00","150","0005","0500","187","86","101","2","189","680","0","27.79","12.65"
"10","013","00","150","0006","0000","360","127","233","8","368","1100","0","33.45","11.55"
"10","013","00","150","0006","0502","168","60","108","2","170","524","0","32.44","11.45"
"10","013","00","150","0006","0503","192","67","125","6","198","576","0","34.38","11.63"
"10","013","00","150","0007","0000","364","98","266","8","372","1253","0","29.69","7.82"
"10","013","00","150","0007","0501","364","98","266","8","372","1253","0","29.69","7.82"
"10","013","00","160","0000","0000","7946","2948","4998","95","8041","20786","23466","38.68","14.18"
"10","013","00","160","0001","0000","463","230","233","3","466","1196","0","38.96","19.23"
"10","013","00","160","0001","0504","463","230","233","3","466","1196","0","38.96","19.23"
"10","013","00","160","0002","0000","320","175","145","7","327","865","0","37.80","20.23"
"10","013","00","160","0002","0505","320","175","145","7","327","865","0","37.80","20.23"
"10","013","00","160","0003","0000","353","120","233","3","356","906","0","39.29","13.25"
"10","013","00","160","0003","0506","353","120","233","3","356","906","0","39.29","13.25"
"10","013","00","160","0004","0000","251","76","175","2","253","573","0","44.15","13.26"
"10","013","00","160","0004","0507","251","76","175","2","253","573","0","44.15","13.26"
"10","013","00","160","0005","0000","614","205","409","7","621","1578","0","39.35","12.99"
"10","013","00","160","0005","0508","315","106","209","2","317","834","0","38.01","12.71"
"10","013","00","160","0005","0509","299","99","200","5","304","744","0","40.86","13.31"
"10","013","00","160","0006","0000","1528","479","1049","22","1550","4151","0","37.34","11.54"
"10","013","00","160","0006","0510","339","106","233","3","342","1005","0","34.03","10.55"
"10","013","00","160","0006","0511","396","114","282","7","403","1033","0","39.01","11.04"
"10","013","00","160","0006","0512","398","129","269","8","406","1079","0","37.63","11.96"
"10","013","00","160","0006","0513","395","130","265","4","399","1034","0","38.59","12.57"
"10","013","00","160","0007","0000","798","264","534","11","809","1866","0","43.35","14.15"
"10","013","00","160","0007","0514","388","123","265","7","395","921","0","42.89","13.36"
"10","013","00","160","0007","0515","410","141","269","4","414","945","0","43.81","14.92"
"10","013","00","160","0008","0000","651","252","399","3","654","1416","0","46.19","17.80"
"10","013","00","160","0008","0516","333","125","208","1","334","694","0","48.13","18.01"
"10","013","00","160","0008","0517","318","127","191","2","320","722","0","44.32","17.59"
"10","013","00","160","0009","0000","830","308","522","6","836","2027","0","41.24","15.19"
"10","013","00","160","0009","0518","400","145","255","4","404","987","0","40.93","14.69"
"10","013","00","160","0009","0519","430","163","267","2","432","1040","0","41.54","15.67"
"10","013","00","160","0010","0000","250","64","186","3","253","695","0","36.40","9.21"
"10","013","00","160","0010","0520","250","64","186","3","253","695","0","36.40","9.21"
"10","013","00","160","0011","0000","234","92","142","3","237","874","0","27.12","10.53"
"10","013","00","160","0011","0521","234","92","142","3","237","874","0","27.12","10.53"
"10","013","00","160","0012","0000","286","124","162","6","292","927","0","31.50","13.38"
"10","013","00","160","0012","0526","286","124","162","6","292","927","0","31.50","13.38"
"10","013","00","160","0013","0000","120","56","64","2","122","428","0","28.50","13.08"
"10","013","00","160","0013","0527","120","56","64","2","122","428","0","28.50","13.08"
"10","013","00","160","0014","0000","1015","432","583","15","1030","2680","0","38.43","16.12"
"10","013","00","160","0014","0522","369","159","210","5","374","963","0","38.84","16.51"
"10","013","00","160","0014","0523","294","123","171","6","300","792","0","37.88","15.53"
"10","013","00","160","0014","0524","352","150","202","4","356","925","0","38.49","16.22"
"10","013","00","160","0015","0000","233","71","162","2","235","604","0","38.91","11.75"
"10","013","00","160","0015","0525","233","71","162","2","235","604","0","38.91","11.75"
"10","013","00","170","0000","0000","11622","3330","8292","143","11765","29974","33639","39.25","11.11"
"10","013","00","170","0001","0000","672","180","492","6","678","1629","0","41.62","11.05"
"10","013","00","170","0001","0528","334","102","232","2","336","809","0","41.53","12.61"
"10","013","00","170","0001","0529","338","78","260","4","342","820","0","41.71","9.51"
"10","013","00","170","0002","0000","908","282","626","11","919","2479","0","37.07","11.38"
"10","013","00","170","0002","0530","445","143","302","3","448","1212","0","36.96","11.80"
"10","013","00","170","0002","0531","463","139","324","8","471","1267","0","37.17","10.97"
"10","013","00","170","0003","0000","818","223","595","9","827","2135","0","38.74","10.44"
"10","013","00","170","0003","0532","381","97","284","4","385","1052","0","36.60","9.22"
"10","013","00","170","0003","0533","437","126","311","5","442","1083","0","40.81","11.63"
"10","013","00","170","0004","0000","306","107","199","2","308","807","0","38.17","13.26"
"10","013","00","170","0004","0534","306","107","199","2","308","807","0","38.17","13.26"
"10","013","00","170","0005","0000","357","117","240","6","363","820","0","44.27","14.27"
"10","013","00","170","0005","0535","357","117","240","6","363","820","0","44.27","14.27"
"10","013","00","170","0006","0000","826","318","508","13","839","2294","0","36.57","13.86"
"10","013","00","170","0006","0536","419","165","254","7","426","1185","0","35.95","13.92"
"10","013","00","170","0006","0537","407","153","254","6","413","1109","0","37.24","13.80"
"10","013","00","170","0007","0000","881","282","599","8","889","2190","0","40.59","12.88"
"10","013","00","170","0007","0538","423","145","278","3","426","1074","0","39.66","13.50"
"10","013","00","170","0007","0539","458","137","321","5","463","1116","0","41.49","12.28"
"10","013","00","170","0008","0000","502","141","361","7","509","1194","0","42.63","11.81"
"10","013","00","170","0008","0542","502","141","361","7","509","1194","0","42.63","11.81"
"10","013","00","170","0009","0000","903","243","660","5","908","2092","0","43.40","11.62"
"10","013","00","170","0009","0543","464","106","358","2","466","1058","0","44.05","10.02"
"10","013","00","170","0009","0544","439","137","302","3","442","1034","0","42.75","13.25"
"10","013","00","170","0010","0000","639","125","514","13","652","1553","0","41.98","8.05"
"10","013","00","170","0010","0545","328","55","273","4","332","843","0","39.38","6.52"
"10","013","00","170","0010","0546","311","70","241","9","320","710","0","45.07","9.86"
"10","013","00","170","0011","0000","569","146","423","7","576","1368","0","42.11","10.67"
"10","013","00","170","0011","0547","569","146","423","7","576","1368","0","42.11","10.67"
"10","013","00","170","0012","0000","800","253","547","7","807","2061","0","39.16","12.28"
"10","013","00","170","0012","0540","377","149","228","4","381","994","0","38.33","14.99"
"10","013","00","170","0012","0541","423","104","319","3","426","1067","0","39.93","9.75"
"10","013","00","170","0013","0000","1059","346","713","11","1070","2733","0","39.15","12.66"
"10","013","00","170","0013","0548","349","94","255","5","354","856","0","41.36","10.98"
"10","013","00","170","0013","0549","369","98","271","3","372","935","0","39.79","10.48"
"10","013","00","170","0013","0550","341","154","187","3","344","942","0","36.52","16.35"
"10","013","00","170","0014","0000","1609","407","1202","23","1632","4335","0","37.65","9.39"
"10","013","00","170","0014","0551","483","106","377","2","485","1398","0","34.69","7.58"
"10","013","00","170","0014","0552","667","169","498","12","679","1695","0","40.06","9.97"
"10","013","00","170","0014","0553","459","132","327","9","468","1242","0","37.68","10.63"
"10","013","00","170","0015","0000","773","160","613","15","788","2284","0","34.50","7.01"
"10","013","00","170","0015","0554","388","84","304","6","394","1080","0","36.48","7.78"
"10","013","00","170","0015","0555","385","76","309","9","394","1204","0","32.72","6.31"
"10","013","00","180","0000","0000","4686","1561","3125","53","4739","11939","15223","39.69","13.07"
"10","013","00","180","0001","0000","845","321","524","7","852","2220","0","38.38","14.46"
"10","013","00","180","0001","0556","458","164","294","2","460","1203","0","38.24","13.63"
"10","013","00","180","0001","0557","387","157","230","5","392","1017","0","38.54","15.44"
"10","013","00","180","0002","0000","794","300","494","8","802","1996","0","40.18","15.03"
"10","013","00","180","0002","0558","297","122","175","4","301","778","0","38.69","15.68"
"10","013","00","180","0002","0559","497","178","319","4","501","1218","0","41.13","14.61"
"10","013","00","180","0003","0000","492","175","317","5","497","1200","0","41.42","14.58"
"10","013","00","180","0003","0561","492","175","317","5","497","1200","0","41.42","14.58"
"10","013","00","180","0004","0000","505","144","361","8","513","1272","0","40.33","11.32"
"10","013","00","180","0004","0560","505","144","361","8","513","1272","0","40.33","11.32"
"10","013","00","180","0005","0000","369","115","254","4","373","1046","0","35.66","10.99"
"10","013","00","180","0005","0562","369","115","254","4","373","1046","0","35.66","10.99"
"10","013","00","180","0006","0000","600","188","412","15","615","1466","0","41.95","12.82"
"10","013","00","180","0006","0563","307","106","201","6","313","758","0","41.29","13.98"
"10","013","00","180","0006","0564","293","82","211","9","302","708","0","42.66","11.58"
"10","013","00","180","0007","0000","357","124","233","1","358","905","0","39.56","13.70"
"10","013","00","180","0007","0565","357","124","233","1","358","905","0","39.56","13.70"
"10","013","00","180","0008","0000","724","194","530","5","729","1834","0","39.75","10.58"
"10","013","00","180","0008","0566","324","83","241","4","328","874","0","37.53","9.50"
"10","013","00","180","0008","0567","400","111","289","1","401","960","0","41.77","11.56"
"10","013","00","190","0000","0000","6275","2075","4200","82","6357","15160","17145","41.93","13.69"
"10","013","00","190","0001","0000","624","203","421","6","630","1392","0","45.26","14.58"
"10","013","00","190","0001","0568","296","95","201","3","299","657","0","45.51","14.46"
"10","013","00","190","0001","0569","328","108","220","3","331","735","0","45.03","14.69"
"10","013","00","190","0002","0000","623","193","430","5","628","1509","0","41.62","12.79"
"10","013","00","190","0002","0570","356","102","254","3","359","856","0","41.94","11.92"
"10","013","00","190","0002","0571","267","91","176","2","269","653","0","41.19","13.94"
"10","013","00","190","0003","0000","693","217","476","7","700","1603","0","43.67","13.54"
"10","013","00","190","0003","0576","365","117","248","2","367","770","0","47.66","15.19"
"10","013","00","190","0003","0577","328","100","228","5","333","833","0","39.98","12.00"
"10","013","00","190","0004","0000","322","125","197","4","326","690","0","47.25","18.12"
"10","013","00","190","0004","0575","322","125","197","4","326","690","0","47.25","18.12"
"10","013","00","190","0005","0000","1376","437","939","14","1390","3098","0","44.87","14.11"
"10","013","00","190","0005","0572","480","148","332","5","485","1015","0","47.78","14.58"
"10","013","00","190","0005","0573","485","158","327","6","491","1126","0","43.61","14.03"
"10","013","00","190","0005","0574","411","131","280","3","414","957","0","43.26","13.69"
"10","013","00","190","0006","0000","641","246","395","13","654","1761","0","37.14","13.97"
"10","013","00","190","0006","0580","293","100","193","1","294","762","0","38.58","13.12"
"10","013","00","190","0006","0581","348","146","202","12","360","999","0","36.04","14.61"
"10","013","00","190","0007","0000","429","157","272","9","438","1241","0","35.29","12.65"
"10","013","00","190","0007","0579","429","157","272","9","438","1241","0","35.29","12.65"
"10","013","00","190","0008","0000","348","111","237","7","355","895","0","39.66","12.40"
"10","013","00","190","0008","0578","348","111","237","7","355","895","0","39.66","12.40"
"10","013","00","190","0009","0000","756","231","525","9","765","1885","0","40.58","12.25"
"10","013","00","190","0009","0582","479","162","317","7","486","1120","0","43.39","14.46"
"10","013","00","190","0009","0583","277","69","208","2","279","765","0","36.47","9.02"
"10","013","00","190","0010","0000","463","155","308","8","471","1086","0","43.37","14.27"
"10","013","00","190","0010","0584","463","155","308","8","471","1086","0","43.37","14.27"
"10","013","00","200","0000","0000","3880","1326","2554","42","3922","9254","10249","42.38","14.33"
"10","013","00","200","0001","0000","689","241","448","6","695","1652","0","42.07","14.59"
"10","013","00","200","0001","0585","352","127","225","3","355","844","0","42.06","15.05"
"10","013","00","200","0001","0586","337","114","223","3","340","808","0","42.08","14.11"
"10","013","00","200","0002","0000","395","149","246","4","399","908","0","43.94","16.41"
"10","013","00","200","0002","0587","395","149","246","4","399","908","0","43.94","16.41"
"10","013","00","200","0003","0000","221","80","141","2","223","487","0","45.79","16.43"
"10","013","00","200","0003","0590","221","80","141","2","223","487","0","45.79","16.43"
"10","013","00","200","0004","0000","308","184","124","3","311","673","0","46.21","27.34"
"10","013","00","200","0004","0591","308","184","124","3","311","673","0","46.21","27.34"
"10","013","00","200","0005","0000","365","128","237","4","369","1011","0","36.50","12.66"
"10","013","00","200","0005","0588","365","128","237","4","369","1011","0","36.50","12.66"
"10","013","00","200","0006","0000","367","133","234","1","368","965","0","38.13","13.78"
"10","013","00","200","0006","0589","367","133","234","1","368","965","0","38.13","13.78"
"10","013","00","200","0007","0000","455","172","283","5","460","1028","0","44.75","16.73"
"10","013","00","200","0007","0592","455","172","283","5","460","1028","0","44.75","16.73"
"10","013","00","200","0008","0000","425","78","347","6","431","1050","0","41.05","7.43"
"10","013","00","200","0008","0593","425","78","347","6","431","1050","0","41.05","7.43"
"10","013","00","200","0009","0000","420","97","323","6","426","965","0","44.15","10.05"
"10","013","00","200","0009","0594","420","97","323","6","426","965","0","44.15","10.05"
"10","013","00","200","0010","0000","235","64","171","5","240","515","0","46.60","12.43"
"10","013","00","200","0010","0595","235","64","171","5","240","515","0","46.60","12.43"
"10","013","00","210","0000","0000","6423","2079","4344","74","6497","16509","18414","39.35","12.59"
"10","013","00","210","0001","0000","582","213","369","8","590","1467","0","40.22","14.52"
"10","013","00","210","0001","0596","582","213","369","8","590","1467","0","40.22","14.52"
"10","013","00","210","0002","0000","542","190","352","6","548","1302","0","42.09","14.59"
"10","013","00","210","0002","0597","542","190","352","6","548","1302","0","42.09","14.59"
"10","013","00","210","0003","0000","343","102","241","2","345","733","0","47.07","13.92"
"10","013","00","210","0003","0598","343","102","241","2","345","733","0","47.07","13.92"
"10","013","00","210","0004","0000","694","250","444","2","696","1793","0","38.82","13.94"
"10","013","00","210","0004","0599","351","118","233","2","353","926","0","38.12","12.74"
"10","013","00","210","0004","0600","343","132","211","0","343","867","0","39.56","15.22"
"10","013","00","210","0005","0000","802","213","589","7","809","1922","0","42.09","11.08"
"10","013","00","210","0005","0601","382","106","276","4","386","928","0","41.59","11.42"
"10","013","00","210","0005","0602","420","107","313","3","423","994","0","42.56","10.76"
"10","013","00","210","0006","0000","793","203","590","13","806","2056","0","39.20","9.87"
"10","013","00","210","0006","0603","340","82","258","7","347","839","0","41.36","9.77"
"10","013","00","210","0006","0604","453","121","332","6","459","1217","0","37.72","9.94"
"10","013","00","210","0007","0000","402","121","281","8","410","936","0","43.80","12.93"
"10","013","00","210","0007","0605","402","121","281","8","410","936","0","43.80","12.93"
"10","013","00","210","0008","0000","275","95","180","2","277","674","0","41.10","14.09"
"10","013","00","210","0008","0606","275","95","180","2","277","674","0","41.10","14.09"
"10","013","00","210","0009","0000","448","127","321","6","454","1138","0","39.89","11.16"
"10","013","00","210","0009","0607","448","127","321","6","454","1138","0","39.89","11.16"
"10","013","00","210","0010","0000","410","108","302","9","419","1061","0","39.49","10.18"
"10","013","00","210","0010","0608","410","108","302","9","419","1061","0","39.49","10.18"
"10","013","00","210","0011","0000","359","123","236","1","360","1072","0","33.58","11.47"
"10","013","00","210","0011","0609","359","123","236","1","360","1072","0","33.58","11.47"
"10","013","00","210","0012","0000","773","334","439","10","783","2355","0","33.25","14.18"
"10","013","00","210","0012","0610","353","150","203","7","360","1229","0","29.29","12.21"
"10","013","00","210","0012","0611","420","184","236","3","423","1126","0","37.57","16.34"
"10","013","00","220","0000","0000","2105","1180","925","19","2124","10595","12095","20.05","11.14"
"10","013","00","220","0001","0000","499","250","249","5","504","2066","0","24.39","12.10"
"10","013","00","220","0001","0612","264","118","146","1","265","1093","0","24.25","10.80"
"10","013","00","220","0001","0613","235","132","103","4","239","973","0","24.56","13.57"
"10","013","00","220","0002","0000","271","144","127","3","274","1247","0","21.97","11.55"
"10","013","00","220","0002","0614","271","144","127","3","274","1247","0","21.97","11.55"
"10","013","00","220","0003","0000","223","157","66","3","226","975","0","23.18","16.10"
"10","013","00","220","0003","0615","223","157","66","3","226","975","0","23.18","16.10"
"10","013","00","220","0004","0000","291","177","114","2","293","1617","0","18.12","10.95"
"10","013","00","220","0004","0616","291","177","114","2","293","1617","0","18.12","10.95"
"10","013","00","220","0005","0000","193","104","89","1","194","1117","0","17.37","9.31"
"10","013","00","220","0005","0617","193","104","89","1","194","1117","0","17.37","9.31"
"10","013","00","220","0006","0000","197","108","89","1","198","1101","0","17.98","9.81"
"10","013","00","220","0006","0618","197","108","89","1","198","1101","0","17.98","9.81"
"10","013","00","220","0007","0000","259","153","106","3","262","1622","0","16.15","9.43"
"10","013","00","220","0007","0619","259","153","106","3","262","1622","0","16.15","9.43"
"10","013","00","220","0008","0000","172","87","85","1","173","850","0","20.35","10.24"
"10","013","00","220","0008","0620","172","87","85","1","173","850","0","20.35","10.24"
"10","013","00","230","0000","0000","2363","958","1405","37","2400","7290","8221","32.92","13.14"
"10","013","00","230","0001","0000","486","209","277","6","492","1315","0","37.41","15.89"
"10","013","00","230","0001","0623","174","72","102","4","178","470","0","37.87","15.32"
"10","013","00","230","0001","0624","312","137","175","2","314","845","0","37.16","16.21"
"10","013","00","230","0002","0000","226","60","166","1","227","534","0","42.51","11.24"
"10","013","00","230","0002","0625","226","60","166","1","227","534","0","42.51","11.24"
"10","013","00","230","0003","0000","156","62","94","1","157","610","0","25.74","10.16"
"10","013","00","230","0003","0622","156","62","94","1","157","610","0","25.74","10.16"
"10","013","00","230","0004","0000","203","91","112","5","208","717","0","29.01","12.69"
"10","013","00","230","0004","0621","203","91","112","5","208","717","0","29.01","12.69"
"10","013","00","230","0005","0000","111","45","66","0","111","370","0","30.00","12.16"
"10","013","00","230","0005","0626","111","45","66","0","111","370","0","30.00","12.16"
"10","013","00","230","0006","0000","267","113","154","6","273","837","0","32.62","13.50"
"10","013","00","230","0006","0627","267","113","154","6","273","837","0","32.62","13.50"
"10","013","00","230","0007","0000","351","147","204","9","360","1197","0","30.08","12.28"
"10","013","00","230","0007","0628","172","67","105","5","177","585","0","30.26","11.45"
"10","013","00","230","0007","0629","179","80","99","4","183","612","0","29.90","13.07"
"10","013","00","230","0008","0000","147","36","111","1","148","418","0","35.41","8.61"
"10","013","00","230","0008","0630","147","36","111","1","148","418","0","35.41","8.61"
"10","013","00","230","0009","0000","110","59","51","2","112","412","0","27.18","14.32"
"10","013","00","230","0009","0631","110","59","51","2","112","412","0","27.18","14.32"
"10","013","00","230","0010","0000","151","72","79","3","154","481","0","32.02","14.97"
"10","013","00","230","0010","0632","151","72","79","3","154","481","0","32.02","14.97"
"10","013","00","230","0011","0000","155","64","91","3","158","399","0","39.60","16.04"
"10","013","00","230","0011","0633","155","64","91","3","158","399","0","39.60","16.04"
"10","013","00","240","0000","0000","1902","837","1065","22","1924","6686","7397","28.78","12.52"
"10","013","00","240","0001","0000","423","202","221","4","427","1429","0","29.88","14.14"
"10","013","00","240","0001","0634","423","202","221","4","427","1429","0","29.88","14.14"
"10","013","00","240","0002","0000","117","55","62","3","120","392","0","30.61","14.03"
"10","013","00","240","0002","0635","117","55","62","3","120","392","0","30.61","14.03"
"10","013","00","240","0003","0000","370","168","202","4","374","1208","0","30.96","13.91"
"10","013","00","240","0003","0637","370","168","202","4","374","1208","0","30.96","13.91"
"10","013","00","240","0004","0000","391","133","258","4","395","1223","0","32.30","10.87"
"10","013","00","240","0004","0638","391","133","258","4","395","1223","0","32.30","10.87"
"10","013","00","240","0005","0000","148","52","96","0","148","526","0","28.14","9.89"
"10","013","00","240","0005","0636","148","52","96","0","148","526","0","28.14","9.89"
"10","013","00","240","0006","0000","266","138","128","6","272","1255","0","21.67","11.00"
"10","013","00","240","0006","0639","266","138","128","6","272","1255","0","21.67","11.00"
"10","013","00","240","0007","0000","89","43","46","1","90","348","0","25.86","12.36"
"10","013","00","240","0007","0640","89","43","46","1","90","348","0","25.86","12.36"
"10","013","00","240","0008","0000","98","46","52","0","98","305","0","32.13","15.08"
"10","013","00","240","0008","0641","98","46","52","0","98","305","0","32.13","15.08"
"10","013","00","250","0000","0000","1582","561","1021","26","1608","4637","5145","34.68","12.10"
"10","013","00","250","0001","0000","353","179","174","8","361","966","0","37.37","18.53"
"10","013","00","250","0001","0642","204","101","103","6","210","548","0","38.32","18.43"
"10","013","00","250","0001","0643","149","78","71","2","151","418","0","36.12","18.66"
"10","013","00","250","0002","0000","691","231","460","11","702","1872","0","37.50","12.34"
"10","013","00","250","0002","0644","332","87","245","6","338","901","0","37.51","9.66"
"10","013","00","250","0002","0645","359","144","215","5","364","971","0","37.49","14.83"
"10","013","00","250","0003","0000","290","75","215","4","294","962","0","30.56","7.80"
"10","013","00","250","0003","0646","290","75","215","4","294","962","0","30.56","7.80"
"10","013","00","250","0004","0000","248","76","172","3","251","837","0","29.99","9.08"
"10","013","00","250","0004","0647","248","76","172","3","251","837","0","29.99","9.08"
"10","013","00","260","0000","0000","1936","1490","446","37","1973","6401","7691","30.82","23.28"
"10","013","00","260","0001","0000","551","438","113","15","566","1460","0","38.77","30.00"
"10","013","00","260","0001","0651","551","438","113","15","566","1460","0","38.77","30.00"
"10","013","00","260","0002","0000","96","62","34","0","96","341","0","28.15","18.18"
"10","013","00","260","0002","0650","96","62","34","0","96","341","0","28.15","18.18"
"10","013","00","260","0003","0000","87","61","26","1","88","566","0","15.55","10.78"
"10","013","00","260","0003","0649","87","61","26","1","88","566","0","15.55","10.78"
"10","013","00","260","0004","0000","172","143","29","6","178","639","0","27.86","22.38"
"10","013","00","260","0004","0648","172","143","29","6","178","639","0","27.86","22.38"
"10","013","00","260","0005","0000","218","161","57","3","221","725","0","30.48","22.21"
"10","013","00","260","0005","0652","218","161","57","3","221","725","0","30.48","22.21"
"10","013","00","260","0006","0000","189","142","47","4","193","550","0","35.09","25.82"
"10","013","00","260","0006","0653","189","142","47","4","193","550","0","35.09","25.82"
"10","013","00","260","0007","0000","101","69","32","0","101","341","0","29.62","20.23"
"10","013","00","260","0007","0654","101","69","32","0","101","341","0","29.62","20.23"
"10","013","00","260","0008","0000","157","116","41","1","158","468","0","33.76","24.79"
"10","013","00","260","0008","0655","157","116","41","1","158","468","0","33.76","24.79"
"10","013","00","260","0009","0000","199","165","34","5","204","694","0","29.39","23.78"
"10","013","00","260","0009","0656","199","165","34","5","204","694","0","29.39","23.78"
"10","013","00","260","0010","0000","166","133","33","2","168","617","0","27.23","21.56"
"10","013","00","260","0010","0657","166","133","33","2","168","617","0","27.23","21.56"
"10","013","00","270","0000","0000","930","659","271","6","936","2842","3230","32.93","23.19"
"10","013","00","270","0001","0000","351","238","113","0","351","1089","0","32.23","21.85"
"10","013","00","270","0001","0658","115","75","40","0","115","314","0","36.62","23.89"
"10","013","00","270","0001","0659","181","136","45","0","181","614","0","29.48","22.15"
"10","013","00","270","0001","0660","55","27","28","0","55","161","0","34.16","16.77"
"10","013","00","270","0002","0000","107","90","17","0","107","297","0","36.03","30.30"
"10","013","00","270","0002","0662","107","90","17","0","107","297","0","36.03","30.30"
"10","013","00","270","0003","0000","72","53","19","0","72","183","0","39.34","28.96"
"10","013","00","270","0003","0661","72","53","19","0","72","183","0","39.34","28.96"
"10","013","00","270","0004","0000","67","39","28","1","68","441","0","15.42","8.84"
"10","013","00","270","0004","0665","67","39","28","1","68","441","0","15.42","8.84"
"10","013","00","270","0005","0000","149","125","24","2","151","356","0","42.42","35.11"
"10","013","00","270","0005","0664","149","125","24","2","151","356","0","42.42","35.11"
"10","013","00","270","0006","0000","184","114","70","3","187","476","0","39.29","23.95"
"10","013","00","270","0006","0663","184","114","70","3","187","476","0","39.29","23.95"
"10","013","00","280","0000","0000","1973","1546","427","19","1992","5610","6706","35.51","27.56"
"10","013","00","280","0001","0000","160","119","41","2","162","443","0","36.57","26.86"
"10","013","00","280","0001","0666","160","119","41","2","162","443","0","36.57","26.86"
"10","013","00","280","0002","0000","311","244","67","2","313","771","0","40.60","31.65"
"10","013","00","280","0002","0667","311","244","67","2","313","771","0","40.60","31.65"
"10","013","00","280","0003","0000","283","226","57","0","283","1041","0","27.19","21.71"
"10","013","00","280","0003","0671","283","226","57","0","283","1041","0","27.19","21.71"
"10","013","00","280","0004","0000","305","209","96","5","310","887","0","34.95","23.56"
"10","013","00","280","0004","0672","305","209","96","5","310","887","0","34.95","23.56"
"10","013","00","280","0005","0000","133","107","26","2","135","419","0","32.22","25.54"
"10","013","00","280","0005","0673","133","107","26","2","135","419","0","32.22","25.54"
"10","013","00","280","0006","0000","781","641","140","8","789","2049","0","38.51","31.28"
"10","013","00","280","0006","0668","237","189","48","5","242","655","0","36.95","28.85"
"10","013","00","280","0006","0669","291","248","43","0","291","711","0","40.93","34.88"
"10","013","00","280","0006","0670","253","204","49","3","256","683","0","37.48","29.87"
"10","013","00","290","0000","0000","1445","1164","281","22","1467","4332","5365","33.86","26.87"
"10","013","00","290","0001","0000","322","276","46","5","327","844","0","38.74","32.70"
"10","013","00","290","0001","0674","230","198","32","4","234","632","0","37.03","31.33"
"10","013","00","290","0001","0675","92","78","14","1","93","212","0","43.87","36.79"
"10","013","00","290","0002","0000","336","262","74","7","343","950","0","36.11","27.58"
"10","013","00","290","0002","0676","336","262","74","7","343","950","0","36.11","27.58"
"10","013","00","290","0003","0000","211","130","81","2","213","610","0","34.92","21.31"
"10","013","00","290","0003","0677","211","130","81","2","213","610","0","34.92","21.31"
"10","013","00","290","0004","0000","116","99","17","2","118","408","0","28.92","24.26"
"10","013","00","290","0004","0679","116","99","17","2","118","408","0","28.92","24.26"
"10","013","00","290","0005","0000","205","172","33","6","211","772","0","27.33","22.28"
"10","013","00","290","0005","0680","205","172","33","6","211","772","0","27.33","22.28"
"10","013","00","290","0006","0000","255","225","30","0","255","748","0","34.09","30.08"
"10","013","00","290","0006","0678","255","225","30","0","255","748","0","34.09","30.08"
"10","013","00","300","0000","0000","2171","1845","326","22","2193","6217","7400","35.27","29.68"
"10","013","00","300","0001","0000","257","218","39","1","258","909","0","28.38","23.98"
"10","013","00","300","0001","0681","257","218","39","1","258","909","0","28.38","23.98"
"10","013","00","300","0002","0000","196","155","41","1","197","586","0","33.62","26.45"
"10","013","00","300","0002","0682","132","106","26","1","133","355","0","37.46","29.86"
"10","013","00","300","0002","0683","64","49","15","0","64","231","0","27.71","21.21"
"10","013","00","300","0003","0000","260","224","36","2","262","709","0","36.95","31.59"
"10","013","00","300","0003","0684","162","141","21","0","162","434","0","37.33","32.49"
"10","013","00","300","0003","0685","98","83","15","2","100","275","0","36.36","30.18"
"10","013","00","300","0004","0000","405","348","57","4","409","1112","0","36.78","31.29"
"10","013","00","300","0004","0686","405","348","57","4","409","1112","0","36.78","31.29"
"10","013","00","300","0005","0000","297","246","51","2","299","840","0","35.60","29.29"
"10","013","00","300","0005","0687","297","246","51","2","299","840","0","35.60","29.29"
"10","013","00","300","0006","0000","347","312","35","3","350","864","0","40.51","36.11"
"10","013","00","300","0006","0688","347","312","35","3","350","864","0","40.51","36.11"
"10","013","00","300","0007","0000","409","342","67","9","418","1197","0","34.92","28.57"
"10","013","00","300","0007","0689","198","171","27","4","202","574","0","35.19","29.79"
"10","013","00","300","0007","0690","211","171","40","5","216","623","0","34.67","27.45"
"10","013","00","310","0000","0000","1014","771","243","25","1039","3975","4912","26.14","19.40"
"10","013","00","310","0001","0000","192","153","39","1","193","923","0","20.91","16.58"
"10","013","00","310","0001","0691","192","153","39","1","193","923","0","20.91","16.58"
"10","013","00","310","0002","0000","186","135","51","3","189","685","0","27.59","19.71"
"10","013","00","310","0002","0692","186","135","51","3","189","685","0","27.59","19.71"
"10","013","00","310","0003","0000","57","41","16","4","61","311","0","19.61","13.18"
"10","013","00","310","0003","0693","57","41","16","4","61","311","0","19.61","13.18"
"10","013","00","310","0004","0000","281","222","59","6","287","940","0","30.53","23.62"
"10","013","00","310","0004","0694","281","222","59","6","287","940","0","30.53","23.62"
"10","013","00","310","0005","0000","174","131","43","3","177","647","0","27.36","20.25"
"10","013","00","310","0005","0695","174","131","43","3","177","647","0","27.36","20.25"
"10","013","00","310","0006","0000","124","89","35","8","132","469","0","28.14","18.98"
"10","013","00","310","0006","0696","124","89","35","8","132","469","0","28.14","18.98"
"10","013","00","320","0000","0000","1280","1069","211","28","1308","4092","4805","31.96","26.12"
"10","013","00","320","0001","0000","225","178","47","1","226","702","0","32.19","25.36"
"10","013","00","320","0001","0697","225","178","47","1","226","702","0","32.19","25.36"
"10","013","00","320","0002","0000","200","170","30","7","207","759","0","27.27","22.40"
"10","013","00","320","0002","0698","200","170","30","7","207","759","0","27.27","22.40"
"10","013","00","320","0003","0000","213","189","24","4","217","626","0","34.66","30.19"
"10","013","00","320","0003","0699","213","189","24","4","217","626","0","34.66","30.19"
"10","013","00","320","0004","0000","72","61","11","1","73","229","0","31.88","26.64"
"10","013","00","320","0004","0700","72","61","11","1","73","229","0","31.88","26.64"
"10","013","00","320","0005","0000","93","72","21","5","98","293","0","33.45","24.57"
"10","013","00","320","0005","0701","93","72","21","5","98","293","0","33.45","24.57"
"10","013","00","320","0006","0000","146","121","25","1","147","490","0","30.00","24.69"
"10","013","00","320","0006","0702","146","121","25","1","147","490","0","30.00","24.69"
"10","013","00","320","0007","0000","220","186","34","5","225","624","0","36.06","29.81"
"10","013","00","320","0007","0703","220","186","34","5","225","624","0","36.06","29.81"
"10","013","00","320","0008","0000","111","92","19","4","115","369","0","31.17","24.93"
"10","013","00","320","0008","0704","111","92","19","4","115","369","0","31.17","24.93"
"10","013","00","330","0000","0000","1253","1027","226","22","1275","4134","4860","30.84","24.84"
"10","013","00","330","0001","0000","502","407","95","4","506","1579","0","32.05","25.78"
"10","013","00","330","0001","0705","260","209","51","2","262","732","0","35.79","28.55"
"10","013","00","330","0001","0706","116","94","22","0","116","520","0","22.31","18.08"
"10","013","00","330","0001","0707","126","104","22","2","128","327","0","39.14","31.80"
"10","013","00","330","0002","0000","221","194","27","8","229","645","0","35.50","30.08"
"10","013","00","330","0002","0708","221","194","27","8","229","645","0","35.50","30.08"
"10","013","00","330","0003","0000","148","126","22","2","150","435","0","34.48","28.97"
"10","013","00","330","0003","0709","148","126","22","2","150","435","0","34.48","28.97"
"10","013","00","330","0004","0000","128","101","27","2","130","359","0","36.21","28.13"
"10","013","00","330","0004","0710","128","101","27","2","130","359","0","36.21","28.13"
"10","013","00","330","0005","0000","150","119","31","2","152","567","0","26.81","20.99"
"10","013","00","330","0005","0711","150","119","31","2","152","567","0","26.81","20.99"
"10","013","00","330","0006","0000","104","80","24","4","108","549","0","19.67","14.57"
"10","013","00","330","0006","0712","104","80","24","4","108","549","0","19.67","14.57"
"10","002","00","000","0000","0000","145491","61292","84199","1555","147046","385260","451946","38.17","15.91"
"10","002","00","010","0000","0000","31172","14793","16379","266","31438","78886","95269","39.85","18.75"
"10","002","00","010","0001","0000","1056","562","494","8","1064","2534","0","41.99","22.18"
"10","002","00","010","0001","0024","281","156","125","2","283","625","0","45.28","24.96"
"10","002","00","010","0001","0025","418","214","204","2","420","937","0","44.82","22.84"
"10","002","00","010","0001","0026","357","192","165","4","361","972","0","37.14","19.75"
"10","002","00","010","0002","0000","595","324","271","6","601","1744","0","34.46","18.58"
"10","002","00","010","0002","0022","326","169","157","3","329","1037","0","31.73","16.30"
"10","002","00","010","0002","0023","269","155","114","3","272","707","0","38.47","21.92"
"10","002","00","010","0008","0000","923","465","458","8","931","2115","0","44.02","21.99"
"10","002","00","010","0008","0030","509","244","265","2","511","1130","0","45.22","21.59"
"10","002","00","010","0008","0031","414","221","193","6","420","985","0","42.64","22.44"
"10","002","00","010","0009","0000","527","236","291","3","530","1269","0","41.77","18.60"
"10","002","00","010","0009","0032","527","236","291","3","530","1269","0","41.77","18.60"
"10","002","00","010","0010","0000","843","359","484","8","851","1962","0","43.37","18.30"
"10","002","00","010","0010","0036","462","220","242","1","463","1126","0","41.12","19.54"
"10","002","00","010","0010","0037","381","139","242","7","388","836","0","46.41","16.63"
"10","002","00","010","0011","0000","882","495","387","8","890","2131","0","41.76","23.23"
"10","002","00","010","0011","0034","440","211","229","2","442","1010","0","43.76","20.89"
"10","002","00","010","0011","0035","442","284","158","6","448","1121","0","39.96","25.33"
"10","002","00","010","0012","0000","520","220","300","6","526","1298","0","40.52","16.95"
"10","002","00","010","0012","0033","520","220","300","6","526","1298","0","40.52","16.95"
"10","002","00","010","0013","0000","718","309","409","7","725","1846","0","39.27","16.74"
"10","002","00","010","0013","0052","358","152","206","4","362","938","0","38.59","16.20"
"10","002","00","010","0013","0053","360","157","203","3","363","908","0","39.98","17.29"
"10","002","00","010","0014","0000","845","399","446","7","852","2200","0","38.73","18.14"
"10","002","00","010","0014","0047","404","213","191","1","405","1072","0","37.78","19.87"
"10","002","00","010","0014","0048","441","186","255","6","447","1128","0","39.63","16.49"
"10","002","00","010","0015","0000","1188","590","598","15","1203","3263","0","36.87","18.08"
"10","002","00","010","0015","0041","409","186","223","4","413","1064","0","38.82","17.48"
"10","002","00","010","0015","0042","365","179","186","6","371","1111","0","33.39","16.11"
"10","002","00","010","0015","0043","414","225","189","5","419","1088","0","38.51","20.68"
"10","002","00","010","0016","0000","529","204","325","11","540","1459","0","37.01","13.98"
"10","002","00","010","0016","0054","290","100","190","8","298","765","0","38.95","13.07"
"10","002","00","010","0016","0055","239","104","135","3","242","694","0","34.87","14.99"
"10","002","00","010","0017","0000","606","299","307","5","611","1801","0","33.93","16.60"
"10","002","00","010","0017","0061","287","150","137","2","289","894","0","32.33","16.78"
"10","002","00","010","0017","0062","319","149","170","3","322","907","0","35.50","16.43"
"10","002","00","010","0018","0000","655","255","400","4","659","1464","0","45.01","17.42"
"10","002","00","010","0018","0028","325","127","198","2","327","686","0","47.67","18.51"
"10","002","00","010","0018","0029","330","128","202","2","332","778","0","42.67","16.45"
"10","002","00","010","0019","0000","401","142","259","1","402","951","0","42.27","14.93"
"10","002","00","010","0019","0057","401","142","259","1","402","951","0","42.27","14.93"
"10","002","00","010","0021","0000","632","275","357","9","641","1595","0","40.19","17.24"
"10","002","00","010","0021","0058","293","139","154","5","298","789","0","37.77","17.62"
"10","002","00","010","0021","0059","339","136","203","4","343","806","0","42.56","16.87"
"10","002","00","010","0022","0000","525","252","273","2","527","1334","0","39.51","18.89"
"10","002","00","010","0022","0060","525","252","273","2","527","1334","0","39.51","18.89"
"10","002","00","010","0023","0000","447","163","284","3","450","1122","0","40.11","14.53"
"10","002","00","010","0023","0056","447","163","284","3","450","1122","0","40.11","14.53"
"10","002","00","010","0024","0000","941","370","571","12","953","2678","0","35.59","13.82"
"10","002","00","010","0024","0066","295","110","185","5","300","890","0","33.71","12.36"
"10","002","00","010","0024","0067","276","92","184","4","280","797","0","35.13","11.54"
"10","002","00","010","0024","0068","370","168","202","3","373","991","0","37.64","16.95"
"10","002","00","010","0025","0000","764","333","431","11","775","2080","0","37.26","16.01"
"10","002","00","010","0025","0069","419","205","214","6","425","1103","0","38.53","18.59"
"10","002","00","010","0025","0070","345","128","217","5","350","977","0","35.82","13.10"
"10","002","00","010","0026","0000","827","329","498","8","835","2200","0","37.95","14.95"
"10","002","00","010","0026","0071","392","169","223","3","395","1102","0","35.84","15.34"
"10","002","00","010","0026","0072","435","160","275","5","440","1098","0","40.07","14.57"
"10","002","00","010","0027","0000","1155","428","727","8","1163","3159","0","36.82","13.55"
"10","002","00","010","0027","0073","380","155","225","2","382","972","0","39.30","15.95"
"10","002","00","010","0027","0074","398","143","255","3","401","1164","0","34.45","12.29"
"10","002","00","010","0027","0075","377","130","247","3","380","1023","0","37.15","12.71"
"10","002","00","010","0028","0000","488","191","297","4","492","1112","0","44.24","17.18"
"10","002","00","010","0028","0081","488","191","297","4","492","1112","0","44.24","17.18"
"10","002","00","010","0031","0000","346","163","183","4","350","902","0","38.80","18.07"
"10","002","00","010","0031","0078","346","163","183","4","350","902","0","38.80","18.07"
"10","002","00","010","0032","0000","739","271","468","6","745","1736","0","42.91","15.61"
"10","002","00","010","0032","0079","347","133","214","2","349","817","0","42.72","16.28"
"10","002","00","010","0032","0080","392","138","254","4","396","919","0","43.09","15.02"
"10","002","00","010","0034","0000","553","255","298","4","557","1330","0","41.88","19.17"
"10","002","00","010","0034","0076","279","151","128","2","281","616","0","45.62","24.51"
"10","002","00","010","0034","0077","274","104","170","2","276","714","0","38.66","14.57"
"10","002","00","010","0035","0000","1182","566","616","7","1189","2908","0","40.89","19.46"
"10","002","00","010","0035","0007","371","184","187","3","374","931","0","40.17","19.76"
"10","002","00","010","0035","0008","421","193","228","1","422","1000","0","42.20","19.30"
"10","002","00","010","0035","0009","390","189","201","3","393","977","0","40.23","19.34"
"10","002","00","010","0036","0000","937","494","443","12","949","2157","0","44.00","22.90"
"10","002","00","010","0036","0001","500","249","251","8","508","1107","0","45.89","22.49"
"10","002","00","010","0036","0002","437","245","192","4","441","1050","0","42.00","23.33"
"10","002","00","010","0037","0000","646","314","332","8","654","1576","0","41.50","19.92"
"10","002","00","010","0037","0003","342","162","180","7","349","834","0","41.85","19.42"
"10","002","00","010","0037","0004","304","152","152","1","305","742","0","41.11","20.49"
"10","002","00","010","0038","0000","1760","983","777","16","1776","4247","0","41.82","23.15"
"10","002","00","010","0038","0010","498","277","221","4","502","1055","0","47.58","26.26"
"10","002","00","010","0038","0011","379","227","152","4","383","1020","0","37.55","22.25"
"10","002","00","010","0038","0012","439","251","188","2","441","1056","0","41.76","23.77"
"10","002","00","010","0038","0013","444","228","216","6","450","1116","0","40.32","20.43"
"10","002","00","010","0039","0000","1229","636","593","7","1236","2966","0","41.67","21.44"
"10","002","00","010","0039","0016","368","171","197","1","369","885","0","41.69","19.32"
"10","002","00","010","0039","0017","383","222","161","5","388","944","0","41.10","23.52"
"10","002","00","010","0039","0018","478","243","235","1","479","1137","0","42.13","21.37"
"10","002","00","010","0040","0000","1084","598","486","5","1089","2613","0","41.68","22.89"
"10","002","00","010","0040","0019","377","264","113","2","379","870","0","43.56","30.34"
"10","002","00","010","0040","0020","339","175","164","3","342","779","0","43.90","22.46"
"10","002","00","010","0040","0021","368","159","209","0","368","964","0","38.17","16.49"
"10","002","00","010","0041","0000","1151","563","588","9","1160","3044","0","38.11","18.50"
"10","002","00","010","0041","0044","308","124","184","2","310","812","0","38.18","15.27"
"10","002","00","010","0041","0045","432","237","195","5","437","1146","0","38.13","20.68"
"10","002","00","010","0041","0046","411","202","209","2","413","1086","0","38.03","18.60"
"10","002","00","010","0042","0000","1169","601","568","14","1183","3099","0","38.17","19.39"
"10","002","00","010","0042","0049","451","235","216","8","459","1132","0","40.55","20.76"
"10","002","00","010","0042","0050","358","183","175","3","361","951","0","37.96","19.24"
"10","002","00","010","0042","0051","360","183","177","3","363","1016","0","35.73","18.01"
"10","002","00","010","0043","0000","1098","596","502","4","1102","2533","0","43.51","23.53"
"10","002","00","010","0043","0014","571","340","231","2","573","1294","0","44.28","26.28"
"10","002","00","010","0043","0015","527","256","271","2","529","1239","0","42.70","20.66"
"10","002","00","010","0044","0000","657","352","305","3","660","1969","0","33.52","17.88"
"10","002","00","010","0044","0005","340","185","155","0","340","1017","0","33.43","18.19"
"10","002","00","010","0044","0006","317","167","150","3","320","952","0","33.61","17.54"
"10","002","00","010","0045","0000","306","139","167","1","307","770","0","39.87","18.05"
"10","002","00","010","0045","0027","306","139","167","1","307","770","0","39.87","18.05"
"10","002","00","010","0046","0000","1017","479","538","4","1021","2844","0","35.90","16.84"
"10","002","00","010","0046","0063","441","211","230","1","442","1229","0","35.96","17.17"
"10","002","00","010","0046","0064","303","147","156","3","306","788","0","38.83","18.65"
"10","002","00","010","0046","0065","273","121","152","0","273","827","0","33.01","14.63"
"10","002","00","010","0047","0000","1231","583","648","8","1239","2875","0","43.10","20.28"
"10","002","00","010","0047","0038","433","200","233","3","436","990","0","44.04","20.20"
"10","002","00","010","0047","0039","383","184","199","1","384","905","0","42.43","20.33"
"10","002","00","010","0047","0040","415","199","216","4","419","980","0","42.76","20.31"
"10","002","00","020","0000","0000","23067","9714","13353","227","23294","56993","71097","40.87","17.04"
"10","002","00","020","0004","0000","614","255","359","11","625","1532","0","40.80","16.64"
"10","002","00","020","0004","0084","614","255","359","11","625","1532","0","40.80","16.64"
"10","002","00","020","0005","0000","1286","520","766","20","1306","3501","0","37.30","14.85"
"10","002","00","020","0005","0085","571","188","383","8","579","1443","0","40.12","13.03"
"10","002","00","020","0005","0086","362","166","196","9","371","1118","0","33.18","14.85"
"10","002","00","020","0005","0087","353","166","187","3","356","940","0","37.87","17.66"
"10","002","00","020","0006","0000","1051","364","687","8","1059","2687","0","39.41","13.55"
"10","002","00","020","0006","0088","590","194","396","4","594","1521","0","39.05","12.75"
"10","002","00","020","0006","0089","461","170","291","4","465","1166","0","39.88","14.58"
"10","002","00","020","0007","0000","1187","523","664","10","1197","3002","0","39.87","17.42"
"10","002","00","020","0007","0090","545","240","305","5","550","1304","0","42.18","18.40"
"10","002","00","020","0007","0091","338","138","200","3","341","829","0","41.13","16.65"
"10","002","00","020","0007","0092","304","145","159","2","306","869","0","35.21","16.69"
"10","002","00","020","0008","0000","877","392","485","3","880","2352","0","37.41","16.67"
"10","002","00","020","0008","0093","504","232","272","3","507","1477","0","34.33","15.71"
"10","002","00","020","0008","0094","373","160","213","0","373","875","0","42.63","18.29"
"10","002","00","020","0009","0000","551","233","318","6","557","1294","0","43.04","18.01"
"10","002","00","020","0009","0095","551","233","318","6","557","1294","0","43.04","18.01"
"10","002","00","020","0010","0000","628","265","363","5","633","1501","0","42.17","17.65"
"10","002","00","020","0010","0096","628","265","363","5","633","1501","0","42.17","17.65"
"10","002","00","020","0011","0000","489","219","270","1","490","1123","0","43.63","19.50"
"10","002","00","020","0011","0097","489","219","270","1","490","1123","0","43.63","19.50"
"10","002","00","020","0016","0000","1414","618","796","17","1431","3579","0","39.98","17.27"
"10","002","00","020","0016","0100","419","172","247","3","422","1025","0","41.17","16.78"
"10","002","00","020","0016","0101","535","253","282","7","542","1283","0","42.24","19.72"
"10","002","00","020","0016","0102","460","193","267","7","467","1271","0","36.74","15.18"
"10","002","00","020","0017","0000","1077","453","624","16","1093","2799","0","39.05","16.18"
"10","002","00","020","0017","0106","535","212","323","7","542","1413","0","38.36","15.00"
"10","002","00","020","0017","0107","542","241","301","9","551","1386","0","39.75","17.39"
"10","002","00","020","0018","0000","1090","451","639","12","1102","2795","0","39.43","16.14"
"10","002","00","020","0018","0108","439","165","274","2","441","1069","0","41.25","15.43"
"10","002","00","020","0018","0109","340","159","181","8","348","879","0","39.59","18.09"
"10","002","00","020","0018","0110","311","127","184","2","313","847","0","36.95","14.99"
"10","002","00","020","0019","0000","1387","627","760","16","1403","3502","0","40.06","17.90"
"10","002","00","020","0019","0115","563","260","303","5","568","1399","0","40.60","18.58"
"10","002","00","020","0019","0116","424","194","230","5","429","1083","0","39.61","17.91"
"10","002","00","020","0019","0117","400","173","227","6","406","1020","0","39.80","16.96"
"10","002","00","020","0020","0000","1130","460","670","8","1138","2641","0","43.09","17.42"
"10","002","00","020","0020","0118","579","243","336","2","581","1375","0","42.25","17.67"
"10","002","00","020","0020","0119","551","217","334","6","557","1266","0","44.00","17.14"
"10","002","00","020","0021","0000","368","147","221","6","374","1099","0","34.03","13.38"
"10","002","00","020","0021","0120","368","147","221","6","374","1099","0","34.03","13.38"
"10","002","00","020","0022","0000","1224","535","689","12","1236","2919","0","42.34","18.33"
"10","002","00","020","0022","0121","486","219","267","5","491","1057","0","46.45","20.72"
"10","002","00","020","0022","0122","430","185","245","4","434","1068","0","40.64","17.32"
"10","002","00","020","0022","0123","308","131","177","3","311","794","0","39.17","16.50"
"10","002","00","020","0023","0000","1156","463","693","17","1173","2844","0","41.24","16.28"
"10","002","00","020","0023","0127","368","144","224","7","375","953","0","39.35","15.11"
"10","002","00","020","0023","0128","401","155","246","2","403","952","0","42.33","16.28"
"10","002","00","020","0023","0129","387","164","223","8","395","939","0","42.07","17.47"
"10","002","00","020","0024","0000","1484","606","878","12","1496","3570","0","41.90","16.97"
"10","002","00","020","0024","0130","567","240","327","5","572","1370","0","41.75","17.52"
"10","002","00","020","0024","0131","443","169","274","5","448","1040","0","43.08","16.25"
"10","002","00","020","0024","0132","474","197","277","2","476","1160","0","41.03","16.98"
"10","002","00","020","0025","0000","1553","721","832","14","1567","3337","0","46.96","21.61"
"10","002","00","020","0025","0124","690","339","351","7","697","1354","0","51.48","25.04"
"10","002","00","020","0025","0125","402","177","225","6","408","847","0","48.17","20.90"
"10","002","00","020","0025","0126","461","205","256","1","462","1136","0","40.67","18.05"
"10","002","00","020","0026","0000","1771","792","979","14","1785","4280","0","41.71","18.50"
"10","002","00","020","0026","0111","448","199","249","4","452","1092","0","41.39","18.22"
"10","002","00","020","0026","0112","505","232","273","4","509","1135","0","44.85","20.44"
"10","002","00","020","0026","0113","440","209","231","3","443","1108","0","39.98","18.86"
"10","002","00","020","0026","0114","378","152","226","3","381","945","0","40.32","16.08"
"10","002","00","020","0027","0000","1243","535","708","6","1249","2960","0","42.20","18.07"
"10","002","00","020","0027","0103","415","197","218","1","416","1020","0","40.78","19.31"
"10","002","00","020","0027","0104","416","173","243","4","420","965","0","43.52","17.93"
"10","002","00","020","0027","0105","412","165","247","1","413","975","0","42.36","16.92"
"10","002","00","020","0028","0000","570","219","351","6","576","1355","0","42.51","16.16"
"10","002","00","020","0028","0082","313","124","189","3","316","662","0","47.73","18.73"
"10","002","00","020","0028","0083","257","95","162","3","260","693","0","37.52","13.71"
"10","002","00","020","0029","0000","535","173","362","4","539","1343","0","40.13","12.88"
"10","002","00","020","0029","0099","535","173","362","4","539","1343","0","40.13","12.88"
"10","002","00","020","0030","0000","382","143","239","3","385","978","0","39.37","14.62"
"10","002","00","020","0030","0098","382","143","239","3","385","978","0","39.37","14.62"
"10","002","00","030","0000","0000","12291","4990","7301","152","12443","33916","38592","36.69","14.71"
"10","002","00","030","0001","0000","1199","445","754","20","1219","3347","0","36.42","13.30"
"10","002","00","030","0001","0133","287","116","171","3","290","859","0","33.76","13.50"
"10","002","00","030","0001","0134","288","98","190","3","291","802","0","36.28","12.22"
"10","002","00","030","0001","0135","287","109","178","7","294","797","0","36.89","13.68"
"10","002","00","030","0001","0136","337","122","215","7","344","889","0","38.70","13.72"
"10","002","00","030","0002","0000","383","125","258","2","385","1020","0","37.75","12.25"
"10","002","00","030","0002","0137","383","125","258","2","385","1020","0","37.75","12.25"
"10","002","00","030","0003","0000","1382","518","864","11","1393","3753","0","37.12","13.80"
"10","002","00","030","0003","0138","358","136","222","3","361","1063","0","33.96","12.79"
"10","002","00","030","0003","0139","359","140","219","4","363","970","0","37.42","14.43"
"10","002","00","030","0003","0140","370","136","234","3","373","929","0","40.15","14.64"
"10","002","00","030","0003","0141","295","106","189","1","296","791","0","37.42","13.40"
"10","002","00","030","0004","0000","345","112","233","7","352","861","0","40.88","13.01"
"10","002","00","030","0004","0142","208","75","133","5","213","543","0","39.23","13.81"
"10","002","00","030","0004","0143","137","37","100","2","139","318","0","43.71","11.64"
"10","002","00","030","0005","0000","495","176","319","11","506","1218","0","41.54","14.45"
"10","002","00","030","0005","0144","338","124","214","5","343","804","0","42.66","15.42"
"10","002","00","030","0005","0145","157","52","105","6","163","414","0","39.37","12.56"
"10","002","00","030","0007","0000","1152","457","695","10","1162","3062","0","37.95","14.92"
"10","002","00","030","0007","0146","358","128","230","2","360","1015","0","35.47","12.61"
"10","002","00","030","0007","0147","394","159","235","1","395","1049","0","37.65","15.16"
"10","002","00","030","0007","0148","400","170","230","7","407","998","0","40.78","17.03"
"10","002","00","030","0008","0000","574","218","356","11","585","1452","0","40.29","15.01"
"10","002","00","030","0008","0149","380","139","241","7","387","996","0","38.86","13.96"
"10","002","00","030","0008","0150","194","79","115","4","198","456","0","43.42","17.32"
"10","002","00","030","0009","0000","795","416","379","8","803","2219","0","36.19","18.75"
"10","002","00","030","0009","0154","214","130","84","1","215","557","0","38.60","23.34"
"10","002","00","030","0009","0155","280","150","130","3","283","841","0","33.65","17.84"
"10","002","00","030","0009","0156","301","136","165","4","305","821","0","37.15","16.57"
"10","002","00","030","0010","0000","882","397","485","11","893","2348","0","38.03","16.91"
"10","002","00","030","0010","0157","308","155","153","4","312","875","0","35.66","17.71"
"10","002","00","030","0010","0158","242","109","133","3","245","661","0","37.07","16.49"
"10","002","00","030","0010","0159","332","133","199","4","336","812","0","41.38","16.38"
"10","002","00","030","0011","0000","379","194","185","4","383","953","0","40.19","20.36"
"10","002","00","030","0011","0160","379","194","185","4","383","953","0","40.19","20.36"
"10","002","00","030","0012","0000","217","92","125","0","217","437","0","49.66","21.05"
"10","002","00","030","0012","0161","217","92","125","0","217","437","0","49.66","21.05"
"10","002","00","030","0013","0000","166","82","84","1","167","499","0","33.47","16.43"
"10","002","00","030","0013","0162","166","82","84","1","167","499","0","33.47","16.43"
"10","002","00","030","0014","0000","183","78","105","2","185","521","0","35.51","14.97"
"10","002","00","030","0014","0163","183","78","105","2","185","521","0","35.51","14.97"
"10","002","00","030","0015","0000","184","102","82","1","185","431","0","42.92","23.67"
"10","002","00","030","0015","0164","184","102","82","1","185","431","0","42.92","23.67"
"10","002","00","030","0016","0000","193","80","113","1","194","573","0","33.86","13.96"
"10","002","00","030","0016","0165","193","80","113","1","194","573","0","33.86","13.96"
"10","002","00","030","0017","0000","149","63","86","4","153","439","0","34.85","14.35"
"10","002","00","030","0017","0166","149","63","86","4","153","439","0","34.85","14.35"
"10","002","00","030","0018","0000","332","148","184","2","334","909","0","36.74","16.28"
"10","002","00","030","0018","0167","332","148","184","2","334","909","0","36.74","16.28"
"10","002","00","030","0019","0000","335","111","224","0","335","893","0","37.51","12.43"
"10","002","00","030","0019","0168","335","111","224","0","335","893","0","37.51","12.43"
"10","002","00","030","0020","0000","330","123","207","7","337","1052","0","32.03","11.69"
"10","002","00","030","0020","0169","154","72","82","4","158","485","0","32.58","14.85"
"10","002","00","030","0020","0170","176","51","125","3","179","567","0","31.57","8.99"
"10","002","00","030","0021","0000","427","192","235","11","438","1414","0","30.98","13.58"
"10","002","00","030","0021","0171","234","106","128","5","239","717","0","33.33","14.78"
"10","002","00","030","0021","0172","193","86","107","6","199","697","0","28.55","12.34"
"10","002","00","030","0022","0000","345","147","198","6","351","1011","0","34.72","14.54"
"10","002","00","030","0022","0173","345","147","198","6","351","1011","0","34.72","14.54"
"10","002","00","030","0023","0000","402","138","264","6","408","1165","0","35.02","11.85"
"10","002","00","030","0023","0174","222","92","130","5","227","625","0","36.32","14.72"
"10","002","00","030","0023","0175","180","46","134","1","181","540","0","33.52","8.52"
"10","002","00","030","0024","0000","88","46","42","3","91","330","0","27.58","13.94"
"10","002","00","030","0024","0176","88","46","42","3","91","330","0","27.58","13.94"
"10","002","00","030","0025","0000","223","70","153","3","226","691","0","32.71","10.13"
"10","002","00","030","0025","0177","223","70","153","3","226","691","0","32.71","10.13"
"10","002","00","030","0026","0000","214","62","152","2","216","584","0","36.99","10.62"
"10","002","00","030","0026","0178","119","33","86","1","120","356","0","33.71","9.27"
"10","002","00","030","0026","0179","95","29","66","1","96","228","0","42.11","12.72"
"10","002","00","030","0027","0000","917","398","519","8","925","2734","0","33.83","14.56"
"10","002","00","030","0027","0151","261","116","145","2","263","785","0","33.50","14.78"
"10","002","00","030","0027","0152","299","132","167","5","304","852","0","35.68","15.49"
"10","002","00","030","0027","0153","357","150","207","1","358","1097","0","32.63","13.67"
"10","002","00","040","0000","0000","8200","3896","4304","109","8309","24942","28673","33.31","15.62"
"10","002","00","040","0001","0000","80","29","51","1","81","304","0","26.64","9.54"
"10","002","00","040","0001","0180","80","29","51","1","81","304","0","26.64","9.54"
"10","002","00","040","0002","0000","193","93","100","3","196","676","0","28.99","13.76"
"10","002","00","040","0002","0181","193","93","100","3","196","676","0","28.99","13.76"
"10","002","00","040","0003","0000","260","100","160","7","267","874","0","30.55","11.44"
"10","002","00","040","0003","0183","260","100","160","7","267","874","0","30.55","11.44"
"10","002","00","040","0004","0000","86","37","49","0","86","345","0","24.93","10.72"
"10","002","00","040","0004","0184","86","37","49","0","86","345","0","24.93","10.72"
"10","002","00","040","0005","0000","348","154","194","14","362","1352","0","26.78","11.39"
"10","002","00","040","0005","0185","172","69","103","6","178","624","0","28.53","11.06"
"10","002","00","040","0005","0186","176","85","91","8","184","728","0","25.27","11.68"
"10","002","00","040","0006","0000","242","117","125","1","243","862","0","28.19","13.57"
"10","002","00","040","0006","0187","242","117","125","1","243","862","0","28.19","13.57"
"10","002","00","040","0007","0000","215","90","125","2","217","678","0","32.01","13.27"
"10","002","00","040","0007","0188","215","90","125","2","217","678","0","32.01","13.27"
"10","002","00","040","0008","0000","568","309","259","5","573","1576","0","36.36","19.61"
"10","002","00","040","0008","0189","301","152","149","3","304","853","0","35.64","17.82"
"10","002","00","040","0008","0190","267","157","110","2","269","723","0","37.21","21.72"
"10","002","00","040","0009","0000","475","220","255","7","482","1356","0","35.55","16.22"
"10","002","00","040","0009","0191","252","116","136","3","255","791","0","32.24","14.66"
"10","002","00","040","0009","0192","223","104","119","4","227","565","0","40.18","18.41"
"10","002","00","040","0010","0000","303","158","145","4","307","710","0","43.24","22.25"
"10","002","00","040","0010","0193","303","158","145","4","307","710","0","43.24","22.25"
"10","002","00","040","0011","0000","200","124","76","0","200","488","0","40.98","25.41"
"10","002","00","040","0011","0194","200","124","76","0","200","488","0","40.98","25.41"
"10","002","00","040","0012","0000","195","95","100","0","195","533","0","36.59","17.82"
"10","002","00","040","0012","0195","195","95","100","0","195","533","0","36.59","17.82"
"10","002","00","040","0013","0000","265","141","124","2","267","645","0","41.40","21.86"
"10","002","00","040","0013","0196","265","141","124","2","267","645","0","41.40","21.86"
"10","002","00","040","0014","0000","571","257","314","11","582","2076","0","28.03","12.38"
"10","002","00","040","0014","0197","287","100","187","3","290","1050","0","27.62","9.52"
"10","002","00","040","0014","0198","284","157","127","8","292","1026","0","28.46","15.30"
"10","002","00","040","0015","0000","702","338","364","6","708","2044","0","34.64","16.54"
"10","002","00","040","0015","0199","297","137","160","1","298","863","0","34.53","15.87"
"10","002","00","040","0015","0200","405","201","204","5","410","1181","0","34.72","17.02"
"10","002","00","040","0016","0000","716","350","366","10","726","2076","0","34.97","16.86"
"10","002","00","040","0016","0201","274","139","135","8","282","901","0","31.30","15.43"
"10","002","00","040","0016","0202","442","211","231","2","444","1175","0","37.79","17.96"
"10","002","00","040","0017","0000","292","131","161","7","299","931","0","32.12","14.07"
"10","002","00","040","0017","0203","292","131","161","7","299","931","0","32.12","14.07"
"10","002","00","040","0018","0000","591","295","296","7","598","1711","0","34.95","17.24"
"10","002","00","040","0018","0204","365","203","162","6","371","1025","0","36.20","19.80"
"10","002","00","040","0018","0205","226","92","134","1","227","686","0","33.09","13.41"
"10","002","00","040","0019","0000","225","110","115","2","227","692","0","32.80","15.90"
"10","002","00","040","0019","0206","225","110","115","2","227","692","0","32.80","15.90"
"10","002","00","040","0020","0000","488","233","255","5","493","1301","0","37.89","17.91"
"10","002","00","040","0020","0207","202","85","117","2","204","569","0","35.85","14.94"
"10","002","00","040","0020","0208","286","148","138","3","289","732","0","39.48","20.22"
"10","002","00","040","0021","0000","308","124","184","3","311","909","0","34.21","13.64"
"10","002","00","040","0021","0209","308","124","184","3","311","909","0","34.21","13.64"
"10","002","00","040","0022","0000","311","138","173","2","313","1008","0","31.05","13.69"
"10","002","00","040","0022","0210","311","138","173","2","313","1008","0","31.05","13.69"
"10","002","00","040","0023","0000","339","149","190","7","346","1090","0","31.74","13.67"
"10","002","00","040","0023","0211","339","149","190","7","346","1090","0","31.74","13.67"
"10","002","00","040","0024","0000","227","104","123","3","230","705","0","32.62","14.75"
"10","002","00","040","0024","0182","227","104","123","3","230","705","0","32.62","14.75"
"10","002","00","050","0000","0000","11384","4653","6731","127","11511","30794","35091","37.38","15.11"
"10","002","00","050","0001","0000","528","216","312","5","533","1601","0","33.29","13.49"
"10","002","00","050","0001","0212","368","145","223","4","372","1093","0","34.03","13.27"
"10","002","00","050","0001","0213","160","71","89","1","161","508","0","31.69","13.98"
"10","002","00","050","0002","0000","705","315","390","8","713","1954","0","36.49","16.12"
"10","002","00","050","0002","0214","331","140","191","2","333","987","0","33.74","14.18"
"10","002","00","050","0002","0215","374","175","199","6","380","967","0","39.30","18.10"
"10","002","00","050","0003","0000","1494","803","691","13","1507","3987","0","37.80","20.14"
"10","002","00","050","0003","0216","339","181","158","1","340","956","0","35.56","18.93"
"10","002","00","050","0003","0217","353","206","147","1","354","955","0","37.07","21.57"
"10","002","00","050","0003","0218","400","207","193","6","406","970","0","41.86","21.34"
"10","002","00","050","0003","0219","402","209","193","5","407","1106","0","36.80","18.90"
"10","002","00","050","0004","0000","922","457","465","12","934","2517","0","37.11","18.16"
"10","002","00","050","0004","0220","281","156","125","5","286","815","0","35.09","19.14"
"10","002","00","050","0004","0221","342","159","183","2","344","870","0","39.54","18.28"
"10","002","00","050","0004","0222","299","142","157","5","304","832","0","36.54","17.07"
"10","002","00","050","0005","0000","228","95","133","4","232","620","0","37.42","15.32"
"10","002","00","050","0005","0223","228","95","133","4","232","620","0","37.42","15.32"
"10","002","00","050","0006","0000","573","273","300","9","582","1372","0","42.42","19.90"
"10","002","00","050","0006","0224","259","129","130","4","263","576","0","45.66","22.40"
"10","002","00","050","0006","0225","314","144","170","5","319","796","0","40.08","18.09"
"10","002","00","050","0007","0000","446","159","287","2","448","1198","0","37.40","13.27"
"10","002","00","050","0007","0226","446","159","287","2","448","1198","0","37.40","13.27"
"10","002","00","050","0008","0000","521","159","362","9","530","1460","0","36.30","10.89"
"10","002","00","050","0008","0227","329","109","220","6","335","875","0","38.29","12.46"
"10","002","00","050","0008","0228","192","50","142","3","195","585","0","33.33","8.55"
"10","002","00","050","0009","0000","829","273","556","8","837","2114","0","39.59","12.91"
"10","002","00","050","0009","0229","349","118","231","4","353","920","0","38.37","12.83"
"10","002","00","050","0009","0230","480","155","325","4","484","1194","0","40.54","12.98"
"10","002","00","050","0010","0000","841","323","518","13","854","2406","0","35.49","13.42"
"10","002","00","050","0010","0231","298","113","185","4","302","844","0","35.78","13.39"
"10","002","00","050","0010","0232","229","92","137","4","233","643","0","36.24","14.31"
"10","002","00","050","0010","0233","314","118","196","5","319","919","0","34.71","12.84"
"10","002","00","050","0011","0000","343","117","226","3","346","1132","0","30.57","10.34"
"10","002","00","050","0011","0234","343","117","226","3","346","1132","0","30.57","10.34"
"10","002","00","050","0012","0000","293","119","174","4","297","830","0","35.78","14.34"
"10","002","00","050","0012","0235","293","119","174","4","297","830","0","35.78","14.34"
"10","002","00","050","0013","0000","423","165","258","3","426","1059","0","40.23","15.58"
"10","002","00","050","0013","0236","423","165","258","3","426","1059","0","40.23","15.58"
"10","002","00","050","0014","0000","476","173","303","7","483","1359","0","35.54","12.73"
"10","002","00","050","0014","0237","476","173","303","7","483","1359","0","35.54","12.73"
"10","002","00","050","0015","0000","1034","390","644","8","1042","2526","0","41.25","15.44"
"10","002","00","050","0015","0238","359","158","201","4","363","898","0","40.42","17.59"
"10","002","00","050","0015","0239","336","121","215","1","337","820","0","41.10","14.76"
"10","002","00","050","0015","0240","339","111","228","3","342","808","0","42.33","13.74"
"10","002","00","050","0016","0000","1223","428","795","13","1236","3316","0","37.27","12.91"
"10","002","00","050","0016","0241","437","162","275","4","441","1073","0","41.10","15.10"
"10","002","00","050","0016","0242","458","156","302","5","463","1215","0","38.11","12.84"
"10","002","00","050","0016","0243","328","110","218","4","332","1028","0","32.30","10.70"
"10","002","00","050","0017","0000","327","141","186","3","330","921","0","35.83","15.31"
"10","002","00","050","0017","0244","327","141","186","3","330","921","0","35.83","15.31"
"10","002","00","050","0018","0000","178","47","131","3","181","422","0","42.89","11.14"
"10","002","00","050","0018","0245","178","47","131","3","181","422","0","42.89","11.14"
"10","002","00","060","0000","0000","7794","2954","4840","89","7883","21700","24419","36.33","13.61"
"10","002","00","060","0001","0000","977","394","583","9","986","2606","0","37.84","15.12"
"10","002","00","060","0001","0246","361","147","214","2","363","899","0","40.38","16.35"
"10","002","00","060","0001","0247","287","109","178","5","292","778","0","37.53","14.01"
"10","002","00","060","0001","0248","329","138","191","2","331","929","0","35.63","14.85"
"10","002","00","060","0002","0000","692","299","393","5","697","1928","0","36.15","15.51"
"10","002","00","060","0002","0250","303","136","167","2","305","925","0","32.97","14.70"
"10","002","00","060","0002","0251","389","163","226","3","392","1003","0","39.08","16.25"
"10","002","00","060","0003","0000","367","138","229","4","371","931","0","39.85","14.82"
"10","002","00","060","0003","0252","367","138","229","4","371","931","0","39.85","14.82"
"10","002","00","060","0004","0000","281","86","195","2","283","979","0","28.91","8.78"
"10","002","00","060","0004","0253","281","86","195","2","283","979","0","28.91","8.78"
"10","002","00","060","0005","0000","518","161","357","7","525","1599","0","32.83","10.07"
"10","002","00","060","0005","0254","269","75","194","4","273","805","0","33.91","9.32"
"10","002","00","060","0005","0255","249","86","163","3","252","794","0","31.74","10.83"
"10","002","00","060","0006","0000","481","170","311","9","490","1492","0","32.84","11.39"
"10","002","00","060","0006","0256","266","86","180","8","274","785","0","34.90","10.96"
"10","002","00","060","0006","0257","215","84","131","1","216","707","0","30.55","11.88"
"10","002","00","060","0007","0000","302","92","210","5","307","792","0","38.76","11.62"
"10","002","00","060","0007","0258","302","92","210","5","307","792","0","38.76","11.62"
"10","002","00","060","0008","0000","877","318","559","9","886","2369","0","37.40","13.42"
"10","002","00","060","0008","0259","306","120","186","6","312","889","0","35.10","13.50"
"10","002","00","060","0008","0260","292","100","192","0","292","729","0","40.05","13.72"
"10","002","00","060","0008","0261","279","98","181","3","282","751","0","37.55","13.05"
"10","002","00","060","0009","0000","591","229","362","4","595","1580","0","37.66","14.49"
"10","002","00","060","0009","0262","247","101","146","2","249","661","0","37.67","15.28"
"10","002","00","060","0009","0263","344","128","216","2","346","919","0","37.65","13.93"
"10","002","00","060","0010","0000","501","180","321","5","506","1240","0","40.81","14.52"
"10","002","00","060","0010","0264","501","180","321","5","506","1240","0","40.81","14.52"
"10","002","00","060","0011","0000","851","342","509","9","860","2246","0","38.29","15.23"
"10","002","00","060","0011","0265","389","162","227","3","392","1103","0","35.54","14.69"
"10","002","00","060","0011","0266","462","180","282","6","468","1143","0","40.94","15.75"
"10","002","00","060","0012","0000","379","136","243","9","388","1058","0","36.67","12.85"
"10","002","00","060","0012","0267","379","136","243","9","388","1058","0","36.67","12.85"
"10","002","00","060","0013","0000","558","250","308","9","567","1756","0","32.29","14.24"
"10","002","00","060","0013","0268","272","158","114","4","276","945","0","29.21","16.72"
"10","002","00","060","0013","0269","286","92","194","5","291","811","0","35.88","11.34"
"10","002","00","060","0014","0000","419","159","260","3","422","1124","0","37.54","14.15"
"10","002","00","060","0014","0249","419","159","260","3","422","1124","0","37.54","14.15"
"10","002","00","070","0000","0000","10317","4015","6302","139","10456","28401","32189","36.82","14.14"
"10","002","00","070","0001","0000","2133","961","1172","31","2164","5810","0","37.25","16.54"
"10","002","00","070","0001","0270","576","276","300","13","589","1443","0","40.82","19.13"
"10","002","00","070","0001","0271","302","132","170","3","305","889","0","34.31","14.85"
"10","002","00","070","0001","0272","465","183","282","6","471","1254","0","37.56","14.59"
"10","002","00","070","0001","0273","383","175","208","7","390","1161","0","33.59","15.07"
"10","002","00","070","0001","0274","407","195","212","2","409","1063","0","38.48","18.34"
"10","002","00","070","0002","0000","753","314","439","13","766","2164","0","35.40","14.51"
"10","002","00","070","0002","0275","363","137","226","6","369","1017","0","36.28","13.47"
"10","002","00","070","0002","0276","390","177","213","7","397","1147","0","34.61","15.43"
"10","002","00","070","0003","0000","671","237","434","8","679","1676","0","40.51","14.14"
"10","002","00","070","0003","0277","342","118","224","4","346","904","0","38.27","13.05"
"10","002","00","070","0003","0278","329","119","210","4","333","772","0","43.13","15.41"
"10","002","00","070","0004","0000","556","253","303","2","558","1505","0","37.08","16.81"
"10","002","00","070","0004","0279","273","127","146","1","274","751","0","36.48","16.91"
"10","002","00","070","0004","0280","283","126","157","1","284","754","0","37.67","16.71"
"10","002","00","070","0005","0000","772","313","459","6","778","1941","0","40.08","16.13"
"10","002","00","070","0005","0281","409","167","242","3","412","1032","0","39.92","16.18"
"10","002","00","070","0005","0282","363","146","217","3","366","909","0","40.26","16.06"
"10","002","00","070","0006","0000","442","144","298","5","447","1249","0","35.79","11.53"
"10","002","00","070","0006","0283","442","144","298","5","447","1249","0","35.79","11.53"
"10","002","00","070","0007","0000","450","202","248","11","461","1436","0","32.10","14.07"
"10","002","00","070","0007","0284","196","88","108","5","201","564","0","35.64","15.60"
"10","002","00","070","0007","0285","254","114","140","6","260","872","0","29.82","13.07"
"10","002","00","070","0008","0000","226","75","151","4","230","608","0","37.83","12.34"
"10","002","00","070","0008","0286","151","46","105","3","154","383","0","40.21","12.01"
"10","002","00","070","0008","0287","75","29","46","1","76","225","0","33.78","12.89"
"10","002","00","070","0009","0000","656","242","414","5","661","1818","0","36.36","13.31"
"10","002","00","070","0009","0288","284","113","171","1","285","921","0","30.94","12.27"
"10","002","00","070","0009","0289","372","129","243","4","376","897","0","41.92","14.38"
"10","002","00","070","0010","0000","471","198","273","7","478","1340","0","35.67","14.78"
"10","002","00","070","0010","0290","228","88","140","5","233","613","0","38.01","14.36"
"10","002","00","070","0010","0291","243","110","133","2","245","727","0","33.70","15.13"
"10","002","00","070","0011","0000","870","254","616","5","875","2277","0","38.43","11.16"
"10","002","00","070","0011","0292","286","79","207","2","288","782","0","36.83","10.10"
"10","002","00","070","0011","0293","365","106","259","2","367","923","0","39.76","11.48"
"10","002","00","070","0011","0294","219","69","150","1","220","572","0","38.46","12.06"
"10","002","00","070","0012","0000","885","310","575","13","898","2403","0","37.37","12.90"
"10","002","00","070","0012","0295","339","119","220","5","344","881","0","39.05","13.51"
"10","002","00","070","0012","0296","280","90","190","2","282","734","0","38.42","12.26"
"10","002","00","070","0012","0297","266","101","165","6","272","788","0","34.52","12.82"
"10","002","00","070","0013","0000","304","121","183","5","309","888","0","34.80","13.63"
"10","002","00","070","0013","0298","304","121","183","5","309","888","0","34.80","13.63"
"10","002","00","070","0014","0000","340","117","223","5","345","926","0","37.26","12.63"
"10","002","00","070","0014","0299","340","117","223","5","345","926","0","37.26","12.63"
"10","002","00","070","0015","0000","349","132","217","5","354","997","0","35.51","13.24"
"10","002","00","070","0015","0300","349","132","217","5","354","997","0","35.51","13.24"
"10","002","00","070","0016","0000","439","142","297","14","453","1363","0","33.24","10.42"
"10","002","00","070","0016","0301","210","66","144","7","217","662","0","32.78","9.97"
"10","002","00","070","0016","0302","229","76","153","7","236","701","0","33.67","10.84"
"10","002","00","080","0000","0000","17818","6362","11456","193","18011","45636","52999","39.47","13.94"
"10","002","00","080","0001","0000","469","128","341","4","473","1262","0","37.48","10.14"
"10","002","00","080","0001","0329","469","128","341","4","473","1262","0","37.48","10.14"
"10","002","00","080","0002","0000","695","227","468","10","705","1625","0","43.38","13.97"
"10","002","00","080","0002","0303","355","112","243","3","358","824","0","43.45","13.59"
"10","002","00","080","0002","0304","340","115","225","7","347","801","0","43.32","14.36"
"10","002","00","080","0003","0000","453","177","276","5","458","1136","0","40.32","15.58"
"10","002","00","080","0003","0305","453","177","276","5","458","1136","0","40.32","15.58"
"10","002","00","080","0004","0000","321","114","207","1","322","894","0","36.02","12.75"
"10","002","00","080","0004","0306","321","114","207","1","322","894","0","36.02","12.75"
"10","002","00","080","0005","0000","345","90","255","10","355","867","0","40.95","10.38"
"10","002","00","080","0005","0307","345","90","255","10","355","867","0","40.95","10.38"
"10","002","00","080","0006","0000","543","189","354","7","550","1409","0","39.03","13.41"
"10","002","00","080","0006","0308","543","189","354","7","550","1409","0","39.03","13.41"
"10","002","00","080","0007","0000","1093","398","695","12","1105","2951","0","37.44","13.49"
"10","002","00","080","0007","0309","404","126","278","4","408","953","0","42.81","13.22"
"10","002","00","080","0007","0310","327","121","206","6","333","1060","0","31.42","11.42"
"10","002","00","080","0007","0311","362","151","211","2","364","938","0","38.81","16.10"
"10","002","00","080","0008","0000","1172","435","737","11","1183","2943","0","40.20","14.78"
"10","002","00","080","0008","0312","362","121","241","4","366","963","0","38.01","12.56"
"10","002","00","080","0008","0313","411","150","261","4","415","1073","0","38.68","13.98"
"10","002","00","080","0008","0314","399","164","235","3","402","907","0","44.32","18.08"
"10","002","00","080","0009","0000","314","122","192","6","320","673","0","47.55","18.13"
"10","002","00","080","0009","0316","314","122","192","6","320","673","0","47.55","18.13"
"10","002","00","080","0010","0000","281","70","211","3","284","709","0","40.06","9.87"
"10","002","00","080","0010","0315","281","70","211","3","284","709","0","40.06","9.87"
"10","002","00","080","0011","0000","649","221","428","6","655","1498","0","43.72","14.75"
"10","002","00","080","0011","0317","649","221","428","6","655","1498","0","43.72","14.75"
"10","002","00","080","0012","0000","358","125","233","3","361","870","0","41.49","14.37"
"10","002","00","080","0012","0318","358","125","233","3","361","870","0","41.49","14.37"
"10","002","00","080","0013","0000","545","163","382","5","550","1512","0","36.38","10.78"
"10","002","00","080","0013","0319","274","80","194","3","277","732","0","37.84","10.93"
"10","002","00","080","0013","0320","271","83","188","2","273","780","0","35.00","10.64"
"10","002","00","080","0014","0000","207","59","148","1","208","474","0","43.88","12.45"
"10","002","00","080","0014","0321","207","59","148","1","208","474","0","43.88","12.45"
"10","002","00","080","0015","0000","1831","649","1182","19","1850","4962","0","37.28","13.08"
"10","002","00","080","0015","0322","471","155","316","4","475","1222","0","38.87","12.68"
"10","002","00","080","0015","0323","474","160","314","4","478","1246","0","38.36","12.84"
"10","002","00","080","0015","0324","482","172","310","9","491","1342","0","36.59","12.82"
"10","002","00","080","0015","0325","404","162","242","2","406","1152","0","35.24","14.06"
"10","002","00","080","0016","0000","1196","421","775","9","1205","3096","0","38.92","13.60"
"10","002","00","080","0016","0326","500","184","316","5","505","1283","0","39.36","14.34"
"10","002","00","080","0016","0327","364","122","242","1","365","928","0","39.33","13.15"
"10","002","00","080","0016","0328","332","115","217","3","335","885","0","37.85","12.99"
"10","002","00","080","0017","0000","1897","714","1183","26","1923","4619","0","41.63","15.46"
"10","002","00","080","0017","0330","596","223","373","7","603","1488","0","40.52","14.99"
"10","002","00","080","0017","0331","394","157","237","7","401","900","0","44.56","17.44"
"10","002","00","080","0017","0332","476","186","290","6","482","1095","0","44.02","16.99"
"10","002","00","080","0017","0333","431","148","283","6","437","1136","0","38.47","13.03"
"10","002","00","080","0018","0000","1522","612","910","15","1537","3769","0","40.78","16.24"
"10","002","00","080","0018","0334","537","241","296","4","541","1315","0","41.14","18.33"
"10","002","00","080","0018","0335","522","201","321","6","528","1252","0","42.17","16.05"
"10","002","00","080","0018","0336","463","170","293","5","468","1202","0","38.94","14.14"
"10","002","00","080","0019","0000","880","271","609","14","894","2557","0","34.96","10.60"
"10","002","00","080","0019","0337","446","149","297","4","450","1296","0","34.72","11.50"
"10","002","00","080","0019","0338","434","122","312","10","444","1261","0","35.21","9.67"
"10","002","00","080","0020","0000","369","165","204","2","371","1080","0","34.35","15.28"
"10","002","00","080","0020","0339","369","165","204","2","371","1080","0","34.35","15.28"
"10","002","00","080","0021","0000","925","338","587","12","937","2509","0","37.35","13.47"
"10","002","00","080","0021","0340","512","165","347","6","518","1263","0","41.01","13.06"
"10","002","00","080","0021","0341","413","173","240","6","419","1246","0","33.63","13.88"
"10","002","00","080","0022","0000","693","286","407","5","698","1680","0","41.55","17.02"
"10","002","00","080","0022","0342","418","165","253","4","422","982","0","42.97","16.80"
"10","002","00","080","0022","0343","275","121","154","1","276","698","0","39.54","17.34"
"10","002","00","080","0023","0000","751","287","464","3","754","1761","0","42.82","16.30"
"10","002","00","080","0023","0344","390","139","251","3","393","887","0","44.31","15.67"
"10","002","00","080","0023","0345","361","148","213","0","361","874","0","41.30","16.93"
"10","002","00","080","0024","0000","309","101","208","4","313","780","0","40.13","12.95"
"10","002","00","080","0024","0346","309","101","208","4","313","780","0","40.13","12.95"
"10","002","00","090","0000","0000","13682","5045","8637","136","13818","35466","40343","38.96","14.22"
"10","002","00","090","0001","0000","803","253","550","7","810","2052","0","39.47","12.33"
"10","002","00","090","0001","0347","415","144","271","2","417","1094","0","38.12","13.16"
"10","002","00","090","0001","0348","388","109","279","5","393","958","0","41.02","11.38"
"10","002","00","090","0002","0000","784","343","441","11","795","1872","0","42.47","18.32"
"10","002","00","090","0002","0349","375","179","196","5","380","917","0","41.44","19.52"
"10","002","00","090","0002","0350","409","164","245","6","415","955","0","43.46","17.17"
"10","002","00","090","0003","0000","1083","407","676","18","1101","2629","0","41.88","15.48"
"10","002","00","090","0003","0351","317","123","194","3","320","786","0","40.71","15.65"
"10","002","00","090","0003","0352","343","138","205","7","350","851","0","41.13","16.22"
"10","002","00","090","0003","0353","423","146","277","8","431","992","0","43.45","14.72"
"10","002","00","090","0004","0000","662","267","395","4","666","1563","0","42.61","17.08"
"10","002","00","090","0004","0354","343","149","194","1","344","771","0","44.62","19.33"
"10","002","00","090","0004","0355","319","118","201","3","322","792","0","40.66","14.90"
"10","002","00","090","0005","0000","500","179","321","4","504","1350","0","37.33","13.26"
"10","002","00","090","0005","0356","500","179","321","4","504","1350","0","37.33","13.26"
"10","002","00","090","0006","0000","1112","458","654","8","1120","2551","0","43.90","17.95"
"10","002","00","090","0006","0357","249","107","142","1","250","592","0","42.23","18.07"
"10","002","00","090","0006","0358","429","178","251","6","435","938","0","46.38","18.98"
"10","002","00","090","0006","0359","434","173","261","1","435","1021","0","42.61","16.94"
"10","002","00","090","0007","0000","738","275","463","8","746","1777","0","41.98","15.48"
"10","002","00","090","0007","0360","390","152","238","6","396","943","0","41.99","16.12"
"10","002","00","090","0007","0361","348","123","225","2","350","834","0","41.97","14.75"
"10","002","00","090","0008","0000","1349","550","799","11","1360","3725","0","36.51","14.77"
"10","002","00","090","0008","0362","325","125","200","3","328","951","0","34.49","13.14"
"10","002","00","090","0008","0363","376","162","214","4","380","948","0","40.08","17.09"
"10","002","00","090","0008","0364","313","139","174","1","314","941","0","33.37","14.77"
"10","002","00","090","0008","0365","335","124","211","3","338","885","0","38.19","14.01"
"10","002","00","090","0009","0000","1439","586","853","9","1448","3727","0","38.85","15.72"
"10","002","00","090","0009","0369","370","155","215","1","371","924","0","40.15","16.77"
"10","002","00","090","0009","0370","345","158","187","3","348","943","0","36.90","16.76"
"10","002","00","090","0009","0371","415","161","254","2","417","1038","0","40.17","15.51"
"10","002","00","090","0009","0372","309","112","197","3","312","822","0","37.96","13.63"
"10","002","00","090","0010","0000","1207","433","774","17","1224","3260","0","37.55","13.28"
"10","002","00","090","0010","0366","444","159","285","7","451","1124","0","40.12","14.15"
"10","002","00","090","0010","0367","331","125","206","3","334","912","0","36.62","13.71"
"10","002","00","090","0010","0368","432","149","283","7","439","1224","0","35.87","12.17"
"10","002","00","090","0011","0000","638","194","444","5","643","1654","0","38.88","11.73"
"10","002","00","090","0011","0373","340","82","258","3","343","912","0","37.61","8.99"
"10","002","00","090","0011","0374","298","112","186","2","300","742","0","40.43","15.09"
"10","002","00","090","0012","0000","550","188","362","7","557","1417","0","39.31","13.27"
"10","002","00","090","0012","0375","245","104","141","2","247","625","0","39.52","16.64"
"10","002","00","090","0012","0376","305","84","221","5","310","792","0","39.14","10.61"
"10","002","00","090","0013","0000","672","222","450","11","683","1951","0","35.01","11.38"
"10","002","00","090","0013","0377","329","102","227","5","334","912","0","36.62","11.18"
"10","002","00","090","0013","0378","343","120","223","6","349","1039","0","33.59","11.55"
"10","002","00","090","0014","0000","1146","353","793","9","1155","3177","0","36.36","11.11"
"10","002","00","090","0014","0379","332","107","225","5","337","1003","0","33.60","10.67"
"10","002","00","090","0014","0380","480","144","336","2","482","1257","0","38.35","11.46"
"10","002","00","090","0014","0381","334","102","232","2","336","917","0","36.64","11.12"
"10","002","00","090","0015","0000","999","337","662","7","1006","2761","0","36.44","12.21"
"10","002","00","090","0015","0382","294","79","215","3","297","852","0","34.86","9.27"
"10","002","00","090","0015","0383","435","153","282","4","439","1221","0","35.95","12.53"
"10","002","00","090","0015","0384","270","105","165","0","270","688","0","39.24","15.26"
"10","002","00","100","0000","0000","7136","2657","4479","79","7215","19047","21219","37.88","13.95"
"10","002","00","100","0001","0000","82","36","46","1","83","207","0","40.10","17.39"
"10","002","00","100","0001","0385","82","36","46","1","83","207","0","40.10","17.39"
"10","002","00","100","0002","0000","146","59","87","4","150","498","0","30.12","11.85"
"10","002","00","100","0002","0386","146","59","87","4","150","498","0","30.12","11.85"
"10","002","00","100","0003","0000","235","85","150","4","239","712","0","33.57","11.94"
"10","002","00","100","0003","0387","235","85","150","4","239","712","0","33.57","11.94"
"10","002","00","100","0004","0000","244","78","166","4","248","553","0","44.85","14.10"
"10","002","00","100","0004","0391","244","78","166","4","248","553","0","44.85","14.10"
"10","002","00","100","0005","0000","157","74","83","2","159","448","0","35.49","16.52"
"10","002","00","100","0005","0392","157","74","83","2","159","448","0","35.49","16.52"
"10","002","00","100","0006","0000","406","185","221","2","408","1133","0","36.01","16.33"
"10","002","00","100","0006","0393","406","185","221","2","408","1133","0","36.01","16.33"
"10","002","00","100","0007","0000","427","180","247","7","434","1145","0","37.90","15.72"
"10","002","00","100","0007","0394","427","180","247","7","434","1145","0","37.90","15.72"
"10","002","00","100","0008","0000","307","137","170","3","310","870","0","35.63","15.75"
"10","002","00","100","0008","0395","307","137","170","3","310","870","0","35.63","15.75"
"10","002","00","100","0009","0000","395","140","255","2","397","1358","0","29.23","10.31"
"10","002","00","100","0009","0396","395","140","255","2","397","1358","0","29.23","10.31"
"10","002","00","100","0010","0000","1539","580","959","12","1551","4328","0","35.84","13.40"
"10","002","00","100","0010","0398","348","118","230","4","352","990","0","35.56","11.92"
"10","002","00","100","0010","0399","382","163","219","3","385","1075","0","35.81","15.16"
"10","002","00","100","0010","0400","419","148","271","0","419","1123","0","37.31","13.18"
"10","002","00","100","0010","0401","390","151","239","5","395","1140","0","34.65","13.25"
"10","002","00","100","0011","0000","332","108","224","5","337","890","0","37.87","12.13"
"10","002","00","100","0011","0397","332","108","224","5","337","890","0","37.87","12.13"
"10","002","00","100","0012","0000","236","79","157","5","241","586","0","41.13","13.48"
"10","002","00","100","0012","0388","236","79","157","5","241","586","0","41.13","13.48"
"10","002","00","100","0013","0000","188","83","105","4","192","525","0","36.57","15.81"
"10","002","00","100","0013","0389","188","83","105","4","192","525","0","36.57","15.81"
"10","002","00","100","0014","0000","282","107","175","3","285","731","0","38.99","14.64"
"10","002","00","100","0014","0390","282","107","175","3","285","731","0","38.99","14.64"
"10","002","00","100","0015","0000","520","168","352","5","525","1266","0","41.47","13.27"
"10","002","00","100","0015","0402","520","168","352","5","525","1266","0","41.47","13.27"
"10","002","00","100","0016","0000","289","118","171","1","290","758","0","38.26","15.57"
"10","002","00","100","0016","0403","289","118","171","1","290","758","0","38.26","15.57"
"10","002","00","100","0017","0000","746","243","503","8","754","1581","0","47.69","15.37"
"10","002","00","100","0017","0404","396","138","258","5","401","813","0","49.32","16.97"
"10","002","00","100","0017","0405","350","105","245","3","353","768","0","45.96","13.67"
"10","002","00","100","0018","0000","605","197","408","7","612","1458","0","41.98","13.51"
"10","002","00","100","0018","0406","265","79","186","6","271","668","0","40.57","11.83"
"10","002","00","100","0018","0407","340","118","222","1","341","790","0","43.16","14.94"
"10","002","00","110","0000","0000","1369","1112","257","18","1387","4915","6099","28.22","22.62"
"10","002","00","110","0001","0000","288","250","38","2","290","923","0","31.42","27.09"
"10","002","00","110","0001","0408","288","250","38","2","290","923","0","31.42","27.09"
"10","002","00","110","0002","0000","185","171","14","4","189","629","0","30.05","27.19"
"10","002","00","110","0002","0409","185","171","14","4","189","629","0","30.05","27.19"
"10","002","00","110","0003","0000","202","146","56","2","204","701","0","29.10","20.83"
"10","002","00","110","0003","0410","202","146","56","2","204","701","0","29.10","20.83"
"10","002","00","110","0004","0000","100","55","45","0","100","262","0","38.17","20.99"
"10","002","00","110","0004","0411","100","55","45","0","100","262","0","38.17","20.99"
"10","002","00","110","0005","0000","97","76","21","2","99","325","0","30.46","23.38"
"10","002","00","110","0005","0412","97","76","21","2","99","325","0","30.46","23.38"
"10","002","00","110","0006","0000","111","101","10","2","113","392","0","28.83","25.77"
"10","002","00","110","0006","0413","111","101","10","2","113","392","0","28.83","25.77"
"10","002","00","110","0007","0000","18","12","6","0","18","54","0","33.33","22.22"
"10","002","00","110","0007","0414","18","12","6","0","18","54","0","33.33","22.22"
"10","002","00","110","0008","0000","185","160","25","3","188","763","0","24.64","20.97"
"10","002","00","110","0008","0416","185","160","25","3","188","763","0","24.64","20.97"
"10","002","00","110","0009","0000","125","94","31","3","128","659","0","19.42","14.26"
"10","002","00","110","0009","0417","125","94","31","3","128","659","0","19.42","14.26"
"10","002","00","110","0010","0000","58","47","11","0","58","207","0","28.02","22.71"
"10","002","00","110","0010","0415","58","47","11","0","58","207","0","28.02","22.71"
"10","002","00","120","0000","0000","1261","1101","160","20","1281","4564","5956","28.07","24.12"
"10","002","00","120","0001","0000","301","262","39","4","305","1156","0","26.38","22.66"
"10","002","00","120","0001","0419","301","262","39","4","305","1156","0","26.38","22.66"
"10","002","00","120","0002","0000","234","205","29","5","239","955","0","25.03","21.47"
"10","002","00","120","0002","0420","234","205","29","5","239","955","0","25.03","21.47"
"10","002","00","120","0003","0000","152","134","18","1","153","435","0","35.17","30.80"
"10","002","00","120","0003","0418","152","134","18","1","153","435","0","35.17","30.80"
"10","002","00","120","0004","0000","86","80","6","2","88","406","0","21.67","19.70"
"10","002","00","120","0004","0421","86","80","6","2","88","406","0","21.67","19.70"
"10","002","00","120","0005","0000","131","106","25","2","133","430","0","30.93","24.65"
"10","002","00","120","0005","0422","131","106","25","2","133","430","0","30.93","24.65"
"10","002","00","120","0006","0000","127","106","21","0","127","475","0","26.74","22.32"
"10","002","00","120","0006","0423","127","106","21","0","127","475","0","26.74","22.32"
"10","002","00","120","0007","0000","230","208","22","6","236","707","0","33.38","29.42"
"10","002","00","120","0007","0424","230","208","22","6","236","707","0","33.38","29.42"
"10","015","00","000","0000","0000","97776","68395","29381","1288","99064","275091","322836","36.01","24.86"
"10","015","00","010","0000","0000","32686","22019","10667","302","32988","83830","101853","39.35","26.27"
"10","015","00","010","0001","0000","621","411","210","5","626","1592","0","39.32","25.82"
"10","015","00","010","0001","0022","367","243","124","2","369","821","0","44.95","29.60"
"10","015","00","010","0001","0023","254","168","86","3","257","771","0","33.33","21.79"
"10","015","00","010","0002","0000","831","562","269","8","839","1985","0","42.27","28.31"
"10","015","00","010","0002","0016","466","312","154","5","471","1114","0","42.28","28.01"
"10","015","00","010","0002","0017","365","250","115","3","368","871","0","42.25","28.70"
"10","015","00","010","0003","0000","169","105","64","0","169","422","0","40.05","24.88"
"10","015","00","010","0003","0027","169","105","64","0","169","422","0","40.05","24.88"
"10","015","00","010","0004","0000","273","170","103","2","275","664","0","41.42","25.60"
"10","015","00","010","0004","0033","273","170","103","2","275","664","0","41.42","25.60"
"10","015","00","010","0005","0000","205","121","84","1","206","558","0","36.92","21.68"
"10","015","00","010","0005","0035","205","121","84","1","206","558","0","36.92","21.68"
"10","015","00","010","0006","0000","1091","699","392","13","1104","2927","0","37.72","23.88"
"10","015","00","010","0006","0037","364","246","118","7","371","901","0","41.18","27.30"
"10","015","00","010","0006","0038","332","210","122","4","336","1036","0","32.43","20.27"
"10","015","00","010","0006","0039","395","243","152","2","397","990","0","40.10","24.55"
"10","015","00","010","0007","0000","576","341","235","7","583","1769","0","32.96","19.28"
"10","015","00","010","0007","0059","256","150","106","2","258","947","0","27.24","15.84"
"10","015","00","010","0007","0060","320","191","129","5","325","822","0","39.54","23.24"
"10","015","00","010","0008","0000","1251","833","418","10","1261","3186","0","39.58","26.15"
"10","015","00","010","0008","0056","418","277","141","3","421","985","0","42.74","28.12"
"10","015","00","010","0008","0057","436","309","127","4","440","1125","0","39.11","27.47"
"10","015","00","010","0008","0058","397","247","150","3","400","1076","0","37.17","22.96"
"10","015","00","010","0009","0000","655","444","211","4","659","1486","0","44.35","29.88"
"10","015","00","010","0009","0001","327","236","91","2","329","736","0","44.70","32.07"
"10","015","00","010","0009","0002","328","208","120","2","330","750","0","44.00","27.73"
"10","015","00","010","0010","0000","804","669","135","15","819","2020","0","40.54","33.12"
"10","015","00","010","0010","0006","163","134","29","1","164","473","0","34.67","28.33"
"10","015","00","010","0010","0007","347","271","76","10","357","842","0","42.40","32.19"
"10","015","00","010","0010","0008","294","264","30","4","298","705","0","42.27","37.45"
"10","015","00","010","0012","0000","197","131","66","1","198","464","0","42.67","28.23"
"10","015","00","010","0012","0034","197","131","66","1","198","464","0","42.67","28.23"
"10","015","00","010","0013","0000","227","130","97","1","228","492","0","46.34","26.42"
"10","015","00","010","0013","0032","227","130","97","1","228","492","0","46.34","26.42"
"10","015","00","010","0014","0000","1332","877","455","11","1343","3477","0","38.63","25.22"
"10","015","00","010","0014","0042","396","260","136","4","400","983","0","40.69","26.45"
"10","015","00","010","0014","0043","332","222","110","3","335","903","0","37.10","24.58"
"10","015","00","010","0014","0044","325","211","114","3","328","796","0","41.21","26.51"
"10","015","00","010","0014","0045","279","184","95","1","280","795","0","35.22","23.14"
"10","015","00","010","0015","0000","304","183","121","1","305","821","0","37.15","22.29"
"10","015","00","010","0015","0061","304","183","121","1","305","821","0","37.15","22.29"
"10","015","00","010","0016","0000","1955","1311","644","22","1977","4822","0","41.00","27.19"
"10","015","00","010","0016","0078","371","245","126","10","381","924","0","41.23","26.52"
"10","015","00","010","0016","0079","356","241","115","1","357","960","0","37.19","25.10"
"10","015","00","010","0016","0080","423","292","131","2","425","958","0","44.36","30.48"
"10","015","00","010","0016","0081","362","231","131","6","368","924","0","39.83","25.00"
"10","015","00","010","0016","0082","443","302","141","3","446","1056","0","42.23","28.60"
"10","015","00","010","0017","0000","1535","1091","444","13","1548","3629","0","42.66","30.06"
"10","015","00","010","0017","0018","391","290","101","2","393","908","0","43.28","31.94"
"10","015","00","010","0017","0019","405","297","108","2","407","906","0","44.92","32.78"
"10","015","00","010","0017","0020","353","231","122","5","358","887","0","40.36","26.04"
"10","015","00","010","0017","0021","386","273","113","4","390","928","0","42.03","29.42"
"10","015","00","010","0018","0000","1251","908","343","18","1269","3092","0","41.04","29.37"
"10","015","00","010","0018","0003","415","306","109","7","422","996","0","42.37","30.72"
"10","015","00","010","0018","0004","395","298","97","3","398","987","0","40.32","30.19"
"10","015","00","010","0018","0005","441","304","137","8","449","1109","0","40.49","27.41"
"10","015","00","010","0019","0000","424","244","180","6","430","1077","0","39.93","22.66"
"10","015","00","010","0019","0028","424","244","180","6","430","1077","0","39.93","22.66"
"10","015","00","010","0020","0000","216","114","102","0","216","537","0","40.22","21.23"
"10","015","00","010","0020","0030","216","114","102","0","216","537","0","40.22","21.23"
"10","015","00","010","0021","0000","718","467","251","5","723","1821","0","39.70","25.65"
"10","015","00","010","0021","0040","337","224","113","2","339","853","0","39.74","26.26"
"10","015","00","010","0021","0041","381","243","138","3","384","968","0","39.67","25.10"
"10","015","00","010","0022","0000","465","322","143","6","471","1214","0","38.80","26.52"
"10","015","00","010","0022","0063","465","322","143","6","471","1214","0","38.80","26.52"
"10","015","00","010","0023","0000","1022","647","375","5","1027","2759","0","37.22","23.45"
"10","015","00","010","0023","0069","288","178","110","1","289","782","0","36.96","22.76"
"10","015","00","010","0023","0070","382","240","142","3","385","977","0","39.41","24.56"
"10","015","00","010","0023","0071","352","229","123","1","353","1000","0","35.30","22.90"
"10","015","00","010","0024","0000","640","419","221","6","646","1757","0","36.77","23.85"
"10","015","00","010","0024","0076","294","192","102","2","296","766","0","38.64","25.07"
"10","015","00","010","0024","0077","346","227","119","4","350","991","0","35.32","22.91"
"10","015","00","010","0025","0000","377","262","115","6","383","932","0","41.09","28.11"
"10","015","00","010","0025","0009","377","262","115","6","383","932","0","41.09","28.11"
"10","015","00","010","0026","0000","239","164","75","1","240","616","0","38.96","26.62"
"10","015","00","010","0026","0024","239","164","75","1","240","616","0","38.96","26.62"
"10","015","00","010","0027","0000","209","153","56","0","209","549","0","38.07","27.87"
"10","015","00","010","0027","0026","209","153","56","0","209","549","0","38.07","27.87"
"10","015","00","010","0028","0000","333","200","133","2","335","763","0","43.91","26.21"
"10","015","00","010","0028","0031","333","200","133","2","335","763","0","43.91","26.21"
"10","015","00","010","0029","0000","1045","651","394","10","1055","2643","0","39.92","24.63"
"10","015","00","010","0029","0053","347","208","139","4","351","828","0","42.39","25.12"
"10","015","00","010","0029","0054","365","223","142","5","370","874","0","42.33","25.51"
"10","015","00","010","0029","0055","333","220","113","1","334","941","0","35.49","23.38"
"10","015","00","010","0030","0000","198","136","62","2","200","496","0","40.32","27.42"
"10","015","00","010","0030","0062","198","136","62","2","200","496","0","40.32","27.42"
"10","015","00","010","0031","0000","776","501","275","11","787","1849","0","42.56","27.10"
"10","015","00","010","0031","0067","378","262","116","7","385","942","0","40.87","27.81"
"10","015","00","010","0031","0068","398","239","159","4","402","907","0","44.32","26.35"
"10","015","00","010","0032","0000","405","232","173","4","409","1069","0","38.26","21.70"
"10","015","00","010","0032","0087","405","232","173","4","409","1069","0","38.26","21.70"
"10","015","00","010","0033","0000","1219","909","310","10","1229","3012","0","40.80","30.18"
"10","015","00","010","0033","0010","362","283","79","3","365","1006","0","36.28","28.13"
"10","015","00","010","0033","0011","411","303","108","2","413","995","0","41.51","30.45"
"10","015","00","010","0033","0012","446","323","123","5","451","1011","0","44.61","31.95"
"10","015","00","010","0034","0000","221","132","89","1","222","584","0","38.01","22.60"
"10","015","00","010","0034","0025","221","132","89","1","222","584","0","38.01","22.60"
"10","015","00","010","0035","0000","173","124","49","0","173","419","0","41.29","29.59"
"10","015","00","010","0035","0029","173","124","49","0","173","419","0","41.29","29.59"
"10","015","00","010","0036","0000","303","192","111","1","304","817","0","37.21","23.50"
"10","015","00","010","0036","0036","303","192","111","1","304","817","0","37.21","23.50"
"10","015","00","010","0037","0000","1976","1333","643","22","1998","5198","0","38.44","25.64"
"10","015","00","010","0037","0048","355","231","124","2","357","903","0","39.53","25.58"
"10","015","00","010","0037","0049","335","241","94","2","337","929","0","36.28","25.94"
"10","015","00","010","0037","0050","401","260","141","11","412","1165","0","35.36","22.32"
"10","015","00","010","0037","0051","442","290","152","3","445","1198","0","37.15","24.21"
"10","015","00","010","0037","0052","443","311","132","4","447","1003","0","44.57","31.01"
"10","015","00","010","0038","0000","869","544","325","6","875","2120","0","41.27","25.66"
"10","015","00","010","0038","0065","408","257","151","1","409","1061","0","38.55","24.22"
"10","015","00","010","0038","0066","461","287","174","5","466","1059","0","44.00","27.10"
"10","015","00","010","0039","0000","317","191","126","0","317","816","0","38.85","23.41"
"10","015","00","010","0039","0064","317","191","126","0","317","816","0","38.85","23.41"
"10","015","00","010","0040","0000","466","331","135","4","470","1480","0","31.76","22.36"
"10","015","00","010","0040","0092","218","162","56","1","219","733","0","29.88","22.10"
"10","015","00","010","0040","0093","248","169","79","3","251","747","0","33.60","22.62"
"10","015","00","010","0041","0000","1616","1136","480","12","1628","4171","0","39.03","27.24"
"10","015","00","010","0041","0083","401","252","149","3","404","1105","0","36.56","22.81"
"10","015","00","010","0041","0084","393","285","108","1","394","1009","0","39.05","28.25"
"10","015","00","010","0041","0085","423","294","129","3","426","1053","0","40.46","27.92"
"10","015","00","010","0041","0086","399","305","94","5","404","1004","0","40.24","30.38"
"10","015","00","010","0042","0000","855","577","278","11","866","2412","0","35.90","23.92"
"10","015","00","010","0042","0046","456","314","142","5","461","1213","0","38.00","25.89"
"10","015","00","010","0042","0047","399","263","136","6","405","1199","0","33.78","21.93"
"10","015","00","010","0043","0000","1237","822","415","8","1245","3671","0","33.91","22.39"
"10","015","00","010","0043","0072","312","209","103","3","315","907","0","34.73","23.04"
"10","015","00","010","0043","0073","316","211","105","0","316","886","0","35.67","23.81"
"10","015","00","010","0043","0074","298","191","107","1","299","938","0","31.88","20.36"
"10","015","00","010","0043","0075","311","211","100","4","315","940","0","33.51","22.45"
"10","015","00","010","0044","0000","1685","1189","496","14","1699","4204","0","40.41","28.28"
"10","015","00","010","0044","0088","464","329","135","2","466","1004","0","46.41","32.77"
"10","015","00","010","0044","0089","428","287","141","4","432","1116","0","38.71","25.72"
"10","015","00","010","0044","0090","391","293","98","5","396","1140","0","34.74","25.70"
"10","015","00","010","0044","0091","402","280","122","3","405","944","0","42.90","29.66"
"10","015","00","010","0045","0000","1405","1041","364","17","1422","3438","0","41.36","30.28"
"10","015","00","010","0045","0013","418","273","145","8","426","1087","0","39.19","25.11"
"10","015","00","010","0045","0014","443","344","99","4","447","1107","0","40.38","31.07"
"10","015","00","010","0045","0015","544","424","120","5","549","1244","0","44.13","34.08"
"10","015","00","020","0000","0000","3570","2547","1023","63","3633","9479","10764","38.33","26.87"
"10","015","00","020","0001","0000","437","315","122","7","444","1166","0","38.08","27.02"
"10","015","00","020","0001","0221","437","315","122","7","444","1166","0","38.08","27.02"
"10","015","00","020","0002","0000","262","211","51","4","266","631","0","42.16","33.44"
"10","015","00","020","0002","0222","262","211","51","4","266","631","0","42.16","33.44"
"10","015","00","020","0003","0000","260","178","82","3","263","575","0","45.74","30.96"
"10","015","00","020","0003","0223","260","178","82","3","263","575","0","45.74","30.96"
"10","015","00","020","0004","0000","407","319","88","5","412","1075","0","38.33","29.67"
"10","015","00","020","0004","0224","407","319","88","5","412","1075","0","38.33","29.67"
"10","015","00","020","0005","0000","468","361","107","9","477","1332","0","35.81","27.10"
"10","015","00","020","0005","0225","232","177","55","8","240","745","0","32.21","23.76"
"10","015","00","020","0005","0226","236","184","52","1","237","587","0","40.37","31.35"
"10","015","00","020","0006","0000","168","131","37","7","175","539","0","32.47","24.30"
"10","015","00","020","0006","0227","95","61","34","6","101","301","0","33.55","20.27"
"10","015","00","020","0006","0228","73","70","3","1","74","238","0","31.09","29.41"
"10","015","00","020","0007","0000","459","302","157","4","463","1250","0","37.04","24.16"
"10","015","00","020","0007","0229","250","150","100","3","253","730","0","34.66","20.55"
"10","015","00","020","0007","0230","209","152","57","1","210","520","0","40.38","29.23"
"10","015","00","020","0008","0000","203","110","93","5","208","538","0","38.66","20.45"
"10","015","00","020","0008","0231","203","110","93","5","208","538","0","38.66","20.45"
"10","015","00","020","0009","0000","210","138","72","1","211","524","0","40.27","26.34"
"10","015","00","020","0009","0232","210","138","72","1","211","524","0","40.27","26.34"
"10","015","00","020","0010","0000","334","233","101","8","342","793","0","43.13","29.38"
"10","015","00","020","0010","0233","334","233","101","8","342","793","0","43.13","29.38"
"10","015","00","020","0011","0000","318","212","106","10","328","959","0","34.20","22.11"
"10","015","00","020","0011","0234","318","212","106","10","328","959","0","34.20","22.11"
"10","015","00","020","0012","0000","44","37","7","0","44","97","0","45.36","38.14"
"10","015","00","020","0012","0235","44","37","7","0","44","97","0","45.36","38.14"
"10","015","00","030","0000","0000","5920","4238","1682","98","6018","19990","23121","30.11","21.20"
"10","015","00","030","0001","0000","1747","1190","557","15","1762","5047","0","34.91","23.58"
"10","015","00","030","0001","0280","323","226","97","4","327","1028","0","31.81","21.98"
"10","015","00","030","0001","0281","321","225","96","2","323","870","0","37.13","25.86"
"10","015","00","030","0001","0282","208","118","90","2","210","607","0","34.60","19.44"
"10","015","00","030","0001","0283","298","206","92","4","302","858","0","35.20","24.01"
"10","015","00","030","0001","0284","257","184","73","1","258","761","0","33.90","24.18"
"10","015","00","030","0001","0285","340","231","109","2","342","923","0","37.05","25.03"
"10","015","00","030","0002","0000","473","349","124","9","482","1587","0","30.37","21.99"
"10","015","00","030","0002","0287","251","188","63","2","253","817","0","30.97","23.01"
"10","015","00","030","0002","0288","222","161","61","7","229","770","0","29.74","20.91"
"10","015","00","030","0003","0000","335","236","99","5","340","1191","0","28.55","19.82"
"10","015","00","030","0003","0291","159","123","36","5","164","508","0","32.28","24.21"
"10","015","00","030","0003","0292","176","113","63","0","176","683","0","25.77","16.54"
"10","015","00","030","0004","0000","338","250","88","1","339","1281","0","26.46","19.52"
"10","015","00","030","0004","0289","183","119","64","1","184","536","0","34.33","22.20"
"10","015","00","030","0004","0290","155","131","24","0","155","745","0","20.81","17.58"
"10","015","00","030","0005","0000","448","286","162","3","451","1150","0","39.22","24.87"
"10","015","00","030","0005","0286","448","286","162","3","451","1150","0","39.22","24.87"
"10","015","00","030","0006","0000","313","226","87","5","318","1204","0","26.41","18.77"
"10","015","00","030","0006","0293","313","226","87","5","318","1204","0","26.41","18.77"
"10","015","00","030","0007","0000","147","114","33","5","152","606","0","25.08","18.81"
"10","015","00","030","0007","0294","147","114","33","5","152","606","0","25.08","18.81"
"10","015","00","030","0008","0000","282","227","55","5","287","963","0","29.80","23.57"
"10","015","00","030","0008","0295","282","227","55","5","287","963","0","29.80","23.57"
"10","015","00","030","0009","0000","154","117","37","2","156","521","0","29.94","22.46"
"10","015","00","030","0009","0296","154","117","37","2","156","521","0","29.94","22.46"
"10","015","00","030","0010","0000","403","305","98","7","410","1500","0","27.33","20.33"
"10","015","00","030","0010","0297","253","194","59","2","255","956","0","26.67","20.29"
"10","015","00","030","0010","0298","150","111","39","5","155","544","0","28.49","20.40"
"10","015","00","030","0011","0000","302","227","75","14","316","1449","0","21.81","15.67"
"10","015","00","030","0011","0299","89","72","17","4","93","412","0","22.57","17.48"
"10","015","00","030","0011","0300","213","155","58","10","223","1037","0","21.50","14.95"
"10","015","00","030","0012","0000","249","181","68","13","262","838","0","31.26","21.60"
"10","015","00","030","0012","0301","249","181","68","13","262","838","0","31.26","21.60"
"10","015","00","030","0013","0000","204","161","43","8","212","750","0","28.27","21.47"
"10","015","00","030","0013","0302","204","161","43","8","212","750","0","28.27","21.47"
"10","015","00","030","0014","0000","243","158","85","3","246","864","0","28.47","18.29"
"10","015","00","030","0014","0303","243","158","85","3","246","864","0","28.47","18.29"
"10","015","00","030","0015","0000","282","211","71","3","285","1039","0","27.43","20.31"
"10","015","00","030","0015","0304","282","211","71","3","285","1039","0","27.43","20.31"
"10","015","00","040","0000","0000","5927","4233","1694","105","6032","17209","20015","35.05","24.60"
"10","015","00","040","0001","0000","502","314","188","9","511","1249","0","40.91","25.14"
"10","015","00","040","0001","0094","129","88","41","2","131","336","0","38.99","26.19"
"10","015","00","040","0001","0095","373","226","147","7","380","913","0","41.62","24.75"
"10","015","00","040","0002","0000","304","140","164","14","318","901","0","35.29","15.54"
"10","015","00","040","0002","0096","192","94","98","12","204","598","0","34.11","15.72"
"10","015","00","040","0002","0097","112","46","66","2","114","303","0","37.62","15.18"
"10","015","00","040","0003","0000","804","565","239","14","818","2413","0","33.90","23.41"
"10","015","00","040","0003","0098","379","272","107","6","385","1128","0","34.13","24.11"
"10","015","00","040","0003","0099","425","293","132","8","433","1285","0","33.70","22.80"
"10","015","00","040","0004","0000","1438","1038","400","19","1457","4113","0","35.42","25.24"
"10","015","00","040","0004","0103","309","229","80","5","314","904","0","34.73","25.33"
"10","015","00","040","0004","0104","396","279","117","3","399","997","0","40.02","27.98"
"10","015","00","040","0004","0105","380","279","101","3","383","1026","0","37.33","27.19"
"10","015","00","040","0004","0106","353","251","102","8","361","1186","0","30.44","21.16"
"10","015","00","040","0005","0000","370","247","123","2","372","992","0","37.50","24.90"
"10","015","00","040","0005","0107","370","247","123","2","372","992","0","37.50","24.90"
"10","015","00","040","0006","0000","1240","930","310","20","1260","3787","0","33.27","24.56"
"10","015","00","040","0006","0108","316","211","105","2","318","988","0","32.19","21.36"
"10","015","00","040","0006","0109","324","254","70","7","331","936","0","35.36","27.14"
"10","015","00","040","0006","0110","309","248","61","7","316","860","0","36.74","28.84"
"10","015","00","040","0006","0111","291","217","74","4","295","1003","0","29.41","21.64"
"10","015","00","040","0007","0000","391","308","83","7","398","1243","0","32.02","24.78"
"10","015","00","040","0007","0112","273","226","47","3","276","887","0","31.12","25.48"
"10","015","00","040","0007","0113","118","82","36","4","122","356","0","34.27","23.03"
"10","015","00","040","0008","0000","878","691","187","20","898","2511","0","35.76","27.52"
"10","015","00","040","0008","0100","356","288","68","14","370","986","0","37.53","29.21"
"10","015","00","040","0008","0101","420","325","95","5","425","1178","0","36.08","27.59"
"10","015","00","040","0008","0102","102","78","24","1","103","347","0","29.68","22.48"
"10","015","00","050","0000","0000","27166","18581","8585","289","27455","72533","83515","37.85","25.62"
"10","015","00","050","0001","0000","2909","1911","998","25","2934","7104","0","41.30","26.90"
"10","015","00","050","0001","0170","393","253","140","4","397","1059","0","37.49","23.89"
"10","015","00","050","0001","0171","460","328","132","2","462","1027","0","44.99","31.94"
"10","015","00","050","0001","0172","427","270","157","1","428","1042","0","41.07","25.91"
"10","015","00","050","0001","0173","396","239","157","5","401","1013","0","39.59","23.59"
"10","015","00","050","0001","0174","453","311","142","2","455","1049","0","43.37","29.65"
"10","015","00","050","0001","0175","392","253","139","6","398","937","0","42.48","27.00"
"10","015","00","050","0001","0176","388","257","131","5","393","977","0","40.23","26.31"
"10","015","00","050","0002","0000","2018","1308","710","11","2029","4909","0","41.33","26.64"
"10","015","00","050","0002","0177","534","349","185","4","538","1239","0","43.42","28.17"
"10","015","00","050","0002","0178","493","329","164","4","497","1255","0","39.60","26.22"
"10","015","00","050","0002","0179","494","327","167","1","495","1245","0","39.76","26.27"
"10","015","00","050","0002","0180","497","303","194","2","499","1170","0","42.65","25.90"
"10","015","00","050","0003","0000","1270","796","474","31","1301","3726","0","34.92","21.36"
"10","015","00","050","0003","0136","470","272","198","10","480","1232","0","38.96","22.08"
"10","015","00","050","0003","0137","447","273","174","8","455","1309","0","34.76","20.86"
"10","015","00","050","0003","0138","353","251","102","13","366","1185","0","30.89","21.18"
"10","015","00","050","0004","0000","1637","1115","522","16","1653","4253","0","38.87","26.22"
"10","015","00","050","0004","0132","392","249","143","4","396","1039","0","38.11","23.97"
"10","015","00","050","0004","0133","443","312","131","2","445","1027","0","43.33","30.38"
"10","015","00","050","0004","0134","385","279","106","6","391","1045","0","37.42","26.70"
"10","015","00","050","0004","0135","417","275","142","4","421","1142","0","36.87","24.08"
"10","015","00","050","0005","0000","2600","1770","830","27","2627","6951","0","37.79","25.46"
"10","015","00","050","0005","0139","543","383","160","5","548","1273","0","43.05","30.09"
"10","015","00","050","0005","0140","444","303","141","7","451","1141","0","39.53","26.56"
"10","015","00","050","0005","0141","394","271","123","3","397","1166","0","34.05","23.24"
"10","015","00","050","0005","0142","391","238","153","2","393","1014","0","38.76","23.47"
"10","015","00","050","0005","0143","450","319","131","9","459","1373","0","33.43","23.23"
"10","015","00","050","0005","0144","378","256","122","1","379","984","0","38.52","26.02"
"10","015","00","050","0006","0000","2022","1397","625","21","2043","5283","0","38.67","26.44"
"10","015","00","050","0006","0145","471","310","161","3","474","1215","0","39.01","25.51"
"10","015","00","050","0006","0146","507","363","144","3","510","1220","0","41.80","29.75"
"10","015","00","050","0006","0147","315","218","97","1","316","814","0","38.82","26.78"
"10","015","00","050","0006","0148","315","224","91","7","322","954","0","33.75","23.48"
"10","015","00","050","0006","0149","414","282","132","7","421","1080","0","38.98","26.11"
"10","015","00","050","0007","0000","1174","760","414","19","1193","2931","0","40.70","25.93"
"10","015","00","050","0007","0150","397","277","120","9","406","1090","0","37.25","25.41"
"10","015","00","050","0007","0151","367","233","134","6","373","889","0","41.96","26.21"
"10","015","00","050","0007","0152","410","250","160","4","414","952","0","43.49","26.26"
"10","015","00","050","0008","0000","602","358","244","12","614","1568","0","39.16","22.83"
"10","015","00","050","0008","0153","306","164","142","5","311","801","0","38.83","20.47"
"10","015","00","050","0008","0154","296","194","102","7","303","767","0","39.50","25.29"
"10","015","00","050","0009","0000","415","318","97","4","419","1280","0","32.73","24.84"
"10","015","00","050","0009","0155","415","318","97","4","419","1280","0","32.73","24.84"
"10","015","00","050","0010","0000","1009","740","269","9","1018","2922","0","34.84","25.33"
"10","015","00","050","0010","0156","379","268","111","5","384","908","0","42.29","29.52"
"10","015","00","050","0010","0157","269","205","64","3","272","914","0","29.76","22.43"
"10","015","00","050","0010","0158","361","267","94","1","362","1100","0","32.91","24.27"
"10","015","00","050","0011","0000","1217","845","372","13","1230","3170","0","38.80","26.66"
"10","015","00","050","0011","0159","390","280","110","3","393","947","0","41.50","29.57"
"10","015","00","050","0011","0160","393","259","134","3","396","989","0","40.04","26.19"
"10","015","00","050","0011","0161","434","306","128","7","441","1234","0","35.74","24.80"
"10","015","00","050","0012","0000","1475","1058","417","10","1485","4138","0","35.89","25.57"
"10","015","00","050","0012","0162","378","289","89","4","382","1120","0","34.11","25.80"
"10","015","00","050","0012","0163","454","337","117","2","456","1149","0","39.69","29.33"
"10","015","00","050","0012","0164","316","215","101","2","318","967","0","32.89","22.23"
"10","015","00","050","0012","0165","327","217","110","2","329","902","0","36.47","24.06"
"10","015","00","050","0013","0000","1515","1022","493","10","1525","3933","0","38.77","25.99"
"10","015","00","050","0013","0166","397","284","113","2","399","1017","0","39.23","27.93"
"10","015","00","050","0013","0167","358","231","127","2","360","1014","0","35.50","22.78"
"10","015","00","050","0013","0168","373","257","116","5","378","949","0","39.83","27.08"
"10","015","00","050","0013","0169","387","250","137","1","388","953","0","40.71","26.23"
"10","015","00","050","0014","0000","2293","1611","682","20","2313","5995","0","38.58","26.87"
"10","015","00","050","0014","0181","397","288","109","4","401","999","0","40.14","28.83"
"10","015","00","050","0014","0182","423","297","126","3","426","991","0","42.99","29.97"
"10","015","00","050","0014","0183","300","227","73","0","300","772","0","38.86","29.40"
"10","015","00","050","0014","0184","394","259","135","0","394","1130","0","34.87","22.92"
"10","015","00","050","0014","0185","425","306","119","6","431","1111","0","38.79","27.54"
"10","015","00","050","0014","0186","354","234","120","7","361","992","0","36.39","23.59"
"10","015","00","050","0015","0000","2011","1458","553","28","2039","5503","0","37.05","26.49"
"10","015","00","050","0015","0187","452","321","131","7","459","1128","0","40.69","28.46"
"10","015","00","050","0015","0188","325","251","74","1","326","978","0","33.33","25.66"
"10","015","00","050","0015","0189","398","298","100","9","407","1019","0","39.94","29.24"
"10","015","00","050","0015","0190","398","292","106","4","402","1135","0","35.42","25.73"
"10","015","00","050","0015","0191","438","296","142","7","445","1243","0","35.80","23.81"
"10","015","00","050","0016","0000","732","488","244","11","743","2360","0","31.48","20.68"
"10","015","00","050","0016","0192","343","211","132","7","350","1134","0","30.86","18.61"
"10","015","00","050","0016","0193","389","277","112","4","393","1226","0","32.06","22.59"
"10","015","00","050","0017","0000","1514","1034","480","8","1522","4520","0","33.67","22.88"
"10","015","00","050","0017","0194","427","287","140","4","431","1178","0","36.59","24.36"
"10","015","00","050","0017","0195","367","254","113","2","369","1059","0","34.84","23.98"
"10","015","00","050","0017","0196","416","284","132","1","417","1271","0","32.81","22.34"
"10","015","00","050","0017","0197","304","209","95","1","305","1012","0","30.14","20.65"
"10","015","00","050","0018","0000","753","592","161","14","767","1987","0","38.60","29.79"
"10","015","00","050","0018","0198","361","286","75","6","367","965","0","38.03","29.64"
"10","015","00","050","0018","0199","392","306","86","8","400","1022","0","39.14","29.94"
"10","015","00","060","0000","0000","5652","3836","1816","82","5734","15544","17427","36.89","24.68"
"10","015","00","060","0001","0000","137","92","45","2","139","352","0","39.49","26.14"
"10","015","00","060","0001","0201","137","92","45","2","139","352","0","39.49","26.14"
"10","015","00","060","0002","0000","383","256","127","8","391","1019","0","38.37","25.12"
"10","015","00","060","0002","0200","383","256","127","8","391","1019","0","38.37","25.12"
"10","015","00","060","0003","0000","651","440","211","13","664","1879","0","35.34","23.42"
"10","015","00","060","0003","0202","320","213","107","4","324","997","0","32.50","21.36"
"10","015","00","060","0003","0203","331","227","104","9","340","882","0","38.55","25.74"
"10","015","00","060","0004","0000","472","314","158","5","477","1317","0","36.22","23.84"
"10","015","00","060","0004","0204","237","153","84","3","240","640","0","37.50","23.91"
"10","015","00","060","0004","0205","235","161","74","2","237","677","0","35.01","23.78"
"10","015","00","060","0005","0000","296","212","84","3","299","900","0","33.22","23.56"
"10","015","00","060","0005","0206","296","212","84","3","299","900","0","33.22","23.56"
"10","015","00","060","0006","0000","318","225","93","1","319","729","0","43.76","30.86"
"10","015","00","060","0006","0209","318","225","93","1","319","729","0","43.76","30.86"
"10","015","00","060","0007","0000","574","393","181","11","585","1627","0","35.96","24.15"
"10","015","00","060","0007","0207","276","176","100","5","281","734","0","38.28","23.98"
"10","015","00","060","0007","0208","298","217","81","6","304","893","0","34.04","24.30"
"10","015","00","060","0008","0000","285","235","50","3","288","772","0","37.31","30.44"
"10","015","00","060","0008","0210","285","235","50","3","288","772","0","37.31","30.44"
"10","015","00","060","0009","0000","297","201","96","5","302","747","0","40.43","26.91"
"10","015","00","060","0009","0211","297","201","96","5","302","747","0","40.43","26.91"
"10","015","00","060","0010","0000","528","314","214","12","540","1402","0","38.52","22.40"
"10","015","00","060","0010","0212","365","206","159","9","374","981","0","38.12","21.00"
"10","015","00","060","0010","0213","163","108","55","3","166","421","0","39.43","25.65"
"10","015","00","060","0011","0000","934","568","366","7","941","2522","0","37.31","22.52"
"10","015","00","060","0011","0214","379","243","136","5","384","1115","0","34.44","21.79"
"10","015","00","060","0011","0215","388","204","184","1","389","981","0","39.65","20.80"
"10","015","00","060","0011","0216","167","121","46","1","168","426","0","39.44","28.40"
"10","015","00","060","0012","0000","110","81","29","4","114","259","0","44.02","31.27"
"10","015","00","060","0012","0217","110","81","29","4","114","259","0","44.02","31.27"
"10","015","00","060","0013","0000","269","218","51","1","270","816","0","33.09","26.72"
"10","015","00","060","0013","0218","269","218","51","1","270","816","0","33.09","26.72"
"10","015","00","060","0014","0000","231","173","58","6","237","700","0","33.86","24.71"
"10","015","00","060","0014","0220","231","173","58","6","237","700","0","33.86","24.71"
"10","015","00","060","0015","0000","167","114","53","1","168","503","0","33.40","22.66"
"10","015","00","060","0015","0219","167","114","53","1","168","503","0","33.40","22.66"
"10","015","00","070","0000","0000","3532","2604","928","79","3611","10956","12280","32.96","23.77"
"10","015","00","070","0001","0000","319","213","106","2","321","809","0","39.68","26.33"
"10","015","00","070","0001","0237","319","213","106","2","321","809","0","39.68","26.33"
"10","015","00","070","0002","0000","415","258","157","11","426","1258","0","33.86","20.51"
"10","015","00","070","0002","0236","415","258","157","11","426","1258","0","33.86","20.51"
"10","015","00","070","0003","0000","272","211","61","11","283","918","0","30.83","22.98"
"10","015","00","070","0003","0238","272","211","61","11","283","918","0","30.83","22.98"
"10","015","00","070","0004","0000","253","211","42","5","258","970","0","26.60","21.75"
"10","015","00","070","0004","0239","253","211","42","5","258","970","0","26.60","21.75"
"10","015","00","070","0005","0000","351","254","97","6","357","1018","0","35.07","24.95"
"10","015","00","070","0005","0240","351","254","97","6","357","1018","0","35.07","24.95"
"10","015","00","070","0006","0000","178","133","45","2","180","435","0","41.38","30.57"
"10","015","00","070","0006","0247","178","133","45","2","180","435","0","41.38","30.57"
"10","015","00","070","0007","0000","226","150","76","5","231","765","0","30.20","19.61"
"10","015","00","070","0007","0248","192","124","68","5","197","630","0","31.27","19.68"
"10","015","00","070","0007","0249","34","26","8","0","34","135","0","25.19","19.26"
"10","015","00","070","0008","0000","160","129","31","0","160","454","0","35.24","28.41"
"10","015","00","070","0008","0250","160","129","31","0","160","454","0","35.24","28.41"
"10","015","00","070","0009","0000","106","65","41","1","107","302","0","35.43","21.52"
"10","015","00","070","0009","0251","106","65","41","1","107","302","0","35.43","21.52"
"10","015","00","070","0010","0000","141","95","46","6","147","409","0","35.94","23.23"
"10","015","00","070","0010","0252","141","95","46","6","147","409","0","35.94","23.23"
"10","015","00","070","0011","0000","291","250","41","9","300","990","0","30.30","25.25"
"10","015","00","070","0011","0241","222","192","30","7","229","799","0","28.66","24.03"
"10","015","00","070","0011","0242","69","58","11","2","71","191","0","37.17","30.37"
"10","015","00","070","0012","0000","310","238","72","8","318","928","0","34.27","25.65"
"10","015","00","070","0012","0243","158","131","27","6","164","479","0","34.24","27.35"
"10","015","00","070","0012","0244","152","107","45","2","154","449","0","34.30","23.83"
"10","015","00","070","0013","0000","253","182","71","10","263","820","0","32.07","22.20"
"10","015","00","070","0013","0245","253","182","71","10","263","820","0","32.07","22.20"
"10","015","00","070","0014","0000","257","215","42","3","260","880","0","29.55","24.43"
"10","015","00","070","0014","0246","257","215","42","3","260","880","0","29.55","24.43"
"10","015","00","080","0000","0000","1084","840","244","47","1131","3966","4341","28.52","21.18"
"10","015","00","080","0001","0000","400","304","96","20","420","1596","0","26.32","19.05"
"10","015","00","080","0001","0255","179","132","47","8","187","652","0","28.68","20.25"
"10","015","00","080","0001","0256","153","112","41","7","160","608","0","26.32","18.42"
"10","015","00","080","0001","0257","68","60","8","5","73","336","0","21.73","17.86"
"10","015","00","080","0002","0000","161","122","39","7","168","614","0","27.36","19.87"
"10","015","00","080","0002","0258","161","122","39","7","168","614","0","27.36","19.87"
"10","015","00","080","0003","0000","119","99","20","1","120","390","0","30.77","25.38"
"10","015","00","080","0003","0259","119","99","20","1","120","390","0","30.77","25.38"
"10","015","00","080","0004","0000","224","157","67","11","235","721","0","32.59","21.78"
"10","015","00","080","0004","0254","224","157","67","11","235","721","0","32.59","21.78"
"10","015","00","080","0005","0000","180","158","22","8","188","645","0","29.15","24.50"
"10","015","00","080","0005","0253","180","158","22","8","188","645","0","29.15","24.50"
"10","015","00","090","0000","0000","3164","2260","904","54","3218","9935","11248","32.39","22.75"
"10","015","00","090","0001","0000","630","445","185","5","635","1828","0","34.74","24.34"
"10","015","00","090","0001","0267","272","197","75","2","274","778","0","35.22","25.32"
"10","015","00","090","0001","0268","358","248","110","3","361","1050","0","34.38","23.62"
"10","015","00","090","0002","0000","641","445","196","4","645","1800","0","35.83","24.72"
"10","015","00","090","0002","0269","313","229","84","1","314","829","0","37.88","27.62"
"10","015","00","090","0002","0270","328","216","112","3","331","971","0","34.09","22.25"
"10","015","00","090","0003","0000","194","133","61","2","196","520","0","37.69","25.58"
"10","015","00","090","0003","0271","194","133","61","2","196","520","0","37.69","25.58"
"10","015","00","090","0004","0000","295","193","102","2","297","923","0","32.18","20.91"
"10","015","00","090","0004","0272","295","193","102","2","297","923","0","32.18","20.91"
"10","015","00","090","0005","0000","161","124","37","6","167","580","0","28.79","21.38"
"10","015","00","090","0005","0273","161","124","37","6","167","580","0","28.79","21.38"
"10","015","00","090","0006","0000","301","207","94","5","306","941","0","32.52","22.00"
"10","015","00","090","0006","0274","301","207","94","5","306","941","0","32.52","22.00"
"10","015","00","090","0007","0000","248","199","49","5","253","867","0","29.18","22.95"
"10","015","00","090","0007","0275","248","199","49","5","253","867","0","29.18","22.95"
"10","015","00","090","0008","0000","73","63","10","3","76","332","0","22.89","18.98"
"10","015","00","090","0008","0276","73","63","10","3","76","332","0","22.89","18.98"
"10","015","00","090","0009","0000","205","145","60","3","208","740","0","28.11","19.59"
"10","015","00","090","0009","0277","205","145","60","3","208","740","0","28.11","19.59"
"10","015","00","090","0010","0000","220","183","37","9","229","825","0","27.76","22.18"
"10","015","00","090","0010","0278","220","183","37","9","229","825","0","27.76","22.18"
"10","015","00","090","0011","0000","196","123","73","10","206","579","0","35.58","21.24"
"10","015","00","090","0011","0279","196","123","73","10","206","579","0","35.58","21.24"
"10","015","00","100","0000","0000","2513","1785","728","72","2585","8785","9897","29.43","20.32"
"10","015","00","100","0001","0000","124","94","30","5","129","471","0","27.39","19.96"
"10","015","00","100","0001","0305","124","94","30","5","129","471","0","27.39","19.96"
"10","015","00","100","0002","0000","229","145","84","8","237","970","0","24.43","14.95"
"10","015","00","100","0002","0306","229","145","84","8","237","970","0","24.43","14.95"
"10","015","00","100","0003","0000","173","147","26","6","179","613","0","29.20","23.98"
"10","015","00","100","0003","0307","173","147","26","6","179","613","0","29.20","23.98"
"10","015","00","100","0004","0000","142","105","37","7","149","573","0","26.00","18.32"
"10","015","00","100","0004","0308","142","105","37","7","149","573","0","26.00","18.32"
"10","015","00","100","0005","0000","318","244","74","2","320","1040","0","30.77","23.46"
"10","015","00","100","0005","0309","318","244","74","2","320","1040","0","30.77","23.46"
"10","015","00","100","0006","0000","128","95","33","3","131","428","0","30.61","22.20"
"10","015","00","100","0006","0310","128","95","33","3","131","428","0","30.61","22.20"
"10","015","00","100","0007","0000","231","169","62","8","239","864","0","27.66","19.56"
"10","015","00","100","0007","0311","231","169","62","8","239","864","0","27.66","19.56"
"10","015","00","100","0008","0000","132","93","39","2","134","368","0","36.41","25.27"
"10","015","00","100","0008","0312","132","93","39","2","134","368","0","36.41","25.27"
"10","015","00","100","0009","0000","400","253","147","6","406","1306","0","31.09","19.37"
"10","015","00","100","0009","0313","400","253","147","6","406","1306","0","31.09","19.37"
"10","015","00","100","0010","0000","148","107","41","3","151","442","0","34.16","24.21"
"10","015","00","100","0010","0314","148","107","41","3","151","442","0","34.16","24.21"
"10","015","00","100","0011","0000","160","134","26","9","169","597","0","28.31","22.45"
"10","015","00","100","0011","0315","160","134","26","9","169","597","0","28.31","22.45"
"10","015","00","100","0012","0000","134","86","48","4","138","491","0","28.11","17.52"
"10","015","00","100","0012","0316","134","86","48","4","138","491","0","28.11","17.52"
"10","015","00","100","0013","0000","194","113","81","9","203","622","0","32.64","18.17"
"10","015","00","100","0013","0317","194","113","81","9","203","622","0","32.64","18.17"
"10","015","00","110","0000","0000","3926","3160","766","46","3972","12966","16204","30.63","24.37"
"10","015","00","110","0001","0000","380","318","62","4","384","1423","0","26.99","22.35"
"10","015","00","110","0001","0116","190","159","31","1","191","726","0","26.31","21.90"
"10","015","00","110","0001","0117","190","159","31","3","193","697","0","27.69","22.81"
"10","015","00","110","0002","0000","577","424","153","9","586","1842","0","31.81","23.02"
"10","015","00","110","0002","0118","256","227","29","2","258","842","0","30.64","26.96"
"10","015","00","110","0002","0119","264","154","110","5","269","841","0","31.99","18.31"
"10","015","00","110","0002","0120","57","43","14","2","59","159","0","37.11","27.04"
"10","015","00","110","0003","0000","523","406","117","7","530","1790","0","29.61","22.68"
"10","015","00","110","0003","0121","128","108","20","5","133","398","0","33.42","27.14"
"10","015","00","110","0003","0122","247","188","59","1","248","881","0","28.15","21.34"
"10","015","00","110","0003","0123","148","110","38","1","149","511","0","29.16","21.53"
"10","015","00","110","0004","0000","386","332","54","5","391","1188","0","32.91","27.95"
"10","015","00","110","0004","0127","386","332","54","5","391","1188","0","32.91","27.95"
"10","015","00","110","0005","0000","398","347","51","8","406","1217","0","33.36","28.51"
"10","015","00","110","0005","0128","215","177","38","7","222","720","0","30.83","24.58"
"10","015","00","110","0005","0129","183","170","13","1","184","497","0","37.02","34.21"
"10","015","00","110","0006","0000","347","295","52","0","347","1126","0","30.82","26.20"
"10","015","00","110","0006","0130","259","221","38","0","259","802","0","32.29","27.56"
"10","015","00","110","0006","0131","88","74","14","0","88","324","0","27.16","22.84"
"10","015","00","110","0007","0000","502","381","121","7","509","1791","0","28.42","21.27"
"10","015","00","110","0007","0124","328","243","85","2","330","1144","0","28.85","21.24"
"10","015","00","110","0007","0125","174","138","36","5","179","647","0","27.67","21.33"
"10","015","00","110","0008","0000","354","309","45","5","359","1048","0","34.26","29.48"
"10","015","00","110","0008","0126","354","309","45","5","359","1048","0","34.26","29.48"
"10","015","00","110","0009","0000","459","348","111","1","460","1541","0","29.85","22.58"
"10","015","00","110","0009","0114","276","201","75","0","276","914","0","30.20","21.99"
"10","015","00","110","0009","0115","183","147","36","1","184","627","0","29.35","23.44"
"10","015","00","120","0000","0000","1315","1119","196","22","1337","5080","6174","26.32","22.03"
"10","015","00","120","0001","0000","299","258","41","4","303","1044","0","29.02","24.71"
"10","015","00","120","0001","0260","299","258","41","4","303","1044","0","29.02","24.71"
"10","015","00","120","0002","0000","121","107","14","0","121","515","0","23.50","20.78"
"10","015","00","120","0002","0261","121","107","14","0","121","515","0","23.50","20.78"
"10","015","00","120","0003","0000","193","162","31","6","199","757","0","26.29","21.40"
"10","015","00","120","0003","0262","193","162","31","6","199","757","0","26.29","21.40"
"10","015","00","120","0004","0000","182","160","22","2","184","639","0","28.79","25.04"
"10","015","00","120","0004","0263","182","160","22","2","184","639","0","28.79","25.04"
"10","015","00","120","0005","0000","262","215","47","6","268","1075","0","24.93","20.00"
"10","015","00","120","0005","0264","129","107","22","2","131","432","0","30.32","24.77"
"10","015","00","120","0005","0265","133","108","25","4","137","643","0","21.31","16.80"
"10","015","00","120","0006","0000","258","217","41","4","262","1050","0","24.95","20.67"
"10","015","00","120","0006","0266","258","217","41","4","262","1050","0","24.95","20.67"
"10","015","00","130","0000","0000","1321","1173","148","29","1350","4818","5997","28.02","24.35"
"10","015","00","130","0001","0000","141","124","17","1","142","523","0","27.15","23.71"
"10","015","00","130","0001","0318","141","124","17","1","142","523","0","27.15","23.71"
"10","015","00","130","0002","0000","233","207","26","9","242","969","0","24.97","21.36"
"10","015","00","130","0002","0319","123","107","16","3","126","511","0","24.66","20.94"
"10","015","00","130","0002","0320","110","100","10","6","116","458","0","25.33","21.83"
"10","015","00","130","0003","0000","234","209","25","9","243","691","0","35.17","30.25"
"10","015","00","130","0003","0321","234","209","25","9","243","691","0","35.17","30.25"
"10","015","00","130","0004","0000","192","170","22","2","194","721","0","26.91","23.58"
"10","015","00","130","0004","0322","192","170","22","2","194","721","0","26.91","23.58"
"10","015","00","130","0005","0000","232","212","20","4","236","1017","0","23.21","20.85"
"10","015","00","130","0005","0323","146","139","7","4","150","623","0","24.08","22.31"
"10","015","00","130","0005","0324","86","73","13","0","86","394","0","21.83","18.53"
"10","015","00","130","0006","0000","289","251","38","4","293","897","0","32.66","27.98"
"10","015","00","130","0006","0325","107","94","13","1","108","321","0","33.64","29.28"
"10","015","00","130","0006","0326","131","110","21","2","133","393","0","33.84","27.99"
"10","015","00","130","0006","0327","51","47","4","1","52","183","0","28.42","25.68"
"10","014","00","000","0000","0000","58854","39175","19679","841","59695","182958","214132","32.63","21.41"
"10","014","00","010","0000","0000","30763","19598","11165","287","31050","87202","104445","35.61","22.47"
"10","014","00","010","0001","0000","454","314","140","7","461","1446","0","31.88","21.72"
"10","014","00","010","0001","0066","252","161","91","4","256","797","0","32.12","20.20"
"10","014","00","010","0001","0067","202","153","49","3","205","649","0","31.59","23.57"
"10","014","00","010","0002","0000","254","156","98","7","261","865","0","30.17","18.03"
"10","014","00","010","0002","0068","254","156","98","7","261","865","0","30.17","18.03"
"10","014","00","010","0003","0000","758","516","242","9","767","2210","0","34.71","23.35"
"10","014","00","010","0003","0072","537","363","174","4","541","1445","0","37.44","25.12"
"10","014","00","010","0003","0073","221","153","68","5","226","765","0","29.54","20.00"
"10","014","00","010","0004","0000","890","611","279","8","898","2796","0","32.12","21.85"
"10","014","00","010","0004","0077","319","213","106","2","321","943","0","34.04","22.59"
"10","014","00","010","0004","0078","296","223","73","1","297","968","0","30.68","23.04"
"10","014","00","010","0004","0079","275","175","100","5","280","885","0","31.64","19.77"
"10","014","00","010","0005","0000","1238","714","524","7","1245","2822","0","44.12","25.30"
"10","014","00","010","0005","0074","411","256","155","1","412","957","0","43.05","26.75"
"10","014","00","010","0005","0075","405","244","161","2","407","926","0","43.95","26.35"
"10","014","00","010","0005","0076","422","214","208","4","426","939","0","45.37","22.79"
"10","014","00","010","0006","0000","896","615","281","9","905","2707","0","33.43","22.72"
"10","014","00","010","0006","0069","351","231","120","2","353","869","0","40.62","26.58"
"10","014","00","010","0006","0070","248","174","74","2","250","865","0","28.90","20.12"
"10","014","00","010","0006","0071","297","210","87","5","302","973","0","31.04","21.58"
"10","014","00","010","0007","0000","2329","1536","793","11","2340","6528","0","35.85","23.53"
"10","014","00","010","0007","0031","400","274","126","1","401","1125","0","35.64","24.36"
"10","014","00","010","0007","0032","327","197","130","1","328","945","0","34.71","20.85"
"10","014","00","010","0007","0033","374","247","127","3","377","1082","0","34.84","22.83"
"10","014","00","010","0007","0034","376","252","124","4","380","1085","0","35.02","23.23"
"10","014","00","010","0007","0035","387","268","119","2","389","1119","0","34.76","23.95"
"10","014","00","010","0007","0036","465","298","167","0","465","1172","0","39.68","25.43"
"10","014","00","010","0008","0000","1280","747","533","15","1295","3035","0","42.67","24.61"
"10","014","00","010","0008","0008","413","235","178","6","419","984","0","42.58","23.88"
"10","014","00","010","0008","0009","472","286","186","6","478","1028","0","46.50","27.82"
"10","014","00","010","0008","0010","395","226","169","3","398","1023","0","38.91","22.09"
"10","014","00","010","0009","0000","299","180","119","4","303","826","0","36.68","21.79"
"10","014","00","010","0009","0011","299","180","119","4","303","826","0","36.68","21.79"
"10","014","00","010","0010","0000","951","677","274","4","955","2489","0","38.37","27.20"
"10","014","00","010","0010","0040","477","340","137","1","478","1223","0","39.08","27.80"
"10","014","00","010","0010","0041","474","337","137","3","477","1266","0","37.68","26.62"
"10","014","00","010","0011","0000","1197","790","407","13","1210","3004","0","40.28","26.30"
"10","014","00","010","0011","0037","392","259","133","3","395","1055","0","37.44","24.55"
"10","014","00","010","0011","0038","362","243","119","2","364","921","0","39.52","26.38"
"10","014","00","010","0011","0039","443","288","155","8","451","1028","0","43.87","28.02"
"10","014","00","010","0012","0000","1590","1005","585","8","1598","3981","0","40.14","25.24"
"10","014","00","010","0012","0004","378","238","140","0","378","953","0","39.66","24.97"
"10","014","00","010","0012","0005","398","256","142","2","400","945","0","42.33","27.09"
"10","014","00","010","0012","0006","367","211","156","2","369","972","0","37.96","21.71"
"10","014","00","010","0012","0007","447","300","147","4","451","1111","0","40.59","27.00"
"10","014","00","010","0013","0000","480","266","214","2","482","1313","0","36.71","20.26"
"10","014","00","010","0013","0002","193","105","88","0","193","526","0","36.69","19.96"
"10","014","00","010","0013","0003","287","161","126","2","289","787","0","36.72","20.46"
"10","014","00","010","0014","0000","220","149","71","2","222","638","0","34.80","23.35"
"10","014","00","010","0014","0013","220","149","71","2","222","638","0","34.80","23.35"
"10","014","00","010","0015","0000","564","317","247","5","569","1628","0","34.95","19.47"
"10","014","00","010","0015","0014","341","181","160","1","342","855","0","40.00","21.17"
"10","014","00","010","0015","0015","223","136","87","4","227","773","0","29.37","17.59"
"10","014","00","010","0016","0000","215","131","84","4","219","620","0","35.32","21.13"
"10","014","00","010","0016","0017","215","131","84","4","219","620","0","35.32","21.13"
"10","014","00","010","0017","0000","399","230","169","2","401","1215","0","33.00","18.93"
"10","014","00","010","0017","0020","399","230","169","2","401","1215","0","33.00","18.93"
"10","014","00","010","0018","0000","325","197","128","3","328","813","0","40.34","24.23"
"10","014","00","010","0018","0012","325","197","128","3","328","813","0","40.34","24.23"
"10","014","00","010","0019","0000","267","146","121","2","269","683","0","39.39","21.38"
"10","014","00","010","0019","0016","267","146","121","2","269","683","0","39.39","21.38"
"10","014","00","010","0020","0000","346","191","155","2","348","768","0","45.31","24.87"
"10","014","00","010","0020","0021","346","191","155","2","348","768","0","45.31","24.87"
"10","014","00","010","0021","0000","272","171","101","3","275","727","0","37.83","23.52"
"10","014","00","010","0021","0018","272","171","101","3","275","727","0","37.83","23.52"
"10","014","00","010","0022","0000","288","151","137","2","290","762","0","38.06","19.82"
"10","014","00","010","0022","0019","288","151","137","2","290","762","0","38.06","19.82"
"10","014","00","010","0023","0000","244","143","101","1","245","941","0","26.04","15.20"
"10","014","00","010","0023","0001","244","143","101","1","245","941","0","26.04","15.20"
"10","014","00","010","0024","0000","319","191","128","0","319","736","0","43.34","25.95"
"10","014","00","010","0024","0022","319","191","128","0","319","736","0","43.34","25.95"
"10","014","00","010","0025","0000","177","114","63","1","178","575","0","30.96","19.83"
"10","014","00","010","0025","0028","177","114","63","1","178","575","0","30.96","19.83"
"10","014","00","010","0026","0000","270","130","140","1","271","711","0","38.12","18.28"
"10","014","00","010","0026","0023","270","130","140","1","271","711","0","38.12","18.28"
"10","014","00","010","0027","0000","135","80","55","1","136","400","0","34.00","20.00"
"10","014","00","010","0027","0029","135","80","55","1","136","400","0","34.00","20.00"
"10","014","00","010","0028","0000","154","87","67","1","155","389","0","39.85","22.37"
"10","014","00","010","0028","0024","154","87","67","1","155","389","0","39.85","22.37"
"10","014","00","010","0029","0000","542","355","187","11","553","1604","0","34.48","22.13"
"10","014","00","010","0029","0082","306","196","110","5","311","799","0","38.92","24.53"
"10","014","00","010","0029","0083","236","159","77","6","242","805","0","30.06","19.75"
"10","014","00","010","0030","0000","727","400","327","12","739","2224","0","33.23","17.99"
"10","014","00","010","0030","0080","309","170","139","5","314","995","0","31.56","17.09"
"10","014","00","010","0030","0081","418","230","188","7","425","1229","0","34.58","18.71"
"10","014","00","010","0031","0000","965","637","328","10","975","3044","0","32.03","20.93"
"10","014","00","010","0031","0044","253","165","88","4","257","961","0","26.74","17.17"
"10","014","00","010","0031","0045","378","238","140","4","382","1126","0","33.93","21.14"
"10","014","00","010","0031","0046","334","234","100","2","336","957","0","35.11","24.45"
"10","014","00","010","0032","0000","974","665","309","6","980","2559","0","38.30","25.99"
"10","014","00","010","0032","0042","535","379","156","4","539","1289","0","41.82","29.40"
"10","014","00","010","0032","0043","439","286","153","2","441","1270","0","34.72","22.52"
"10","014","00","010","0033","0000","490","317","173","2","492","1481","0","33.22","21.40"
"10","014","00","010","0033","0047","289","177","112","0","289","733","0","39.43","24.15"
"10","014","00","010","0033","0048","201","140","61","2","203","748","0","27.14","18.72"
"10","014","00","010","0034","0000","724","457","267","5","729","2117","0","34.44","21.59"
"10","014","00","010","0034","0049","311","190","121","2","313","947","0","33.05","20.06"
"10","014","00","010","0034","0050","413","267","146","3","416","1170","0","35.56","22.82"
"10","014","00","010","0035","0000","390","248","142","10","400","1309","0","30.56","18.95"
"10","014","00","010","0035","0051","390","248","142","10","400","1309","0","30.56","18.95"
"10","014","00","010","0036","0000","1033","666","367","8","1041","2638","0","39.46","25.25"
"10","014","00","010","0036","0025","246","148","98","1","247","718","0","34.40","20.61"
"10","014","00","010","0036","0026","413","259","154","2","415","919","0","45.16","28.18"
"10","014","00","010","0036","0027","374","259","115","5","379","1001","0","37.86","25.87"
"10","014","00","010","0037","0000","328","187","141","2","330","940","0","35.11","19.89"
"10","014","00","010","0037","0030","328","187","141","2","330","940","0","35.11","19.89"
"10","014","00","010","0038","0000","2908","1946","962","18","2926","8103","0","36.11","24.02"
"10","014","00","010","0038","0052","439","282","157","5","444","1195","0","37.15","23.60"
"10","014","00","010","0038","0053","380","266","114","3","383","1176","0","32.57","22.62"
"10","014","00","010","0038","0054","424","288","136","1","425","1217","0","34.92","23.66"
"10","014","00","010","0038","0055","448","286","162","3","451","1259","0","35.82","22.72"
"10","014","00","010","0038","0056","323","201","122","3","326","1035","0","31.50","19.42"
"10","014","00","010","0038","0057","404","276","128","1","405","1084","0","37.36","25.46"
"10","014","00","010","0038","0058","490","347","143","2","492","1137","0","43.27","30.52"
"10","014","00","010","0039","0000","1495","1033","462","13","1508","5024","0","30.02","20.56"
"10","014","00","010","0039","0059","415","286","129","3","418","1349","0","30.99","21.20"
"10","014","00","010","0039","0060","332","219","113","5","337","1284","0","26.25","17.06"
"10","014","00","010","0039","0061","403","284","119","0","403","1270","0","31.73","22.36"
"10","014","00","010","0039","0062","345","244","101","5","350","1121","0","31.22","21.77"
"10","014","00","010","0040","0000","745","428","317","9","754","2362","0","31.92","18.12"
"10","014","00","010","0040","0063","369","227","142","4","373","1127","0","33.10","20.14"
"10","014","00","010","0040","0064","376","201","175","5","381","1235","0","30.85","16.28"
"10","014","00","010","0041","0000","413","217","196","10","423","1214","0","34.84","17.87"
"10","014","00","010","0041","0065","413","217","196","10","423","1214","0","34.84","17.87"
"10","014","00","010","0042","0000","465","324","141","4","469","1392","0","33.69","23.28"
"10","014","00","010","0042","0084","212","128","84","1","213","723","0","29.46","17.70"
"10","014","00","010","0042","0085","253","196","57","3","256","669","0","38.27","29.30"
"10","014","00","010","0043","0000","340","203","137","8","348","952","0","36.55","21.32"
"10","014","00","010","0043","0086","340","203","137","8","348","952","0","36.55","21.32"
"10","014","00","010","0044","0000","383","238","145","5","388","1256","0","30.89","18.95"
"10","014","00","010","0044","0087","383","238","145","5","388","1256","0","30.89","18.95"
"10","014","00","010","0045","0000","458","289","169","7","465","1365","0","34.07","21.17"
"10","014","00","010","0045","0088","248","154","94","5","253","717","0","35.29","21.48"
"10","014","00","010","0045","0089","210","135","75","2","212","648","0","32.72","20.83"
"10","014","00","010","0046","0000","572","433","139","13","585","1990","0","29.40","21.76"
"10","014","00","010","0046","0090","342","266","76","6","348","1087","0","32.01","24.47"
"10","014","00","010","0046","0091","230","167","63","7","237","903","0","26.25","18.49"
"10","014","00","020","0000","0000","3298","2420","878","60","3358","11887","13396","28.25","20.36"
"10","014","00","020","0001","0000","204","166","38","8","212","596","0","35.57","27.85"
"10","014","00","020","0001","0107","114","88","26","5","119","347","0","34.29","25.36"
"10","014","00","020","0001","0108","90","78","12","3","93","249","0","37.35","31.33"
"10","014","00","020","0002","0000","231","159","72","5","236","935","0","25.24","17.01"
"10","014","00","020","0002","0105","121","82","39","4","125","469","0","26.65","17.48"
"10","014","00","020","0002","0106","110","77","33","1","111","466","0","23.82","16.52"
"10","014","00","020","0003","0000","302","221","81","8","310","1337","0","23.19","16.53"
"10","014","00","020","0003","0103","127","85","42","0","127","508","0","25.00","16.73"
"10","014","00","020","0003","0104","175","136","39","8","183","829","0","22.07","16.41"
"10","014","00","020","0004","0000","660","516","144","14","674","2619","0","25.74","19.70"
"10","014","00","020","0004","0101","318","250","68","4","322","1309","0","24.60","19.10"
"10","014","00","020","0004","0102","342","266","76","10","352","1310","0","26.87","20.31"
"10","014","00","020","0005","0000","578","407","171","6","584","1823","0","32.04","22.33"
"10","014","00","020","0005","0099","275","178","97","3","278","882","0","31.52","20.18"
"10","014","00","020","0005","0100","303","229","74","3","306","941","0","32.52","24.34"
"10","014","00","020","0006","0000","635","411","224","4","639","2079","0","30.74","19.77"
"10","014","00","020","0006","0096","93","67","26","0","93","333","0","27.93","20.12"
"10","014","00","020","0006","0097","298","184","114","2","300","938","0","31.98","19.62"
"10","014","00","020","0006","0098","244","160","84","2","246","808","0","30.45","19.80"
"10","014","00","020","0007","0000","191","141","50","2","193","725","0","26.62","19.45"
"10","014","00","020","0007","0095","191","141","50","2","193","725","0","26.62","19.45"
"10","014","00","020","0008","0000","497","399","98","13","510","1773","0","28.76","22.50"
"10","014","00","020","0008","0092","145","110","35","5","150","501","0","29.94","21.96"
"10","014","00","020","0008","0093","252","202","50","6","258","911","0","28.32","22.17"
"10","014","00","020","0008","0094","100","87","13","2","102","361","0","28.25","24.10"
"10","014","00","030","0000","0000","2295","1526","769","49","2344","7211","8330","32.51","21.16"
"10","014","00","030","0001","0000","451","301","150","17","468","1682","0","27.82","17.90"
"10","014","00","030","0001","0115","226","177","49","9","235","915","0","25.68","19.34"
"10","014","00","030","0001","0116","225","124","101","8","233","767","0","30.38","16.17"
"10","014","00","030","0002","0000","380","267","113","2","382","1084","0","35.24","24.63"
"10","014","00","030","0002","0113","380","267","113","2","382","1084","0","35.24","24.63"
"10","014","00","030","0003","0000","274","168","106","13","287","865","0","33.18","19.42"
"10","014","00","030","0003","0112","274","168","106","13","287","865","0","33.18","19.42"
"10","014","00","030","0004","0000","312","186","126","4","316","752","0","42.02","24.73"
"10","014","00","030","0004","0111","312","186","126","4","316","752","0","42.02","24.73"
"10","014","00","030","0005","0000","529","386","143","2","531","1611","0","32.96","23.96"
"10","014","00","030","0005","0109","318","227","91","1","319","864","0","36.92","26.27"
"10","014","00","030","0005","0110","211","159","52","1","212","747","0","28.38","21.29"
"10","014","00","030","0006","0000","159","108","51","7","166","528","0","31.44","20.45"
"10","014","00","030","0006","0117","159","108","51","7","166","528","0","31.44","20.45"
"10","014","00","030","0007","0000","190","110","80","4","194","689","0","28.16","15.97"
"10","014","00","030","0007","0114","190","110","80","4","194","689","0","28.16","15.97"
"10","014","00","040","0000","0000","4799","3035","1764","82","4881","14938","16897","32.68","20.32"
"10","014","00","040","0001","0000","132","80","52","8","140","486","0","28.81","16.46"
"10","014","00","040","0001","0127","59","36","23","4","63","271","0","23.25","13.28"
"10","014","00","040","0001","0128","73","44","29","4","77","215","0","35.81","20.47"
"10","014","00","040","0002","0000","155","121","34","0","155","449","0","34.52","26.95"
"10","014","00","040","0002","0139","155","121","34","0","155","449","0","34.52","26.95"
"10","014","00","040","0003","0000","148","110","38","6","154","467","0","32.98","23.55"
"10","014","00","040","0003","0137","148","110","38","6","154","467","0","32.98","23.55"
"10","014","00","040","0004","0000","119","57","62","1","120","333","0","36.04","17.12"
"10","014","00","040","0004","0138","119","57","62","1","120","333","0","36.04","17.12"
"10","014","00","040","0005","0000","343","190","153","3","346","1149","0","30.11","16.54"
"10","014","00","040","0005","0125","206","103","103","1","207","715","0","28.95","14.41"
"10","014","00","040","0005","0126","137","87","50","2","139","434","0","32.03","20.05"
"10","014","00","040","0006","0000","363","227","136","7","370","1236","0","29.94","18.37"
"10","014","00","040","0006","0123","191","124","67","4","195","741","0","26.32","16.73"
"10","014","00","040","0006","0124","172","103","69","3","175","495","0","35.35","20.81"
"10","014","00","040","0007","0000","359","172","187","6","365","1068","0","34.18","16.10"
"10","014","00","040","0007","0120","62","25","37","2","64","211","0","30.33","11.85"
"10","014","00","040","0007","0121","160","69","91","2","162","466","0","34.76","14.81"
"10","014","00","040","0007","0122","137","78","59","2","139","391","0","35.55","19.95"
"10","014","00","040","0008","0000","726","411","315","10","736","2211","0","33.29","18.59"
"10","014","00","040","0008","0118","340","156","184","5","345","1032","0","33.43","15.12"
"10","014","00","040","0008","0119","386","255","131","5","391","1179","0","33.16","21.63"
"10","014","00","040","0009","0000","325","212","113","4","329","1122","0","29.32","18.89"
"10","014","00","040","0009","0132","325","212","113","4","329","1122","0","29.32","18.89"
"10","014","00","040","0010","0000","997","686","311","11","1008","3124","0","32.27","21.96"
"10","014","00","040","0010","0129","494","320","174","5","499","1334","0","37.41","23.99"
"10","014","00","040","0010","0130","228","162","66","2","230","712","0","32.30","22.75"
"10","014","00","040","0010","0131","275","204","71","4","279","1078","0","25.88","18.92"
"10","014","00","040","0011","0000","395","292","103","13","408","1094","0","37.29","26.69"
"10","014","00","040","0011","0133","395","292","103","13","408","1094","0","37.29","26.69"
"10","014","00","040","0012","0000","391","331","60","9","400","1133","0","35.30","29.21"
"10","014","00","040","0012","0134","391","331","60","9","400","1133","0","35.30","29.21"
"10","014","00","040","0013","0000","346","146","200","4","350","1066","0","32.83","13.70"
"10","014","00","040","0013","0135","294","128","166","3","297","914","0","32.49","14.00"
"10","014","00","040","0013","0136","52","18","34","1","53","152","0","34.87","11.84"
"10","014","00","050","0000","0000","2007","1183","824","42","2049","6713","7514","30.52","17.62"
"10","014","00","050","0001","0000","144","90","54","7","151","650","0","23.23","13.85"
"10","014","00","050","0001","0147","144","90","54","7","151","650","0","23.23","13.85"
"10","014","00","050","0002","0000","316","131","185","7","323","871","0","37.08","15.04"
"10","014","00","050","0002","0148","133","77","56","2","135","413","0","32.69","18.64"
"10","014","00","050","0002","0149","183","54","129","5","188","458","0","41.05","11.79"
"10","014","00","050","0003","0000","220","131","89","7","227","835","0","27.19","15.69"
"10","014","00","050","0003","0146","220","131","89","7","227","835","0","27.19","15.69"
"10","014","00","050","0004","0000","426","276","150","1","427","1440","0","29.65","19.17"
"10","014","00","050","0004","0143","338","209","129","1","339","1099","0","30.85","19.02"
"10","014","00","050","0004","0144","88","67","21","0","88","341","0","25.81","19.65"
"10","014","00","050","0005","0000","216","145","71","5","221","858","0","25.76","16.90"
"10","014","00","050","0005","0145","216","145","71","5","221","858","0","25.76","16.90"
"10","014","00","050","0006","0000","317","233","84","10","327","1026","0","31.87","22.71"
"10","014","00","050","0006","0140","145","124","21","8","153","493","0","31.03","25.15"
"10","014","00","050","0006","0141","172","109","63","2","174","533","0","32.65","20.45"
"10","014","00","050","0007","0000","368","177","191","5","373","1033","0","36.11","17.13"
"10","014","00","050","0007","0142","368","177","191","5","373","1033","0","36.11","17.13"
"10","014","00","060","0000","0000","2164","1306","858","42","2206","7030","8018","31.38","18.58"
"10","014","00","060","0001","0000","300","177","123","4","304","1091","0","27.86","16.22"
"10","014","00","060","0001","0152","137","70","67","2","139","430","0","32.33","16.28"
"10","014","00","060","0001","0153","163","107","56","2","165","661","0","24.96","16.19"
"10","014","00","060","0002","0000","214","137","77","6","220","660","0","33.33","20.76"
"10","014","00","060","0002","0154","214","137","77","6","220","660","0","33.33","20.76"
"10","014","00","060","0003","0000","72","57","15","3","75","322","0","23.29","17.70"
"10","014","00","060","0003","0155","72","57","15","3","75","322","0","23.29","17.70"
"10","014","00","060","0004","0000","254","168","86","4","258","773","0","33.38","21.73"
"10","014","00","060","0004","0156","254","168","86","4","258","773","0","33.38","21.73"
"10","014","00","060","0005","0000","662","392","270","8","670","1890","0","35.45","20.74"
"10","014","00","060","0005","0150","328","213","115","4","332","983","0","33.77","21.67"
"10","014","00","060","0005","0151","334","179","155","4","338","907","0","37.27","19.74"
"10","014","00","060","0006","0000","96","46","50","2","98","337","0","29.08","13.65"
"10","014","00","060","0006","0158","96","46","50","2","98","337","0","29.08","13.65"
"10","014","00","060","0007","0000","254","143","111","4","258","832","0","31.01","17.19"
"10","014","00","060","0007","0157","254","143","111","4","258","832","0","31.01","17.19"
"10","014","00","060","0008","0000","107","48","59","7","114","304","0","37.50","15.79"
"10","014","00","060","0008","0159","107","48","59","7","114","304","0","37.50","15.79"
"10","014","00","060","0009","0000","127","89","38","1","128","393","0","32.57","22.65"
"10","014","00","060","0009","0160","127","89","38","1","128","393","0","32.57","22.65"
"10","014","00","060","0010","0000","78","49","29","3","81","428","0","18.93","11.45"
"10","014","00","060","0010","0161","78","49","29","3","81","428","0","18.93","11.45"
"10","014","00","070","0000","0000","2058","1435","623","41","2099","7358","8123","28.53","19.50"
"10","014","00","070","0001","0000","341","257","84","7","348","1544","0","22.54","16.65"
"10","014","00","070","0001","0169","131","102","29","6","137","813","0","16.85","12.55"
"10","014","00","070","0001","0170","90","74","16","1","91","332","0","27.41","22.29"
"10","014","00","070","0001","0171","120","81","39","0","120","399","0","30.08","20.30"
"10","014","00","070","0002","0000","248","185","63","8","256","1127","0","22.72","16.42"
"10","014","00","070","0002","0168","248","185","63","8","256","1127","0","22.72","16.42"
"10","014","00","070","0003","0000","265","201","64","3","268","951","0","28.18","21.14"
"10","014","00","070","0003","0167","265","201","64","3","268","951","0","28.18","21.14"
"10","014","00","070","0004","0000","81","58","23","1","82","252","0","32.54","23.02"
"10","014","00","070","0004","0172","81","58","23","1","82","252","0","32.54","23.02"
"10","014","00","070","0005","0000","163","116","47","1","164","511","0","32.09","22.70"
"10","014","00","070","0005","0166","163","116","47","1","164","511","0","32.09","22.70"
"10","014","00","070","0006","0000","294","179","115","2","296","886","0","33.41","20.20"
"10","014","00","070","0006","0165","294","179","115","2","296","886","0","33.41","20.20"
"10","014","00","070","0007","0000","666","439","227","19","685","2087","0","32.82","21.03"
"10","014","00","070","0007","0162","196","125","71","6","202","681","0","29.66","18.36"
"10","014","00","070","0007","0163","215","143","72","4","219","618","0","35.44","23.14"
"10","014","00","070","0007","0164","255","171","84","9","264","788","0","33.50","21.70"
"10","014","00","080","0000","0000","1836","1353","483","44","1880","6168","6828","30.48","21.94"
"10","014","00","080","0001","0000","188","144","44","3","191","599","0","31.89","24.04"
"10","014","00","080","0001","0182","16","11","5","0","16","31","0","51.61","35.48"
"10","014","00","080","0001","0183","172","133","39","3","175","568","0","30.81","23.42"
"10","014","00","080","0002","0000","331","278","53","13","344","1145","0","30.04","24.28"
"10","014","00","080","0002","0179","181","154","27","2","183","642","0","28.50","23.99"
"10","014","00","080","0002","0180","108","93","15","5","113","321","0","35.20","28.97"
"10","014","00","080","0002","0181","42","31","11","6","48","182","0","26.37","17.03"
"10","014","00","080","0003","0000","123","78","45","6","129","519","0","24.86","15.03"
"10","014","00","080","0003","0178","123","78","45","6","129","519","0","24.86","15.03"
"10","014","00","080","0004","0000","584","401","183","10","594","1898","0","31.30","21.13"
"10","014","00","080","0004","0176","343","224","119","4","347","1203","0","28.84","18.62"
"10","014","00","080","0004","0177","241","177","64","6","247","695","0","35.54","25.47"
"10","014","00","080","0005","0000","259","166","93","5","264","853","0","30.95","19.46"
"10","014","00","080","0005","0175","259","166","93","5","264","853","0","30.95","19.46"
"10","014","00","080","0006","0000","351","286","65","7","358","1154","0","31.02","24.78"
"10","014","00","080","0006","0173","141","116","25","3","144","495","0","29.09","23.43"
"10","014","00","080","0006","0174","210","170","40","4","214","659","0","32.47","25.80"
"10","014","00","090","0000","0000","2928","1912","1016","60","2988","9526","10806","31.37","20.07"
"10","014","00","090","0001","0000","379","171","208","5","384","1297","0","29.61","13.18"
"10","014","00","090","0001","0184","205","93","112","3","208","641","0","32.45","14.51"
"10","014","00","090","0001","0185","174","78","96","2","176","656","0","26.83","11.89"
"10","014","00","090","0002","0000","192","97","95","5","197","589","0","33.45","16.47"
"10","014","00","090","0002","0186","192","97","95","5","197","589","0","33.45","16.47"
"10","014","00","090","0003","0000","188","90","98","4","192","588","0","32.65","15.31"
"10","014","00","090","0003","0187","188","90","98","4","192","588","0","32.65","15.31"
"10","014","00","090","0004","0000","188","104","84","2","190","564","0","33.69","18.44"
"10","014","00","090","0004","0188","188","104","84","2","190","564","0","33.69","18.44"
"10","014","00","090","0005","0000","443","286","157","10","453","1352","0","33.51","21.15"
"10","014","00","090","0005","0191","221","137","84","2","223","645","0","34.57","21.24"
"10","014","00","090","0005","0192","222","149","73","8","230","707","0","32.53","21.07"
"10","014","00","090","0006","0000","575","386","189","12","587","1720","0","34.13","22.44"
"10","014","00","090","0006","0189","333","255","78","9","342","916","0","37.34","27.84"
"10","014","00","090","0006","0190","242","131","111","3","245","804","0","30.47","16.29"
"10","014","00","090","0007","0000","266","177","89","6","272","811","0","33.54","21.82"
"10","014","00","090","0007","0193","137","103","34","0","137","420","0","32.62","24.52"
"10","014","00","090","0007","0194","129","74","55","6","135","391","0","34.53","18.93"
"10","014","00","090","0008","0000","427","367","60","7","434","1705","0","25.45","21.52"
"10","014","00","090","0008","0195","205","181","24","6","211","832","0","25.36","21.75"
"10","014","00","090","0008","0196","222","186","36","1","223","873","0","25.54","21.31"
"10","014","00","090","0009","0000","270","234","36","9","279","900","0","31.00","26.00"
"10","014","00","090","0009","0197","88","80","8","2","90","228","0","39.47","35.09"
"10","014","00","090","0009","0198","182","154","28","7","189","672","0","28.13","22.92"
"10","014","00","100","0000","0000","1346","1009","337","33","1379","4892","5663","28.19","20.63"
"10","014","00","100","0001","0000","206","184","22","10","216","733","0","29.47","25.10"
"10","014","00","100","0001","0203","108","97","11","7","115","365","0","31.51","26.58"
"10","014","00","100","0001","0204","98","87","11","3","101","368","0","27.45","23.64"
"10","014","00","100","0002","0000","288","263","25","7","295","1061","0","27.80","24.79"
"10","014","00","100","0002","0202","288","263","25","7","295","1061","0","27.80","24.79"
"10","014","00","100","0003","0000","345","247","98","6","351","1229","0","28.56","20.10"
"10","014","00","100","0003","0201","345","247","98","6","351","1229","0","28.56","20.10"
"10","014","00","100","0004","0000","337","179","158","6","343","1341","0","25.58","13.35"
"10","014","00","100","0004","0200","337","179","158","6","343","1341","0","25.58","13.35"
"10","014","00","100","0005","0000","170","136","34","4","174","528","0","32.95","25.76"
"10","014","00","100","0005","0199","170","136","34","4","174","528","0","32.95","25.76"
"10","014","00","110","0000","0000","626","480","146","8","634","3562","4083","17.80","13.48"
"10","014","00","110","0001","0000","197","156","41","5","202","986","0","20.49","15.82"
"10","014","00","110","0001","0207","139","106","33","3","142","782","0","18.16","13.55"
"10","014","00","110","0001","0208","58","50","8","2","60","204","0","29.41","24.51"
"10","014","00","110","0002","0000","171","128","43","1","172","1038","0","16.57","12.33"
"10","014","00","110","0002","0206","171","128","43","1","172","1038","0","16.57","12.33"
"10","014","00","110","0003","0000","258","196","62","2","260","1538","0","16.91","12.74"
"10","014","00","110","0003","0205","258","196","62","2","260","1538","0","16.91","12.74"
"10","014","00","120","0000","0000","893","742","151","14","907","3275","4132","27.69","22.66"
"10","014","00","120","0001","0000","194","171","23","3","197","730","0","26.99","23.42"
"10","014","00","120","0001","0212","194","171","23","3","197","730","0","26.99","23.42"
"10","014","00","120","0002","0000","103","85","18","2","105","251","0","41.83","33.86"
"10","014","00","120","0002","0213","103","85","18","2","105","251","0","41.83","33.86"
"10","014","00","120","0003","0000","67","38","29","1","68","261","0","26.05","14.56"
"10","014","00","120","0003","0214","67","38","29","1","68","261","0","26.05","14.56"
"10","014","00","120","0004","0000","224","190","34","4","228","957","0","23.82","19.85"
"10","014","00","120","0004","0211","224","190","34","4","228","957","0","23.82","19.85"
"10","014","00","120","0005","0000","163","137","26","1","164","575","0","28.52","23.83"
"10","014","00","120","0005","0210","163","137","26","1","164","575","0","28.52","23.83"
"10","014","00","120","0006","0000","142","121","21","3","145","501","0","28.94","24.15"
"10","014","00","120","0006","0209","142","121","21","3","145","501","0","28.94","24.15"
"10","014","00","130","0000","0000","863","718","145","23","886","2912","3575","30.43","24.66"
"10","014","00","130","0001","0000","181","158","23","7","188","593","0","31.70","26.64"
"10","014","00","130","0001","0218","181","158","23","7","188","593","0","31.70","26.64"
"10","014","00","130","0002","0000","112","104","8","1","113","318","0","35.53","32.70"
"10","014","00","130","0002","0217","112","104","8","1","113","318","0","35.53","32.70"
"10","014","00","130","0003","0000","134","118","16","4","138","421","0","32.78","28.03"
"10","014","00","130","0003","0216","134","118","16","4","138","421","0","32.78","28.03"
"10","014","00","130","0004","0000","143","129","14","5","148","577","0","25.65","22.36"
"10","014","00","130","0004","0219","143","129","14","5","148","577","0","25.65","22.36"
"10","014","00","130","0005","0000","293","209","84","6","299","1003","0","29.81","20.84"
"10","014","00","130","0005","0215","293","209","84","6","299","1003","0","29.81","20.84"
"10","014","00","140","0000","0000","1123","1012","111","23","1146","3004","3673","38.15","33.69"
"10","014","00","140","0001","0000","244","215","29","5","249","512","0","48.63","41.99"
"10","014","00","140","0001","0223","244","215","29","5","249","512","0","48.63","41.99"
"10","014","00","140","0002","0000","256","239","17","3","259","603","0","42.95","39.64"
"10","014","00","140","0002","0222","256","239","17","3","259","603","0","42.95","39.64"
"10","014","00","140","0003","0000","377","333","44","10","387","1235","0","31.34","26.96"
"10","014","00","140","0003","0220","201","185","16","5","206","650","0","31.69","28.46"
"10","014","00","140","0003","0221","176","148","28","5","181","585","0","30.94","25.30"
"10","014","00","140","0004","0000","121","116","5","3","124","325","0","38.15","35.69"
"10","014","00","140","0004","0224","121","116","5","3","124","325","0","38.15","35.69"
"10","014","00","140","0005","0000","125","109","16","2","127","329","0","38.60","33.13"
"10","014","00","140","0005","0225","125","109","16","2","127","329","0","38.60","33.13"
"10","014","00","150","0000","0000","1062","906","156","12","1074","2990","3450","35.92","30.30"
"10","014","00","150","0001","0000","231","200","31","4","235","589","0","39.90","33.96"
"10","014","00","150","0001","0231","231","200","31","4","235","589","0","39.90","33.96"
"10","014","00","150","0002","0000","276","241","35","2","278","851","0","32.67","28.32"
"10","014","00","150","0002","0232","276","241","35","2","278","851","0","32.67","28.32"
"10","014","00","150","0003","0000","99","80","19","1","100","334","0","29.94","23.95"
"10","014","00","150","0003","0230","99","80","19","1","100","334","0","29.94","23.95"
"10","014","00","150","0004","0000","206","173","33","3","209","548","0","38.14","31.57"
"10","014","00","150","0004","0226","84","68","16","2","86","232","0","37.07","29.31"
"10","014","00","150","0004","0227","122","105","17","1","123","316","0","38.92","33.23"
"10","014","00","150","0005","0000","143","118","25","0","143","359","0","39.83","32.87"
"10","014","00","150","0005","0229","143","118","25","0","143","359","0","39.83","32.87"
"10","014","00","150","0006","0000","107","94","13","2","109","309","0","35.28","30.42"
"10","014","00","150","0006","0228","107","94","13","2","109","309","0","35.28","30.42"
"10","014","00","160","0000","0000","793","540","253","21","814","4290","5199","18.97","12.59"
"10","014","00","160","0001","0000","208","134","74","2","210","1293","0","16.24","10.36"
"10","014","00","160","0001","0235","208","134","74","2","210","1293","0","16.24","10.36"
"10","014","00","160","0002","0000","132","67","65","6","138","773","0","17.85","8.67"
"10","014","00","160","0002","0236","132","67","65","6","138","773","0","17.85","8.67"
"10","014","00","160","0003","0000","271","186","85","6","277","1256","0","22.05","14.81"
"10","014","00","160","0003","0234","271","186","85","6","277","1256","0","22.05","14.81"
"10","014","00","160","0004","0000","182","153","29","7","189","968","0","19.52","15.81"
"10","014","00","160","0004","0233","182","153","29","7","189","968","0","19.52","15.81"
"10","016","00","000","0000","0000","26219","13817","12402","300","26519","92051","105634","28.81","15.01"
"10","016","00","010","0000","0000","17060","9387","7673","153","17213","54139","62912","31.79","17.34"
"10","016","00","010","0002","0000","137","84","53","0","137","496","0","27.62","16.94"
"10","016","00","010","0002","0001","137","84","53","0","137","496","0","27.62","16.94"
"10","016","00","010","0003","0000","219","124","95","1","220","534","0","41.20","23.22"
"10","016","00","010","0003","0002","219","124","95","1","220","534","0","41.20","23.22"
"10","016","00","010","0004","0000","199","99","100","2","201","520","0","38.65","19.04"
"10","016","00","010","0004","0003","199","99","100","2","201","520","0","38.65","19.04"
"10","016","00","010","0005","0000","332","148","184","4","336","872","0","38.53","16.97"
"10","016","00","010","0005","0004","332","148","184","4","336","872","0","38.53","16.97"
"10","016","00","010","0006","0000","378","170","208","3","381","932","0","40.88","18.24"
"10","016","00","010","0006","0005","378","170","208","3","381","932","0","40.88","18.24"
"10","016","00","010","0007","0000","270","163","107","1","271","785","0","34.52","20.76"
"10","016","00","010","0007","0006","270","163","107","1","271","785","0","34.52","20.76"
"10","016","00","010","0008","0000","645","342","303","5","650","1903","0","34.16","17.97"
"10","016","00","010","0008","0007","323","162","161","3","326","935","0","34.87","17.33"
"10","016","00","010","0008","0008","322","180","142","2","324","968","0","33.47","18.60"
"10","016","00","010","0009","0000","1480","1006","474","17","1497","4135","0","36.20","24.33"
"10","016","00","010","0009","0010","502","379","123","9","511","1381","0","37.00","27.44"
"10","016","00","010","0009","0011","506","313","193","3","509","1416","0","35.95","22.10"
"10","016","00","010","0009","0012","472","314","158","5","477","1338","0","35.65","23.47"
"10","016","00","010","0010","0000","410","258","152","5","415","1175","0","35.32","21.96"
"10","016","00","010","0010","0009","410","258","152","5","415","1175","0","35.32","21.96"
"10","016","00","010","0011","0000","1661","948","713","9","1670","5179","0","32.25","18.30"
"10","016","00","010","0011","0013","397","216","181","2","399","1242","0","32.13","17.39"
"10","016","00","010","0011","0014","332","184","148","3","335","1168","0","28.68","15.75"
"10","016","00","010","0011","0015","453","239","214","3","456","1397","0","32.64","17.11"
"10","016","00","010","0011","0016","479","309","170","1","480","1372","0","34.99","22.52"
"10","016","00","010","0012","0000","764","414","350","7","771","2417","0","31.90","17.13"
"10","016","00","010","0012","0017","342","190","152","0","342","1163","0","29.41","16.34"
"10","016","00","010","0012","0018","422","224","198","7","429","1254","0","34.21","17.86"
"10","016","00","010","0013","0000","511","283","228","5","516","1483","0","34.79","19.08"
"10","016","00","010","0013","0019","511","283","228","5","516","1483","0","34.79","19.08"
"10","016","00","010","0014","0000","1781","1060","721","13","1794","5825","0","30.80","18.20"
"10","016","00","010","0014","0020","369","216","153","6","375","1141","0","32.87","18.93"
"10","016","00","010","0014","0021","485","298","187","2","487","1376","0","35.39","21.66"
"10","016","00","010","0014","0022","523","345","178","2","525","1551","0","33.85","22.24"
"10","016","00","010","0014","0023","404","201","203","3","407","1757","0","23.16","11.44"
"10","016","00","010","0015","0000","995","566","429","7","1002","3202","0","31.29","17.68"
"10","016","00","010","0015","0024","311","174","137","2","313","1006","0","31.11","17.30"
"10","016","00","010","0015","0025","357","203","154","3","360","1066","0","33.77","19.04"
"10","016","00","010","0015","0026","327","189","138","2","329","1130","0","29.12","16.73"
"10","016","00","010","0016","0000","988","563","425","8","996","3283","0","30.34","17.15"
"10","016","00","010","0016","0027","339","196","143","4","343","1038","0","33.04","18.88"
"10","016","00","010","0016","0028","329","193","136","3","332","1142","0","29.07","16.90"
"10","016","00","010","0016","0029","320","174","146","1","321","1103","0","29.10","15.78"
"10","016","00","010","0017","0000","561","301","260","8","569","1855","0","30.67","16.23"
"10","016","00","010","0017","0030","263","144","119","5","268","1007","0","26.61","14.30"
"10","016","00","010","0017","0031","298","157","141","3","301","848","0","35.50","18.51"
"10","016","00","010","0018","0000","222","134","88","2","224","979","0","22.88","13.69"
"10","016","00","010","0018","0032","222","134","88","2","224","979","0","22.88","13.69"
"10","016","00","010","0019","0000","289","139","150","2","291","953","0","30.54","14.59"
"10","016","00","010","0019","0033","289","139","150","2","291","953","0","30.54","14.59"
"10","016","00","010","0020","0000","879","545","334","4","883","2661","0","33.18","20.48"
"10","016","00","010","0020","0034","338","206","132","1","339","930","0","36.45","22.15"
"10","016","00","010","0020","0035","295","188","107","2","297","898","0","33.07","20.94"
"10","016","00","010","0020","0036","246","151","95","1","247","833","0","29.65","18.13"
"10","016","00","010","0021","0000","145","76","69","0","145","439","0","33.03","17.31"
"10","016","00","010","0021","0037","145","76","69","0","145","439","0","33.03","17.31"
"10","016","00","010","0022","0000","671","427","244","8","679","2134","0","31.82","20.01"
"10","016","00","010","0022","0038","375","238","137","4","379","1162","0","32.62","20.48"
"10","016","00","010","0022","0039","296","189","107","4","300","972","0","30.86","19.44"
"10","016","00","010","0023","0000","201","107","94","3","204","650","0","31.38","16.46"
"10","016","00","010","0023","0040","201","107","94","3","204","650","0","31.38","16.46"
"10","016","00","010","0024","0000","357","142","215","7","364","1060","0","34.34","13.40"
"10","016","00","010","0024","0042","357","142","215","7","364","1060","0","34.34","13.40"
"10","016","00","010","0025","0000","385","215","170","6","391","1240","0","31.53","17.34"
"10","016","00","010","0025","0041","385","215","170","6","391","1240","0","31.53","17.34"
"10","016","00","010","0026","0000","228","82","146","2","230","677","0","33.97","12.11"
"10","016","00","010","0026","0043","228","82","146","2","230","677","0","33.97","12.11"
"10","016","00","010","0027","0000","516","196","320","5","521","1707","0","30.52","11.48"
"10","016","00","010","0027","0046","231","96","135","1","232","777","0","29.86","12.36"
"10","016","00","010","0027","0047","285","100","185","4","289","930","0","31.08","10.75"
"10","016","00","010","0028","0000","762","265","497","6","768","2539","0","30.25","10.44"
"10","016","00","010","0028","0044","447","160","287","4","451","1454","0","31.02","11.00"
"10","016","00","010","0028","0045","315","105","210","2","317","1085","0","29.22","9.68"
"10","016","00","010","0029","0000","96","53","43","1","97","470","0","20.64","11.28"
"10","016","00","010","0029","0048","96","53","43","1","97","470","0","20.64","11.28"
"10","016","00","010","0030","0000","114","60","54","2","116","378","0","30.69","15.87"
"10","016","00","010","0030","0049","114","60","54","2","116","378","0","30.69","15.87"
"10","016","00","010","0031","0000","302","190","112","7","309","1162","0","26.59","16.35"
"10","016","00","010","0031","0050","302","190","112","7","309","1162","0","26.59","16.35"
"10","016","00","010","0032","0000","384","112","272","3","387","1368","0","28.29","8.19"
"10","016","00","010","0032","0051","384","112","272","3","387","1368","0","28.29","8.19"
"10","016","00","010","0033","0000","134","86","48","0","134","812","0","16.50","10.59"
"10","016","00","010","0033","0052","134","86","48","0","134","812","0","16.50","10.59"
"10","016","00","010","0034","0000","44","29","15","0","44","314","0","14.01","9.24"
"10","016","00","010","0034","0053","44","29","15","0","44","314","0","14.01","9.24"
"10","016","00","020","0000","0000","3971","1857","2114","67","4038","13570","15248","29.76","13.68"
"10","016","00","020","0001","0000","366","201","165","4","370","1199","0","30.86","16.76"
"10","016","00","020","0001","0054","366","201","165","4","370","1199","0","30.86","16.76"
"10","016","00","020","0002","0000","97","53","44","2","99","358","0","27.65","14.80"
"10","016","00","020","0002","0055","97","53","44","2","99","358","0","27.65","14.80"
"10","016","00","020","0003","0000","66","40","26","2","68","243","0","27.98","16.46"
"10","016","00","020","0003","0056","66","40","26","2","68","243","0","27.98","16.46"
"10","016","00","020","0004","0000","86","44","42","5","91","297","0","30.64","14.81"
"10","016","00","020","0004","0057","86","44","42","5","91","297","0","30.64","14.81"
"10","016","00","020","0005","0000","181","53","128","3","184","683","0","26.94","7.76"
"10","016","00","020","0005","0058","181","53","128","3","184","683","0","26.94","7.76"
"10","016","00","020","0006","0000","87","49","38","0","87","327","0","26.61","14.98"
"10","016","00","020","0006","0059","87","49","38","0","87","327","0","26.61","14.98"
"10","016","00","020","0007","0000","217","92","125","5","222","748","0","29.68","12.30"
"10","016","00","020","0007","0060","217","92","125","5","222","748","0","29.68","12.30"
"10","016","00","020","0008","0000","167","92","75","4","171","839","0","20.38","10.97"
"10","016","00","020","0008","0061","167","92","75","4","171","839","0","20.38","10.97"
"10","016","00","020","0009","0000","291","136","155","3","294","860","0","34.19","15.81"
"10","016","00","020","0009","0062","291","136","155","3","294","860","0","34.19","15.81"
"10","016","00","020","0010","0000","49","23","26","1","50","123","0","40.65","18.70"
"10","016","00","020","0010","0063","49","23","26","1","50","123","0","40.65","18.70"
"10","016","00","020","0011","0000","73","37","36","2","75","221","0","33.94","16.74"
"10","016","00","020","0011","0065","73","37","36","2","75","221","0","33.94","16.74"
"10","016","00","020","0012","0000","108","58","50","2","110","300","0","36.67","19.33"
"10","016","00","020","0012","0067","108","58","50","2","110","300","0","36.67","19.33"
"10","016","00","020","0013","0000","131","76","55","3","134","641","0","20.90","11.86"
"10","016","00","020","0013","0066","131","76","55","3","134","641","0","20.90","11.86"
"10","016","00","020","0014","0000","101","54","47","1","102","389","0","26.22","13.88"
"10","016","00","020","0014","0068","101","54","47","1","102","389","0","26.22","13.88"
"10","016","00","020","0015","0000","260","67","193","4","264","807","0","32.71","8.30"
"10","016","00","020","0015","0064","260","67","193","4","264","807","0","32.71","8.30"
"10","016","00","020","0016","0000","122","84","38","1","123","334","0","36.83","25.15"
"10","016","00","020","0016","0069","122","84","38","1","123","334","0","36.83","25.15"
"10","016","00","020","0017","0000","30","17","13","2","32","94","0","34.04","18.09"
"10","016","00","020","0017","0070","30","17","13","2","32","94","0","34.04","18.09"
"10","016","00","020","0018","0000","285","147","138","2","287","911","0","31.50","16.14"
"10","016","00","020","0018","0071","285","147","138","2","287","911","0","31.50","16.14"
"10","016","00","020","0019","0000","293","115","178","10","303","1004","0","30.18","11.45"
"10","016","00","020","0019","0072","293","115","178","10","303","1004","0","30.18","11.45"
"10","016","00","020","0020","0000","194","78","116","1","195","670","0","29.10","11.64"
"10","016","00","020","0020","0073","194","78","116","1","195","670","0","29.10","11.64"
"10","016","00","020","0021","0000","540","268","272","4","544","1760","0","30.91","15.23"
"10","016","00","020","0021","0074","278","149","129","1","279","913","0","30.56","16.32"
"10","016","00","020","0021","0075","262","119","143","3","265","847","0","31.29","14.05"
"10","016","00","020","0022","0000","227","73","154","6","233","762","0","30.58","9.58"
"10","016","00","020","0022","0076","227","73","154","6","233","762","0","30.58","9.58"
"10","016","00","030","0000","0000","2233","1174","1059","35","2268","8798","9915","25.78","13.34"
"10","016","00","030","0001","0000","166","92","74","4","170","525","0","32.38","17.52"
"10","016","00","030","0001","0077","166","92","74","4","170","525","0","32.38","17.52"
"10","016","00","030","0002","0000","207","120","87","0","207","671","0","30.85","17.88"
"10","016","00","030","0002","0078","207","120","87","0","207","671","0","30.85","17.88"
"10","016","00","030","0003","0000","50","29","21","2","52","110","0","47.27","26.36"
"10","016","00","030","0003","0079","50","29","21","2","52","110","0","47.27","26.36"
"10","016","00","030","0004","0000","48","38","10","0","48","156","0","30.77","24.36"
"10","016","00","030","0004","0080","48","38","10","0","48","156","0","30.77","24.36"
"10","016","00","030","0005","0000","78","48","30","2","80","297","0","26.94","16.16"
"10","016","00","030","0005","0081","78","48","30","2","80","297","0","26.94","16.16"
"10","016","00","030","0006","0000","48","33","15","0","48","216","0","22.22","15.28"
"10","016","00","030","0006","0082","48","33","15","0","48","216","0","22.22","15.28"
"10","016","00","030","0007","0000","62","34","28","1","63","168","0","37.50","20.24"
"10","016","00","030","0007","0083","62","34","28","1","63","168","0","37.50","20.24"
"10","016","00","030","0008","0000","464","250","214","6","470","1719","0","27.34","14.54"
"10","016","00","030","0008","0084","270","138","132","3","273","986","0","27.69","14.00"
"10","016","00","030","0008","0085","194","112","82","3","197","733","0","26.88","15.28"
"10","016","00","030","0009","0000","90","50","40","0","90","307","0","29.32","16.29"
"10","016","00","030","0009","0086","90","50","40","0","90","307","0","29.32","16.29"
"10","016","00","030","0010","0000","210","81","129","6","216","766","0","28.20","10.57"
"10","016","00","030","0010","0087","210","81","129","6","216","766","0","28.20","10.57"
"10","016","00","030","0011","0000","203","87","116","3","206","798","0","25.81","10.90"
"10","016","00","030","0011","0088","203","87","116","3","206","798","0","25.81","10.90"
"10","016","00","030","0012","0000","258","57","201","7","265","1412","0","18.77","4.04"
"10","016","00","030","0012","0089","258","57","201","7","265","1412","0","18.77","4.04"
"10","016","00","030","0013","0000","235","181","54","2","237","1110","0","21.35","16.31"
"10","016","00","030","0013","0090","235","181","54","2","237","1110","0","21.35","16.31"
"10","016","00","030","0014","0000","64","57","7","1","65","274","0","23.72","20.80"
"10","016","00","030","0014","0091","64","57","7","1","65","274","0","23.72","20.80"
"10","016","00","030","0015","0000","50","17","33","1","51","269","0","18.96","6.32"
"10","016","00","030","0015","0092","50","17","33","1","51","269","0","18.96","6.32"
"10","016","00","040","0000","0000","1899","887","1012","22","1921","7398","8309","25.97","11.99"
"10","016","00","040","0001","0000","55","21","34","2","57","301","0","18.94","6.98"
"10","016","00","040","0001","0093","55","21","34","2","57","301","0","18.94","6.98"
"10","016","00","040","0002","0000","100","38","62","0","100","415","0","24.10","9.16"
"10","016","00","040","0002","0094","100","38","62","0","100","415","0","24.10","9.16"
"10","016","00","040","0003","0000","96","67","29","1","97","285","0","34.04","23.51"
"10","016","00","040","0003","0096","96","67","29","1","97","285","0","34.04","23.51"
"10","016","00","040","0004","0000","219","83","136","3","222","817","0","27.17","10.16"
"10","016","00","040","0004","0095","219","83","136","3","222","817","0","27.17","10.16"
"10","016","00","040","0005","0000","188","72","116","2","190","665","0","28.57","10.83"
"10","016","00","040","0005","0097","188","72","116","2","190","665","0","28.57","10.83"
"10","016","00","040","0006","0000","56","16","40","1","57","145","0","39.31","11.03"
"10","016","00","040","0006","0098","56","16","40","1","57","145","0","39.31","11.03"
"10","016","00","040","0007","0000","181","85","96","3","184","642","0","28.66","13.24"
"10","016","00","040","0007","0099","181","85","96","3","184","642","0","28.66","13.24"
"10","016","00","040","0008","0000","63","19","44","1","64","225","0","28.44","8.44"
"10","016","00","040","0008","0100","63","19","44","1","64","225","0","28.44","8.44"
"10","016","00","040","0009","0000","142","46","96","0","142","580","0","24.48","7.93"
"10","016","00","040","0009","0101","142","46","96","0","142","580","0","24.48","7.93"
"10","016","00","040","0010","0000","322","101","221","5","327","1265","0","25.85","7.98"
"10","016","00","040","0010","0102","322","101","221","5","327","1265","0","25.85","7.98"
"10","016","00","040","0011","0000","477","339","138","4","481","2058","0","23.37","16.47"
"10","016","00","040","0011","0103","228","161","67","3","231","927","0","24.92","17.37"
"10","016","00","040","0011","0104","249","178","71","1","250","1131","0","22.10","15.74"
"10","016","00","050","0000","0000","659","284","375","12","671","4779","5401","14.04","5.94"
"10","016","00","050","0001","0000","131","61","70","2","133","723","0","18.40","8.44"
"10","016","00","050","0001","0105","131","61","70","2","133","723","0","18.40","8.44"
"10","016","00","050","0002","0000","92","56","36","0","92","436","0","21.10","12.84"
"10","016","00","050","0002","0106","92","56","36","0","92","436","0","21.10","12.84"
"10","016","00","050","0003","0000","54","20","34","1","55","342","0","16.08","5.85"
"10","016","00","050","0003","0107","54","20","34","1","55","342","0","16.08","5.85"
"10","016","00","050","0004","0000","93","36","57","3","96","487","0","19.71","7.39"
"10","016","00","050","0004","0108","93","36","57","3","96","487","0","19.71","7.39"
"10","016","00","050","0005","0000","176","44","132","4","180","1425","0","12.63","3.09"
"10","016","00","050","0005","0109","84","24","60","3","87","669","0","13.00","3.59"
"10","016","00","050","0005","0110","92","20","72","1","93","756","0","12.30","2.65"
"10","016","00","050","0006","0000","18","10","8","0","18","527","0","3.42","1.90"
"10","016","00","050","0006","0112","18","10","8","0","18","527","0","3.42","1.90"
"10","016","00","050","0007","0000","8","4","4","0","8","220","0","3.64","1.82"
"10","016","00","050","0007","0113","8","4","4","0","8","220","0","3.64","1.82"
"10","016","00","050","0008","0000","37","16","21","1","38","296","0","12.84","5.41"
"10","016","00","050","0008","0111","37","16","21","1","38","296","0","12.84","5.41"
"10","016","00","050","0009","0000","50","37","13","1","51","323","0","15.79","11.46"
"10","016","00","050","0009","0114","50","37","13","1","51","323","0","15.79","11.46"
"10","016","00","060","0000","0000","397","228","169","11","408","3367","3849","12.12","6.77"
"10","016","00","060","0001","0000","20","9","11","3","23","259","0","8.88","3.47"
"10","016","00","060","0001","0115","20","9","11","3","23","259","0","8.88","3.47"
"10","016","00","060","0002","0000","63","35","28","0","63","573","0","10.99","6.11"
"10","016","00","060","0002","0116","63","35","28","0","63","573","0","10.99","6.11"
"10","016","00","060","0003","0000","70","41","29","2","72","643","0","11.20","6.38"
"10","016","00","060","0003","0117","70","41","29","2","72","643","0","11.20","6.38"
"10","016","00","060","0004","0000","58","28","30","0","58","367","0","15.80","7.63"
"10","016","00","060","0004","0118","58","28","30","0","58","367","0","15.80","7.63"
"10","016","00","060","0005","0000","46","19","27","0","46","377","0","12.20","5.04"
"10","016","00","060","0005","0119","46","19","27","0","46","377","0","12.20","5.04"
"10","016","00","060","0006","0000","140","96","44","6","146","1148","0","12.72","8.36"
"10","016","00","060","0006","0120","140","96","44","6","146","1148","0","12.72","8.36"
"10","017","00","000","0000","0000","128944","72735","56209","1118","130062","318539","365891","40.83","22.83"
"10","017","00","010","0000","0000","17342","9703","7639","153","17495","45298","50967","38.62","21.42"
"10","017","00","010","0001","0000","308","164","144","1","309","649","0","47.61","25.27"
"10","017","00","010","0001","0040","308","164","144","1","309","649","0","47.61","25.27"
"10","017","00","010","0002","0000","542","314","228","6","548","1166","0","47.00","26.93"
"10","017","00","010","0002","0038","542","314","228","6","548","1166","0","47.00","26.93"
"10","017","00","010","0003","0000","373","189","184","1","374","874","0","42.79","21.62"
"10","017","00","010","0003","0039","373","189","184","1","374","874","0","42.79","21.62"
"10","017","00","010","0004","0000","403","227","176","4","407","991","0","41.07","22.91"
"10","017","00","010","0004","0037","403","227","176","4","407","991","0","41.07","22.91"
"10","017","00","010","0005","0000","583","290","293","4","587","1177","0","49.87","24.64"
"10","017","00","010","0005","0036","583","290","293","4","587","1177","0","49.87","24.64"
"10","017","00","010","0006","0000","463","228","235","4","467","1117","0","41.81","20.41"
"10","017","00","010","0006","0035","463","228","235","4","467","1117","0","41.81","20.41"
"10","017","00","010","0007","0000","536","329","207","4","540","1217","0","44.37","27.03"
"10","017","00","010","0007","0034","536","329","207","4","540","1217","0","44.37","27.03"
"10","017","00","010","0008","0000","321","184","137","7","328","752","0","43.62","24.47"
"10","017","00","010","0008","0033","321","184","137","7","328","752","0","43.62","24.47"
"10","017","00","010","0009","0000","549","323","226","4","553","1594","0","34.69","20.26"
"10","017","00","010","0009","0032","549","323","226","4","553","1594","0","34.69","20.26"
"10","017","00","010","0010","0000","995","618","377","9","1004","2260","0","44.42","27.35"
"10","017","00","010","0010","0030","544","307","237","5","549","1181","0","46.49","25.99"
"10","017","00","010","0010","0031","451","311","140","4","455","1079","0","42.17","28.82"
"10","017","00","010","0011","0000","604","344","260","7","611","1294","0","47.22","26.58"
"10","017","00","010","0011","0029","604","344","260","7","611","1294","0","47.22","26.58"
"10","017","00","010","0012","0000","807","517","290","12","819","1981","0","41.34","26.10"
"10","017","00","010","0012","0027","503","313","190","6","509","1129","0","45.08","27.72"
"10","017","00","010","0012","0028","304","204","100","6","310","852","0","36.38","23.94"
"10","017","00","010","0013","0000","786","531","255","9","795","1945","0","40.87","27.30"
"10","017","00","010","0013","0025","477","319","158","4","481","1103","0","43.61","28.92"
"10","017","00","010","0013","0026","309","212","97","5","314","842","0","37.29","25.18"
"10","017","00","010","0014","0000","510","297","213","4","514","1245","0","41.29","23.86"
"10","017","00","010","0014","0024","510","297","213","4","514","1245","0","41.29","23.86"
"10","017","00","010","0015","0000","394","255","139","2","396","1125","0","35.20","22.67"
"10","017","00","010","0015","0021","394","255","139","2","396","1125","0","35.20","22.67"
"10","017","00","010","0016","0000","675","312","363","9","684","1688","0","40.52","18.48"
"10","017","00","010","0016","0018","379","183","196","6","385","990","0","38.89","18.48"
"10","017","00","010","0016","0019","296","129","167","3","299","698","0","42.84","18.48"
"10","017","00","010","0017","0000","297","185","112","6","303","920","0","32.93","20.11"
"10","017","00","010","0017","0020","297","185","112","6","303","920","0","32.93","20.11"
"10","017","00","010","0018","0000","459","209","250","1","460","1211","0","37.99","17.26"
"10","017","00","010","0018","0017","459","209","250","1","460","1211","0","37.99","17.26"
"10","017","00","010","0019","0000","602","177","425","3","605","1442","0","41.96","12.27"
"10","017","00","010","0019","0006","602","177","425","3","605","1442","0","41.96","12.27"
"10","017","00","010","0020","0000","402","174","228","3","405","1212","0","33.42","14.36"
"10","017","00","010","0020","0007","402","174","228","3","405","1212","0","33.42","14.36"
"10","017","00","010","0021","0000","204","56","148","2","206","439","0","46.92","12.76"
"10","017","00","010","0021","0001","204","56","148","2","206","439","0","46.92","12.76"
"10","017","00","010","0022","0000","1829","996","833","17","1846","5622","0","32.84","17.72"
"10","017","00","010","0022","0002","425","168","257","5","430","1226","0","35.07","13.70"
"10","017","00","010","0022","0003","417","231","186","7","424","1343","0","31.57","17.20"
"10","017","00","010","0022","0004","530","313","217","2","532","1557","0","34.17","20.10"
"10","017","00","010","0022","0005","457","284","173","3","460","1496","0","30.75","18.98"
"10","017","00","010","0023","0000","576","307","269","2","578","1615","0","35.79","19.01"
"10","017","00","010","0023","0023","576","307","269","2","578","1615","0","35.79","19.01"
"10","017","00","010","0024","0000","356","215","141","5","361","907","0","39.80","23.70"
"10","017","00","010","0024","0022","356","215","141","5","361","907","0","39.80","23.70"
"10","017","00","010","0025","0000","2155","1317","838","9","2164","5731","0","37.76","22.98"
"10","017","00","010","0025","0012","562","319","243","3","565","1473","0","38.36","21.66"
"10","017","00","010","0025","0013","519","323","196","2","521","1463","0","35.61","22.08"
"10","017","00","010","0025","0014","419","248","171","2","421","1100","0","38.27","22.55"
"10","017","00","010","0025","0015","388","259","129","0","388","915","0","42.40","28.31"
"10","017","00","010","0025","0016","267","168","99","2","269","780","0","34.49","21.54"
"10","017","00","010","0026","0000","1613","945","668","18","1631","5124","0","31.83","18.44"
"10","017","00","010","0026","0008","498","286","212","5","503","1435","0","35.05","19.93"
"10","017","00","010","0026","0009","588","348","240","6","594","1580","0","37.59","22.03"
"10","017","00","010","0026","0010","205","134","71","3","208","777","0","26.77","17.25"
"10","017","00","010","0026","0011","322","177","145","4","326","1332","0","24.47","13.29"
"10","017","00","020","0000","0000","18020","9609","8411","178","18198","46431","53534","39.19","20.70"
"10","017","00","020","0001","0000","1394","786","608","20","1414","3732","0","37.89","21.06"
"10","017","00","020","0001","0235","458","243","215","8","466","1219","0","38.23","19.93"
"10","017","00","020","0001","0236","450","261","189","8","458","1182","0","38.75","22.08"
"10","017","00","020","0001","0237","486","282","204","4","490","1331","0","36.81","21.19"
"10","017","00","020","0002","0000","1022","527","495","6","1028","2522","0","40.76","20.90"
"10","017","00","020","0002","0238","478","217","261","3","481","1075","0","44.74","20.19"
"10","017","00","020","0002","0239","544","310","234","3","547","1447","0","37.80","21.42"
"10","017","00","020","0003","0000","1461","850","611","14","1475","3476","0","42.43","24.45"
"10","017","00","020","0003","0242","460","240","220","5","465","1094","0","42.50","21.94"
"10","017","00","020","0003","0243","510","280","230","5","515","1215","0","42.39","23.05"
"10","017","00","020","0003","0244","491","330","161","4","495","1167","0","42.42","28.28"
"10","017","00","020","0004","0000","836","464","372","2","838","1877","0","44.65","24.72"
"10","017","00","020","0004","0245","423","223","200","2","425","934","0","45.50","23.88"
"10","017","00","020","0004","0246","413","241","172","0","413","943","0","43.80","25.56"
"10","017","00","020","0005","0000","936","564","372","11","947","2193","0","43.18","25.72"
"10","017","00","020","0005","0247","513","312","201","9","522","1211","0","43.10","25.76"
"10","017","00","020","0005","0248","423","252","171","2","425","982","0","43.28","25.66"
"10","017","00","020","0006","0000","592","314","278","6","598","1482","0","40.35","21.19"
"10","017","00","020","0006","0249","118","55","63","0","118","284","0","41.55","19.37"
"10","017","00","020","0006","0250","474","259","215","6","480","1198","0","40.07","21.62"
"10","017","00","020","0007","0000","470","254","216","9","479","1165","0","41.12","21.80"
"10","017","00","020","0007","0251","470","254","216","9","479","1165","0","41.12","21.80"
"10","017","00","020","0008","0000","836","428","408","4","840","2268","0","37.04","18.87"
"10","017","00","020","0008","0255","347","179","168","1","348","982","0","35.44","18.23"
"10","017","00","020","0008","0256","489","249","240","3","492","1286","0","38.26","19.36"
"10","017","00","020","0009","0000","1649","920","729","16","1665","4366","0","38.14","21.07"
"10","017","00","020","0009","0252","505","272","233","4","509","1311","0","38.83","20.75"
"10","017","00","020","0009","0253","685","395","290","7","692","1723","0","40.16","22.93"
"10","017","00","020","0009","0254","459","253","206","5","464","1332","0","34.83","18.99"
"10","017","00","020","0010","0000","1384","670","714","13","1397","3616","0","38.63","18.53"
"10","017","00","020","0010","0261","689","348","341","7","696","1791","0","38.86","19.43"
"10","017","00","020","0010","0262","695","322","373","6","701","1825","0","38.41","17.64"
"10","017","00","020","0011","0000","733","359","374","7","740","2070","0","35.75","17.34"
"10","017","00","020","0011","0257","426","201","225","3","429","1076","0","39.87","18.68"
"10","017","00","020","0011","0258","307","158","149","4","311","994","0","31.29","15.90"
"10","017","00","020","0012","0000","163","64","99","3","166","402","0","41.29","15.92"
"10","017","00","020","0012","0270","163","64","99","3","166","402","0","41.29","15.92"
"10","017","00","020","0013","0000","104","57","47","1","105","317","0","33.12","17.98"
"10","017","00","020","0013","0271","104","57","47","1","105","317","0","33.12","17.98"
"10","017","00","020","0014","0000","130","57","73","3","133","325","0","40.92","17.54"
"10","017","00","020","0014","0272","130","57","73","3","133","325","0","40.92","17.54"
"10","017","00","020","0015","0000","916","550","366","5","921","1965","0","46.87","27.99"
"10","017","00","020","0015","0273","403","228","175","2","405","975","0","41.54","23.38"
"10","017","00","020","0015","0274","513","322","191","3","516","990","0","52.12","32.53"
"10","017","00","020","0016","0000","229","89","140","5","234","448","0","52.23","19.87"
"10","017","00","020","0016","0275","229","89","140","5","234","448","0","52.23","19.87"
"10","017","00","020","0017","0000","800","443","357","21","821","1879","0","43.69","23.58"
"10","017","00","020","0017","0240","414","236","178","6","420","968","0","43.39","24.38"
"10","017","00","020","0017","0241","386","207","179","15","401","911","0","44.02","22.72"
"10","017","00","020","0018","0000","2129","1058","1071","20","2149","6051","0","35.51","17.48"
"10","017","00","020","0018","0263","520","245","275","5","525","1502","0","34.95","16.31"
"10","017","00","020","0018","0264","503","250","253","3","506","1474","0","34.33","16.96"
"10","017","00","020","0018","0265","466","215","251","3","469","1450","0","32.34","14.83"
"10","017","00","020","0018","0266","640","348","292","9","649","1625","0","39.94","21.42"
"10","017","00","020","0019","0000","1394","700","694","7","1401","3772","0","37.14","18.56"
"10","017","00","020","0019","0267","490","246","244","4","494","1375","0","35.93","17.89"
"10","017","00","020","0019","0268","383","181","202","1","384","1049","0","36.61","17.25"
"10","017","00","020","0019","0269","521","273","248","2","523","1348","0","38.80","20.25"
"10","017","00","020","0020","0000","842","455","387","5","847","2505","0","33.81","18.16"
"10","017","00","020","0020","0259","410","210","200","4","414","1230","0","33.66","17.07"
"10","017","00","020","0020","0260","432","245","187","1","433","1275","0","33.96","19.22"
"10","017","00","030","0000","0000","13454","7864","5590","131","13585","33447","38494","40.62","23.51"
"10","017","00","030","0001","0000","561","322","239","2","563","1390","0","40.50","23.17"
"10","017","00","030","0001","0205","561","322","239","2","563","1390","0","40.50","23.17"
"10","017","00","030","0002","0000","275","143","132","5","280","641","0","43.68","22.31"
"10","017","00","030","0002","0207","275","143","132","5","280","641","0","43.68","22.31"
"10","017","00","030","0003","0000","267","136","131","1","268","754","0","35.54","18.04"
"10","017","00","030","0003","0208","267","136","131","1","268","754","0","35.54","18.04"
"10","017","00","030","0004","0000","1487","894","593","19","1506","3626","0","41.53","24.66"
"10","017","00","030","0004","0209","424","282","142","4","428","1038","0","41.23","27.17"
"10","017","00","030","0004","0210","513","310","203","6","519","1229","0","42.23","25.22"
"10","017","00","030","0004","0211","550","302","248","9","559","1359","0","41.13","22.22"
"10","017","00","030","0005","0000","1051","630","421","5","1056","2636","0","40.06","23.90"
"10","017","00","030","0005","0221","552","305","247","3","555","1262","0","43.98","24.17"
"10","017","00","030","0005","0222","499","325","174","2","501","1374","0","36.46","23.65"
"10","017","00","030","0006","0000","1278","855","423","2","1280","2957","0","43.29","28.91"
"10","017","00","030","0006","0223","468","380","88","1","469","989","0","47.42","38.42"
"10","017","00","030","0006","0224","395","234","161","0","395","975","0","40.51","24.00"
"10","017","00","030","0006","0225","415","241","174","1","416","993","0","41.89","24.27"
"10","017","00","030","0007","0000","1003","590","413","9","1012","2529","0","40.02","23.33"
"10","017","00","030","0007","0214","461","249","212","5","466","1105","0","42.17","22.53"
"10","017","00","030","0007","0215","542","341","201","4","546","1424","0","38.34","23.95"
"10","017","00","030","0008","0000","1092","615","477","8","1100","2563","0","42.92","24.00"
"10","017","00","030","0008","0212","659","385","274","5","664","1460","0","45.48","26.37"
"10","017","00","030","0008","0213","433","230","203","3","436","1103","0","39.53","20.85"
"10","017","00","030","0009","0000","141","70","71","4","145","405","0","35.80","17.28"
"10","017","00","030","0009","0216","141","70","71","4","145","405","0","35.80","17.28"
"10","017","00","030","0010","0000","1939","1073","866","19","1958","4724","0","41.45","22.71"
"10","017","00","030","0010","0217","620","326","294","4","624","1493","0","41.80","21.84"
"10","017","00","030","0010","0218","433","241","192","6","439","1045","0","42.01","23.06"
"10","017","00","030","0010","0219","458","263","195","6","464","1072","0","43.28","24.53"
"10","017","00","030","0010","0220","428","243","185","3","431","1114","0","38.69","21.81"
"10","017","00","030","0011","0000","175","89","86","0","175","408","0","42.89","21.81"
"10","017","00","030","0011","0206","175","89","86","0","175","408","0","42.89","21.81"
"10","017","00","030","0012","0000","1982","1121","861","35","2017","4877","0","41.36","22.99"
"10","017","00","030","0012","0231","552","326","226","8","560","1327","0","42.20","24.57"
"10","017","00","030","0012","0232","492","269","223","6","498","1219","0","40.85","22.07"
"10","017","00","030","0012","0233","390","231","159","6","396","965","0","41.04","23.94"
"10","017","00","030","0012","0234","548","295","253","15","563","1366","0","41.22","21.60"
"10","017","00","030","0013","0000","2203","1326","877","22","2225","5937","0","37.48","22.33"
"10","017","00","030","0013","0226","436","262","174","4","440","1202","0","36.61","21.80"
"10","017","00","030","0013","0227","387","222","165","6","393","1215","0","32.35","18.27"
"10","017","00","030","0013","0228","476","282","194","3","479","1187","0","40.35","23.76"
"10","017","00","030","0013","0229","559","342","217","7","566","1368","0","41.37","25.00"
"10","017","00","030","0013","0230","345","218","127","2","347","965","0","35.96","22.59"
"10","017","00","040","0000","0000","14752","7787","6965","129","14881","35403","42303","42.03","22.00"
"10","017","00","040","0001","0000","644","351","293","5","649","1698","0","38.22","20.67"
"10","017","00","040","0001","0079","318","172","146","2","320","860","0","37.21","20.00"
"10","017","00","040","0001","0080","326","179","147","3","329","838","0","39.26","21.36"
"10","017","00","040","0002","0000","427","239","188","5","432","1015","0","42.56","23.55"
"10","017","00","040","0002","0081","427","239","188","5","432","1015","0","42.56","23.55"
"10","017","00","040","0003","0000","638","350","288","4","642","1481","0","43.35","23.63"
"10","017","00","040","0003","0082","400","210","190","2","402","936","0","42.95","22.44"
"10","017","00","040","0003","0083","238","140","98","2","240","545","0","44.04","25.69"
"10","017","00","040","0004","0000","698","410","288","3","701","1716","0","40.85","23.89"
"10","017","00","040","0004","0084","360","222","138","3","363","881","0","41.20","25.20"
"10","017","00","040","0004","0085","338","188","150","0","338","835","0","40.48","22.51"
"10","017","00","040","0005","0000","912","496","416","5","917","2263","0","40.52","21.92"
"10","017","00","040","0005","0086","490","275","215","4","494","1213","0","40.73","22.67"
"10","017","00","040","0005","0087","422","221","201","1","423","1050","0","40.29","21.05"
"10","017","00","040","0006","0000","687","380","307","7","694","1653","0","41.98","22.99"
"10","017","00","040","0006","0088","687","380","307","7","694","1653","0","41.98","22.99"
"10","017","00","040","0007","0000","359","179","180","2","361","924","0","39.07","19.37"
"10","017","00","040","0007","0089","359","179","180","2","361","924","0","39.07","19.37"
"10","017","00","040","0008","0000","420","203","217","1","421","945","0","44.55","21.48"
"10","017","00","040","0008","0090","420","203","217","1","421","945","0","44.55","21.48"
"10","017","00","040","0009","0000","382","192","190","2","384","840","0","45.71","22.86"
"10","017","00","040","0009","0091","382","192","190","2","384","840","0","45.71","22.86"
"10","017","00","040","0010","0000","690","362","328","5","695","1413","0","49.19","25.62"
"10","017","00","040","0010","0092","508","266","242","4","512","1002","0","51.10","26.55"
"10","017","00","040","0010","0093","182","96","86","1","183","411","0","44.53","23.36"
"10","017","00","040","0011","0000","330","138","192","6","336","730","0","46.03","18.90"
"10","017","00","040","0011","0094","330","138","192","6","336","730","0","46.03","18.90"
"10","017","00","040","0012","0000","386","185","201","4","390","917","0","42.53","20.17"
"10","017","00","040","0012","0095","386","185","201","4","390","917","0","42.53","20.17"
"10","017","00","040","0013","0000","987","504","483","8","995","2538","0","39.20","19.86"
"10","017","00","040","0013","0096","513","251","262","4","517","1258","0","41.10","19.95"
"10","017","00","040","0013","0097","474","253","221","4","478","1280","0","37.34","19.77"
"10","017","00","040","0014","0000","277","116","161","2","279","710","0","39.30","16.34"
"10","017","00","040","0014","0098","277","116","161","2","279","710","0","39.30","16.34"
"10","017","00","040","0015","0000","473","238","235","5","478","1247","0","38.33","19.09"
"10","017","00","040","0015","0099","236","103","133","0","236","624","0","37.82","16.51"
"10","017","00","040","0015","0100","237","135","102","5","242","623","0","38.84","21.67"
"10","017","00","040","0016","0000","312","136","176","5","317","770","0","41.17","17.66"
"10","017","00","040","0016","0101","312","136","176","5","317","770","0","41.17","17.66"
"10","017","00","040","0017","0000","715","397","318","6","721","1698","0","42.46","23.38"
"10","017","00","040","0017","0102","715","397","318","6","721","1698","0","42.46","23.38"
"10","017","00","040","0018","0000","349","161","188","5","354","790","0","44.81","20.38"
"10","017","00","040","0018","0103","349","161","188","5","354","790","0","44.81","20.38"
"10","017","00","040","0019","0000","388","199","189","4","392","846","0","46.34","23.52"
"10","017","00","040","0019","0104","388","199","189","4","392","846","0","46.34","23.52"
"10","017","00","040","0020","0000","281","122","159","4","285","820","0","34.76","14.88"
"10","017","00","040","0020","0105","281","122","159","4","285","820","0","34.76","14.88"
"10","017","00","040","0021","0000","298","180","118","5","303","670","0","45.22","26.87"
"10","017","00","040","0021","0106","298","180","118","5","303","670","0","45.22","26.87"
"10","017","00","040","0022","0000","341","188","153","4","345","957","0","36.05","19.64"
"10","017","00","040","0022","0107","341","188","153","4","345","957","0","36.05","19.64"
"10","017","00","040","0023","0000","374","184","190","5","379","1056","0","35.89","17.42"
"10","017","00","040","0023","0108","374","184","190","5","379","1056","0","35.89","17.42"
"10","017","00","040","0024","0000","1147","738","409","14","1161","2712","0","42.81","27.21"
"10","017","00","040","0024","0109","398","206","192","6","404","1182","0","34.18","17.43"
"10","017","00","040","0024","0110","749","532","217","8","757","1530","0","49.48","34.77"
"10","017","00","040","0025","0000","312","166","146","3","315","676","0","46.60","24.56"
"10","017","00","040","0025","0113","312","166","146","3","315","676","0","46.60","24.56"
"10","017","00","040","0026","0000","247","123","124","1","248","548","0","45.26","22.45"
"10","017","00","040","0026","0114","247","123","124","1","248","548","0","45.26","22.45"
"10","017","00","040","0027","0000","367","152","215","2","369","692","0","53.32","21.97"
"10","017","00","040","0027","0115","367","152","215","2","369","692","0","53.32","21.97"
"10","017","00","040","0028","0000","279","139","140","3","282","571","0","49.39","24.34"
"10","017","00","040","0028","0116","279","139","140","3","282","571","0","49.39","24.34"
"10","017","00","040","0029","0000","1032","559","473","4","1036","2507","0","41.32","22.30"
"10","017","00","040","0029","0111","452","244","208","1","453","1334","0","33.96","18.29"
"10","017","00","040","0029","0112","580","315","265","3","583","1173","0","49.70","26.85"
"10","017","00","050","0000","0000","16385","9178","7207","158","16543","40977","46058","40.37","22.40"
"10","017","00","050","0001","0000","353","201","152","4","357","769","0","46.42","26.14"
"10","017","00","050","0001","0117","353","201","152","4","357","769","0","46.42","26.14"
"10","017","00","050","0002","0000","494","259","235","4","498","992","0","50.20","26.11"
"10","017","00","050","0002","0118","494","259","235","4","498","992","0","50.20","26.11"
"10","017","00","050","0003","0000","313","160","153","5","318","750","0","42.40","21.33"
"10","017","00","050","0003","0119","313","160","153","5","318","750","0","42.40","21.33"
"10","017","00","050","0004","0000","374","171","203","5","379","962","0","39.40","17.78"
"10","017","00","050","0004","0120","374","171","203","5","379","962","0","39.40","17.78"
"10","017","00","050","0005","0000","345","203","142","5","350","749","0","46.73","27.10"
"10","017","00","050","0005","0121","345","203","142","5","350","749","0","46.73","27.10"
"10","017","00","050","0006","0000","507","302","205","7","514","1221","0","42.10","24.73"
"10","017","00","050","0006","0122","507","302","205","7","514","1221","0","42.10","24.73"
"10","017","00","050","0007","0000","309","202","107","1","310","742","0","41.78","27.22"
"10","017","00","050","0007","0123","309","202","107","1","310","742","0","41.78","27.22"
"10","017","00","050","0008","0000","493","260","233","8","501","1138","0","44.02","22.85"
"10","017","00","050","0008","0124","493","260","233","8","501","1138","0","44.02","22.85"
"10","017","00","050","0009","0000","380","234","146","5","385","961","0","40.06","24.35"
"10","017","00","050","0009","0125","380","234","146","5","385","961","0","40.06","24.35"
"10","017","00","050","0010","0000","477","282","195","11","488","1266","0","38.55","22.27"
"10","017","00","050","0010","0126","477","282","195","11","488","1266","0","38.55","22.27"
"10","017","00","050","0011","0000","686","353","333","8","694","1710","0","40.58","20.64"
"10","017","00","050","0011","0127","289","162","127","3","292","812","0","35.96","19.95"
"10","017","00","050","0011","0128","397","191","206","5","402","898","0","44.77","21.27"
"10","017","00","050","0012","0000","584","309","275","7","591","1512","0","39.09","20.44"
"10","017","00","050","0012","0132","584","309","275","7","591","1512","0","39.09","20.44"
"10","017","00","050","0013","0000","358","190","168","2","360","1271","0","28.32","14.95"
"10","017","00","050","0013","0133","358","190","168","2","360","1271","0","28.32","14.95"
"10","017","00","050","0014","0000","227","124","103","4","231","563","0","41.03","22.02"
"10","017","00","050","0014","0130","227","124","103","4","231","563","0","41.03","22.02"
"10","017","00","050","0015","0000","317","154","163","3","320","864","0","37.04","17.82"
"10","017","00","050","0015","0131","317","154","163","3","320","864","0","37.04","17.82"
"10","017","00","050","0016","0000","274","134","140","6","280","654","0","42.81","20.49"
"10","017","00","050","0016","0153","274","134","140","6","280","654","0","42.81","20.49"
"10","017","00","050","0017","0000","408","205","203","1","409","828","0","49.40","24.76"
"10","017","00","050","0017","0152","408","205","203","1","409","828","0","49.40","24.76"
"10","017","00","050","0018","0000","343","175","168","4","347","904","0","38.38","19.36"
"10","017","00","050","0018","0151","343","175","168","4","347","904","0","38.38","19.36"
"10","017","00","050","0019","0000","571","293","278","9","580","1556","0","37.28","18.83"
"10","017","00","050","0019","0150","571","293","278","9","580","1556","0","37.28","18.83"
"10","017","00","050","0020","0000","2470","1503","967","8","2478","5331","0","46.48","28.19"
"10","017","00","050","0020","0137","562","349","213","2","564","1063","0","53.06","32.83"
"10","017","00","050","0020","0138","619","354","265","2","621","1435","0","43.28","24.67"
"10","017","00","050","0020","0139","718","452","266","3","721","1510","0","47.75","29.93"
"10","017","00","050","0020","0140","571","348","223","1","572","1323","0","43.24","26.30"
"10","017","00","050","0021","0000","2142","1289","853","17","2159","5461","0","39.53","23.60"
"10","017","00","050","0021","0141","503","294","209","3","506","1249","0","40.51","23.54"
"10","017","00","050","0021","0142","357","219","138","3","360","848","0","42.45","25.83"
"10","017","00","050","0021","0143","489","313","176","5","494","1319","0","37.45","23.73"
"10","017","00","050","0021","0144","445","255","190","0","445","1319","0","33.74","19.33"
"10","017","00","050","0021","0145","348","208","140","6","354","726","0","48.76","28.65"
"10","017","00","050","0022","0000","1557","817","740","15","1572","3826","0","41.09","21.35"
"10","017","00","050","0022","0134","498","243","255","3","501","1250","0","40.08","19.44"
"10","017","00","050","0022","0135","539","289","250","9","548","1433","0","38.24","20.17"
"10","017","00","050","0022","0136","520","285","235","3","523","1143","0","45.76","24.93"
"10","017","00","050","0023","0000","207","133","74","2","209","431","0","48.49","30.86"
"10","017","00","050","0023","0129","207","133","74","2","209","431","0","48.49","30.86"
"10","017","00","050","0024","0000","2196","1225","971","17","2213","6516","0","33.96","18.80"
"10","017","00","050","0024","0146","492","292","200","3","495","1635","0","30.28","17.86"
"10","017","00","050","0024","0147","517","297","220","0","517","1589","0","32.54","18.69"
"10","017","00","050","0024","0148","605","333","272","5","610","1670","0","36.53","19.94"
"10","017","00","050","0024","0149","582","303","279","9","591","1622","0","36.44","18.68"
"10","017","00","060","0000","0000","29275","16700","12575","224","29499","70296","81453","41.96","23.76"
"10","017","00","060","0001","0000","450","257","193","2","452","1179","0","38.34","21.80"
"10","017","00","060","0001","0155","450","257","193","2","452","1179","0","38.34","21.80"
"10","017","00","060","0002","0000","403","204","199","4","407","1020","0","39.90","20.00"
"10","017","00","060","0002","0156","403","204","199","4","407","1020","0","39.90","20.00"
"10","017","00","060","0003","0000","481","220","261","5","486","1326","0","36.65","16.59"
"10","017","00","060","0003","0154","481","220","261","5","486","1326","0","36.65","16.59"
"10","017","00","060","0004","0000","473","257","216","5","478","998","0","47.90","25.75"
"10","017","00","060","0004","0157","473","257","216","5","478","998","0","47.90","25.75"
"10","017","00","060","0005","0000","337","140","197","1","338","883","0","38.28","15.86"
"10","017","00","060","0005","0158","337","140","197","1","338","883","0","38.28","15.86"
"10","017","00","060","0006","0000","701","376","325","6","707","1988","0","35.56","18.91"
"10","017","00","060","0006","0159","508","273","235","4","512","1380","0","37.10","19.78"
"10","017","00","060","0006","0160","193","103","90","2","195","608","0","32.07","16.94"
"10","017","00","060","0007","0000","698","356","342","2","700","1900","0","36.84","18.74"
"10","017","00","060","0007","0161","526","259","267","2","528","1446","0","36.51","17.91"
"10","017","00","060","0007","0162","172","97","75","0","172","454","0","37.89","21.37"
"10","017","00","060","0008","0000","1353","648","705","14","1367","3163","0","43.22","20.49"
"10","017","00","060","0008","0165","815","363","452","9","824","1860","0","44.30","19.52"
"10","017","00","060","0008","0166","538","285","253","5","543","1303","0","41.67","21.87"
"10","017","00","060","0009","0000","371","160","211","5","376","821","0","45.80","19.49"
"10","017","00","060","0009","0163","371","160","211","5","376","821","0","45.80","19.49"
"10","017","00","060","0010","0000","220","103","117","2","222","556","0","39.93","18.53"
"10","017","00","060","0010","0164","220","103","117","2","222","556","0","39.93","18.53"
"10","017","00","060","0011","0000","1435","818","617","13","1448","3892","0","37.20","21.02"
"10","017","00","060","0011","0193","738","402","336","7","745","1910","0","39.01","21.05"
"10","017","00","060","0011","0194","697","416","281","6","703","1982","0","35.47","20.99"
"10","017","00","060","0012","0000","687","392","295","8","695","1657","0","41.94","23.66"
"10","017","00","060","0012","0200","687","392","295","8","695","1657","0","41.94","23.66"
"10","017","00","060","0013","0000","2053","1170","883","13","2066","5349","0","38.62","21.87"
"10","017","00","060","0013","0201","491","258","233","1","492","1271","0","38.71","20.30"
"10","017","00","060","0013","0202","548","370","178","2","550","1398","0","39.34","26.47"
"10","017","00","060","0013","0203","542","297","245","5","547","1407","0","38.88","21.11"
"10","017","00","060","0013","0204","472","245","227","5","477","1273","0","37.47","19.25"
"10","017","00","060","0014","0000","1506","832","674","11","1517","4007","0","37.86","20.76"
"10","017","00","060","0014","0195","885","474","411","7","892","2156","0","41.37","21.99"
"10","017","00","060","0014","0196","621","358","263","4","625","1851","0","33.77","19.34"
"10","017","00","060","0015","0000","1055","543","512","10","1065","2451","0","43.45","22.15"
"10","017","00","060","0015","0167","501","235","266","7","508","1156","0","43.94","20.33"
"10","017","00","060","0015","0168","554","308","246","3","557","1295","0","43.01","23.78"
"10","017","00","060","0016","0000","2229","1303","926","10","2239","4656","0","48.09","27.99"
"10","017","00","060","0016","0172","776","460","316","2","778","1539","0","50.55","29.89"
"10","017","00","060","0016","0173","714","418","296","4","718","1709","0","42.01","24.46"
"10","017","00","060","0016","0174","739","425","314","4","743","1408","0","52.77","30.18"
"10","017","00","060","0017","0000","1486","871","615","6","1492","3415","0","43.69","25.51"
"10","017","00","060","0017","0175","725","411","314","4","729","1773","0","41.12","23.18"
"10","017","00","060","0017","0176","761","460","301","2","763","1642","0","46.47","28.01"
"10","017","00","060","0018","0000","1817","1108","709","12","1829","3876","0","47.19","28.59"
"10","017","00","060","0018","0177","703","415","288","5","708","1586","0","44.64","26.17"
"10","017","00","060","0018","0178","563","352","211","2","565","1145","0","49.34","30.74"
"10","017","00","060","0018","0179","551","341","210","5","556","1145","0","48.56","29.78"
"10","017","00","060","0019","0000","1028","536","492","11","1039","2426","0","42.83","22.09"
"10","017","00","060","0019","0180","546","287","259","8","554","1239","0","44.71","23.16"
"10","017","00","060","0019","0181","482","249","233","3","485","1187","0","40.86","20.98"
"10","017","00","060","0020","0000","1040","619","421","3","1043","2796","0","37.30","22.14"
"10","017","00","060","0020","0185","496","299","197","1","497","1411","0","35.22","21.19"
"10","017","00","060","0020","0186","544","320","224","2","546","1385","0","39.42","23.10"
"10","017","00","060","0021","0000","2076","1246","830","14","2090","4808","0","43.47","25.92"
"10","017","00","060","0021","0197","548","302","246","4","552","1546","0","35.71","19.53"
"10","017","00","060","0021","0198","965","581","384","6","971","2100","0","46.24","27.67"
"10","017","00","060","0021","0199","563","363","200","4","567","1162","0","48.80","31.24"
"10","017","00","060","0022","0000","1638","1011","627","16","1654","3289","0","50.29","30.74"
"10","017","00","060","0022","0182","854","536","318","8","862","1726","0","49.94","31.05"
"10","017","00","060","0022","0183","358","216","142","4","362","686","0","52.77","31.49"
"10","017","00","060","0022","0184","426","259","167","4","430","877","0","49.03","29.53"
"10","017","00","060","0023","0000","1703","992","711","24","1727","4694","0","36.79","21.13"
"10","017","00","060","0023","0190","612","360","252","6","618","1681","0","36.76","21.42"
"10","017","00","060","0023","0191","390","234","156","6","396","1069","0","37.04","21.89"
"10","017","00","060","0023","0192","701","398","303","12","713","1944","0","36.68","20.47"
"10","017","00","060","0024","0000","2256","1419","837","14","2270","4907","0","46.26","28.92"
"10","017","00","060","0024","0187","731","453","278","6","737","1557","0","47.33","29.09"
"10","017","00","060","0024","0188","625","371","254","4","629","1416","0","44.42","26.20"
"10","017","00","060","0024","0189","900","595","305","4","904","1934","0","46.74","30.77"
"10","017","00","060","0025","0000","1779","1119","660","13","1792","4239","0","42.27","26.40"
"10","017","00","060","0025","0169","717","447","270","8","725","1633","0","44.40","27.37"
"10","017","00","060","0025","0170","746","464","282","5","751","1833","0","40.97","25.31"
"10","017","00","060","0025","0171","316","208","108","0","316","773","0","40.88","26.91"
"10","017","00","070","0000","0000","19716","11894","7822","145","19861","46687","53082","42.54","25.48"
"10","017","00","070","0001","0000","509","294","215","6","515","1024","0","50.29","28.71"
"10","017","00","070","0001","0041","509","294","215","6","515","1024","0","50.29","28.71"
"10","017","00","070","0002","0000","597","387","210","5","602","1165","0","51.67","33.22"
"10","017","00","070","0002","0042","597","387","210","5","602","1165","0","51.67","33.22"
"10","017","00","070","0003","0000","601","351","250","2","603","1243","0","48.51","28.24"
"10","017","00","070","0003","0043","601","351","250","2","603","1243","0","48.51","28.24"
"10","017","00","070","0004","0000","1088","670","418","4","1092","2232","0","48.92","30.02"
"10","017","00","070","0004","0044","559","339","220","3","562","1092","0","51.47","31.04"
"10","017","00","070","0004","0045","529","331","198","1","530","1140","0","46.49","29.04"
"10","017","00","070","0005","0000","295","161","134","5","300","723","0","41.49","22.27"
"10","017","00","070","0005","0046","295","161","134","5","300","723","0","41.49","22.27"
"10","017","00","070","0006","0000","567","343","224","4","571","1508","0","37.86","22.75"
"10","017","00","070","0006","0047","567","343","224","4","571","1508","0","37.86","22.75"
"10","017","00","070","0007","0000","350","215","135","7","357","712","0","50.14","30.20"
"10","017","00","070","0007","0048","350","215","135","7","357","712","0","50.14","30.20"
"10","017","00","070","0008","0000","546","275","271","5","551","1483","0","37.15","18.54"
"10","017","00","070","0008","0049","546","275","271","5","551","1483","0","37.15","18.54"
"10","017","00","070","0009","0000","713","438","275","7","720","1552","0","46.39","28.22"
"10","017","00","070","0009","0050","713","438","275","7","720","1552","0","46.39","28.22"
"10","017","00","070","0010","0000","706","460","246","7","713","1439","0","49.55","31.97"
"10","017","00","070","0010","0051","706","460","246","7","713","1439","0","49.55","31.97"
"10","017","00","070","0011","0000","904","545","359","6","910","1997","0","45.57","27.29"
"10","017","00","070","0011","0052","460","284","176","4","464","987","0","47.01","28.77"
"10","017","00","070","0011","0053","444","261","183","2","446","1010","0","44.16","25.84"
"10","017","00","070","0012","0000","784","457","327","7","791","1817","0","43.53","25.15"
"10","017","00","070","0012","0058","441","282","159","5","446","1068","0","41.76","26.40"
"10","017","00","070","0012","0059","343","175","168","2","345","749","0","46.06","23.36"
"10","017","00","070","0013","0000","1466","938","528","7","1473","3468","0","42.47","27.05"
"10","017","00","070","0013","0060","570","338","232","3","573","1312","0","43.67","25.76"
"10","017","00","070","0013","0061","560","365","195","1","561","1378","0","40.71","26.49"
"10","017","00","070","0013","0062","336","235","101","3","339","778","0","43.57","30.21"
"10","017","00","070","0014","0000","1124","671","453","17","1141","2716","0","42.01","24.71"
"10","017","00","070","0014","0063","620","372","248","10","630","1440","0","43.75","25.83"
"10","017","00","070","0014","0064","504","299","205","7","511","1276","0","40.05","23.43"
"10","017","00","070","0015","0000","482","267","215","3","485","1308","0","37.08","20.41"
"10","017","00","070","0015","0078","482","267","215","3","485","1308","0","37.08","20.41"
"10","017","00","070","0016","0000","1865","1181","684","10","1875","4064","0","46.14","29.06"
"10","017","00","070","0016","0054","312","187","125","0","312","712","0","43.82","26.26"
"10","017","00","070","0016","0055","414","287","127","4","418","914","0","45.73","31.40"
"10","017","00","070","0016","0056","557","342","215","3","560","1108","0","50.54","30.87"
"10","017","00","070","0016","0057","582","365","217","3","585","1330","0","43.98","27.44"
"10","017","00","070","0017","0000","1620","950","670","16","1636","4618","0","35.43","20.57"
"10","017","00","070","0017","0075","528","303","225","5","533","1215","0","43.87","24.94"
"10","017","00","070","0017","0076","513","290","223","7","520","1598","0","32.54","18.15"
"10","017","00","070","0017","0077","579","357","222","4","583","1805","0","32.30","19.78"
"10","017","00","070","0018","0000","1548","946","602","5","1553","3461","0","44.87","27.33"
"10","017","00","070","0018","0065","427","263","164","0","427","944","0","45.23","27.86"
"10","017","00","070","0018","0066","440","248","192","2","442","1047","0","42.22","23.69"
"10","017","00","070","0018","0067","681","435","246","3","684","1470","0","46.53","29.59"
"10","017","00","070","0019","0000","962","542","420","7","969","2604","0","37.21","20.81"
"10","017","00","070","0019","0073","512","291","221","5","517","1471","0","35.15","19.78"
"10","017","00","070","0019","0074","450","251","199","2","452","1133","0","39.89","22.15"
"10","017","00","070","0020","0000","2989","1803","1186","15","3004","7553","0","39.77","23.87"
"10","017","00","070","0020","0068","647","400","247","1","648","1445","0","44.84","27.68"
"10","017","00","070","0020","0069","670","392","278","2","672","1482","0","45.34","26.45"
"10","017","00","070","0020","0070","481","301","180","4","485","1413","0","34.32","21.30"
"10","017","00","070","0020","0071","529","322","207","5","534","1524","0","35.04","21.13"
"10","017","00","070","0020","0072","662","388","274","3","665","1689","0","39.37","22.97"
"10","018","00","000","0000","0000","154940","84140","70800","1948","156888","361353","452807","43.42","23.28"
"10","018","00","010","0000","0000","76350","43282","33068","898","77248","169450","221541","45.59","25.54"
"10","018","00","010","0001","0000","336","148","188","5","341","689","0","49.49","21.48"
"10","018","00","010","0001","0118","336","148","188","5","341","689","0","49.49","21.48"
"10","018","00","010","0002","0000","652","356","296","5","657","1426","0","46.07","24.96"
"10","018","00","010","0002","0120","428","254","174","2","430","977","0","44.01","26.00"
"10","018","00","010","0002","0121","224","102","122","3","227","449","0","50.56","22.72"
"10","018","00","010","0003","0000","364","138","226","6","370","860","0","43.02","16.05"
"10","018","00","010","0003","0119","364","138","226","6","370","860","0","43.02","16.05"
"10","018","00","010","0004","0000","210","91","119","7","217","472","0","45.97","19.28"
"10","018","00","010","0004","0117","210","91","119","7","217","472","0","45.97","19.28"
"10","018","00","010","0005","0000","277","112","165","0","277","527","0","52.56","21.25"
"10","018","00","010","0005","0004","277","112","165","0","277","527","0","52.56","21.25"
"10","018","00","010","0007","0000","279","122","157","5","284","591","0","48.05","20.64"
"10","018","00","010","0007","0005","279","122","157","5","284","591","0","48.05","20.64"
"10","018","00","010","0010","0000","311","149","162","5","316","712","0","44.38","20.93"
"10","018","00","010","0010","0130","311","149","162","5","316","712","0","44.38","20.93"
"10","018","00","010","0011","0000","455","256","199","5","460","1657","0","27.76","15.45"
"10","018","00","010","0011","0001","455","256","199","5","460","1657","0","27.76","15.45"
"10","018","00","010","0012","0000","242","120","122","3","245","544","0","45.04","22.06"
"10","018","00","010","0012","0006","242","120","122","3","245","544","0","45.04","22.06"
"10","018","00","010","0013","0000","1428","827","601","17","1445","3181","0","45.43","26.00"
"10","018","00","010","0013","0030","442","245","197","5","447","1017","0","43.95","24.09"
"10","018","00","010","0013","0031","507","319","188","5","512","1177","0","43.50","27.10"
"10","018","00","010","0013","0032","479","263","216","7","486","987","0","49.24","26.65"
"10","018","00","010","0014","0000","1250","582","668","19","1269","2794","0","45.42","20.83"
"10","018","00","010","0014","0132","370","176","194","3","373","829","0","44.99","21.23"
"10","018","00","010","0014","0133","429","185","244","11","440","934","0","47.11","19.81"
"10","018","00","010","0014","0134","451","221","230","5","456","1031","0","44.23","21.44"
"10","018","00","010","0015","0000","627","296","331","10","637","1360","0","46.84","21.76"
"10","018","00","010","0015","0135","287","127","160","2","289","589","0","49.07","21.56"
"10","018","00","010","0015","0136","340","169","171","8","348","771","0","45.14","21.92"
"10","018","00","010","0016","0000","2173","1187","986","26","2199","5451","0","40.34","21.78"
"10","018","00","010","0016","0122","474","224","250","4","478","1091","0","43.81","20.53"
"10","018","00","010","0016","0123","460","242","218","7","467","1113","0","41.96","21.74"
"10","018","00","010","0016","0124","450","270","180","10","460","1139","0","40.39","23.71"
"10","018","00","010","0016","0125","402","241","161","2","404","1091","0","37.03","22.09"
"10","018","00","010","0016","0126","387","210","177","3","390","1017","0","38.35","20.65"
"10","018","00","010","0017","0000","538","310","228","1","539","1058","0","50.95","29.30"
"10","018","00","010","0017","0002","538","310","228","1","539","1058","0","50.95","29.30"
"10","018","00","010","0018","0000","2021","1141","880","27","2048","4446","0","46.06","25.66"
"10","018","00","010","0018","0009","304","191","113","5","309","642","0","48.13","29.75"
"10","018","00","010","0018","0010","584","298","286","5","589","1260","0","46.75","23.65"
"10","018","00","010","0018","0011","570","341","229","12","582","1334","0","43.63","25.56"
"10","018","00","010","0018","0012","563","311","252","5","568","1210","0","46.94","25.70"
"10","018","00","010","0019","0000","1894","1079","815","21","1915","4120","0","46.48","26.19"
"10","018","00","010","0019","0013","453","287","166","5","458","959","0","47.76","29.93"
"10","018","00","010","0019","0014","476","299","177","5","481","980","0","49.08","30.51"
"10","018","00","010","0019","0015","535","280","255","5","540","1175","0","45.96","23.83"
"10","018","00","010","0019","0016","430","213","217","6","436","1006","0","43.34","21.17"
"10","018","00","010","0020","0000","2068","1073","995","15","2083","4584","0","45.44","23.41"
"10","018","00","010","0020","0021","435","229","206","4","439","1026","0","42.79","22.32"
"10","018","00","010","0020","0022","526","282","244","7","533","1225","0","43.51","23.02"
"10","018","00","010","0020","0023","522","265","257","2","524","1089","0","48.12","24.33"
"10","018","00","010","0020","0024","585","297","288","2","587","1244","0","47.19","23.87"
"10","018","00","010","0021","0000","2665","1450","1215","28","2693","5827","0","46.22","24.88"
"10","018","00","010","0021","0025","498","277","221","7","505","1139","0","44.34","24.32"
"10","018","00","010","0021","0026","591","324","267","4","595","1245","0","47.79","26.02"
"10","018","00","010","0021","0027","449","238","211","5","454","1127","0","40.28","21.12"
"10","018","00","010","0021","0028","548","321","227","5","553","1186","0","46.63","27.07"
"10","018","00","010","0021","0029","579","290","289","7","586","1130","0","51.86","25.66"
"10","018","00","010","0022","0000","1448","759","689","23","1471","3117","0","47.19","24.35"
"10","018","00","010","0022","0044","743","349","394","16","759","1651","0","45.97","21.14"
"10","018","00","010","0022","0045","705","410","295","7","712","1466","0","48.57","27.97"
"10","018","00","010","0023","0000","1311","683","628","19","1330","2796","0","47.57","24.43"
"10","018","00","010","0023","0046","415","191","224","9","424","955","0","44.40","20.00"
"10","018","00","010","0023","0047","424","219","205","4","428","877","0","48.80","24.97"
"10","018","00","010","0023","0048","472","273","199","6","478","964","0","49.59","28.32"
"10","018","00","010","0024","0000","2290","1371","919","22","2312","4392","0","52.64","31.22"
"10","018","00","010","0024","0057","634","349","285","7","641","1196","0","53.60","29.18"
"10","018","00","010","0024","0058","388","257","131","7","395","939","0","42.07","27.37"
"10","018","00","010","0024","0059","593","359","234","1","594","1103","0","53.85","32.55"
"10","018","00","010","0024","0060","675","406","269","7","682","1154","0","59.10","35.18"
"10","018","00","010","0025","0000","2040","1557","483","26","2066","3972","0","52.01","39.20"
"10","018","00","010","0025","0061","678","548","130","12","690","1319","0","52.31","41.55"
"10","018","00","010","0025","0062","688","529","159","11","699","1353","0","51.66","39.10"
"10","018","00","010","0025","0063","674","480","194","3","677","1300","0","52.08","36.92"
"10","018","00","010","0026","0000","2882","1688","1194","30","2912","6185","0","47.08","27.29"
"10","018","00","010","0026","0039","587","347","240","7","594","1306","0","45.48","26.57"
"10","018","00","010","0026","0040","545","340","205","7","552","1222","0","45.17","27.82"
"10","018","00","010","0026","0041","586","347","239","3","589","1220","0","48.28","28.44"
"10","018","00","010","0026","0042","614","345","269","5","619","1302","0","47.54","26.50"
"10","018","00","010","0026","0043","550","309","241","8","558","1135","0","49.16","27.22"
"10","018","00","010","0027","0000","1546","936","610","18","1564","3075","0","50.86","30.44"
"10","018","00","010","0027","0036","450","290","160","4","454","921","0","49.29","31.49"
"10","018","00","010","0027","0037","524","312","212","9","533","1066","0","50.00","29.27"
"10","018","00","010","0027","0038","572","334","238","5","577","1088","0","53.03","30.70"
"10","018","00","010","0028","0000","1512","803","709","17","1529","3537","0","43.23","22.70"
"10","018","00","010","0028","0140","419","220","199","6","425","1043","0","40.75","21.09"
"10","018","00","010","0028","0141","504","273","231","7","511","1047","0","48.81","26.07"
"10","018","00","010","0028","0142","589","310","279","4","593","1447","0","40.98","21.42"
"10","018","00","010","0029","0000","1336","674","662","19","1355","3009","0","45.03","22.40"
"10","018","00","010","0029","0127","417","189","228","6","423","882","0","47.96","21.43"
"10","018","00","010","0029","0128","449","244","205","6","455","1054","0","43.17","23.15"
"10","018","00","010","0029","0129","470","241","229","7","477","1073","0","44.45","22.46"
"10","018","00","010","0030","0000","2313","1280","1033","19","2332","5175","0","45.06","24.73"
"10","018","00","010","0030","0151","355","211","144","3","358","989","0","36.20","21.33"
"10","018","00","010","0030","0152","377","196","181","5","382","867","0","44.06","22.61"
"10","018","00","010","0030","0153","471","277","194","2","473","894","0","52.91","30.98"
"10","018","00","010","0030","0154","414","217","197","6","420","1082","0","38.82","20.06"
"10","018","00","010","0030","0155","696","379","317","3","699","1343","0","52.05","28.22"
"10","018","00","010","0031","0000","2453","1314","1139","24","2477","5610","0","44.15","23.42"
"10","018","00","010","0031","0143","574","267","307","5","579","1285","0","45.06","20.78"
"10","018","00","010","0031","0144","504","284","220","6","510","1080","0","47.22","26.30"
"10","018","00","010","0031","0145","420","241","179","9","429","1103","0","38.89","21.85"
"10","018","00","010","0031","0146","471","256","215","1","472","1099","0","42.95","23.29"
"10","018","00","010","0031","0147","484","266","218","3","487","1043","0","46.69","25.50"
"10","018","00","010","0032","0000","583","339","244","5","588","1240","0","47.42","27.34"
"10","018","00","010","0032","0116","583","339","244","5","588","1240","0","47.42","27.34"
"10","018","00","010","0033","0000","1456","941","515","25","1481","2932","0","50.51","32.09"
"10","018","00","010","0033","0072","485","343","142","10","495","1063","0","46.57","32.27"
"10","018","00","010","0033","0073","389","237","152","4","393","775","0","50.71","30.58"
"10","018","00","010","0033","0074","582","361","221","11","593","1094","0","54.20","33.00"
"10","018","00","010","0035","0000","413","318","95","4","417","887","0","47.01","35.85"
"10","018","00","010","0035","0067","413","318","95","4","417","887","0","47.01","35.85"
"10","018","00","010","0036","0000","1245","855","390","13","1258","2672","0","47.08","32.00"
"10","018","00","010","0036","0064","405","274","131","0","405","971","0","41.71","28.22"
"10","018","00","010","0036","0065","416","277","139","3","419","817","0","51.29","33.90"
"10","018","00","010","0036","0066","424","304","120","10","434","884","0","49.10","34.39"
"10","018","00","010","0037","0000","1960","1479","481","24","1984","3777","0","52.53","39.16"
"10","018","00","010","0037","0068","621","513","108","8","629","1168","0","53.85","43.92"
"10","018","00","010","0037","0069","387","276","111","9","396","802","0","49.38","34.41"
"10","018","00","010","0037","0070","383","310","73","2","385","663","0","58.07","46.76"
"10","018","00","010","0037","0071","569","380","189","5","574","1144","0","50.17","33.22"
"10","018","00","010","0038","0000","1132","546","586","17","1149","2728","0","42.12","20.01"
"10","018","00","010","0038","0049","405","196","209","4","409","936","0","43.70","20.94"
"10","018","00","010","0038","0050","385","197","188","8","393","946","0","41.54","20.82"
"10","018","00","010","0038","0051","342","153","189","5","347","846","0","41.02","18.09"
"10","018","00","010","0039","0000","1436","679","757","31","1467","3260","0","45.00","20.83"
"10","018","00","010","0039","0052","530","251","279","13","543","1277","0","42.52","19.66"
"10","018","00","010","0039","0053","481","253","228","13","494","1055","0","46.82","23.98"
"10","018","00","010","0039","0054","425","175","250","5","430","928","0","46.34","18.86"
"10","018","00","010","0040","0000","876","486","390","16","892","2117","0","42.14","22.96"
"10","018","00","010","0040","0055","445","216","229","14","459","1108","0","41.43","19.49"
"10","018","00","010","0040","0056","431","270","161","2","433","1009","0","42.91","26.76"
"10","018","00","010","0041","0000","2628","1360","1268","32","2660","6204","0","42.88","21.92"
"10","018","00","010","0041","0079","435","235","200","7","442","1033","0","42.79","22.75"
"10","018","00","010","0041","0090","516","276","240","10","526","1218","0","43.19","22.66"
"10","018","00","010","0041","0091","548","248","300","6","554","1367","0","40.53","18.14"
"10","018","00","010","0041","0092","551","304","247","5","556","1254","0","44.34","24.24"
"10","018","00","010","0041","0093","578","297","281","4","582","1332","0","43.69","22.30"
"10","018","00","010","0042","0000","4321","2379","1942","42","4363","9368","0","46.57","25.39"
"10","018","00","010","0042","0075","463","281","182","0","463","1038","0","44.61","27.07"
"10","018","00","010","0042","0076","559","286","273","5","564","1196","0","47.16","23.91"
"10","018","00","010","0042","0077","565","320","245","10","575","1203","0","47.80","26.60"
"10","018","00","010","0042","0078","791","423","368","5","796","1737","0","45.83","24.35"
"10","018","00","010","0042","0080","368","202","166","5","373","864","0","43.17","23.38"
"10","018","00","010","0042","0081","439","255","184","3","442","962","0","45.95","26.51"
"10","018","00","010","0042","0082","621","333","288","6","627","1386","0","45.24","24.03"
"10","018","00","010","0042","0083","515","279","236","8","523","982","0","53.26","28.41"
"10","018","00","010","0043","0000","2315","1342","973","26","2341","5305","0","44.13","25.30"
"10","018","00","010","0043","0094","469","268","201","9","478","1065","0","44.88","25.16"
"10","018","00","010","0043","0095","434","260","174","8","442","1006","0","43.94","25.84"
"10","018","00","010","0043","0096","489","279","210","4","493","1109","0","44.45","25.16"
"10","018","00","010","0043","0097","478","273","205","4","482","1126","0","42.81","24.25"
"10","018","00","010","0043","0098","445","262","183","1","446","999","0","44.64","26.23"
"10","018","00","010","0044","0000","1989","1157","832","24","2013","4355","0","46.22","26.57"
"10","018","00","010","0044","0112","443","253","190","3","446","1165","0","38.28","21.72"
"10","018","00","010","0044","0113","539","296","243","7","546","1079","0","50.60","27.43"
"10","018","00","010","0044","0114","450","249","201","5","455","950","0","47.89","26.21"
"10","018","00","010","0044","0115","557","359","198","9","566","1161","0","48.75","30.92"
"10","018","00","010","0045","0000","2145","1337","808","20","2165","5215","0","41.51","25.64"
"10","018","00","010","0045","0107","416","281","135","8","424","1102","0","38.48","25.50"
"10","018","00","010","0045","0108","490","299","191","6","496","1204","0","41.20","24.83"
"10","018","00","010","0045","0109","416","257","159","1","417","1031","0","40.45","24.93"
"10","018","00","010","0045","0110","351","236","115","2","353","936","0","37.71","25.21"
"10","018","00","010","0045","0111","472","264","208","3","475","942","0","50.42","28.03"
"10","018","00","010","0046","0000","1955","1196","759","24","1979","4835","0","40.93","24.74"
"10","018","00","010","0046","0103","396","252","144","7","403","1117","0","36.08","22.56"
"10","018","00","010","0046","0104","527","334","193","7","534","1299","0","41.11","25.71"
"10","018","00","010","0046","0105","469","272","197","4","473","1175","0","40.26","23.15"
"10","018","00","010","0046","0106","563","338","225","6","569","1244","0","45.74","27.17"
"10","018","00","010","0047","0000","3215","1954","1261","35","3250","6299","0","51.60","31.02"
"10","018","00","010","0047","0084","513","320","193","9","522","1057","0","49.39","30.27"
"10","018","00","010","0047","0085","476","292","184","3","479","1003","0","47.76","29.11"
"10","018","00","010","0047","0086","539","320","219","6","545","1038","0","52.50","30.83"
"10","018","00","010","0047","0087","588","353","235","8","596","1142","0","52.19","30.91"
"10","018","00","010","0047","0088","463","269","194","7","470","900","0","52.22","29.89"
"10","018","00","010","0047","0089","636","400","236","2","638","1159","0","55.05","34.51"
"10","018","00","010","0048","0000","1059","563","496","15","1074","2356","0","45.59","23.90"
"10","018","00","010","0048","0033","338","169","169","8","346","764","0","45.29","22.12"
"10","018","00","010","0048","0034","354","198","156","2","356","790","0","45.06","25.06"
"10","018","00","010","0048","0035","367","196","171","5","372","802","0","46.38","24.44"
"10","018","00","010","0049","0000","1439","738","701","23","1462","3398","0","43.03","21.72"
"10","018","00","010","0049","0137","473","270","203","6","479","1080","0","44.35","25.00"
"10","018","00","010","0049","0138","449","216","233","9","458","1094","0","41.86","19.74"
"10","018","00","010","0049","0139","517","252","265","8","525","1224","0","42.89","20.59"
"10","018","00","010","0050","0000","2145","1186","959","29","2174","4960","0","43.83","23.91"
"10","018","00","010","0050","0017","507","259","248","9","516","1250","0","41.28","20.72"
"10","018","00","010","0050","0018","505","291","214","6","511","1254","0","40.75","23.21"
"10","018","00","010","0050","0019","580","318","262","7","587","1297","0","45.26","24.52"
"10","018","00","010","0050","0020","553","318","235","7","560","1159","0","48.32","27.44"
"10","018","00","010","0051","0000","848","504","344","9","857","1881","0","45.56","26.79"
"10","018","00","010","0051","0007","319","202","117","3","322","756","0","42.59","26.72"
"10","018","00","010","0051","0008","529","302","227","6","535","1125","0","47.56","26.84"
"10","018","00","010","0052","0000","1633","904","729","15","1648","3466","0","47.55","26.08"
"10","018","00","010","0052","0148","546","324","222","6","552","1196","0","46.15","27.09"
"10","018","00","010","0052","0149","566","310","256","4","570","1279","0","44.57","24.24"
"10","018","00","010","0052","0150","521","270","251","5","526","991","0","53.08","27.25"
"10","018","00","010","0053","0000","1756","1036","720","18","1774","4931","0","35.98","21.01"
"10","018","00","010","0053","0156","391","215","176","2","393","995","0","39.50","21.61"
"10","018","00","010","0053","0157","281","163","118","4","285","931","0","30.61","17.51"
"10","018","00","010","0053","0158","353","227","126","1","354","954","0","37.11","23.79"
"10","018","00","010","0053","0159","397","226","171","5","402","1162","0","34.60","19.45"
"10","018","00","010","0053","0160","334","205","129","6","340","889","0","38.25","23.06"
"10","018","00","010","0054","0000","1921","981","940","16","1937","3964","0","48.86","24.75"
"10","018","00","010","0054","0099","453","247","206","6","459","998","0","45.99","24.75"
"10","018","00","010","0054","0100","454","233","221","3","457","890","0","51.35","26.18"
"10","018","00","010","0054","0101","518","259","259","2","520","1041","0","49.95","24.88"
"10","018","00","010","0054","0102","496","242","254","5","501","1035","0","48.41","23.38"
"10","018","00","010","0055","0000","429","244","185","4","433","958","0","45.20","25.47"
"10","018","00","010","0055","0003","429","244","185","4","433","958","0","45.20","25.47"
"10","018","00","010","0056","0000","530","256","274","9","539","1175","0","45.87","21.79"
"10","018","00","010","0056","0131","530","256","274","9","539","1175","0","45.87","21.79"
"10","018","00","020","0000","0000","52995","28126","24869","681","53676","125506","152490","42.77","22.41"
"10","018","00","020","0001","0000","252","133","119","3","255","555","0","45.95","23.96"
"10","018","00","020","0001","0161","252","133","119","3","255","555","0","45.95","23.96"
"10","018","00","020","0002","0000","318","136","182","3","321","728","0","44.09","18.68"
"10","018","00","020","0002","0165","318","136","182","3","321","728","0","44.09","18.68"
"10","018","00","020","0003","0000","330","143","187","6","336","743","0","45.22","19.25"
"10","018","00","020","0003","0163","330","143","187","6","336","743","0","45.22","19.25"
"10","018","00","020","0004","0000","197","76","121","1","198","464","0","42.67","16.38"
"10","018","00","020","0004","0162","197","76","121","1","198","464","0","42.67","16.38"
"10","018","00","020","0005","0000","472","194","278","6","478","1063","0","44.97","18.25"
"10","018","00","020","0005","0166","472","194","278","6","478","1063","0","44.97","18.25"
"10","018","00","020","0007","0000","524","248","276","12","536","1170","0","45.81","21.20"
"10","018","00","020","0007","0167","524","248","276","12","536","1170","0","45.81","21.20"
"10","018","00","020","0008","0000","442","206","236","3","445","975","0","45.64","21.13"
"10","018","00","020","0008","0197","442","206","236","3","445","975","0","45.64","21.13"
"10","018","00","020","0009","0000","407","197","210","3","410","867","0","47.29","22.72"
"10","018","00","020","0009","0192","407","197","210","3","410","867","0","47.29","22.72"
"10","018","00","020","0010","0000","381","212","169","5","386","775","0","49.81","27.35"
"10","018","00","020","0010","0190","381","212","169","5","386","775","0","49.81","27.35"
"10","018","00","020","0011","0000","378","157","221","4","382","826","0","46.25","19.01"
"10","018","00","020","0011","0191","378","157","221","4","382","826","0","46.25","19.01"
"10","018","00","020","0012","0000","600","274","326","4","604","1365","0","44.25","20.07"
"10","018","00","020","0012","0195","365","163","202","2","367","793","0","46.28","20.55"
"10","018","00","020","0012","0196","235","111","124","2","237","572","0","41.43","19.41"
"10","018","00","020","0013","0000","678","319","359","8","686","1599","0","42.90","19.95"
"10","018","00","020","0013","0193","423","198","225","4","427","936","0","45.62","21.15"
"10","018","00","020","0013","0194","255","121","134","4","259","663","0","39.06","18.25"
"10","018","00","020","0014","0000","1898","903","995","21","1919","4837","0","39.67","18.67"
"10","018","00","020","0014","0198","495","239","256","2","497","1227","0","40.51","19.48"
"10","018","00","020","0014","0199","551","295","256","7","558","1261","0","44.25","23.39"
"10","018","00","020","0014","0200","399","176","223","6","405","1199","0","33.78","14.68"
"10","018","00","020","0014","0201","453","193","260","6","459","1150","0","39.91","16.78"
"10","018","00","020","0015","0000","1344","711","633","11","1355","3018","0","44.90","23.56"
"10","018","00","020","0015","0215","467","255","212","5","472","1007","0","46.87","25.32"
"10","018","00","020","0015","0216","437","228","209","2","439","1010","0","43.47","22.57"
"10","018","00","020","0015","0217","440","228","212","4","444","1001","0","44.36","22.78"
"10","018","00","020","0016","0000","1774","916","858","31","1805","4021","0","44.89","22.78"
"10","018","00","020","0016","0211","468","215","253","8","476","1113","0","42.77","19.32"
"10","018","00","020","0016","0212","460","251","209","9","469","1042","0","45.01","24.09"
"10","018","00","020","0016","0213","450","247","203","6","456","949","0","48.05","26.03"
"10","018","00","020","0016","0214","396","203","193","8","404","917","0","44.06","22.14"
"10","018","00","020","0017","0000","949","528","421","16","965","2080","0","46.39","25.38"
"10","018","00","020","0017","0218","532","289","243","11","543","1129","0","48.10","25.60"
"10","018","00","020","0017","0219","417","239","178","5","422","951","0","44.37","25.13"
"10","018","00","020","0018","0000","791","351","440","11","802","1845","0","43.47","19.02"
"10","018","00","020","0018","0262","516","241","275","7","523","1219","0","42.90","19.77"
"10","018","00","020","0018","0263","275","110","165","4","279","626","0","44.57","17.57"
"10","018","00","020","0019","0000","1719","1026","693","17","1736","3780","0","45.93","27.14"
"10","018","00","020","0019","0254","521","298","223","5","526","1156","0","45.50","25.78"
"10","018","00","020","0019","0255","552","335","217","7","559","1180","0","47.37","28.39"
"10","018","00","020","0019","0256","331","212","119","3","334","722","0","46.26","29.36"
"10","018","00","020","0019","0257","315","181","134","2","317","722","0","43.91","25.07"
"10","018","00","020","0020","0000","351","143","208","10","361","837","0","43.13","17.08"
"10","018","00","020","0020","0264","351","143","208","10","361","837","0","43.13","17.08"
"10","018","00","020","0021","0000","1282","696","586","21","1303","2741","0","47.54","25.39"
"10","018","00","020","0021","0228","384","218","166","6","390","841","0","46.37","25.92"
"10","018","00","020","0021","0229","439","229","210","9","448","886","0","50.56","25.85"
"10","018","00","020","0021","0230","459","249","210","6","465","1014","0","45.86","24.56"
"10","018","00","020","0022","0000","2615","1421","1194","38","2653","5956","0","44.54","23.86"
"10","018","00","020","0022","0239","402","221","181","6","408","869","0","46.95","25.43"
"10","018","00","020","0022","0240","352","198","154","12","364","847","0","42.98","23.38"
"10","018","00","020","0022","0241","402","224","178","6","408","863","0","47.28","25.96"
"10","018","00","020","0022","0242","378","203","175","3","381","967","0","39.40","20.99"
"10","018","00","020","0022","0243","487","245","242","6","493","1166","0","42.28","21.01"
"10","018","00","020","0022","0244","594","330","264","5","599","1244","0","48.15","26.53"
"10","018","00","020","0023","0000","2137","1719","418","22","2159","4508","0","47.89","38.13"
"10","018","00","020","0023","0250","508","415","93","6","514","1085","0","47.37","38.25"
"10","018","00","020","0023","0251","506","419","87","2","508","1122","0","45.28","37.34"
"10","018","00","020","0023","0252","581","451","130","3","584","1208","0","48.34","37.33"
"10","018","00","020","0023","0253","542","434","108","11","553","1093","0","50.59","39.71"
"10","018","00","020","0024","0000","2006","1057","949","32","2038","5777","0","35.28","18.30"
"10","018","00","020","0024","0265","505","258","247","7","512","1307","0","39.17","19.74"
"10","018","00","020","0024","0266","433","257","176","11","444","1220","0","36.39","21.07"
"10","018","00","020","0024","0267","395","192","203","5","400","1169","0","34.22","16.42"
"10","018","00","020","0024","0268","314","171","143","2","316","953","0","33.16","17.94"
"10","018","00","020","0024","0269","359","179","180","7","366","1128","0","32.45","15.87"
"10","018","00","020","0025","0000","224","119","105","3","227","574","0","39.55","20.73"
"10","018","00","020","0025","0282","224","119","105","3","227","574","0","39.55","20.73"
"10","018","00","020","0026","0000","1198","594","604","18","1216","2946","0","41.28","20.16"
"10","018","00","020","0026","0270","307","161","146","8","315","750","0","42.00","21.47"
"10","018","00","020","0026","0271","507","256","251","2","509","1282","0","39.70","19.97"
"10","018","00","020","0026","0272","384","177","207","8","392","914","0","42.89","19.37"
"10","018","00","020","0027","0000","747","329","418","12","759","1982","0","38.29","16.60"
"10","018","00","020","0027","0280","313","131","182","5","318","845","0","37.63","15.50"
"10","018","00","020","0027","0281","434","198","236","7","441","1137","0","38.79","17.41"
"10","018","00","020","0028","0000","1364","708","656","14","1378","3687","0","37.37","19.20"
"10","018","00","020","0028","0273","412","221","191","0","412","1093","0","37.69","20.22"
"10","018","00","020","0028","0274","507","240","267","8","515","1419","0","36.29","16.91"
"10","018","00","020","0028","0275","445","247","198","6","451","1175","0","38.38","21.02"
"10","018","00","020","0029","0000","1422","750","672","19","1441","4195","0","34.35","17.88"
"10","018","00","020","0029","0276","348","173","175","10","358","1068","0","33.52","16.20"
"10","018","00","020","0029","0277","333","206","127","1","334","875","0","38.17","23.54"
"10","018","00","020","0029","0278","371","195","176","5","376","1078","0","34.88","18.09"
"10","018","00","020","0029","0279","370","176","194","3","373","1174","0","31.77","14.99"
"10","018","00","020","0030","0000","704","356","348","2","706","1590","0","44.40","22.39"
"10","018","00","020","0030","0181","440","212","228","2","442","972","0","45.47","21.81"
"10","018","00","020","0030","0182","264","144","120","0","264","618","0","42.72","23.30"
"10","018","00","020","0031","0000","1498","731","767","14","1512","3409","0","44.35","21.44"
"10","018","00","020","0031","0168","459","229","230","4","463","1145","0","40.44","20.00"
"10","018","00","020","0031","0169","525","264","261","5","530","1104","0","48.01","23.91"
"10","018","00","020","0031","0170","514","238","276","5","519","1160","0","44.74","20.52"
"10","018","00","020","0032","0000","1991","1067","924","20","2011","5102","0","39.42","20.91"
"10","018","00","020","0032","0173","334","200","134","6","340","938","0","36.25","21.32"
"10","018","00","020","0032","0174","515","278","237","5","520","1165","0","44.64","23.86"
"10","018","00","020","0032","0175","359","202","157","3","362","1087","0","33.30","18.58"
"10","018","00","020","0032","0176","260","152","108","2","262","735","0","35.65","20.68"
"10","018","00","020","0032","0177","523","235","288","4","527","1177","0","44.77","19.97"
"10","018","00","020","0033","0000","1201","540","661","17","1218","2825","0","43.12","19.12"
"10","018","00","020","0033","0178","401","175","226","5","406","984","0","41.26","17.78"
"10","018","00","020","0033","0179","373","159","214","5","378","903","0","41.86","17.61"
"10","018","00","020","0033","0180","427","206","221","7","434","938","0","46.27","21.96"
"10","018","00","020","0034","0000","1500","618","882","20","1520","3409","0","44.59","18.13"
"10","018","00","020","0034","0186","487","217","270","11","498","1086","0","45.86","19.98"
"10","018","00","020","0034","0187","447","175","272","5","452","1103","0","40.98","15.87"
"10","018","00","020","0034","0188","566","226","340","4","570","1220","0","46.72","18.52"
"10","018","00","020","0036","0000","2110","1121","989","28","2138","4668","0","45.80","24.01"
"10","018","00","020","0036","0258","497","251","246","4","501","1052","0","47.62","23.86"
"10","018","00","020","0036","0259","514","270","244","14","528","1140","0","46.32","23.68"
"10","018","00","020","0036","0260","569","302","267","8","577","1209","0","47.73","24.98"
"10","018","00","020","0036","0261","530","298","232","2","532","1267","0","41.99","23.52"
"10","018","00","020","0037","0000","2314","1145","1169","30","2344","5381","0","43.56","21.28"
"10","018","00","020","0037","0202","442","214","228","5","447","1048","0","42.65","20.42"
"10","018","00","020","0037","0203","458","202","256","4","462","1019","0","45.34","19.82"
"10","018","00","020","0037","0204","479","245","234","5","484","1106","0","43.76","22.15"
"10","018","00","020","0037","0205","500","273","227","8","508","1188","0","42.76","22.98"
"10","018","00","020","0037","0206","435","211","224","8","443","1020","0","43.43","20.69"
"10","018","00","020","0038","0000","1654","795","859","30","1684","4426","0","38.05","17.96"
"10","018","00","020","0038","0207","416","195","221","9","425","1145","0","37.12","17.03"
"10","018","00","020","0038","0208","397","206","191","13","410","1074","0","38.18","19.18"
"10","018","00","020","0038","0209","417","174","243","1","418","1141","0","36.63","15.25"
"10","018","00","020","0038","0210","424","220","204","7","431","1066","0","40.43","20.64"
"10","018","00","020","0039","0000","1495","820","675","13","1508","4165","0","36.21","19.69"
"10","018","00","020","0039","0220","241","135","106","1","242","1264","0","19.15","10.68"
"10","018","00","020","0039","0221","424","219","205","2","426","887","0","48.03","24.69"
"10","018","00","020","0039","0222","402","231","171","5","407","1031","0","39.48","22.41"
"10","018","00","020","0039","0223","428","235","193","5","433","983","0","44.05","23.91"
"10","018","00","020","0040","0000","2186","1184","1002","22","2208","4801","0","45.99","24.66"
"10","018","00","020","0040","0224","474","245","229","3","477","1165","0","40.94","21.03"
"10","018","00","020","0040","0225","561","295","266","8","569","1221","0","46.60","24.16"
"10","018","00","020","0040","0226","567","298","269","5","572","1127","0","50.75","26.44"
"10","018","00","020","0040","0227","584","346","238","6","590","1288","0","45.81","26.86"
"10","018","00","020","0041","0000","2416","1374","1042","19","2435","5732","0","42.48","23.97"
"10","018","00","020","0041","0245","469","243","226","0","469","1175","0","39.91","20.68"
"10","018","00","020","0041","0246","475","269","206","2","477","1166","0","40.91","23.07"
"10","018","00","020","0041","0247","485","294","191","7","492","1124","0","43.77","26.16"
"10","018","00","020","0041","0248","524","303","221","2","526","1182","0","44.50","25.63"
"10","018","00","020","0041","0249","463","265","198","8","471","1085","0","43.41","24.42"
"10","018","00","020","0042","0000","2962","1732","1230","40","3002","6577","0","45.64","26.33"
"10","018","00","020","0042","0233","498","242","256","5","503","1166","0","43.14","20.75"
"10","018","00","020","0042","0234","431","243","188","7","438","1040","0","42.12","23.37"
"10","018","00","020","0042","0235","504","302","202","11","515","1087","0","47.38","27.78"
"10","018","00","020","0042","0236","478","294","184","3","481","1041","0","46.21","28.24"
"10","018","00","020","0042","0237","509","311","198","6","515","1118","0","46.06","27.82"
"10","018","00","020","0042","0238","542","340","202","8","550","1125","0","48.89","30.22"
"10","018","00","020","0043","0000","1312","677","635","24","1336","2938","0","45.47","23.04"
"10","018","00","020","0043","0231","641","298","343","11","652","1461","0","44.63","20.40"
"10","018","00","020","0043","0232","671","379","292","13","684","1477","0","46.31","25.66"
"10","018","00","020","0044","0000","598","314","284","10","608","1564","0","38.87","20.08"
"10","018","00","020","0044","0171","306","165","141","5","311","829","0","37.52","19.90"
"10","018","00","020","0044","0172","292","149","143","5","297","735","0","40.41","20.27"
"10","018","00","020","0045","0000","1552","1058","494","28","1580","3326","0","47.50","31.81"
"10","018","00","020","0045","0183","626","509","117","5","631","1219","0","51.76","41.76"
"10","018","00","020","0045","0184","441","248","193","14","455","1113","0","40.88","22.28"
"10","018","00","020","0045","0185","485","301","184","9","494","994","0","49.70","30.28"
"10","018","00","020","0046","0000","338","153","185","4","342","684","0","50.00","22.37"
"10","018","00","020","0046","0164","338","153","185","4","342","684","0","50.00","22.37"
"10","018","00","020","0047","0000","364","175","189","6","370","995","0","37.19","17.59"
"10","018","00","020","0047","0189","364","175","189","6","370","995","0","37.19","17.59"
"10","018","00","030","0000","0000","25595","12732","12863","369","25964","66397","78776","39.10","19.18"
"10","018","00","030","0001","0000","1045","409","636","13","1058","2715","0","38.97","15.06"
"10","018","00","030","0001","0313","330","125","205","8","338","857","0","39.44","14.59"
"10","018","00","030","0001","0314","371","153","218","2","373","930","0","40.11","16.45"
"10","018","00","030","0001","0315","344","131","213","3","347","928","0","37.39","14.12"
"10","018","00","030","0002","0000","2067","926","1141","38","2105","5496","0","38.30","16.85"
"10","018","00","030","0002","0308","357","163","194","8","365","1057","0","34.53","15.42"
"10","018","00","030","0002","0309","341","153","188","9","350","925","0","37.84","16.54"
"10","018","00","030","0002","0310","470","224","246","5","475","1310","0","36.26","17.10"
"10","018","00","030","0002","0311","381","167","214","6","387","982","0","39.41","17.01"
"10","018","00","030","0002","0312","518","219","299","10","528","1222","0","43.21","17.92"
"10","018","00","030","0003","0000","903","449","454","11","914","2275","0","40.18","19.74"
"10","018","00","030","0003","0306","356","187","169","4","360","935","0","38.50","20.00"
"10","018","00","030","0003","0307","547","262","285","7","554","1340","0","41.34","19.55"
"10","018","00","030","0004","0000","827","355","472","8","835","2355","0","35.46","15.07"
"10","018","00","030","0004","0304","405","188","217","5","410","1212","0","33.83","15.51"
"10","018","00","030","0004","0305","422","167","255","3","425","1143","0","37.18","14.61"
"10","018","00","030","0005","0000","906","335","571","15","921","2096","0","43.94","15.98"
"10","018","00","030","0005","0302","469","160","309","7","476","1143","0","41.64","14.00"
"10","018","00","030","0005","0303","437","175","262","8","445","953","0","46.69","18.36"
"10","018","00","030","0006","0000","1305","596","709","19","1324","3186","0","41.56","18.71"
"10","018","00","030","0006","0299","448","219","229","4","452","1122","0","40.29","19.52"
"10","018","00","030","0006","0300","369","181","188","8","377","862","0","43.74","21.00"
"10","018","00","030","0006","0301","488","196","292","7","495","1202","0","41.18","16.31"
"10","018","00","030","0007","0000","1277","648","629","15","1292","2869","0","45.03","22.59"
"10","018","00","030","0007","0292","422","198","224","5","427","892","0","47.87","22.20"
"10","018","00","030","0007","0293","468","241","227","6","474","1093","0","43.37","22.05"
"10","018","00","030","0007","0294","387","209","178","4","391","884","0","44.23","23.64"
"10","018","00","030","0008","0000","1723","894","829","18","1741","4595","0","37.89","19.46"
"10","018","00","030","0008","0295","464","214","250","5","469","1134","0","41.36","18.87"
"10","018","00","030","0008","0296","410","203","207","4","414","1141","0","36.28","17.79"
"10","018","00","030","0008","0297","380","211","169","3","383","1182","0","32.40","17.85"
"10","018","00","030","0008","0298","469","266","203","6","475","1138","0","41.74","23.37"
"10","018","00","030","0009","0000","1965","1037","928","16","1981","5017","0","39.49","20.67"
"10","018","00","030","0009","0283","434","216","218","5","439","990","0","44.34","21.82"
"10","018","00","030","0009","0284","355","179","176","4","359","943","0","38.07","18.98"
"10","018","00","030","0009","0285","345","191","154","2","347","968","0","35.85","19.73"
"10","018","00","030","0009","0286","419","216","203","4","423","1030","0","41.07","20.97"
"10","018","00","030","0009","0287","412","235","177","1","413","1086","0","38.03","21.64"
"10","018","00","030","0010","0000","1812","1064","748","25","1837","4051","0","45.35","26.27"
"10","018","00","030","0010","0316","324","185","139","8","332","815","0","40.74","22.70"
"10","018","00","030","0010","0317","553","336","217","8","561","1053","0","53.28","31.91"
"10","018","00","030","0010","0318","379","230","149","1","380","951","0","39.96","24.19"
"10","018","00","030","0010","0319","556","313","243","8","564","1232","0","45.78","25.41"
"10","018","00","030","0011","0000","1408","786","622","19","1427","3559","0","40.10","22.08"
"10","018","00","030","0011","0320","421","213","208","8","429","1215","0","35.31","17.53"
"10","018","00","030","0011","0321","469","251","218","6","475","1156","0","41.09","21.71"
"10","018","00","030","0011","0322","518","322","196","5","523","1188","0","44.02","27.10"
"10","018","00","030","0012","0000","1578","798","780","21","1599","4357","0","36.70","18.32"
"10","018","00","030","0012","0323","439","217","222","2","441","1176","0","37.50","18.45"
"10","018","00","030","0012","0324","368","167","201","7","375","1025","0","36.59","16.29"
"10","018","00","030","0012","0325","390","208","182","7","397","1146","0","34.64","18.15"
"10","018","00","030","0012","0326","381","206","175","5","386","1010","0","38.22","20.40"
"10","018","00","030","0013","0000","1059","470","589","23","1082","2843","0","38.06","16.53"
"10","018","00","030","0013","0327","432","191","241","10","442","1042","0","42.42","18.33"
"10","018","00","030","0013","0328","334","146","188","5","339","897","0","37.79","16.28"
"10","018","00","030","0013","0329","293","133","160","8","301","904","0","33.30","14.71"
"10","018","00","030","0014","0000","426","170","256","10","436","1121","0","38.89","15.17"
"10","018","00","030","0014","0330","426","170","256","10","436","1121","0","38.89","15.17"
"10","018","00","030","0015","0000","773","375","398","10","783","2151","0","36.40","17.43"
"10","018","00","030","0015","0331","408","211","197","5","413","1131","0","36.52","18.66"
"10","018","00","030","0015","0332","365","164","201","5","370","1020","0","36.27","16.08"
"10","018","00","030","0016","0000","875","466","409","15","890","2366","0","37.62","19.70"
"10","018","00","030","0016","0333","404","191","213","8","412","1245","0","33.09","15.34"
"10","018","00","030","0016","0334","471","275","196","7","478","1121","0","42.64","24.53"
"10","018","00","030","0017","0000","273","146","127","4","277","924","0","29.98","15.80"
"10","018","00","030","0017","0346","273","146","127","4","277","924","0","29.98","15.80"
"10","018","00","030","0018","0000","327","163","164","6","333","862","0","38.63","18.91"
"10","018","00","030","0018","0345","327","163","164","6","333","862","0","38.63","18.91"
"10","018","00","030","0019","0000","296","173","123","7","303","770","0","39.35","22.47"
"10","018","00","030","0019","0344","296","173","123","7","303","770","0","39.35","22.47"
"10","018","00","030","0020","0000","624","362","262","12","636","1828","0","34.79","19.80"
"10","018","00","030","0020","0342","274","155","119","2","276","718","0","38.44","21.59"
"10","018","00","030","0020","0343","350","207","143","10","360","1110","0","32.43","18.65"
"10","018","00","030","0021","0000","1480","741","739","24","1504","4280","0","35.14","17.31"
"10","018","00","030","0021","0337","428","252","176","3","431","1083","0","39.80","23.27"
"10","018","00","030","0021","0338","291","150","141","3","294","974","0","30.18","15.40"
"10","018","00","030","0021","0339","425","180","245","9","434","1239","0","35.03","14.53"
"10","018","00","030","0021","0340","336","159","177","9","345","984","0","35.06","16.16"
"10","018","00","030","0022","0000","553","266","287","6","559","1479","0","37.80","17.99"
"10","018","00","030","0022","0335","326","166","160","5","331","863","0","38.35","19.24"
"10","018","00","030","0022","0336","227","100","127","1","228","616","0","37.01","16.23"
"10","018","00","030","0023","0000","333","145","188","8","341","792","0","43.06","18.31"
"10","018","00","030","0023","0341","333","145","188","8","341","792","0","43.06","18.31"
"10","018","00","030","0024","0000","1760","958","802","26","1786","4410","0","40.50","21.72"
"10","018","00","030","0024","0288","333","167","166","11","344","789","0","43.60","21.17"
"10","018","00","030","0024","0289","502","267","235","5","507","1240","0","40.89","21.53"
"10","018","00","030","0024","0290","494","289","205","6","500","1222","0","40.92","23.65"
"10","018","00","030","0024","0291","431","235","196","4","435","1159","0","37.53","20.28"
"10","020","00","000","0000","0000","92236","41488","50748","696","92932","221038","264721","42.04","18.77"
"10","020","00","010","0000","0000","42411","20005","22406","302","42713","100157","119170","42.65","19.97"
"10","020","00","010","0001","0000","1754","741","1013","6","1760","4525","0","38.90","16.38"
"10","020","00","010","0001","0086","528","156","372","4","532","1289","0","41.27","12.10"
"10","020","00","010","0001","0087","386","182","204","2","388","983","0","39.47","18.51"
"10","020","00","010","0001","0088","406","199","207","0","406","1142","0","35.55","17.43"
"10","020","00","010","0001","0089","434","204","230","0","434","1111","0","39.06","18.36"
"10","020","00","010","0002","0000","1365","596","769","9","1374","3379","0","40.66","17.64"
"10","020","00","010","0002","0083","442","189","253","6","448","1094","0","40.95","17.28"
"10","020","00","010","0002","0084","504","226","278","3","507","1209","0","41.94","18.69"
"10","020","00","010","0002","0085","419","181","238","0","419","1076","0","38.94","16.82"
"10","020","00","010","0003","0000","1184","555","629","5","1189","2803","0","42.42","19.80"
"10","020","00","010","0003","0081","571","255","316","2","573","1364","0","42.01","18.70"
"10","020","00","010","0003","0082","613","300","313","3","616","1439","0","42.81","20.85"
"10","020","00","010","0004","0000","1317","627","690","11","1328","3208","0","41.40","19.54"
"10","020","00","010","0004","0074","383","177","206","2","385","1014","0","37.97","17.46"
"10","020","00","010","0004","0075","499","251","248","4","503","1128","0","44.59","22.25"
"10","020","00","010","0004","0076","435","199","236","5","440","1066","0","41.28","18.67"
"10","020","00","010","0005","0000","903","470","433","5","908","2125","0","42.73","22.12"
"10","020","00","010","0005","0077","481","241","240","4","485","1177","0","41.21","20.48"
"10","020","00","010","0005","0078","422","229","193","1","423","948","0","44.62","24.16"
"10","020","00","010","0034","0000","1768","987","781","14","1782","4239","0","42.04","23.28"
"10","020","00","010","0034","0024","480","308","172","7","487","1231","0","39.56","25.02"
"10","020","00","010","0034","0025","556","327","229","3","559","1270","0","44.02","25.75"
"10","020","00","010","0034","0026","357","179","178","2","359","861","0","41.70","20.79"
"10","020","00","010","0034","0027","375","173","202","2","377","877","0","42.99","19.73"
"10","020","00","010","0035","0000","1847","936","911","18","1865","4140","0","45.05","22.61"
"10","020","00","010","0035","0020","479","228","251","5","484","1062","0","45.57","21.47"
"10","020","00","010","0035","0021","489","261","228","6","495","1170","0","42.31","22.31"
"10","020","00","010","0035","0022","423","220","203","0","423","907","0","46.64","24.26"
"10","020","00","010","0035","0023","456","227","229","7","463","1001","0","46.25","22.68"
"10","020","00","010","0036","0000","1698","875","823","11","1709","3945","0","43.32","22.18"
"10","020","00","010","0036","0017","553","242","311","8","561","1433","0","39.15","16.89"
"10","020","00","010","0036","0018","512","263","249","1","513","1055","0","48.63","24.93"
"10","020","00","010","0036","0019","633","370","263","2","635","1457","0","43.58","25.39"
"10","020","00","010","0037","0000","1054","539","515","10","1064","2249","0","47.31","23.97"
"10","020","00","010","0037","0013","533","270","263","6","539","1144","0","47.12","23.60"
"10","020","00","010","0037","0014","521","269","252","4","525","1105","0","47.51","24.34"
"10","020","00","010","0038","0000","805","434","371","4","809","1740","0","46.49","24.94"
"10","020","00","010","0038","0005","340","185","155","2","342","683","0","50.07","27.09"
"10","020","00","010","0038","0006","465","249","216","2","467","1057","0","44.18","23.56"
"10","020","00","010","0039","0000","1784","930","854","8","1792","4209","0","42.58","22.10"
"10","020","00","010","0039","0030","578","327","251","3","581","1472","0","39.47","22.21"
"10","020","00","010","0039","0031","612","312","300","4","616","1352","0","45.56","23.08"
"10","020","00","010","0039","0032","594","291","303","1","595","1385","0","42.96","21.01"
"10","020","00","010","0041","0000","803","383","420","5","808","1933","0","41.80","19.81"
"10","020","00","010","0041","0008","370","173","197","2","372","923","0","40.30","18.74"
"10","020","00","010","0041","0009","433","210","223","3","436","1010","0","43.17","20.79"
"10","020","00","010","0042","0000","382","175","207","0","382","1058","0","36.11","16.54"
"10","020","00","010","0042","0007","382","175","207","0","382","1058","0","36.11","16.54"
"10","020","00","010","0043","0000","1296","630","666","7","1303","2882","0","45.21","21.86"
"10","020","00","010","0043","0015","669","324","345","3","672","1496","0","44.92","21.66"
"10","020","00","010","0043","0016","627","306","321","4","631","1386","0","45.53","22.08"
"10","020","00","010","0044","0000","1080","556","524","9","1089","2346","0","46.42","23.70"
"10","020","00","010","0044","0001","455","220","235","4","459","1021","0","44.96","21.55"
"10","020","00","010","0044","0002","625","336","289","5","630","1325","0","47.55","25.36"
"10","020","00","010","0045","0000","854","412","442","4","858","1953","0","43.93","21.10"
"10","020","00","010","0045","0045","375","186","189","2","377","895","0","42.12","20.78"
"10","020","00","010","0045","0046","479","226","253","2","481","1058","0","45.46","21.36"
"10","020","00","010","0046","0000","491","204","287","6","497","1241","0","40.05","16.44"
"10","020","00","010","0046","0047","491","204","287","6","497","1241","0","40.05","16.44"
"10","020","00","010","0047","0000","637","229","408","5","642","1578","0","40.68","14.51"
"10","020","00","010","0047","0048","365","129","236","2","367","804","0","45.65","16.04"
"10","020","00","010","0047","0049","272","100","172","3","275","774","0","35.53","12.92"
"10","020","00","010","0048","0000","519","217","302","1","520","1231","0","42.24","17.63"
"10","020","00","010","0048","0050","519","217","302","1","520","1231","0","42.24","17.63"
"10","020","00","010","0049","0000","1296","576","720","14","1310","3435","0","38.14","16.77"
"10","020","00","010","0049","0051","431","174","257","5","436","1031","0","42.29","16.88"
"10","020","00","010","0049","0052","437","218","219","3","440","1306","0","33.69","16.69"
"10","020","00","010","0049","0053","428","184","244","6","434","1098","0","39.53","16.76"
"10","020","00","010","0050","0000","943","428","515","14","957","2160","0","44.31","19.81"
"10","020","00","010","0050","0054","434","221","213","8","442","1021","0","43.29","21.65"
"10","020","00","010","0050","0055","509","207","302","6","515","1139","0","45.22","18.17"
"10","020","00","010","0051","0000","1064","452","612","12","1076","2474","0","43.49","18.27"
"10","020","00","010","0051","0056","512","210","302","8","520","1246","0","41.73","16.85"
"10","020","00","010","0051","0057","552","242","310","4","556","1228","0","45.28","19.71"
"10","020","00","010","0052","0000","1125","500","625","11","1136","2693","0","42.18","18.57"
"10","020","00","010","0052","0058","602","273","329","4","606","1409","0","43.01","19.38"
"10","020","00","010","0052","0059","523","227","296","7","530","1284","0","41.28","17.68"
"10","020","00","010","0053","0000","1162","543","619","10","1172","2905","0","40.34","18.69"
"10","020","00","010","0053","0065","424","183","241","4","428","1179","0","36.30","15.52"
"10","020","00","010","0053","0066","738","360","378","6","744","1726","0","43.11","20.86"
"10","020","00","010","0054","0000","1531","732","799","5","1536","3865","0","39.74","18.94"
"10","020","00","010","0054","0062","475","196","279","0","475","1141","0","41.63","17.18"
"10","020","00","010","0054","0063","459","225","234","2","461","1198","0","38.48","18.78"
"10","020","00","010","0054","0064","597","311","286","3","600","1526","0","39.32","20.38"
"10","020","00","010","0055","0000","1517","785","732","12","1529","3606","0","42.40","21.77"
"10","020","00","010","0055","0067","490","214","276","5","495","1173","0","42.20","18.24"
"10","020","00","010","0055","0068","570","365","205","3","573","1272","0","45.05","28.69"
"10","020","00","010","0055","0069","457","206","251","4","461","1161","0","39.71","17.74"
"10","020","00","010","0056","0000","905","383","522","5","910","1993","0","45.66","19.22"
"10","020","00","010","0056","0043","464","197","267","2","466","996","0","46.79","19.78"
"10","020","00","010","0056","0044","441","186","255","3","444","997","0","44.53","18.66"
"10","020","00","010","0057","0000","664","283","381","5","669","1684","0","39.73","16.81"
"10","020","00","010","0057","0041","394","180","214","2","396","902","0","43.90","19.96"
"10","020","00","010","0057","0042","270","103","167","3","273","782","0","34.91","13.17"
"10","020","00","010","0058","0000","845","341","504","7","852","1923","0","44.31","17.73"
"10","020","00","010","0058","0039","421","143","278","2","423","912","0","46.38","15.68"
"10","020","00","010","0058","0040","424","198","226","5","429","1011","0","42.43","19.58"
"10","020","00","010","0059","0000","799","337","462","11","810","1928","0","42.01","17.48"
"10","020","00","010","0059","0035","380","175","205","1","381","906","0","42.05","19.32"
"10","020","00","010","0059","0036","419","162","257","10","429","1022","0","41.98","15.85"
"10","020","00","010","0060","0000","852","360","492","4","856","1797","0","47.63","20.03"
"10","020","00","010","0060","0033","408","209","199","0","408","890","0","45.84","23.48"
"10","020","00","010","0060","0034","444","151","293","4","448","907","0","49.39","16.65"
"10","020","00","010","0061","0000","898","454","444","9","907","1852","0","48.97","24.51"
"10","020","00","010","0061","0028","547","282","265","5","552","1166","0","47.34","24.19"
"10","020","00","010","0061","0029","351","172","179","4","355","686","0","51.75","25.07"
"10","020","00","010","0062","0000","994","376","618","7","1001","2130","0","47.00","17.65"
"10","020","00","010","0062","0037","491","194","297","4","495","1125","0","44.00","17.24"
"10","020","00","010","0062","0038","503","182","321","3","506","1005","0","50.35","18.11"
"10","020","00","010","0063","0000","971","437","534","4","975","2284","0","42.69","19.13"
"10","020","00","010","0063","0072","579","262","317","4","583","1312","0","44.44","19.97"
"10","020","00","010","0063","0073","392","175","217","0","392","972","0","40.33","18.00"
"10","020","00","010","0064","0000","953","382","571","11","964","2085","0","46.24","18.32"
"10","020","00","010","0064","0070","463","189","274","7","470","1097","0","42.84","17.23"
"10","020","00","010","0064","0071","490","193","297","4","494","988","0","50.00","19.53"
"10","020","00","010","0065","0000","909","446","463","4","913","2195","0","41.59","20.32"
"10","020","00","010","0065","0003","375","180","195","2","377","1015","0","37.14","17.73"
"10","020","00","010","0065","0004","534","266","268","2","536","1180","0","45.42","22.54"
"10","020","00","010","0066","0000","1619","844","775","14","1633","3695","0","44.19","22.84"
"10","020","00","010","0066","0010","581","289","292","5","586","1290","0","45.43","22.40"
"10","020","00","010","0066","0011","529","278","251","3","532","1221","0","43.57","22.77"
"10","020","00","010","0066","0012","509","277","232","6","515","1184","0","43.50","23.40"
"10","020","00","010","0067","0000","781","375","406","1","782","1950","0","40.10","19.23"
"10","020","00","010","0067","0060","378","192","186","0","378","963","0","39.25","19.94"
"10","020","00","010","0067","0061","403","183","220","1","404","987","0","40.93","18.54"
"10","020","00","010","0068","0000","1042","475","567","4","1046","2719","0","38.47","17.47"
"10","020","00","010","0068","0079","546","247","299","4","550","1354","0","40.62","18.24"
"10","020","00","010","0068","0080","496","228","268","0","496","1365","0","36.34","16.70"
"10","020","00","020","0000","0000","49825","21483","28342","394","50219","120881","145551","41.54","17.77"
"10","020","00","020","0001","0000","303","124","179","2","305","819","0","37.24","15.14"
"10","020","00","020","0001","0164","303","124","179","2","305","819","0","37.24","15.14"
"10","020","00","020","0002","0000","804","296","508","6","810","2045","0","39.61","14.47"
"10","020","00","020","0002","0169","381","123","258","4","385","1001","0","38.46","12.29"
"10","020","00","020","0002","0170","423","173","250","2","425","1044","0","40.71","16.57"
"10","020","00","020","0003","0000","1022","395","627","9","1031","2205","0","46.76","17.91"
"10","020","00","020","0003","0160","501","189","312","5","506","1127","0","44.90","16.77"
"10","020","00","020","0003","0161","521","206","315","4","525","1078","0","48.70","19.11"
"10","020","00","020","0005","0000","765","306","459","10","775","1945","0","39.85","15.73"
"10","020","00","020","0005","0165","409","175","234","2","411","1104","0","37.23","15.85"
"10","020","00","020","0005","0166","356","131","225","8","364","841","0","43.28","15.58"
"10","020","00","020","0009","0000","1738","716","1022","16","1754","4451","0","39.41","16.09"
"10","020","00","020","0009","0171","541","229","312","8","549","1473","0","37.27","15.55"
"10","020","00","020","0009","0172","616","241","375","5","621","1523","0","40.77","15.82"
"10","020","00","020","0009","0173","581","246","335","3","584","1455","0","40.14","16.91"
"10","020","00","020","0010","0000","1737","589","1148","21","1758","4153","0","42.33","14.18"
"10","020","00","020","0010","0180","608","210","398","6","614","1390","0","44.17","15.11"
"10","020","00","020","0010","0181","531","179","352","10","541","1379","0","39.23","12.98"
"10","020","00","020","0010","0182","598","200","398","5","603","1384","0","43.57","14.45"
"10","020","00","020","0011","0000","1303","548","755","8","1311","3225","0","40.65","16.99"
"10","020","00","020","0011","0177","691","294","397","4","695","1654","0","42.02","17.78"
"10","020","00","020","0011","0178","612","254","358","4","616","1571","0","39.21","16.17"
"10","020","00","020","0012","0000","1179","480","699","2","1181","2954","0","39.98","16.25"
"10","020","00","020","0012","0187","622","257","365","2","624","1562","0","39.95","16.45"
"10","020","00","020","0012","0188","557","223","334","0","557","1392","0","40.01","16.02"
"10","020","00","020","0013","0000","595","243","352","6","601","1556","0","38.62","15.62"
"10","020","00","020","0013","0189","595","243","352","6","601","1556","0","38.62","15.62"
"10","020","00","020","0014","0000","429","187","242","4","433","1125","0","38.49","16.62"
"10","020","00","020","0014","0186","429","187","242","4","433","1125","0","38.49","16.62"
"10","020","00","020","0015","0000","821","305","516","4","825","2143","0","38.50","14.23"
"10","020","00","020","0015","0101","406","159","247","1","407","1040","0","39.13","15.29"
"10","020","00","020","0015","0102","415","146","269","3","418","1103","0","37.90","13.24"
"10","020","00","020","0016","0000","1619","713","906","14","1633","4114","0","39.69","17.33"
"10","020","00","020","0016","0106","501","210","291","5","506","1158","0","43.70","18.13"
"10","020","00","020","0016","0107","508","214","294","5","513","1263","0","40.62","16.94"
"10","020","00","020","0016","0108","610","289","321","4","614","1693","0","36.27","17.07"
"10","020","00","020","0017","0000","1347","557","790","5","1352","3239","0","41.74","17.20"
"10","020","00","020","0017","0119","450","164","286","2","452","1048","0","43.13","15.65"
"10","020","00","020","0017","0120","459","215","244","1","460","1088","0","42.28","19.76"
"10","020","00","020","0017","0121","438","178","260","2","440","1103","0","39.89","16.14"
"10","020","00","020","0018","0000","1393","566","827","12","1405","3497","0","40.18","16.19"
"10","020","00","020","0018","0103","440","164","276","1","441","1023","0","43.11","16.03"
"10","020","00","020","0018","0104","468","189","279","7","475","1182","0","40.19","15.99"
"10","020","00","020","0018","0105","485","213","272","4","489","1292","0","37.85","16.49"
"10","020","00","020","0019","0000","1358","635","723","7","1365","3363","0","40.59","18.88"
"10","020","00","020","0019","0114","398","199","199","3","401","987","0","40.63","20.16"
"10","020","00","020","0019","0115","469","213","256","3","472","1128","0","41.84","18.88"
"10","020","00","020","0019","0116","491","223","268","1","492","1248","0","39.42","17.87"
"10","020","00","020","0020","0000","755","312","443","4","759","1847","0","41.09","16.89"
"10","020","00","020","0020","0117","412","164","248","0","412","970","0","42.47","16.91"
"10","020","00","020","0020","0118","343","148","195","4","347","877","0","39.57","16.88"
"10","020","00","020","0021","0000","2648","1257","1391","25","2673","6843","0","39.06","18.37"
"10","020","00","020","0021","0122","561","262","299","5","566","1437","0","39.39","18.23"
"10","020","00","020","0021","0123","492","227","265","3","495","1253","0","39.51","18.12"
"10","020","00","020","0021","0124","551","280","271","4","555","1460","0","38.01","19.18"
"10","020","00","020","0021","0125","478","223","255","4","482","1255","0","38.41","17.77"
"10","020","00","020","0021","0126","566","265","301","9","575","1438","0","39.99","18.43"
"10","020","00","020","0022","0000","793","339","454","10","803","2010","0","39.95","16.87"
"10","020","00","020","0022","0112","401","165","236","7","408","970","0","42.06","17.01"
"10","020","00","020","0022","0113","392","174","218","3","395","1040","0","37.98","16.73"
"10","020","00","020","0031","0000","872","387","485","6","878","1889","0","46.48","20.49"
"10","020","00","020","0031","0090","394","172","222","3","397","859","0","46.22","20.02"
"10","020","00","020","0031","0091","478","215","263","3","481","1030","0","46.70","20.87"
"10","020","00","020","0045","0000","775","455","320","1","776","1615","0","48.05","28.17"
"10","020","00","020","0045","0151","348","131","217","0","348","755","0","46.09","17.35"
"10","020","00","020","0045","0152","427","324","103","1","428","860","0","49.77","37.67"
"10","020","00","020","0046","0000","684","288","396","8","692","1915","0","36.14","15.04"
"10","020","00","020","0046","0149","350","140","210","3","353","926","0","38.12","15.12"
"10","020","00","020","0046","0150","334","148","186","5","339","989","0","34.28","14.96"
"10","020","00","020","0047","0000","2342","1044","1298","15","2357","5748","0","41.01","18.16"
"10","020","00","020","0047","0145","608","273","335","4","612","1547","0","39.56","17.65"
"10","020","00","020","0047","0146","507","215","292","3","510","1297","0","39.32","16.58"
"10","020","00","020","0047","0147","600","282","318","4","604","1334","0","45.28","21.14"
"10","020","00","020","0047","0148","627","274","353","4","631","1570","0","40.19","17.45"
"10","020","00","020","0048","0000","2117","953","1164","19","2136","5437","0","39.29","17.53"
"10","020","00","020","0048","0141","533","248","285","4","537","1169","0","45.94","21.21"
"10","020","00","020","0048","0142","543","211","332","7","550","1279","0","43.00","16.50"
"10","020","00","020","0048","0143","508","225","283","5","513","1601","0","32.04","14.05"
"10","020","00","020","0048","0144","533","269","264","3","536","1388","0","38.62","19.38"
"10","020","00","020","0049","0000","1760","672","1088","14","1774","4510","0","39.33","14.90"
"10","020","00","020","0049","0131","525","187","338","4","529","1464","0","36.13","12.77"
"10","020","00","020","0049","0132","574","207","367","3","577","1405","0","41.07","14.73"
"10","020","00","020","0049","0133","661","278","383","7","668","1641","0","40.71","16.94"
"10","020","00","020","0050","0000","1532","681","851","9","1541","3560","0","43.29","19.13"
"10","020","00","020","0050","0128","340","112","228","4","344","898","0","38.31","12.47"
"10","020","00","020","0050","0129","704","320","384","2","706","1550","0","45.55","20.65"
"10","020","00","020","0050","0130","488","249","239","3","491","1112","0","44.15","22.39"
"10","020","00","020","0051","0000","776","320","456","4","780","1726","0","45.19","18.54"
"10","020","00","020","0051","0153","423","182","241","2","425","915","0","46.45","19.89"
"10","020","00","020","0051","0154","353","138","215","2","355","811","0","43.77","17.02"
"10","020","00","020","0052","0000","815","610","205","8","823","1739","0","47.33","35.08"
"10","020","00","020","0052","0155","410","301","109","5","415","868","0","47.81","34.68"
"10","020","00","020","0052","0156","405","309","96","3","408","871","0","46.84","35.48"
"10","020","00","020","0053","0000","2151","984","1167","29","2180","5111","0","42.65","19.25"
"10","020","00","020","0053","0137","483","208","275","9","492","1185","0","41.52","17.55"
"10","020","00","020","0053","0138","569","260","309","9","578","1319","0","43.82","19.71"
"10","020","00","020","0053","0139","599","271","328","6","605","1464","0","41.33","18.51"
"10","020","00","020","0053","0140","500","245","255","5","505","1143","0","44.18","21.43"
"10","020","00","020","0054","0000","653","495","158","4","657","1383","0","47.51","35.79"
"10","020","00","020","0054","0157","653","495","158","4","657","1383","0","47.51","35.79"
"10","020","00","020","0055","0000","698","320","378","5","703","1622","0","43.34","19.73"
"10","020","00","020","0055","0127","698","320","378","5","703","1622","0","43.34","19.73"
"10","020","00","020","0056","0000","775","336","439","5","780","1864","0","41.85","18.03"
"10","020","00","020","0056","0092","369","155","214","5","374","951","0","39.33","16.30"
"10","020","00","020","0056","0093","406","181","225","0","406","913","0","44.47","19.82"
"10","020","00","020","0057","0000","734","237","497","5","739","1627","0","45.42","14.57"
"10","020","00","020","0057","0094","734","237","497","5","739","1627","0","45.42","14.57"
"10","020","00","020","0058","0000","1021","411","610","9","1030","2211","0","46.59","18.59"
"10","020","00","020","0058","0095","542","243","299","6","548","1200","0","45.67","20.25"
"10","020","00","020","0058","0096","479","168","311","3","482","1011","0","47.68","16.62"
"10","020","00","020","0059","0000","1004","382","622","7","1011","2209","0","45.77","17.29"
"10","020","00","020","0059","0097","480","174","306","1","481","1109","0","43.37","15.69"
"10","020","00","020","0059","0098","524","208","316","6","530","1100","0","48.18","18.91"
"10","020","00","020","0060","0000","549","243","306","2","551","1253","0","43.97","19.39"
"10","020","00","020","0060","0100","549","243","306","2","551","1253","0","43.97","19.39"
"10","020","00","020","0061","0000","639","247","392","6","645","1355","0","47.60","18.23"
"10","020","00","020","0061","0099","639","247","392","6","645","1355","0","47.60","18.23"
"10","020","00","020","0062","0000","689","272","417","5","694","1512","0","45.90","17.99"
"10","020","00","020","0062","0158","331","119","212","2","333","719","0","46.31","16.55"
"10","020","00","020","0062","0159","358","153","205","3","361","793","0","45.52","19.29"
"10","020","00","020","0063","0000","633","250","383","8","641","1521","0","42.14","16.44"
"10","020","00","020","0063","0162","318","140","178","4","322","743","0","43.34","18.84"
"10","020","00","020","0063","0163","315","110","205","4","319","778","0","41.00","14.14"
"10","020","00","020","0064","0000","805","296","509","6","811","2042","0","39.72","14.50"
"10","020","00","020","0064","0167","456","179","277","2","458","1129","0","40.57","15.85"
"10","020","00","020","0064","0168","349","117","232","4","353","913","0","38.66","12.81"
"10","020","00","020","0065","0000","1701","721","980","16","1717","4195","0","40.93","17.19"
"10","020","00","020","0065","0109","590","221","369","5","595","1364","0","43.62","16.20"
"10","020","00","020","0065","0110","551","243","308","6","557","1386","0","40.19","17.53"
"10","020","00","020","0065","0111","560","257","303","5","565","1445","0","39.10","17.79"
"10","020","00","020","0066","0000","1140","505","635","9","1149","2686","0","42.78","18.80"
"10","020","00","020","0066","0134","561","272","289","5","566","1313","0","43.11","20.72"
"10","020","00","020","0066","0135","579","233","346","4","583","1373","0","42.46","16.97"
"10","020","00","020","0067","0000","643","253","390","8","651","1570","0","41.46","16.11"
"10","020","00","020","0067","0136","643","253","390","8","651","1570","0","41.46","16.11"
"10","020","00","020","0068","0000","1364","590","774","7","1371","3637","0","37.70","16.22"
"10","020","00","020","0068","0183","445","186","259","4","449","1276","0","35.19","14.58"
"10","020","00","020","0068","0184","468","191","277","2","470","1212","0","38.78","15.76"
"10","020","00","020","0068","0185","451","213","238","1","452","1149","0","39.34","18.54"
"10","020","00","020","0069","0000","1837","772","1065","10","1847","4295","0","43.00","17.97"
"10","020","00","020","0069","0174","519","200","319","3","522","1243","0","42.00","16.09"
"10","020","00","020","0069","0175","600","276","324","3","603","1324","0","45.54","20.85"
"10","020","00","020","0069","0176","718","296","422","4","722","1728","0","41.78","17.13"
"10","020","00","020","0070","0000","507","191","316","4","511","1115","0","45.83","17.13"
"10","020","00","020","0070","0179","507","191","316","4","511","1115","0","45.83","17.13"
"09","020","00","000","0000","0000","23113","20343","2770","291","23404","124592","139764","18.78","16.33"
"09","020","00","010","0000","0000","7303","6494","809","72","7375","37667","42770","19.58","17.24"
"09","020","00","010","0001","0000","956","861","95","10","966","4809","0","20.09","17.90"
"09","020","00","010","0001","0001","269","248","21","1","270","1369","0","19.72","18.12"
"09","020","00","010","0001","0002","359","325","34","5","364","1748","0","20.82","18.59"
"09","020","00","010","0001","0003","328","288","40","4","332","1692","0","19.62","17.02"
"09","020","00","010","0002","0000","2028","1840","188","12","2040","9671","0","21.09","19.03"
"09","020","00","010","0002","0007","313","275","38","2","315","1584","0","19.89","17.36"
"09","020","00","010","0002","0008","331","304","27","2","333","1622","0","20.53","18.74"
"09","020","00","010","0002","0009","315","285","30","3","318","1564","0","20.33","18.22"
"09","020","00","010","0002","0010","347","316","31","0","347","1654","0","20.98","19.11"
"09","020","00","010","0002","0011","387","349","38","2","389","1730","0","22.49","20.17"
"09","020","00","010","0002","0012","335","311","24","3","338","1517","0","22.28","20.50"
"09","020","00","010","0003","0000","1066","946","120","14","1080","5344","0","20.21","17.70"
"09","020","00","010","0003","0004","341","298","43","2","343","1870","0","18.34","15.94"
"09","020","00","010","0003","0005","290","261","29","4","294","1608","0","18.28","16.23"
"09","020","00","010","0003","0006","435","387","48","8","443","1866","0","23.74","20.74"
"09","020","00","010","0004","0000","726","655","71","7","733","3979","0","18.42","16.46"
"09","020","00","010","0004","0013","264","229","35","5","269","1334","0","20.16","17.17"
"09","020","00","010","0004","0014","234","225","9","0","234","1174","0","19.93","19.17"
"09","020","00","010","0004","0015","228","201","27","2","230","1471","0","15.64","13.66"
"09","020","00","010","0005","0000","728","625","103","9","737","4023","0","18.32","15.54"
"09","020","00","010","0005","0020","234","207","27","3","237","1334","0","17.77","15.52"
"09","020","00","010","0005","0021","221","179","42","3","224","1229","0","18.23","14.56"
"09","020","00","010","0005","0022","273","239","34","3","276","1460","0","18.90","16.37"
"09","020","00","010","0006","0000","456","402","54","6","462","2226","0","20.75","18.06"
"09","020","00","010","0006","0019","456","402","54","6","462","2226","0","20.75","18.06"
"09","020","00","010","0007","0000","499","440","59","7","506","2885","0","17.54","15.25"
"09","020","00","010","0007","0023","237","206","31","3","240","1590","0","15.09","12.96"
"09","020","00","010","0007","0024","262","234","28","4","266","1295","0","20.54","18.07"
"09","020","00","010","0008","0000","844","725","119","7","851","4730","0","17.99","15.33"
"09","020","00","010","0008","0016","290","256","34","3","293","1565","0","18.72","16.36"
"09","020","00","010","0008","0017","261","226","35","1","262","1530","0","17.12","14.77"
"09","020","00","010","0008","0018","293","243","50","3","296","1635","0","18.10","14.86"
"09","020","00","020","0000","0000","3411","3136","275","45","3456","18724","20622","18.46","16.75"
"09","020","00","020","0001","0000","970","890","80","9","979","5076","0","19.29","17.53"
"09","020","00","020","0001","0070","160","151","9","0","160","895","0","17.88","16.87"
"09","020","00","020","0001","0071","187","168","19","3","190","994","0","19.11","16.90"
"09","020","00","020","0001","0072","299","278","21","4","303","1524","0","19.88","18.24"
"09","020","00","020","0001","0073","324","293","31","2","326","1663","0","19.60","17.62"
"09","020","00","020","0002","0000","336","308","28","7","343","1955","0","17.54","15.75"
"09","020","00","020","0002","0081","155","137","18","3","158","1033","0","15.30","13.26"
"09","020","00","020","0002","0082","181","171","10","4","185","922","0","20.07","18.55"
"09","020","00","020","0003","0000","214","196","18","6","220","1153","0","19.08","17.00"
"09","020","00","020","0003","0083","214","196","18","6","220","1153","0","19.08","17.00"
"09","020","00","020","0004","0000","434","386","48","7","441","2348","0","18.78","16.44"
"09","020","00","020","0004","0084","214","189","25","2","216","1251","0","17.27","15.11"
"09","020","00","020","0004","0085","220","197","23","5","225","1097","0","20.51","17.96"
"09","020","00","020","0005","0000","381","355","26","2","383","2045","0","18.73","17.36"
"09","020","00","020","0005","0074","179","166","13","2","181","960","0","18.85","17.29"
"09","020","00","020","0005","0075","202","189","13","0","202","1085","0","18.62","17.42"
"09","020","00","020","0006","0000","262","249","13","3","265","1592","0","16.65","15.64"
"09","020","00","020","0006","0078","262","249","13","3","265","1592","0","16.65","15.64"
"09","020","00","020","0007","0000","365","340","25","7","372","2210","0","16.83","15.38"
"09","020","00","020","0007","0079","225","217","8","3","228","1233","0","18.49","17.60"
"09","020","00","020","0007","0080","140","123","17","4","144","977","0","14.74","12.59"
"09","020","00","020","0008","0000","449","412","37","4","453","2345","0","19.32","17.57"
"09","020","00","020","0008","0076","247","227","20","1","248","1212","0","20.46","18.73"
"09","020","00","020","0008","0077","202","185","17","3","205","1133","0","18.09","16.33"
"09","020","00","030","0000","0000","5214","4584","630","76","5290","26724","30316","19.79","17.15"
"09","020","00","030","0001","0000","845","766","79","9","854","3969","0","21.52","19.30"
"09","020","00","030","0001","0052","293","262","31","5","298","1248","0","23.88","20.99"
"09","020","00","030","0001","0053","251","233","18","4","255","1260","0","20.24","18.49"
"09","020","00","030","0001","0054","301","271","30","0","301","1461","0","20.60","18.55"
"09","020","00","030","0002","0000","657","581","76","13","670","3328","0","20.13","17.46"
"09","020","00","030","0002","0055","378","334","44","7","385","1882","0","20.46","17.75"
"09","020","00","030","0002","0056","279","247","32","6","285","1446","0","19.71","17.08"
"09","020","00","030","0003","0000","514","455","59","12","526","2699","0","19.49","16.86"
"09","020","00","030","0003","0066","202","172","30","3","205","1279","0","16.03","13.45"
"09","020","00","030","0003","0067","312","283","29","9","321","1420","0","22.61","19.93"
"09","020","00","030","0004","0000","422","363","59","7","429","2132","0","20.12","17.03"
"09","020","00","030","0004","0059","199","177","22","3","202","1061","0","19.04","16.68"
"09","020","00","030","0004","0060","223","186","37","4","227","1071","0","21.20","17.37"
"09","020","00","030","0005","0000","654","584","70","9","663","3259","0","20.34","17.92"
"09","020","00","030","0005","0068","329","292","37","3","332","1652","0","20.10","17.68"
"09","020","00","030","0005","0069","325","292","33","6","331","1607","0","20.60","18.17"
"09","020","00","030","0006","0000","1533","1292","241","15","1548","8073","0","19.18","16.00"
"09","020","00","030","0006","0061","390","319","71","2","392","2006","0","19.54","15.90"
"09","020","00","030","0006","0062","292","262","30","3","295","1672","0","17.64","15.67"
"09","020","00","030","0006","0063","276","238","38","5","281","1459","0","19.26","16.31"
"09","020","00","030","0006","0064","279","228","51","3","282","1502","0","18.77","15.18"
"09","020","00","030","0006","0065","296","245","51","2","298","1434","0","20.78","17.09"
"09","020","00","030","0007","0000","238","225","13","4","242","1560","0","15.51","14.42"
"09","020","00","030","0007","0057","238","225","13","4","242","1560","0","15.51","14.42"
"09","020","00","030","0008","0000","351","318","33","7","358","1704","0","21.01","18.66"
"09","020","00","030","0008","0058","351","318","33","7","358","1704","0","21.01","18.66"
"09","020","00","040","0000","0000","5326","4433","893","66","5392","29252","32749","18.43","15.15"
"09","020","00","040","0001","0000","479","417","62","4","483","3363","0","14.36","12.40"
"09","020","00","040","0001","0025","268","235","33","2","270","1783","0","15.14","13.18"
"09","020","00","040","0001","0026","211","182","29","2","213","1580","0","13.48","11.52"
"09","020","00","040","0002","0000","821","701","120","16","837","5049","0","16.58","13.88"
"09","020","00","040","0002","0027","325","259","66","3","328","2119","0","15.48","12.22"
"09","020","00","040","0002","0028","169","150","19","5","174","1014","0","17.16","14.79"
"09","020","00","040","0002","0029","327","292","35","8","335","1916","0","17.48","15.24"
"09","020","00","040","0003","0000","304","269","35","1","305","1618","0","18.85","16.63"
"09","020","00","040","0003","0041","304","269","35","1","305","1618","0","18.85","16.63"
"09","020","00","040","0004","0000","1517","1238","279","18","1535","7551","0","20.33","16.40"
"09","020","00","040","0004","0030","340","287","53","7","347","1878","0","18.48","15.28"
"09","020","00","040","0004","0031","428","282","146","7","435","1865","0","23.32","15.12"
"09","020","00","040","0004","0032","391","348","43","0","391","1872","0","20.89","18.59"
"09","020","00","040","0004","0033","358","321","37","4","362","1936","0","18.70","16.58"
"09","020","00","040","0005","0000","928","811","117","11","939","5268","0","17.82","15.39"
"09","020","00","040","0005","0034","354","294","60","5","359","1933","0","18.57","15.21"
"09","020","00","040","0005","0035","284","259","25","3","287","1816","0","15.80","14.26"
"09","020","00","040","0005","0036","290","258","32","3","293","1519","0","19.29","16.98"
"09","020","00","040","0006","0000","1277","997","280","16","1293","6403","0","20.19","15.57"
"09","020","00","040","0006","0037","290","255","35","7","297","1570","0","18.92","16.24"
"09","020","00","040","0006","0038","313","273","40","3","316","1874","0","16.86","14.57"
"09","020","00","040","0006","0039","447","270","177","5","452","1681","0","26.89","16.06"
"09","020","00","040","0006","0040","227","199","28","1","228","1278","0","17.84","15.57"
"09","020","00","050","0000","0000","1822","1666","156","32","1854","11656","12646","15.91","14.29"
"09","020","00","050","0001","0000","456","423","33","9","465","2843","0","16.36","14.88"
"09","020","00","050","0001","0048","244","232","12","1","245","1411","0","17.36","16.44"
"09","020","00","050","0001","0049","212","191","21","8","220","1432","0","15.36","13.34"
"09","020","00","050","0002","0000","184","170","14","6","190","1428","0","13.31","11.90"
"09","020","00","050","0002","0047","184","170","14","6","190","1428","0","13.31","11.90"
"09","020","00","050","0003","0000","343","303","40","8","351","2415","0","14.53","12.55"
"09","020","00","050","0003","0045","166","144","22","6","172","1285","0","13.39","11.21"
"09","020","00","050","0003","0046","177","159","18","2","179","1130","0","15.84","14.07"
"09","020","00","050","0004","0000","611","561","50","5","616","3328","0","18.51","16.86"
"09","020","00","050","0004","0042","298","281","17","4","302","1601","0","18.86","17.55"
"09","020","00","050","0004","0043","313","280","33","1","314","1727","0","18.18","16.21"
"09","020","00","050","0005","0000","228","209","19","4","232","1642","0","14.13","12.73"
"09","020","00","050","0005","0044","228","209","19","4","232","1642","0","14.13","12.73"
"09","020","00","060","0000","0000","37","30","7","0","37","569","661","6.50","5.27"
"09","020","00","060","0001","0000","19","16","3","0","19","270","0","7.04","5.93"
"09","020","00","060","0001","0050","19","16","3","0","19","270","0","7.04","5.93"
"09","020","00","060","0002","0000","18","14","4","0","18","299","0","6.02","4.68"
"09","020","00","060","0002","0051","18","14","4","0","18","299","0","6.02","4.68"
"09","007","00","000","0000","0000","3078","2676","402","40","3118","11673","13449","26.71","22.92"
"09","007","00","010","0000","0000","1873","1638","235","27","1900","6505","7644","29.21","25.18"
"09","007","00","010","0001","0000","641","568","73","11","652","1982","0","32.90","28.66"
"09","007","00","010","0001","0001","322","286","36","9","331","1041","0","31.80","27.47"
"09","007","00","010","0001","0002","319","282","37","2","321","941","0","34.11","29.97"
"09","007","00","010","0010","0000","467","407","60","6","473","1682","0","28.12","24.20"
"09","007","00","010","0010","0003","467","407","60","6","473","1682","0","28.12","24.20"
"09","007","00","010","0011","0000","330","275","55","4","334","1223","0","27.31","22.49"
"09","007","00","010","0011","0004","330","275","55","4","334","1223","0","27.31","22.49"
"09","007","00","010","0012","0000","435","388","47","6","441","1618","0","27.26","23.98"
"09","007","00","010","0012","0005","435","388","47","6","441","1618","0","27.26","23.98"
"09","007","00","020","0000","0000","615","526","89","9","624","2537","2846","24.60","20.73"
"09","007","00","020","0007","0000","331","281","50","4","335","1310","0","25.57","21.45"
"09","007","00","020","0007","0006","331","281","50","4","335","1310","0","25.57","21.45"
"09","007","00","020","0008","0000","284","245","39","5","289","1227","0","23.55","19.97"
"09","007","00","020","0008","0007","284","245","39","5","289","1227","0","23.55","19.97"
"09","007","00","030","0000","0000","296","252","44","3","299","1363","1496","21.94","18.49"
"09","007","00","030","0006","0000","156","130","26","2","158","668","0","23.65","19.46"
"09","007","00","030","0006","0008","156","130","26","2","158","668","0","23.65","19.46"
"09","007","00","030","0007","0000","140","122","18","1","141","695","0","20.29","17.55"
"09","007","00","030","0007","0009","140","122","18","1","141","695","0","20.29","17.55"
"09","007","00","040","0000","0000","294","260","34","1","295","1268","1463","23.26","20.50"
"09","007","00","040","0003","0000","294","260","34","1","295","1268","0","23.26","20.50"
"09","007","00","040","0003","0010","294","260","34","1","295","1268","0","23.26","20.50"
