"prv_code","city_code","area_code","dept_code","li_code","tbox_no","valid_ticket","agree_ticket","disagree_ticket","invalid_ticket","vote_ticket","votable_population","population","vote_to_votable","agree_to_votable"
"00","000","00","000","0000","0000","10023281","7791856","2231425","756041","10779322","19757067","23580833","54.56","39.44"
"63","000","00","000","0000","0000","1202239","922395","279844","74941","1277180","2228430","2669874","57.31","41.39"
"63","000","00","001","0000","0000","94286","72672","21614","5549","99835","169278","205826","58.98","42.93"
"63","000","00","001","0102","0000","2521","1957","564","164","2685","4660","0","57.62","42.0"
"63","000","00","001","0102","0527","866","686","180","46","912","1583","0","57.61","43.34"
"63","000","00","001","0102","0528","905","692","213","75","980","1691","0","57.95","40.92"
"63","000","00","001","0102","0529","750","579","171","43","793","1386","0","57.22","41.77"
"63","000","00","001","0103","0000","3893","2869","1024","256","4149","6767","0","61.31","42.4"
"63","000","00","001","0103","0530","772","575","197","52","824","1362","0","60.5","42.22"
"63","000","00","001","0103","0531","791","595","196","50","841","1399","0","60.11","42.53"
"63","000","00","001","0103","0532","756","537","219","47","803","1324","0","60.65","40.56"
"63","000","00","001","0103","0533","775","580","195","54","829","1296","0","63.97","44.75"
"63","000","00","001","0103","0534","799","582","217","53","852","1386","0","61.47","41.99"
"63","000","00","001","0104","0000","3292","2495","797","219","3511","5950","0","59.01","41.93"
"63","000","00","001","0104","0535","888","657","231","72","960","1529","0","62.79","42.97"
"63","000","00","001","0104","0536","779","613","166","40","819","1416","0","57.84","43.29"
"63","000","00","001","0104","0537","841","659","182","55","896","1619","0","55.34","40.7"
"63","000","00","001","0104","0538","784","566","218","52","836","1386","0","60.32","40.84"
"63","000","00","001","0105","0000","2406","1831","575","123","2529","4033","0","62.71","45.4"
"63","000","00","001","0105","0539","856","642","214","33","889","1380","0","64.42","46.52"
"63","000","00","001","0105","0540","780","586","194","46","826","1357","0","60.87","43.18"
"63","000","00","001","0105","0541","770","603","167","44","814","1296","0","62.81","46.53"
"63","000","00","001","0106","0000","2512","1946","566","142","2654","4450","0","59.64","43.73"
"63","000","00","001","0106","0542","931","750","181","57","988","1632","0","60.54","45.96"
"63","000","00","001","0106","0543","778","592","186","46","824","1414","0","58.27","41.87"
"63","000","00","001","0106","0544","803","604","199","39","842","1404","0","59.97","43.02"
"63","000","00","001","0107","0000","2417","1876","541","189","2606","4279","0","60.9","43.84"
"63","000","00","001","0107","0545","783","629","154","68","851","1365","0","62.34","46.08"
"63","000","00","001","0107","0546","797","625","172","60","857","1431","0","59.89","43.68"
"63","000","00","001","0107","0547","837","622","215","61","898","1483","0","60.55","41.94"
"63","000","00","001","0108","0000","2268","1800","468","143","2411","4010","0","60.12","44.89"
"63","000","00","001","0108","0548","754","582","172","58","812","1293","0","62.8","45.01"
"63","000","00","001","0108","0549","762","621","141","43","805","1410","0","57.09","44.04"
"63","000","00","001","0108","0550","752","597","155","42","794","1307","0","60.75","45.68"
"63","000","00","001","0109","0000","2182","1678","504","132","2314","3710","0","62.37","45.23"
"63","000","00","001","0109","0551","736","563","173","52","788","1242","0","63.45","45.33"
"63","000","00","001","0109","0552","697","545","152","30","727","1192","0","60.99","45.72"
"63","000","00","001","0109","0553","749","570","179","50","799","1276","0","62.62","44.67"
"63","000","00","001","0110","0000","2094","1613","481","111","2205","3676","0","59.98","43.88"
"63","000","00","001","0110","0554","675","512","163","28","703","1201","0","58.53","42.63"
"63","000","00","001","0110","0555","749","592","157","43","792","1318","0","60.09","44.92"
"63","000","00","001","0110","0556","670","509","161","40","710","1157","0","61.37","43.99"
"63","000","00","001","0111","0000","3460","2657","803","187","3647","6311","0","57.79","42.1"
"63","000","00","001","0111","0557","645","497","148","18","663","1157","0","57.3","42.96"
"63","000","00","001","0111","0558","781","615","166","53","834","1357","0","61.46","45.32"
"63","000","00","001","0111","0559","596","444","152","31","627","1215","0","51.6","36.54"
"63","000","00","001","0111","0560","737","569","168","41","778","1345","0","57.84","42.3"
"63","000","00","001","0111","0561","701","532","169","44","745","1237","0","60.23","43.01"
"63","000","00","001","0112","0000","4961","4034","927","250","5211","8478","0","61.46","47.58"
"63","000","00","001","0112","0562","865","747","118","43","908","1393","0","65.18","53.63"
"63","000","00","001","0112","0563","812","612","200","45","857","1331","0","64.39","45.98"
"63","000","00","001","0112","0564","901","669","232","57","958","1550","0","61.81","43.16"
"63","000","00","001","0112","0565","720","621","99","21","741","1308","0","56.65","47.48"
"63","000","00","001","0112","0566","805","692","113","46","851","1490","0","57.11","46.44"
"63","000","00","001","0112","0567","858","693","165","38","896","1406","0","63.73","49.29"
"63","000","00","001","0113","0000","1354","999","355","75","1429","2286","0","62.51","43.7"
"63","000","00","001","0113","0568","729","542","187","38","767","1191","0","64.4","45.51"
"63","000","00","001","0113","0569","625","457","168","37","662","1095","0","60.46","41.74"
"63","000","00","001","0114","0000","2038","1554","484","139","2177","3688","0","59.03","42.14"
"63","000","00","001","0114","0570","662","496","166","42","704","1198","0","58.76","41.4"
"63","000","00","001","0114","0571","705","553","152","45","750","1265","0","59.29","43.72"
"63","000","00","001","0114","0572","671","505","166","52","723","1225","0","59.02","41.22"
"63","000","00","001","0115","0000","2976","2309","667","169","3145","5271","0","59.67","43.81"
"63","000","00","001","0115","0573","998","758","240","50","1048","1698","0","61.72","44.64"
"63","000","00","001","0115","0574","990","787","203","49","1039","1819","0","57.12","43.27"
"63","000","00","001","0115","0575","988","764","224","70","1058","1754","0","60.32","43.56"
"63","000","00","001","0116","0000","4410","3263","1147","242","4652","7675","0","60.61","42.51"
"63","000","00","001","0116","0576","802","567","235","44","846","1361","0","62.16","41.66"
"63","000","00","001","0116","0577","702","549","153","25","727","1189","0","61.14","46.17"
"63","000","00","001","0116","0578","703","519","184","43","746","1214","0","61.45","42.75"
"63","000","00","001","0116","0579","714","533","181","47","761","1284","0","59.27","41.51"
"63","000","00","001","0116","0580","754","552","202","48","802","1297","0","61.84","42.56"
"63","000","00","001","0116","0581","735","543","192","35","770","1330","0","57.89","40.83"
"63","000","00","001","0117","0000","3248","2571","677","168","3416","5685","0","60.09","45.22"
"63","000","00","001","0117","0582","815","655","160","53","868","1396","0","62.18","46.92"
"63","000","00","001","0117","0583","813","663","150","27","840","1480","0","56.76","44.8"
"63","000","00","001","0117","0584","832","646","186","33","865","1419","0","60.96","45.53"
"63","000","00","001","0117","0585","788","607","181","55","843","1390","0","60.65","43.67"
"63","000","00","001","0118","0000","3114","2439","675","224","3338","7127","0","46.84","34.22"
"63","000","00","001","0118","0588","841","651","190","51","892","2677","0","33.32","24.32"
"63","000","00","001","0118","0589","712","632","80","57","769","1281","0","60.03","49.34"
"63","000","00","001","0118","0590","669","492","177","47","716","1469","0","48.74","33.49"
"63","000","00","001","0118","0591","892","664","228","69","961","1700","0","56.53","39.06"
"63","000","00","001","0119","0000","4006","2985","1021","265","4271","7443","0","57.38","40.1"
"63","000","00","001","0119","0592","774","597","177","39","813","1503","0","54.09","39.72"
"63","000","00","001","0119","0593","707","548","159","50","757","1309","0","57.83","41.86"
"63","000","00","001","0119","0594","772","598","174","65","837","1376","0","60.83","43.46"
"63","000","00","001","0119","0595","930","609","321","32","962","1654","0","58.16","36.82"
"63","000","00","001","0119","0596","823","633","190","79","902","1601","0","56.34","39.54"
"63","000","00","001","0120","0000","2780","2196","584","165","2945","4845","0","60.78","45.33"
"63","000","00","001","0120","0597","843","708","135","33","876","1496","0","58.56","47.33"
"63","000","00","001","0120","0598","937","719","218","75","1012","1598","0","63.33","44.99"
"63","000","00","001","0120","0599","1000","769","231","57","1057","1751","0","60.37","43.92"
"63","000","00","001","0121","0000","5076","4273","803","221","5297","8544","0","62.0","50.01"
"63","000","00","001","0121","0600","926","770","156","43","969","1557","0","62.24","49.45"
"63","000","00","001","0121","0601","1047","885","162","54","1101","1686","0","65.3","52.49"
"63","000","00","001","0121","0602","1012","880","132","40","1052","1707","0","61.63","51.55"
"63","000","00","001","0121","0603","1148","993","155","44","1192","1854","0","64.29","53.56"
"63","000","00","001","0121","0604","943","745","198","40","983","1740","0","56.49","42.82"
"63","000","00","001","0122","0000","4157","3222","935","233","4390","7404","0","59.29","43.52"
"63","000","00","001","0122","0605","819","627","192","66","885","1494","0","59.24","41.97"
"63","000","00","001","0122","0606","830","649","181","44","874","1453","0","60.15","44.67"
"63","000","00","001","0122","0607","833","651","182","38","871","1458","0","59.74","44.65"
"63","000","00","001","0122","0608","837","657","180","46","883","1536","0","57.49","42.77"
"63","000","00","001","0122","0609","838","638","200","39","877","1463","0","59.95","43.61"
"63","000","00","001","0124","0000","3697","2786","911","232","3929","7047","0","55.75","39.53"
"63","000","00","001","0124","0610","914","704","210","39","953","1790","0","53.24","39.33"
"63","000","00","001","0124","0611","953","705","248","54","1007","1679","0","59.98","41.99"
"63","000","00","001","0124","0612","860","640","220","72","932","1785","0","52.21","35.85"
"63","000","00","001","0124","0613","970","737","233","67","1037","1793","0","57.84","41.1"
"63","000","00","001","0125","0000","3165","2483","682","213","3378","5573","0","60.61","44.55"
"63","000","00","001","0125","0614","770","614","156","50","820","1381","0","59.38","44.46"
"63","000","00","001","0125","0615","728","564","164","46","774","1279","0","60.52","44.1"
"63","000","00","001","0125","0616","941","716","225","71","1012","1681","0","60.2","42.59"
"63","000","00","001","0125","0617","726","589","137","46","772","1232","0","62.66","47.81"
"63","000","00","001","0126","0000","4250","3220","1030","237","4487","7803","0","57.5","41.27"
"63","000","00","001","0126","0618","821","644","177","58","879","1533","0","57.34","42.01"
"63","000","00","001","0126","0619","908","677","231","39","947","1540","0","61.49","43.96"
"63","000","00","001","0126","0620","905","693","212","56","961","1716","0","56.0","40.38"
"63","000","00","001","0126","0621","869","653","216","53","922","1664","0","55.41","39.24"
"63","000","00","001","0126","0622","747","553","194","31","778","1350","0","57.63","40.96"
"63","000","00","001","0127","0000","1776","1340","436","125","1901","3395","0","55.99","39.47"
"63","000","00","001","0127","0623","997","761","236","50","1047","1837","0","57.0","41.43"
"63","000","00","001","0127","0624","779","579","200","75","854","1558","0","54.81","37.16"
"63","000","00","001","0128","0000","1613","1236","377","103","1716","2894","0","59.3","42.71"
"63","000","00","001","0128","0625","822","642","180","48","870","1420","0","61.27","45.21"
"63","000","00","001","0128","0626","791","594","197","55","846","1474","0","57.39","40.3"
"63","000","00","001","0129","0000","1818","1384","434","105","1923","3317","0","57.97","41.72"
"63","000","00","001","0129","0627","862","641","221","47","909","1591","0","57.13","40.29"
"63","000","00","001","0129","0628","956","743","213","58","1014","1726","0","58.75","43.05"
"63","000","00","001","0130","0000","3167","2325","842","171","3338","5792","0","57.63","40.14"
"63","000","00","001","0130","0629","799","570","229","43","842","1452","0","57.99","39.26"
"63","000","00","001","0130","0630","787","582","205","42","829","1482","0","55.94","39.27"
"63","000","00","001","0130","0631","820","628","192","43","863","1460","0","59.11","43.01"
"63","000","00","001","0130","0632","761","545","216","43","804","1398","0","57.51","38.98"
"63","000","00","001","0131","0000","1516","1188","328","77","1593","2649","0","60.14","44.85"
"63","000","00","001","0131","0633","807","623","184","53","860","1423","0","60.44","43.78"
"63","000","00","001","0131","0634","709","565","144","24","733","1226","0","59.79","46.08"
"63","000","00","001","0132","0000","2097","1618","479","117","2214","3761","0","58.87","43.02"
"63","000","00","001","0132","0635","650","515","135","51","701","1158","0","60.54","44.47"
"63","000","00","001","0132","0636","784","594","190","39","823","1426","0","57.71","41.65"
"63","000","00","001","0132","0637","663","509","154","27","690","1177","0","58.62","43.25"
"63","000","00","001","0133","0000","3056","2309","747","190","3246","5355","0","60.62","43.12"
"63","000","00","001","0133","0638","745","545","200","49","794","1363","0","58.25","39.99"
"63","000","00","001","0133","0639","720","550","170","49","769","1240","0","62.02","44.35"
"63","000","00","001","0133","0640","808","627","181","50","858","1375","0","62.4","45.6"
"63","000","00","001","0133","0641","783","587","196","42","825","1377","0","59.91","42.63"
"63","000","00","001","0134","0000","1250","913","337","69","1319","2242","0","58.83","40.72"
"63","000","00","001","0134","0642","643","488","155","29","672","1225","0","54.86","39.84"
"63","000","00","001","0134","0643","607","425","182","40","647","1017","0","63.62","41.79"
"63","000","00","001","0135","0000","1716","1303","413","93","1809","3158","0","57.28","41.26"
"63","000","00","001","0135","0586","869","662","207","45","914","1525","0","59.93","43.41"
"63","000","00","001","0135","0587","847","641","206","48","895","1633","0","54.81","39.25"
"63","000","00","002","0000","0000","103041","80252","22789","6057","109098","190444","223594","57.29","42.14"
"63","000","00","002","0201","0000","2400","1967","433","96","2496","5151","0","48.46","38.19"
"63","000","00","002","0201","0644","775","626","149","26","801","2476","0","32.35","25.28"
"63","000","00","002","0201","0645","858","726","132","17","875","1381","0","63.36","52.57"
"63","000","00","002","0201","0646","767","615","152","53","820","1294","0","63.37","47.53"
"63","000","00","002","0202","0000","2225","1737","488","132","2357","3949","0","59.69","43.99"
"63","000","00","002","0202","0647","757","577","180","41","798","1351","0","59.07","42.71"
"63","000","00","002","0202","0648","715","563","152","43","758","1296","0","58.49","43.44"
"63","000","00","002","0202","0649","753","597","156","48","801","1302","0","61.52","45.85"
"63","000","00","002","0203","0000","1285","1004","281","85","1370","2446","0","56.01","41.05"
"63","000","00","002","0203","0650","527","409","118","57","584","1025","0","56.98","39.9"
"63","000","00","002","0203","0651","758","595","163","28","786","1421","0","55.31","41.87"
"63","000","00","002","0204","0000","1572","1227","345","90","1662","3076","0","54.03","39.89"
"63","000","00","002","0204","0652","800","633","167","48","848","1501","0","56.5","42.17"
"63","000","00","002","0204","0653","772","594","178","42","814","1575","0","51.68","37.71"
"63","000","00","002","0205","0000","1630","1275","355","44","1674","2898","0","57.76","44.0"
"63","000","00","002","0205","0654","842","677","165","21","863","1516","0","56.93","44.66"
"63","000","00","002","0205","0655","788","598","190","23","811","1382","0","58.68","43.27"
"63","000","00","002","0206","0000","2779","2142","637","197","2976","5054","0","58.88","42.38"
"63","000","00","002","0206","0656","607","494","113","50","657","1128","0","58.24","43.79"
"63","000","00","002","0206","0657","747","562","185","50","797","1397","0","57.05","40.23"
"63","000","00","002","0206","0658","673","506","167","54","727","1161","0","62.62","43.58"
"63","000","00","002","0206","0659","752","580","172","43","795","1368","0","58.11","42.4"
"63","000","00","002","0207","0000","2634","2043","591","142","2776","4589","0","60.49","44.52"
"63","000","00","002","0207","0660","598","470","128","25","623","1049","0","59.39","44.8"
"63","000","00","002","0207","0661","720","562","158","49","769","1308","0","58.79","42.97"
"63","000","00","002","0207","0662","674","514","160","45","719","1154","0","62.31","44.54"
"63","000","00","002","0207","0663","642","497","145","23","665","1078","0","61.69","46.1"
"63","000","00","002","0208","0000","3810","2958","852","179","3989","6667","0","59.83","44.37"
"63","000","00","002","0208","0664","762","600","162","44","806","1375","0","58.62","43.64"
"63","000","00","002","0208","0665","824","651","173","36","860","1448","0","59.39","44.96"
"63","000","00","002","0208","0666","724","562","162","25","749","1250","0","59.92","44.96"
"63","000","00","002","0208","0667","787","592","195","34","821","1381","0","59.45","42.87"
"63","000","00","002","0208","0668","713","553","160","40","753","1213","0","62.08","45.59"
"63","000","00","002","0209","0000","4917","3808","1109","252","5169","8706","0","59.37","43.74"
"63","000","00","002","0209","0669","828","636","192","39","867","1373","0","63.15","46.32"
"63","000","00","002","0209","0670","715","550","165","42","757","1226","0","61.75","44.86"
"63","000","00","002","0209","0671","667","506","161","17","684","1117","0","61.24","45.3"
"63","000","00","002","0209","0672","651","506","145","45","696","1123","0","61.98","45.06"
"63","000","00","002","0209","0673","690","538","152","38","728","1200","0","60.67","44.83"
"63","000","00","002","0209","0674","671","536","135","37","708","1335","0","53.03","40.15"
"63","000","00","002","0209","0675","695","536","159","34","729","1332","0","54.73","40.24"
"63","000","00","002","0210","0000","1721","1276","445","142","1863","3190","0","58.4","40.0"
"63","000","00","002","0210","0676","910","674","236","73","983","1648","0","59.65","40.9"
"63","000","00","002","0210","0677","811","602","209","69","880","1542","0","57.07","39.04"
"63","000","00","002","0211","0000","2402","1822","580","165","2567","4362","0","58.85","41.77"
"63","000","00","002","0211","0678","673","516","157","57","730","1228","0","59.45","42.02"
"63","000","00","002","0211","0679","948","705","243","56","1004","1731","0","58.0","40.73"
"63","000","00","002","0211","0680","781","601","180","52","833","1403","0","59.37","42.84"
"63","000","00","002","0212","0000","1746","1380","366","124","1870","3229","0","57.91","42.74"
"63","000","00","002","0212","0681","985","786","199","85","1070","1929","0","55.47","40.75"
"63","000","00","002","0212","0682","761","594","167","39","800","1300","0","61.54","45.69"
"63","000","00","002","0213","0000","2271","1730","541","150","2421","4405","0","54.96","39.27"
"63","000","00","002","0213","0683","750","589","161","31","781","1486","0","52.56","39.64"
"63","000","00","002","0213","0684","711","530","181","63","774","1532","0","50.52","34.6"
"63","000","00","002","0213","0685","810","611","199","56","866","1387","0","62.44","44.05"
"63","000","00","002","0214","0000","1778","1401","377","146","1924","3536","0","54.41","39.62"
"63","000","00","002","0214","0686","603","470","133","56","659","1195","0","55.15","39.33"
"63","000","00","002","0214","0687","552","434","118","37","589","1068","0","55.15","40.64"
"63","000","00","002","0214","0688","623","497","126","53","676","1273","0","53.1","39.04"
"63","000","00","002","0215","0000","2098","1599","499","157","2255","3898","0","57.85","41.02"
"63","000","00","002","0215","0689","776","596","180","64","840","1329","0","63.21","44.85"
"63","000","00","002","0215","0690","665","496","169","45","710","1311","0","54.16","37.83"
"63","000","00","002","0215","0691","657","507","150","48","705","1258","0","56.04","40.3"
"63","000","00","002","0216","0000","2839","2137","702","225","3064","5022","0","61.01","42.55"
"63","000","00","002","0216","0692","714","541","173","60","774","1277","0","60.61","42.36"
"63","000","00","002","0216","0693","749","569","180","64","813","1285","0","63.27","44.28"
"63","000","00","002","0216","0694","680","514","166","60","740","1161","0","63.74","44.27"
"63","000","00","002","0216","0695","696","513","183","41","737","1299","0","56.74","39.49"
"63","000","00","002","0217","0000","2666","2056","610","149","2815","4811","0","58.51","42.74"
"63","000","00","002","0217","0696","673","518","155","45","718","1243","0","57.76","41.67"
"63","000","00","002","0217","0697","655","495","160","39","694","1197","0","57.98","41.35"
"63","000","00","002","0217","0698","738","570","168","31","769","1224","0","62.83","46.57"
"63","000","00","002","0217","0699","600","473","127","34","634","1147","0","55.27","41.24"
"63","000","00","002","0218","0000","2399","1859","540","118","2517","4373","0","57.56","42.51"
"63","000","00","002","0218","0700","546","428","118","20","566","1045","0","54.16","40.96"
"63","000","00","002","0218","0701","644","513","131","30","674","1096","0","61.5","46.81"
"63","000","00","002","0218","0702","620","484","136","13","633","1115","0","56.77","43.41"
"63","000","00","002","0218","0703","589","434","155","55","644","1117","0","57.65","38.85"
"63","000","00","002","0219","0000","1997","1571","426","125","2122","3770","0","56.29","41.67"
"63","000","00","002","0219","0704","505","386","119","27","532","1019","0","52.21","37.88"
"63","000","00","002","0219","0705","751","585","166","50","801","1346","0","59.51","43.46"
"63","000","00","002","0219","0706","741","600","141","48","789","1405","0","56.16","42.7"
"63","000","00","002","0220","0000","3712","2915","797","200","3912","6448","0","60.67","45.21"
"63","000","00","002","0220","0707","758","591","167","37","795","1356","0","58.63","43.58"
"63","000","00","002","0220","0708","765","587","178","35","800","1250","0","64.0","46.96"
"63","000","00","002","0220","0709","723","564","159","41","764","1254","0","60.93","44.98"
"63","000","00","002","0220","0710","725","592","133","29","754","1317","0","57.25","44.95"
"63","000","00","002","0220","0711","741","581","160","58","799","1271","0","62.86","45.71"
"63","000","00","002","0221","0000","1046","802","244","77","1123","2004","0","56.04","40.02"
"63","000","00","002","0221","0712","520","398","122","31","551","979","0","56.28","40.65"
"63","000","00","002","0221","0713","526","404","122","46","572","1025","0","55.8","39.41"
"63","000","00","002","0222","0000","3142","2604","538","133","3275","5741","0","57.05","45.36"
"63","000","00","002","0222","0714","718","676","42","39","757","1512","0","50.07","44.71"
"63","000","00","002","0222","0715","843","664","179","36","879","1483","0","59.27","44.77"
"63","000","00","002","0222","0716","792","635","157","36","828","1359","0","60.93","46.73"
"63","000","00","002","0222","0717","789","629","160","22","811","1387","0","58.47","45.35"
"63","000","00","002","0223","0000","2418","1843","575","119","2537","4448","0","57.04","41.43"
"63","000","00","002","0223","0718","754","578","176","28","782","1455","0","53.75","39.73"
"63","000","00","002","0223","0719","811","602","209","28","839","1461","0","57.43","41.2"
"63","000","00","002","0223","0720","853","663","190","63","916","1532","0","59.79","43.28"
"63","000","00","002","0224","0000","2263","1684","579","163","2426","3964","0","61.2","42.48"
"63","000","00","002","0224","0721","628","472","156","41","669","1043","0","64.14","45.25"
"63","000","00","002","0224","0722","516","380","136","37","553","875","0","63.2","43.43"
"63","000","00","002","0224","0723","498","376","122","24","522","927","0","56.31","40.56"
"63","000","00","002","0224","0724","621","456","165","61","682","1119","0","60.95","40.75"
"63","000","00","002","0225","0000","3891","2962","929","266","4157","7061","0","58.87","41.95"
"63","000","00","002","0225","0725","801","600","201","59","860","1463","0","58.78","41.01"
"63","000","00","002","0225","0726","776","595","181","42","818","1293","0","63.26","46.02"
"63","000","00","002","0225","0727","809","608","201","64","873","1553","0","56.21","39.15"
"63","000","00","002","0225","0728","740","571","169","38","778","1360","0","57.21","41.99"
"63","000","00","002","0225","0729","765","588","177","63","828","1392","0","59.48","42.24"
"63","000","00","002","0226","0000","2918","2223","695","137","3055","5430","0","56.26","40.94"
"63","000","00","002","0226","0730","750","559","191","24","774","1377","0","56.21","40.6"
"63","000","00","002","0226","0731","769","615","154","16","785","1377","0","57.01","44.66"
"63","000","00","002","0226","0732","630","461","169","36","666","1269","0","52.48","36.33"
"63","000","00","002","0226","0733","769","588","181","61","830","1407","0","58.99","41.79"
"63","000","00","002","0227","0000","1986","1520","466","119","2105","3609","0","58.33","42.12"
"63","000","00","002","0227","0734","638","477","161","41","679","1172","0","57.94","40.7"
"63","000","00","002","0227","0735","658","520","138","20","678","1182","0","57.36","43.99"
"63","000","00","002","0227","0736","690","523","167","58","748","1255","0","59.6","41.67"
"63","000","00","002","0228","0000","2247","1809","438","101","2348","4437","0","52.92","40.77"
"63","000","00","002","0228","0737","838","653","185","35","873","1689","0","51.69","38.66"
"63","000","00","002","0228","0738","789","651","138","31","820","1605","0","51.09","40.56"
"63","000","00","002","0228","0739","620","505","115","35","655","1143","0","57.31","44.18"
"63","000","00","002","0229","0000","3141","2429","712","194","3335","5898","0","56.54","41.18"
"63","000","00","002","0229","0740","740","593","147","37","777","1440","0","53.96","41.18"
"63","000","00","002","0229","0741","810","620","190","46","856","1495","0","57.26","41.47"
"63","000","00","002","0229","0742","855","630","225","55","910","1514","0","60.11","41.61"
"63","000","00","002","0229","0743","736","586","150","56","792","1449","0","54.66","40.44"
"63","000","00","002","0230","0000","4367","3545","822","208","4575","7867","0","58.15","45.06"
"63","000","00","002","0230","0744","792","605","187","58","850","1401","0","60.67","43.18"
"63","000","00","002","0230","0745","609","479","130","21","630","1181","0","53.34","40.56"
"63","000","00","002","0230","0746","818","762","56","30","848","1376","0","61.63","55.38"
"63","000","00","002","0230","0747","821","658","163","50","871","1422","0","61.25","46.27"
"63","000","00","002","0230","0748","698","566","132","25","723","1267","0","57.06","44.67"
"63","000","00","002","0230","0749","629","475","154","24","653","1220","0","53.52","38.93"
"63","000","00","002","0231","0000","2370","1857","513","101","2471","4622","0","53.46","40.18"
"63","000","00","002","0231","0750","767","602","165","25","792","1562","0","50.7","38.54"
"63","000","00","002","0231","0751","770","594","176","28","798","1455","0","54.85","40.82"
"63","000","00","002","0231","0752","833","661","172","48","881","1605","0","54.89","41.18"
"63","000","00","002","0232","0000","3279","2558","721","151","3430","6070","0","56.51","42.14"
"63","000","00","002","0232","0753","971","788","183","23","994","1626","0","61.13","48.46"
"63","000","00","002","0232","0754","862","678","184","71","933","1561","0","59.77","43.43"
"63","000","00","002","0232","0755","713","528","185","31","744","1547","0","48.09","34.13"
"63","000","00","002","0232","0756","733","564","169","26","759","1336","0","56.81","42.22"
"63","000","00","002","0233","0000","3558","2776","782","238","3796","6899","0","55.02","40.24"
"63","000","00","002","0233","0757","625","490","135","39","664","1314","0","50.53","37.29"
"63","000","00","002","0233","0758","650","509","141","42","692","1297","0","53.35","39.24"
"63","000","00","002","0233","0759","697","550","147","61","758","1366","0","55.49","40.26"
"63","000","00","002","0233","0760","791","608","183","47","838","1472","0","56.93","41.3"
"63","000","00","002","0233","0761","795","619","176","49","844","1450","0","58.21","42.69"
"63","000","00","002","0234","0000","2302","1753","549","172","2474","4100","0","60.34","42.76"
"63","000","00","002","0234","0762","723","548","175","50","773","1328","0","58.21","41.27"
"63","000","00","002","0234","0763","799","604","195","56","855","1399","0","61.12","43.17"
"63","000","00","002","0234","0764","780","601","179","66","846","1373","0","61.62","43.77"
"63","000","00","002","0235","0000","1856","1460","396","113","1969","3592","0","54.82","40.65"
"63","000","00","002","0235","0765","546","416","130","42","588","1099","0","53.5","37.85"
"63","000","00","002","0235","0766","661","512","149","49","710","1226","0","57.91","41.76"
"63","000","00","002","0235","0767","649","532","117","22","671","1267","0","52.96","41.99"
"63","000","00","002","0236","0000","3316","2668","648","188","3504","6247","0","56.09","42.71"
"63","000","00","002","0236","0768","821","622","199","58","879","1531","0","57.41","40.63"
"63","000","00","002","0236","0769","822","647","175","51","873","1438","0","60.71","44.99"
"63","000","00","002","0236","0770","858","677","181","27","885","1657","0","53.41","40.86"
"63","000","00","002","0236","0771","815","722","93","52","867","1621","0","53.49","44.54"
"63","000","00","002","0237","0000","1595","1248","347","72","1667","2842","0","58.66","43.91"
"63","000","00","002","0237","0772","842","657","185","26","868","1508","0","57.56","43.57"
"63","000","00","002","0237","0773","753","591","162","46","799","1334","0","59.9","44.3"
"63","000","00","002","0238","0000","1889","1456","433","116","2005","3662","0","54.75","39.76"
"63","000","00","002","0238","0774","549","427","122","43","592","1246","0","47.51","34.27"
"63","000","00","002","0238","0775","651","486","165","46","697","1196","0","58.28","40.64"
"63","000","00","002","0238","0776","689","543","146","27","716","1220","0","58.69","44.51"
"63","000","00","002","0239","0000","3255","2546","709","237","3492","6210","0","56.23","41.0"
"63","000","00","002","0239","0777","804","627","177","38","842","1538","0","54.75","40.77"
"63","000","00","002","0239","0778","885","696","189","55","940","1565","0","60.06","44.47"
"63","000","00","002","0239","0779","791","628","163","79","870","1621","0","53.67","38.74"
"63","000","00","002","0239","0780","775","595","180","65","840","1486","0","56.53","40.04"
"63","000","00","002","0240","0000","2354","1845","509","142","2496","4310","0","57.91","42.81"
"63","000","00","002","0240","0781","775","614","161","25","800","1507","0","53.09","40.74"
"63","000","00","002","0240","0782","836","649","187","57","893","1516","0","58.91","42.81"
"63","000","00","002","0240","0783","743","582","161","60","803","1287","0","62.39","45.22"
"63","000","00","002","0241","0000","967","757","210","92","1059","1851","0","57.21","40.9"
"63","000","00","002","0241","0784","505","399","106","56","561","1050","0","53.43","38.0"
"63","000","00","002","0241","0785","462","358","104","36","498","801","0","62.17","44.69"
"63","000","00","003","0000","0000","137409","105524","31885","7116","144525","252645","308835","57.2","41.77"
"63","000","00","003","0301","0000","2635","2041","594","102","2737","4848","0","56.46","42.1"
"63","000","00","003","0301","1214","625","474","151","20","645","1184","0","54.48","40.03"
"63","000","00","003","0301","1215","617","485","132","35","652","1197","0","54.47","40.52"
"63","000","00","003","0301","1216","678","508","170","19","697","1221","0","57.08","41.61"
"63","000","00","003","0301","1217","715","574","141","28","743","1246","0","59.63","46.07"
"63","000","00","003","0302","0000","2474","1879","595","148","2622","4386","0","59.78","42.84"
"63","000","00","003","0302","1218","860","629","231","44","904","1478","0","61.16","42.56"
"63","000","00","003","0302","1219","699","538","161","54","753","1314","0","57.31","40.94"
"63","000","00","003","0302","1220","915","712","203","50","965","1594","0","60.54","44.67"
"63","000","00","003","0303","0000","3304","2552","752","137","3441","5767","0","59.67","44.25"
"63","000","00","003","0303","1221","824","623","201","34","858","1429","0","60.04","43.6"
"63","000","00","003","0303","1222","850","688","162","26","876","1452","0","60.33","47.38"
"63","000","00","003","0303","1223","870","657","213","23","893","1551","0","57.58","42.36"
"63","000","00","003","0303","1224","760","584","176","54","814","1335","0","60.97","43.75"
"63","000","00","003","0304","0000","3608","2655","953","217","3825","6795","0","56.29","39.07"
"63","000","00","003","0304","1225","620","480","140","26","646","1196","0","54.01","40.13"
"63","000","00","003","0304","1226","698","503","195","37","735","1339","0","54.89","37.57"
"63","000","00","003","0304","1227","775","550","225","35","810","1448","0","55.94","37.98"
"63","000","00","003","0304","1228","750","576","174","47","797","1373","0","58.05","41.95"
"63","000","00","003","0304","1229","765","546","219","72","837","1439","0","58.17","37.94"
"63","000","00","003","0305","0000","2211","1670","541","108","2319","4461","0","51.98","37.44"
"63","000","00","003","0305","1230","606","445","161","14","620","1174","0","52.81","37.9"
"63","000","00","003","0305","1231","566","420","146","33","599","1144","0","52.36","36.71"
"63","000","00","003","0305","1232","576","458","118","25","601","1119","0","53.71","40.93"
"63","000","00","003","0305","1233","463","347","116","36","499","1024","0","48.73","33.89"
"63","000","00","003","0306","0000","2913","2318","595","153","3066","5067","0","60.51","45.75"
"63","000","00","003","0306","1234","608","491","117","21","629","1032","0","60.95","47.58"
"63","000","00","003","0306","1235","747","643","104","43","790","1319","0","59.89","48.75"
"63","000","00","003","0306","1236","802","647","155","42","844","1369","0","61.65","47.26"
"63","000","00","003","0306","1237","756","537","219","47","803","1347","0","59.61","39.87"
"63","000","00","003","0307","0000","2998","2231","767","126","3124","5988","0","52.17","37.26"
"63","000","00","003","0307","1238","822","584","238","44","866","1655","0","52.33","35.29"
"63","000","00","003","0307","1239","783","599","184","22","805","1595","0","50.47","37.55"
"63","000","00","003","0307","1240","747","557","190","31","778","1429","0","54.44","38.98"
"63","000","00","003","0307","1241","646","491","155","29","675","1309","0","51.57","37.51"
"63","000","00","003","0308","0000","1453","1059","394","83","1536","2818","0","54.51","37.58"
"63","000","00","003","0308","1242","775","578","197","42","817","1508","0","54.18","38.33"
"63","000","00","003","0308","1243","678","481","197","41","719","1310","0","54.89","36.72"
"63","000","00","003","0309","0000","1818","1346","472","104","1922","3667","0","52.41","36.71"
"63","000","00","003","0309","1244","609","445","164","30","639","1233","0","51.82","36.09"
"63","000","00","003","0309","1245","640","483","157","49","689","1287","0","53.54","37.53"
"63","000","00","003","0309","1246","569","418","151","25","594","1147","0","51.79","36.44"
"63","000","00","003","0310","0000","3297","2527","770","212","3509","6508","0","53.92","38.83"
"63","000","00","003","0310","1247","644","477","167","32","676","1260","0","53.65","37.86"
"63","000","00","003","0310","1248","707","553","154","50","757","1377","0","54.97","40.16"
"63","000","00","003","0310","1249","645","472","173","70","715","1284","0","55.69","36.76"
"63","000","00","003","0310","1250","657","536","121","26","683","1314","0","51.98","40.79"
"63","000","00","003","0310","1251","644","489","155","34","678","1273","0","53.26","38.41"
"63","000","00","003","0311","0000","2770","2032","738","123","2893","4829","0","59.91","42.08"
"63","000","00","003","0311","1252","646","452","194","24","670","1146","0","58.46","39.44"
"63","000","00","003","0311","1253","725","525","200","29","754","1285","0","58.68","40.86"
"63","000","00","003","0311","1254","753","555","198","31","784","1297","0","60.45","42.79"
"63","000","00","003","0311","1255","646","500","146","39","685","1101","0","62.22","45.41"
"63","000","00","003","0312","0000","2241","1652","589","134","2375","4047","0","58.69","40.82"
"63","000","00","003","0312","1256","697","514","183","53","750","1310","0","57.25","39.24"
"63","000","00","003","0312","1257","786","577","209","55","841","1365","0","61.61","42.27"
"63","000","00","003","0312","1258","758","561","197","26","784","1372","0","57.14","40.89"
"63","000","00","003","0313","0000","2072","1554","518","101","2173","3596","0","60.43","43.21"
"63","000","00","003","0313","1259","691","514","177","29","720","1189","0","60.56","43.23"
"63","000","00","003","0313","1260","709","537","172","40","749","1256","0","59.63","42.75"
"63","000","00","003","0313","1261","672","503","169","32","704","1151","0","61.16","43.7"
"63","000","00","003","0314","0000","3561","2826","735","179","3740","6129","0","61.02","46.11"
"63","000","00","003","0314","1262","891","690","201","39","930","1501","0","61.96","45.97"
"63","000","00","003","0314","1263","864","779","85","44","908","1520","0","59.74","51.25"
"63","000","00","003","0314","1264","888","662","226","53","941","1529","0","61.54","43.3"
"63","000","00","003","0314","1265","918","695","223","43","961","1579","0","60.86","44.02"
"63","000","00","003","0315","0000","3000","2223","777","98","3098","6705","0","46.2","33.15"
"63","000","00","003","0315","1266","643","484","159","29","672","2619","0","25.66","18.48"
"63","000","00","003","0315","1267","706","553","153","25","731","1290","0","56.67","42.87"
"63","000","00","003","0315","1268","800","557","243","18","818","1307","0","62.59","42.62"
"63","000","00","003","0315","1269","851","629","222","26","877","1489","0","58.9","42.24"
"63","000","00","003","0316","0000","2733","2139","594","123","2856","4884","0","58.48","43.8"
"63","000","00","003","0316","1270","649","520","129","33","682","1097","0","62.17","47.4"
"63","000","00","003","0316","1271","742","571","171","35","777","1328","0","58.51","43.0"
"63","000","00","003","0316","1272","638","488","150","30","668","1189","0","56.18","41.04"
"63","000","00","003","0316","1273","704","560","144","25","729","1270","0","57.4","44.09"
"63","000","00","003","0317","0000","2913","2181","732","122","3035","5155","0","58.87","42.31"
"63","000","00","003","0317","1274","744","546","198","15","759","1349","0","56.26","40.47"
"63","000","00","003","0317","1275","704","542","162","24","728","1292","0","56.35","41.95"
"63","000","00","003","0317","1276","772","586","186","36","808","1314","0","61.49","44.6"
"63","000","00","003","0317","1277","693","507","186","47","740","1200","0","61.67","42.25"
"63","000","00","003","0318","0000","1747","1306","441","71","1818","3119","0","58.29","41.87"
"63","000","00","003","0318","1278","868","641","227","34","902","1558","0","57.89","41.14"
"63","000","00","003","0318","1279","879","665","214","37","916","1561","0","58.68","42.6"
"63","000","00","003","0319","0000","1683","1313","370","78","1761","2945","0","59.8","44.58"
"63","000","00","003","0319","1280","824","661","163","51","875","1446","0","60.51","45.71"
"63","000","00","003","0319","1281","859","652","207","27","886","1499","0","59.11","43.5"
"63","000","00","003","0320","0000","1634","1237","397","70","1704","2978","0","57.22","41.54"
"63","000","00","003","0320","1282","826","651","175","33","859","1467","0","58.55","44.38"
"63","000","00","003","0320","1283","808","586","222","37","845","1511","0","55.92","38.78"
"63","000","00","003","0321","0000","2653","2010","643","136","2789","4640","0","60.11","43.32"
"63","000","00","003","0321","1284","908","678","230","54","962","1600","0","60.13","42.38"
"63","000","00","003","0321","1285","893","661","232","39","932","1573","0","59.25","42.02"
"63","000","00","003","0321","1286","852","671","181","43","895","1467","0","61.01","45.74"
"63","000","00","003","0322","0000","3192","2465","727","196","3388","5891","0","57.51","41.84"
"63","000","00","003","0322","1287","732","575","157","66","798","1358","0","58.76","42.34"
"63","000","00","003","0322","1288","845","637","208","59","904","1568","0","57.65","40.63"
"63","000","00","003","0322","1289","803","622","181","42","845","1411","0","59.89","44.08"
"63","000","00","003","0322","1290","812","631","181","29","841","1554","0","54.12","40.6"
"63","000","00","003","0323","0000","3390","2774","616","114","3504","5712","0","61.34","48.56"
"63","000","00","003","0323","1291","792","633","159","30","822","1345","0","61.12","47.06"
"63","000","00","003","0323","1292","812","669","143","23","835","1435","0","58.19","46.62"
"63","000","00","003","0323","1293","896","731","165","28","924","1481","0","62.39","49.36"
"63","000","00","003","0323","1294","890","741","149","33","923","1451","0","63.61","51.07"
"63","000","00","003","0326","0000","1716","1277","439","100","1816","3091","0","58.75","41.31"
"63","000","00","003","0326","1295","854","629","225","70","924","1566","0","59.0","40.17"
"63","000","00","003","0326","1296","862","648","214","30","892","1525","0","58.49","42.49"
"63","000","00","003","0327","0000","2213","1696","517","130","2343","4215","0","55.59","40.24"
"63","000","00","003","0327","1297","709","564","145","43","752","1336","0","56.29","42.22"
"63","000","00","003","0327","1298","823","620","203","58","881","1483","0","59.41","41.81"
"63","000","00","003","0327","1299","681","512","169","29","710","1396","0","50.86","36.68"
"63","000","00","003","0328","0000","3090","2486","604","164","3254","5535","0","58.79","44.91"
"63","000","00","003","0328","1300","807","646","161","63","870","1406","0","61.88","45.95"
"63","000","00","003","0328","1301","773","620","153","33","806","1434","0","56.21","43.24"
"63","000","00","003","0328","1302","707","586","121","38","745","1288","0","57.84","45.5"
"63","000","00","003","0328","1303","803","634","169","30","833","1407","0","59.2","45.06"
"63","000","00","003","0329","0000","2326","1808","518","131","2457","4554","0","53.95","39.7"
"63","000","00","003","0329","1304","781","595","186","33","814","1514","0","53.76","39.3"
"63","000","00","003","0329","1305","725","563","162","46","771","1550","0","49.74","36.32"
"63","000","00","003","0329","1306","820","650","170","52","872","1490","0","58.52","43.62"
"63","000","00","003","0330","0000","2564","1943","621","128","2692","4663","0","57.73","41.67"
"63","000","00","003","0330","1307","677","532","145","36","713","1284","0","55.53","41.43"
"63","000","00","003","0330","1308","647","501","146","31","678","1129","0","60.05","44.38"
"63","000","00","003","0330","1309","679","502","177","23","702","1193","0","58.84","42.08"
"63","000","00","003","0330","1310","561","408","153","38","599","1057","0","56.67","38.6"
"63","000","00","003","0331","0000","2758","2104","654","237","2995","5453","0","54.92","38.58"
"63","000","00","003","0331","1311","742","573","169","44","786","1361","0","57.75","42.1"
"63","000","00","003","0331","1312","742","578","164","54","796","1412","0","56.37","40.93"
"63","000","00","003","0331","1313","646","481","165","33","679","1423","0","47.72","33.8"
"63","000","00","003","0331","1314","628","472","156","106","734","1257","0","58.39","37.55"
"63","000","00","003","0332","0000","2748","2071","677","169","2917","4829","0","60.41","42.89"
"63","000","00","003","0332","1315","663","519","144","40","703","1133","0","62.05","45.81"
"63","000","00","003","0332","1316","580","408","172","28","608","1077","0","56.45","37.88"
"63","000","00","003","0332","1317","746","555","191","44","790","1300","0","60.77","42.69"
"63","000","00","003","0332","1318","759","589","170","57","816","1319","0","61.87","44.66"
"63","000","00","003","0333","0000","1966","1519","447","133","2099","3633","0","57.78","41.81"
"63","000","00","003","0333","1319","686","522","164","75","761","1265","0","60.16","41.26"
"63","000","00","003","0333","1320","655","496","159","30","685","1265","0","54.15","39.21"
"63","000","00","003","0333","1321","625","501","124","28","653","1103","0","59.2","45.42"
"63","000","00","003","0334","0000","2255","1768","487","110","2365","3958","0","59.75","44.67"
"63","000","00","003","0334","1322","763","610","153","33","796","1341","0","59.36","45.49"
"63","000","00","003","0334","1323","781","632","149","42","823","1357","0","60.65","46.57"
"63","000","00","003","0334","1324","711","526","185","35","746","1260","0","59.21","41.75"
"63","000","00","003","0335","0000","2073","1625","448","105","2178","3844","0","56.66","42.27"
"63","000","00","003","0335","1325","738","572","166","36","774","1295","0","59.77","44.17"
"63","000","00","003","0335","1326","706","566","140","34","740","1399","0","52.89","40.46"
"63","000","00","003","0335","1327","629","487","142","35","664","1150","0","57.74","42.35"
"63","000","00","003","0336","0000","2761","2188","573","122","2883","5149","0","55.99","42.49"
"63","000","00","003","0336","1328","673","544","129","30","703","1351","0","52.04","40.27"
"63","000","00","003","0336","1329","742","566","176","50","792","1341","0","59.06","42.21"
"63","000","00","003","0336","1330","606","474","132","22","628","1129","0","55.62","41.98"
"63","000","00","003","0336","1331","740","604","136","20","760","1328","0","57.23","45.48"
"63","000","00","003","0337","0000","3400","2821","579","146","3546","6080","0","58.32","46.4"
"63","000","00","003","0337","1332","938","803","135","34","972","1557","0","62.43","51.57"
"63","000","00","003","0337","1333","884","711","173","43","927","1461","0","63.45","48.67"
"63","000","00","003","0337","1334","786","648","138","32","818","1589","0","51.48","40.78"
"63","000","00","003","0337","1335","792","659","133","37","829","1473","0","56.28","44.74"
"63","000","00","003","0338","0000","1833","1421","412","101","1934","3311","0","58.41","42.92"
"63","000","00","003","0338","1336","805","634","171","38","843","1479","0","57.0","42.87"
"63","000","00","003","0338","1337","492","365","127","34","526","833","0","63.15","43.82"
"63","000","00","003","0338","1338","536","422","114","29","565","999","0","56.56","42.24"
"63","000","00","003","0339","0000","998","792","206","45","1043","1757","0","59.36","45.08"
"63","000","00","003","0339","1339","998","792","206","45","1043","1757","0","59.36","45.08"
"63","000","00","003","0340","0000","4299","3230","1069","221","4520","7674","0","58.9","42.09"
"63","000","00","003","0340","1340","785","578","207","36","821","1573","0","52.19","36.75"
"63","000","00","003","0340","1341","939","708","231","46","985","1587","0","62.07","44.61"
"63","000","00","003","0340","1342","866","646","220","48","914","1496","0","61.1","43.18"
"63","000","00","003","0340","1343","807","602","205","37","844","1440","0","58.61","41.81"
"63","000","00","003","0340","1344","902","696","206","54","956","1578","0","60.58","44.11"
"63","000","00","003","0341","0000","2046","1509","537","61","2107","3594","0","58.63","41.99"
"63","000","00","003","0341","1345","689","518","171","27","716","1223","0","58.54","42.35"
"63","000","00","003","0341","1346","625","454","171","17","642","1119","0","57.37","40.57"
"63","000","00","003","0341","1347","732","537","195","17","749","1252","0","59.82","42.89"
"63","000","00","003","0343","0000","4013","3016","997","163","4176","7232","0","57.74","41.7"
"63","000","00","003","0343","1348","896","673","223","34","930","1576","0","59.01","42.7"
"63","000","00","003","0343","1349","768","584","184","39","807","1425","0","56.63","40.98"
"63","000","00","003","0343","1350","786","590","196","21","807","1450","0","55.66","40.69"
"63","000","00","003","0343","1351","764","575","189","39","803","1444","0","55.61","39.82"
"63","000","00","003","0343","1352","799","594","205","30","829","1337","0","62.0","44.43"
"63","000","00","003","0344","0000","2772","2143","629","191","2963","5100","0","58.1","42.02"
"63","000","00","003","0344","1353","735","562","173","35","770","1417","0","54.34","39.66"
"63","000","00","003","0344","1354","679","519","160","44","723","1250","0","57.84","41.52"
"63","000","00","003","0344","1355","626","486","140","60","686","1176","0","58.33","41.33"
"63","000","00","003","0344","1356","732","576","156","52","784","1257","0","62.37","45.82"
"63","000","00","003","0346","0000","2650","2049","601","164","2814","4851","0","58.01","42.24"
"63","000","00","003","0346","1357","698","534","164","51","749","1257","0","59.59","42.48"
"63","000","00","003","0346","1358","639","495","144","30","669","1148","0","58.28","43.12"
"63","000","00","003","0346","1359","762","597","165","59","821","1418","0","57.9","42.1"
"63","000","00","003","0346","1360","551","423","128","24","575","1028","0","55.93","41.15"
"63","000","00","003","0347","0000","3780","2929","851","215","3995","6796","0","58.78","43.1"
"63","000","00","003","0347","1361","821","627","194","46","867","1445","0","60.0","43.39"
"63","000","00","003","0347","1362","766","620","146","43","809","1361","0","59.44","45.55"
"63","000","00","003","0347","1363","777","603","174","45","822","1343","0","61.21","44.9"
"63","000","00","003","0347","1364","706","547","159","45","751","1267","0","59.27","43.17"
"63","000","00","003","0347","1365","710","532","178","36","746","1380","0","54.06","38.55"
"63","000","00","003","0348","0000","2272","1797","475","147","2419","4312","0","56.1","41.67"
"63","000","00","003","0348","1366","802","623","179","54","856","1524","0","56.17","40.88"
"63","000","00","003","0348","1367","817","641","176","41","858","1470","0","58.37","43.61"
"63","000","00","003","0348","1368","653","533","120","52","705","1318","0","53.49","40.44"
"63","000","00","003","0349","0000","2206","1685","521","118","2324","4254","0","54.63","39.61"
"63","000","00","003","0349","1369","727","551","176","39","766","1430","0","53.57","38.53"
"63","000","00","003","0349","1370","751","572","179","45","796","1386","0","57.43","41.27"
"63","000","00","003","0349","1371","728","562","166","34","762","1438","0","52.99","39.08"
"63","000","00","003","0350","0000","2749","2126","623","152","2901","5267","0","55.08","40.36"
"63","000","00","003","0350","1372","631","487","144","18","649","1270","0","51.1","38.35"
"63","000","00","003","0350","1373","732","560","172","48","780","1395","0","55.91","40.14"
"63","000","00","003","0350","1374","696","551","145","43","739","1292","0","57.2","42.65"
"63","000","00","003","0350","1375","690","528","162","43","733","1310","0","55.95","40.31"
"63","000","00","003","0351","0000","2843","2177","666","114","2957","5321","0","55.57","40.91"
"63","000","00","003","0351","1376","704","535","169","36","740","1319","0","56.1","40.56"
"63","000","00","003","0351","1377","760","575","185","23","783","1355","0","57.79","42.44"
"63","000","00","003","0351","1378","662","504","158","28","690","1312","0","52.59","38.41"
"63","000","00","003","0351","1379","717","563","154","27","744","1335","0","55.73","42.17"
"63","000","00","003","0352","0000","2131","1625","506","95","2226","4124","0","53.98","39.4"
"63","000","00","003","0352","1380","745","575","170","35","780","1489","0","52.38","38.62"
"63","000","00","003","0352","1381","717","558","159","29","746","1307","0","57.08","42.69"
"63","000","00","003","0352","1382","669","492","177","31","700","1328","0","52.71","37.05"
"63","000","00","003","0353","0000","2787","2128","659","146","2933","5169","0","56.74","41.17"
"63","000","00","003","0353","1383","655","508","147","9","664","1277","0","52.0","39.78"
"63","000","00","003","0353","1384","712","560","152","36","748","1314","0","56.93","42.62"
"63","000","00","003","0353","1385","713","529","184","54","767","1270","0","60.39","41.65"
"63","000","00","003","0353","1386","707","531","176","47","754","1308","0","57.65","40.6"
"63","000","00","003","0354","0000","2011","1574","437","91","2102","3647","0","57.64","43.16"
"63","000","00","003","0354","1387","650","496","154","27","677","1138","0","59.49","43.59"
"63","000","00","003","0354","1388","710","561","149","29","739","1333","0","55.44","42.09"
"63","000","00","003","0354","1389","651","517","134","35","686","1176","0","58.33","43.96"
"63","000","00","003","0355","0000","2928","2243","685","168","3096","5436","0","56.95","41.26"
"63","000","00","003","0355","1390","713","528","185","46","759","1311","0","57.89","40.27"
"63","000","00","003","0355","1391","696","533","163","27","723","1295","0","55.83","41.16"
"63","000","00","003","0355","1392","777","596","181","51","828","1421","0","58.27","41.94"
"63","000","00","003","0355","1393","742","586","156","44","786","1409","0","55.78","41.59"
"63","000","00","003","0356","0000","3641","2797","844","215","3856","6534","0","59.01","42.81"
"63","000","00","003","0356","1394","798","623","175","43","841","1434","0","58.65","43.44"
"63","000","00","003","0356","1395","728","543","185","55","783","1449","0","54.04","37.47"
"63","000","00","003","0356","1396","699","524","175","60","759","1284","0","59.11","40.81"
"63","000","00","003","0356","1397","689","554","135","28","717","1248","0","57.45","44.39"
"63","000","00","003","0356","1398","727","553","174","29","756","1119","0","67.56","49.42"
"63","000","00","003","0357","0000","1280","987","293","99","1379","2327","0","59.26","42.42"
"63","000","00","003","0357","1399","501","413","88","36","537","883","0","60.82","46.77"
"63","000","00","003","0357","1400","323","248","75","35","358","630","0","56.83","39.37"
"63","000","00","003","0357","1401","456","326","130","28","484","814","0","59.46","40.05"
"63","000","00","004","0000","0000","103928","78403","25525","6836","110764","195148","229680","56.76","40.18"
"63","000","00","004","0401","0000","1502","1155","347","81","1583","2854","0","55.47","40.47"
"63","000","00","004","0401","0786","824","651","173","47","871","1522","0","57.23","42.77"
"63","000","00","004","0401","0787","678","504","174","34","712","1332","0","53.45","37.84"
"63","000","00","004","0402","0000","2268","1685","583","161","2429","4755","0","51.08","35.44"
"63","000","00","004","0402","0788","782","584","198","54","836","1656","0","50.48","35.27"
"63","000","00","004","0402","0789","662","474","188","48","710","1367","0","51.94","34.67"
"63","000","00","004","0402","0790","824","627","197","59","883","1732","0","50.98","36.2"
"63","000","00","004","0403","0000","1736","1287","449","103","1839","3284","0","56.0","39.19"
"63","000","00","004","0403","0791","883","673","210","54","937","1634","0","57.34","41.19"
"63","000","00","004","0403","0792","853","614","239","49","902","1650","0","54.67","37.21"
"63","000","00","004","0404","0000","2279","1656","623","122","2401","4046","0","59.34","40.93"
"63","000","00","004","0404","0793","766","557","209","47","813","1392","0","58.41","40.01"
"63","000","00","004","0404","0794","701","501","200","25","726","1177","0","61.68","42.57"
"63","000","00","004","0404","0795","812","598","214","50","862","1477","0","58.36","40.49"
"63","000","00","004","0405","0000","1188","895","293","106","1294","2359","0","54.85","37.94"
"63","000","00","004","0405","0796","524","385","139","57","581","1063","0","54.66","36.22"
"63","000","00","004","0405","0797","664","510","154","49","713","1296","0","55.02","39.35"
"63","000","00","004","0406","0000","3029","2269","760","186","3215","6065","0","53.01","37.41"
"63","000","00","004","0406","0798","676","512","164","34","710","1330","0","53.38","38.5"
"63","000","00","004","0406","0799","742","513","229","54","796","1483","0","53.67","34.59"
"63","000","00","004","0406","0800","781","610","171","40","821","1542","0","53.24","39.56"
"63","000","00","004","0406","0801","830","634","196","58","888","1710","0","51.93","37.08"
"63","000","00","004","0407","0000","1904","1459","445","144","2048","3822","0","53.58","38.17"
"63","000","00","004","0407","0802","630","486","144","36","666","1315","0","50.65","36.96"
"63","000","00","004","0407","0803","627","483","144","70","697","1245","0","55.98","38.8"
"63","000","00","004","0407","0804","647","490","157","38","685","1262","0","54.28","38.83"
"63","000","00","004","0408","0000","3201","2368","833","228","3429","6149","0","55.77","38.51"
"63","000","00","004","0408","0805","809","584","225","62","871","1518","0","57.38","38.47"
"63","000","00","004","0408","0806","812","610","202","64","876","1522","0","57.56","40.08"
"63","000","00","004","0408","0807","762","538","224","67","829","1580","0","52.47","34.05"
"63","000","00","004","0408","0808","818","636","182","35","853","1529","0","55.79","41.6"
"63","000","00","004","0409","0000","1874","1421","453","109","1983","3581","0","55.38","39.68"
"63","000","00","004","0409","0809","635","505","130","50","685","1221","0","56.1","41.36"
"63","000","00","004","0409","0810","690","504","186","34","724","1221","0","59.3","41.28"
"63","000","00","004","0409","0811","549","412","137","25","574","1139","0","50.4","36.17"
"63","000","00","004","0410","0000","2193","1640","553","166","2359","4306","0","54.78","38.09"
"63","000","00","004","0410","0812","730","519","211","77","807","1407","0","57.36","36.89"
"63","000","00","004","0410","0813","711","533","178","46","757","1321","0","57.31","40.35"
"63","000","00","004","0410","0814","752","588","164","43","795","1578","0","50.38","37.26"
"63","000","00","004","0411","0000","2416","1820","596","175","2591","4917","0","52.69","37.01"
"63","000","00","004","0411","0815","847","666","181","48","895","1739","0","51.47","38.3"
"63","000","00","004","0411","0816","797","590","207","58","855","1637","0","52.23","36.04"
"63","000","00","004","0411","0817","772","564","208","69","841","1541","0","54.57","36.6"
"63","000","00","004","0412","0000","1943","1435","508","150","2093","3765","0","55.59","38.11"
"63","000","00","004","0412","0818","674","492","182","49","723","1210","0","59.75","40.66"
"63","000","00","004","0412","0819","679","510","169","45","724","1331","0","54.4","38.32"
"63","000","00","004","0412","0820","590","433","157","56","646","1224","0","52.78","35.38"
"63","000","00","004","0413","0000","1785","1485","300","96","1881","3209","0","58.62","46.28"
"63","000","00","004","0413","0824","983","818","165","55","1038","1805","0","57.51","45.32"
"63","000","00","004","0413","0825","802","667","135","41","843","1404","0","60.04","47.51"
"63","000","00","004","0414","0000","4482","3388","1094","270","4752","7819","0","60.78","43.33"
"63","000","00","004","0414","0826","1023","756","267","44","1067","1708","0","62.47","44.26"
"63","000","00","004","0414","0827","864","661","203","53","917","1451","0","63.2","45.55"
"63","000","00","004","0414","0828","972","704","268","69","1041","1684","0","61.82","41.81"
"63","000","00","004","0414","0829","859","688","171","32","891","1585","0","56.21","43.41"
"63","000","00","004","0414","0830","764","579","185","72","836","1391","0","60.1","41.62"
"63","000","00","004","0415","0000","3207","2429","778","142","3349","5575","0","60.07","43.57"
"63","000","00","004","0415","0831","850","631","219","62","912","1375","0","66.33","45.89"
"63","000","00","004","0415","0832","862","651","211","12","874","1472","0","59.38","44.23"
"63","000","00","004","0415","0833","707","529","178","34","741","1327","0","55.84","39.86"
"63","000","00","004","0415","0834","788","618","170","34","822","1401","0","58.67","44.11"
"63","000","00","004","0416","0000","4432","3335","1097","212","4644","7980","0","58.2","41.79"
"63","000","00","004","0416","0835","779","608","171","56","835","1423","0","58.68","42.73"
"63","000","00","004","0416","0836","881","644","237","46","927","1569","0","59.08","41.05"
"63","000","00","004","0416","0837","921","686","235","31","952","1651","0","57.66","41.55"
"63","000","00","004","0416","0838","864","640","224","22","886","1624","0","54.56","39.41"
"63","000","00","004","0416","0839","987","757","230","57","1044","1713","0","60.95","44.19"
"63","000","00","004","0417","0000","512","401","111","51","563","944","0","59.64","42.48"
"63","000","00","004","0417","0862","512","401","111","51","563","944","0","59.64","42.48"
"63","000","00","004","0418","0000","2374","1879","495","169","2543","4693","0","54.19","40.04"
"63","000","00","004","0418","0846","766","591","175","46","812","1472","0","55.16","40.15"
"63","000","00","004","0418","0847","758","545","213","49","807","1517","0","53.2","35.93"
"63","000","00","004","0418","0848","850","743","107","74","924","1704","0","54.23","43.6"
"63","000","00","004","0419","0000","2467","1878","589","208","2675","4476","0","59.76","41.96"
"63","000","00","004","0419","0821","840","672","168","61","901","1585","0","56.85","42.4"
"63","000","00","004","0419","0822","860","625","235","83","943","1523","0","61.92","41.04"
"63","000","00","004","0419","0823","767","581","186","64","831","1368","0","60.75","42.47"
"63","000","00","004","0420","0000","2423","1685","738","195","2618","4535","0","57.73","37.16"
"63","000","00","004","0420","0849","902","573","329","39","941","1603","0","58.7","35.75"
"63","000","00","004","0420","0850","705","519","186","80","785","1432","0","54.82","36.24"
"63","000","00","004","0420","0851","816","593","223","76","892","1500","0","59.47","39.53"
"63","000","00","004","0421","0000","3111","2300","811","206","3317","5635","0","58.86","40.82"
"63","000","00","004","0421","0852","759","554","205","44","803","1332","0","60.29","41.59"
"63","000","00","004","0421","0853","826","597","229","52","878","1450","0","60.55","41.17"
"63","000","00","004","0421","0854","803","601","202","57","860","1434","0","59.97","41.91"
"63","000","00","004","0421","0855","723","548","175","53","776","1419","0","54.69","38.62"
"63","000","00","004","0422","0000","2162","1638","524","165","2327","4400","0","52.89","37.23"
"63","000","00","004","0422","0856","666","482","184","49","715","1292","0","55.34","37.31"
"63","000","00","004","0422","0857","774","634","140","60","834","1526","0","54.65","41.55"
"63","000","00","004","0422","0858","722","522","200","56","778","1582","0","49.18","33.0"
"63","000","00","004","0423","0000","2282","1671","611","194","2476","4584","0","54.01","36.45"
"63","000","00","004","0423","0859","765","561","204","64","829","1588","0","52.2","35.33"
"63","000","00","004","0423","0860","779","575","204","80","859","1463","0","58.71","39.3"
"63","000","00","004","0423","0861","738","535","203","50","788","1533","0","51.4","34.9"
"63","000","00","004","0424","0000","2559","1904","655","172","2731","6843","0","39.91","27.82"
"63","000","00","004","0424","0863","1016","744","272","71","1087","1745","0","62.29","42.64"
"63","000","00","004","0424","0864","786","600","186","50","836","1679","0","49.79","35.74"
"63","000","00","004","0424","0865","757","560","197","51","808","3419","0","23.63","16.38"
"63","000","00","004","0425","0000","3853","2901","952","311","4164","7203","0","57.81","40.27"
"63","000","00","004","0425","0866","761","567","194","69","830","1387","0","59.84","40.88"
"63","000","00","004","0425","0867","916","690","226","66","982","1672","0","58.73","41.27"
"63","000","00","004","0425","0868","701","542","159","65","766","1319","0","58.07","41.09"
"63","000","00","004","0425","0869","718","547","171","54","772","1364","0","56.6","40.1"
"63","000","00","004","0425","0870","757","555","202","57","814","1461","0","55.72","37.99"
"63","000","00","004","0426","0000","1913","1392","521","156","2069","3654","0","56.62","38.1"
"63","000","00","004","0426","0871","642","461","181","51","693","1173","0","59.08","39.3"
"63","000","00","004","0426","0872","571","431","140","60","631","1171","0","53.89","36.81"
"63","000","00","004","0426","0873","700","500","200","45","745","1310","0","56.87","38.17"
"63","000","00","004","0427","0000","3762","2849","913","233","3995","6655","0","60.03","42.81"
"63","000","00","004","0427","0874","777","604","173","44","821","1373","0","59.8","43.99"
"63","000","00","004","0427","0875","729","541","188","33","762","1290","0","59.07","41.94"
"63","000","00","004","0427","0876","770","593","177","54","824","1346","0","61.22","44.06"
"63","000","00","004","0427","0877","824","615","209","62","886","1468","0","60.35","41.89"
"63","000","00","004","0427","0878","662","496","166","40","702","1178","0","59.59","42.11"
"63","000","00","004","0428","0000","3308","2476","832","207","3515","6102","0","57.6","40.58"
"63","000","00","004","0428","0879","928","703","225","58","986","1654","0","59.61","42.5"
"63","000","00","004","0428","0880","799","613","186","61","860","1464","0","58.74","41.87"
"63","000","00","004","0428","0881","764","553","211","29","793","1450","0","54.69","38.14"
"63","000","00","004","0428","0882","817","607","210","59","876","1534","0","57.11","39.57"
"63","000","00","004","0429","0000","3568","2631","937","270","3838","6660","0","57.63","39.5"
"63","000","00","004","0429","0883","896","677","219","48","944","1703","0","55.43","39.75"
"63","000","00","004","0429","0884","878","671","207","76","954","1610","0","59.25","41.68"
"63","000","00","004","0429","0885","841","600","241","84","925","1653","0","55.96","36.3"
"63","000","00","004","0429","0886","953","683","270","62","1015","1694","0","59.92","40.32"
"63","000","00","004","0430","0000","2557","1816","741","165","2722","4824","0","56.43","37.65"
"63","000","00","004","0430","0887","853","620","233","58","911","1623","0","56.13","38.2"
"63","000","00","004","0430","0888","880","591","289","57","937","1618","0","57.91","36.53"
"63","000","00","004","0430","0889","824","605","219","50","874","1583","0","55.21","38.22"
"63","000","00","004","0431","0000","2650","1913","737","186","2836","4529","0","62.62","42.24"
"63","000","00","004","0431","0890","891","597","294","74","965","1605","0","60.12","37.2"
"63","000","00","004","0431","0891","836","608","228","53","889","1398","0","63.59","43.49"
"63","000","00","004","0431","0892","923","708","215","59","982","1526","0","64.35","46.4"
"63","000","00","004","0432","0000","2542","1993","549","181","2723","4739","0","57.46","42.06"
"63","000","00","004","0432","0893","858","698","160","49","907","1555","0","58.33","44.89"
"63","000","00","004","0432","0894","840","669","171","45","885","1597","0","55.42","41.89"
"63","000","00","004","0432","0895","844","626","218","87","931","1587","0","58.66","39.45"
"63","000","00","004","0433","0000","1769","1355","414","133","1902","3133","0","60.71","43.25"
"63","000","00","004","0433","0896","898","720","178","61","959","1587","0","60.43","45.37"
"63","000","00","004","0433","0897","871","635","236","72","943","1546","0","61.0","41.07"
"63","000","00","004","0434","0000","2756","2150","606","171","2927","5094","0","57.46","42.21"
"63","000","00","004","0434","0898","696","548","148","57","753","1322","0","56.96","41.45"
"63","000","00","004","0434","0899","702","536","166","38","740","1267","0","58.41","42.3"
"63","000","00","004","0434","0900","672","512","160","16","688","1210","0","56.86","42.31"
"63","000","00","004","0434","0901","686","554","132","60","746","1295","0","57.61","42.78"
"63","000","00","004","0435","0000","2652","2128","524","167","2819","4474","0","63.01","47.56"
"63","000","00","004","0435","0902","833","624","209","62","895","1467","0","61.01","42.54"
"63","000","00","004","0435","0903","883","719","164","52","935","1491","0","62.71","48.22"
"63","000","00","004","0435","0904","936","785","151","53","989","1516","0","65.24","51.78"
"63","000","00","004","0436","0000","2192","1652","540","106","2298","4035","0","56.95","40.94"
"63","000","00","004","0436","0905","716","542","174","37","753","1384","0","54.41","39.16"
"63","000","00","004","0436","0906","715","556","159","31","746","1138","0","65.55","48.86"
"63","000","00","004","0436","0907","761","554","207","38","799","1513","0","52.81","36.62"
"63","000","00","004","0437","0000","1664","1259","405","136","1800","2988","0","60.24","42.14"
"63","000","00","004","0437","0908","864","671","193","60","924","1559","0","59.27","43.04"
"63","000","00","004","0437","0909","800","588","212","76","876","1429","0","61.3","41.15"
"63","000","00","004","0438","0000","1487","1133","354","73","1560","2459","0","63.44","46.08"
"63","000","00","004","0438","0910","733","565","168","32","765","1245","0","61.45","45.38"
"63","000","00","004","0438","0911","754","568","186","41","795","1214","0","65.49","46.79"
"63","000","00","004","0439","0000","2886","2154","732","142","3028","5339","0","56.71","40.34"
"63","000","00","004","0439","0912","783","579","204","42","825","1394","0","59.18","41.54"
"63","000","00","004","0439","0913","667","494","173","23","690","1336","0","51.65","36.98"
"63","000","00","004","0439","0914","659","499","160","35","694","1227","0","56.56","40.67"
"63","000","00","004","0439","0915","777","582","195","42","819","1382","0","59.26","42.11"
"63","000","00","004","0440","0000","2162","1694","468","123","2285","4100","0","55.73","41.32"
"63","000","00","004","0440","0916","771","606","165","52","823","1436","0","57.31","42.2"
"63","000","00","004","0440","0917","697","524","173","37","734","1405","0","52.24","37.3"
"63","000","00","004","0440","0918","694","564","130","34","728","1259","0","57.82","44.8"
"63","000","00","004","0441","0000","3536","2756","780","186","3722","6297","0","59.11","43.77"
"63","000","00","004","0441","0840","933","745","188","53","986","1647","0","59.87","45.23"
"63","000","00","004","0441","0841","919","696","223","40","959","1762","0","54.43","39.5"
"63","000","00","004","0441","0842","814","638","176","46","860","1399","0","61.47","45.6"
"63","000","00","004","0441","0843","870","677","193","47","917","1489","0","61.58","45.47"
"63","000","00","004","0442","0000","1342","1068","274","79","1421","2267","0","62.68","47.11"
"63","000","00","004","0442","0844","749","600","149","31","780","1269","0","61.47","47.28"
"63","000","00","004","0442","0845","593","468","125","48","641","998","0","64.23","46.89"
"63","000","00","005","0000","0000","70532","54214","16318","3896","74428","128292","159026","58.01","42.26"
"63","000","00","005","0501","0000","1400","1057","343","117","1517","2625","0","57.79","40.27"
"63","000","00","005","0501","1001","736","568","168","46","782","1308","0","59.79","43.43"
"63","000","00","005","0501","1002","664","489","175","71","735","1317","0","55.81","37.13"
"63","000","00","005","0502","0000","1218","955","263","72","1290","2197","0","58.72","43.47"
"63","000","00","005","0502","1003","631","499","132","30","661","1069","0","61.83","46.68"
"63","000","00","005","0502","1004","587","456","131","42","629","1128","0","55.76","40.43"
"63","000","00","005","0503","0000","1193","893","300","58","1251","2101","0","59.54","42.5"
"63","000","00","005","0503","1005","605","445","160","41","646","1053","0","61.35","42.26"
"63","000","00","005","0503","1006","588","448","140","17","605","1048","0","57.73","42.75"
"63","000","00","005","0504","0000","2308","1841","467","110","2418","3990","0","60.6","46.14"
"63","000","00","005","0504","1007","691","581","110","47","738","1297","0","56.9","44.8"
"63","000","00","005","0504","1008","698","566","132","12","710","1193","0","59.51","47.44"
"63","000","00","005","0504","1009","919","694","225","51","970","1500","0","64.67","46.27"
"63","000","00","005","0505","0000","2180","1650","530","110","2290","4079","0","56.14","40.45"
"63","000","00","005","0505","1010","706","531","175","34","740","1346","0","54.98","39.45"
"63","000","00","005","0505","1011","698","545","153","28","726","1283","0","56.59","42.48"
"63","000","00","005","0505","1012","776","574","202","48","824","1450","0","56.83","39.59"
"63","000","00","005","0506","0000","3097","2363","734","166","3263","5329","0","61.23","44.34"
"63","000","00","005","0506","1013","813","605","208","45","858","1433","0","59.87","42.22"
"63","000","00","005","0506","1014","817","611","206","43","860","1309","0","65.7","46.68"
"63","000","00","005","0506","1015","781","617","164","33","814","1386","0","58.73","44.52"
"63","000","00","005","0506","1016","686","530","156","45","731","1201","0","60.87","44.13"
"63","000","00","005","0507","0000","2977","2274","703","177","3154","5107","0","61.76","44.53"
"63","000","00","005","0507","1017","776","608","168","48","824","1336","0","61.68","45.51"
"63","000","00","005","0507","1018","779","592","187","51","830","1358","0","61.12","43.59"
"63","000","00","005","0507","1019","665","495","170","49","714","1177","0","60.66","42.06"
"63","000","00","005","0507","1020","757","579","178","29","786","1236","0","63.59","46.84"
"63","000","00","005","0508","0000","1630","1247","383","75","1705","2952","0","57.76","42.24"
"63","000","00","005","0508","1021","811","619","192","44","855","1478","0","57.85","41.88"
"63","000","00","005","0508","1022","819","628","191","31","850","1474","0","57.67","42.61"
"63","000","00","005","0509","0000","2763","2072","691","156","2919","4914","0","59.4","42.17"
"63","000","00","005","0509","1023","647","493","154","43","690","1172","0","58.87","42.06"
"63","000","00","005","0509","1024","737","555","182","37","774","1310","0","59.08","42.37"
"63","000","00","005","0509","1025","716","540","176","41","757","1263","0","59.94","42.76"
"63","000","00","005","0509","1026","663","484","179","35","698","1169","0","59.71","41.4"
"63","000","00","005","0510","0000","2152","1659","493","97","2249","3916","0","57.43","42.36"
"63","000","00","005","0510","1027","762","602","160","30","792","1391","0","56.94","43.28"
"63","000","00","005","0510","1028","649","476","173","27","676","1201","0","56.29","39.63"
"63","000","00","005","0510","1029","741","581","160","40","781","1324","0","58.99","43.88"
"63","000","00","005","0511","0000","2847","2158","689","236","3083","5279","0","58.4","40.88"
"63","000","00","005","0511","1030","626","475","151","68","694","1216","0","57.07","39.06"
"63","000","00","005","0511","1031","632","469","163","50","682","1183","0","57.65","39.64"
"63","000","00","005","0511","1032","823","619","204","63","886","1469","0","60.31","42.14"
"63","000","00","005","0511","1033","766","595","171","55","821","1411","0","58.19","42.17"
"63","000","00","005","0512","0000","2363","1834","529","232","2595","4497","0","57.71","40.78"
"63","000","00","005","0512","1034","764","574","190","82","846","1398","0","60.52","41.06"
"63","000","00","005","0512","1035","770","608","162","70","840","1479","0","56.8","41.11"
"63","000","00","005","0512","1036","829","652","177","80","909","1620","0","56.11","40.25"
"63","000","00","005","0513","0000","1777","1381","396","77","1854","3160","0","58.67","43.7"
"63","000","00","005","0513","1037","571","459","112","18","589","1041","0","56.58","44.09"
"63","000","00","005","0513","1038","564","419","145","18","582","1056","0","55.11","39.68"
"63","000","00","005","0513","1039","642","503","139","41","683","1063","0","64.25","47.32"
"63","000","00","005","0514","0000","2729","2099","630","249","2978","5865","0","50.78","35.79"
"63","000","00","005","0514","1040","676","507","169","65","741","1591","0","46.57","31.87"
"63","000","00","005","0514","1041","633","484","149","75","708","1502","0","47.14","32.22"
"63","000","00","005","0514","1042","661","525","136","51","712","1331","0","53.49","39.44"
"63","000","00","005","0514","1043","759","583","176","58","817","1441","0","56.7","40.46"
"63","000","00","005","0515","0000","2044","1581","463","126","2170","3562","0","60.92","44.39"
"63","000","00","005","0515","1044","748","582","166","40","788","1273","0","61.9","45.72"
"63","000","00","005","0515","1045","642","473","169","48","690","1133","0","60.9","41.75"
"63","000","00","005","0515","1046","654","526","128","38","692","1156","0","59.86","45.5"
"63","000","00","005","0516","0000","1451","1101","350","117","1568","2643","0","59.33","41.66"
"63","000","00","005","0516","1047","744","558","186","54","798","1377","0","57.95","40.52"
"63","000","00","005","0516","1048","707","543","164","63","770","1266","0","60.82","42.89"
"63","000","00","005","0517","0000","1303","1049","254","66","1369","2235","0","61.25","46.94"
"63","000","00","005","0517","1049","670","538","132","41","711","1111","0","64.0","48.42"
"63","000","00","005","0517","1050","633","511","122","25","658","1124","0","58.54","45.46"
"63","000","00","005","0518","0000","1591","1232","359","78","1669","2724","0","61.27","45.23"
"63","000","00","005","0518","1051","801","608","193","39","840","1373","0","61.18","44.28"
"63","000","00","005","0518","1052","790","624","166","39","829","1351","0","61.36","46.19"
"63","000","00","005","0519","0000","4863","3867","996","233","5096","8679","0","58.72","44.56"
"63","000","00","005","0519","1053","848","653","195","34","882","1495","0","59.0","43.68"
"63","000","00","005","0519","1054","869","666","203","52","921","1436","0","64.14","46.38"
"63","000","00","005","0519","1055","835","660","175","26","861","1516","0","56.79","43.54"
"63","000","00","005","0519","1056","761","596","165","37","798","1374","0","58.08","43.38"
"63","000","00","005","0519","1057","792","712","80","42","834","1522","0","54.8","46.78"
"63","000","00","005","0519","1058","758","580","178","42","800","1336","0","59.88","43.41"
"63","000","00","005","0520","0000","2592","1981","611","147","2739","4648","0","58.93","42.62"
"63","000","00","005","0520","1059","875","671","204","36","911","1551","0","58.74","43.26"
"63","000","00","005","0520","1060","904","694","210","49","953","1594","0","59.79","43.54"
"63","000","00","005","0520","1061","813","616","197","62","875","1503","0","58.22","40.98"
"63","000","00","005","0521","0000","4137","3283","854","164","4301","7237","0","59.43","45.36"
"63","000","00","005","0521","1062","834","649","185","28","862","1455","0","59.24","44.6"
"63","000","00","005","0521","1063","820","644","176","20","840","1439","0","58.37","44.75"
"63","000","00","005","0521","1064","814","642","172","43","857","1469","0","58.34","43.7"
"63","000","00","005","0521","1065","828","689","139","27","855","1430","0","59.79","48.18"
"63","000","00","005","0521","1066","841","659","182","46","887","1444","0","61.43","45.64"
"63","000","00","005","0522","0000","709","555","154","15","724","1254","0","57.74","44.26"
"63","000","00","005","0522","1067","709","555","154","15","724","1254","0","57.74","44.26"
"63","000","00","005","0523","0000","1811","1359","452","125","1936","3213","0","60.26","42.3"
"63","000","00","005","0523","1068","526","390","136","45","571","932","0","61.27","41.85"
"63","000","00","005","0523","1069","602","453","149","42","644","1055","0","61.04","42.94"
"63","000","00","005","0523","1070","683","516","167","38","721","1226","0","58.81","42.09"
"63","000","00","005","0524","0000","1441","1124","317","70","1511","2726","0","55.43","41.23"
"63","000","00","005","0524","1071","702","548","154","36","738","1390","0","53.09","39.42"
"63","000","00","005","0524","1072","739","576","163","34","773","1336","0","57.86","43.11"
"63","000","00","005","0525","0000","1501","1119","382","90","1591","2780","0","57.23","40.25"
"63","000","00","005","0525","1073","710","528","182","41","751","1419","0","52.92","37.21"
"63","000","00","005","0525","1074","791","591","200","49","840","1361","0","61.72","43.42"
"63","000","00","005","0526","0000","2228","1718","510","59","2287","5016","0","45.59","34.25"
"63","000","00","005","0526","1075","875","676","199","40","915","2520","0","36.31","26.83"
"63","000","00","005","0526","1076","690","537","153","14","704","1224","0","57.52","43.87"
"63","000","00","005","0526","1077","663","505","158","5","668","1272","0","52.52","39.7"
"63","000","00","005","0527","0000","2188","1605","583","109","2297","3951","0","58.14","40.62"
"63","000","00","005","0527","1078","773","541","232","39","812","1400","0","58.0","38.64"
"63","000","00","005","0527","1079","684","500","184","35","719","1319","0","54.51","37.91"
"63","000","00","005","0527","1080","731","564","167","35","766","1232","0","62.18","45.78"
"63","000","00","005","0528","0000","1929","1499","430","99","2028","3274","0","61.94","45.78"
"63","000","00","005","0528","1081","747","575","172","47","794","1265","0","62.77","45.45"
"63","000","00","005","0528","1082","643","515","128","25","668","1055","0","63.32","48.82"
"63","000","00","005","0528","1083","539","409","130","27","566","954","0","59.33","42.87"
"63","000","00","005","0529","0000","2544","1885","659","154","2698","4703","0","57.37","40.08"
"63","000","00","005","0529","1084","581","446","135","32","613","1018","0","60.22","43.81"
"63","000","00","005","0529","1085","765","550","215","37","802","1431","0","56.04","38.43"
"63","000","00","005","0529","1086","627","465","162","42","669","1271","0","52.64","36.59"
"63","000","00","005","0529","1087","571","424","147","43","614","983","0","62.46","43.13"
"63","000","00","005","0530","0000","3516","2715","801","152","3668","6409","0","57.23","42.36"
"63","000","00","005","0530","1088","862","657","205","36","898","1594","0","56.34","41.22"
"63","000","00","005","0530","1089","891","704","187","42","933","1565","0","59.62","44.98"
"63","000","00","005","0530","1090","921","709","212","36","957","1650","0","58.0","42.97"
"63","000","00","005","0530","1091","842","645","197","38","880","1600","0","55.0","40.31"
"63","000","00","005","0531","0000","4050","3058","992","160","4210","7227","0","58.25","42.31"
"63","000","00","005","0531","1092","755","578","177","21","776","1391","0","55.79","41.55"
"63","000","00","005","0531","1093","957","716","241","43","1000","1769","0","56.53","40.47"
"63","000","00","005","0531","1094","826","606","220","47","873","1487","0","58.71","40.75"
"63","000","00","005","0531","1095","761","591","170","23","784","1291","0","60.73","45.78"
"63","000","00","005","0531","1096","751","567","184","26","777","1289","0","60.28","43.99"
"63","000","00","006","0000","0000","57241","42181","15060","4408","61649","107557","127833","57.32","39.22"
"63","000","00","006","0601","0000","1458","1055","403","122","1580","2613","0","60.47","40.38"
"63","000","00","006","0601","0919","677","499","178","73","750","1261","0","59.48","39.57"
"63","000","00","006","0601","0920","781","556","225","49","830","1352","0","61.39","41.12"
"63","000","00","006","0602","0000","1588","1159","429","123","1711","2972","0","57.57","39.0"
"63","000","00","006","0602","0921","783","574","209","53","836","1462","0","57.18","39.26"
"63","000","00","006","0602","0922","805","585","220","70","875","1510","0","57.95","38.74"
"63","000","00","006","0603","0000","2137","1572","565","169","2306","4132","0","55.81","38.04"
"63","000","00","006","0603","0923","748","552","196","38","786","1496","0","52.54","36.9"
"63","000","00","006","0603","0924","693","513","180","59","752","1329","0","56.58","38.6"
"63","000","00","006","0603","0925","696","507","189","72","768","1307","0","58.76","38.79"
"63","000","00","006","0604","0000","1764","1285","479","133","1897","3197","0","59.34","40.19"
"63","000","00","006","0604","0926","574","436","138","53","627","1065","0","58.87","40.94"
"63","000","00","006","0604","0927","584","435","149","28","612","1085","0","56.41","40.09"
"63","000","00","006","0604","0928","606","414","192","52","658","1047","0","62.85","39.54"
"63","000","00","006","0605","0000","2597","1840","757","185","2782","4703","0","59.15","39.12"
"63","000","00","006","0605","0929","609","452","157","33","642","1215","0","52.84","37.2"
"63","000","00","006","0605","0930","646","440","206","37","683","1117","0","61.15","39.39"
"63","000","00","006","0605","0931","683","501","182","51","734","1186","0","61.89","42.24"
"63","000","00","006","0605","0932","659","447","212","64","723","1185","0","61.01","37.72"
"63","000","00","006","0606","0000","2177","1638","539","110","2287","3923","0","58.3","41.75"
"63","000","00","006","0606","0933","732","557","175","35","767","1359","0","56.44","40.99"
"63","000","00","006","0606","0934","693","543","150","28","721","1273","0","56.64","42.66"
"63","000","00","006","0606","0935","752","538","214","47","799","1291","0","61.89","41.67"
"63","000","00","006","0607","0000","2844","2092","752","183","3027","5142","0","58.87","40.68"
"63","000","00","006","0607","0936","668","500","168","48","716","1288","0","55.59","38.82"
"63","000","00","006","0607","0937","736","545","191","43","779","1245","0","62.57","43.78"
"63","000","00","006","0607","0938","740","533","207","59","799","1261","0","63.36","42.27"
"63","000","00","006","0607","0939","700","514","186","33","733","1348","0","54.38","38.13"
"63","000","00","006","0608","0000","2339","1731","608","234","2573","4303","0","59.8","40.23"
"63","000","00","006","0608","0940","894","638","256","86","980","1676","0","58.47","38.07"
"63","000","00","006","0608","0941","738","578","160","64","802","1311","0","61.17","44.09"
"63","000","00","006","0608","0942","707","515","192","84","791","1316","0","60.11","39.13"
"63","000","00","006","0609","0000","2357","1670","687","183","2540","4253","0","59.72","39.27"
"63","000","00","006","0609","0943","764","534","230","69","833","1409","0","59.12","37.9"
"63","000","00","006","0609","0944","815","607","208","56","871","1436","0","60.65","42.27"
"63","000","00","006","0609","0945","778","529","249","58","836","1408","0","59.38","37.57"
"63","000","00","006","0610","0000","2024","1503","521","90","2114","3710","0","56.98","40.51"
"63","000","00","006","0610","0946","692","485","207","40","732","1276","0","57.37","38.01"
"63","000","00","006","0610","0947","608","485","123","20","628","1110","0","56.58","43.69"
"63","000","00","006","0610","0948","724","533","191","30","754","1324","0","56.95","40.26"
"63","000","00","006","0611","0000","4489","3396","1093","312","4801","7949","0","60.4","42.72"
"63","000","00","006","0611","0949","546","380","166","42","588","1016","0","57.87","37.4"
"63","000","00","006","0611","0950","599","453","146","42","641","1028","0","62.35","44.07"
"63","000","00","006","0611","0951","645","490","155","56","701","1158","0","60.54","42.31"
"63","000","00","006","0611","0952","645","501","144","48","693","1138","0","60.9","44.02"
"63","000","00","006","0611","0953","677","527","150","53","730","1214","0","60.13","43.41"
"63","000","00","006","0611","0954","586","433","153","32","618","1090","0","56.7","39.72"
"63","000","00","006","0611","0955","791","612","179","39","830","1305","0","63.6","46.9"
"63","000","00","006","0612","0000","1912","1403","509","132","2044","3518","0","58.1","39.88"
"63","000","00","006","0612","0956","590","458","132","33","623","1167","0","53.38","39.25"
"63","000","00","006","0612","0957","628","448","180","46","674","1148","0","58.71","39.02"
"63","000","00","006","0612","0958","694","497","197","53","747","1203","0","62.09","41.31"
"63","000","00","006","0613","0000","2951","2169","782","212","3163","5427","0","58.28","39.97"
"63","000","00","006","0613","0959","751","558","193","42","793","1441","0","55.03","38.72"
"63","000","00","006","0613","0960","754","544","210","63","817","1315","0","62.13","41.37"
"63","000","00","006","0613","0961","727","547","180","61","788","1393","0","56.57","39.27"
"63","000","00","006","0613","0962","719","520","199","46","765","1278","0","59.86","40.69"
"63","000","00","006","0614","0000","1197","890","307","123","1320","2388","0","55.28","37.27"
"63","000","00","006","0614","0963","607","463","144","57","664","1246","0","53.29","37.16"
"63","000","00","006","0614","0964","590","427","163","66","656","1142","0","57.44","37.39"
"63","000","00","006","0615","0000","1513","1098","415","133","1646","2699","0","60.99","40.68"
"63","000","00","006","0615","0965","749","549","200","63","812","1336","0","60.78","41.09"
"63","000","00","006","0615","0966","764","549","215","70","834","1363","0","61.19","40.28"
"63","000","00","006","0616","0000","2330","1805","525","107","2437","4354","0","55.97","41.46"
"63","000","00","006","0616","0967","809","677","132","18","827","1476","0","56.03","45.87"
"63","000","00","006","0616","0968","770","553","217","56","826","1418","0","58.25","39.0"
"63","000","00","006","0616","0969","751","575","176","33","784","1460","0","53.7","39.38"
"63","000","00","006","0617","0000","1086","747","339","154","1240","2468","0","50.24","30.27"
"63","000","00","006","0617","0970","555","383","172","61","616","1222","0","50.41","31.34"
"63","000","00","006","0617","0971","531","364","167","93","624","1246","0","50.08","29.21"
"63","000","00","006","0618","0000","2111","1505","606","118","2229","3885","0","57.37","38.74"
"63","000","00","006","0618","0972","716","487","229","68","784","1256","0","62.42","38.77"
"63","000","00","006","0618","0973","714","527","187","29","743","1289","0","57.64","40.88"
"63","000","00","006","0618","0974","681","491","190","21","702","1340","0","52.39","36.64"
"63","000","00","006","0619","0000","1525","1176","349","145","1670","4014","0","41.6","29.3"
"63","000","00","006","0619","0975","784","592","192","62","846","1555","0","54.41","38.07"
"63","000","00","006","0619","0976","741","584","157","83","824","2459","0","33.51","23.75"
"63","000","00","006","0620","0000","2200","1619","581","197","2397","4466","0","53.67","36.25"
"63","000","00","006","0620","0977","479","326","153","51","530","1108","0","47.83","29.42"
"63","000","00","006","0620","0978","429","305","124","56","485","867","0","55.94","35.18"
"63","000","00","006","0620","0979","673","561","112","53","726","1329","0","54.63","42.21"
"63","000","00","006","0620","0980","619","427","192","37","656","1162","0","56.45","36.75"
"63","000","00","006","0621","0000","2932","2121","811","193","3125","5823","0","53.67","36.42"
"63","000","00","006","0621","0981","717","520","197","70","787","1434","0","54.88","36.26"
"63","000","00","006","0621","0982","733","528","205","56","789","1351","0","58.4","39.08"
"63","000","00","006","0621","0983","754","548","206","52","806","1531","0","52.65","35.79"
"63","000","00","006","0621","0984","728","525","203","15","743","1507","0","49.3","34.84"
"63","000","00","006","0622","0000","3830","2837","993","318","4148","7142","0","58.08","39.72"
"63","000","00","006","0622","0985","773","569","204","56","829","1488","0","55.71","38.24"
"63","000","00","006","0622","0986","771","559","212","82","853","1384","0","61.63","40.39"
"63","000","00","006","0622","0987","758","571","187","88","846","1460","0","57.95","39.11"
"63","000","00","006","0622","0988","779","588","191","59","838","1371","0","61.12","42.89"
"63","000","00","006","0622","0989","749","550","199","33","782","1439","0","54.34","38.22"
"63","000","00","006","0624","0000","2837","2113","724","275","3112","5195","0","59.9","40.67"
"63","000","00","006","0624","0990","751","551","200","71","822","1376","0","59.74","40.04"
"63","000","00","006","0624","0991","692","526","166","83","775","1366","0","56.73","38.51"
"63","000","00","006","0624","0992","723","519","204","64","787","1218","0","64.61","42.61"
"63","000","00","006","0624","0993","671","517","154","57","728","1235","0","58.95","41.86"
"63","000","00","006","0625","0000","3038","2313","725","233","3271","5651","0","57.88","40.93"
"63","000","00","006","0625","0994","695","525","170","27","722","1364","0","52.93","38.49"
"63","000","00","006","0625","0995","732","600","132","71","803","1408","0","57.03","42.61"
"63","000","00","006","0625","0996","789","575","214","65","854","1450","0","58.9","39.66"
"63","000","00","006","0625","0997","822","613","209","70","892","1429","0","62.42","42.9"
"63","000","00","006","0626","0000","2005","1444","561","224","2229","3630","0","61.4","39.78"
"63","000","00","006","0626","0998","646","477","169","59","705","1170","0","60.26","40.77"
"63","000","00","006","0626","0999","657","465","192","78","735","1245","0","59.04","37.35"
"63","000","00","006","0626","1000","702","502","200","87","789","1215","0","64.94","41.32"
"63","000","00","007","0000","0000","83904","63881","20023","6601","90505","164020","189875","55.18","38.95"
"63","000","00","007","0701","0000","2419","1824","595","189","2608","4833","0","53.96","37.74"
"63","000","00","007","0701","1097","722","531","191","57","779","1305","0","59.69","40.69"
"63","000","00","007","0701","1098","540","404","136","65","605","1183","0","51.14","34.15"
"63","000","00","007","0701","1099","600","468","132","36","636","1176","0","54.08","39.8"
"63","000","00","007","0701","1100","557","421","136","31","588","1169","0","50.3","36.01"
"63","000","00","007","0702","0000","1373","1036","337","120","1493","3020","0","49.44","34.3"
"63","000","00","007","0702","1101","692","530","162","47","739","1457","0","50.72","36.38"
"63","000","00","007","0702","1102","681","506","175","73","754","1563","0","48.24","32.37"
"63","000","00","007","0703","0000","1585","1187","398","92","1677","3386","0","49.53","35.06"
"63","000","00","007","0703","1103","802","618","184","41","843","1771","0","47.6","34.9"
"63","000","00","007","0703","1104","783","569","214","51","834","1615","0","51.64","35.23"
"63","000","00","007","0704","0000","2872","2127","745","252","3124","5794","0","53.92","36.71"
"63","000","00","007","0704","1105","744","531","213","82","826","1478","0","55.89","35.93"
"63","000","00","007","0704","1106","734","550","184","38","772","1462","0","52.8","37.62"
"63","000","00","007","0704","1107","665","515","150","70","735","1507","0","48.77","34.17"
"63","000","00","007","0704","1108","729","531","198","62","791","1347","0","58.72","39.42"
"63","000","00","007","0705","0000","2872","2108","764","214","3086","5489","0","56.22","38.4"
"63","000","00","007","0705","1109","668","502","166","53","721","1367","0","52.74","36.72"
"63","000","00","007","0705","1110","728","543","185","56","784","1277","0","61.39","42.52"
"63","000","00","007","0705","1111","760","547","213","44","804","1395","0","57.63","39.21"
"63","000","00","007","0705","1112","716","516","200","61","777","1450","0","53.59","35.59"
"63","000","00","007","0706","0000","2547","1859","688","228","2775","5192","0","53.45","35.81"
"63","000","00","007","0706","1113","640","462","178","52","692","1340","0","51.64","34.48"
"63","000","00","007","0706","1114","613","428","185","53","666","1242","0","53.62","34.46"
"63","000","00","007","0706","1115","639","464","175","72","711","1286","0","55.29","36.08"
"63","000","00","007","0706","1116","655","505","150","51","706","1324","0","53.32","38.14"
"63","000","00","007","0707","0000","2085","1504","581","195","2280","4411","0","51.69","34.1"
"63","000","00","007","0707","1117","782","578","204","81","863","1619","0","53.3","35.7"
"63","000","00","007","0707","1118","618","426","192","62","680","1352","0","50.3","31.51"
"63","000","00","007","0707","1119","685","500","185","52","737","1440","0","51.18","34.72"
"63","000","00","007","0708","0000","1914","1443","471","172","2086","3514","0","59.36","41.06"
"63","000","00","007","0708","1120","668","494","174","46","714","1194","0","59.8","41.37"
"63","000","00","007","0708","1121","631","499","132","61","692","1083","0","63.9","46.08"
"63","000","00","007","0708","1122","615","450","165","65","680","1237","0","54.97","36.38"
"63","000","00","007","0709","0000","2262","1689","573","203","2465","4301","0","57.31","39.27"
"63","000","00","007","0709","1123","807","611","196","64","871","1625","0","53.6","37.6"
"63","000","00","007","0709","1124","728","529","199","73","801","1324","0","60.5","39.95"
"63","000","00","007","0709","1125","727","549","178","66","793","1352","0","58.65","40.61"
"63","000","00","007","0710","0000","2226","1636","590","187","2413","5559","0","43.41","29.43"
"63","000","00","007","0710","1126","673","477","196","62","735","2630","0","27.95","18.14"
"63","000","00","007","0710","1127","838","622","216","67","905","1504","0","60.17","41.36"
"63","000","00","007","0710","1128","715","537","178","58","773","1425","0","54.25","37.68"
"63","000","00","007","0711","0000","3205","2359","846","283","3488","6398","0","54.52","36.87"
"63","000","00","007","0711","1144","494","336","158","49","543","1052","0","51.62","31.94"
"63","000","00","007","0711","1145","586","438","148","49","635","1135","0","55.95","38.59"
"63","000","00","007","0711","1146","630","453","177","63","693","1225","0","56.57","36.98"
"63","000","00","007","0711","1147","768","584","184","65","833","1583","0","52.62","36.89"
"63","000","00","007","0711","1148","727","548","179","57","784","1403","0","55.88","39.06"
"63","000","00","007","0712","0000","2125","1567","558","204","2329","3995","0","58.3","39.22"
"63","000","00","007","0712","1149","737","549","188","74","811","1406","0","57.68","39.05"
"63","000","00","007","0712","1150","751","555","196","62","813","1401","0","58.03","39.61"
"63","000","00","007","0712","1151","637","463","174","68","705","1188","0","59.34","38.97"
"63","000","00","007","0713","0000","1684","1429","255","100","1784","3076","0","58.0","46.46"
"63","000","00","007","0713","1198","751","616","135","52","803","1485","0","54.07","41.48"
"63","000","00","007","0713","1199","933","813","120","48","981","1591","0","61.66","51.1"
"63","000","00","007","0714","0000","4441","3637","804","192","4633","7544","0","61.41","48.21"
"63","000","00","007","0714","1200","868","724","144","29","897","1394","0","64.35","51.94"
"63","000","00","007","0714","1201","830","642","188","41","871","1522","0","57.23","42.18"
"63","000","00","007","0714","1202","963","819","144","39","1002","1661","0","60.33","49.31"
"63","000","00","007","0714","1203","926","757","169","36","962","1561","0","61.63","48.49"
"63","000","00","007","0714","1204","854","695","159","47","901","1406","0","64.08","49.43"
"63","000","00","007","0715","0000","2628","1938","690","190","2818","4891","0","57.62","39.62"
"63","000","00","007","0715","1137","621","456","165","34","655","1228","0","53.34","37.13"
"63","000","00","007","0715","1138","663","472","191","59","722","1268","0","56.94","37.22"
"63","000","00","007","0715","1139","672","496","176","55","727","1207","0","60.23","41.09"
"63","000","00","007","0715","1140","672","514","158","42","714","1188","0","60.1","43.27"
"63","000","00","007","0716","0000","2998","2218","780","221","3219","6228","0","51.69","35.61"
"63","000","00","007","0716","1152","765","570","195","82","847","1597","0","53.04","35.69"
"63","000","00","007","0716","1153","729","537","192","65","794","1290","0","61.55","41.63"
"63","000","00","007","0716","1154","801","580","221","31","832","1746","0","47.65","33.22"
"63","000","00","007","0716","1155","703","531","172","43","746","1595","0","46.77","33.29"
"63","000","00","007","0717","0000","1706","1312","394","134","1840","3860","0","47.67","33.99"
"63","000","00","007","0717","1141","739","564","175","50","789","1474","0","53.53","38.26"
"63","000","00","007","0717","1142","564","445","119","30","594","1304","0","45.55","34.13"
"63","000","00","007","0717","1143","403","303","100","54","457","1082","0","42.24","28.0"
"63","000","00","007","0718","0000","4021","3055","966","284","4305","7643","0","56.33","39.97"
"63","000","00","007","0718","1132","738","558","180","58","796","1447","0","55.01","38.56"
"63","000","00","007","0718","1133","810","628","182","57","867","1491","0","58.15","42.12"
"63","000","00","007","0718","1134","835","642","193","47","882","1500","0","58.8","42.8"
"63","000","00","007","0718","1135","859","638","221","67","926","1582","0","58.53","40.33"
"63","000","00","007","0718","1136","779","589","190","55","834","1623","0","51.39","36.29"
"63","000","00","007","0719","0000","2216","1688","528","237","2453","4677","0","52.45","36.09"
"63","000","00","007","0719","1129","737","554","183","68","805","1591","0","50.6","34.82"
"63","000","00","007","0719","1130","722","559","163","85","807","1474","0","54.75","37.92"
"63","000","00","007","0719","1131","757","575","182","84","841","1612","0","52.17","35.67"
"63","000","00","007","0720","0000","1833","1397","436","142","1975","3212","0","61.49","43.49"
"63","000","00","007","0720","1163","571","437","134","31","602","1036","0","58.11","42.18"
"63","000","00","007","0720","1164","608","448","160","59","667","1035","0","64.44","43.29"
"63","000","00","007","0720","1165","654","512","142","52","706","1141","0","61.88","44.87"
"63","000","00","007","0721","0000","2656","2088","568","225","2881","5522","0","52.17","37.81"
"63","000","00","007","0721","1205","658","510","148","37","695","1498","0","46.4","34.05"
"63","000","00","007","0721","1206","639","486","153","79","718","1478","0","48.58","32.88"
"63","000","00","007","0721","1207","603","464","139","55","658","1170","0","56.24","39.66"
"63","000","00","007","0721","1208","756","628","128","54","810","1376","0","58.87","45.64"
"63","000","00","007","0722","0000","2128","1620","508","175","2303","3885","0","59.28","41.7"
"63","000","00","007","0722","1166","703","540","163","35","738","1271","0","58.06","42.49"
"63","000","00","007","0722","1167","719","549","170","93","812","1328","0","61.14","41.34"
"63","000","00","007","0722","1168","706","531","175","47","753","1286","0","58.55","41.29"
"63","000","00","007","0723","0000","1525","1168","357","141","1666","2903","0","57.39","40.23"
"63","000","00","007","0723","1172","874","680","194","70","944","1623","0","58.16","41.9"
"63","000","00","007","0723","1173","651","488","163","71","722","1280","0","56.41","38.13"
"63","000","00","007","0724","0000","2904","2146","758","349","3253","6128","0","53.08","35.02"
"63","000","00","007","0724","1156","831","602","229","100","931","1701","0","54.73","35.39"
"63","000","00","007","0724","1157","580","399","181","85","665","1339","0","49.66","29.8"
"63","000","00","007","0724","1158","644","497","147","85","729","1484","0","49.12","33.49"
"63","000","00","007","0724","1159","849","648","201","79","928","1604","0","57.86","40.4"
"63","000","00","007","0725","0000","2466","1853","613","236","2702","4923","0","54.89","37.64"
"63","000","00","007","0725","1169","899","675","224","86","985","1679","0","58.67","40.2"
"63","000","00","007","0725","1170","817","616","201","89","906","1619","0","55.96","38.05"
"63","000","00","007","0725","1171","750","562","188","61","811","1625","0","49.91","34.58"
"63","000","00","007","0726","0000","2046","1553","493","161","2207","3767","0","58.59","41.23"
"63","000","00","007","0726","1160","644","489","155","46","690","1197","0","57.64","40.85"
"63","000","00","007","0726","1161","659","482","177","79","738","1347","0","54.79","35.78"
"63","000","00","007","0726","1162","743","582","161","36","779","1223","0","63.7","47.59"
"63","000","00","007","0727","0000","1621","1221","400","135","1756","2911","0","60.32","41.94"
"63","000","00","007","0727","1180","774","568","206","52","826","1342","0","61.55","42.32"
"63","000","00","007","0727","1181","847","653","194","83","930","1569","0","59.27","41.62"
"63","000","00","007","0728","0000","2152","1648","504","141","2293","4194","0","54.67","39.29"
"63","000","00","007","0728","1177","758","563","195","33","791","1373","0","57.61","41.01"
"63","000","00","007","0728","1178","704","548","156","68","772","1394","0","55.38","39.31"
"63","000","00","007","0728","1179","690","537","153","40","730","1427","0","51.16","37.63"
"63","000","00","007","0729","0000","1474","1145","329","98","1572","3234","0","48.61","35.41"
"63","000","00","007","0729","1182","692","520","172","58","750","1514","0","49.54","34.35"
"63","000","00","007","0729","1183","782","625","157","40","822","1720","0","47.79","36.34"
"63","000","00","007","0730","0000","2475","1868","607","175","2650","4533","0","58.46","41.21"
"63","000","00","007","0730","1174","838","634","204","64","902","1608","0","56.09","39.43"
"63","000","00","007","0730","1175","786","592","194","64","850","1453","0","58.5","40.74"
"63","000","00","007","0730","1176","851","642","209","47","898","1472","0","61.01","43.61"
"63","000","00","007","0731","0000","2081","1594","487","168","2249","4154","0","54.14","38.37"
"63","000","00","007","0731","1188","645","508","137","38","683","1307","0","52.26","38.87"
"63","000","00","007","0731","1189","744","564","180","90","834","1420","0","58.73","39.72"
"63","000","00","007","0731","1190","692","522","170","40","732","1427","0","51.3","36.58"
"63","000","00","007","0732","0000","3010","2292","718","222","3232","5505","0","58.71","41.63"
"63","000","00","007","0732","1184","834","645","189","70","904","1461","0","61.88","44.15"
"63","000","00","007","0732","1185","635","480","155","43","678","1264","0","53.64","37.97"
"63","000","00","007","0732","1186","761","567","194","67","828","1334","0","62.07","42.5"
"63","000","00","007","0732","1187","780","600","180","42","822","1446","0","56.85","41.49"
"63","000","00","007","0733","0000","2667","2135","532","176","2843","4900","0","58.02","43.57"
"63","000","00","007","0733","1191","501","385","116","41","542","956","0","56.69","40.27"
"63","000","00","007","0733","1192","736","562","174","58","794","1352","0","58.73","41.57"
"63","000","00","007","0733","1193","738","601","137","37","775","1370","0","56.57","43.87"
"63","000","00","007","0733","1194","692","587","105","40","732","1222","0","59.9","48.04"
"63","000","00","007","0734","0000","2269","1814","455","138","2407","4365","0","55.14","41.56"
"63","000","00","007","0734","1195","733","596","137","42","775","1375","0","56.36","43.35"
"63","000","00","007","0734","1196","796","641","155","58","854","1463","0","58.37","43.81"
"63","000","00","007","0734","1197","740","577","163","38","778","1527","0","50.95","37.79"
"63","000","00","007","0735","0000","1825","1467","358","151","1976","3296","0","59.95","44.51"
"63","000","00","007","0735","1209","589","486","103","25","614","1093","0","56.18","44.46"
"63","000","00","007","0735","1210","624","493","131","61","685","1084","0","63.19","45.48"
"63","000","00","007","0735","1211","612","488","124","65","677","1119","0","60.5","43.61"
"63","000","00","007","0736","0000","1593","1256","337","71","1664","2777","0","59.92","45.23"
"63","000","00","007","0736","1212","821","654","167","37","858","1381","0","62.13","47.36"
"63","000","00","007","0736","1213","772","602","170","34","806","1396","0","57.74","43.12"
"63","000","00","008","0000","0000","127272","100344","26928","7692","134964","227211","273883","59.4","44.16"
"63","000","00","008","0801","0000","3369","2573","796","210","3579","6228","0","57.47","41.31"
"63","000","00","008","0801","1402","824","624","200","39","863","1539","0","56.08","40.55"
"63","000","00","008","0801","1403","778","602","176","41","819","1548","0","52.91","38.89"
"63","000","00","008","0801","1404","828","615","213","73","901","1493","0","60.35","41.19"
"63","000","00","008","0801","1405","939","732","207","57","996","1648","0","60.44","44.42"
"63","000","00","008","0802","0000","3422","2748","674","213","3635","6155","0","59.06","44.65"
"63","000","00","008","0802","1406","847","686","161","46","893","1544","0","57.84","44.43"
"63","000","00","008","0802","1407","852","676","176","57","909","1557","0","58.38","43.42"
"63","000","00","008","0802","1408","796","642","154","53","849","1514","0","56.08","42.4"
"63","000","00","008","0802","1409","927","744","183","57","984","1540","0","63.9","48.31"
"63","000","00","008","0803","0000","2528","2000","528","161","2689","4365","0","61.6","45.82"
"63","000","00","008","0803","1410","867","675","192","40","907","1466","0","61.87","46.04"
"63","000","00","008","0803","1411","854","690","164","42","896","1444","0","62.05","47.78"
"63","000","00","008","0803","1412","807","635","172","79","886","1455","0","60.89","43.64"
"63","000","00","008","0804","0000","3084","2410","674","186","3270","5676","0","57.61","42.46"
"63","000","00","008","0804","1413","759","597","162","51","810","1440","0","56.25","41.46"
"63","000","00","008","0804","1414","810","642","168","57","867","1398","0","62.02","45.92"
"63","000","00","008","0804","1415","738","574","164","27","765","1412","0","54.18","40.65"
"63","000","00","008","0804","1416","777","597","180","51","828","1426","0","58.06","41.87"
"63","000","00","008","0805","0000","2430","1902","528","121","2551","4345","0","58.71","43.77"
"63","000","00","008","0805","1417","808","627","181","45","853","1437","0","59.36","43.63"
"63","000","00","008","0805","1418","759","593","166","49","808","1340","0","60.3","44.25"
"63","000","00","008","0805","1419","863","682","181","27","890","1568","0","56.76","43.49"
"63","000","00","008","0806","0000","2794","2195","599","128","2922","5016","0","58.25","43.76"
"63","000","00","008","0806","1420","754","587","167","27","781","1372","0","56.92","42.78"
"63","000","00","008","0806","1421","574","451","123","29","603","1046","0","57.65","43.12"
"63","000","00","008","0806","1422","722","557","165","40","762","1274","0","59.81","43.72"
"63","000","00","008","0806","1423","744","600","144","32","776","1324","0","58.61","45.32"
"63","000","00","008","0807","0000","2762","2145","617","136","2898","4829","0","60.01","44.42"
"63","000","00","008","0807","1424","951","725","226","54","1005","1722","0","58.36","42.1"
"63","000","00","008","0807","1425","979","762","217","62","1041","1737","0","59.93","43.87"
"63","000","00","008","0807","1426","832","658","174","20","852","1370","0","62.19","48.03"
"63","000","00","008","0808","0000","2230","1697","533","160","2390","3961","0","60.34","42.84"
"63","000","00","008","0808","1427","829","638","191","51","880","1495","0","58.86","42.68"
"63","000","00","008","0808","1428","742","569","173","59","801","1328","0","60.32","42.85"
"63","000","00","008","0808","1429","659","490","169","50","709","1138","0","62.3","43.06"
"63","000","00","008","0809","0000","3656","2847","809","200","3856","6217","0","62.02","45.79"
"63","000","00","008","0809","1430","834","636","198","38","872","1471","0","59.28","43.24"
"63","000","00","008","0809","1431","676","531","145","35","711","1144","0","62.15","46.42"
"63","000","00","008","0809","1432","713","551","162","50","763","1176","0","64.88","46.85"
"63","000","00","008","0809","1433","715","554","161","45","760","1212","0","62.71","45.71"
"63","000","00","008","0809","1434","718","575","143","32","750","1214","0","61.78","47.36"
"63","000","00","008","0810","0000","2674","2062","612","194","2868","4778","0","60.03","43.16"
"63","000","00","008","0810","1435","634","474","160","41","675","1170","0","57.69","40.51"
"63","000","00","008","0810","1436","748","573","175","52","800","1308","0","61.16","43.81"
"63","000","00","008","0810","1437","667","511","156","56","723","1190","0","60.76","42.94"
"63","000","00","008","0810","1438","625","504","121","45","670","1110","0","60.36","45.41"
"63","000","00","008","0811","0000","1629","1353","276","118","1747","2899","0","60.26","46.67"
"63","000","00","008","0811","1439","835","694","141","55","890","1512","0","58.86","45.9"
"63","000","00","008","0811","1440","794","659","135","63","857","1387","0","61.79","47.51"
"63","000","00","008","0812","0000","2364","1831","533","162","2526","4209","0","60.01","43.5"
"63","000","00","008","0812","1441","771","600","171","43","814","1355","0","60.07","44.28"
"63","000","00","008","0812","1442","768","570","198","56","824","1370","0","60.15","41.61"
"63","000","00","008","0812","1443","825","661","164","63","888","1484","0","59.84","44.54"
"63","000","00","008","0813","0000","2454","1911","543","140","2594","4240","0","61.18","45.07"
"63","000","00","008","0813","1444","998","768","230","53","1051","1786","0","58.85","43.0"
"63","000","00","008","0813","1445","708","560","148","57","765","1260","0","60.71","44.44"
"63","000","00","008","0813","1446","748","583","165","30","778","1194","0","65.16","48.83"
"63","000","00","008","0814","0000","1655","1296","359","114","1769","2936","0","60.25","44.14"
"63","000","00","008","0814","1450","789","624","165","65","854","1450","0","58.9","43.03"
"63","000","00","008","0814","1451","866","672","194","49","915","1486","0","61.57","45.22"
"63","000","00","008","0815","0000","3804","3021","783","198","4002","6643","0","60.24","45.48"
"63","000","00","008","0815","1452","739","592","147","34","773","1259","0","61.4","47.02"
"63","000","00","008","0815","1453","775","632","143","26","801","1317","0","60.82","47.99"
"63","000","00","008","0815","1454","798","616","182","34","832","1321","0","62.98","46.63"
"63","000","00","008","0815","1455","814","643","171","49","863","1475","0","58.51","43.59"
"63","000","00","008","0815","1456","678","538","140","55","733","1271","0","57.67","42.33"
"63","000","00","008","0816","0000","2873","2273","600","161","3034","5159","0","58.81","44.06"
"63","000","00","008","0816","1457","925","722","203","43","968","1609","0","60.16","44.87"
"63","000","00","008","0816","1458","794","642","152","35","829","1501","0","55.23","42.77"
"63","000","00","008","0816","1459","507","392","115","44","551","997","0","55.27","39.32"
"63","000","00","008","0816","1460","647","517","130","39","686","1052","0","65.21","49.14"
"63","000","00","008","0817","0000","2840","2249","591","132","2972","4847","0","61.32","46.4"
"63","000","00","008","0817","1461","734","584","150","29","763","1247","0","61.19","46.83"
"63","000","00","008","0817","1462","677","520","157","46","723","1167","0","61.95","44.56"
"63","000","00","008","0817","1463","739","578","161","31","770","1280","0","60.16","45.16"
"63","000","00","008","0817","1464","690","567","123","26","716","1153","0","62.1","49.18"
"63","000","00","008","0818","0000","3451","2776","675","170","3621","5817","0","62.25","47.72"
"63","000","00","008","0818","1465","914","734","180","42","956","1557","0","61.4","47.14"
"63","000","00","008","0818","1466","814","654","160","46","860","1444","0","59.56","45.29"
"63","000","00","008","0818","1467","892","713","179","41","933","1459","0","63.95","48.87"
"63","000","00","008","0818","1468","831","675","156","41","872","1357","0","64.26","49.74"
"63","000","00","008","0819","0000","2868","2311","557","199","3067","4847","0","63.28","47.68"
"63","000","00","008","0819","1469","753","616","137","40","793","1194","0","66.42","51.59"
"63","000","00","008","0819","1470","703","543","160","60","763","1184","0","64.44","45.86"
"63","000","00","008","0819","1471","672","537","135","46","718","1119","0","64.16","47.99"
"63","000","00","008","0819","1472","740","615","125","53","793","1350","0","58.74","45.56"
"63","000","00","008","0820","0000","4235","3368","867","215","4450","7265","0","61.25","46.36"
"63","000","00","008","0820","1473","795","629","166","48","843","1502","0","56.13","41.88"
"63","000","00","008","0820","1474","851","666","185","58","909","1511","0","60.16","44.08"
"63","000","00","008","0820","1475","930","746","184","37","967","1481","0","65.29","50.37"
"63","000","00","008","0820","1476","896","721","175","30","926","1477","0","62.69","48.82"
"63","000","00","008","0820","1477","763","606","157","42","805","1294","0","62.21","46.83"
"63","000","00","008","0821","0000","2128","1667","461","128","2256","3516","0","64.16","47.41"
"63","000","00","008","0821","1478","669","527","142","40","709","1040","0","68.17","50.67"
"63","000","00","008","0821","1479","790","624","166","40","830","1323","0","62.74","47.17"
"63","000","00","008","0821","1480","669","516","153","48","717","1153","0","62.19","44.75"
"63","000","00","008","0822","0000","3317","2584","733","190","3507","5896","0","59.48","43.83"
"63","000","00","008","0822","1481","844","690","154","52","896","1525","0","58.75","45.25"
"63","000","00","008","0822","1482","741","592","149","49","790","1412","0","55.95","41.93"
"63","000","00","008","0822","1483","869","644","225","60","929","1473","0","63.07","43.72"
"63","000","00","008","0822","1484","863","658","205","29","892","1486","0","60.03","44.28"
"63","000","00","008","0823","0000","3557","2857","700","210","3767","6013","0","62.65","47.51"
"63","000","00","008","0823","1485","960","804","156","53","1013","1616","0","62.69","49.75"
"63","000","00","008","0823","1486","893","709","184","53","946","1489","0","63.53","47.62"
"63","000","00","008","0823","1487","790","633","157","52","842","1414","0","59.55","44.77"
"63","000","00","008","0823","1488","914","711","203","52","966","1494","0","64.66","47.59"
"63","000","00","008","0824","0000","4588","3629","959","242","4830","7764","0","62.21","46.74"
"63","000","00","008","0824","1489","896","698","198","60","956","1547","0","61.8","45.12"
"63","000","00","008","0824","1490","912","691","221","58","970","1587","0","61.12","43.54"
"63","000","00","008","0824","1491","930","768","162","29","959","1515","0","63.3","50.69"
"63","000","00","008","0824","1492","932","753","179","53","985","1573","0","62.62","47.87"
"63","000","00","008","0824","1493","918","719","199","42","960","1542","0","62.26","46.63"
"63","000","00","008","0825","0000","1712","1321","391","149","1861","3536","0","52.63","37.36"
"63","000","00","008","0825","1494","753","598","155","58","811","1465","0","55.36","40.82"
"63","000","00","008","0825","1495","307","219","88","35","342","699","0","48.93","31.33"
"63","000","00","008","0825","1496","652","504","148","56","708","1372","0","51.6","36.73"
"63","000","00","008","0826","0000","3324","2651","673","176","3500","6057","0","57.78","43.77"
"63","000","00","008","0826","1497","695","555","140","50","745","1448","0","51.45","38.33"
"63","000","00","008","0826","1498","849","666","183","60","909","1548","0","58.72","43.02"
"63","000","00","008","0826","1499","867","683","184","36","903","1501","0","60.16","45.5"
"63","000","00","008","0826","1500","913","747","166","30","943","1560","0","60.45","47.88"
"63","000","00","008","0827","0000","4423","3521","902","223","4646","7736","0","60.06","45.51"
"63","000","00","008","0827","1501","874","690","184","44","918","1567","0","58.58","44.03"
"63","000","00","008","0827","1502","872","702","170","45","917","1554","0","59.01","45.17"
"63","000","00","008","0827","1503","857","668","189","59","916","1544","0","59.33","43.26"
"63","000","00","008","0827","1504","889","704","185","44","933","1528","0","61.06","46.07"
"63","000","00","008","0827","1505","931","757","174","31","962","1543","0","62.35","49.06"
"63","000","00","008","0828","0000","4053","3226","827","335","4388","9127","0","48.08","35.35"
"63","000","00","008","0828","1506","903","699","204","55","958","2754","0","34.79","25.38"
"63","000","00","008","0828","1507","726","631","95","66","792","1709","0","46.34","36.92"
"63","000","00","008","0828","1508","803","623","180","68","871","1515","0","57.49","41.12"
"63","000","00","008","0828","1509","785","612","173","75","860","1571","0","54.74","38.96"
"63","000","00","008","0828","1510","836","661","175","71","907","1578","0","57.48","41.89"
"63","000","00","008","0829","0000","3614","2860","754","289","3903","6503","0","60.02","43.98"
"63","000","00","008","0829","1511","761","590","171","64","825","1454","0","56.74","40.58"
"63","000","00","008","0829","1512","801","644","157","56","857","1436","0","59.68","44.85"
"63","000","00","008","0829","1513","821","657","164","55","876","1402","0","62.48","46.86"
"63","000","00","008","0829","1514","655","516","139","44","699","1117","0","62.58","46.2"
"63","000","00","008","0829","1515","576","453","123","70","646","1094","0","59.05","41.41"
"63","000","00","008","0830","0000","4120","3395","725","262","4382","7402","0","59.2","45.87"
"63","000","00","008","0830","1519","740","600","140","44","784","1385","0","56.61","43.32"
"63","000","00","008","0830","1520","812","650","162","56","868","1416","0","61.3","45.9"
"63","000","00","008","0830","1521","849","699","150","53","902","1412","0","63.88","49.5"
"63","000","00","008","0830","1522","827","653","174","53","880","1535","0","57.33","42.54"
"63","000","00","008","0830","1523","892","793","99","56","948","1654","0","57.32","47.94"
"63","000","00","008","0831","0000","2837","2323","514","145","2982","4781","0","62.37","48.59"
"63","000","00","008","0831","1524","698","556","142","31","729","1156","0","63.06","48.1"
"63","000","00","008","0831","1525","749","649","100","33","782","1231","0","63.53","52.72"
"63","000","00","008","0831","1526","678","538","140","40","718","1218","0","58.95","44.17"
"63","000","00","008","0831","1527","712","580","132","41","753","1176","0","64.03","49.32"
"63","000","00","008","0832","0000","2710","2109","601","195","2905","4889","0","59.42","43.14"
"63","000","00","008","0832","1532","877","676","201","55","932","1613","0","57.78","41.91"
"63","000","00","008","0832","1533","959","753","206","69","1028","1697","0","60.58","44.37"
"63","000","00","008","0832","1534","874","680","194","71","945","1579","0","59.85","43.07"
"63","000","00","008","0833","0000","3936","3052","884","235","4171","6932","0","60.17","44.03"
"63","000","00","008","0833","1538","924","697","227","60","984","1646","0","59.78","42.35"
"63","000","00","008","0833","1539","738","565","173","43","781","1286","0","60.73","43.93"
"63","000","00","008","0833","1540","721","571","150","29","750","1219","0","61.53","46.84"
"63","000","00","008","0833","1541","762","606","156","42","804","1292","0","62.23","46.9"
"63","000","00","008","0833","1542","791","613","178","61","852","1489","0","57.22","41.17"
"63","000","00","008","0834","0000","2784","2141","643","148","2932","5133","0","57.12","41.71"
"63","000","00","008","0834","1547","868","666","202","33","901","1816","0","49.61","36.67"
"63","000","00","008","0834","1548","525","379","146","33","558","985","0","56.65","38.48"
"63","000","00","008","0834","1549","771","612","159","38","809","1314","0","61.57","46.58"
"63","000","00","008","0834","1550","620","484","136","44","664","1018","0","65.23","47.54"
"63","000","00","008","0835","0000","4020","3109","911","232","4252","7131","0","59.63","43.6"
"63","000","00","008","0835","1551","888","683","205","41","929","1578","0","58.87","43.28"
"63","000","00","008","0835","1552","821","630","191","36","857","1457","0","58.82","43.24"
"63","000","00","008","0835","1553","770","608","162","47","817","1326","0","61.61","45.85"
"63","000","00","008","0835","1554","804","620","184","54","858","1393","0","61.59","44.51"
"63","000","00","008","0835","1555","737","568","169","54","791","1377","0","57.44","41.25"
"63","000","00","008","0836","0000","1825","1401","424","159","1984","3454","0","57.44","40.56"
"63","000","00","008","0836","1560","748","576","172","44","792","1288","0","61.49","44.72"
"63","000","00","008","0836","1561","659","514","145","59","718","1301","0","55.19","39.51"
"63","000","00","008","0836","1562","418","311","107","56","474","865","0","54.8","35.95"
"63","000","00","008","0837","0000","400","284","116","38","438","789","0","55.51","35.99"
"63","000","00","008","0837","1563","400","284","116","38","438","789","0","55.51","35.99"
"63","000","00","008","0838","0000","2201","1770","431","119","2320","3615","0","64.18","48.96"
"63","000","00","008","0838","1516","645","505","140","43","688","1070","0","64.3","47.2"
"63","000","00","008","0838","1517","808","665","143","38","846","1319","0","64.14","50.42"
"63","000","00","008","0838","1518","748","600","148","38","786","1226","0","64.11","48.94"
"63","000","00","008","0839","0000","3436","2654","782","233","3669","6498","0","56.46","40.84"
"63","000","00","008","0839","1543","921","726","195","57","978","1611","0","60.71","45.07"
"63","000","00","008","0839","1544","759","568","191","48","807","1549","0","52.1","36.67"
"63","000","00","008","0839","1545","871","682","189","69","940","1678","0","56.02","40.64"
"63","000","00","008","0839","1546","885","678","207","59","944","1660","0","56.87","40.84"
"63","000","00","008","0840","0000","3619","2786","833","165","3784","6091","0","62.12","45.74"
"63","000","00","008","0840","1556","835","637","198","30","865","1448","0","59.74","43.99"
"63","000","00","008","0840","1557","858","641","217","55","913","1447","0","63.1","44.3"
"63","000","00","008","0840","1558","1084","845","239","47","1131","1739","0","65.04","48.59"
"63","000","00","008","0840","1559","842","663","179","33","875","1457","0","60.05","45.5"
"63","000","00","008","0841","0000","2918","2342","576","235","3153","5308","0","59.4","44.12"
"63","000","00","008","0841","1528","718","623","95","49","767","1392","0","55.1","44.76"
"63","000","00","008","0841","1529","748","583","165","80","828","1323","0","62.59","44.07"
"63","000","00","008","0841","1530","700","537","163","45","745","1297","0","57.44","41.4"
"63","000","00","008","0841","1531","752","599","153","61","813","1296","0","62.73","46.22"
"63","000","00","008","0842","0000","2282","1821","461","161","2443","4385","0","55.71","41.53"
"63","000","00","008","0842","1447","813","623","190","47","860","1444","0","59.56","43.14"
"63","000","00","008","0842","1448","641","502","139","55","696","1495","0","46.56","33.58"
"63","000","00","008","0842","1449","828","696","132","59","887","1446","0","61.34","48.13"
"63","000","00","008","0843","0000","2346","1873","473","105","2451","4223","0","58.04","44.35"
"63","000","00","008","0843","1535","803","639","164","39","842","1320","0","63.79","48.41"
"63","000","00","008","0843","1536","785","615","170","36","821","1438","0","57.09","42.77"
"63","000","00","008","0843","1537","758","619","139","30","788","1465","0","53.79","42.25"
"63","000","00","009","0000","0000","55244","42721","12523","3123","58367","101907","121769","57.27","41.92"
"63","000","00","009","0901","0000","2787","2191","596","132","2919","5655","0","51.62","38.74"
"63","000","00","009","0901","0455","625","478","147","30","655","1280","0","51.17","37.34"
"63","000","00","009","0901","0456","721","579","142","26","747","1351","0","55.29","42.86"
"63","000","00","009","0901","0457","735","589","146","36","771","1345","0","57.32","43.79"
"63","000","00","009","0901","0458","706","545","161","40","746","1679","0","44.43","32.46"
"63","000","00","009","0902","0000","1596","1197","399","118","1714","3315","0","51.7","36.11"
"63","000","00","009","0902","0459","816","602","214","61","877","1680","0","52.2","35.83"
"63","000","00","009","0902","0460","780","595","185","57","837","1635","0","51.19","36.39"
"63","000","00","009","0903","0000","2054","1558","496","149","2203","3486","0","63.2","44.69"
"63","000","00","009","0903","0465","662","515","147","36","698","1086","0","64.27","47.42"
"63","000","00","009","0903","0466","723","549","174","57","780","1202","0","64.89","45.67"
"63","000","00","009","0903","0467","669","494","175","56","725","1198","0","60.52","41.24"
"63","000","00","009","0904","0000","3332","2622","710","154","3486","6330","0","55.07","41.42"
"63","000","00","009","0904","0461","755","582","173","46","801","1459","0","54.9","39.89"
"63","000","00","009","0904","0462","930","738","192","29","959","1706","0","56.21","43.26"
"63","000","00","009","0904","0463","849","649","200","52","901","1674","0","53.82","38.77"
"63","000","00","009","0904","0464","798","653","145","27","825","1491","0","55.33","43.8"
"63","000","00","009","0905","0000","3315","2556","759","198","3513","6336","0","55.45","40.34"
"63","000","00","009","0905","0483","734","568","166","56","790","1518","0","52.04","37.42"
"63","000","00","009","0905","0484","885","676","209","61","946","1552","0","60.95","43.56"
"63","000","00","009","0905","0485","827","634","193","24","851","1658","0","51.33","38.24"
"63","000","00","009","0905","0486","869","678","191","57","926","1608","0","57.59","42.16"
"63","000","00","009","0906","0000","1712","1379","333","89","1801","3337","0","53.97","41.32"
"63","000","00","009","0906","0504","786","630","156","37","823","1649","0","49.91","38.2"
"63","000","00","009","0906","0505","926","749","177","52","978","1688","0","57.94","44.37"
"63","000","00","009","0907","0000","2305","1810","495","131","2436","4093","0","59.52","44.22"
"63","000","00","009","0907","0490","773","608","165","47","820","1397","0","58.7","43.52"
"63","000","00","009","0907","0491","757","592","165","46","803","1352","0","59.39","43.79"
"63","000","00","009","0907","0492","775","610","165","38","813","1344","0","60.49","45.39"
"63","000","00","009","0908","0000","2151","1609","542","122","2273","4165","0","54.57","38.63"
"63","000","00","009","0908","0493","687","509","178","31","718","1385","0","51.84","36.75"
"63","000","00","009","0908","0494","738","545","193","49","787","1399","0","56.25","38.96"
"63","000","00","009","0908","0495","726","555","171","42","768","1381","0","55.61","40.19"
"63","000","00","009","0909","0000","2252","1730","522","126","2378","4228","0","56.24","40.92"
"63","000","00","009","0909","0496","800","607","193","58","858","1548","0","55.43","39.21"
"63","000","00","009","0909","0497","616","486","130","36","652","1190","0","54.79","40.84"
"63","000","00","009","0909","0498","836","637","199","32","868","1490","0","58.26","42.75"
"63","000","00","009","0910","0000","3381","2624","757","179","3560","5983","0","59.5","43.86"
"63","000","00","009","0910","0499","643","496","147","23","666","1096","0","60.77","45.26"
"63","000","00","009","0910","0500","737","572","165","23","760","1238","0","61.39","46.2"
"63","000","00","009","0910","0501","729","568","161","36","765","1271","0","60.19","44.69"
"63","000","00","009","0910","0502","624","496","128","49","673","1146","0","58.73","43.28"
"63","000","00","009","0910","0503","648","492","156","48","696","1232","0","56.49","39.94"
"63","000","00","009","0911","0000","3855","2935","920","220","4075","6741","0","60.45","43.54"
"63","000","00","009","0911","0518","731","587","144","31","762","1225","0","62.2","47.92"
"63","000","00","009","0911","0519","758","579","179","52","810","1264","0","64.08","45.81"
"63","000","00","009","0911","0520","920","701","219","81","1001","1649","0","60.7","42.51"
"63","000","00","009","0911","0521","723","488","235","20","743","1267","0","58.64","38.52"
"63","000","00","009","0911","0522","723","580","143","36","759","1336","0","56.81","43.41"
"63","000","00","009","0912","0000","2137","1641","496","147","2284","3805","0","60.03","43.13"
"63","000","00","009","0912","0509","680","526","154","80","760","1195","0","63.6","44.02"
"63","000","00","009","0912","0510","717","531","186","20","737","1254","0","58.77","42.34"
"63","000","00","009","0912","0511","740","584","156","47","787","1356","0","58.04","43.07"
"63","000","00","009","0913","0000","2300","1760","540","140","2440","4011","0","60.83","43.88"
"63","000","00","009","0913","0512","774","581","193","61","835","1363","0","61.26","42.63"
"63","000","00","009","0913","0513","787","610","177","42","829","1317","0","62.95","46.32"
"63","000","00","009","0913","0514","739","569","170","37","776","1331","0","58.3","42.75"
"63","000","00","009","0914","0000","2543","1951","592","171","2714","4733","0","57.34","41.22"
"63","000","00","009","0914","0515","877","656","221","69","946","1610","0","58.76","40.75"
"63","000","00","009","0914","0516","795","623","172","40","835","1542","0","54.15","40.4"
"63","000","00","009","0914","0517","871","672","199","62","933","1581","0","59.01","42.5"
"63","000","00","009","0915","0000","2494","1896","598","117","2611","4508","0","57.92","42.06"
"63","000","00","009","0915","0506","858","666","192","34","892","1503","0","59.35","44.31"
"63","000","00","009","0915","0507","819","617","202","32","851","1542","0","55.19","40.01"
"63","000","00","009","0915","0508","817","613","204","51","868","1463","0","59.33","41.9"
"63","000","00","009","0916","0000","3881","3001","880","271","4152","7922","0","52.41","37.88"
"63","000","00","009","0916","0478","764","600","164","65","829","1529","0","54.22","39.24"
"63","000","00","009","0916","0479","798","590","208","56","854","1618","0","52.78","36.46"
"63","000","00","009","0916","0480","689","526","163","64","753","1545","0","48.74","34.05"
"63","000","00","009","0916","0481","840","666","174","51","891","1569","0","56.79","42.45"
"63","000","00","009","0916","0482","790","619","171","35","825","1661","0","49.67","37.27"
"63","000","00","009","0917","0000","4538","3433","1105","250","4788","8171","0","58.6","42.01"
"63","000","00","009","0917","0468","696","517","179","35","731","1430","0","51.12","36.15"
"63","000","00","009","0917","0469","727","518","209","60","787","1275","0","61.73","40.63"
"63","000","00","009","0917","0470","812","604","208","51","863","1344","0","64.21","44.94"
"63","000","00","009","0917","0471","790","587","203","39","829","1391","0","59.6","42.2"
"63","000","00","009","0917","0472","793","623","170","28","821","1342","0","61.18","46.42"
"63","000","00","009","0917","0473","720","584","136","37","757","1389","0","54.5","42.04"
"63","000","00","009","0918","0000","3135","2494","641","157","3292","5592","0","58.87","44.6"
"63","000","00","009","0918","0474","807","626","181","46","853","1426","0","59.82","43.9"
"63","000","00","009","0918","0475","779","659","120","31","810","1359","0","59.6","48.49"
"63","000","00","009","0918","0476","735","568","167","55","790","1366","0","57.83","41.58"
"63","000","00","009","0918","0477","814","641","173","25","839","1441","0","58.22","44.48"
"63","000","00","009","0919","0000","2844","2272","572","134","2978","4916","0","60.58","46.22"
"63","000","00","009","0919","0523","688","551","137","28","716","1162","0","61.62","47.42"
"63","000","00","009","0919","0524","586","461","125","24","610","1045","0","58.37","44.11"
"63","000","00","009","0919","0525","838","667","171","51","889","1351","0","65.8","49.37"
"63","000","00","009","0919","0526","732","593","139","31","763","1358","0","56.19","43.67"
"63","000","00","009","0920","0000","2632","2062","570","118","2750","4580","0","60.04","45.02"
"63","000","00","009","0920","0487","755","571","184","38","793","1475","0","53.76","38.71"
"63","000","00","009","0920","0488","1025","812","213","43","1068","1722","0","62.02","47.15"
"63","000","00","009","0920","0489","852","679","173","37","889","1383","0","64.28","49.1"
"63","000","00","010","0000","0000","130005","101210","28795","6798","136803","236824","287227","57.77","42.74"
"63","000","00","010","1001","0000","3474","2656","818","230","3704","6500","0","56.98","40.86"
"63","000","00","010","1001","0305","816","646","170","24","840","1661","0","50.57","38.89"
"63","000","00","010","1001","0306","827","614","213","63","890","1602","0","55.56","38.33"
"63","000","00","010","1001","0307","921","715","206","97","1018","1655","0","61.51","43.2"
"63","000","00","010","1001","0308","910","681","229","46","956","1582","0","60.43","43.05"
"63","000","00","010","1002","0000","4422","3519","903","294","4716","8357","0","56.43","42.11"
"63","000","00","010","1002","0309","814","686","128","36","850","1688","0","50.36","40.64"
"63","000","00","010","1002","0310","932","730","202","43","975","1737","0","56.13","42.03"
"63","000","00","010","1002","0311","982","769","213","72","1054","1809","0","58.26","42.51"
"63","000","00","010","1002","0312","733","580","153","52","785","1376","0","57.05","42.15"
"63","000","00","010","1002","0313","961","754","207","91","1052","1747","0","60.22","43.16"
"63","000","00","010","1003","0000","3510","2744","766","163","3673","5914","0","62.11","46.4"
"63","000","00","010","1003","0314","798","634","164","34","832","1389","0","59.9","45.64"
"63","000","00","010","1003","0315","866","683","183","41","907","1454","0","62.38","46.97"
"63","000","00","010","1003","0316","881","665","216","48","929","1468","0","63.28","45.3"
"63","000","00","010","1003","0317","965","762","203","40","1005","1603","0","62.69","47.54"
"63","000","00","010","1005","0000","2952","2265","687","173","3125","5276","0","59.23","42.93"
"63","000","00","010","1005","0318","946","731","215","44","990","1795","0","55.15","40.72"
"63","000","00","010","1005","0319","1031","779","252","55","1086","1737","0","62.52","44.85"
"63","000","00","010","1005","0320","975","755","220","74","1049","1744","0","60.15","43.29"
"63","000","00","010","1006","0000","2660","2070","590","128","2788","4732","0","58.92","43.74"
"63","000","00","010","1006","0321","911","719","192","63","974","1661","0","58.64","43.29"
"63","000","00","010","1006","0322","867","654","213","39","906","1577","0","57.45","41.47"
"63","000","00","010","1006","0323","882","697","185","26","908","1494","0","60.78","46.65"
"63","000","00","010","1007","0000","4583","3452","1131","282","4865","8285","0","58.72","41.67"
"63","000","00","010","1007","0324","891","705","186","61","952","1626","0","58.55","43.36"
"63","000","00","010","1007","0325","905","714","191","71","976","1641","0","59.48","43.51"
"63","000","00","010","1007","0326","860","658","202","44","904","1554","0","58.17","42.34"
"63","000","00","010","1007","0327","1000","661","339","46","1046","1728","0","60.53","38.25"
"63","000","00","010","1007","0328","927","714","213","60","987","1736","0","56.85","41.13"
"63","000","00","010","1008","0000","4324","3381","943","183","4507","7740","0","58.23","43.68"
"63","000","00","010","1008","0329","897","715","182","41","938","1461","0","64.2","48.94"
"63","000","00","010","1008","0330","834","665","169","39","873","1509","0","57.85","44.07"
"63","000","00","010","1008","0331","735","550","185","27","762","1358","0","56.11","40.5"
"63","000","00","010","1008","0332","948","731","217","46","994","1761","0","56.45","41.51"
"63","000","00","010","1008","0333","910","720","190","30","940","1651","0","56.94","43.61"
"63","000","00","010","1009","0000","3014","2394","620","136","3150","5472","0","57.57","43.75"
"63","000","00","010","1009","0334","1020","793","227","62","1082","1809","0","59.81","43.84"
"63","000","00","010","1009","0335","985","788","197","41","1026","1773","0","57.87","44.44"
"63","000","00","010","1009","0336","1009","813","196","33","1042","1890","0","55.13","43.02"
"63","000","00","010","1010","0000","4261","3348","913","182","4443","7310","0","60.78","45.8"
"63","000","00","010","1010","0337","1072","823","249","61","1133","1760","0","64.38","46.76"
"63","000","00","010","1010","0338","934","732","202","41","975","1645","0","59.27","44.5"
"63","000","00","010","1010","0339","787","626","161","20","807","1324","0","60.95","47.28"
"63","000","00","010","1010","0340","635","508","127","28","663","1072","0","61.85","47.39"
"63","000","00","010","1010","0341","833","659","174","32","865","1509","0","57.32","43.67"
"63","000","00","010","1011","0000","3976","3022","954","187","4163","7069","0","58.89","42.75"
"63","000","00","010","1011","0342","939","676","263","56","995","1715","0","58.02","39.42"
"63","000","00","010","1011","0343","990","786","204","45","1035","1774","0","58.34","44.31"
"63","000","00","010","1011","0344","1087","840","247","50","1137","1796","0","63.31","46.77"
"63","000","00","010","1011","0345","960","720","240","36","996","1784","0","55.83","40.36"
"63","000","00","010","1012","0000","2781","2107","674","147","2928","4835","0","60.56","43.58"
"63","000","00","010","1012","0346","816","611","205","60","876","1417","0","61.82","43.12"
"63","000","00","010","1012","0347","931","693","238","42","973","1699","0","57.27","40.79"
"63","000","00","010","1012","0348","1034","803","231","45","1079","1719","0","62.77","46.71"
"63","000","00","010","1013","0000","2503","1942","561","125","2628","4784","0","54.93","40.59"
"63","000","00","010","1013","0349","955","743","212","23","978","1715","0","57.03","43.32"
"63","000","00","010","1013","0350","803","630","173","31","834","1634","0","51.04","38.56"
"63","000","00","010","1013","0351","745","569","176","71","816","1435","0","56.86","39.65"
"63","000","00","010","1014","0000","3172","2523","649","193","3365","5804","0","57.98","43.47"
"63","000","00","010","1014","0352","771","622","149","30","801","1440","0","55.63","43.19"
"63","000","00","010","1014","0353","855","683","172","32","887","1446","0","61.34","47.23"
"63","000","00","010","1014","0354","846","673","173","56","902","1657","0","54.44","40.62"
"63","000","00","010","1014","0355","700","545","155","75","775","1261","0","61.46","43.22"
"63","000","00","010","1015","0000","3549","2698","851","195","3744","6183","0","60.55","43.64"
"63","000","00","010","1015","0356","204","138","66","32","236","456","0","51.75","30.26"
"63","000","00","010","1015","0357","906","700","206","38","944","1433","0","65.88","48.85"
"63","000","00","010","1015","0358","836","616","220","37","873","1485","0","58.79","41.48"
"63","000","00","010","1015","0359","870","672","198","36","906","1590","0","56.98","42.26"
"63","000","00","010","1015","0360","733","572","161","52","785","1219","0","64.4","46.92"
"63","000","00","010","1016","0000","2782","2196","586","138","2920","5096","0","57.3","43.09"
"63","000","00","010","1016","0361","946","729","217","58","1004","1732","0","57.97","42.09"
"63","000","00","010","1016","0362","923","767","156","30","953","1727","0","55.18","44.41"
"63","000","00","010","1016","0363","913","700","213","50","963","1637","0","58.83","42.76"
"63","000","00","010","1017","0000","4147","3293","854","181","4328","7433","0","58.23","44.3"
"63","000","00","010","1017","0364","786","625","161","44","830","1453","0","57.12","43.01"
"63","000","00","010","1017","0365","866","696","170","35","901","1617","0","55.72","43.04"
"63","000","00","010","1017","0366","876","722","154","25","901","1604","0","56.17","45.01"
"63","000","00","010","1017","0367","855","661","194","34","889","1406","0","63.23","47.01"
"63","000","00","010","1017","0368","764","589","175","43","807","1353","0","59.65","43.53"
"63","000","00","010","1018","0000","3420","2706","714","151","3571","6052","0","59.01","44.71"
"63","000","00","010","1018","0369","983","787","196","50","1033","1724","0","59.92","45.65"
"63","000","00","010","1018","0370","796","616","180","33","829","1378","0","60.16","44.7"
"63","000","00","010","1018","0371","820","668","152","30","850","1403","0","60.58","47.61"
"63","000","00","010","1018","0372","821","635","186","38","859","1547","0","55.53","41.05"
"63","000","00","010","1019","0000","4084","3168","916","207","4291","7177","0","59.79","44.14"
"63","000","00","010","1019","0373","986","755","231","50","1036","1718","0","60.3","43.95"
"63","000","00","010","1019","0374","992","754","238","44","1036","1813","0","57.14","41.59"
"63","000","00","010","1019","0375","1043","811","232","65","1108","1791","0","61.86","45.28"
"63","000","00","010","1019","0376","1063","848","215","48","1111","1855","0","59.89","45.71"
"63","000","00","010","1020","0000","3836","3076","760","193","4029","6880","0","58.56","44.71"
"63","000","00","010","1020","0377","956","776","180","34","990","1731","0","57.19","44.83"
"63","000","00","010","1020","0378","963","753","210","58","1021","1593","0","64.09","47.27"
"63","000","00","010","1020","0379","955","764","191","48","1003","1869","0","53.67","40.88"
"63","000","00","010","1020","0380","962","783","179","53","1015","1687","0","60.17","46.41"
"63","000","00","010","1021","0000","2424","1933","491","112","2536","4144","0","61.2","46.65"
"63","000","00","010","1021","0381","868","661","207","25","893","1530","0","58.37","43.2"
"63","000","00","010","1021","0382","753","622","131","47","800","1300","0","61.54","47.85"
"63","000","00","010","1021","0383","803","650","153","40","843","1314","0","64.16","49.47"
"63","000","00","010","1022","0000","4594","3597","997","244","4838","8925","0","54.21","40.3"
"63","000","00","010","1022","0384","694","542","152","33","727","1433","0","50.73","37.82"
"63","000","00","010","1022","0385","758","606","152","34","792","1450","0","54.62","41.79"
"63","000","00","010","1022","0386","858","679","179","59","917","1608","0","57.03","42.23"
"63","000","00","010","1022","0387","794","635","159","43","837","1414","0","59.19","44.91"
"63","000","00","010","1022","0388","715","531","184","47","762","1492","0","51.07","35.59"
"63","000","00","010","1022","0389","775","604","171","28","803","1528","0","52.55","39.53"
"63","000","00","010","1023","0000","3574","2741","833","166","3740","6634","0","56.38","41.32"
"63","000","00","010","1023","0390","934","721","213","45","979","1692","0","57.86","42.61"
"63","000","00","010","1023","0391","867","665","202","53","920","1556","0","59.13","42.74"
"63","000","00","010","1023","0392","870","668","202","25","895","1637","0","54.67","40.81"
"63","000","00","010","1023","0393","903","687","216","43","946","1749","0","54.09","39.28"
"63","000","00","010","1024","0000","3957","3041","916","242","4199","7348","0","57.14","41.39"
"63","000","00","010","1024","0394","636","495","141","39","675","1220","0","55.33","40.57"
"63","000","00","010","1024","0395","866","660","206","56","922","1600","0","57.63","41.25"
"63","000","00","010","1024","0396","806","625","181","44","850","1473","0","57.71","42.43"
"63","000","00","010","1024","0397","805","615","190","56","861","1498","0","57.48","41.05"
"63","000","00","010","1024","0398","844","646","198","47","891","1557","0","57.23","41.49"
"63","000","00","010","1025","0000","2202","1676","526","130","2332","4190","0","55.66","40.0"
"63","000","00","010","1025","0399","863","662","201","37","900","1674","0","53.76","39.55"
"63","000","00","010","1025","0400","987","750","237","46","1033","1728","0","59.78","43.4"
"63","000","00","010","1025","0401","352","264","88","47","399","788","0","50.63","33.5"
"63","000","00","010","1026","0000","3708","2839","869","197","3905","7138","0","54.71","39.77"
"63","000","00","010","1026","0402","803","572","231","70","873","1542","0","56.61","37.09"
"63","000","00","010","1026","0403","788","613","175","50","838","1676","0","50.0","36.58"
"63","000","00","010","1026","0404","664","481","183","28","692","1360","0","50.88","35.37"
"63","000","00","010","1026","0405","762","611","151","29","791","1259","0","62.83","48.53"
"63","000","00","010","1026","0406","691","562","129","20","711","1301","0","54.65","43.2"
"63","000","00","010","1027","0000","3152","2464","688","167","3319","5998","0","55.34","41.08"
"63","000","00","010","1027","0407","605","446","159","41","646","1251","0","51.64","35.65"
"63","000","00","010","1027","0408","786","616","170","64","850","1502","0","56.59","41.01"
"63","000","00","010","1027","0409","855","691","164","36","891","1596","0","55.83","43.3"
"63","000","00","010","1027","0410","906","711","195","26","932","1649","0","56.52","43.12"
"63","000","00","010","1028","0000","1798","1428","370","100","1898","3520","0","53.92","40.57"
"63","000","00","010","1028","0411","921","747","174","60","981","1774","0","55.3","42.11"
"63","000","00","010","1028","0412","877","681","196","40","917","1746","0","52.52","39.0"
"63","000","00","010","1029","0000","3401","2586","815","176","3577","7676","0","46.6","33.69"
"63","000","00","010","1029","0413","774","584","190","23","797","1473","0","54.11","39.65"
"63","000","00","010","1029","0414","903","686","217","67","970","2824","0","34.35","24.29"
"63","000","00","010","1029","0415","921","705","216","34","955","1849","0","51.65","38.13"
"63","000","00","010","1029","0416","803","611","192","52","855","1530","0","55.88","39.93"
"63","000","00","010","1030","0000","2656","2032","624","149","2805","4808","0","58.34","42.26"
"63","000","00","010","1030","0417","894","671","223","50","944","1656","0","57.0","40.52"
"63","000","00","010","1030","0418","800","606","194","45","845","1457","0","58.0","41.59"
"63","000","00","010","1030","0419","962","755","207","54","1016","1695","0","59.94","44.54"
"63","000","00","010","1031","0000","3693","2865","828","179","3872","6644","0","58.28","43.12"
"63","000","00","010","1031","0420","944","751","193","41","985","1663","0","59.23","45.16"
"63","000","00","010","1031","0421","894","700","194","50","944","1654","0","57.07","42.32"
"63","000","00","010","1031","0422","939","718","221","47","986","1642","0","60.05","43.73"
"63","000","00","010","1031","0423","916","696","220","41","957","1685","0","56.8","41.31"
"63","000","00","010","1032","0000","3147","2483","664","159","3306","5552","0","59.55","44.72"
"63","000","00","010","1032","0424","993","753","240","54","1047","1862","0","56.23","40.44"
"63","000","00","010","1032","0425","1080","842","238","50","1130","1900","0","59.47","44.32"
"63","000","00","010","1032","0426","1074","888","186","55","1129","1790","0","63.07","49.61"
"63","000","00","010","1033","0000","2510","1975","535","181","2691","4787","0","56.21","41.26"
"63","000","00","010","1033","0427","761","594","167","52","813","1417","0","57.37","41.92"
"63","000","00","010","1033","0428","905","709","196","61","966","1694","0","57.02","41.85"
"63","000","00","010","1033","0429","844","672","172","68","912","1676","0","54.42","40.1"
"63","000","00","010","1034","0000","4569","3584","985","206","4775","8109","0","58.89","44.2"
"63","000","00","010","1034","0430","892","669","223","23","915","1643","0","55.69","40.72"
"63","000","00","010","1034","0431","889","711","178","44","933","1588","0","58.75","44.77"
"63","000","00","010","1034","0432","911","705","206","48","959","1603","0","59.83","43.98"
"63","000","00","010","1034","0433","912","730","182","42","954","1629","0","58.56","44.81"
"63","000","00","010","1034","0434","965","769","196","49","1014","1646","0","61.6","46.72"
"63","000","00","010","1035","0000","4054","3218","836","241","4295","7457","0","57.6","43.15"
"63","000","00","010","1035","0435","1001","813","188","42","1043","1883","0","55.39","43.18"
"63","000","00","010","1035","0436","765","602","163","48","813","1434","0","56.69","41.98"
"63","000","00","010","1035","0437","762","608","154","39","801","1418","0","56.49","42.88"
"63","000","00","010","1035","0438","765","603","162","56","821","1373","0","59.8","43.92"
"63","000","00","010","1035","0439","761","592","169","56","817","1349","0","60.56","43.88"
"63","000","00","010","1036","0000","2624","2045","579","172","2796","4624","0","60.47","44.23"
"63","000","00","010","1036","0440","878","677","201","54","932","1511","0","61.68","44.8"
"63","000","00","010","1036","0441","893","706","187","67","960","1563","0","61.42","45.17"
"63","000","00","010","1036","0442","853","662","191","51","904","1550","0","58.32","42.71"
"63","000","00","010","1037","0000","615","466","149","39","654","1157","0","56.53","40.28"
"63","000","00","010","1037","0443","615","466","149","39","654","1157","0","56.53","40.28"
"63","000","00","010","1038","0000","2854","2174","680","163","3017","5175","0","58.3","42.01"
"63","000","00","010","1038","0444","979","724","255","41","1020","1768","0","57.69","40.95"
"63","000","00","010","1038","0445","913","715","198","58","971","1664","0","58.35","42.97"
"63","000","00","010","1038","0446","962","735","227","64","1026","1743","0","58.86","42.17"
"63","000","00","010","1039","0000","4234","3328","906","168","4402","7392","0","59.55","45.02"
"63","000","00","010","1039","0447","830","660","170","31","861","1480","0","58.18","44.59"
"63","000","00","010","1039","0448","933","709","224","49","982","1589","0","61.8","44.62"
"63","000","00","010","1039","0449","760","605","155","33","793","1371","0","57.84","44.13"
"63","000","00","010","1039","0450","931","721","210","39","970","1575","0","61.59","45.78"
"63","000","00","010","1039","0451","780","633","147","16","796","1377","0","57.81","45.97"
"63","000","00","010","1040","0000","2789","2175","614","119","2908","4647","0","62.58","46.8"
"63","000","00","010","1040","0452","914","702","212","55","969","1469","0","65.96","47.79"
"63","000","00","010","1040","0453","922","717","205","18","940","1529","0","61.48","46.89"
"63","000","00","010","1040","0454","953","756","197","46","999","1649","0","60.58","45.85"
"63","000","00","011","0000","0000","127739","95594","32145","9355","137094","241854","286695","56.68","39.53"
"63","000","00","011","1101","0000","1782","1314","468","168","1950","3415","0","57.1","38.48"
"63","000","00","011","1101","0142","862","638","224","77","939","1695","0","55.4","37.64"
"63","000","00","011","1101","0143","920","676","244","91","1011","1720","0","58.78","39.3"
"63","000","00","011","1102","0000","1464","1125","339","131","1595","2834","0","56.28","39.7"
"63","000","00","011","1102","0144","661","507","154","76","737","1288","0","57.22","39.36"
"63","000","00","011","1102","0145","803","618","185","55","858","1546","0","55.5","39.97"
"63","000","00","011","1103","0000","1481","1107","374","122","1603","2659","0","60.29","41.63"
"63","000","00","011","1103","0146","385","305","80","26","411","652","0","63.04","46.78"
"63","000","00","011","1103","0147","444","331","113","41","485","870","0","55.75","38.05"
"63","000","00","011","1103","0148","652","471","181","55","707","1137","0","62.18","41.42"
"63","000","00","011","1104","0000","2266","1665","601","195","2461","5331","0","46.16","31.23"
"63","000","00","011","1104","0149","610","439","171","53","663","1050","0","63.14","41.81"
"63","000","00","011","1104","0150","586","439","147","56","642","1031","0","62.27","42.58"
"63","000","00","011","1104","0151","604","449","155","33","637","1075","0","59.26","41.77"
"63","000","00","011","1104","0152","466","338","128","53","519","2175","0","23.86","15.54"
"63","000","00","011","1105","0000","3694","2758","936","252","3946","6757","0","58.4","40.82"
"63","000","00","011","1105","0153","876","672","204","58","934","1775","0","52.62","37.86"
"63","000","00","011","1105","0154","917","724","193","59","976","1669","0","58.48","43.38"
"63","000","00","011","1105","0155","952","661","291","60","1012","1665","0","60.78","39.7"
"63","000","00","011","1105","0156","949","701","248","75","1024","1648","0","62.14","42.54"
"63","000","00","011","1106","0000","3046","2203","843","206","3252","5565","0","58.44","39.59"
"63","000","00","011","1106","0157","685","520","165","28","713","1246","0","57.22","41.73"
"63","000","00","011","1106","0158","749","539","210","71","820","1419","0","57.79","37.98"
"63","000","00","011","1106","0159","700","491","209","78","778","1327","0","58.63","37.0"
"63","000","00","011","1106","0160","912","653","259","29","941","1573","0","59.82","41.51"
"63","000","00","011","1107","0000","3655","2808","847","227","3882","6779","0","57.27","41.42"
"63","000","00","011","1107","0161","797","616","181","75","872","1470","0","59.32","41.9"
"63","000","00","011","1107","0162","940","698","242","34","974","1775","0","54.87","39.32"
"63","000","00","011","1107","0163","904","730","174","62","966","1692","0","57.09","43.14"
"63","000","00","011","1107","0164","1014","764","250","56","1070","1842","0","58.09","41.48"
"63","000","00","011","1108","0000","3888","2912","976","253","4141","7204","0","57.48","40.42"
"63","000","00","011","1108","0165","670","507","163","47","717","1166","0","61.49","43.48"
"63","000","00","011","1108","0166","815","623","192","0","815","1687","0","48.31","36.93"
"63","000","00","011","1108","0167","848","625","223","75","923","1624","0","56.83","38.49"
"63","000","00","011","1108","0168","843","620","223","83","926","1477","0","62.69","41.98"
"63","000","00","011","1108","0169","712","537","175","48","760","1250","0","60.8","42.96"
"63","000","00","011","1109","0000","3318","2473","845","286","3604","5934","0","60.73","41.68"
"63","000","00","011","1109","0170","766","576","190","89","855","1434","0","59.62","40.17"
"63","000","00","011","1109","0171","801","578","223","65","866","1452","0","59.64","39.81"
"63","000","00","011","1109","0172","894","659","235","65","959","1533","0","62.56","42.99"
"63","000","00","011","1109","0173","857","660","197","67","924","1515","0","60.99","43.56"
"63","000","00","011","1110","0000","2191","1651","540","176","2367","3942","0","60.05","41.88"
"63","000","00","011","1110","0174","673","497","176","55","728","1203","0","60.52","41.31"
"63","000","00","011","1110","0175","845","642","203","82","927","1487","0","62.34","43.17"
"63","000","00","011","1110","0176","673","512","161","39","712","1252","0","56.87","40.89"
"63","000","00","011","1111","0000","3000","2115","885","246","3246","6175","0","52.57","34.25"
"63","000","00","011","1111","0177","806","598","208","54","860","1536","0","55.99","38.93"
"63","000","00","011","1111","0178","874","643","231","73","947","1556","0","60.86","41.32"
"63","000","00","011","1111","0179","822","627","195","58","880","1511","0","58.24","41.5"
"63","000","00","011","1111","0180","498","247","251","61","559","1572","0","35.56","15.71"
"63","000","00","011","1112","0000","2565","1951","614","242","2807","4921","0","57.04","39.65"
"63","000","00","011","1112","0181","868","674","194","78","946","1668","0","56.71","40.41"
"63","000","00","011","1112","0182","849","636","213","107","956","1685","0","56.74","37.74"
"63","000","00","011","1112","0183","848","641","207","57","905","1568","0","57.72","40.88"
"63","000","00","011","1113","0000","2886","2159","727","260","3146","5632","0","55.86","38.33"
"63","000","00","011","1113","0184","679","516","163","51","730","1327","0","55.01","38.88"
"63","000","00","011","1113","0185","671","482","189","75","746","1338","0","55.75","36.02"
"63","000","00","011","1113","0186","731","548","183","70","801","1515","0","52.87","36.17"
"63","000","00","011","1113","0187","805","613","192","64","869","1452","0","59.85","42.22"
"63","000","00","011","1114","0000","2389","1806","583","151","2540","4430","0","57.34","40.77"
"63","000","00","011","1114","0188","774","613","161","58","832","1448","0","57.46","42.33"
"63","000","00","011","1114","0189","838","627","211","52","890","1521","0","58.51","41.22"
"63","000","00","011","1114","0190","777","566","211","41","818","1461","0","55.99","38.74"
"63","000","00","011","1115","0000","2273","1689","584","206","2479","4747","0","52.22","35.58"
"63","000","00","011","1115","0191","748","532","216","82","830","1541","0","53.86","34.52"
"63","000","00","011","1115","0192","690","527","163","55","745","1611","0","46.24","32.71"
"63","000","00","011","1115","0193","835","630","205","69","904","1595","0","56.68","39.5"
"63","000","00","011","1116","0000","2585","1931","654","214","2799","5188","0","53.95","37.22"
"63","000","00","011","1116","0194","827","629","198","38","865","1685","0","51.34","37.33"
"63","000","00","011","1116","0195","899","679","220","78","977","1816","0","53.8","37.39"
"63","000","00","011","1116","0196","859","623","236","98","957","1687","0","56.73","36.93"
"63","000","00","011","1117","0000","3499","2673","826","261","3760","6631","0","56.7","40.31"
"63","000","00","011","1117","0197","843","626","217","83","926","1646","0","56.26","38.03"
"63","000","00","011","1117","0198","829","627","202","56","885","1643","0","53.86","38.16"
"63","000","00","011","1117","0199","921","721","200","54","975","1687","0","57.79","42.74"
"63","000","00","011","1117","0200","906","699","207","68","974","1655","0","58.85","42.24"
"63","000","00","011","1118","0000","1920","1401","519","97","2017","3634","0","55.5","38.55"
"63","000","00","011","1118","0201","910","664","246","32","942","1779","0","52.95","37.32"
"63","000","00","011","1118","0202","1010","737","273","65","1075","1855","0","57.95","39.73"
"63","000","00","011","1119","0000","2717","2031","686","201","2918","5700","0","51.19","35.63"
"63","000","00","011","1119","0203","723","555","168","58","781","1350","0","57.85","41.11"
"63","000","00","011","1119","0204","717","572","145","28","745","1455","0","51.2","39.31"
"63","000","00","011","1119","0205","663","452","211","60","723","1497","0","48.3","30.19"
"63","000","00","011","1119","0206","614","452","162","55","669","1398","0","47.85","32.33"
"63","000","00","011","1120","0000","4216","3048","1168","385","4601","8041","0","57.22","37.91"
"63","000","00","011","1120","0207","951","699","252","75","1026","1747","0","58.73","40.01"
"63","000","00","011","1120","0208","744","573","171","83","827","1465","0","56.45","39.11"
"63","000","00","011","1120","0209","897","585","312","68","965","1530","0","63.07","38.24"
"63","000","00","011","1120","0210","879","642","237","83","962","1855","0","51.86","34.61"
"63","000","00","011","1120","0211","745","549","196","76","821","1444","0","56.86","38.02"
"63","000","00","011","1121","0000","3181","2385","796","326","3507","6387","0","54.91","37.34"
"63","000","00","011","1121","0212","759","574","185","72","831","1563","0","53.17","36.72"
"63","000","00","011","1121","0213","722","520","202","80","802","1482","0","54.12","35.09"
"63","000","00","011","1121","0214","773","561","212","92","865","1552","0","55.73","36.15"
"63","000","00","011","1121","0215","927","730","197","82","1009","1790","0","56.37","40.78"
"63","000","00","011","1122","0000","3141","2259","882","339","3480","6383","0","54.52","35.39"
"63","000","00","011","1122","0216","771","597","174","79","850","1628","0","52.21","36.67"
"63","000","00","011","1122","0217","679","483","196","68","747","1337","0","55.87","36.13"
"63","000","00","011","1122","0218","898","601","297","90","988","1750","0","56.46","34.34"
"63","000","00","011","1122","0219","793","578","215","102","895","1668","0","53.66","34.65"
"63","000","00","011","1123","0000","1907","1375","532","167","2074","4342","0","47.77","31.67"
"63","000","00","011","1123","0220","595","432","163","73","668","1403","0","47.61","30.79"
"63","000","00","011","1123","0221","647","455","192","58","705","1468","0","48.02","30.99"
"63","000","00","011","1123","0222","665","488","177","36","701","1471","0","47.65","33.17"
"63","000","00","011","1124","0000","2438","1868","570","225","2663","5240","0","50.82","35.65"
"63","000","00","011","1124","0223","782","605","177","88","870","1666","0","52.22","36.31"
"63","000","00","011","1124","0224","766","570","196","57","823","1587","0","51.86","35.92"
"63","000","00","011","1124","0225","890","693","197","80","970","1987","0","48.82","34.88"
"63","000","00","011","1125","0000","1559","1168","391","104","1663","2999","0","55.45","38.95"
"63","000","00","011","1125","0226","600","448","152","29","629","1271","0","49.49","35.25"
"63","000","00","011","1125","0227","959","720","239","75","1034","1728","0","59.84","41.67"
"63","000","00","011","1126","0000","3539","2707","832","227","3766","6297","0","59.81","42.99"
"63","000","00","011","1126","0228","916","696","220","62","978","1630","0","60.0","42.7"
"63","000","00","011","1126","0229","922","679","243","49","971","1619","0","59.98","41.94"
"63","000","00","011","1126","0230","784","623","161","54","838","1425","0","58.81","43.72"
"63","000","00","011","1126","0231","917","709","208","62","979","1623","0","60.32","43.68"
"63","000","00","011","1127","0000","2216","1629","587","160","2376","3862","0","61.52","42.18"
"63","000","00","011","1127","0242","764","540","224","66","830","1273","0","65.2","42.42"
"63","000","00","011","1127","0243","713","539","174","47","760","1273","0","59.7","42.34"
"63","000","00","011","1127","0244","739","550","189","47","786","1316","0","59.73","41.79"
"63","000","00","011","1128","0000","2638","2009","629","155","2793","4960","0","56.31","40.5"
"63","000","00","011","1128","0245","895","659","236","64","959","1659","0","57.81","39.72"
"63","000","00","011","1128","0246","911","720","191","41","952","1749","0","54.43","41.17"
"63","000","00","011","1128","0247","832","630","202","50","882","1552","0","56.83","40.59"
"63","000","00","011","1129","0000","2602","1951","651","146","2748","4457","0","61.66","43.77"
"63","000","00","011","1129","0232","862","641","221","52","914","1564","0","58.44","40.98"
"63","000","00","011","1129","0233","838","573","265","56","894","1376","0","64.97","41.64"
"63","000","00","011","1129","0234","902","737","165","38","940","1517","0","61.96","48.58"
"63","000","00","011","1130","0000","2670","2120","550","155","2825","4952","0","57.05","42.81"
"63","000","00","011","1130","0248","852","700","152","52","904","1529","0","59.12","45.78"
"63","000","00","011","1130","0249","869","695","174","45","914","1644","0","55.6","42.27"
"63","000","00","011","1130","0250","949","725","224","58","1007","1779","0","56.6","40.75"
"63","000","00","011","1131","0000","3634","2723","911","189","3823","6584","0","58.07","41.36"
"63","000","00","011","1131","0235","885","635","250","45","930","1729","0","53.79","36.73"
"63","000","00","011","1131","0236","882","673","209","44","926","1511","0","61.28","44.54"
"63","000","00","011","1131","0237","1023","778","245","53","1076","1811","0","59.41","42.96"
"63","000","00","011","1131","0238","844","637","207","47","891","1533","0","58.12","41.55"
"63","000","00","011","1132","0000","2573","2021","552","148","2721","4558","0","59.7","44.34"
"63","000","00","011","1132","0239","1019","786","233","53","1072","1657","0","64.7","47.44"
"63","000","00","011","1132","0240","807","647","160","34","841","1499","0","56.1","43.16"
"63","000","00","011","1132","0241","747","588","159","61","808","1402","0","57.63","41.94"
"63","000","00","011","1133","0000","2700","2053","647","195","2895","5127","0","56.47","40.04"
"63","000","00","011","1133","0260","956","733","223","67","1023","1826","0","56.02","40.14"
"63","000","00","011","1133","0261","874","660","214","61","935","1647","0","56.77","40.07"
"63","000","00","011","1133","0262","870","660","210","67","937","1654","0","56.65","39.9"
"63","000","00","011","1134","0000","4181","3134","1047","228","4409","7652","0","57.62","40.96"
"63","000","00","011","1134","0251","847","635","212","53","900","1597","0","56.36","39.76"
"63","000","00","011","1134","0252","792","594","198","59","851","1454","0","58.53","40.85"
"63","000","00","011","1134","0253","920","669","251","46","966","1582","0","61.06","42.29"
"63","000","00","011","1134","0254","862","672","190","47","909","1518","0","59.88","44.27"
"63","000","00","011","1134","0255","760","564","196","23","783","1501","0","52.17","37.57"
"63","000","00","011","1135","0000","3231","2364","867","210","3441","5690","0","60.47","41.55"
"63","000","00","011","1135","0256","804","585","219","50","854","1420","0","60.14","41.2"
"63","000","00","011","1135","0257","815","602","213","57","872","1494","0","58.37","40.29"
"63","000","00","011","1135","0258","895","658","237","56","951","1568","0","60.65","41.96"
"63","000","00","011","1135","0259","717","519","198","47","764","1208","0","63.25","42.96"
"63","000","00","011","1136","0000","3101","2335","766","218","3319","5497","0","60.38","42.48"
"63","000","00","011","1136","0263","876","659","217","48","924","1550","0","59.61","42.52"
"63","000","00","011","1136","0264","764","577","187","53","817","1298","0","62.94","44.45"
"63","000","00","011","1136","0265","742","552","190","68","810","1297","0","62.45","42.56"
"63","000","00","011","1136","0266","719","547","172","49","768","1352","0","56.8","40.46"
"63","000","00","011","1137","0000","2409","1745","664","195","2604","4565","0","57.04","38.23"
"63","000","00","011","1137","0267","799","594","205","51","850","1522","0","55.85","39.03"
"63","000","00","011","1137","0268","837","604","233","82","919","1602","0","57.37","37.7"
"63","000","00","011","1137","0269","773","547","226","62","835","1441","0","57.95","37.96"
"63","000","00","011","1138","0000","2352","1742","610","96","2448","4410","0","55.51","39.5"
"63","000","00","011","1138","0270","678","502","176","26","704","1325","0","53.13","37.89"
"63","000","00","011","1138","0271","854","646","208","45","899","1567","0","57.37","41.23"
"63","000","00","011","1138","0272","820","594","226","25","845","1518","0","55.67","39.13"
"63","000","00","011","1139","0000","3628","2721","907","172","3800","6605","0","57.53","41.2"
"63","000","00","011","1139","0273","898","675","223","46","944","1549","0","60.94","43.58"
"63","000","00","011","1139","0274","892","674","218","34","926","1652","0","56.05","40.8"
"63","000","00","011","1139","0275","977","718","259","67","1044","1766","0","59.12","40.66"
"63","000","00","011","1139","0276","861","654","207","25","886","1638","0","54.09","39.93"
"63","000","00","011","1140","0000","3338","2534","804","169","3507","6105","0","57.44","41.51"
"63","000","00","011","1140","0277","849","662","187","47","896","1491","0","60.09","44.4"
"63","000","00","011","1140","0278","851","654","197","27","878","1521","0","57.73","43.0"
"63","000","00","011","1140","0279","764","586","178","62","826","1351","0","61.14","43.38"
"63","000","00","011","1140","0280","874","632","242","33","907","1742","0","52.07","36.28"
"63","000","00","011","1141","0000","4175","3180","995","222","4397","7594","0","57.9","41.88"
"63","000","00","011","1141","0281","863","644","219","50","913","1585","0","57.6","40.63"
"63","000","00","011","1141","0282","850","668","182","45","895","1521","0","58.84","43.92"
"63","000","00","011","1141","0283","832","614","218","38","870","1543","0","56.38","39.79"
"63","000","00","011","1141","0284","783","606","177","45","828","1404","0","58.97","43.16"
"63","000","00","011","1141","0285","847","648","199","44","891","1541","0","57.82","42.05"
"63","000","00","011","1142","0000","3059","2342","717","201","3260","5828","0","55.94","40.19"
"63","000","00","011","1142","0286","816","637","179","60","876","1584","0","55.3","40.21"
"63","000","00","011","1142","0287","846","636","210","62","908","1519","0","59.78","41.87"
"63","000","00","011","1142","0288","739","573","166","27","766","1482","0","51.69","38.66"
"63","000","00","011","1142","0289","658","496","162","52","710","1243","0","57.12","39.9"
"63","000","00","011","1143","0000","609","434","175","51","660","1156","0","57.09","37.54"
"63","000","00","011","1143","0290","609","434","175","51","660","1156","0","57.09","37.54"
"63","000","00","011","1144","0000","602","417","185","80","682","1262","0","54.04","33.04"
"63","000","00","011","1144","0291","602","417","185","80","682","1262","0","54.04","33.04"
"63","000","00","011","1145","0000","967","666","301","97","1064","1747","0","60.9","38.12"
"63","000","00","011","1145","0292","487","349","138","46","533","889","0","59.96","39.26"
"63","000","00","011","1145","0293","480","317","163","51","531","858","0","61.89","36.95"
"63","000","00","011","1146","0000","1418","1053","365","150","1568","2781","0","56.38","37.86"
"63","000","00","011","1146","0294","478","324","154","53","531","945","0","56.19","34.29"
"63","000","00","011","1146","0295","496","374","122","46","542","960","0","56.46","38.96"
"63","000","00","011","1146","0296","444","355","89","51","495","876","0","56.51","40.53"
"63","000","00","011","1147","0000","827","613","214","109","936","1475","0","63.46","41.56"
"63","000","00","011","1147","0297","320","228","92","43","363","556","0","65.29","41.01"
"63","000","00","011","1147","0298","507","385","122","66","573","919","0","62.35","41.89"
"63","000","00","011","1148","0000","792","565","227","108","900","1360","0","66.18","41.54"
"63","000","00","011","1148","0299","792","565","227","108","900","1360","0","66.18","41.54"
"63","000","00","011","1149","0000","743","558","185","83","826","1355","0","60.96","41.18"
"63","000","00","011","1149","0300","743","558","185","83","826","1355","0","60.96","41.18"
"63","000","00","011","1150","0000","1370","1100","270","91","1461","2434","0","60.02","45.19"
"63","000","00","011","1150","0301","680","543","137","42","722","1252","0","57.67","43.37"
"63","000","00","011","1150","0302","690","557","133","49","739","1182","0","62.52","47.12"
"63","000","00","011","1151","0000","1304","1003","301","60","1364","2671","0","51.07","37.55"
"63","000","00","011","1151","0303","673","524","149","17","690","1431","0","48.22","36.62"
"63","000","00","011","1151","0304","631","479","152","43","674","1240","0","54.35","38.63"
"63","000","00","012","0000","0000","111638","85399","26239","7510","119148","213250","255631","55.87","40.05"
"63","000","00","012","1201","0000","2172","1639","533","154","2326","3797","0","61.26","43.17"
"63","000","00","012","1201","0001","737","550","187","56","793","1313","0","60.4","41.89"
"63","000","00","012","1201","0002","822","626","196","46","868","1403","0","61.87","44.62"
"63","000","00","012","1201","0003","613","463","150","52","665","1081","0","61.52","42.83"
"63","000","00","012","1202","0000","2118","1556","562","144","2262","3798","0","59.56","40.97"
"63","000","00","012","1202","0004","681","503","178","45","726","1209","0","60.05","41.6"
"63","000","00","012","1202","0005","723","522","201","50","773","1326","0","58.3","39.37"
"63","000","00","012","1202","0006","714","531","183","49","763","1263","0","60.41","42.04"
"63","000","00","012","1203","0000","2615","1993","622","180","2795","4640","0","60.24","42.95"
"63","000","00","012","1203","0007","886","673","213","66","952","1580","0","60.25","42.59"
"63","000","00","012","1203","0008","906","685","221","47","953","1577","0","60.43","43.44"
"63","000","00","012","1203","0009","823","635","188","67","890","1483","0","60.01","42.82"
"63","000","00","012","1204","0000","3209","2460","749","194","3403","6090","0","55.88","40.39"
"63","000","00","012","1204","0010","780","605","175","36","816","1461","0","55.85","41.41"
"63","000","00","012","1204","0011","771","586","185","63","834","1466","0","56.89","39.97"
"63","000","00","012","1204","0012","887","683","204","63","950","1620","0","58.64","42.16"
"63","000","00","012","1204","0013","771","586","185","32","803","1543","0","52.04","37.98"
"63","000","00","012","1205","0000","3360","2582","778","236","3596","6230","0","57.72","41.44"
"63","000","00","012","1205","0014","778","586","192","57","835","1513","0","55.19","38.73"
"63","000","00","012","1205","0015","817","641","176","54","871","1534","0","56.78","41.79"
"63","000","00","012","1205","0016","899","696","203","84","983","1650","0","59.58","42.18"
"63","000","00","012","1205","0017","866","659","207","41","907","1533","0","59.17","42.99"
"63","000","00","012","1206","0000","3555","2643","912","222","3777","6528","0","57.86","40.49"
"63","000","00","012","1206","0018","898","681","217","46","944","1702","0","55.46","40.01"
"63","000","00","012","1206","0019","926","691","235","52","978","1721","0","56.83","40.15"
"63","000","00","012","1206","0020","904","651","253","56","960","1575","0","60.95","41.33"
"63","000","00","012","1206","0021","827","620","207","68","895","1530","0","58.5","40.52"
"63","000","00","012","1207","0000","3473","2616","857","262","3735","6810","0","54.85","38.41"
"63","000","00","012","1207","0022","948","696","252","70","1018","1728","0","58.91","40.28"
"63","000","00","012","1207","0023","879","677","202","84","963","1702","0","56.58","39.78"
"63","000","00","012","1207","0024","892","664","228","67","959","1696","0","56.54","39.15"
"63","000","00","012","1207","0025","754","579","175","41","795","1684","0","47.21","34.38"
"63","000","00","012","1208","0000","3698","2815","883","223","3921","6642","0","59.03","42.38"
"63","000","00","012","1208","0026","958","726","232","71","1029","1717","0","59.93","42.28"
"63","000","00","012","1208","0027","878","661","217","45","923","1605","0","57.51","41.18"
"63","000","00","012","1208","0028","937","727","210","50","987","1723","0","57.28","42.19"
"63","000","00","012","1208","0029","925","701","224","57","982","1597","0","61.49","43.89"
"63","000","00","012","1209","0000","4241","3303","938","202","4443","7993","0","55.59","41.32"
"63","000","00","012","1209","0030","918","702","216","52","970","1700","0","57.06","41.29"
"63","000","00","012","1209","0031","764","567","197","40","804","1544","0","52.07","36.72"
"63","000","00","012","1209","0032","817","620","197","50","867","1635","0","53.03","37.92"
"63","000","00","012","1209","0033","834","743","91","29","863","1495","0","57.73","49.7"
"63","000","00","012","1209","0034","908","671","237","31","939","1619","0","58.0","41.45"
"63","000","00","012","1210","0000","3435","2548","887","166","3601","6869","0","52.42","37.09"
"63","000","00","012","1210","0035","913","646","267","46","959","1683","0","56.98","38.38"
"63","000","00","012","1210","0036","829","639","190","55","884","1662","0","53.19","38.45"
"63","000","00","012","1210","0037","870","641","229","40","910","1850","0","49.19","34.65"
"63","000","00","012","1210","0038","823","622","201","25","848","1674","0","50.66","37.16"
"63","000","00","012","1211","0000","2340","1824","516","145","2485","4183","0","59.41","43.61"
"63","000","00","012","1211","0039","854","675","179","62","916","1511","0","60.62","44.67"
"63","000","00","012","1211","0040","733","566","167","27","760","1393","0","54.56","40.63"
"63","000","00","012","1211","0041","753","583","170","56","809","1279","0","63.25","45.58"
"63","000","00","012","1212","0000","2225","1689","536","165","2390","3837","0","62.29","44.02"
"63","000","00","012","1212","0042","595","452","143","39","634","1122","0","56.51","40.29"
"63","000","00","012","1212","0043","792","625","167","56","848","1238","0","68.5","50.48"
"63","000","00","012","1212","0044","838","612","226","70","908","1477","0","61.48","41.44"
"63","000","00","012","1213","0000","3300","2559","741","232","3532","5857","0","60.3","43.69"
"63","000","00","012","1213","0045","848","651","197","65","913","1495","0","61.07","43.55"
"63","000","00","012","1213","0046","865","654","211","48","913","1469","0","62.15","44.52"
"63","000","00","012","1213","0047","804","637","167","55","859","1462","0","58.76","43.57"
"63","000","00","012","1213","0048","783","617","166","64","847","1431","0","59.19","43.12"
"63","000","00","012","1214","0000","2359","1737","622","136","2495","4391","0","56.82","39.56"
"63","000","00","012","1214","0049","745","542","203","42","787","1486","0","52.96","36.47"
"63","000","00","012","1214","0050","821","609","212","57","878","1449","0","60.59","42.03"
"63","000","00","012","1214","0051","793","586","207","37","830","1456","0","57.01","40.25"
"63","000","00","012","1215","0000","2161","1658","503","130","2291","4005","0","57.2","41.4"
"63","000","00","012","1215","0052","696","523","173","39","735","1311","0","56.06","39.89"
"63","000","00","012","1215","0053","733","577","156","57","790","1356","0","58.26","42.55"
"63","000","00","012","1215","0054","732","558","174","34","766","1338","0","57.25","41.7"
"63","000","00","012","1216","0000","2381","1841","540","109","2490","4644","0","53.62","39.64"
"63","000","00","012","1216","0055","816","622","194","31","847","1525","0","55.54","40.79"
"63","000","00","012","1216","0056","813","636","177","54","867","1620","0","53.52","39.26"
"63","000","00","012","1216","0057","752","583","169","24","776","1499","0","51.77","38.89"
"63","000","00","012","1217","0000","4105","3185","920","308","4413","7724","0","57.13","41.24"
"63","000","00","012","1217","0058","847","681","166","34","881","1497","0","58.85","45.49"
"63","000","00","012","1217","0059","836","633","203","64","900","1624","0","55.42","38.98"
"63","000","00","012","1217","0060","776","610","166","71","847","1536","0","55.14","39.71"
"63","000","00","012","1217","0061","821","633","188","79","900","1469","0","61.27","43.09"
"63","000","00","012","1217","0062","825","628","197","60","885","1598","0","55.38","39.3"
"63","000","00","012","1218","0000","2540","1973","567","208","2748","4923","0","55.82","40.08"
"63","000","00","012","1218","0063","873","687","186","39","912","1690","0","53.96","40.65"
"63","000","00","012","1218","0064","802","609","193","105","907","1599","0","56.72","38.09"
"63","000","00","012","1218","0065","865","677","188","64","929","1634","0","56.85","41.43"
"63","000","00","012","1219","0000","811","617","194","59","870","1660","0","52.41","37.17"
"63","000","00","012","1219","0066","811","617","194","59","870","1660","0","52.41","37.17"
"63","000","00","012","1220","0000","4824","3678","1146","303","5127","9045","0","56.68","40.66"
"63","000","00","012","1220","0067","932","717","215","63","995","1900","0","52.37","37.74"
"63","000","00","012","1220","0068","973","731","242","52","1025","1797","0","57.04","40.68"
"63","000","00","012","1220","0069","977","731","246","81","1058","1832","0","57.75","39.9"
"63","000","00","012","1220","0070","990","764","226","55","1045","1784","0","58.58","42.83"
"63","000","00","012","1220","0071","952","735","217","52","1004","1732","0","57.97","42.44"
"63","000","00","012","1221","0000","3890","2963","927","347","4237","8470","0","50.02","34.98"
"63","000","00","012","1221","0072","506","372","134","52","558","2035","0","27.42","18.28"
"63","000","00","012","1221","0073","788","578","210","72","860","1504","0","57.18","38.43"
"63","000","00","012","1221","0074","940","743","197","67","1007","1683","0","59.83","44.15"
"63","000","00","012","1221","0075","826","617","209","77","903","1635","0","55.23","37.74"
"63","000","00","012","1221","0076","830","653","177","79","909","1613","0","56.35","40.48"
"63","000","00","012","1222","0000","3848","2988","860","270","4118","7542","0","54.6","39.62"
"63","000","00","012","1222","0077","742","652","90","27","769","1483","0","51.85","43.96"
"63","000","00","012","1222","0078","801","589","212","45","846","1500","0","56.4","39.27"
"63","000","00","012","1222","0079","796","615","181","65","861","1483","0","58.06","41.47"
"63","000","00","012","1222","0080","812","590","222","64","876","1544","0","56.74","38.21"
"63","000","00","012","1222","0081","697","542","155","69","766","1532","0","50.0","35.38"
"63","000","00","012","1223","0000","2682","2005","677","192","2874","5554","0","51.75","36.1"
"63","000","00","012","1223","0082","953","744","209","69","1022","1819","0","56.18","40.9"
"63","000","00","012","1223","0083","869","615","254","83","952","1863","0","51.1","33.01"
"63","000","00","012","1223","0084","860","646","214","40","900","1872","0","48.08","34.51"
"63","000","00","012","1224","0000","2614","1980","634","167","2781","5164","0","53.85","38.34"
"63","000","00","012","1224","0085","836","633","203","60","896","1627","0","55.07","38.91"
"63","000","00","012","1224","0086","833","652","181","44","877","1696","0","51.71","38.44"
"63","000","00","012","1224","0087","945","695","250","63","1008","1841","0","54.75","37.75"
"63","000","00","012","1225","0000","3151","2381","770","200","3351","5954","0","56.28","39.99"
"63","000","00","012","1225","0088","694","517","177","57","751","1324","0","56.72","39.05"
"63","000","00","012","1225","0089","765","611","154","39","804","1504","0","53.46","40.63"
"63","000","00","012","1225","0090","797","601","196","51","848","1511","0","56.12","39.77"
"63","000","00","012","1225","0091","895","652","243","53","948","1615","0","58.7","40.37"
"63","000","00","012","1226","0000","1330","1011","319","68","1398","2762","0","50.62","36.6"
"63","000","00","012","1226","0092","639","484","155","35","674","1270","0","53.07","38.11"
"63","000","00","012","1226","0093","691","527","164","33","724","1492","0","48.53","35.32"
"63","000","00","012","1227","0000","2935","2310","625","134","3069","5832","0","52.62","39.61"
"63","000","00","012","1227","0094","718","527","191","42","760","1429","0","53.18","36.88"
"63","000","00","012","1227","0095","773","702","71","30","803","1567","0","51.24","44.8"
"63","000","00","012","1227","0096","742","563","179","39","781","1388","0","56.27","40.56"
"63","000","00","012","1227","0097","702","518","184","23","725","1448","0","50.07","35.77"
"63","000","00","012","1228","0000","2001","1527","474","160","2161","3829","0","56.44","39.88"
"63","000","00","012","1228","0098","673","513","160","57","730","1356","0","53.83","37.83"
"63","000","00","012","1228","0099","684","522","162","48","732","1308","0","55.96","39.91"
"63","000","00","012","1228","0100","644","492","152","55","699","1165","0","60.0","42.23"
"63","000","00","012","1229","0000","3202","2477","725","232","3434","5889","0","58.31","42.06"
"63","000","00","012","1229","0101","784","608","176","71","855","1429","0","59.83","42.55"
"63","000","00","012","1229","0102","752","602","150","37","789","1472","0","53.6","40.9"
"63","000","00","012","1229","0103","880","674","206","65","945","1508","0","62.67","44.69"
"63","000","00","012","1229","0104","786","593","193","59","845","1480","0","57.09","40.07"
"63","000","00","012","1230","0000","2241","1730","511","182","2423","4365","0","55.51","39.63"
"63","000","00","012","1230","0105","558","416","142","45","603","1142","0","52.8","36.43"
"63","000","00","012","1230","0106","780","619","161","41","821","1554","0","52.83","39.83"
"63","000","00","012","1230","0107","903","695","208","96","999","1669","0","59.86","41.64"
"63","000","00","012","1231","0000","2731","2137","594","205","2936","5333","0","55.05","40.07"
"63","000","00","012","1231","0108","957","759","198","72","1029","1823","0","56.45","41.63"
"63","000","00","012","1231","0109","891","697","194","65","956","1739","0","54.97","40.08"
"63","000","00","012","1231","0110","883","681","202","68","951","1771","0","53.7","38.45"
"63","000","00","012","1232","0000","1481","1152","329","90","1571","2937","0","53.49","39.22"
"63","000","00","012","1232","0111","716","567","149","56","772","1468","0","52.59","38.62"
"63","000","00","012","1232","0112","765","585","180","34","799","1469","0","54.39","39.82"
"63","000","00","012","1233","0000","2140","1733","407","142","2282","3617","0","63.09","47.91"
"63","000","00","012","1233","0113","672","559","113","39","711","1094","0","64.99","51.1"
"63","000","00","012","1233","0114","667","535","132","40","707","1101","0","64.21","48.59"
"63","000","00","012","1233","0115","801","639","162","63","864","1422","0","60.76","44.94"
"63","000","00","012","1234","0000","2122","1640","482","202","2324","3912","0","59.41","41.92"
"63","000","00","012","1234","0116","720","581","139","56","776","1390","0","55.83","41.8"
"63","000","00","012","1234","0117","709","554","155","69","778","1307","0","59.53","42.39"
"63","000","00","012","1234","0118","693","505","188","77","770","1215","0","63.37","41.56"
"63","000","00","012","1235","0000","2428","1930","498","145","2573","4886","0","52.66","39.5"
"63","000","00","012","1235","0119","806","640","166","44","850","1642","0","51.77","38.98"
"63","000","00","012","1235","0120","790","642","148","40","830","1623","0","51.14","39.56"
"63","000","00","012","1235","0121","832","648","184","61","893","1621","0","55.09","39.98"
"63","000","00","012","1236","0000","2825","2129","696","148","2973","5397","0","55.09","39.45"
"63","000","00","012","1236","0122","717","548","169","18","735","1367","0","53.77","40.09"
"63","000","00","012","1236","0123","665","479","186","52","717","1309","0","54.77","36.59"
"63","000","00","012","1236","0124","734","571","163","37","771","1356","0","56.86","42.11"
"63","000","00","012","1236","0125","709","531","178","41","750","1365","0","54.95","38.9"
"63","000","00","012","1237","0000","3304","2497","807","213","3517","6487","0","54.22","38.49"
"63","000","00","012","1237","0126","816","616","200","40","856","1613","0","53.07","38.19"
"63","000","00","012","1237","0127","722","564","158","39","761","1590","0","47.86","35.47"
"63","000","00","012","1237","0128","893","676","217","72","965","1662","0","58.06","40.67"
"63","000","00","012","1237","0129","873","641","232","62","935","1622","0","57.64","39.52"
"63","000","00","012","1238","0000","5052","3811","1241","332","5384","10006","0","53.81","38.09"
"63","000","00","012","1238","0130","943","686","257","39","982","1820","0","53.96","37.69"
"63","000","00","012","1238","0131","869","672","197","75","944","1615","0","58.45","41.61"
"63","000","00","012","1238","0132","687","528","159","64","751","1612","0","46.59","32.75"
"63","000","00","012","1238","0133","844","629","215","73","917","1652","0","55.51","38.08"
"63","000","00","012","1238","0134","876","665","211","29","905","1666","0","54.32","39.92"
"63","000","00","012","1238","0135","833","631","202","52","885","1641","0","53.93","38.45"
"63","000","00","012","1239","0000","988","714","274","112","1100","2170","0","50.69","32.9"
"63","000","00","012","1239","0136","280","198","82","38","318","528","0","60.23","37.5"
"63","000","00","012","1239","0137","708","516","192","74","782","1642","0","47.62","31.43"
"63","000","00","012","1240","0000","782","614","168","69","851","1519","0","56.02","40.42"
"63","000","00","012","1240","0138","436","337","99","33","469","829","0","56.57","40.65"
"63","000","00","012","1240","0139","346","277","69","36","382","690","0","55.36","40.14"
"63","000","00","012","1241","0000","527","418","109","57","584","1067","0","54.73","39.18"
"63","000","00","012","1241","0140","527","418","109","57","584","1067","0","54.73","39.18"
"63","000","00","012","1242","0000","442","336","106","65","507","892","0","56.84","37.67"
"63","000","00","012","1242","0141","442","336","106","65","507","892","0","56.84","37.67"
"65","000","00","000","0000","0000","1720792","1338359","382433","127605","1848397","3375513","3992291","54.76","39.65"
"65","000","00","001","0000","0000","239525","183906","55619","18834","258359","463411","554357","55.75","39.69"
"65","000","00","001","0101","0000","715","528","187","72","787","1388","0","56.7","38.04"
"65","000","00","001","0101","0894","715","528","187","72","787","1388","0","56.7","38.04"
"65","000","00","001","0102","0000","710","525","185","47","757","1294","0","58.5","40.57"
"65","000","00","001","0102","0895","710","525","185","47","757","1294","0","58.5","40.57"
"65","000","00","001","0103","0000","370","269","101","23","393","667","0","58.92","40.33"
"65","000","00","001","0103","0896","370","269","101","23","393","667","0","58.92","40.33"
"65","000","00","001","0104","0000","435","327","108","40","475","898","0","52.9","36.41"
"65","000","00","001","0104","0897","435","327","108","40","475","898","0","52.9","36.41"
"65","000","00","001","0105","0000","896","706","190","68","964","1568","0","61.48","45.03"
"65","000","00","001","0105","0898","469","362","107","34","503","829","0","60.68","43.67"
"65","000","00","001","0105","0899","427","344","83","34","461","739","0","62.38","46.55"
"65","000","00","001","0106","0000","2255","1686","569","195","2450","4718","0","51.93","35.74"
"65","000","00","001","0106","0900","579","422","157","50","629","1035","0","60.77","40.77"
"65","000","00","001","0106","0901","723","545","178","38","761","1713","0","44.42","31.82"
"65","000","00","001","0106","0902","308","230","78","18","326","658","0","49.54","34.95"
"65","000","00","001","0106","0903","645","489","156","89","734","1312","0","55.95","37.27"
"65","000","00","001","0107","0000","1355","1037","318","125","1480","2885","0","51.3","35.94"
"65","000","00","001","0107","0904","699","551","148","62","761","1492","0","51.01","36.93"
"65","000","00","001","0107","0905","656","486","170","63","719","1393","0","51.62","34.89"
"65","000","00","001","0108","0000","2724","2067","657","211","2935","8490","0","34.57","24.35"
"65","000","00","001","0108","0906","822","601","221","61","883","4742","0","18.62","12.67"
"65","000","00","001","0108","0907","715","548","167","39","754","1439","0","52.4","38.08"
"65","000","00","001","0108","0908","617","471","146","71","688","1187","0","57.96","39.68"
"65","000","00","001","0108","0909","570","447","123","40","610","1122","0","54.37","39.84"
"65","000","00","001","0109","0000","2041","1543","498","162","2203","3787","0","58.17","40.74"
"65","000","00","001","0109","0910","717","564","153","65","782","1363","0","57.37","41.38"
"65","000","00","001","0109","0911","597","440","157","51","648","1093","0","59.29","40.26"
"65","000","00","001","0109","0912","727","539","188","46","773","1331","0","58.08","40.5"
"65","000","00","001","0110","0000","1889","1441","448","173","2062","3777","0","54.59","38.15"
"65","000","00","001","0110","0915","598","455","143","85","683","1268","0","53.86","35.88"
"65","000","00","001","0110","0916","610","466","144","39","649","1313","0","49.43","35.49"
"65","000","00","001","0110","0917","681","520","161","49","730","1196","0","61.04","43.48"
"65","000","00","001","0111","0000","2726","2057","669","182","2908","4565","0","63.7","45.06"
"65","000","00","001","0111","0918","728","541","187","46","774","1137","0","68.07","47.58"
"65","000","00","001","0111","0919","754","559","195","50","804","1269","0","63.36","44.05"
"65","000","00","001","0111","0920","635","495","140","34","669","1117","0","59.89","44.32"
"65","000","00","001","0111","0921","609","462","147","52","661","1042","0","63.44","44.34"
"65","000","00","001","0112","0000","1334","1015","319","146","1480","2473","0","59.85","41.04"
"65","000","00","001","0112","0922","679","510","169","80","759","1257","0","60.38","40.57"
"65","000","00","001","0112","0923","655","505","150","66","721","1216","0","59.29","41.53"
"65","000","00","001","0113","0000","1372","1042","330","128","1500","2416","0","62.09","43.13"
"65","000","00","001","0113","0924","587","437","150","70","657","1126","0","58.35","38.81"
"65","000","00","001","0113","0925","785","605","180","58","843","1290","0","65.35","46.9"
"65","000","00","001","0114","0000","1941","1642","299","113","2054","3372","0","60.91","48.7"
"65","000","00","001","0114","0928","778","678","100","40","818","1329","0","61.55","51.02"
"65","000","00","001","0114","0929","576","491","85","34","610","996","0","61.24","49.3"
"65","000","00","001","0114","0930","587","473","114","39","626","1047","0","59.79","45.18"
"65","000","00","001","0115","0000","1429","1107","322","116","1545","2524","0","61.21","43.86"
"65","000","00","001","0115","0931","698","520","178","67","765","1272","0","60.14","40.88"
"65","000","00","001","0115","0932","731","587","144","49","780","1252","0","62.3","46.88"
"65","000","00","001","0116","0000","1791","1384","407","187","1978","3509","0","56.37","39.44"
"65","000","00","001","0116","0936","522","417","105","62","584","1093","0","53.43","38.15"
"65","000","00","001","0116","0937","582","443","139","76","658","1148","0","57.32","38.59"
"65","000","00","001","0116","0938","687","524","163","49","736","1268","0","58.04","41.32"
"65","000","00","001","0117","0000","2299","1718","581","231","2530","4250","0","59.53","40.42"
"65","000","00","001","0117","0939","650","467","183","68","718","1230","0","58.37","37.97"
"65","000","00","001","0117","0940","527","410","117","49","576","1012","0","56.92","40.51"
"65","000","00","001","0117","0941","444","341","103","42","486","811","0","59.93","42.05"
"65","000","00","001","0117","0942","678","500","178","72","750","1197","0","62.66","41.77"
"65","000","00","001","0118","0000","1229","964","265","85","1314","2364","0","55.58","40.78"
"65","000","00","001","0118","0943","580","459","121","37","617","1142","0","54.03","40.19"
"65","000","00","001","0118","0944","649","505","144","48","697","1222","0","57.04","41.33"
"65","000","00","001","0119","0000","1720","1247","473","170","1890","3208","0","58.92","38.87"
"65","000","00","001","0119","0947","549","365","184","39","588","1011","0","58.16","36.1"
"65","000","00","001","0119","0948","600","441","159","68","668","1157","0","57.74","38.12"
"65","000","00","001","0119","0949","571","441","130","63","634","1040","0","60.96","42.4"
"65","000","00","001","0120","0000","1988","1570","418","108","2096","3621","0","57.88","43.36"
"65","000","00","001","0120","0950","673","539","134","38","711","1173","0","60.61","45.95"
"65","000","00","001","0120","0951","625","498","127","27","652","1193","0","54.65","41.74"
"65","000","00","001","0120","0952","690","533","157","43","733","1255","0","58.41","42.47"
"65","000","00","001","0121","0000","1770","1326","444","106","1876","3298","0","56.88","40.21"
"65","000","00","001","0121","0953","701","516","185","51","752","1306","0","57.58","39.51"
"65","000","00","001","0121","0954","564","423","141","17","581","1050","0","55.33","40.29"
"65","000","00","001","0121","0955","505","387","118","38","543","942","0","57.64","41.08"
"65","000","00","001","0122","0000","2059","1590","469","136","2195","3677","0","59.7","43.24"
"65","000","00","001","0122","0956","664","521","143","50","714","1133","0","63.02","45.98"
"65","000","00","001","0122","0957","681","512","169","46","727","1251","0","58.11","40.93"
"65","000","00","001","0122","0958","714","557","157","40","754","1293","0","58.31","43.08"
"65","000","00","001","0123","0000","1783","1427","356","191","1974","3492","0","56.53","40.86"
"65","000","00","001","0123","0959","594","441","153","64","658","1208","0","54.47","36.51"
"65","000","00","001","0123","0960","640","474","166","72","712","1223","0","58.22","38.76"
"65","000","00","001","0123","0961","549","512","37","55","604","1061","0","56.93","48.26"
"65","000","00","001","0124","0000","2130","1758","372","112","2242","3596","0","62.35","48.89"
"65","000","00","001","0124","0964","682","555","127","30","712","1120","0","63.57","49.55"
"65","000","00","001","0124","0965","644","510","134","43","687","1091","0","62.97","46.75"
"65","000","00","001","0124","0966","804","693","111","39","843","1385","0","60.87","50.04"
"65","000","00","001","0125","0000","1322","1011","311","119","1441","2269","0","63.51","44.56"
"65","000","00","001","0125","0969","702","548","154","54","756","1191","0","63.48","46.01"
"65","000","00","001","0125","0970","620","463","157","65","685","1078","0","63.54","42.95"
"65","000","00","001","0126","0000","1419","1087","332","152","1571","2673","0","58.77","40.67"
"65","000","00","001","0126","0971","717","545","172","79","796","1351","0","58.92","40.34"
"65","000","00","001","0126","0972","702","542","160","73","775","1322","0","58.62","41.0"
"65","000","00","001","0127","0000","1073","811","262","139","1212","1897","0","63.89","42.75"
"65","000","00","001","0127","0973","465","364","101","58","523","868","0","60.25","41.94"
"65","000","00","001","0127","0974","608","447","161","81","689","1029","0","66.96","43.44"
"65","000","00","001","0128","0000","3351","2648","703","223","3574","6157","0","58.05","43.01"
"65","000","00","001","0128","0975","898","705","193","43","941","1602","0","58.74","44.01"
"65","000","00","001","0128","0976","749","584","165","71","820","1362","0","60.21","42.88"
"65","000","00","001","0128","0977","888","680","208","74","962","1698","0","56.65","40.05"
"65","000","00","001","0128","0978","816","679","137","35","851","1495","0","56.92","45.42"
"65","000","00","001","0129","0000","2130","1619","511","199","2329","4360","0","53.42","37.13"
"65","000","00","001","0129","0979","765","545","220","78","843","1522","0","55.39","35.81"
"65","000","00","001","0129","0980","691","562","129","62","753","1279","0","58.87","43.94"
"65","000","00","001","0129","0981","674","512","162","59","733","1559","0","47.02","32.84"
"65","000","00","001","0130","0000","2291","1822","469","220","2511","4788","0","52.44","38.05"
"65","000","00","001","0130","0982","721","552","169","106","827","1537","0","53.81","35.91"
"65","000","00","001","0130","0983","720","530","190","75","795","1531","0","51.93","34.62"
"65","000","00","001","0130","0984","850","740","110","39","889","1720","0","51.69","43.02"
"65","000","00","001","0131","0000","2696","2093","603","152","2848","5277","0","53.97","39.66"
"65","000","00","001","0131","0985","562","445","117","39","601","1165","0","51.59","38.2"
"65","000","00","001","0131","0986","1002","789","213","18","1020","1857","0","54.93","42.49"
"65","000","00","001","0131","0987","545","410","135","73","618","1078","0","57.33","38.03"
"65","000","00","001","0131","0988","587","449","138","22","609","1177","0","51.74","38.15"
"65","000","00","001","0132","0000","1742","1339","403","166","1908","3253","0","58.65","41.16"
"65","000","00","001","0132","0989","975","747","228","53","1028","1798","0","57.17","41.55"
"65","000","00","001","0132","0990","767","592","175","113","880","1455","0","60.48","40.69"
"65","000","00","001","0133","0000","2241","1707","534","127","2368","4295","0","55.13","39.74"
"65","000","00","001","0133","0993","883","702","181","37","920","1600","0","57.5","43.88"
"65","000","00","001","0133","0994","676","507","169","34","710","1409","0","50.39","35.98"
"65","000","00","001","0133","0995","682","498","184","56","738","1286","0","57.39","38.72"
"65","000","00","001","0134","0000","1130","826","304","168","1298","2547","0","50.96","32.43"
"65","000","00","001","0134","0996","549","393","156","120","669","1359","0","49.23","28.92"
"65","000","00","001","0134","0997","581","433","148","48","629","1188","0","52.95","36.45"
"65","000","00","001","0135","0000","3470","2564","906","265","3735","6884","0","54.26","37.25"
"65","000","00","001","0135","0998","785","596","189","57","842","1627","0","51.75","36.63"
"65","000","00","001","0135","0999","719","555","164","36","755","1633","0","46.23","33.99"
"65","000","00","001","0135","1000","1031","700","331","80","1111","1814","0","61.25","38.59"
"65","000","00","001","0135","1001","935","713","222","92","1027","1810","0","56.74","39.39"
"65","000","00","001","0136","0000","1695","1270","425","176","1871","3315","0","56.44","38.31"
"65","000","00","001","0136","1005","560","422","138","77","637","1130","0","56.37","37.35"
"65","000","00","001","0136","1006","593","438","155","67","660","1056","0","62.5","41.48"
"65","000","00","001","0136","1007","542","410","132","32","574","1129","0","50.84","36.32"
"65","000","00","001","0137","0000","3462","2674","788","243","3705","6233","0","59.44","42.9"
"65","000","00","001","0137","1008","879","678","201","92","971","1713","0","56.68","39.58"
"65","000","00","001","0137","1009","874","653","221","71","945","1622","0","58.26","40.26"
"65","000","00","001","0137","1010","841","658","183","51","892","1427","0","62.51","46.11"
"65","000","00","001","0137","1011","868","685","183","29","897","1471","0","60.98","46.57"
"65","000","00","001","0138","0000","1391","1025","366","178","1569","2637","0","59.5","38.87"
"65","000","00","001","0138","1015","411","304","107","61","472","828","0","57.0","36.71"
"65","000","00","001","0138","1016","447","313","134","68","515","820","0","62.8","38.17"
"65","000","00","001","0138","1017","533","408","125","49","582","989","0","58.85","41.25"
"65","000","00","001","0139","0000","2221","1625","596","202","2423","4257","0","56.92","38.17"
"65","000","00","001","0139","1018","528","366","162","73","601","1023","0","58.75","35.78"
"65","000","00","001","0139","1019","518","382","136","35","553","1044","0","52.97","36.59"
"65","000","00","001","0139","1020","511","376","135","60","571","968","0","58.99","38.84"
"65","000","00","001","0139","1021","664","501","163","34","698","1222","0","57.12","41.0"
"65","000","00","001","0140","0000","1495","1129","366","123","1618","2970","0","54.48","38.01"
"65","000","00","001","0140","1022","714","555","159","45","759","1385","0","54.8","40.07"
"65","000","00","001","0140","1023","781","574","207","78","859","1585","0","54.2","36.21"
"65","000","00","001","0141","0000","1944","1445","499","182","2126","3646","0","58.31","39.63"
"65","000","00","001","0141","1024","935","701","234","73","1008","1840","0","54.78","38.1"
"65","000","00","001","0141","1025","1009","744","265","109","1118","1806","0","61.9","41.2"
"65","000","00","001","0142","0000","2305","1733","572","256","2561","4482","0","57.14","38.67"
"65","000","00","001","0142","1026","773","570","203","89","862","1506","0","57.24","37.85"
"65","000","00","001","0142","1027","730","544","186","96","826","1476","0","55.96","36.86"
"65","000","00","001","0142","1028","802","619","183","71","873","1500","0","58.2","41.27"
"65","000","00","001","0143","0000","1655","1300","355","114","1769","3108","0","56.92","41.83"
"65","000","00","001","0143","1031","796","628","168","45","841","1601","0","52.53","39.23"
"65","000","00","001","0143","1032","859","672","187","69","928","1507","0","61.58","44.59"
"65","000","00","001","0144","0000","4892","3813","1079","283","5175","8859","0","58.42","43.04"
"65","000","00","001","0144","1035","1001","776","225","91","1092","1822","0","59.93","42.59"
"65","000","00","001","0144","1036","926","683","243","74","1000","1605","0","62.31","42.55"
"65","000","00","001","0144","1037","875","690","185","23","898","1549","0","57.97","44.54"
"65","000","00","001","0144","1038","1098","893","205","55","1153","1948","0","59.19","45.84"
"65","000","00","001","0144","1039","992","771","221","40","1032","1935","0","53.33","39.84"
"65","000","00","001","0145","0000","1073","804","269","100","1173","2192","0","53.51","36.68"
"65","000","00","001","0145","1040","530","410","120","46","576","1097","0","52.51","37.37"
"65","000","00","001","0145","1041","543","394","149","54","597","1095","0","54.52","35.98"
"65","000","00","001","0146","0000","1916","1455","461","122","2038","3603","0","56.56","40.38"
"65","000","00","001","0146","1044","605","446","159","59","664","1187","0","55.94","37.57"
"65","000","00","001","0146","1045","636","492","144","29","665","1154","0","57.63","42.63"
"65","000","00","001","0146","1046","675","517","158","34","709","1262","0","56.18","40.97"
"65","000","00","001","0147","0000","1318","973","345","203","1521","2681","0","56.73","36.29"
"65","000","00","001","0147","1047","620","474","146","95","715","1271","0","56.25","37.29"
"65","000","00","001","0147","1048","698","499","199","108","806","1410","0","57.16","35.39"
"65","000","00","001","0148","0000","2551","1941","610","314","2865","5365","0","53.4","36.18"
"65","000","00","001","0148","1049","809","643","166","92","901","1745","0","51.63","36.85"
"65","000","00","001","0148","1050","810","574","236","130","940","1867","0","50.35","30.74"
"65","000","00","001","0148","1051","932","724","208","92","1024","1753","0","58.41","41.3"
"65","000","00","001","0149","0000","657","487","170","66","723","1204","0","60.05","40.45"
"65","000","00","001","0149","1052","657","487","170","66","723","1204","0","60.05","40.45"
"65","000","00","001","0150","0000","2879","2154","725","234","3113","5455","0","57.07","39.49"
"65","000","00","001","0150","1053","809","619","190","77","886","1614","0","54.89","38.35"
"65","000","00","001","0150","1054","690","521","169","50","740","1237","0","59.82","42.12"
"65","000","00","001","0150","1055","722","532","190","76","798","1361","0","58.63","39.09"
"65","000","00","001","0150","1056","658","482","176","31","689","1243","0","55.43","38.78"
"65","000","00","001","0151","0000","2056","1567","489","188","2244","3979","0","56.4","39.38"
"65","000","00","001","0151","1057","717","556","161","38","755","1515","0","49.83","36.7"
"65","000","00","001","0151","1058","820","618","202","87","907","1515","0","59.87","40.79"
"65","000","00","001","0151","1059","519","393","126","63","582","949","0","61.33","41.41"
"65","000","00","001","0152","0000","1863","1410","453","162","2025","3768","0","53.74","37.42"
"65","000","00","001","0152","1060","847","639","208","78","925","1629","0","56.78","39.23"
"65","000","00","001","0152","1061","663","494","169","46","709","1238","0","57.27","39.9"
"65","000","00","001","0152","1062","353","277","76","38","391","901","0","43.4","30.74"
"65","000","00","001","0153","0000","1497","1125","372","174","1671","2956","0","56.53","38.06"
"65","000","00","001","0153","1063","754","576","178","90","844","1475","0","57.22","39.05"
"65","000","00","001","0153","1064","743","549","194","84","827","1481","0","55.84","37.07"
"65","000","00","001","0154","0000","2874","2190","684","244","3118","5602","0","55.66","39.09"
"65","000","00","001","0154","1065","834","626","208","90","924","1800","0","51.33","34.78"
"65","000","00","001","0154","1066","838","636","202","61","899","1630","0","55.15","39.02"
"65","000","00","001","0154","1067","722","552","170","51","773","1298","0","59.55","42.53"
"65","000","00","001","0154","1068","480","376","104","42","522","874","0","59.73","43.02"
"65","000","00","001","0155","0000","1415","1070","345","130","1545","2581","0","59.86","41.46"
"65","000","00","001","0155","1071","794","585","209","76","870","1451","0","59.96","40.32"
"65","000","00","001","0155","1072","621","485","136","54","675","1130","0","59.73","42.92"
"65","000","00","001","0156","0000","1600","1213","387","155","1755","2971","0","59.07","40.83"
"65","000","00","001","0156","1073","787","614","173","60","847","1440","0","58.82","42.64"
"65","000","00","001","0156","1074","813","599","214","95","908","1531","0","59.31","39.12"
"65","000","00","001","0157","0000","3540","2762","778","220","3760","6492","0","57.92","42.54"
"65","000","00","001","0157","1077","617","497","120","33","650","1174","0","55.37","42.33"
"65","000","00","001","0157","1078","642","499","143","53","695","1228","0","56.6","40.64"
"65","000","00","001","0157","1079","631","484","147","39","670","1187","0","56.44","40.78"
"65","000","00","001","0157","1080","481","364","117","54","535","870","0","61.49","41.84"
"65","000","00","001","0157","1081","1169","918","251","41","1210","2033","0","59.52","45.15"
"65","000","00","001","0158","0000","1279","921","358","109","1388","2493","0","55.68","36.94"
"65","000","00","001","0158","1082","720","523","197","50","770","1418","0","54.3","36.88"
"65","000","00","001","0158","1083","559","398","161","59","618","1075","0","57.49","37.02"
"65","000","00","001","0159","0000","2286","1727","559","191","2477","4561","0","54.31","37.86"
"65","000","00","001","0159","1086","968","740","228","77","1045","1893","0","55.2","39.09"
"65","000","00","001","0159","1087","656","497","159","67","723","1302","0","55.53","38.17"
"65","000","00","001","0159","1088","662","490","172","47","709","1366","0","51.9","35.87"
"65","000","00","001","0160","0000","1375","1054","321","118","1493","2518","0","59.29","41.86"
"65","000","00","001","0160","1089","746","566","180","78","824","1318","0","62.52","42.94"
"65","000","00","001","0160","1090","629","488","141","40","669","1200","0","55.75","40.67"
"65","000","00","001","0161","0000","1996","1493","503","161","2157","3774","0","57.15","39.56"
"65","000","00","001","0161","1091","1087","825","262","48","1135","2028","0","55.97","40.68"
"65","000","00","001","0161","1092","909","668","241","113","1022","1746","0","58.53","38.26"
"65","000","00","001","0162","0000","1625","1209","416","126","1751","2981","0","58.74","40.56"
"65","000","00","001","0162","1095","728","544","184","60","788","1418","0","55.57","38.36"
"65","000","00","001","0162","1096","897","665","232","66","963","1563","0","61.61","42.55"
"65","000","00","001","0163","0000","1779","1364","415","157","1936","3487","0","55.52","39.12"
"65","000","00","001","0163","1097","903","697","206","101","1004","1780","0","56.4","39.16"
"65","000","00","001","0163","1098","876","667","209","56","932","1707","0","54.6","39.07"
"65","000","00","001","0164","0000","1438","1091","347","119","1557","3051","0","51.03","35.76"
"65","000","00","001","0164","1099","309","248","61","9","318","906","0","35.1","27.37"
"65","000","00","001","0164","1100","526","397","129","64","590","1030","0","57.28","38.54"
"65","000","00","001","0164","1101","603","446","157","46","649","1115","0","58.21","40.0"
"65","000","00","001","0165","0000","3736","2937","799","198","3934","7165","0","54.91","40.99"
"65","000","00","001","0165","1102","930","731","199","27","957","1836","0","52.12","39.81"
"65","000","00","001","0165","1103","939","695","244","86","1025","1881","0","54.49","36.95"
"65","000","00","001","0165","1104","875","695","180","41","916","1688","0","54.27","41.17"
"65","000","00","001","0165","1105","992","816","176","44","1036","1760","0","58.86","46.36"
"65","000","00","001","0166","0000","1833","1409","424","154","1987","3186","0","62.37","44.22"
"65","000","00","001","0166","1106","596","450","146","54","650","1044","0","62.26","43.1"
"65","000","00","001","0166","1107","610","469","141","41","651","1043","0","62.42","44.97"
"65","000","00","001","0166","1108","627","490","137","59","686","1099","0","62.42","44.59"
"65","000","00","001","0167","0000","1284","978","306","93","1377","2391","0","57.59","40.9"
"65","000","00","001","0167","1109","671","508","163","53","724","1260","0","57.46","40.32"
"65","000","00","001","0167","1110","613","470","143","40","653","1131","0","57.74","41.56"
"65","000","00","001","0168","0000","2156","1625","531","178","2334","3947","0","59.13","41.17"
"65","000","00","001","0168","1111","662","497","165","56","718","1225","0","58.61","40.57"
"65","000","00","001","0168","1112","842","660","182","56","898","1455","0","61.72","45.36"
"65","000","00","001","0168","1113","652","468","184","66","718","1267","0","56.67","36.94"
"65","000","00","001","0169","0000","2114","1624","490","161","2275","3832","0","59.37","42.38"
"65","000","00","001","0169","1116","621","479","142","20","641","1111","0","57.7","43.11"
"65","000","00","001","0169","1117","706","530","176","72","778","1177","0","66.1","45.03"
"65","000","00","001","0169","1118","787","615","172","69","856","1544","0","55.44","39.83"
"65","000","00","001","0170","0000","2159","1702","457","106","2265","4087","0","55.42","41.64"
"65","000","00","001","0170","1121","782","603","179","35","817","1504","0","54.32","40.09"
"65","000","00","001","0170","1122","704","580","124","39","743","1373","0","54.12","42.24"
"65","000","00","001","0170","1123","673","519","154","32","705","1210","0","58.26","42.89"
"65","000","00","001","0171","0000","1729","1206","523","150","1879","3360","0","55.92","35.89"
"65","000","00","001","0171","1124","897","547","350","65","962","1809","0","53.18","30.24"
"65","000","00","001","0171","1125","832","659","173","85","917","1551","0","59.12","42.49"
"65","000","00","001","0172","0000","2139","1671","468","98","2237","3795","0","58.95","44.03"
"65","000","00","001","0172","1126","780","610","170","29","809","1408","0","57.46","43.32"
"65","000","00","001","0172","1127","711","586","125","32","743","1285","0","57.82","45.6"
"65","000","00","001","0172","1128","648","475","173","37","685","1102","0","62.16","43.1"
"65","000","00","001","0173","0000","1533","1225","308","134","1667","3091","0","53.93","39.63"
"65","000","00","001","0173","1129","677","542","135","35","712","1399","0","50.89","38.74"
"65","000","00","001","0173","1130","856","683","173","99","955","1692","0","56.44","40.37"
"65","000","00","001","0174","0000","2375","1849","526","140","2515","4478","0","56.16","41.29"
"65","000","00","001","0174","1133","659","509","150","38","697","1246","0","55.94","40.85"
"65","000","00","001","0174","1134","792","612","180","32","824","1471","0","56.02","41.6"
"65","000","00","001","0174","1135","924","728","196","70","994","1761","0","56.45","41.34"
"65","000","00","001","0175","0000","1541","1173","368","124","1665","3027","0","55.0","38.75"
"65","000","00","001","0175","1136","793","612","181","72","865","1499","0","57.71","40.83"
"65","000","00","001","0175","1137","748","561","187","52","800","1528","0","52.36","36.71"
"65","000","00","001","0176","0000","1652","1271","381","113","1765","3086","0","57.19","41.19"
"65","000","00","001","0176","1138","815","624","191","63","878","1536","0","57.16","40.63"
"65","000","00","001","0176","1139","837","647","190","50","887","1550","0","57.23","41.74"
"65","000","00","001","0177","0000","1811","1387","424","144","1955","3350","0","58.36","41.4"
"65","000","00","001","0177","1140","1102","839","263","85","1187","2050","0","57.9","40.93"
"65","000","00","001","0177","1141","709","548","161","59","768","1300","0","59.08","42.15"
"65","000","00","001","0178","0000","3018","2361","657","137","3155","5917","0","53.32","39.9"
"65","000","00","001","0178","1142","831","662","169","37","868","1537","0","56.47","43.07"
"65","000","00","001","0178","1143","633","491","142","25","658","1341","0","49.07","36.61"
"65","000","00","001","0178","1144","869","662","207","31","900","1606","0","56.04","41.22"
"65","000","00","001","0178","1145","685","546","139","44","729","1433","0","50.87","38.1"
"65","000","00","001","0179","0000","2089","1637","452","151","2240","4105","0","54.57","39.88"
"65","000","00","001","0179","1146","787","611","176","42","829","1685","0","49.2","36.26"
"65","000","00","001","0179","1147","708","542","166","57","765","1248","0","61.3","43.43"
"65","000","00","001","0179","1148","594","484","110","52","646","1172","0","55.12","41.3"
"65","000","00","001","0180","0000","3802","2965","837","238","4040","7527","0","53.67","39.39"
"65","000","00","001","0180","1149","719","558","161","29","748","1640","0","45.61","34.02"
"65","000","00","001","0180","1150","689","535","154","42","731","1428","0","51.19","37.46"
"65","000","00","001","0180","1151","803","603","200","74","877","1527","0","57.43","39.49"
"65","000","00","001","0180","1152","759","596","163","31","790","1350","0","58.52","44.15"
"65","000","00","001","0180","1153","832","673","159","62","894","1582","0","56.51","42.54"
"65","000","00","001","0181","0000","1616","1273","343","98","1714","2823","0","60.72","45.09"
"65","000","00","001","0181","1154","549","434","115","48","597","919","0","64.96","47.23"
"65","000","00","001","0181","1155","500","397","103","23","523","930","0","56.24","42.69"
"65","000","00","001","0181","1156","567","442","125","27","594","974","0","60.99","45.38"
"65","000","00","001","0182","0000","1687","1391","296","92","1779","3170","0","56.12","43.88"
"65","000","00","001","0182","1157","934","786","148","37","971","1732","0","56.06","45.38"
"65","000","00","001","0182","1158","753","605","148","55","808","1438","0","56.19","42.07"
"65","000","00","001","0183","0000","1676","1220","456","169","1845","3541","0","52.1","34.45"
"65","000","00","001","0183","1159","861","600","261","106","967","1777","0","54.42","33.76"
"65","000","00","001","0183","1160","815","620","195","63","878","1764","0","49.77","35.15"
"65","000","00","001","0184","0000","1915","1496","419","165","2080","3712","0","56.03","40.3"
"65","000","00","001","0184","1164","903","700","203","105","1008","1870","0","53.9","37.43"
"65","000","00","001","0184","1165","1012","796","216","60","1072","1842","0","58.2","43.21"
"65","000","00","001","0185","0000","1207","930","277","104","1311","2322","0","56.46","40.05"
"65","000","00","001","0185","1166","579","457","122","54","633","1094","0","57.86","41.77"
"65","000","00","001","0185","1167","628","473","155","50","678","1228","0","55.21","38.52"
"65","000","00","001","0186","0000","3163","2449","714","235","3398","6224","0","54.6","39.35"
"65","000","00","001","0186","1170","787","583","204","66","853","1622","0","52.59","35.94"
"65","000","00","001","0186","1171","654","496","158","67","721","1205","0","59.83","41.16"
"65","000","00","001","0186","1172","851","658","193","57","908","1787","0","50.81","36.82"
"65","000","00","001","0186","1173","871","712","159","45","916","1610","0","56.89","44.22"
"65","000","00","001","0187","0000","3460","2671","789","182","3642","6600","0","55.18","40.47"
"65","000","00","001","0187","1174","1240","950","290","39","1279","2216","0","57.72","42.87"
"65","000","00","001","0187","1175","1212","931","281","56","1268","2294","0","55.27","40.58"
"65","000","00","001","0187","1176","1008","790","218","87","1095","2090","0","52.39","37.8"
"65","000","00","001","0188","0000","1925","1490","435","131","2056","3742","0","54.94","39.82"
"65","000","00","001","0188","1177","629","513","116","39","668","1356","0","49.26","37.83"
"65","000","00","001","0188","1178","581","446","135","41","622","1067","0","58.29","41.8"
"65","000","00","001","0188","1179","715","531","184","51","766","1319","0","58.07","40.26"
"65","000","00","001","0189","0000","1624","1210","414","159","1783","3368","0","52.94","35.93"
"65","000","00","001","0189","1180","605","450","155","55","660","1316","0","50.15","34.19"
"65","000","00","001","0189","1181","580","435","145","70","650","1195","0","54.39","36.4"
"65","000","00","001","0189","1182","439","325","114","34","473","857","0","55.19","37.92"
"65","000","00","001","0190","0000","2448","1807","641","251","2699","4724","0","57.13","38.25"
"65","000","00","001","0190","1183","694","524","170","78","772","1417","0","54.48","36.98"
"65","000","00","001","0190","1184","818","595","223","80","898","1560","0","57.56","38.14"
"65","000","00","001","0190","1185","936","688","248","93","1029","1747","0","58.9","39.38"
"65","000","00","001","0191","0000","2103","1603","500","111","2214","3735","0","59.28","42.92"
"65","000","00","001","0191","1186","703","528","175","53","756","1176","0","64.29","44.9"
"65","000","00","001","0191","1187","616","469","147","28","644","1101","0","58.49","42.6"
"65","000","00","001","0191","1188","784","606","178","30","814","1458","0","55.83","41.56"
"65","000","00","001","0192","0000","2993","2327","666","262","3255","5591","0","58.22","41.62"
"65","000","00","001","0192","1192","566","456","110","33","599","1120","0","53.48","40.71"
"65","000","00","001","0192","1193","566","419","147","88","654","1022","0","63.99","41.0"
"65","000","00","001","0192","1194","555","393","162","82","637","1049","0","60.72","37.46"
"65","000","00","001","0192","1195","562","449","113","23","585","1007","0","58.09","44.59"
"65","000","00","001","0192","1196","744","610","134","36","780","1393","0","55.99","43.79"
"65","000","00","001","0193","0000","440","332","108","62","502","974","0","51.54","34.09"
"65","000","00","001","0193","1197","165","126","39","35","200","474","0","42.19","26.58"
"65","000","00","001","0193","1198","275","206","69","27","302","500","0","60.4","41.2"
"65","000","00","001","0194","0000","1857","1419","438","135","1992","3502","0","56.88","40.52"
"65","000","00","001","0194","1199","601","441","160","44","645","1177","0","54.8","37.47"
"65","000","00","001","0194","1200","603","472","131","33","636","1186","0","53.63","39.8"
"65","000","00","001","0194","1201","653","506","147","58","711","1139","0","62.42","44.42"
"65","000","00","001","0195","0000","2029","1595","434","99","2128","5201","0","40.92","30.67"
"65","000","00","001","0195","1202","886","681","205","69","955","1750","0","54.57","38.91"
"65","000","00","001","0195","1203","1143","914","229","30","1173","3451","0","33.99","26.49"
"65","000","00","001","0196","0000","2314","1780","534","167","2481","4730","0","52.45","37.63"
"65","000","00","001","0196","1204","779","595","184","79","858","1620","0","52.96","36.73"
"65","000","00","001","0196","1205","410","328","82","23","433","903","0","47.95","36.32"
"65","000","00","001","0196","1206","675","513","162","44","719","1232","0","58.36","41.64"
"65","000","00","001","0196","1207","450","344","106","21","471","975","0","48.31","35.28"
"65","000","00","001","0197","0000","1270","987","283","81","1351","2515","0","53.72","39.24"
"65","000","00","001","0197","1208","601","462","139","42","643","1224","0","52.53","37.75"
"65","000","00","001","0197","1209","669","525","144","39","708","1291","0","54.84","40.67"
"65","000","00","001","0198","0000","4089","3194","895","229","4318","8555","0","50.47","37.33"
"65","000","00","001","0198","1210","859","655","204","42","901","1828","0","49.29","35.83"
"65","000","00","001","0198","1211","807","629","178","52","859","1725","0","49.8","36.46"
"65","000","00","001","0198","1212","501","387","114","29","530","1085","0","48.85","35.67"
"65","000","00","001","0198","1213","1136","911","225","71","1207","2357","0","51.21","38.65"
"65","000","00","001","0198","1214","786","612","174","35","821","1560","0","52.63","39.23"
"65","000","00","001","0199","0000","2473","1950","523","141","2614","5152","0","50.74","37.85"
"65","000","00","001","0199","1218","869","666","203","54","923","1763","0","52.35","37.78"
"65","000","00","001","0199","1219","802","645","157","34","836","1744","0","47.94","36.98"
"65","000","00","001","0199","1220","802","639","163","53","855","1645","0","51.98","38.84"
"65","000","00","001","01A0","0000","1680","1294","386","128","1808","3118","0","57.99","41.5"
"65","000","00","001","01A0","1228","801","599","202","81","882","1566","0","56.32","38.25"
"65","000","00","001","01A0","1229","879","695","184","47","926","1552","0","59.66","44.78"
"65","000","00","001","01A1","0000","1217","950","267","135","1352","2270","0","59.56","41.85"
"65","000","00","001","01A1","0913","595","456","139","45","640","1026","0","62.38","44.44"
"65","000","00","001","01A1","0914","622","494","128","90","712","1244","0","57.23","39.71"
"65","000","00","001","01A2","0000","2176","1665","511","190","2366","3821","0","61.92","43.57"
"65","000","00","001","01A2","0933","664","502","162","67","731","1238","0","59.05","40.55"
"65","000","00","001","01A2","0934","819","635","184","64","883","1389","0","63.57","45.72"
"65","000","00","001","01A2","0935","693","528","165","59","752","1194","0","62.98","44.22"
"65","000","00","001","01A3","0000","1499","1180","319","111","1610","2740","0","58.76","43.07"
"65","000","00","001","01A3","0962","811","632","179","44","855","1515","0","56.44","41.72"
"65","000","00","001","01A3","0963","688","548","140","67","755","1225","0","61.63","44.73"
"65","000","00","001","01A4","0000","1543","1112","431","165","1708","2949","0","57.92","37.71"
"65","000","00","001","01A4","0991","700","521","179","72","772","1245","0","62.01","41.85"
"65","000","00","001","01A4","0992","843","591","252","93","936","1704","0","54.93","34.68"
"65","000","00","001","01A5","0000","1591","1244","347","74","1665","3134","0","53.13","39.69"
"65","000","00","001","01A5","1012","530","402","128","23","553","1076","0","51.39","37.36"
"65","000","00","001","01A5","1013","439","341","98","14","453","979","0","46.27","34.83"
"65","000","00","001","01A5","1014","622","501","121","37","659","1079","0","61.08","46.43"
"65","000","00","001","01A6","0000","1339","981","358","114","1453","2493","0","58.28","39.35"
"65","000","00","001","01A6","1033","741","550","191","77","818","1315","0","62.21","41.83"
"65","000","00","001","01A6","1034","598","431","167","37","635","1178","0","53.9","36.59"
"65","000","00","001","01A7","0000","1109","836","273","41","1150","2026","0","56.76","41.26"
"65","000","00","001","01A7","1069","497","377","120","21","518","992","0","52.22","38.0"
"65","000","00","001","01A7","1070","612","459","153","20","632","1034","0","61.12","44.39"
"65","000","00","001","01A8","0000","1432","1113","319","93","1525","2697","0","56.54","41.27"
"65","000","00","001","01A8","1084","742","585","157","44","786","1515","0","51.88","38.61"
"65","000","00","001","01A8","1085","690","528","162","49","739","1182","0","62.52","44.67"
"65","000","00","001","01A9","0000","1072","795","277","104","1176","1966","0","59.82","40.44"
"65","000","00","001","01A9","1114","531","392","139","63","594","972","0","61.11","40.33"
"65","000","00","001","01A9","1115","541","403","138","41","582","994","0","58.55","40.54"
"65","000","00","001","01B0","0000","1842","1402","440","109","1951","3337","0","58.47","42.01"
"65","000","00","001","01B0","1131","924","709","215","35","959","1625","0","59.02","43.63"
"65","000","00","001","01B0","1132","918","693","225","74","992","1712","0","57.94","40.48"
"65","000","00","001","01B1","0000","1172","909","263","89","1261","1860","0","67.8","48.87"
"65","000","00","001","01B1","1168","598","453","145","49","647","998","0","64.83","45.39"
"65","000","00","001","01B1","1169","574","456","118","40","614","862","0","71.23","52.9"
"65","000","00","001","01B2","0000","1859","1382","477","100","1959","3778","0","51.85","36.58"
"65","000","00","001","01B2","1230","937","698","239","34","971","1885","0","51.51","37.03"
"65","000","00","001","01B2","1231","922","684","238","66","988","1893","0","52.19","36.13"
"65","000","00","001","01B3","0000","2443","1943","500","201","2644","5613","0","47.1","34.62"
"65","000","00","001","01B3","1215","892","740","152","32","924","2201","0","41.98","33.62"
"65","000","00","001","01B3","1216","792","605","187","115","907","1626","0","55.78","37.21"
"65","000","00","001","01B3","1217","759","598","161","54","813","1786","0","45.52","33.48"
"65","000","00","001","01B4","0000","1128","891","237","42","1170","2314","0","50.56","38.5"
"65","000","00","001","01B4","0926","583","467","116","16","599","1215","0","49.3","38.44"
"65","000","00","001","01B4","0927","545","424","121","26","571","1099","0","51.96","38.58"
"65","000","00","001","01B5","0000","1030","822","208","118","1148","1793","0","64.03","45.84"
"65","000","00","001","01B5","0945","459","363","96","43","502","796","0","63.07","45.6"
"65","000","00","001","01B5","0946","571","459","112","75","646","997","0","64.79","46.04"
"65","000","00","001","01B6","0000","1349","1012","337","166","1515","2487","0","60.92","40.69"
"65","000","00","001","01B6","0967","717","533","184","75","792","1283","0","61.73","41.54"
"65","000","00","001","01B6","0968","632","479","153","91","723","1204","0","60.05","39.78"
"65","000","00","001","01B7","0000","1611","1218","393","176","1787","3024","0","59.09","40.28"
"65","000","00","001","01B7","1002","579","429","150","80","659","1133","0","58.16","37.86"
"65","000","00","001","01B7","1003","432","324","108","41","473","841","0","56.24","38.53"
"65","000","00","001","01B7","1004","600","465","135","55","655","1050","0","62.38","44.29"
"65","000","00","001","01B8","0000","1152","877","275","136","1288","2059","0","62.55","42.59"
"65","000","00","001","01B8","1029","619","489","130","66","685","1096","0","62.5","44.62"
"65","000","00","001","01B8","1030","533","388","145","70","603","963","0","62.62","40.29"
"65","000","00","001","01B9","0000","1667","1240","427","219","1886","3428","0","55.02","36.17"
"65","000","00","001","01B9","1042","811","603","208","110","921","1678","0","54.89","35.94"
"65","000","00","001","01B9","1043","856","637","219","109","965","1750","0","55.14","36.4"
"65","000","00","001","01C0","0000","1560","1163","397","121","1681","2942","0","57.14","39.53"
"65","000","00","001","01C0","1075","793","599","194","76","869","1349","0","64.42","44.4"
"65","000","00","001","01C0","1076","767","564","203","45","812","1593","0","50.97","35.4"
"65","000","00","001","01C1","0000","1701","1355","346","96","1797","3428","0","52.42","39.53"
"65","000","00","001","01C1","1093","940","760","180","31","971","1954","0","49.69","38.89"
"65","000","00","001","01C1","1094","761","595","166","65","826","1474","0","56.04","40.37"
"65","000","00","001","01C2","0000","1044","812","232","135","1179","2061","0","57.21","39.4"
"65","000","00","001","01C2","1119","513","395","118","78","591","1021","0","57.88","38.69"
"65","000","00","001","01C2","1120","531","417","114","57","588","1040","0","56.54","40.1"
"65","000","00","001","01C3","0000","1934","1509","425","138","2072","3645","0","56.84","41.4"
"65","000","00","001","01C3","1161","670","515","155","20","690","1289","0","53.53","39.95"
"65","000","00","001","01C3","1162","618","508","110","53","671","1182","0","56.77","42.98"
"65","000","00","001","01C3","1163","646","486","160","65","711","1174","0","60.56","41.4"
"65","000","00","001","01C4","0000","6118","4882","1236","344","6462","12065","0","53.56","40.46"
"65","000","00","001","01C4","1221","853","699","154","47","900","1861","0","48.36","37.56"
"65","000","00","001","01C4","1222","745","586","159","31","776","1596","0","48.62","36.72"
"65","000","00","001","01C4","1223","950","713","237","61","1011","1871","0","54.04","38.11"
"65","000","00","001","01C4","1224","1096","883","213","69","1165","1938","0","60.11","45.56"
"65","000","00","001","01C4","1225","966","760","206","47","1013","1827","0","55.45","41.6"
"65","000","00","001","01C4","1226","685","566","119","29","714","1359","0","52.54","41.65"
"65","000","00","001","01C4","1227","823","675","148","60","883","1613","0","54.74","41.85"
"65","000","00","001","01C5","0000","1540","1220","320","148","1688","3241","0","52.08","37.64"
"65","000","00","001","01C5","1189","752","605","147","48","800","1630","0","49.08","37.12"
"65","000","00","001","01C5","1190","788","615","173","100","888","1611","0","55.12","38.18"
"65","000","00","001","01C6","0000","554","428","126","42","596","1139","0","52.33","37.58"
"65","000","00","001","01C6","1191","554","428","126","42","596","1139","0","52.33","37.58"
"65","000","00","002","0000","0000","167630","126943","40687","15951","183581","329846","386077","55.66","38.49"
"65","000","00","002","0201","0000","2471","1867","604","213","2684","4753","0","56.47","39.28"
"65","000","00","002","0201","0659","732","564","168","75","807","1509","0","53.48","37.38"
"65","000","00","002","0201","0660","861","663","198","68","929","1591","0","58.39","41.67"
"65","000","00","002","0201","0661","878","640","238","70","948","1653","0","57.35","38.72"
"65","000","00","002","0202","0000","785","589","196","47","832","1459","0","57.03","40.37"
"65","000","00","002","0202","0665","785","589","196","47","832","1459","0","57.03","40.37"
"65","000","00","002","0203","0000","1128","845","283","130","1258","2090","0","60.19","40.43"
"65","000","00","002","0203","0666","549","418","131","68","617","1024","0","60.25","40.82"
"65","000","00","002","0203","0667","579","427","152","62","641","1066","0","60.13","40.06"
"65","000","00","002","0204","0000","496","360","136","70","566","856","0","66.12","42.06"
"65","000","00","002","0204","0668","496","360","136","70","566","856","0","66.12","42.06"
"65","000","00","002","0205","0000","1728","1301","427","121","1849","3533","0","52.34","36.82"
"65","000","00","002","0205","0671","913","703","210","70","983","1887","0","52.09","37.25"
"65","000","00","002","0205","0672","815","598","217","51","866","1646","0","52.61","36.33"
"65","000","00","002","0206","0000","194","143","51","19","213","358","0","59.5","39.94"
"65","000","00","002","0206","0673","194","143","51","19","213","358","0","59.5","39.94"
"65","000","00","002","0207","0000","2960","2225","735","178","3138","5443","0","57.65","40.88"
"65","000","00","002","0207","0674","570","452","118","52","622","1039","0","59.87","43.5"
"65","000","00","002","0207","0675","633","445","188","42","675","1114","0","60.59","39.95"
"65","000","00","002","0207","0676","890","676","214","41","931","1588","0","58.63","42.57"
"65","000","00","002","0207","0677","867","652","215","43","910","1702","0","53.47","38.31"
"65","000","00","002","0208","0000","2599","1973","626","213","2812","4778","0","58.85","41.29"
"65","000","00","002","0208","0678","729","538","191","61","790","1288","0","61.34","41.77"
"65","000","00","002","0208","0679","903","667","236","74","977","1629","0","59.98","40.95"
"65","000","00","002","0208","0680","967","768","199","78","1045","1861","0","56.15","41.27"
"65","000","00","002","0209","0000","1635","1249","386","149","1784","3108","0","57.4","40.19"
"65","000","00","002","0209","0683","826","647","179","74","900","1595","0","56.43","40.56"
"65","000","00","002","0209","0684","809","602","207","75","884","1513","0","58.43","39.79"
"65","000","00","002","0210","0000","3066","2324","742","188","3254","8503","0","38.27","27.33"
"65","000","00","002","0210","0685","764","533","231","57","821","4433","0","18.52","12.02"
"65","000","00","002","0210","0686","702","535","167","43","745","1283","0","58.07","41.7"
"65","000","00","002","0210","0687","824","647","177","48","872","1430","0","60.98","45.24"
"65","000","00","002","0210","0688","776","609","167","40","816","1357","0","60.13","44.88"
"65","000","00","002","0211","0000","1002","745","257","93","1095","1846","0","59.32","40.36"
"65","000","00","002","0211","0689","529","401","128","41","570","963","0","59.19","41.64"
"65","000","00","002","0211","0690","473","344","129","52","525","883","0","59.46","38.96"
"65","000","00","002","0212","0000","1608","1205","403","195","1803","3110","0","57.97","38.75"
"65","000","00","002","0212","0691","775","569","206","99","874","1494","0","58.5","38.09"
"65","000","00","002","0212","0692","833","636","197","96","929","1616","0","57.49","39.36"
"65","000","00","002","0213","0000","2151","1621","530","220","2371","3998","0","59.3","40.55"
"65","000","00","002","0213","0693","682","529","153","77","759","1329","0","57.11","39.8"
"65","000","00","002","0213","0694","748","557","191","58","806","1289","0","62.53","43.21"
"65","000","00","002","0213","0695","721","535","186","85","806","1380","0","58.41","38.77"
"65","000","00","002","0214","0000","3118","2403","715","274","3392","5679","0","59.73","42.31"
"65","000","00","002","0214","0696","894","714","180","46","940","1668","0","56.35","42.81"
"65","000","00","002","0214","0697","702","541","161","74","776","1226","0","63.3","44.13"
"65","000","00","002","0214","0698","776","578","198","99","875","1421","0","61.58","40.68"
"65","000","00","002","0214","0699","746","570","176","55","801","1364","0","58.72","41.79"
"65","000","00","002","0215","0000","2075","1555","520","187","2262","3736","0","60.55","41.62"
"65","000","00","002","0215","0700","676","515","161","56","732","1232","0","59.42","41.8"
"65","000","00","002","0215","0701","712","549","163","67","779","1248","0","62.42","43.99"
"65","000","00","002","0215","0702","687","491","196","64","751","1256","0","59.79","39.09"
"65","000","00","002","0216","0000","1778","1331","447","140","1918","3175","0","60.41","41.92"
"65","000","00","002","0216","0703","863","636","227","68","931","1506","0","61.82","42.23"
"65","000","00","002","0216","0704","915","695","220","72","987","1669","0","59.14","41.64"
"65","000","00","002","0217","0000","2936","2240","696","368","3304","5489","0","60.19","40.81"
"65","000","00","002","0217","0705","663","500","163","102","765","1308","0","58.49","38.23"
"65","000","00","002","0217","0706","761","594","167","68","829","1263","0","65.64","47.03"
"65","000","00","002","0217","0707","749","565","184","88","837","1471","0","56.9","38.41"
"65","000","00","002","0217","0708","763","581","182","110","873","1447","0","60.33","40.15"
"65","000","00","002","0218","0000","2635","2007","628","229","2864","5520","0","51.88","36.36"
"65","000","00","002","0218","0709","760","564","196","71","831","1693","0","49.08","33.31"
"65","000","00","002","0218","0710","1033","792","241","53","1086","2015","0","53.9","39.31"
"65","000","00","002","0218","0711","842","651","191","105","947","1812","0","52.26","35.93"
"65","000","00","002","0219","0000","1468","1105","363","104","1572","2948","0","53.32","37.48"
"65","000","00","002","0219","0712","713","525","188","41","754","1509","0","49.97","34.79"
"65","000","00","002","0219","0713","755","580","175","63","818","1439","0","56.85","40.31"
"65","000","00","002","0220","0000","3373","2643","730","228","3601","6530","0","55.15","40.47"
"65","000","00","002","0220","0714","751","559","192","59","810","1437","0","56.37","38.9"
"65","000","00","002","0220","0715","853","644","209","66","919","1697","0","54.15","37.95"
"65","000","00","002","0220","0716","866","751","115","47","913","1793","0","50.92","41.89"
"65","000","00","002","0220","0717","903","689","214","56","959","1603","0","59.83","42.98"
"65","000","00","002","0221","0000","1210","913","297","89","1299","2292","0","56.68","39.83"
"65","000","00","002","0221","0718","591","445","146","44","635","1166","0","54.46","38.16"
"65","000","00","002","0221","0719","619","468","151","45","664","1126","0","58.97","41.56"
"65","000","00","002","0222","0000","583","447","136","64","647","1291","0","50.12","34.62"
"65","000","00","002","0222","0720","583","447","136","64","647","1291","0","50.12","34.62"
"65","000","00","002","0223","0000","725","615","110","81","806","1597","0","50.47","38.51"
"65","000","00","002","0223","0721","725","615","110","81","806","1597","0","50.47","38.51"
"65","000","00","002","0224","0000","1122","842","280","128","1250","1992","0","62.75","42.27"
"65","000","00","002","0224","0722","594","439","155","68","662","1081","0","61.24","40.61"
"65","000","00","002","0224","0723","528","403","125","60","588","911","0","64.54","44.24"
"65","000","00","002","0225","0000","782","581","201","57","839","1719","0","48.81","33.8"
"65","000","00","002","0225","0724","782","581","201","57","839","1719","0","48.81","33.8"
"65","000","00","002","0226","0000","634","482","152","90","724","1289","0","56.17","37.39"
"65","000","00","002","0226","0725","634","482","152","90","724","1289","0","56.17","37.39"
"65","000","00","002","0227","0000","711","547","164","93","804","1318","0","61.0","41.5"
"65","000","00","002","0227","0726","711","547","164","93","804","1318","0","61.0","41.5"
"65","000","00","002","0228","0000","867","643","224","75","942","1822","0","51.7","35.29"
"65","000","00","002","0228","0727","867","643","224","75","942","1822","0","51.7","35.29"
"65","000","00","002","0229","0000","591","440","151","100","691","1185","0","58.31","37.13"
"65","000","00","002","0229","0728","591","440","151","100","691","1185","0","58.31","37.13"
"65","000","00","002","0230","0000","630","466","164","92","722","1369","0","52.74","34.04"
"65","000","00","002","0230","0729","630","466","164","92","722","1369","0","52.74","34.04"
"65","000","00","002","0231","0000","784","587","197","73","857","1507","0","56.87","38.95"
"65","000","00","002","0231","0730","784","587","197","73","857","1507","0","56.87","38.95"
"65","000","00","002","0232","0000","927","700","227","93","1020","1876","0","54.37","37.31"
"65","000","00","002","0232","0731","484","371","113","69","553","926","0","59.72","40.06"
"65","000","00","002","0232","0732","443","329","114","24","467","950","0","49.16","34.63"
"65","000","00","002","0233","0000","805","605","200","83","888","1678","0","52.92","36.05"
"65","000","00","002","0233","0733","805","605","200","83","888","1678","0","52.92","36.05"
"65","000","00","002","0234","0000","562","412","150","76","638","1117","0","57.12","36.88"
"65","000","00","002","0234","0734","562","412","150","76","638","1117","0","57.12","36.88"
"65","000","00","002","0235","0000","634","483","151","66","700","1318","0","53.11","36.65"
"65","000","00","002","0235","0735","634","483","151","66","700","1318","0","53.11","36.65"
"65","000","00","002","0236","0000","714","516","198","40","754","1388","0","54.32","37.18"
"65","000","00","002","0236","0736","714","516","198","40","754","1388","0","54.32","37.18"
"65","000","00","002","0237","0000","525","386","139","74","599","1026","0","58.38","37.62"
"65","000","00","002","0237","0737","525","386","139","74","599","1026","0","58.38","37.62"
"65","000","00","002","0238","0000","1171","894","277","85","1256","2063","0","60.88","43.33"
"65","000","00","002","0238","0738","637","483","154","48","685","1096","0","62.5","44.07"
"65","000","00","002","0238","0739","534","411","123","37","571","967","0","59.05","42.5"
"65","000","00","002","0239","0000","1741","1288","453","167","1908","3534","0","53.99","36.45"
"65","000","00","002","0239","0740","901","660","241","71","972","1871","0","51.95","35.28"
"65","000","00","002","0239","0741","840","628","212","96","936","1663","0","56.28","37.76"
"65","000","00","002","0240","0000","607","477","130","30","637","1208","0","52.73","39.49"
"65","000","00","002","0240","0742","607","477","130","30","637","1208","0","52.73","39.49"
"65","000","00","002","0241","0000","1194","901","293","98","1292","2476","0","52.18","36.39"
"65","000","00","002","0241","0743","655","490","165","67","722","1398","0","51.65","35.05"
"65","000","00","002","0241","0744","539","411","128","31","570","1078","0","52.88","38.13"
"65","000","00","002","0242","0000","1224","916","308","147","1371","2495","0","54.95","36.71"
"65","000","00","002","0242","0745","534","413","121","70","604","1102","0","54.81","37.48"
"65","000","00","002","0242","0746","690","503","187","77","767","1393","0","55.06","36.11"
"65","000","00","002","0243","0000","1383","1035","348","142","1525","2485","0","61.37","41.65"
"65","000","00","002","0243","0747","672","490","182","67","739","1251","0","59.07","39.17"
"65","000","00","002","0243","0748","711","545","166","75","786","1234","0","63.7","44.17"
"65","000","00","002","0244","0000","1698","1272","426","169","1867","3251","0","57.43","39.13"
"65","000","00","002","0244","0749","876","657","219","84","960","1661","0","57.8","39.55"
"65","000","00","002","0244","0750","822","615","207","85","907","1590","0","57.04","38.68"
"65","000","00","002","0245","0000","2090","1542","548","190","2280","3773","0","60.43","40.87"
"65","000","00","002","0245","0751","640","474","166","64","704","1182","0","59.56","40.1"
"65","000","00","002","0245","0752","748","547","201","70","818","1369","0","59.75","39.96"
"65","000","00","002","0245","0753","702","521","181","56","758","1222","0","62.03","42.64"
"65","000","00","002","0246","0000","644","484","160","97","741","1304","0","56.83","37.12"
"65","000","00","002","0246","0754","644","484","160","97","741","1304","0","56.83","37.12"
"65","000","00","002","0247","0000","517","398","119","48","565","1054","0","53.61","37.76"
"65","000","00","002","0247","0755","517","398","119","48","565","1054","0","53.61","37.76"
"65","000","00","002","0248","0000","846","623","223","70","916","1635","0","56.02","38.1"
"65","000","00","002","0248","0756","846","623","223","70","916","1635","0","56.02","38.1"
"65","000","00","002","0249","0000","858","650","208","78","936","1779","0","52.61","36.54"
"65","000","00","002","0249","0757","858","650","208","78","936","1779","0","52.61","36.54"
"65","000","00","002","0250","0000","837","624","213","97","934","1633","0","57.2","38.21"
"65","000","00","002","0250","0758","837","624","213","97","934","1633","0","57.2","38.21"
"65","000","00","002","0251","0000","1162","871","291","111","1273","2128","0","59.82","40.93"
"65","000","00","002","0251","0759","581","444","137","59","640","1107","0","57.81","40.11"
"65","000","00","002","0251","0760","581","427","154","52","633","1021","0","62.0","41.82"
"65","000","00","002","0252","0000","746","538","208","105","851","1649","0","51.61","32.63"
"65","000","00","002","0252","0761","746","538","208","105","851","1649","0","51.61","32.63"
"65","000","00","002","0253","0000","481","378","103","37","518","874","0","59.27","43.25"
"65","000","00","002","0253","0762","481","378","103","37","518","874","0","59.27","43.25"
"65","000","00","002","0254","0000","716","540","176","104","820","1402","0","58.49","38.52"
"65","000","00","002","0254","0763","716","540","176","104","820","1402","0","58.49","38.52"
"65","000","00","002","0255","0000","762","570","192","101","863","1713","0","50.38","33.27"
"65","000","00","002","0255","0764","762","570","192","101","863","1713","0","50.38","33.27"
"65","000","00","002","0256","0000","989","740","249","115","1104","2011","0","54.9","36.8"
"65","000","00","002","0256","0765","431","323","108","59","490","973","0","50.36","33.2"
"65","000","00","002","0256","0766","558","417","141","56","614","1038","0","59.15","40.17"
"65","000","00","002","0257","0000","816","615","201","123","939","1833","0","51.23","33.55"
"65","000","00","002","0257","0767","816","615","201","123","939","1833","0","51.23","33.55"
"65","000","00","002","0258","0000","416","311","105","32","448","817","0","54.83","38.07"
"65","000","00","002","0258","0768","416","311","105","32","448","817","0","54.83","38.07"
"65","000","00","002","0259","0000","807","637","170","66","873","1387","0","62.94","45.93"
"65","000","00","002","0259","0769","807","637","170","66","873","1387","0","62.94","45.93"
"65","000","00","002","0260","0000","436","336","100","37","473","784","0","60.33","42.86"
"65","000","00","002","0260","0770","436","336","100","37","473","784","0","60.33","42.86"
"65","000","00","002","0261","0000","1159","852","307","109","1268","2259","0","56.13","37.72"
"65","000","00","002","0261","0771","545","400","145","35","580","1096","0","52.92","36.5"
"65","000","00","002","0261","0772","614","452","162","74","688","1163","0","59.16","38.87"
"65","000","00","002","0262","0000","909","719","190","63","972","1868","0","52.03","38.49"
"65","000","00","002","0262","0773","909","719","190","63","972","1868","0","52.03","38.49"
"65","000","00","002","0263","0000","993","727","266","123","1116","2051","0","54.41","35.45"
"65","000","00","002","0263","0774","541","397","144","74","615","1117","0","55.06","35.54"
"65","000","00","002","0263","0775","452","330","122","49","501","934","0","53.64","35.33"
"65","000","00","002","0264","0000","664","485","179","76","740","1412","0","52.41","34.35"
"65","000","00","002","0264","0776","664","485","179","76","740","1412","0","52.41","34.35"
"65","000","00","002","0265","0000","620","482","138","50","670","1062","0","63.09","45.39"
"65","000","00","002","0265","0777","620","482","138","50","670","1062","0","63.09","45.39"
"65","000","00","002","0266","0000","1006","783","223","152","1158","1827","0","63.38","42.86"
"65","000","00","002","0266","0778","428","328","100","85","513","891","0","57.58","36.81"
"65","000","00","002","0266","0779","578","455","123","67","645","936","0","68.91","48.61"
"65","000","00","002","0267","0000","1019","727","292","90","1109","2150","0","51.58","33.81"
"65","000","00","002","0267","0780","531","390","141","69","600","1085","0","55.3","35.94"
"65","000","00","002","0267","0781","488","337","151","21","509","1065","0","47.79","31.64"
"65","000","00","002","0268","0000","1553","1219","334","133","1686","2948","0","57.19","41.35"
"65","000","00","002","0268","0782","733","567","166","68","801","1398","0","57.3","40.56"
"65","000","00","002","0268","0783","820","652","168","65","885","1550","0","57.1","42.06"
"65","000","00","002","0269","0000","811","626","185","96","907","1674","0","54.18","37.4"
"65","000","00","002","0269","0784","811","626","185","96","907","1674","0","54.18","37.4"
"65","000","00","002","0270","0000","637","475","162","72","709","1215","0","58.35","39.09"
"65","000","00","002","0270","0785","637","475","162","72","709","1215","0","58.35","39.09"
"65","000","00","002","0271","0000","802","581","221","77","879","1606","0","54.73","36.18"
"65","000","00","002","0271","0786","802","581","221","77","879","1606","0","54.73","36.18"
"65","000","00","002","0272","0000","1249","948","301","142","1391","2420","0","57.48","39.17"
"65","000","00","002","0272","0787","607","467","140","56","663","1182","0","56.09","39.51"
"65","000","00","002","0272","0788","642","481","161","86","728","1238","0","58.8","38.85"
"65","000","00","002","0273","0000","1493","1129","364","123","1616","2750","0","58.76","41.05"
"65","000","00","002","0273","0789","738","559","179","59","797","1342","0","59.39","41.65"
"65","000","00","002","0273","0790","755","570","185","64","819","1408","0","58.17","40.48"
"65","000","00","002","0274","0000","893","663","230","98","991","1770","0","55.99","37.46"
"65","000","00","002","0274","0791","893","663","230","98","991","1770","0","55.99","37.46"
"65","000","00","002","0275","0000","986","727","259","75","1061","1915","0","55.4","37.96"
"65","000","00","002","0275","0792","496","362","134","54","550","940","0","58.51","38.51"
"65","000","00","002","0275","0793","490","365","125","21","511","975","0","52.41","37.44"
"65","000","00","002","0276","0000","2151","1620","531","181","2332","4183","0","55.75","38.73"
"65","000","00","002","0276","0794","758","584","174","43","801","1507","0","53.15","38.75"
"65","000","00","002","0276","0795","733","521","212","80","813","1419","0","57.29","36.72"
"65","000","00","002","0276","0796","660","515","145","58","718","1257","0","57.12","40.97"
"65","000","00","002","0277","0000","1698","1319","379","175","1873","3364","0","55.68","39.21"
"65","000","00","002","0277","0797","830","631","199","90","920","1619","0","56.83","38.97"
"65","000","00","002","0277","0798","868","688","180","85","953","1745","0","54.61","39.43"
"65","000","00","002","0278","0000","2507","1886","621","230","2737","4898","0","55.88","38.51"
"65","000","00","002","0278","0799","775","578","197","79","854","1519","0","56.22","38.05"
"65","000","00","002","0278","0800","809","605","204","80","889","1682","0","52.85","35.97"
"65","000","00","002","0278","0801","923","703","220","71","994","1697","0","58.57","41.43"
"65","000","00","002","0279","0000","969","717","252","123","1092","1997","0","54.68","35.9"
"65","000","00","002","0279","0802","510","367","143","72","582","1073","0","54.24","34.2"
"65","000","00","002","0279","0803","459","350","109","51","510","924","0","55.19","37.88"
"65","000","00","002","0280","0000","697","524","173","60","757","1613","0","46.93","32.49"
"65","000","00","002","0280","0804","697","524","173","60","757","1613","0","46.93","32.49"
"65","000","00","002","0281","0000","1072","808","264","126","1198","2152","0","55.67","37.55"
"65","000","00","002","0281","0805","491","378","113","64","555","1034","0","53.68","36.56"
"65","000","00","002","0281","0806","581","430","151","62","643","1118","0","57.51","38.46"
"65","000","00","002","0282","0000","1759","1300","459","254","2013","3595","0","55.99","36.16"
"65","000","00","002","0282","0807","619","454","165","86","705","1269","0","55.56","35.78"
"65","000","00","002","0282","0808","475","339","136","77","552","990","0","55.76","34.24"
"65","000","00","002","0282","0809","665","507","158","91","756","1336","0","56.59","37.95"
"65","000","00","002","0283","0000","1689","1286","403","163","1852","3182","0","58.2","40.41"
"65","000","00","002","0283","0810","823","637","186","76","899","1601","0","56.15","39.79"
"65","000","00","002","0283","0811","866","649","217","87","953","1581","0","60.28","41.05"
"65","000","00","002","0284","0000","1401","1058","343","135","1536","2571","0","59.74","41.15"
"65","000","00","002","0284","0812","713","556","157","70","783","1345","0","58.22","41.34"
"65","000","00","002","0284","0813","688","502","186","65","753","1226","0","61.42","40.95"
"65","000","00","002","0285","0000","1349","1064","285","166","1515","2790","0","54.3","38.14"
"65","000","00","002","0285","0814","768","606","162","93","861","1650","0","52.18","36.73"
"65","000","00","002","0285","0815","581","458","123","73","654","1140","0","57.37","40.18"
"65","000","00","002","0286","0000","1681","1327","354","123","1804","3338","0","54.04","39.75"
"65","000","00","002","0286","0816","811","635","176","43","854","1639","0","52.1","38.74"
"65","000","00","002","0286","0817","870","692","178","80","950","1699","0","55.92","40.73"
"65","000","00","002","0287","0000","2172","1640","532","222","2394","4355","0","54.97","37.66"
"65","000","00","002","0287","0820","756","580","176","88","844","1540","0","54.81","37.66"
"65","000","00","002","0287","0821","659","513","146","56","715","1276","0","56.03","40.2"
"65","000","00","002","0287","0822","757","547","210","78","835","1539","0","54.26","35.54"
"65","000","00","002","0288","0000","1481","1125","356","147","1628","2898","0","56.18","38.82"
"65","000","00","002","0288","0828","719","541","178","74","793","1407","0","56.36","38.45"
"65","000","00","002","0288","0829","762","584","178","73","835","1491","0","56.0","39.17"
"65","000","00","002","0289","0000","2427","1798","629","232","2659","4718","0","56.36","38.11"
"65","000","00","002","0289","0837","741","546","195","77","818","1398","0","58.51","39.06"
"65","000","00","002","0289","0838","829","613","216","88","917","1706","0","53.75","35.93"
"65","000","00","002","0289","0839","857","639","218","67","924","1614","0","57.25","39.59"
"65","000","00","002","0290","0000","2429","1816","613","243","2672","4723","0","56.57","38.45"
"65","000","00","002","0290","0840","828","605","223","98","926","1591","0","58.2","38.03"
"65","000","00","002","0290","0841","805","601","204","64","869","1627","0","53.41","36.94"
"65","000","00","002","0290","0842","796","610","186","81","877","1505","0","58.27","40.53"
"65","000","00","002","0291","0000","1766","1365","401","117","1883","3577","0","52.64","38.16"
"65","000","00","002","0291","0832","954","752","202","65","1019","1938","0","52.58","38.8"
"65","000","00","002","0291","0833","812","613","199","52","864","1639","0","52.72","37.4"
"65","000","00","002","0292","0000","1231","901","330","110","1341","2290","0","58.56","39.34"
"65","000","00","002","0292","0823","648","468","180","55","703","1170","0","60.09","40.0"
"65","000","00","002","0292","0824","583","433","150","55","638","1120","0","56.96","38.66"
"65","000","00","002","0293","0000","3604","2757","847","242","3846","7372","0","52.17","37.4"
"65","000","00","002","0293","0846","977","726","251","74","1051","1800","0","58.39","40.33"
"65","000","00","002","0293","0847","787","630","157","49","836","1703","0","49.09","36.99"
"65","000","00","002","0293","0848","922","714","208","55","977","1975","0","49.47","36.15"
"65","000","00","002","0293","0849","918","687","231","64","982","1894","0","51.85","36.27"
"65","000","00","002","0294","0000","2138","1664","474","153","2291","3957","0","57.9","42.05"
"65","000","00","002","0294","0850","770","591","179","54","824","1405","0","58.65","42.06"
"65","000","00","002","0294","0851","700","600","100","42","742","1293","0","57.39","46.4"
"65","000","00","002","0294","0852","668","473","195","57","725","1259","0","57.59","37.57"
"65","000","00","002","0295","0000","1987","1515","472","231","2218","3711","0","59.77","40.82"
"65","000","00","002","0295","0853","625","478","147","83","708","1144","0","61.89","41.78"
"65","000","00","002","0295","0854","682","527","155","85","767","1254","0","61.16","42.03"
"65","000","00","002","0295","0855","680","510","170","63","743","1313","0","56.59","38.84"
"65","000","00","002","0296","0000","1690","1293","397","156","1846","3369","0","54.79","38.38"
"65","000","00","002","0296","0856","788","596","192","86","874","1594","0","54.83","37.39"
"65","000","00","002","0296","0857","902","697","205","70","972","1775","0","54.76","39.27"
"65","000","00","002","0297","0000","1472","1110","362","197","1669","2831","0","58.95","39.21"
"65","000","00","002","0297","0858","746","562","184","103","849","1516","0","56.0","37.07"
"65","000","00","002","0297","0859","726","548","178","94","820","1315","0","62.36","41.67"
"65","000","00","002","0298","0000","1007","754","253","134","1141","2003","0","56.96","37.64"
"65","000","00","002","0298","0860","451","325","126","68","519","843","0","61.57","38.55"
"65","000","00","002","0298","0861","556","429","127","66","622","1160","0","53.62","36.98"
"65","000","00","002","0299","0000","1158","850","308","125","1283","2106","0","60.92","40.36"
"65","000","00","002","0299","0862","554","416","138","63","617","1052","0","58.65","39.54"
"65","000","00","002","0299","0863","604","434","170","62","666","1054","0","63.19","41.18"
"65","000","00","002","02A0","0000","975","709","266","113","1088","1933","0","56.29","36.68"
"65","000","00","002","02A0","0864","519","370","149","68","587","997","0","58.88","37.11"
"65","000","00","002","02A0","0865","456","339","117","45","501","936","0","53.53","36.22"
"65","000","00","002","02A1","0000","1564","1182","382","159","1723","3154","0","54.63","37.48"
"65","000","00","002","02A1","0866","827","630","197","81","908","1658","0","54.76","38.0"
"65","000","00","002","02A1","0867","737","552","185","78","815","1496","0","54.48","36.9"
"65","000","00","002","02A2","0000","1237","945","292","122","1359","2216","0","61.33","42.64"
"65","000","00","002","02A2","0868","596","453","143","59","655","1064","0","61.56","42.58"
"65","000","00","002","02A2","0869","641","492","149","63","704","1152","0","61.11","42.71"
"65","000","00","002","02A3","0000","2025","1598","427","157","2182","4173","0","52.29","38.29"
"65","000","00","002","02A3","0870","736","595","141","50","786","1532","0","51.31","38.84"
"65","000","00","002","02A3","0871","599","475","124","39","638","1338","0","47.68","35.5"
"65","000","00","002","02A3","0872","690","528","162","68","758","1303","0","58.17","40.52"
"65","000","00","002","02A4","0000","2128","1593","535","148","2276","4610","0","49.37","34.56"
"65","000","00","002","02A4","0880","619","471","148","30","649","1381","0","46.99","34.11"
"65","000","00","002","02A4","0881","761","557","204","75","836","1681","0","49.73","33.14"
"65","000","00","002","02A4","0882","748","565","183","43","791","1548","0","51.1","36.5"
"65","000","00","002","02A5","0000","2730","2063","667","226","2956","5569","0","53.08","37.04"
"65","000","00","002","02A5","0875","842","626","216","106","948","1821","0","52.06","34.38"
"65","000","00","002","02A5","0876","907","705","202","58","965","1906","0","50.63","36.99"
"65","000","00","002","02A5","0877","981","732","249","62","1043","1842","0","56.62","39.74"
"65","000","00","002","02A6","0000","1512","1149","363","177","1689","2860","0","59.06","40.17"
"65","000","00","002","02A6","0873","768","574","194","88","856","1369","0","62.53","41.93"
"65","000","00","002","02A6","0874","744","575","169","89","833","1491","0","55.87","38.56"
"65","000","00","002","02A7","0000","980","732","248","106","1086","1841","0","58.99","39.76"
"65","000","00","002","02A7","0878","425","320","105","48","473","878","0","53.87","36.45"
"65","000","00","002","02A7","0879","555","412","143","58","613","963","0","63.66","42.78"
"65","000","00","002","02A8","0000","3470","2696","774","229","3699","6784","0","54.53","39.74"
"65","000","00","002","02A8","0883","831","632","199","63","894","1542","0","57.98","40.99"
"65","000","00","002","02A8","0884","753","567","186","71","824","1557","0","52.92","36.42"
"65","000","00","002","02A8","0885","839","667","172","61","900","1661","0","54.18","40.16"
"65","000","00","002","02A8","0886","1047","830","217","34","1081","2024","0","53.41","41.01"
"65","000","00","002","02A9","0000","861","626","235","87","948","1585","0","59.81","39.5"
"65","000","00","002","02A9","0669","400","299","101","40","440","764","0","57.59","39.14"
"65","000","00","002","02A9","0670","461","327","134","47","508","821","0","61.88","39.83"
"65","000","00","002","02B0","0000","2201","1631","570","267","2468","4172","0","59.16","39.09"
"65","000","00","002","02B0","0662","743","558","185","81","824","1392","0","59.2","40.09"
"65","000","00","002","02B0","0663","780","594","186","99","879","1451","0","60.58","40.94"
"65","000","00","002","02B0","0664","678","479","199","87","765","1329","0","57.56","36.04"
"65","000","00","002","02B1","0000","1792","1394","398","97","1889","3540","0","53.36","39.38"
"65","000","00","002","02B1","0681","843","661","182","42","885","1727","0","51.24","38.27"
"65","000","00","002","02B1","0682","949","733","216","55","1004","1813","0","55.38","40.43"
"65","000","00","002","02B2","0000","1372","1020","352","156","1528","2603","0","58.7","39.19"
"65","000","00","002","02B2","0830","749","570","179","71","820","1381","0","59.38","41.27"
"65","000","00","002","02B2","0831","623","450","173","85","708","1222","0","57.94","36.82"
"65","000","00","002","02B3","0000","2571","1922","649","259","2830","5130","0","55.17","37.47"
"65","000","00","002","02B3","0825","907","669","238","97","1004","1789","0","56.12","37.4"
"65","000","00","002","02B3","0826","733","553","180","77","810","1520","0","53.29","36.38"
"65","000","00","002","02B3","0827","931","700","231","85","1016","1821","0","55.79","38.44"
"65","000","00","002","02B4","0000","2278","1763","515","183","2461","4507","0","54.6","39.12"
"65","000","00","002","02B4","0843","696","554","142","56","752","1331","0","56.5","41.62"
"65","000","00","002","02B4","0844","805","624","181","58","863","1678","0","51.43","37.19"
"65","000","00","002","02B4","0845","777","585","192","69","846","1498","0","56.48","39.05"
"65","000","00","002","02B5","0000","2528","2048","480","219","2747","5076","0","54.12","40.35"
"65","000","00","002","02B5","0834","822","660","162","83","905","1614","0","56.07","40.89"
"65","000","00","002","02B5","0835","874","729","145","57","931","1709","0","54.48","42.66"
"65","000","00","002","02B5","0836","832","659","173","79","911","1753","0","51.97","37.59"
"65","000","00","002","02B6","0000","1692","1316","376","170","1862","3039","0","61.27","43.3"
"65","000","00","002","02B6","0818","900","711","189","94","994","1501","0","66.22","47.37"
"65","000","00","002","02B6","0819","792","605","187","76","868","1538","0","56.44","39.34"
"65","000","00","002","02B7","0000","1555","1086","469","205","1760","3294","0","53.43","32.97"
"65","000","00","002","02B7","0887","717","541","176","78","795","1588","0","50.06","34.07"
"65","000","00","002","02B7","0888","838","545","293","127","965","1706","0","56.57","31.95"
"65","000","00","002","02B8","0000","1909","1472","437","169","2078","3705","0","56.09","39.73"
"65","000","00","002","02B8","0889","733","550","183","49","782","1341","0","58.31","41.01"
"65","000","00","002","02B8","0890","491","376","115","42","533","1025","0","52.0","36.68"
"65","000","00","002","02B8","0891","685","546","139","78","763","1339","0","56.98","40.78"
"65","000","00","002","02B9","0000","1768","1322","446","189","1957","3551","0","55.11","37.23"
"65","000","00","002","02B9","0892","852","628","224","107","959","1725","0","55.59","36.41"
"65","000","00","002","02B9","0893","916","694","222","82","998","1826","0","54.65","38.01"
"65","000","00","003","0000","0000","184458","146291","38167","11790","196248","355978","412545","55.13","41.1"
"65","000","00","003","0301","0000","2592","2054","538","162","2754","5249","0","52.47","39.13"
"65","000","00","003","0301","1232","778","601","177","67","845","1630","0","51.84","36.87"
"65","000","00","003","0301","1233","933","731","202","59","992","1775","0","55.89","41.18"
"65","000","00","003","0301","1234","881","722","159","36","917","1844","0","49.73","39.15"
"65","000","00","003","0302","0000","4281","3418","863","294","4575","8034","0","56.95","42.54"
"65","000","00","003","0302","1282","879","661","218","77","956","1788","0","53.47","36.97"
"65","000","00","003","0302","1283","934","752","182","62","996","1793","0","55.55","41.94"
"65","000","00","003","0302","1284","725","580","145","61","786","1352","0","58.14","42.9"
"65","000","00","003","0302","1285","968","781","187","53","1021","1813","0","56.32","43.08"
"65","000","00","003","0302","1286","775","644","131","41","816","1288","0","63.35","50.0"
"65","000","00","003","0303","0000","1958","1490","468","86","2044","3829","0","53.38","38.91"
"65","000","00","003","0303","1287","627","470","157","35","662","1186","0","55.82","39.63"
"65","000","00","003","0303","1288","607","451","156","9","616","1237","0","49.8","36.46"
"65","000","00","003","0303","1289","724","569","155","42","766","1406","0","54.48","40.47"
"65","000","00","003","0304","0000","2052","1587","465","181","2233","3774","0","59.17","42.05"
"65","000","00","003","0304","1290","729","567","162","80","809","1442","0","56.1","39.32"
"65","000","00","003","0304","1291","584","457","127","51","635","1040","0","61.06","43.94"
"65","000","00","003","0304","1292","739","563","176","50","789","1292","0","61.07","43.58"
"65","000","00","003","0305","0000","1837","1433","404","165","2002","3600","0","55.61","39.81"
"65","000","00","003","0305","1293","920","722","198","61","981","1811","0","54.17","39.87"
"65","000","00","003","0305","1294","917","711","206","104","1021","1789","0","57.07","39.74"
"65","000","00","003","0306","0000","1851","1480","371","109","1960","3177","0","61.69","46.58"
"65","000","00","003","0306","1295","537","444","93","30","567","859","0","66.01","51.69"
"65","000","00","003","0306","1296","593","506","87","33","626","972","0","64.4","52.06"
"65","000","00","003","0306","1297","721","530","191","46","767","1346","0","56.98","39.38"
"65","000","00","003","0307","0000","1299","1033","266","67","1366","2157","0","63.33","47.89"
"65","000","00","003","0307","1235","642","494","148","32","674","1019","0","66.14","48.48"
"65","000","00","003","0307","1236","657","539","118","35","692","1138","0","60.81","47.36"
"65","000","00","003","0308","0000","2945","2433","512","169","3114","5702","0","54.61","42.67"
"65","000","00","003","0308","1237","901","761","140","48","949","1878","0","50.53","40.52"
"65","000","00","003","0308","1238","1082","911","171","47","1129","1980","0","57.02","46.01"
"65","000","00","003","0308","1239","962","761","201","74","1036","1844","0","56.18","41.27"
"65","000","00","003","0309","0000","2775","2213","562","125","2900","5344","0","54.27","41.41"
"65","000","00","003","0309","1240","1095","902","193","37","1132","2085","0","54.29","43.26"
"65","000","00","003","0309","1241","779","603","176","54","833","1498","0","55.61","40.25"
"65","000","00","003","0309","1242","901","708","193","34","935","1761","0","53.09","40.2"
"65","000","00","003","0310","0000","1730","1378","352","121","1851","3294","0","56.19","41.83"
"65","000","00","003","0310","1248","893","688","205","57","950","1712","0","55.49","40.19"
"65","000","00","003","0310","1249","837","690","147","64","901","1582","0","56.95","43.62"
"65","000","00","003","0311","0000","1753","1364","389","114","1867","3235","0","57.71","42.16"
"65","000","00","003","0311","1250","888","705","183","63","951","1742","0","54.59","40.47"
"65","000","00","003","0311","1251","865","659","206","51","916","1493","0","61.35","44.14"
"65","000","00","003","0312","0000","2104","1671","433","183","2287","3990","0","57.32","41.88"
"65","000","00","003","0312","1252","661","519","142","77","738","1352","0","54.59","38.39"
"65","000","00","003","0312","1253","691","560","131","42","733","1244","0","58.92","45.02"
"65","000","00","003","0312","1254","752","592","160","64","816","1394","0","58.54","42.47"
"65","000","00","003","0313","0000","1682","1325","357","111","1793","3747","0","47.85","35.36"
"65","000","00","003","0313","1255","814","661","153","27","841","1917","0","43.87","34.48"
"65","000","00","003","0313","1256","868","664","204","84","952","1830","0","52.02","36.28"
"65","000","00","003","0314","0000","1960","1504","456","140","2100","3892","0","53.96","38.64"
"65","000","00","003","0314","1257","616","476","140","46","662","1124","0","58.9","42.35"
"65","000","00","003","0314","1258","658","497","161","38","696","1412","0","49.29","35.2"
"65","000","00","003","0314","1259","686","531","155","56","742","1356","0","54.72","39.16"
"65","000","00","003","0315","0000","2041","1571","470","196","2237","3940","0","56.78","39.87"
"65","000","00","003","0315","1260","703","547","156","49","752","1425","0","52.77","38.39"
"65","000","00","003","0315","1261","679","519","160","78","757","1259","0","60.13","41.22"
"65","000","00","003","0315","1262","659","505","154","69","728","1256","0","57.96","40.21"
"65","000","00","003","0316","0000","2300","1838","462","158","2458","4502","0","54.6","40.83"
"65","000","00","003","0316","1263","763","594","169","44","807","1423","0","56.71","41.74"
"65","000","00","003","0316","1264","649","524","125","58","707","1221","0","57.9","42.92"
"65","000","00","003","0316","1265","888","720","168","56","944","1858","0","50.81","38.75"
"65","000","00","003","0317","0000","2586","2045","541","127","2713","4958","0","54.72","41.25"
"65","000","00","003","0317","1266","877","688","189","53","930","1804","0","51.55","38.14"
"65","000","00","003","0317","1267","916","723","193","31","947","1669","0","56.74","43.32"
"65","000","00","003","0317","1268","793","634","159","43","836","1485","0","56.3","42.69"
"65","000","00","003","0318","0000","1908","1501","407","149","2057","3351","0","61.38","44.79"
"65","000","00","003","0318","1269","558","438","120","49","607","1005","0","60.4","43.58"
"65","000","00","003","0318","1270","702","547","155","59","761","1175","0","64.77","46.55"
"65","000","00","003","0318","1271","648","516","132","41","689","1171","0","58.84","44.06"
"65","000","00","003","0319","0000","2127","1682","445","134","2261","4413","0","51.23","38.11"
"65","000","00","003","0319","1272","819","655","164","34","853","1746","0","48.85","37.51"
"65","000","00","003","0319","1273","733","574","159","43","776","1555","0","49.9","36.91"
"65","000","00","003","0319","1274","575","453","122","57","632","1112","0","56.83","40.74"
"65","000","00","003","0320","0000","1680","1305","375","85","1765","3286","0","53.71","39.71"
"65","000","00","003","0320","1434","746","582","164","51","797","1462","0","54.51","39.81"
"65","000","00","003","0320","1435","934","723","211","34","968","1824","0","53.07","39.64"
"65","000","00","003","0321","0000","1502","1180","322","110","1612","2823","0","57.1","41.8"
"65","000","00","003","0321","1436","699","546","153","70","769","1389","0","55.36","39.31"
"65","000","00","003","0321","1437","803","634","169","40","843","1434","0","58.79","44.21"
"65","000","00","003","0322","0000","2757","2243","514","127","2884","5350","0","53.91","41.93"
"65","000","00","003","0322","1440","926","756","170","36","962","1858","0","51.78","40.69"
"65","000","00","003","0322","1441","923","755","168","34","957","1801","0","53.14","41.92"
"65","000","00","003","0322","1442","908","732","176","57","965","1691","0","57.07","43.29"
"65","000","00","003","0323","0000","2288","1868","420","106","2394","3948","0","60.64","47.32"
"65","000","00","003","0323","1443","757","606","151","51","808","1363","0","59.28","44.46"
"65","000","00","003","0323","1444","725","602","123","26","751","1220","0","61.56","49.34"
"65","000","00","003","0323","1445","806","660","146","29","835","1365","0","61.17","48.35"
"65","000","00","003","0324","0000","1689","1335","354","114","1803","3205","0","56.26","41.65"
"65","000","00","003","0324","1446","638","518","120","27","665","1178","0","56.45","43.97"
"65","000","00","003","0324","1447","468","360","108","36","504","830","0","60.72","43.37"
"65","000","00","003","0324","1448","583","457","126","51","634","1197","0","52.97","38.18"
"65","000","00","003","0325","0000","3695","2950","745","150","3845","7168","0","53.64","41.16"
"65","000","00","003","0325","1275","1004","794","210","47","1051","1780","0","59.04","44.61"
"65","000","00","003","0325","1276","997","806","191","34","1031","1918","0","53.75","42.02"
"65","000","00","003","0325","1277","725","575","150","37","762","1689","0","45.12","34.04"
"65","000","00","003","0325","1278","969","775","194","32","1001","1781","0","56.2","43.51"
"65","000","00","003","0326","0000","2507","1969","538","141","2648","4567","0","57.98","43.11"
"65","000","00","003","0326","1279","742","570","172","55","797","1419","0","56.17","40.17"
"65","000","00","003","0326","1280","690","548","142","37","727","1344","0","54.09","40.77"
"65","000","00","003","0326","1281","1075","851","224","49","1124","1804","0","62.31","47.17"
"65","000","00","003","0327","0000","2300","1850","450","161","2461","4082","0","60.29","45.32"
"65","000","00","003","0327","1449","747","580","167","54","801","1369","0","58.51","42.37"
"65","000","00","003","0327","1450","748","612","136","50","798","1336","0","59.73","45.81"
"65","000","00","003","0327","1451","805","658","147","57","862","1377","0","62.6","47.79"
"65","000","00","003","0328","0000","1754","1426","328","107","1861","3188","0","58.38","44.73"
"65","000","00","003","0328","1452","821","659","162","62","883","1499","0","58.91","43.96"
"65","000","00","003","0328","1453","933","767","166","45","978","1689","0","57.9","45.41"
"65","000","00","003","0329","0000","2258","1841","417","163","2421","4314","0","56.12","42.68"
"65","000","00","003","0329","1456","834","659","175","67","901","1545","0","58.32","42.65"
"65","000","00","003","0329","1457","679","590","89","60","739","1326","0","55.73","44.49"
"65","000","00","003","0329","1458","745","592","153","36","781","1443","0","54.12","41.03"
"65","000","00","003","0330","0000","3116","2482","634","140","3256","5694","0","57.18","43.59"
"65","000","00","003","0330","1459","907","730","177","30","937","1712","0","54.73","42.64"
"65","000","00","003","0330","1460","987","785","202","55","1042","1916","0","54.38","40.97"
"65","000","00","003","0330","1461","500","384","116","41","541","863","0","62.69","44.5"
"65","000","00","003","0330","1462","722","583","139","14","736","1203","0","61.18","48.46"
"65","000","00","003","0331","0000","2248","1861","387","107","2355","4490","0","52.45","41.45"
"65","000","00","003","0331","1463","774","646","128","17","791","1483","0","53.34","43.56"
"65","000","00","003","0331","1464","805","682","123","33","838","1575","0","53.21","43.3"
"65","000","00","003","0331","1465","669","533","136","57","726","1432","0","50.7","37.22"
"65","000","00","003","0332","0000","2243","1863","380","140","2383","4073","0","58.51","45.74"
"65","000","00","003","0332","1466","754","620","134","58","812","1441","0","56.35","43.03"
"65","000","00","003","0332","1467","709","573","136","51","760","1269","0","59.89","45.15"
"65","000","00","003","0332","1468","780","670","110","31","811","1363","0","59.5","49.16"
"65","000","00","003","0333","0000","1576","1270","306","86","1662","2973","0","55.9","42.72"
"65","000","00","003","0333","1474","777","625","152","45","822","1526","0","53.87","40.96"
"65","000","00","003","0333","1475","799","645","154","41","840","1447","0","58.05","44.57"
"65","000","00","003","0334","0000","1505","1209","296","109","1614","2757","0","58.54","43.85"
"65","000","00","003","0334","1305","698","560","138","47","745","1319","0","56.48","42.46"
"65","000","00","003","0334","1306","807","649","158","62","869","1438","0","60.43","45.13"
"65","000","00","003","0335","0000","3168","2599","569","158","3326","6396","0","52.0","40.63"
"65","000","00","003","0335","1307","886","729","157","31","917","1808","0","50.72","40.32"
"65","000","00","003","0335","1308","587","498","89","22","609","1191","0","51.13","41.81"
"65","000","00","003","0335","1309","835","667","168","64","899","1632","0","55.09","40.87"
"65","000","00","003","0335","1310","860","705","155","41","901","1765","0","51.05","39.94"
"65","000","00","003","0336","0000","2209","1880","329","114","2323","3909","0","59.43","48.09"
"65","000","00","003","0336","1311","675","581","94","28","703","1168","0","60.19","49.74"
"65","000","00","003","0336","1312","606","506","100","31","637","1176","0","54.17","43.03"
"65","000","00","003","0336","1313","928","793","135","55","983","1565","0","62.81","50.67"
"65","000","00","003","0337","0000","2282","1852","430","122","2404","4512","0","53.28","41.05"
"65","000","00","003","0337","1314","763","597","166","47","810","1578","0","51.33","37.83"
"65","000","00","003","0337","1315","1030","865","165","43","1073","2029","0","52.88","42.63"
"65","000","00","003","0337","1316","489","390","99","32","521","905","0","57.57","43.09"
"65","000","00","003","0338","0000","2189","1716","473","186","2375","4293","0","55.32","39.97"
"65","000","00","003","0338","1317","406","302","104","37","443","839","0","52.8","36.0"
"65","000","00","003","0338","1318","410","312","98","28","438","762","0","57.48","40.94"
"65","000","00","003","0338","1319","735","590","145","66","801","1420","0","56.41","41.55"
"65","000","00","003","0338","1320","638","512","126","55","693","1272","0","54.48","40.25"
"65","000","00","003","0339","0000","1885","1537","348","120","2005","3755","0","53.4","40.93"
"65","000","00","003","0339","1321","976","774","202","72","1048","1976","0","53.04","39.17"
"65","000","00","003","0339","1322","909","763","146","48","957","1779","0","53.79","42.89"
"65","000","00","003","0340","0000","1412","1166","246","109","1521","2870","0","53.0","40.63"
"65","000","00","003","0340","1325","649","561","88","45","694","1369","0","50.69","40.98"
"65","000","00","003","0340","1326","763","605","158","64","827","1501","0","55.1","40.31"
"65","000","00","003","0341","0000","179","145","34","19","198","321","0","61.68","45.17"
"65","000","00","003","0341","1329","179","145","34","19","198","321","0","61.68","45.17"
"65","000","00","003","0342","0000","2291","1872","419","188","2479","4556","0","54.41","41.09"
"65","000","00","003","0342","1330","720","603","117","62","782","1474","0","53.05","40.91"
"65","000","00","003","0342","1331","770","616","154","68","838","1461","0","57.36","42.16"
"65","000","00","003","0342","1332","801","653","148","58","859","1621","0","52.99","40.28"
"65","000","00","003","0343","0000","1166","877","289","101","1267","2102","0","60.28","41.72"
"65","000","00","003","0343","1333","753","565","188","68","821","1327","0","61.87","42.58"
"65","000","00","003","0343","1334","413","312","101","33","446","775","0","57.55","40.26"
"65","000","00","003","0344","0000","1942","1506","436","127","2069","6749","0","30.66","22.31"
"65","000","00","003","0344","1337","709","554","155","44","753","4411","0","17.07","12.56"
"65","000","00","003","0344","1338","626","484","142","41","667","1212","0","55.03","39.93"
"65","000","00","003","0344","1339","607","468","139","42","649","1126","0","57.64","41.56"
"65","000","00","003","0345","0000","2116","1666","450","95","2211","4522","0","48.89","36.84"
"65","000","00","003","0345","1346","708","559","149","35","743","1627","0","45.67","34.36"
"65","000","00","003","0345","1347","724","562","162","39","763","1503","0","50.77","37.39"
"65","000","00","003","0345","1348","684","545","139","21","705","1392","0","50.65","39.15"
"65","000","00","003","0346","0000","2097","1686","411","107","2204","3898","0","56.54","43.25"
"65","000","00","003","0346","1349","602","499","103","36","638","1067","0","59.79","46.77"
"65","000","00","003","0346","1350","808","632","176","50","858","1623","0","52.87","38.94"
"65","000","00","003","0346","1351","687","555","132","21","708","1208","0","58.61","45.94"
"65","000","00","003","0347","0000","2277","1836","441","131","2408","4870","0","49.45","37.7"
"65","000","00","003","0347","1352","840","670","170","50","890","1991","0","44.7","33.65"
"65","000","00","003","0347","1353","850","698","152","46","896","1932","0","46.38","36.13"
"65","000","00","003","0347","1354","587","468","119","35","622","947","0","65.68","49.42"
"65","000","00","003","0348","0000","1613","1287","326","124","1737","3234","0","53.71","39.8"
"65","000","00","003","0348","1355","894","707","187","58","952","1660","0","57.35","42.59"
"65","000","00","003","0348","1356","719","580","139","66","785","1574","0","49.87","36.85"
"65","000","00","003","0349","0000","2446","1931","515","204","2650","5146","0","51.5","37.52"
"65","000","00","003","0349","1357","1005","800","205","57","1062","2136","0","49.72","37.45"
"65","000","00","003","0349","1358","704","538","166","76","780","1462","0","53.35","36.8"
"65","000","00","003","0349","1359","737","593","144","71","808","1548","0","52.2","38.31"
"65","000","00","003","0350","0000","2456","1949","507","165","2621","4228","0","61.99","46.1"
"65","000","00","003","0350","1360","435","349","86","22","457","692","0","66.04","50.43"
"65","000","00","003","0350","1361","721","604","117","49","770","1221","0","63.06","49.47"
"65","000","00","003","0350","1362","738","552","186","53","791","1331","0","59.43","41.47"
"65","000","00","003","0350","1363","562","444","118","41","603","984","0","61.28","45.12"
"65","000","00","003","0351","0000","1534","1232","302","87","1621","3150","0","51.46","39.11"
"65","000","00","003","0351","1364","894","720","174","51","945","1871","0","50.51","38.48"
"65","000","00","003","0351","1365","640","512","128","36","676","1279","0","52.85","40.03"
"65","000","00","003","0352","0000","2617","2046","571","144","2761","4826","0","57.21","42.4"
"65","000","00","003","0352","1366","878","679","199","44","922","1629","0","56.6","41.68"
"65","000","00","003","0352","1367","805","638","167","36","841","1482","0","56.75","43.05"
"65","000","00","003","0352","1368","934","729","205","64","998","1715","0","58.19","42.51"
"65","000","00","003","0353","0000","1024","835","189","65","1089","1952","0","55.79","42.78"
"65","000","00","003","0353","1369","1024","835","189","65","1089","1952","0","55.79","42.78"
"65","000","00","003","0354","0000","366","277","89","34","400","686","0","58.31","40.38"
"65","000","00","003","0354","1370","366","277","89","34","400","686","0","58.31","40.38"
"65","000","00","003","0355","0000","3997","3188","809","177","4174","7264","0","57.46","43.89"
"65","000","00","003","0355","1371","723","549","174","32","755","1577","0","47.88","34.81"
"65","000","00","003","0355","1372","647","496","151","32","679","1158","0","58.64","42.83"
"65","000","00","003","0355","1373","717","589","128","22","739","1195","0","61.84","49.29"
"65","000","00","003","0355","1374","640","516","124","34","674","1054","0","63.95","48.96"
"65","000","00","003","0355","1375","370","296","74","21","391","612","0","63.89","48.37"
"65","000","00","003","0355","1376","900","742","158","36","936","1668","0","56.12","44.48"
"65","000","00","003","0356","0000","1346","1034","312","131","1477","2240","0","65.94","46.16"
"65","000","00","003","0356","1377","608","454","154","72","680","1071","0","63.49","42.39"
"65","000","00","003","0356","1378","738","580","158","59","797","1169","0","68.18","49.62"
"65","000","00","003","0357","0000","2666","2089","577","170","2836","5558","0","51.03","37.59"
"65","000","00","003","0357","1379","683","525","158","49","732","1370","0","53.43","38.32"
"65","000","00","003","0357","1380","858","672","186","89","947","1574","0","60.17","42.69"
"65","000","00","003","0357","1381","1125","892","233","32","1157","2614","0","44.26","34.12"
"65","000","00","003","0358","0000","1377","1040","337","99","1476","2518","0","58.62","41.3"
"65","000","00","003","0358","1382","825","646","179","40","865","1477","0","58.56","43.74"
"65","000","00","003","0358","1383","552","394","158","59","611","1041","0","58.69","37.85"
"65","000","00","003","0359","0000","2384","1832","552","194","2578","4723","0","54.58","38.79"
"65","000","00","003","0359","1384","726","563","163","62","788","1538","0","51.24","36.61"
"65","000","00","003","0359","1385","793","600","193","53","846","1599","0","52.91","37.52"
"65","000","00","003","0359","1386","865","669","196","79","944","1586","0","59.52","42.18"
"65","000","00","003","0360","0000","1963","1467","496","182","2145","3580","0","59.92","40.98"
"65","000","00","003","0360","1387","922","676","246","97","1019","1726","0","59.04","39.17"
"65","000","00","003","0360","1388","1041","791","250","85","1126","1854","0","60.73","42.66"
"65","000","00","003","0361","0000","2473","1909","564","184","2657","4390","0","60.52","43.49"
"65","000","00","003","0361","1389","834","627","207","60","894","1472","0","60.73","42.6"
"65","000","00","003","0361","1390","803","631","172","67","870","1430","0","60.84","44.13"
"65","000","00","003","0361","1391","836","651","185","57","893","1488","0","60.01","43.75"
"65","000","00","003","0362","0000","2117","1625","492","174","2291","4066","0","56.35","39.97"
"65","000","00","003","0362","1392","653","499","154","29","682","1251","0","54.52","39.89"
"65","000","00","003","0362","1393","818","650","168","47","865","1487","0","58.17","43.71"
"65","000","00","003","0362","1394","646","476","170","98","744","1328","0","56.02","35.84"
"65","000","00","003","0363","0000","1273","1010","263","80","1353","2136","0","63.34","47.28"
"65","000","00","003","0363","1395","645","505","140","52","697","1128","0","61.79","44.77"
"65","000","00","003","0363","1396","628","505","123","28","656","1008","0","65.08","50.1"
"65","000","00","003","0364","0000","2100","1648","452","88","2188","4005","0","54.63","41.15"
"65","000","00","003","0364","1397","976","763","213","33","1009","1786","0","56.49","42.72"
"65","000","00","003","0364","1398","1124","885","239","55","1179","2219","0","53.13","39.88"
"65","000","00","003","0365","0000","1470","1160","310","63","1533","2817","0","54.42","41.18"
"65","000","00","003","0365","1399","628","458","170","37","665","1322","0","50.3","34.64"
"65","000","00","003","0365","1400","842","702","140","26","868","1495","0","58.06","46.96"
"65","000","00","003","0366","0000","2287","1760","527","192","2479","4456","0","55.63","39.5"
"65","000","00","003","0366","1401","704","550","154","57","761","1414","0","53.82","38.9"
"65","000","00","003","0366","1402","891","675","216","76","967","1681","0","57.53","40.15"
"65","000","00","003","0366","1403","692","535","157","59","751","1361","0","55.18","39.31"
"65","000","00","003","0367","0000","2106","1631","475","121","2227","4089","0","54.46","39.89"
"65","000","00","003","0367","1404","744","574","170","58","802","1442","0","55.62","39.81"
"65","000","00","003","0367","1405","690","527","163","24","714","1383","0","51.63","38.11"
"65","000","00","003","0367","1406","672","530","142","39","711","1264","0","56.25","41.93"
"65","000","00","003","0368","0000","1862","1436","426","152","2014","3761","0","53.55","38.18"
"65","000","00","003","0368","1407","957","731","226","105","1062","1810","0","58.67","40.39"
"65","000","00","003","0368","1408","905","705","200","47","952","1951","0","48.8","36.14"
"65","000","00","003","0369","0000","1788","1418","370","139","1927","3527","0","54.64","40.2"
"65","000","00","003","0369","1409","724","591","133","51","775","1582","0","48.99","37.36"
"65","000","00","003","0369","1410","1064","827","237","88","1152","1945","0","59.23","42.52"
"65","000","00","003","0370","0000","2143","1752","391","101","2244","3950","0","56.81","44.35"
"65","000","00","003","0370","1411","757","605","152","47","804","1390","0","57.84","43.53"
"65","000","00","003","0370","1412","632","490","142","23","655","1161","0","56.42","42.2"
"65","000","00","003","0370","1413","754","657","97","31","785","1399","0","56.11","46.96"
"65","000","00","003","0371","0000","1845","1455","390","125","1970","3453","0","57.05","42.14"
"65","000","00","003","0371","1414","554","430","124","28","582","1070","0","54.39","40.19"
"65","000","00","003","0371","1415","590","463","127","33","623","1169","0","53.29","39.61"
"65","000","00","003","0371","1416","701","562","139","64","765","1214","0","63.01","46.29"
"65","000","00","003","0372","0000","1924","1552","372","127","2051","3371","0","60.84","46.04"
"65","000","00","003","0372","1471","605","486","119","40","645","1150","0","56.09","42.26"
"65","000","00","003","0372","1472","702","549","153","47","749","1154","0","64.9","47.57"
"65","000","00","003","0372","1473","617","517","100","40","657","1067","0","61.57","48.45"
"65","000","00","003","0373","0000","2885","2163","722","116","3001","5742","0","52.26","37.67"
"65","000","00","003","0373","1245","928","736","192","37","965","1789","0","53.94","41.14"
"65","000","00","003","0373","1246","1059","855","204","35","1094","2000","0","54.7","42.75"
"65","000","00","003","0373","1247","898","572","326","44","942","1953","0","48.23","29.29"
"65","000","00","003","0374","0000","915","742","173","50","965","1712","0","56.37","43.34"
"65","000","00","003","0374","1433","915","742","173","50","965","1712","0","56.37","43.34"
"65","000","00","003","0375","0000","2043","1626","417","122","2165","3955","0","54.74","41.11"
"65","000","00","003","0375","1438","975","788","187","61","1036","1953","0","53.05","40.35"
"65","000","00","003","0375","1439","1068","838","230","61","1129","2002","0","56.39","41.86"
"65","000","00","003","0376","0000","1386","1091","295","103","1489","2402","0","61.99","45.42"
"65","000","00","003","0376","1454","758","599","159","54","812","1323","0","61.38","45.28"
"65","000","00","003","0376","1455","628","492","136","49","677","1079","0","62.74","45.6"
"65","000","00","003","0377","0000","1167","943","224","62","1229","2260","0","54.38","41.73"
"65","000","00","003","0377","1469","595","507","88","29","624","1089","0","57.3","46.56"
"65","000","00","003","0377","1470","572","436","136","33","605","1171","0","51.67","37.23"
"65","000","00","003","0378","0000","1315","1067","248","90","1405","2828","0","49.68","37.73"
"65","000","00","003","0378","1323","651","504","147","51","702","1454","0","48.28","34.66"
"65","000","00","003","0378","1324","664","563","101","39","703","1374","0","51.16","40.98"
"65","000","00","003","0379","0000","1133","896","237","117","1250","1970","0","63.45","45.48"
"65","000","00","003","0379","1327","543","429","114","56","599","920","0","65.11","46.63"
"65","000","00","003","0379","1328","590","467","123","61","651","1050","0","62.0","44.48"
"65","000","00","003","0380","0000","1832","1474","358","110","1942","3817","0","50.88","38.62"
"65","000","00","003","0380","1335","915","723","192","41","956","1916","0","49.9","37.73"
"65","000","00","003","0380","1336","917","751","166","69","986","1901","0","51.87","39.51"
"65","000","00","003","0381","0000","3141","2494","647","172","3313","5946","0","55.72","41.94"
"65","000","00","003","0381","1340","748","593","155","27","775","1507","0","51.43","39.35"
"65","000","00","003","0381","1341","790","646","144","27","817","1519","0","53.79","42.53"
"65","000","00","003","0381","1342","791","624","167","46","837","1467","0","57.06","42.54"
"65","000","00","003","0381","1343","812","631","181","72","884","1453","0","60.84","43.43"
"65","000","00","003","0382","0000","1450","1174","276","100","1550","2666","0","58.14","44.04"
"65","000","00","003","0382","1344","768","619","149","53","821","1364","0","60.19","45.38"
"65","000","00","003","0382","1345","682","555","127","47","729","1302","0","55.99","42.63"
"65","000","00","003","0383","0000","1305","1028","277","92","1397","2421","0","57.7","42.46"
"65","000","00","003","0383","1298","563","428","135","38","601","1034","0","58.12","41.39"
"65","000","00","003","0383","1299","742","600","142","54","796","1387","0","57.39","43.26"
"65","000","00","003","0384","0000","1934","1526","408","142","2076","3737","0","55.55","40.83"
"65","000","00","003","0384","1300","1086","858","228","88","1174","2067","0","56.8","41.51"
"65","000","00","003","0384","1301","848","668","180","54","902","1670","0","54.01","40.0"
"65","000","00","003","0385","0000","2106","1689","417","137","2243","3771","0","59.48","44.79"
"65","000","00","003","0385","1417","777","643","134","57","834","1398","0","59.66","45.99"
"65","000","00","003","0385","1418","564","436","128","37","601","1049","0","57.29","41.56"
"65","000","00","003","0385","1419","765","610","155","43","808","1324","0","61.03","46.07"
"65","000","00","003","0386","0000","1597","1274","323","92","1689","3474","0","48.62","36.67"
"65","000","00","003","0386","1420","780","619","161","36","816","1765","0","46.23","35.07"
"65","000","00","003","0386","1421","817","655","162","56","873","1709","0","51.08","38.33"
"65","000","00","003","0387","0000","1353","1035","318","113","1466","2504","0","58.55","41.33"
"65","000","00","003","0387","1422","634","486","148","62","696","1186","0","58.68","40.98"
"65","000","00","003","0387","1423","719","549","170","51","770","1318","0","58.42","41.65"
"65","000","00","003","0388","0000","1443","1105","338","116","1559","3067","0","50.83","36.03"
"65","000","00","003","0388","1424","775","586","189","55","830","1430","0","58.04","40.98"
"65","000","00","003","0388","1425","668","519","149","61","729","1637","0","44.53","31.7"
"65","000","00","003","0389","0000","2077","1595","482","141","2218","3894","0","56.96","40.96"
"65","000","00","003","0389","1426","667","498","169","50","717","1283","0","55.88","38.82"
"65","000","00","003","0389","1427","700","543","157","39","739","1310","0","56.41","41.45"
"65","000","00","003","0389","1428","710","554","156","52","762","1301","0","58.57","42.58"
"65","000","00","003","0390","0000","1634","1309","325","112","1746","3065","0","56.97","42.71"
"65","000","00","003","0390","1429","896","717","179","69","965","1681","0","57.41","42.65"
"65","000","00","003","0390","1430","738","592","146","43","781","1384","0","56.43","42.77"
"65","000","00","003","0391","0000","1400","1083","317","64","1464","2966","0","49.36","36.51"
"65","000","00","003","0391","1431","626","481","145","57","683","1187","0","57.54","40.52"
"65","000","00","003","0391","1432","774","602","172","7","781","1779","0","43.9","33.84"
"65","000","00","003","0392","0000","1658","1311","347","137","1795","3199","0","56.11","40.98"
"65","000","00","003","0392","1302","611","481","130","51","662","1166","0","56.78","41.25"
"65","000","00","003","0392","1303","525","417","108","49","574","963","0","59.61","43.3"
"65","000","00","003","0392","1304","522","413","109","37","559","1070","0","52.24","38.6"
"65","000","00","003","0393","0000","1395","1093","302","66","1461","2597","0","56.26","42.09"
"65","000","00","003","0393","1243","650","486","164","27","677","1254","0","53.99","38.76"
"65","000","00","003","0393","1244","745","607","138","39","784","1343","0","58.38","45.2"
"65","000","00","004","0000","0000","103814","82910","20904","6214","110028","187798","221123","58.59","44.15"
"65","000","00","004","0401","0000","1534","1223","311","92","1626","3012","0","53.98","40.6"
"65","000","00","004","0401","1486","770","607","163","53","823","1568","0","52.49","38.71"
"65","000","00","004","0401","1487","764","616","148","39","803","1444","0","55.61","42.66"
"65","000","00","004","0402","0000","1402","1160","242","63","1465","2535","0","57.79","45.76"
"65","000","00","004","0402","1601","699","591","108","28","727","1189","0","61.14","49.71"
"65","000","00","004","0402","1602","703","569","134","35","738","1346","0","54.83","42.27"
"65","000","00","004","0403","0000","1522","1220","302","82","1604","4440","0","36.13","27.48"
"65","000","00","004","0403","1495","716","575","141","50","766","1598","0","47.93","35.98"
"65","000","00","004","0403","1496","806","645","161","32","838","2842","0","29.49","22.7"
"65","000","00","004","0404","0000","1618","1259","359","96","1714","2710","0","63.25","46.46"
"65","000","00","004","0404","1497","739","567","172","49","788","1261","0","62.49","44.96"
"65","000","00","004","0404","1498","879","692","187","47","926","1449","0","63.91","47.76"
"65","000","00","004","0405","0000","1412","1114","298","85","1497","2418","0","61.91","46.07"
"65","000","00","004","0405","1599","674","529","145","42","716","1155","0","61.99","45.8"
"65","000","00","004","0405","1600","738","585","153","43","781","1263","0","61.84","46.32"
"65","000","00","004","0406","0000","1689","1310","379","63","1752","3034","0","57.75","43.18"
"65","000","00","004","0406","1505","863","674","189","28","891","1566","0","56.9","43.04"
"65","000","00","004","0406","1506","826","636","190","35","861","1468","0","58.65","43.32"
"65","000","00","004","0407","0000","1521","1221","300","81","1602","2486","0","64.44","49.12"
"65","000","00","004","0407","1507","856","700","156","41","897","1305","0","68.74","53.64"
"65","000","00","004","0407","1508","665","521","144","40","705","1181","0","59.7","44.12"
"65","000","00","004","0408","0000","1363","1115","248","121","1484","2537","0","58.49","43.95"
"65","000","00","004","0408","1543","652","541","111","70","722","1234","0","58.51","43.84"
"65","000","00","004","0408","1544","711","574","137","51","762","1303","0","58.48","44.05"
"65","000","00","004","0409","0000","378","303","75","31","409","893","0","45.8","33.93"
"65","000","00","004","0409","1597","378","303","75","31","409","893","0","45.8","33.93"
"65","000","00","004","0410","0000","402","332","70","34","436","743","0","58.68","44.68"
"65","000","00","004","0410","1598","402","332","70","34","436","743","0","58.68","44.68"
"65","000","00","004","0411","0000","2237","1793","444","148","2385","4189","0","56.93","42.8"
"65","000","00","004","0411","1514","792","627","165","63","855","1488","0","57.46","42.14"
"65","000","00","004","0411","1515","744","592","152","51","795","1288","0","61.72","45.96"
"65","000","00","004","0411","1516","701","574","127","34","735","1413","0","52.02","40.62"
"65","000","00","004","0412","0000","1767","1378","389","133","1900","3289","0","57.77","41.9"
"65","000","00","004","0412","1527","935","739","196","62","997","1798","0","55.45","41.1"
"65","000","00","004","0412","1528","832","639","193","71","903","1491","0","60.56","42.86"
"65","000","00","004","0413","0000","3568","2865","703","212","3780","6230","0","60.67","45.99"
"65","000","00","004","0413","1582","857","680","177","60","917","1598","0","57.38","42.55"
"65","000","00","004","0413","1583","917","736","181","58","975","1609","0","60.6","45.74"
"65","000","00","004","0413","1584","811","635","176","40","851","1375","0","61.89","46.18"
"65","000","00","004","0413","1585","983","814","169","54","1037","1648","0","62.92","49.39"
"65","000","00","004","0414","0000","2401","1885","516","135","2536","4535","0","55.92","41.57"
"65","000","00","004","0414","1579","851","670","181","48","899","1586","0","56.68","42.24"
"65","000","00","004","0414","1580","681","544","137","20","701","1313","0","53.39","41.43"
"65","000","00","004","0414","1581","869","671","198","67","936","1636","0","57.21","41.01"
"65","000","00","004","0415","0000","2167","1733","434","116","2283","3628","0","62.93","47.77"
"65","000","00","004","0415","1558","701","562","139","36","737","1209","0","60.96","46.48"
"65","000","00","004","0415","1559","678","537","141","31","709","1132","0","62.63","47.44"
"65","000","00","004","0415","1560","788","634","154","49","837","1287","0","65.03","49.26"
"65","000","00","004","0416","0000","2374","1945","429","123","2497","4081","0","61.19","47.66"
"65","000","00","004","0416","1520","700","589","111","42","742","1100","0","67.45","53.55"
"65","000","00","004","0416","1521","902","730","172","52","954","1545","0","61.75","47.25"
"65","000","00","004","0416","1522","772","626","146","29","801","1436","0","55.78","43.59"
"65","000","00","004","0417","0000","2186","1771","415","137","2323","3877","0","59.92","45.68"
"65","000","00","004","0417","1517","717","597","120","55","772","1329","0","58.09","44.92"
"65","000","00","004","0417","1518","853","695","158","34","887","1436","0","61.77","48.4"
"65","000","00","004","0417","1519","616","479","137","48","664","1112","0","59.71","43.08"
"65","000","00","004","0418","0000","1478","1159","319","108","1586","2704","0","58.65","42.86"
"65","000","00","004","0418","1489","686","548","138","49","735","1188","0","61.87","46.13"
"65","000","00","004","0418","1490","792","611","181","59","851","1516","0","56.13","40.3"
"65","000","00","004","0419","0000","572","422","150","51","623","1140","0","54.65","37.02"
"65","000","00","004","0419","1488","572","422","150","51","623","1140","0","54.65","37.02"
"65","000","00","004","0420","0000","2024","1613","411","133","2157","3493","0","61.75","46.18"
"65","000","00","004","0420","1523","1011","831","180","61","1072","1731","0","61.93","48.01"
"65","000","00","004","0420","1524","1013","782","231","72","1085","1762","0","61.58","44.38"
"65","000","00","004","0421","0000","1296","1011","285","69","1365","2617","0","52.16","38.63"
"65","000","00","004","0421","1525","694","533","161","47","741","1320","0","56.14","40.38"
"65","000","00","004","0421","1526","602","478","124","22","624","1297","0","48.11","36.85"
"65","000","00","004","0422","0000","961","736","225","59","1020","1783","0","57.21","41.28"
"65","000","00","004","0422","1606","456","364","92","23","479","879","0","54.49","41.41"
"65","000","00","004","0422","1607","505","372","133","36","541","904","0","59.85","41.15"
"65","000","00","004","0423","0000","1773","1445","328","95","1868","3314","0","56.37","43.6"
"65","000","00","004","0423","1480","934","755","179","40","974","1733","0","56.2","43.57"
"65","000","00","004","0423","1481","839","690","149","55","894","1581","0","56.55","43.64"
"65","000","00","004","0424","0000","1986","1603","383","124","2110","3452","0","61.12","46.44"
"65","000","00","004","0424","1568","1060","869","191","52","1112","1876","0","59.28","46.32"
"65","000","00","004","0424","1569","926","734","192","72","998","1576","0","63.32","46.57"
"65","000","00","004","0425","0000","1930","1655","275","72","2002","3469","0","57.71","47.71"
"65","000","00","004","0425","1570","950","858","92","44","994","1661","0","59.84","51.66"
"65","000","00","004","0425","1571","980","797","183","28","1008","1808","0","55.75","44.08"
"65","000","00","004","0426","0000","2077","1645","432","170","2247","3547","0","63.35","46.38"
"65","000","00","004","0426","1563","711","587","124","49","760","1222","0","62.19","48.04"
"65","000","00","004","0426","1564","648","510","138","64","712","1157","0","61.54","44.08"
"65","000","00","004","0426","1565","718","548","170","57","775","1168","0","66.35","46.92"
"65","000","00","004","0427","0000","1445","1132","313","99","1544","2655","0","58.15","42.64"
"65","000","00","004","0427","1566","693","531","162","56","749","1283","0","58.38","41.39"
"65","000","00","004","0427","1567","752","601","151","43","795","1372","0","57.94","43.8"
"65","000","00","004","0428","0000","1637","1299","338","84","1721","2979","0","57.77","43.61"
"65","000","00","004","0428","1610","827","654","173","35","862","1551","0","55.58","42.17"
"65","000","00","004","0428","1611","810","645","165","49","859","1428","0","60.15","45.17"
"65","000","00","004","0429","0000","1296","1048","248","103","1399","2239","0","62.48","46.81"
"65","000","00","004","0429","1608","716","581","135","55","771","1221","0","63.14","47.58"
"65","000","00","004","0429","1609","580","467","113","48","628","1018","0","61.69","45.87"
"65","000","00","004","0430","0000","2219","1800","419","73","2292","3932","0","58.29","45.78"
"65","000","00","004","0430","1551","697","560","137","23","720","1210","0","59.5","46.28"
"65","000","00","004","0430","1552","898","732","166","28","926","1630","0","56.81","44.91"
"65","000","00","004","0430","1553","624","508","116","22","646","1092","0","59.16","46.52"
"65","000","00","004","0431","0000","2437","1953","484","128","2565","4196","0","61.13","46.54"
"65","000","00","004","0431","1547","588","460","128","31","619","991","0","62.46","46.42"
"65","000","00","004","0431","1548","598","481","117","35","633","1016","0","62.3","47.34"
"65","000","00","004","0431","1549","655","534","121","38","693","1146","0","60.47","46.6"
"65","000","00","004","0431","1550","596","478","118","24","620","1043","0","59.44","45.83"
"65","000","00","004","0432","0000","1366","1077","289","84","1450","2334","0","62.13","46.14"
"65","000","00","004","0432","1556","598","471","127","46","644","1049","0","61.39","44.9"
"65","000","00","004","0432","1557","768","606","162","38","806","1285","0","62.72","47.16"
"65","000","00","004","0433","0000","2274","1754","520","148","2422","4225","0","57.33","41.51"
"65","000","00","004","0433","1576","651","515","136","34","685","1177","0","58.2","43.76"
"65","000","00","004","0433","1577","848","671","177","64","912","1557","0","58.57","43.1"
"65","000","00","004","0433","1578","775","568","207","50","825","1491","0","55.33","38.1"
"65","000","00","004","0434","0000","1780","1394","386","116","1896","3434","0","55.21","40.59"
"65","000","00","004","0434","1536","895","693","202","59","954","1713","0","55.69","40.46"
"65","000","00","004","0434","1537","885","701","184","57","942","1721","0","54.74","40.73"
"65","000","00","004","0435","0000","2439","1987","452","153","2592","4177","0","62.05","47.57"
"65","000","00","004","0435","1540","810","671","139","42","852","1348","0","63.2","49.78"
"65","000","00","004","0435","1541","884","728","156","41","925","1461","0","63.31","49.83"
"65","000","00","004","0435","1542","745","588","157","70","815","1368","0","59.58","42.98"
"65","000","00","004","0436","0000","837","650","187","82","919","1554","0","59.14","41.83"
"65","000","00","004","0436","1476","837","650","187","82","919","1554","0","59.14","41.83"
"65","000","00","004","0437","0000","1186","956","230","91","1277","2107","0","60.61","45.37"
"65","000","00","004","0437","1478","500","403","97","38","538","854","0","63.0","47.19"
"65","000","00","004","0437","1479","686","553","133","53","739","1253","0","58.98","44.13"
"65","000","00","004","0438","0000","2594","2070","524","134","2728","4561","0","59.81","45.38"
"65","000","00","004","0438","1499","841","644","197","43","884","1511","0","58.5","42.62"
"65","000","00","004","0438","1500","893","730","163","50","943","1470","0","64.15","49.66"
"65","000","00","004","0438","1501","860","696","164","41","901","1580","0","57.03","44.05"
"65","000","00","004","0439","0000","2243","1828","415","104","2347","3789","0","61.94","48.24"
"65","000","00","004","0439","1502","861","701","160","44","905","1438","0","62.93","48.75"
"65","000","00","004","0439","1503","778","641","137","32","810","1305","0","62.07","49.12"
"65","000","00","004","0439","1504","604","486","118","28","632","1046","0","60.42","46.46"
"65","000","00","004","0440","0000","1602","1328","274","84","1686","2938","0","57.39","45.2"
"65","000","00","004","0440","1545","789","656","133","30","819","1516","0","54.02","43.27"
"65","000","00","004","0440","1546","813","672","141","54","867","1422","0","60.97","47.26"
"65","000","00","004","0441","0000","380","310","70","46","426","768","0","55.47","40.36"
"65","000","00","004","0441","1596","380","310","70","46","426","768","0","55.47","40.36"
"65","000","00","004","0442","0000","491","407","84","37","528","853","0","61.9","47.71"
"65","000","00","004","0442","1595","491","407","84","37","528","853","0","61.9","47.71"
"65","000","00","004","0443","0000","1048","831","217","39","1087","1898","0","57.27","43.78"
"65","000","00","004","0443","1572","1048","831","217","39","1087","1898","0","57.27","43.78"
"65","000","00","004","0444","0000","2406","1932","474","168","2574","4271","0","60.27","45.24"
"65","000","00","004","0444","1573","871","684","187","52","923","1508","0","61.21","45.36"
"65","000","00","004","0444","1574","757","610","147","67","824","1341","0","61.45","45.49"
"65","000","00","004","0444","1575","778","638","140","49","827","1422","0","58.16","44.87"
"65","000","00","004","0445","0000","1156","916","240","96","1252","2011","0","62.26","45.55"
"65","000","00","004","0445","1612","594","468","126","56","650","1044","0","62.26","44.83"
"65","000","00","004","0445","1613","562","448","114","40","602","967","0","62.25","46.33"
"65","000","00","004","0446","0000","1926","1514","412","142","2068","3545","0","58.34","42.71"
"65","000","00","004","0446","1593","1031","817","214","80","1111","1938","0","57.33","42.16"
"65","000","00","004","0446","1594","895","697","198","62","957","1607","0","59.55","43.37"
"65","000","00","004","0447","0000","2441","1927","514","184","2625","4361","0","60.19","44.19"
"65","000","00","004","0447","1511","859","698","161","103","962","1649","0","58.34","42.33"
"65","000","00","004","0447","1512","723","565","158","33","756","1206","0","62.69","46.85"
"65","000","00","004","0447","1513","859","664","195","48","907","1506","0","60.23","44.09"
"65","000","00","004","0448","0000","1529","1180","349","87","1616","2823","0","57.24","41.8"
"65","000","00","004","0448","1509","879","675","204","57","936","1720","0","54.42","39.24"
"65","000","00","004","0448","1510","650","505","145","30","680","1103","0","61.65","45.78"
"65","000","00","004","0449","0000","1917","1497","420","138","2055","3465","0","59.31","43.2"
"65","000","00","004","0449","1533","581","459","122","22","603","1115","0","54.08","41.17"
"65","000","00","004","0449","1534","663","509","154","64","727","1133","0","64.17","44.92"
"65","000","00","004","0449","1535","673","529","144","52","725","1217","0","59.57","43.47"
"65","000","00","004","0450","0000","1273","1016","257","76","1349","2331","0","57.87","43.59"
"65","000","00","004","0450","1529","661","545","116","24","685","1223","0","56.01","44.56"
"65","000","00","004","0450","1530","612","471","141","52","664","1108","0","59.93","42.51"
"65","000","00","004","0451","0000","1707","1373","334","95","1802","3104","0","58.05","44.23"
"65","000","00","004","0451","1484","921","714","207","56","977","1650","0","59.21","43.27"
"65","000","00","004","0451","1485","786","659","127","39","825","1454","0","56.74","45.32"
"65","000","00","004","0452","0000","573","464","109","22","595","1065","0","55.87","43.57"
"65","000","00","004","0452","1477","573","464","109","22","595","1065","0","55.87","43.57"
"65","000","00","004","0453","0000","1120","889","231","73","1193","2025","0","58.91","43.9"
"65","000","00","004","0453","1493","609","482","127","40","649","1084","0","59.87","44.46"
"65","000","00","004","0453","1494","511","407","104","33","544","941","0","57.81","43.25"
"65","000","00","004","0454","0000","1482","1183","299","105","1587","2835","0","55.98","41.73"
"65","000","00","004","0454","1491","719","590","129","61","780","1397","0","55.83","42.23"
"65","000","00","004","0454","1492","763","593","170","44","807","1438","0","56.12","41.24"
"65","000","00","004","0455","0000","1697","1375","322","74","1771","3298","0","53.7","41.69"
"65","000","00","004","0455","1482","889","713","176","52","941","1735","0","54.24","41.1"
"65","000","00","004","0455","1483","808","662","146","22","830","1563","0","53.1","42.35"
"65","000","00","004","0456","0000","1996","1618","378","100","2096","3653","0","57.38","44.29"
"65","000","00","004","0456","1554","1044","830","214","57","1101","1872","0","58.81","44.34"
"65","000","00","004","0456","1555","952","788","164","43","995","1781","0","55.87","44.24"
"65","000","00","004","0457","0000","1325","1040","285","70","1395","2411","0","57.86","43.14"
"65","000","00","004","0457","1603","733","562","171","49","782","1368","0","57.16","41.08"
"65","000","00","004","0457","1604","592","478","114","21","613","1043","0","58.77","45.83"
"65","000","00","004","0458","0000","975","743","232","46","1021","1709","0","59.74","43.48"
"65","000","00","004","0458","1605","975","743","232","46","1021","1709","0","59.74","43.48"
"65","000","00","004","0459","0000","1435","1145","290","93","1528","2584","0","59.13","44.31"
"65","000","00","004","0459","1538","687","550","137","61","748","1327","0","56.37","41.45"
"65","000","00","004","0459","1539","748","595","153","32","780","1257","0","62.05","47.33"
"65","000","00","004","0460","0000","1517","1187","330","117","1634","2673","0","61.13","44.41"
"65","000","00","004","0460","1531","796","622","174","64","860","1408","0","61.08","44.18"
"65","000","00","004","0460","1532","721","565","156","53","774","1265","0","61.19","44.66"
"65","000","00","004","0461","0000","1276","1014","262","90","1366","2166","0","63.07","46.81"
"65","000","00","004","0461","1561","623","502","121","45","668","1068","0","62.55","47.0"
"65","000","00","004","0461","1562","653","512","141","45","698","1098","0","63.57","46.63"
"65","000","00","004","0462","0000","5151","4157","994","200","5351","8673","0","61.7","47.93"
"65","000","00","004","0462","1586","606","482","124","42","648","1077","0","60.17","44.75"
"65","000","00","004","0462","1587","675","507","168","33","708","1157","0","61.19","43.82"
"65","000","00","004","0462","1588","823","658","165","30","853","1339","0","63.7","49.14"
"65","000","00","004","0462","1589","779","629","150","18","797","1306","0","61.03","48.16"
"65","000","00","004","0462","1590","754","623","131","22","776","1236","0","62.78","50.4"
"65","000","00","004","0462","1591","682","563","119","21","703","1133","0","62.05","49.69"
"65","000","00","004","0462","1592","832","695","137","34","866","1425","0","60.77","48.77"
"65","000","00","005","0000","0000","180746","139805","40941","14127","194873","344981","417405","56.49","40.53"
"65","000","00","005","0501","0000","2662","2012","650","256","2918","4792","0","60.89","41.99"
"65","000","00","005","0501","0302","594","452","142","66","660","1123","0","58.77","40.25"
"65","000","00","005","0501","0303","693","513","180","73","766","1278","0","59.94","40.14"
"65","000","00","005","0501","0304","674","524","150","62","736","1163","0","63.28","45.06"
"65","000","00","005","0501","0305","701","523","178","55","756","1228","0","61.56","42.59"
"65","000","00","005","0502","0000","3695","2833","862","220","3915","7166","0","54.63","39.53"
"65","000","00","005","0502","0328","649","482","167","36","685","1382","0","49.57","34.88"
"65","000","00","005","0502","0329","775","598","177","51","826","1475","0","56.0","40.54"
"65","000","00","005","0502","0330","796","626","170","31","827","1462","0","56.57","42.82"
"65","000","00","005","0502","0331","746","587","159","42","788","1426","0","55.26","41.16"
"65","000","00","005","0502","0332","729","540","189","60","789","1421","0","55.52","38.0"
"65","000","00","005","0503","0000","635","496","139","118","753","1341","0","56.15","36.99"
"65","000","00","005","0503","0449","635","496","139","118","753","1341","0","56.15","36.99"
"65","000","00","005","0504","0000","2181","1641","540","165","2346","3923","0","59.8","41.83"
"65","000","00","005","0504","0306","655","468","187","55","710","1211","0","58.63","38.65"
"65","000","00","005","0504","0307","650","492","158","55","705","1176","0","59.95","41.84"
"65","000","00","005","0504","0308","876","681","195","55","931","1536","0","60.61","44.34"
"65","000","00","005","0505","0000","2042","1588","454","112","2154","3872","0","55.63","41.01"
"65","000","00","005","0505","0333","803","632","171","48","851","1536","0","55.4","41.15"
"65","000","00","005","0505","0334","869","671","198","46","915","1587","0","57.66","42.28"
"65","000","00","005","0505","0335","370","285","85","18","388","749","0","51.8","38.05"
"65","000","00","005","0506","0000","1814","1358","456","175","1989","3313","0","60.04","40.99"
"65","000","00","005","0506","0446","588","438","150","66","654","1107","0","59.08","39.57"
"65","000","00","005","0506","0447","616","465","151","53","669","1063","0","62.94","43.74"
"65","000","00","005","0506","0448","610","455","155","56","666","1143","0","58.27","39.81"
"65","000","00","005","0507","0000","2260","1786","474","188","2448","4240","0","57.74","42.12"
"65","000","00","005","0507","0312","692","560","132","82","774","1353","0","57.21","41.39"
"65","000","00","005","0507","0313","807","612","195","64","871","1409","0","61.82","43.44"
"65","000","00","005","0507","0314","761","614","147","42","803","1478","0","54.33","41.54"
"65","000","00","005","0508","0000","2048","1528","520","229","2277","3930","0","57.94","38.88"
"65","000","00","005","0508","0383","710","537","173","72","782","1342","0","58.27","40.01"
"65","000","00","005","0508","0384","701","515","186","79","780","1341","0","58.17","38.4"
"65","000","00","005","0508","0385","637","476","161","78","715","1247","0","57.34","38.17"
"65","000","00","005","0509","0000","3278","2544","734","219","3497","6296","0","55.54","40.41"
"65","000","00","005","0509","0501","781","626","155","44","825","1539","0","53.61","40.68"
"65","000","00","005","0509","0502","842","629","213","43","885","1586","0","55.8","39.66"
"65","000","00","005","0509","0503","859","673","186","73","932","1631","0","57.14","41.26"
"65","000","00","005","0509","0504","796","616","180","59","855","1540","0","55.52","40.0"
"65","000","00","005","0510","0000","1085","796","289","101","1186","1892","0","62.68","42.07"
"65","000","00","005","0510","0315","522","379","143","53","575","921","0","62.43","41.15"
"65","000","00","005","0510","0316","563","417","146","48","611","971","0","62.92","42.95"
"65","000","00","005","0511","0000","2761","2111","650","236","2997","5088","0","58.9","41.49"
"65","000","00","005","0511","0379","678","500","178","54","732","1167","0","62.72","42.84"
"65","000","00","005","0511","0380","671","502","169","70","741","1299","0","57.04","38.65"
"65","000","00","005","0511","0381","648","497","151","50","698","1207","0","57.83","41.18"
"65","000","00","005","0511","0382","764","612","152","62","826","1415","0","58.37","43.25"
"65","000","00","005","0512","0000","1366","1030","336","127","1493","2771","0","53.88","37.17"
"65","000","00","005","0512","0518","661","513","148","61","722","1371","0","52.66","37.42"
"65","000","00","005","0512","0519","705","517","188","66","771","1400","0","55.07","36.93"
"65","000","00","005","0513","0000","1636","1266","370","120","1756","3070","0","57.2","41.24"
"65","000","00","005","0513","0319","370","265","105","38","408","697","0","58.54","38.02"
"65","000","00","005","0513","0320","666","547","119","37","703","1235","0","56.92","44.29"
"65","000","00","005","0513","0321","600","454","146","45","645","1138","0","56.68","39.89"
"65","000","00","005","0514","0000","2226","1694","532","195","2421","4068","0","59.51","41.64"
"65","000","00","005","0514","0390","724","553","171","51","775","1346","0","57.58","41.08"
"65","000","00","005","0514","0391","743","575","168","75","818","1372","0","59.62","41.91"
"65","000","00","005","0514","0392","759","566","193","69","828","1350","0","61.33","41.93"
"65","000","00","005","0515","0000","5028","3928","1100","293","5321","9838","0","54.09","39.93"
"65","000","00","005","0515","0547","628","489","139","46","674","1126","0","59.86","43.43"
"65","000","00","005","0515","0548","677","530","147","42","719","1240","0","57.98","42.74"
"65","000","00","005","0515","0549","785","610","175","45","830","1460","0","56.85","41.78"
"65","000","00","005","0515","0550","557","435","122","43","600","1072","0","55.97","40.58"
"65","000","00","005","0515","0551","527","404","123","38","565","1127","0","50.13","35.85"
"65","000","00","005","0515","0552","742","584","158","31","773","1332","0","58.03","43.84"
"65","000","00","005","0515","0553","661","527","134","21","682","1341","0","50.86","39.3"
"65","000","00","005","0515","0554","451","349","102","27","478","1140","0","41.93","30.61"
"65","000","00","005","0516","0000","1304","979","325","92","1396","4462","0","31.29","21.94"
"65","000","00","005","0516","0322","527","392","135","27","554","1063","0","52.12","36.88"
"65","000","00","005","0516","0323","777","587","190","65","842","3399","0","24.77","17.27"
"65","000","00","005","0517","0000","2000","1503","497","254","2254","3947","0","57.11","38.08"
"65","000","00","005","0517","0393","638","479","159","82","720","1307","0","55.09","36.65"
"65","000","00","005","0517","0394","684","533","151","89","773","1353","0","57.13","39.39"
"65","000","00","005","0517","0395","678","491","187","83","761","1287","0","59.13","38.15"
"65","000","00","005","0518","0000","2730","2054","676","212","2942","5155","0","57.07","39.84"
"65","000","00","005","0518","0452","707","540","167","41","748","1309","0","57.14","41.25"
"65","000","00","005","0518","0453","683","509","174","49","732","1216","0","60.2","41.86"
"65","000","00","005","0518","0454","640","503","137","48","688","1278","0","53.83","39.36"
"65","000","00","005","0518","0455","700","502","198","74","774","1352","0","57.25","37.13"
"65","000","00","005","0519","0000","850","660","190","83","933","1575","0","59.24","41.9"
"65","000","00","005","0519","0324","850","660","190","83","933","1575","0","59.24","41.9"
"65","000","00","005","0520","0000","975","723","252","124","1099","1907","0","57.63","37.91"
"65","000","00","005","0520","0413","504","382","122","56","560","955","0","58.64","40.0"
"65","000","00","005","0520","0414","471","341","130","68","539","952","0","56.62","35.82"
"65","000","00","005","0521","0000","2938","2220","718","312","3250","6100","0","53.28","36.39"
"65","000","00","005","0521","0485","734","564","170","93","827","1505","0","54.95","37.48"
"65","000","00","005","0521","0486","739","553","186","84","823","1527","0","53.9","36.21"
"65","000","00","005","0521","0487","721","532","189","59","780","1482","0","52.63","35.9"
"65","000","00","005","0521","0488","744","571","173","76","820","1586","0","51.7","36.0"
"65","000","00","005","0522","0000","924","690","234","73","997","1615","0","61.73","42.72"
"65","000","00","005","0522","0325","924","690","234","73","997","1615","0","61.73","42.72"
"65","000","00","005","0523","0000","3044","2334","710","225","3269","5541","0","59.0","42.12"
"65","000","00","005","0523","0415","743","569","174","37","780","1412","0","55.24","40.3"
"65","000","00","005","0523","0416","750","568","182","73","823","1415","0","58.16","40.14"
"65","000","00","005","0523","0417","792","602","190","61","853","1421","0","60.03","42.36"
"65","000","00","005","0523","0418","759","595","164","54","813","1293","0","62.88","46.02"
"65","000","00","005","0524","0000","1133","845","288","102","1235","2161","0","57.15","39.1"
"65","000","00","005","0524","0491","559","408","151","52","611","1090","0","56.06","37.43"
"65","000","00","005","0524","0492","574","437","137","50","624","1071","0","58.26","40.8"
"65","000","00","005","0525","0000","2398","1866","532","210","2608","4748","0","54.93","39.3"
"65","000","00","005","0525","0371","802","613","189","84","886","1571","0","56.4","39.02"
"65","000","00","005","0525","0372","796","627","169","64","860","1594","0","53.95","39.34"
"65","000","00","005","0525","0373","800","626","174","62","862","1583","0","54.45","39.55"
"65","000","00","005","0526","0000","1206","973","233","86","1292","2027","0","63.74","48.0"
"65","000","00","005","0526","0386","614","506","108","34","648","984","0","65.85","51.42"
"65","000","00","005","0526","0387","592","467","125","52","644","1043","0","61.74","44.77"
"65","000","00","005","0527","0000","2465","1875","590","205","2670","4704","0","56.76","39.86"
"65","000","00","005","0527","0508","587","467","120","44","631","1181","0","53.43","39.54"
"65","000","00","005","0527","0509","601","432","169","62","663","1135","0","58.41","38.06"
"65","000","00","005","0527","0510","614","452","162","58","672","1173","0","57.29","38.53"
"65","000","00","005","0527","0511","663","524","139","41","704","1215","0","57.94","43.13"
"65","000","00","005","0528","0000","1214","901","313","176","1390","2406","0","57.77","37.45"
"65","000","00","005","0528","0362","596","428","168","76","672","1170","0","57.44","36.58"
"65","000","00","005","0528","0363","618","473","145","100","718","1236","0","58.09","38.27"
"65","000","00","005","0529","0000","1353","1040","313","88","1441","2320","0","62.11","44.83"
"65","000","00","005","0529","0388","709","538","171","45","754","1135","0","66.43","47.4"
"65","000","00","005","0529","0389","644","502","142","43","687","1185","0","57.97","42.36"
"65","000","00","005","0530","0000","2450","1923","527","169","2619","4728","0","55.39","40.67"
"65","000","00","005","0530","0353","805","611","194","96","901","1558","0","57.83","39.22"
"65","000","00","005","0530","0354","779","620","159","73","852","1567","0","54.37","39.57"
"65","000","00","005","0530","0355","866","692","174","0","866","1603","0","54.02","43.17"
"65","000","00","005","0531","0000","2583","2049","534","231","2814","4477","0","62.85","45.77"
"65","000","00","005","0531","0443","829","661","168","76","905","1535","0","58.96","43.06"
"65","000","00","005","0531","0444","935","742","193","61","996","1492","0","66.76","49.73"
"65","000","00","005","0531","0445","819","646","173","94","913","1450","0","62.97","44.55"
"65","000","00","005","0532","0000","2826","2258","568","198","3024","5219","0","57.94","43.26"
"65","000","00","005","0532","0523","655","509","146","76","731","1318","0","55.46","38.62"
"65","000","00","005","0532","0524","772","626","146","49","821","1411","0","58.19","44.37"
"65","000","00","005","0532","0525","693","540","153","35","728","1262","0","57.69","42.79"
"65","000","00","005","0532","0526","706","583","123","38","744","1228","0","60.59","47.48"
"65","000","00","005","0533","0000","2116","1636","480","199","2315","4251","0","54.46","38.49"
"65","000","00","005","0533","0344","629","503","126","56","685","1351","0","50.7","37.23"
"65","000","00","005","0533","0345","728","546","182","69","797","1403","0","56.81","38.92"
"65","000","00","005","0533","0346","759","587","172","74","833","1497","0","55.64","39.21"
"65","000","00","005","0534","0000","1530","1165","365","132","1662","3285","0","50.59","35.46"
"65","000","00","005","0534","0438","714","552","162","64","778","1633","0","47.64","33.8"
"65","000","00","005","0534","0439","816","613","203","68","884","1652","0","53.51","37.11"
"65","000","00","005","0535","0000","1260","966","294","113","1373","2670","0","51.42","36.18"
"65","000","00","005","0535","0529","642","495","147","61","703","1326","0","53.02","37.33"
"65","000","00","005","0535","0530","618","471","147","52","670","1344","0","49.85","35.04"
"65","000","00","005","0536","0000","1525","1151","374","162","1687","3126","0","53.97","36.82"
"65","000","00","005","0536","0326","769","569","200","81","850","1612","0","52.73","35.3"
"65","000","00","005","0536","0327","756","582","174","81","837","1514","0","55.28","38.44"
"65","000","00","005","0537","0000","1956","1493","463","137","2093","3484","0","60.07","42.85"
"65","000","00","005","0537","0400","640","474","166","71","711","1148","0","61.93","41.29"
"65","000","00","005","0537","0401","642","492","150","10","652","1201","0","54.29","40.97"
"65","000","00","005","0537","0402","674","527","147","56","730","1135","0","64.32","46.43"
"65","000","00","005","0538","0000","3118","2391","727","260","3378","6209","0","54.4","38.51"
"65","000","00","005","0538","0542","605","443","162","44","649","1245","0","52.13","35.58"
"65","000","00","005","0538","0543","592","462","130","50","642","1212","0","52.97","38.12"
"65","000","00","005","0538","0544","617","457","160","69","686","1253","0","54.75","36.47"
"65","000","00","005","0538","0545","621","476","145","56","677","1272","0","53.22","37.42"
"65","000","00","005","0538","0546","683","553","130","41","724","1227","0","59.01","45.07"
"65","000","00","005","0539","0000","1977","1513","464","158","2135","3713","0","57.5","40.75"
"65","000","00","005","0539","0374","696","551","145","58","754","1245","0","60.56","44.26"
"65","000","00","005","0539","0375","533","370","163","47","580","1203","0","48.21","30.76"
"65","000","00","005","0539","0376","748","592","156","53","801","1265","0","63.32","46.8"
"65","000","00","005","0540","0000","1116","820","296","68","1184","1990","0","59.5","41.21"
"65","000","00","005","0540","0458","442","329","113","25","467","881","0","53.01","37.34"
"65","000","00","005","0540","0459","674","491","183","43","717","1109","0","64.65","44.27"
"65","000","00","005","0541","0000","2046","1641","405","122","2168","3833","0","56.56","42.81"
"65","000","00","005","0541","0537","685","556","129","27","712","1301","0","54.73","42.74"
"65","000","00","005","0541","0538","674","539","135","50","724","1262","0","57.37","42.71"
"65","000","00","005","0541","0539","687","546","141","45","732","1270","0","57.64","42.99"
"65","000","00","005","0542","0000","1160","906","254","90","1250","2442","0","51.19","37.1"
"65","000","00","005","0542","0369","594","456","138","45","639","1225","0","52.16","37.22"
"65","000","00","005","0542","0370","566","450","116","45","611","1217","0","50.21","36.98"
"65","000","00","005","0543","0000","3795","2959","836","267","4062","7475","0","54.34","39.59"
"65","000","00","005","0543","0460","653","476","177","64","717","1291","0","55.54","36.87"
"65","000","00","005","0543","0461","658","519","139","29","687","1293","0","53.13","40.14"
"65","000","00","005","0543","0462","719","533","186","68","787","1336","0","58.91","39.9"
"65","000","00","005","0543","0463","693","556","137","46","739","1384","0","53.4","40.17"
"65","000","00","005","0543","0464","581","476","105","29","610","1231","0","49.55","38.67"
"65","000","00","005","0543","0465","491","399","92","31","522","940","0","55.53","42.45"
"65","000","00","005","0544","0000","2153","1671","482","167","2320","4010","0","57.86","41.67"
"65","000","00","005","0544","0531","709","552","157","56","765","1355","0","56.46","40.74"
"65","000","00","005","0544","0532","684","521","163","73","757","1306","0","57.96","39.89"
"65","000","00","005","0544","0533","760","598","162","38","798","1349","0","59.15","44.33"
"65","000","00","005","0545","0000","2336","1756","580","225","2561","4756","0","53.85","36.92"
"65","000","00","005","0545","0366","869","647","222","50","919","1586","0","57.94","40.79"
"65","000","00","005","0545","0367","758","573","185","68","826","1597","0","51.72","35.88"
"65","000","00","005","0545","0368","709","536","173","107","816","1573","0","51.88","34.08"
"65","000","00","005","0546","0000","2034","1529","505","249","2283","4025","0","56.72","37.99"
"65","000","00","005","0546","0466","656","474","182","110","766","1369","0","55.95","34.62"
"65","000","00","005","0546","0467","710","546","164","66","776","1384","0","56.07","39.45"
"65","000","00","005","0546","0468","668","509","159","73","741","1272","0","58.25","40.02"
"65","000","00","005","0547","0000","1973","1508","465","210","2183","3876","0","56.32","38.91"
"65","000","00","005","0547","0347","677","529","148","94","771","1272","0","60.61","41.59"
"65","000","00","005","0547","0348","577","447","130","47","624","1269","0","49.17","35.22"
"65","000","00","005","0547","0349","719","532","187","69","788","1335","0","59.03","39.85"
"65","000","00","005","0548","0000","4847","3857","990","293","5140","9217","0","55.77","41.85"
"65","000","00","005","0548","0471","801","635","166","26","827","1528","0","54.12","41.56"
"65","000","00","005","0548","0472","632","513","119","46","678","1244","0","54.5","41.24"
"65","000","00","005","0548","0473","671","536","135","54","725","1356","0","53.47","39.53"
"65","000","00","005","0548","0474","580","487","93","30","610","1164","0","52.41","41.84"
"65","000","00","005","0548","0475","771","612","159","69","840","1423","0","59.03","43.01"
"65","000","00","005","0548","0476","736","566","170","38","774","1250","0","61.92","45.28"
"65","000","00","005","0548","0477","656","508","148","30","686","1252","0","54.79","40.58"
"65","000","00","005","0549","0000","1126","856","270","118","1244","2200","0","56.55","38.91"
"65","000","00","005","0549","0364","537","419","118","62","599","1071","0","55.93","39.12"
"65","000","00","005","0549","0365","589","437","152","56","645","1129","0","57.13","38.71"
"65","000","00","005","0550","0000","4199","3264","935","256","4455","7788","0","57.2","41.91"
"65","000","00","005","0550","0480","904","689","215","52","956","1646","0","58.08","41.86"
"65","000","00","005","0550","0481","778","609","169","66","844","1551","0","54.42","39.26"
"65","000","00","005","0550","0482","842","639","203","60","902","1526","0","59.11","41.87"
"65","000","00","005","0550","0483","814","630","184","36","850","1518","0","55.99","41.5"
"65","000","00","005","0550","0484","861","697","164","42","903","1547","0","58.37","45.05"
"65","000","00","005","0551","0000","1386","1088","298","110","1496","2542","0","58.85","42.8"
"65","000","00","005","0551","0377","678","529","149","72","750","1255","0","59.76","42.15"
"65","000","00","005","0551","0378","708","559","149","38","746","1287","0","57.96","43.43"
"65","000","00","005","0552","0000","2077","1602","475","162","2239","4004","0","55.92","40.01"
"65","000","00","005","0552","0435","813","620","193","75","888","1584","0","56.06","39.14"
"65","000","00","005","0552","0436","831","666","165","34","865","1602","0","54.0","41.57"
"65","000","00","005","0552","0437","433","316","117","53","486","818","0","59.41","38.63"
"65","000","00","005","0553","0000","4879","3833","1046","261","5140","9369","0","54.86","40.91"
"65","000","00","005","0553","0429","785","615","170","45","830","1641","0","50.58","37.48"
"65","000","00","005","0553","0430","803","618","185","41","844","1633","0","51.68","37.84"
"65","000","00","005","0553","0431","830","668","162","27","857","1531","0","55.98","43.63"
"65","000","00","005","0553","0432","850","674","176","55","905","1517","0","59.66","44.43"
"65","000","00","005","0553","0433","772","602","170","47","819","1487","0","55.08","40.48"
"65","000","00","005","0553","0434","839","656","183","46","885","1560","0","56.73","42.05"
"65","000","00","005","0554","0000","3861","3046","815","291","4152","7331","0","56.64","41.55"
"65","000","00","005","0554","0419","722","541","181","30","752","1475","0","50.98","36.68"
"65","000","00","005","0554","0420","738","595","143","78","816","1429","0","57.1","41.64"
"65","000","00","005","0554","0421","778","620","158","66","844","1481","0","56.99","41.86"
"65","000","00","005","0554","0422","798","643","155","78","876","1472","0","59.51","43.68"
"65","000","00","005","0554","0423","825","647","178","39","864","1474","0","58.62","43.89"
"65","000","00","005","0555","0000","1893","1419","474","209","2102","4163","0","50.49","34.09"
"65","000","00","005","0555","0505","639","473","166","57","696","1388","0","50.14","34.08"
"65","000","00","005","0555","0506","626","461","165","89","715","1388","0","51.51","33.21"
"65","000","00","005","0555","0507","628","485","143","63","691","1387","0","49.82","34.97"
"65","000","00","005","0556","0000","1236","934","302","130","1366","2241","0","60.95","41.68"
"65","000","00","005","0556","0499","613","473","140","58","671","1130","0","59.38","41.86"
"65","000","00","005","0556","0500","623","461","162","72","695","1111","0","62.56","41.49"
"65","000","00","005","0557","0000","1487","1140","347","118","1605","3276","0","48.99","34.8"
"65","000","00","005","0557","0396","660","516","144","33","693","1567","0","44.22","32.93"
"65","000","00","005","0557","0397","827","624","203","85","912","1709","0","53.36","36.51"
"65","000","00","005","0558","0000","1487","1178","309","112","1599","3244","0","49.29","36.31"
"65","000","00","005","0558","0398","742","595","147","43","785","1616","0","48.58","36.82"
"65","000","00","005","0558","0399","745","583","162","69","814","1628","0","50.0","35.81"
"65","000","00","005","0559","0000","2204","1719","485","163","2367","4258","0","55.59","40.37"
"65","000","00","005","0559","0440","764","603","161","66","830","1498","0","55.41","40.25"
"65","000","00","005","0559","0441","684","529","155","47","731","1379","0","53.01","38.36"
"65","000","00","005","0559","0442","756","587","169","50","806","1381","0","58.36","42.51"
"65","000","00","005","0560","0000","2585","2012","573","208","2793","4394","0","63.56","45.79"
"65","000","00","005","0560","0309","872","707","165","59","931","1486","0","62.65","47.58"
"65","000","00","005","0560","0310","898","692","206","75","973","1513","0","64.31","45.74"
"65","000","00","005","0560","0311","815","613","202","74","889","1395","0","63.73","43.94"
"65","000","00","005","0561","0000","1705","1319","386","214","1919","3322","0","57.77","39.7"
"65","000","00","005","0561","0360","903","696","207","127","1030","1696","0","60.73","41.04"
"65","000","00","005","0561","0361","802","623","179","87","889","1626","0","54.67","38.31"
"65","000","00","005","0562","0000","3127","2448","679","193","3320","5442","0","61.01","44.98"
"65","000","00","005","0562","0409","803","623","180","64","867","1389","0","62.42","44.85"
"65","000","00","005","0562","0410","692","548","144","41","733","1272","0","57.63","43.08"
"65","000","00","005","0562","0411","830","681","149","48","878","1409","0","62.31","48.33"
"65","000","00","005","0562","0412","802","596","206","40","842","1372","0","61.37","43.44"
"65","000","00","005","0563","0000","1717","1318","399","96","1813","3243","0","55.91","40.64"
"65","000","00","005","0563","0358","837","651","186","39","876","1698","0","51.59","38.34"
"65","000","00","005","0563","0359","880","667","213","57","937","1545","0","60.65","43.17"
"65","000","00","005","0564","0000","3175","2471","704","127","3302","5852","0","56.43","42.22"
"65","000","00","005","0564","0340","818","660","158","30","848","1493","0","56.8","44.21"
"65","000","00","005","0564","0341","823","628","195","53","876","1507","0","58.13","41.67"
"65","000","00","005","0564","0342","778","604","174","17","795","1456","0","54.6","41.48"
"65","000","00","005","0564","0343","756","579","177","27","783","1396","0","56.09","41.48"
"65","000","00","005","0565","0000","1661","1329","332","131","1792","3050","0","58.75","43.57"
"65","000","00","005","0565","0317","879","709","170","84","963","1534","0","62.78","46.22"
"65","000","00","005","0565","0318","782","620","162","47","829","1516","0","54.68","40.9"
"65","000","00","005","0566","0000","1711","1321","390","183","1894","3301","0","57.38","40.02"
"65","000","00","005","0566","0497","879","690","189","82","961","1689","0","56.9","40.85"
"65","000","00","005","0566","0498","832","631","201","101","933","1612","0","57.88","39.14"
"65","000","00","005","0567","0000","1146","868","278","145","1291","2105","0","61.33","41.24"
"65","000","00","005","0567","0489","532","392","140","89","621","1065","0","58.31","36.81"
"65","000","00","005","0567","0490","614","476","138","56","670","1040","0","64.42","45.77"
"65","000","00","005","0568","0000","1172","887","285","118","1290","2340","0","55.13","37.91"
"65","000","00","005","0568","0456","619","462","157","59","678","1298","0","52.23","35.59"
"65","000","00","005","0568","0457","553","425","128","59","612","1042","0","58.73","40.79"
"65","000","00","005","0569","0000","1529","1182","347","105","1634","2712","0","60.25","43.58"
"65","000","00","005","0569","0495","788","612","176","63","851","1362","0","62.48","44.93"
"65","000","00","005","0569","0496","741","570","171","42","783","1350","0","58.0","42.22"
"65","000","00","005","0570","0000","3157","2464","693","169","3326","5880","0","56.56","41.9"
"65","000","00","005","0570","0512","819","636","183","47","866","1488","0","58.2","42.74"
"65","000","00","005","0570","0513","786","623","163","47","833","1444","0","57.69","43.14"
"65","000","00","005","0570","0514","783","604","179","44","827","1499","0","55.17","40.29"
"65","000","00","005","0570","0515","769","601","168","31","800","1449","0","55.21","41.48"
"65","000","00","005","0571","0000","2187","1666","521","238","2425","4371","0","55.48","38.11"
"65","000","00","005","0571","0520","741","578","163","77","818","1457","0","56.14","39.67"
"65","000","00","005","0571","0521","739","549","190","83","822","1502","0","54.73","36.55"
"65","000","00","005","0571","0522","707","539","168","78","785","1412","0","55.59","38.17"
"65","000","00","005","0572","0000","2817","2183","634","207","3024","5129","0","58.96","42.56"
"65","000","00","005","0572","0336","720","567","153","47","767","1276","0","60.11","44.44"
"65","000","00","005","0572","0337","652","493","159","47","699","1303","0","53.65","37.84"
"65","000","00","005","0572","0338","723","555","168","57","780","1259","0","61.95","44.08"
"65","000","00","005","0572","0339","722","568","154","56","778","1291","0","60.26","44.0"
"65","000","00","005","0573","0000","1704","1341","363","101","1805","3209","0","56.25","41.79"
"65","000","00","005","0573","0356","811","641","170","43","854","1538","0","55.53","41.68"
"65","000","00","005","0573","0357","893","700","193","58","951","1671","0","56.91","41.89"
"65","000","00","005","0574","0000","2242","1780","462","126","2368","3841","0","61.65","46.34"
"65","000","00","005","0574","0350","720","574","146","38","758","1300","0","58.31","44.15"
"65","000","00","005","0574","0351","743","587","156","39","782","1286","0","60.81","45.65"
"65","000","00","005","0574","0352","779","619","160","49","828","1255","0","65.98","49.32"
"65","000","00","005","0575","0000","4081","3223","858","169","4250","7288","0","58.32","44.22"
"65","000","00","005","0575","0424","816","631","185","22","838","1462","0","57.32","43.16"
"65","000","00","005","0575","0425","844","660","184","37","881","1484","0","59.37","44.47"
"65","000","00","005","0575","0426","792","627","165","47","839","1461","0","57.43","42.92"
"65","000","00","005","0575","0427","818","656","162","34","852","1444","0","59.0","45.43"
"65","000","00","005","0575","0428","811","649","162","29","840","1437","0","58.46","45.16"
"65","000","00","005","0576","0000","5240","4153","1087","294","5534","9313","0","59.42","44.59"
"65","000","00","005","0576","0403","852","647","205","69","921","1495","0","61.61","43.28"
"65","000","00","005","0576","0404","853","663","190","63","916","1486","0","61.64","44.62"
"65","000","00","005","0576","0405","870","696","174","45","915","1483","0","61.7","46.93"
"65","000","00","005","0576","0406","799","643","156","52","851","1553","0","54.8","41.4"
"65","000","00","005","0576","0407","962","781","181","38","1000","1625","0","61.54","48.06"
"65","000","00","005","0576","0408","904","723","181","27","931","1671","0","55.72","43.27"
"65","000","00","005","0577","0000","1181","884","297","100","1281","2159","0","59.33","40.94"
"65","000","00","005","0577","0450","573","439","134","50","623","1063","0","58.61","41.3"
"65","000","00","005","0577","0451","608","445","163","50","658","1096","0","60.04","40.6"
"65","000","00","005","0578","0000","1616","1298","318","76","1692","3402","0","49.74","38.15"
"65","000","00","005","0578","0493","809","632","177","40","849","1704","0","49.82","37.09"
"65","000","00","005","0578","0494","807","666","141","36","843","1698","0","49.65","39.22"
"65","000","00","005","0579","0000","1061","814","247","65","1126","1981","0","56.84","41.09"
"65","000","00","005","0579","0478","543","422","121","21","564","1022","0","55.19","41.29"
"65","000","00","005","0579","0479","518","392","126","44","562","959","0","58.6","40.88"
"65","000","00","005","0580","0000","1161","911","250","75","1236","2131","0","58.0","42.75"
"65","000","00","005","0580","0469","599","471","128","38","637","1073","0","59.37","43.9"
"65","000","00","005","0580","0470","562","440","122","37","599","1058","0","56.62","41.59"
"65","000","00","005","0581","0000","1667","1293","374","154","1821","3288","0","55.38","39.32"
"65","000","00","005","0581","0516","838","646","192","81","919","1640","0","56.04","39.39"
"65","000","00","005","0581","0517","829","647","182","73","902","1648","0","54.73","39.26"
"65","000","00","005","0582","0000","1887","1502","385","149","2036","3509","0","58.02","42.8"
"65","000","00","005","0582","0527","936","760","176","73","1009","1748","0","57.72","43.48"
"65","000","00","005","0582","0528","951","742","209","76","1027","1761","0","58.32","42.14"
"65","000","00","005","0583","0000","2059","1655","404","170","2229","3784","0","58.91","43.74"
"65","000","00","005","0583","0534","667","528","139","42","709","1265","0","56.05","41.74"
"65","000","00","005","0583","0535","712","565","147","63","775","1282","0","60.45","44.07"
"65","000","00","005","0583","0536","680","562","118","65","745","1237","0","60.23","45.43"
"65","000","00","005","0584","0000","1271","938","333","138","1409","2465","0","57.16","38.05"
"65","000","00","005","0584","0540","660","479","181","64","724","1245","0","58.15","38.47"
"65","000","00","005","0584","0541","611","459","152","74","685","1220","0","56.15","37.62"
"65","000","00","006","0000","0000","140235","112489","27746","8099","148334","264053","302055","56.18","42.6"
"65","000","00","006","0601","0000","1619","1287","332","147","1766","3019","0","58.5","42.63"
"65","000","00","006","0601","2049","850","672","178","73","923","1552","0","59.47","43.3"
"65","000","00","006","0601","2050","769","615","154","74","843","1467","0","57.46","41.92"
"65","000","00","006","0602","0000","2005","1601","404","133","2138","3593","0","59.5","44.56"
"65","000","00","006","0602","2051","751","587","164","49","800","1371","0","58.35","42.82"
"65","000","00","006","0602","2052","564","452","112","35","599","991","0","60.44","45.61"
"65","000","00","006","0602","2053","690","562","128","49","739","1231","0","60.03","45.65"
"65","000","00","006","0603","0000","1867","1487","380","112","1979","3408","0","58.07","43.63"
"65","000","00","006","0603","2054","935","728","207","59","994","1701","0","58.44","42.8"
"65","000","00","006","0603","2055","932","759","173","53","985","1707","0","57.7","44.46"
"65","000","00","006","0604","0000","1894","1535","359","80","1974","3639","0","54.25","42.18"
"65","000","00","006","0604","2056","954","779","175","34","988","1773","0","55.72","43.94"
"65","000","00","006","0604","2057","940","756","184","46","986","1866","0","52.84","40.51"
"65","000","00","006","0605","0000","2868","2323","545","148","3016","4958","0","60.83","46.85"
"65","000","00","006","0605","2058","979","781","198","52","1031","1735","0","59.42","45.01"
"65","000","00","006","0605","2059","1004","806","198","41","1045","1632","0","64.03","49.39"
"65","000","00","006","0605","2060","885","736","149","55","940","1591","0","59.08","46.26"
"65","000","00","006","0606","0000","2725","2203","522","154","2879","4790","0","60.1","45.99"
"65","000","00","006","0606","2063","679","544","135","56","735","1260","0","58.33","43.17"
"65","000","00","006","0606","2064","1114","916","198","50","1164","1948","0","59.75","47.02"
"65","000","00","006","0606","2065","932","743","189","48","980","1582","0","61.95","46.97"
"65","000","00","006","0607","0000","2709","2230","479","138","2847","5031","0","56.59","44.33"
"65","000","00","006","0607","2070","936","762","174","35","971","1735","0","55.97","43.92"
"65","000","00","006","0607","2071","909","756","153","52","961","1716","0","56.0","44.06"
"65","000","00","006","0607","2072","864","712","152","51","915","1580","0","57.91","45.06"
"65","000","00","006","0608","0000","3338","2661","677","193","3531","5947","0","59.37","44.75"
"65","000","00","006","0608","2073","800","640","160","45","845","1358","0","62.22","47.13"
"65","000","00","006","0608","2074","923","735","188","79","1002","1610","0","62.24","45.65"
"65","000","00","006","0608","2075","742","571","171","33","775","1383","0","56.04","41.29"
"65","000","00","006","0608","2076","873","715","158","36","909","1596","0","56.95","44.8"
"65","000","00","006","0609","0000","1255","1049","206","60","1315","2520","0","52.18","41.63"
"65","000","00","006","0609","2077","679","556","123","41","720","1360","0","52.94","40.88"
"65","000","00","006","0609","2078","576","493","83","19","595","1160","0","51.29","42.5"
"65","000","00","006","0610","0000","1543","1315","228","69","1612","2470","0","65.26","53.24"
"65","000","00","006","0610","2079","777","668","109","40","817","1236","0","66.1","54.05"
"65","000","00","006","0610","2080","766","647","119","29","795","1234","0","64.42","52.43"
"65","000","00","006","0611","0000","1513","1190","323","110","1623","2820","0","57.55","42.2"
"65","000","00","006","0611","2081","849","656","193","65","914","1579","0","57.88","41.55"
"65","000","00","006","0611","2082","664","534","130","45","709","1241","0","57.13","43.03"
"65","000","00","006","0612","0000","727","540","187","61","788","1578","0","49.94","34.22"
"65","000","00","006","0612","2085","727","540","187","61","788","1578","0","49.94","34.22"
"65","000","00","006","0613","0000","1432","1093","339","134","1566","2917","0","53.69","37.47"
"65","000","00","006","0613","2086","750","580","170","46","796","1442","0","55.2","40.22"
"65","000","00","006","0613","2087","682","513","169","88","770","1475","0","52.2","34.78"
"65","000","00","006","0614","0000","4165","3278","887","248","4413","7921","0","55.71","41.38"
"65","000","00","006","0614","2088","875","685","190","51","926","1580","0","58.61","43.35"
"65","000","00","006","0614","2089","799","620","179","39","838","1585","0","52.87","39.12"
"65","000","00","006","0614","2090","833","647","186","60","893","1586","0","56.31","40.79"
"65","000","00","006","0614","2091","1011","802","209","62","1073","1931","0","55.57","41.53"
"65","000","00","006","0614","2092","647","524","123","36","683","1239","0","55.13","42.29"
"65","000","00","006","0615","0000","2347","1877","470","170","2517","4617","0","54.52","40.65"
"65","000","00","006","0615","2097","948","769","179","45","993","1885","0","52.68","40.8"
"65","000","00","006","0615","2098","676","538","138","55","731","1345","0","54.35","40.0"
"65","000","00","006","0615","2099","723","570","153","70","793","1387","0","57.17","41.1"
"65","000","00","006","0616","0000","5411","4282","1129","350","5761","10556","0","54.58","40.56"
"65","000","00","006","0616","2105","919","694","225","69","988","1835","0","53.84","37.82"
"65","000","00","006","0616","2106","1008","811","197","76","1084","2009","0","53.96","40.37"
"65","000","00","006","0616","2107","751","578","173","61","812","1450","0","56.0","39.86"
"65","000","00","006","0616","2108","910","734","176","49","959","1726","0","55.56","42.53"
"65","000","00","006","0616","2109","909","735","174","57","966","1797","0","53.76","40.9"
"65","000","00","006","0616","2110","914","730","184","38","952","1739","0","54.74","41.98"
"65","000","00","006","0617","0000","2701","2106","595","145","2846","5599","0","50.83","37.61"
"65","000","00","006","0617","2114","791","599","192","43","834","1662","0","50.18","36.04"
"65","000","00","006","0617","2115","1124","903","221","55","1179","2067","0","57.04","43.69"
"65","000","00","006","0617","2116","786","604","182","47","833","1870","0","44.55","32.3"
"65","000","00","006","0618","0000","2679","2090","589","159","2838","5222","0","54.35","40.02"
"65","000","00","006","0618","2123","498","356","142","44","542","1079","0","50.23","32.99"
"65","000","00","006","0618","2124","563","422","141","23","586","1140","0","51.4","37.02"
"65","000","00","006","0618","2125","940","789","151","59","999","1825","0","54.74","43.23"
"65","000","00","006","0618","2126","678","523","155","33","711","1178","0","60.36","44.4"
"65","000","00","006","0619","0000","2390","1874","516","192","2582","5277","0","48.93","35.51"
"65","000","00","006","0619","2133","885","678","207","78","963","1992","0","48.34","34.04"
"65","000","00","006","0619","2134","757","596","161","60","817","1668","0","48.98","35.73"
"65","000","00","006","0619","2135","748","600","148","54","802","1617","0","49.6","37.11"
"65","000","00","006","0620","0000","2794","2248","546","233","3027","5428","0","55.77","41.41"
"65","000","00","006","0620","2136","951","751","200","125","1076","2013","0","53.45","37.31"
"65","000","00","006","0620","2137","972","800","172","59","1031","1791","0","57.57","44.67"
"65","000","00","006","0620","2138","871","697","174","49","920","1624","0","56.65","42.92"
"65","000","00","006","0621","0000","406","302","104","33","439","939","0","46.75","32.16"
"65","000","00","006","0621","2142","406","302","104","33","439","939","0","46.75","32.16"
"65","000","00","006","0622","0000","2569","2058","511","116","2685","4725","0","56.83","43.56"
"65","000","00","006","0622","2148","1032","805","227","44","1076","1860","0","57.85","43.28"
"65","000","00","006","0622","2149","844","687","157","31","875","1743","0","50.2","39.41"
"65","000","00","006","0622","2150","693","566","127","41","734","1122","0","65.42","50.45"
"65","000","00","006","0623","0000","2377","1919","458","119","2496","4575","0","54.56","41.95"
"65","000","00","006","0623","2151","768","628","140","44","812","1468","0","55.31","42.78"
"65","000","00","006","0623","2152","933","746","187","35","968","1763","0","54.91","42.31"
"65","000","00","006","0623","2153","676","545","131","40","716","1344","0","53.27","40.55"
"65","000","00","006","0624","0000","359","273","86","46","405","753","0","53.78","36.25"
"65","000","00","006","0624","2154","359","273","86","46","405","753","0","53.78","36.25"
"65","000","00","006","0625","0000","1387","1035","352","75","1462","2839","0","51.5","36.46"
"65","000","00","006","0625","2155","284","201","83","14","298","602","0","49.5","33.39"
"65","000","00","006","0625","2156","1103","834","269","61","1164","2237","0","52.03","37.28"
"65","000","00","006","0626","0000","1042","792","250","78","1120","2239","0","50.02","35.37"
"65","000","00","006","0626","2157","555","430","125","31","586","1096","0","53.47","39.23"
"65","000","00","006","0626","2158","487","362","125","47","534","1143","0","46.72","31.67"
"65","000","00","006","0627","0000","741","560","181","83","824","1569","0","52.52","35.69"
"65","000","00","006","0627","2159","741","560","181","83","824","1569","0","52.52","35.69"
"65","000","00","006","0628","0000","618","463","155","68","686","1284","0","53.43","36.06"
"65","000","00","006","0628","2160","618","463","155","68","686","1284","0","53.43","36.06"
"65","000","00","006","0629","0000","521","369","152","52","573","1189","0","48.19","31.03"
"65","000","00","006","0629","2161","124","89","35","13","137","439","0","31.21","20.27"
"65","000","00","006","0629","2162","397","280","117","39","436","750","0","58.13","37.33"
"65","000","00","006","0630","0000","2451","1928","523","151","2602","4840","0","53.76","39.83"
"65","000","00","006","0630","2145","902","718","184","53","955","1838","0","51.96","39.06"
"65","000","00","006","0630","2146","766","608","158","50","816","1453","0","56.16","41.84"
"65","000","00","006","0630","2147","783","602","181","48","831","1549","0","53.65","38.86"
"65","000","00","006","0631","0000","822","650","172","56","878","1603","0","54.77","40.55"
"65","000","00","006","0631","1987","822","650","172","56","878","1603","0","54.77","40.55"
"65","000","00","006","0632","0000","986","814","172","42","1028","1921","0","53.51","42.37"
"65","000","00","006","0632","1988","986","814","172","42","1028","1921","0","53.51","42.37"
"65","000","00","006","0633","0000","1232","948","284","67","1299","2317","0","56.06","40.91"
"65","000","00","006","0633","1989","557","432","125","23","580","1082","0","53.6","39.93"
"65","000","00","006","0633","1990","675","516","159","44","719","1235","0","58.22","41.78"
"65","000","00","006","0634","0000","871","717","154","37","908","1568","0","57.91","45.73"
"65","000","00","006","0634","1991","871","717","154","37","908","1568","0","57.91","45.73"
"65","000","00","006","0635","0000","427","324","103","30","457","771","0","59.27","42.02"
"65","000","00","006","0635","1992","427","324","103","30","457","771","0","59.27","42.02"
"65","000","00","006","0636","0000","1213","924","289","83","1296","2264","0","57.24","40.81"
"65","000","00","006","0636","1993","652","488","164","44","696","1256","0","55.41","38.85"
"65","000","00","006","0636","1994","561","436","125","39","600","1008","0","59.52","43.25"
"65","000","00","006","0637","0000","2666","2173","493","143","2809","4701","0","59.75","46.22"
"65","000","00","006","0637","1995","838","707","131","52","890","1515","0","58.75","46.67"
"65","000","00","006","0637","1996","978","795","183","40","1018","1637","0","62.19","48.56"
"65","000","00","006","0637","1997","850","671","179","51","901","1549","0","58.17","43.32"
"65","000","00","006","0638","0000","2935","2353","582","197","3132","5335","0","58.71","44.1"
"65","000","00","006","0638","1998","1199","983","216","51","1250","2011","0","62.16","48.88"
"65","000","00","006","0638","1999","824","649","175","75","899","1554","0","57.85","41.76"
"65","000","00","006","0638","2000","912","721","191","71","983","1770","0","55.54","40.73"
"65","000","00","006","0639","0000","1318","1051","267","109","1427","2442","0","58.44","43.04"
"65","000","00","006","0639","2001","735","590","145","47","782","1316","0","59.42","44.83"
"65","000","00","006","0639","2002","583","461","122","62","645","1126","0","57.28","40.94"
"65","000","00","006","0640","0000","4359","3489","870","222","4581","7834","0","58.48","44.54"
"65","000","00","006","0640","2003","749","579","170","46","795","1460","0","54.45","39.66"
"65","000","00","006","0640","2004","884","699","185","54","938","1584","0","59.22","44.13"
"65","000","00","006","0640","2005","774","611","163","51","825","1449","0","56.94","42.17"
"65","000","00","006","0640","2006","906","744","162","47","953","1520","0","62.7","48.95"
"65","000","00","006","0640","2007","1046","856","190","24","1070","1821","0","58.76","47.01"
"65","000","00","006","0641","0000","3720","3038","682","154","3874","6728","0","57.58","45.15"
"65","000","00","006","0641","2008","1046","836","210","44","1090","1956","0","55.73","42.74"
"65","000","00","006","0641","2009","924","755","169","51","975","1665","0","58.56","45.35"
"65","000","00","006","0641","2010","927","768","159","39","966","1588","0","60.83","48.36"
"65","000","00","006","0641","2011","823","679","144","20","843","1519","0","55.5","44.7"
"65","000","00","006","0642","0000","2226","1771","455","134","2360","5969","0","39.54","29.67"
"65","000","00","006","0642","2014","634","506","128","55","689","1106","0","62.3","45.75"
"65","000","00","006","0642","2015","392","288","104","18","410","2700","0","15.19","10.67"
"65","000","00","006","0642","2016","567","461","106","23","590","995","0","59.3","46.33"
"65","000","00","006","0642","2017","633","516","117","38","671","1168","0","57.45","44.18"
"65","000","00","006","0643","0000","1369","1100","269","93","1462","2208","0","66.21","49.82"
"65","000","00","006","0643","2018","707","582","125","53","760","1123","0","67.68","51.83"
"65","000","00","006","0643","2019","662","518","144","40","702","1085","0","64.7","47.74"
"65","000","00","006","0644","0000","3173","2567","606","177","3350","5645","0","59.34","45.47"
"65","000","00","006","0644","2020","833","663","170","50","883","1412","0","62.54","46.95"
"65","000","00","006","0644","2021","912","730","182","48","960","1659","0","57.87","44.0"
"65","000","00","006","0644","2022","719","608","111","44","763","1198","0","63.69","50.75"
"65","000","00","006","0644","2023","709","566","143","35","744","1376","0","54.07","41.13"
"65","000","00","006","0645","0000","2078","1673","405","91","2169","3926","0","55.25","42.61"
"65","000","00","006","0645","2024","678","559","119","32","710","1300","0","54.62","43.0"
"65","000","00","006","0645","2025","688","546","142","35","723","1238","0","58.4","44.1"
"65","000","00","006","0645","2026","712","568","144","24","736","1388","0","53.03","40.92"
"65","000","00","006","0646","0000","1105","871","234","63","1168","1841","0","63.44","47.31"
"65","000","00","006","0646","2027","550","433","117","37","587","933","0","62.92","46.41"
"65","000","00","006","0646","2028","555","438","117","26","581","908","0","63.99","48.24"
"65","000","00","006","0647","0000","2000","1642","358","150","2150","3508","0","61.29","46.81"
"65","000","00","006","0647","2031","550","442","108","51","601","971","0","61.89","45.52"
"65","000","00","006","0647","2032","662","555","107","50","712","1145","0","62.18","48.47"
"65","000","00","006","0647","2033","788","645","143","49","837","1392","0","60.13","46.34"
"65","000","00","006","0648","0000","1642","1355","287","109","1751","2892","0","60.55","46.85"
"65","000","00","006","0648","2034","863","724","139","53","916","1452","0","63.09","49.86"
"65","000","00","006","0648","2035","779","631","148","56","835","1440","0","57.99","43.82"
"65","000","00","006","0649","0000","1947","1583","364","131","2078","3611","0","57.55","43.84"
"65","000","00","006","0649","2036","941","745","196","77","1018","1786","0","57.0","41.71"
"65","000","00","006","0649","2037","1006","838","168","54","1060","1825","0","58.08","45.92"
"65","000","00","006","0650","0000","1839","1459","380","77","1916","3227","0","59.37","45.21"
"65","000","00","006","0650","2038","853","676","177","33","886","1477","0","59.99","45.77"
"65","000","00","006","0650","2039","986","783","203","44","1030","1750","0","58.86","44.74"
"65","000","00","006","0651","0000","2011","1670","341","131","2142","3771","0","56.8","44.29"
"65","000","00","006","0651","2040","952","780","172","72","1024","1792","0","57.14","43.53"
"65","000","00","006","0651","2041","1059","890","169","59","1118","1979","0","56.49","44.97"
"65","000","00","006","0652","0000","2395","2007","388","89","2484","4133","0","60.1","48.56"
"65","000","00","006","0652","2042","470","393","77","29","499","826","0","60.41","47.58"
"65","000","00","006","0652","2043","1099","919","180","38","1137","1924","0","59.1","47.77"
"65","000","00","006","0652","2044","826","695","131","22","848","1383","0","61.32","50.25"
"65","000","00","006","0653","0000","382","299","83","42","424","830","0","51.08","36.02"
"65","000","00","006","0653","2045","382","299","83","42","424","830","0","51.08","36.02"
"65","000","00","006","0654","0000","3045","2498","547","114","3159","5197","0","60.79","48.07"
"65","000","00","006","0654","2046","1043","854","189","33","1076","1759","0","61.17","48.55"
"65","000","00","006","0654","2047","1136","939","197","50","1186","1957","0","60.6","47.98"
"65","000","00","006","0654","2048","866","705","161","31","897","1481","0","60.57","47.6"
"65","000","00","006","0655","0000","1857","1511","346","60","1917","3135","0","61.15","48.2"
"65","000","00","006","0655","2119","996","792","204","37","1033","1712","0","60.34","46.26"
"65","000","00","006","0655","2120","861","719","142","23","884","1423","0","62.12","50.53"
"65","000","00","006","0656","0000","3409","2792","617","197","3606","6684","0","53.95","41.77"
"65","000","00","006","0656","2093","987","823","164","58","1045","1892","0","55.23","43.5"
"65","000","00","006","0656","2094","751","599","152","47","798","1529","0","52.19","39.18"
"65","000","00","006","0656","2095","737","631","106","51","788","1358","0","58.03","46.47"
"65","000","00","006","0656","2096","934","739","195","41","975","1905","0","51.18","38.79"
"65","000","00","006","0657","0000","2408","1999","409","116","2524","4334","0","58.24","46.12"
"65","000","00","006","0657","2139","681","571","110","32","713","1178","0","60.53","48.47"
"65","000","00","006","0657","2140","719","600","119","29","748","1277","0","58.57","46.99"
"65","000","00","006","0657","2141","1008","828","180","55","1063","1879","0","56.57","44.07"
"65","000","00","006","0658","0000","3490","2821","669","188","3678","6377","0","57.68","44.24"
"65","000","00","006","0658","2066","719","544","175","46","765","1315","0","58.17","41.37"
"65","000","00","006","0658","2067","792","640","152","54","846","1562","0","54.16","40.97"
"65","000","00","006","0658","2068","1140","975","165","28","1168","1982","0","58.93","49.19"
"65","000","00","006","0658","2069","839","662","177","60","899","1518","0","59.22","43.61"
"65","000","00","006","0659","0000","1988","1593","395","105","2093","3435","0","60.93","46.38"
"65","000","00","006","0659","2121","942","747","195","56","998","1666","0","59.9","44.84"
"65","000","00","006","0659","2122","1046","846","200","49","1095","1769","0","61.9","47.82"
"65","000","00","006","0660","0000","4659","3796","863","221","4880","9469","0","51.54","40.09"
"65","000","00","006","0660","2127","755","613","142","42","797","1463","0","54.48","41.9"
"65","000","00","006","0660","2128","630","507","123","28","658","1152","0","57.12","44.01"
"65","000","00","006","0660","2129","901","738","163","36","937","2008","0","46.66","36.75"
"65","000","00","006","0660","2130","933","779","154","50","983","2120","0","46.37","36.75"
"65","000","00","006","0660","2131","653","534","119","22","675","1153","0","58.54","46.31"
"65","000","00","006","0660","2132","787","625","162","43","830","1573","0","52.77","39.73"
"65","000","00","006","0661","0000","1578","1256","322","109","1687","2829","0","59.63","44.4"
"65","000","00","006","0661","2029","847","667","180","64","911","1582","0","57.59","42.16"
"65","000","00","006","0661","2030","731","589","142","45","776","1247","0","62.23","47.23"
"65","000","00","006","0662","0000","1489","1216","273","85","1574","3006","0","52.36","40.45"
"65","000","00","006","0662","2061","754","603","151","62","816","1495","0","54.58","40.33"
"65","000","00","006","0662","2062","735","613","122","23","758","1511","0","50.17","40.57"
"65","000","00","006","0663","0000","1278","1026","252","71","1349","2489","0","54.2","41.22"
"65","000","00","006","0663","2083","681","555","126","22","703","1275","0","55.14","43.53"
"65","000","00","006","0663","2084","597","471","126","49","646","1214","0","53.21","38.8"
"65","000","00","006","0664","0000","2538","2097","441","79","2617","4809","0","54.42","43.61"
"65","000","00","006","0664","2111","817","680","137","30","847","1523","0","55.61","44.65"
"65","000","00","006","0664","2112","843","707","136","30","873","1642","0","53.17","43.06"
"65","000","00","006","0664","2113","878","710","168","19","897","1644","0","54.56","43.19"
"65","000","00","006","0665","0000","1384","1083","301","53","1437","2280","0","63.03","47.5"
"65","000","00","006","0665","2012","712","548","164","31","743","1185","0","62.7","46.24"
"65","000","00","006","0665","2013","672","535","137","22","694","1095","0","63.38","48.86"
"65","000","00","006","0666","0000","1972","1602","370","136","2108","3797","0","55.52","42.19"
"65","000","00","006","0666","2100","1017","818","199","64","1081","1960","0","55.15","41.73"
"65","000","00","006","0666","2101","955","784","171","72","1027","1837","0","55.91","42.68"
"65","000","00","006","0667","0000","2754","2195","559","144","2898","4983","0","58.16","44.05"
"65","000","00","006","0667","2102","891","716","175","54","945","1662","0","56.86","43.08"
"65","000","00","006","0667","2103","936","749","187","59","995","1617","0","61.53","46.32"
"65","000","00","006","0667","2104","927","730","197","31","958","1704","0","56.22","42.84"
"65","000","00","006","0668","0000","1849","1489","360","87","1936","3528","0","54.88","42.21"
"65","000","00","006","0668","2117","1008","800","208","54","1062","1982","0","53.58","40.36"
"65","000","00","006","0668","2118","841","689","152","33","874","1546","0","56.53","44.57"
"65","000","00","006","0669","0000","1368","1069","299","50","1418","2394","0","59.23","44.65"
"65","000","00","006","0669","2143","517","396","121","30","547","960","0","56.98","41.25"
"65","000","00","006","0669","2144","851","673","178","20","871","1434","0","60.74","46.93"
"65","000","00","007","0000","0000","77732","59598","18134","5540","83272","152102","183780","54.75","39.18"
"65","000","00","007","0701","0000","1643","1193","450","162","1805","3613","0","49.96","33.02"
"65","000","00","007","0701","1620","807","577","230","84","891","1897","0","46.97","30.42"
"65","000","00","007","0701","1621","836","616","220","78","914","1716","0","53.26","35.9"
"65","000","00","007","0702","0000","1872","1409","463","141","2013","3470","0","58.01","40.61"
"65","000","00","007","0702","1617","611","457","154","60","671","1211","0","55.41","37.74"
"65","000","00","007","0702","1618","616","466","150","44","660","1125","0","58.67","41.42"
"65","000","00","007","0702","1619","645","486","159","37","682","1134","0","60.14","42.86"
"65","000","00","007","0703","0000","2001","1527","474","154","2155","4252","0","50.68","35.91"
"65","000","00","007","0703","1614","669","506","163","72","741","1408","0","52.63","35.94"
"65","000","00","007","0703","1615","640","491","149","32","672","1310","0","51.3","37.48"
"65","000","00","007","0703","1616","692","530","162","50","742","1534","0","48.37","34.55"
"65","000","00","007","0704","0000","1644","1198","446","108","1752","3296","0","53.16","36.35"
"65","000","00","007","0704","1643","595","453","142","58","653","1116","0","58.51","40.59"
"65","000","00","007","0704","1644","530","361","169","35","565","1077","0","52.46","33.52"
"65","000","00","007","0704","1645","519","384","135","15","534","1103","0","48.41","34.81"
"65","000","00","007","0705","0000","2842","2186","656","174","3016","5619","0","53.68","38.9"
"65","000","00","007","0705","1639","747","569","178","25","772","1483","0","52.06","38.37"
"65","000","00","007","0705","1640","749","592","157","42","791","1524","0","51.9","38.85"
"65","000","00","007","0705","1641","759","593","166","38","797","1431","0","55.7","41.44"
"65","000","00","007","0705","1642","587","432","155","69","656","1181","0","55.55","36.58"
"65","000","00","007","0706","0000","1888","1425","463","183","2071","4297","0","48.2","33.16"
"65","000","00","007","0706","1633","636","465","171","79","715","1927","0","37.1","24.13"
"65","000","00","007","0706","1634","474","361","113","46","520","914","0","56.89","39.5"
"65","000","00","007","0706","1635","778","599","179","58","836","1456","0","57.42","41.14"
"65","000","00","007","0707","0000","2133","1630","503","147","2280","4468","0","51.03","36.48"
"65","000","00","007","0707","1624","748","563","185","51","799","1542","0","51.82","36.51"
"65","000","00","007","0707","1625","738","569","169","64","802","1470","0","54.56","38.71"
"65","000","00","007","0707","1626","647","498","149","32","679","1456","0","46.63","34.2"
"65","000","00","007","0708","0000","1714","1335","379","135","1849","3218","0","57.46","41.49"
"65","000","00","007","0708","1652","470","375","95","26","496","870","0","57.01","43.1"
"65","000","00","007","0708","1653","745","560","185","74","819","1338","0","61.21","41.85"
"65","000","00","007","0708","1654","499","400","99","35","534","1010","0","52.87","39.6"
"65","000","00","007","0709","0000","2454","1867","587","189","2643","4558","0","57.99","40.96"
"65","000","00","007","0709","1657","802","646","156","81","883","1405","0","62.85","45.98"
"65","000","00","007","0709","1658","828","607","221","60","888","1587","0","55.95","38.25"
"65","000","00","007","0709","1659","824","614","210","48","872","1566","0","55.68","39.21"
"65","000","00","007","0710","0000","2072","1555","517","143","2215","3749","0","59.08","41.48"
"65","000","00","007","0710","1667","706","528","178","66","772","1268","0","60.88","41.64"
"65","000","00","007","0710","1668","702","535","167","27","729","1281","0","56.91","41.76"
"65","000","00","007","0710","1669","664","492","172","50","714","1200","0","59.5","41.0"
"65","000","00","007","0711","0000","1572","1257","315","105","1677","2979","0","56.29","42.2"
"65","000","00","007","0711","1663","906","730","176","48","954","1701","0","56.08","42.92"
"65","000","00","007","0711","1664","666","527","139","57","723","1278","0","56.57","41.24"
"65","000","00","007","0712","0000","735","553","182","33","768","1491","0","51.51","37.09"
"65","000","00","007","0712","1670","735","553","182","33","768","1491","0","51.51","37.09"
"65","000","00","007","0713","0000","530","400","130","23","553","1066","0","51.88","37.52"
"65","000","00","007","0713","1671","530","400","130","23","553","1066","0","51.88","37.52"
"65","000","00","007","0714","0000","1640","1333","307","73","1713","3132","0","54.69","42.56"
"65","000","00","007","0714","1686","823","685","138","49","872","1566","0","55.68","43.74"
"65","000","00","007","0714","1687","817","648","169","24","841","1566","0","53.7","41.38"
"65","000","00","007","0715","0000","1774","1329","445","146","1920","3427","0","56.03","38.78"
"65","000","00","007","0715","1676","640","485","155","46","686","1144","0","59.97","42.4"
"65","000","00","007","0715","1677","521","398","123","33","554","1059","0","52.31","37.58"
"65","000","00","007","0715","1678","613","446","167","67","680","1224","0","55.56","36.44"
"65","000","00","007","0716","0000","2212","1700","512","172","2384","4452","0","53.55","38.19"
"65","000","00","007","0716","1683","761","585","176","71","832","1514","0","54.95","38.64"
"65","000","00","007","0716","1684","729","561","168","51","780","1546","0","50.45","36.29"
"65","000","00","007","0716","1685","722","554","168","50","772","1392","0","55.46","39.8"
"65","000","00","007","0717","0000","2219","1739","480","195","2414","4572","0","52.8","38.04"
"65","000","00","007","0717","1673","809","629","180","66","875","1616","0","54.15","38.92"
"65","000","00","007","0717","1674","679","527","152","64","743","1589","0","46.76","33.17"
"65","000","00","007","0717","1675","731","583","148","65","796","1367","0","58.23","42.65"
"65","000","00","007","0718","0000","1413","1065","348","134","1547","2883","0","53.66","36.94"
"65","000","00","007","0718","1699","786","620","166","63","849","1606","0","52.86","38.61"
"65","000","00","007","0718","1700","627","445","182","71","698","1277","0","54.66","34.85"
"65","000","00","007","0719","0000","2621","2036","585","224","2845","5231","0","54.39","38.92"
"65","000","00","007","0719","1695","630","482","148","70","700","1247","0","56.13","38.65"
"65","000","00","007","0719","1696","675","535","140","78","753","1390","0","54.17","38.49"
"65","000","00","007","0719","1697","698","539","159","44","742","1293","0","57.39","41.69"
"65","000","00","007","0719","1698","618","480","138","32","650","1301","0","49.96","36.89"
"65","000","00","007","0720","0000","2346","1778","568","159","2505","4264","0","58.75","41.7"
"65","000","00","007","0720","1692","920","669","251","74","994","1661","0","59.84","40.28"
"65","000","00","007","0720","1693","846","649","197","48","894","1585","0","56.4","40.95"
"65","000","00","007","0720","1694","580","460","120","37","617","1018","0","60.61","45.19"
"65","000","00","007","0721","0000","681","523","158","40","721","1683","0","42.84","31.08"
"65","000","00","007","0721","1708","681","523","158","40","721","1683","0","42.84","31.08"
"65","000","00","007","0722","0000","663","488","175","48","711","1565","0","45.43","31.18"
"65","000","00","007","0722","1722","663","488","175","48","711","1565","0","45.43","31.18"
"65","000","00","007","0723","0000","854","604","250","88","942","1638","0","57.51","36.87"
"65","000","00","007","0723","1714","854","604","250","88","942","1638","0","57.51","36.87"
"65","000","00","007","0724","0000","6207","4917","1290","403","6610","11772","0","56.15","41.77"
"65","000","00","007","0724","1715","813","647","166","47","860","1592","0","54.02","40.64"
"65","000","00","007","0724","1716","833","665","168","52","885","1521","0","58.19","43.72"
"65","000","00","007","0724","1717","967","755","212","60","1027","1707","0","60.16","44.23"
"65","000","00","007","0724","1718","973","741","232","64","1037","1741","0","59.56","42.56"
"65","000","00","007","0724","1719","868","703","165","41","909","1655","0","54.92","42.48"
"65","000","00","007","0724","1720","824","650","174","79","903","1775","0","50.87","36.62"
"65","000","00","007","0724","1721","929","756","173","60","989","1781","0","55.53","42.45"
"65","000","00","007","0725","0000","996","726","270","66","1062","1966","0","54.02","36.93"
"65","000","00","007","0725","1723","459","330","129","45","504","936","0","53.85","35.26"
"65","000","00","007","0725","1724","537","396","141","21","558","1030","0","54.17","38.45"
"65","000","00","007","0726","0000","4299","3458","841","170","4469","7662","0","58.33","45.13"
"65","000","00","007","0726","1709","799","628","171","46","845","1452","0","58.2","43.25"
"65","000","00","007","0726","1710","889","721","168","31","920","1592","0","57.79","45.29"
"65","000","00","007","0726","1711","898","731","167","37","935","1619","0","57.75","45.15"
"65","000","00","007","0726","1712","982","785","197","32","1014","1642","0","61.75","47.81"
"65","000","00","007","0726","1713","731","593","138","24","755","1357","0","55.64","43.7"
"65","000","00","007","0727","0000","499","389","110","59","558","877","0","63.63","44.36"
"65","000","00","007","0727","1672","499","389","110","59","558","877","0","63.63","44.36"
"65","000","00","007","0728","0000","1941","1477","464","144","2085","3846","0","54.21","38.4"
"65","000","00","007","0728","1646","717","563","154","55","772","1385","0","55.74","40.65"
"65","000","00","007","0728","1647","620","472","148","44","664","1266","0","52.45","37.28"
"65","000","00","007","0728","1648","604","442","162","45","649","1195","0","54.31","36.99"
"65","000","00","007","0729","0000","1645","1298","347","116","1761","3245","0","54.27","40.0"
"65","000","00","007","0729","1660","495","401","94","14","509","997","0","51.05","40.22"
"65","000","00","007","0729","1661","621","480","141","52","673","1187","0","56.7","40.44"
"65","000","00","007","0729","1662","529","417","112","50","579","1061","0","54.57","39.3"
"65","000","00","007","0730","0000","1807","1358","449","113","1920","3196","0","60.08","42.49"
"65","000","00","007","0730","1655","906","682","224","53","959","1658","0","57.84","41.13"
"65","000","00","007","0730","1656","901","676","225","60","961","1538","0","62.48","43.95"
"65","000","00","007","0731","0000","1854","1400","454","86","1940","3571","0","54.33","39.2"
"65","000","00","007","0731","1627","594","467","127","22","616","1124","0","54.8","41.55"
"65","000","00","007","0731","1628","624","470","154","32","656","1235","0","53.12","38.06"
"65","000","00","007","0731","1629","636","463","173","32","668","1212","0","55.12","38.2"
"65","000","00","007","0732","0000","1848","1374","474","145","1993","3764","0","52.95","36.5"
"65","000","00","007","0732","1630","560","424","136","35","595","1223","0","48.65","34.67"
"65","000","00","007","0732","1631","662","483","179","73","735","1335","0","55.06","36.18"
"65","000","00","007","0732","1632","626","467","159","37","663","1206","0","54.98","38.72"
"65","000","00","007","0733","0000","2412","1815","597","185","2597","5192","0","50.02","34.96"
"65","000","00","007","0733","1679","548","425","123","42","590","1141","0","51.71","37.25"
"65","000","00","007","0733","1680","573","457","116","25","598","1396","0","42.84","32.74"
"65","000","00","007","0733","1681","597","435","162","37","634","1157","0","54.8","37.6"
"65","000","00","007","0733","1682","694","498","196","81","775","1498","0","51.74","33.24"
"65","000","00","007","0734","0000","2339","1760","579","169","2508","4454","0","56.31","39.52"
"65","000","00","007","0734","1636","693","522","171","47","740","1409","0","52.52","37.05"
"65","000","00","007","0734","1637","836","614","222","63","899","1500","0","59.93","40.93"
"65","000","00","007","0734","1638","810","624","186","59","869","1545","0","56.25","40.39"
"65","000","00","007","0735","0000","2599","1999","600","167","2766","4995","0","55.38","40.02"
"65","000","00","007","0735","1701","632","459","173","63","695","1219","0","57.01","37.65"
"65","000","00","007","0735","1702","697","558","139","36","733","1454","0","50.41","38.38"
"65","000","00","007","0735","1703","658","514","144","42","700","1314","0","53.27","39.12"
"65","000","00","007","0735","1704","612","468","144","26","638","1008","0","63.29","46.43"
"65","000","00","007","0736","0000","2272","1770","502","191","2463","4615","0","53.37","38.35"
"65","000","00","007","0736","1705","776","603","173","70","846","1574","0","53.75","38.31"
"65","000","00","007","0736","1706","730","586","144","37","767","1364","0","56.23","42.96"
"65","000","00","007","0736","1707","766","581","185","84","850","1677","0","50.69","34.65"
"65","000","00","007","0737","0000","1535","1189","346","129","1664","2739","0","60.75","43.41"
"65","000","00","007","0737","1665","806","628","178","59","865","1433","0","60.36","43.82"
"65","000","00","007","0737","1666","729","561","168","70","799","1306","0","61.18","42.96"
"65","000","00","007","0738","0000","1547","1218","329","90","1637","2998","0","54.6","40.63"
"65","000","00","007","0738","1688","769","601","168","53","822","1517","0","54.19","39.62"
"65","000","00","007","0738","1689","778","617","161","37","815","1481","0","55.03","41.66"
"65","000","00","007","0739","0000","1209","947","262","80","1289","2424","0","53.18","39.07"
"65","000","00","007","0739","1690","631","488","143","50","681","1261","0","54.0","38.7"
"65","000","00","007","0739","1691","578","459","119","30","608","1163","0","52.28","39.47"
"65","000","00","007","0740","0000","1308","977","331","100","1408","2517","0","55.94","38.82"
"65","000","00","007","0740","1649","625","462","163","54","679","1254","0","54.15","36.84"
"65","000","00","007","0740","1650","683","515","168","46","729","1263","0","57.72","40.78"
"65","000","00","007","0741","0000","818","594","224","78","896","1473","0","60.83","40.33"
"65","000","00","007","0741","1651","818","594","224","78","896","1473","0","60.83","40.33"
"65","000","00","007","0742","0000","1074","802","272","73","1147","1873","0","61.24","42.82"
"65","000","00","007","0742","1622","420","299","121","38","458","736","0","62.23","40.63"
"65","000","00","007","0742","1623","654","503","151","35","689","1137","0","60.6","44.24"
"65","000","00","008","0000","0000","34788","27021","7767","2543","37331","71645","86223","52.11","37.72"
"65","000","00","008","0801","0000","536","407","129","43","579","965","0","60.0","42.18"
"65","000","00","008","0801","1726","536","407","129","43","579","965","0","60.0","42.18"
"65","000","00","008","0802","0000","1010","792","218","60","1070","2019","0","53.0","39.23"
"65","000","00","008","0802","1729","545","427","118","45","590","1057","0","55.82","40.4"
"65","000","00","008","0802","1730","465","365","100","15","480","962","0","49.9","37.94"
"65","000","00","008","0803","0000","2550","1997","553","185","2735","5052","0","54.14","39.53"
"65","000","00","008","0803","1732","976","769","207","76","1052","1742","0","60.39","44.14"
"65","000","00","008","0803","1733","799","602","197","61","860","1634","0","52.63","36.84"
"65","000","00","008","0803","1734","775","626","149","48","823","1676","0","49.11","37.35"
"65","000","00","008","0804","0000","1773","1344","429","180","1953","3728","0","52.39","36.05"
"65","000","00","008","0804","1727","977","746","231","88","1065","1931","0","55.15","38.63"
"65","000","00","008","0804","1728","796","598","198","92","888","1797","0","49.42","33.28"
"65","000","00","008","0805","0000","545","415","130","39","584","934","0","62.53","44.43"
"65","000","00","008","0805","1731","545","415","130","39","584","934","0","62.53","44.43"
"65","000","00","008","0806","0000","272","215","57","21","293","515","0","56.89","41.75"
"65","000","00","008","0806","1725","272","215","57","21","293","515","0","56.89","41.75"
"65","000","00","008","0807","0000","797","614","183","51","848","1440","0","58.89","42.64"
"65","000","00","008","0807","1750","797","614","183","51","848","1440","0","58.89","42.64"
"65","000","00","008","0808","0000","3860","2979","881","252","4112","7315","0","56.21","40.72"
"65","000","00","008","0808","1751","919","695","224","70","989","1809","0","54.67","38.42"
"65","000","00","008","0808","1752","920","728","192","65","985","1758","0","56.03","41.41"
"65","000","00","008","0808","1753","817","626","191","47","864","1589","0","54.37","39.4"
"65","000","00","008","0808","1754","597","457","140","34","631","1067","0","59.14","42.83"
"65","000","00","008","0808","1755","607","473","134","36","643","1092","0","58.88","43.32"
"65","000","00","008","0809","0000","1507","1137","370","116","1623","3208","0","50.59","35.44"
"65","000","00","008","0809","1747","465","350","115","35","500","942","0","53.08","37.15"
"65","000","00","008","0809","1748","643","475","168","57","700","1317","0","53.15","36.07"
"65","000","00","008","0809","1749","399","312","87","24","423","949","0","44.57","32.88"
"65","000","00","008","0810","0000","3058","2408","650","203","3261","6702","0","48.66","35.93"
"65","000","00","008","0810","1743","818","676","142","47","865","1737","0","49.8","38.92"
"65","000","00","008","0810","1744","778","621","157","57","835","1669","0","50.03","37.21"
"65","000","00","008","0810","1745","782","603","179","43","825","1842","0","44.79","32.74"
"65","000","00","008","0810","1746","680","508","172","56","736","1454","0","50.62","34.94"
"65","000","00","008","0811","0000","3278","2542","736","205","3483","7102","0","49.04","35.79"
"65","000","00","008","0811","1739","859","673","186","52","911","1782","0","51.12","37.77"
"65","000","00","008","0811","1740","746","591","155","45","791","1496","0","52.87","39.51"
"65","000","00","008","0811","1741","945","719","226","47","992","2071","0","47.9","34.72"
"65","000","00","008","0811","1742","728","559","169","61","789","1753","0","45.01","31.89"
"65","000","00","008","0812","0000","350","272","78","29","379","850","0","44.59","32.0"
"65","000","00","008","0812","1738","350","272","78","29","379","850","0","44.59","32.0"
"65","000","00","008","0813","0000","97","76","21","5","102","227","0","44.93","33.48"
"65","000","00","008","0813","1774","97","76","21","5","102","227","0","44.93","33.48"
"65","000","00","008","0814","0000","2193","1699","494","183","2376","4604","0","51.61","36.9"
"65","000","00","008","0814","1768","612","481","131","66","678","1479","0","45.84","32.52"
"65","000","00","008","0814","1769","832","642","190","59","891","1736","0","51.32","36.98"
"65","000","00","008","0814","1770","749","576","173","58","807","1389","0","58.1","41.47"
"65","000","00","008","0815","0000","1871","1467","404","143","2014","4064","0","49.56","36.1"
"65","000","00","008","0815","1762","455","364","91","28","483","1026","0","47.08","35.48"
"65","000","00","008","0815","1763","798","634","164","44","842","1721","0","48.93","36.84"
"65","000","00","008","0815","1764","618","469","149","71","689","1317","0","52.32","35.61"
"65","000","00","008","0816","0000","1825","1361","464","168","1993","3526","0","56.52","38.6"
"65","000","00","008","0816","1765","574","445","129","52","626","1046","0","59.85","42.54"
"65","000","00","008","0816","1766","631","457","174","56","687","1144","0","60.05","39.95"
"65","000","00","008","0816","1767","620","459","161","60","680","1336","0","50.9","34.36"
"65","000","00","008","0817","0000","2274","1825","449","157","2431","4249","0","57.21","42.95"
"65","000","00","008","0817","1756","900","739","161","51","951","1730","0","54.97","42.72"
"65","000","00","008","0817","1757","660","533","127","53","713","1281","0","55.66","41.61"
"65","000","00","008","0817","1758","714","553","161","53","767","1238","0","61.95","44.67"
"65","000","00","008","0818","0000","2229","1800","429","177","2406","5137","0","46.84","35.04"
"65","000","00","008","0818","1771","848","765","83","82","930","1956","0","47.55","39.11"
"65","000","00","008","0818","1772","695","492","203","49","744","1371","0","54.27","35.89"
"65","000","00","008","0818","1773","686","543","143","46","732","1810","0","40.44","30.0"
"65","000","00","008","0819","0000","1888","1450","438","156","2044","4022","0","50.82","36.05"
"65","000","00","008","0819","1759","796","604","192","73","869","1568","0","55.42","38.52"
"65","000","00","008","0819","1760","632","504","128","53","685","1271","0","53.89","39.65"
"65","000","00","008","0819","1761","460","342","118","30","490","1183","0","41.42","28.91"
"65","000","00","008","0820","0000","2875","2221","654","170","3045","5986","0","50.87","37.1"
"65","000","00","008","0820","1735","1020","783","237","100","1120","2052","0","54.58","38.16"
"65","000","00","008","0820","1736","866","679","187","39","905","1977","0","45.78","34.34"
"65","000","00","008","0820","1737","989","759","230","31","1020","1957","0","52.12","38.78"
"65","000","00","009","0000","0000","45824","35620","10204","3252","49076","94291","115712","52.05","37.78"
"65","000","00","009","0901","0000","164","115","49","22","186","274","0","67.88","41.97"
"65","000","00","009","0901","1917","164","115","49","22","186","274","0","67.88","41.97"
"65","000","00","009","0902","0000","290","213","77","32","322","583","0","55.23","36.54"
"65","000","00","009","0902","1918","290","213","77","32","322","583","0","55.23","36.54"
"65","000","00","009","0903","0000","1588","1177","411","78","1666","3479","0","47.89","33.83"
"65","000","00","009","0903","1919","740","547","193","22","762","1765","0","43.17","30.99"
"65","000","00","009","0903","1920","848","630","218","56","904","1714","0","52.74","36.76"
"65","000","00","009","0904","0000","1345","1074","271","77","1422","2684","0","52.98","40.01"
"65","000","00","009","0904","1921","644","517","127","33","677","1355","0","49.96","38.15"
"65","000","00","009","0904","1922","701","557","144","44","745","1329","0","56.06","41.91"
"65","000","00","009","0905","0000","505","372","133","49","554","1059","0","52.31","35.13"
"65","000","00","009","0905","1923","505","372","133","49","554","1059","0","52.31","35.13"
"65","000","00","009","0906","0000","3327","2504","823","280","3607","6529","0","55.25","38.35"
"65","000","00","009","0906","1924","723","536","187","59","782","1364","0","57.33","39.3"
"65","000","00","009","0906","1925","593","416","177","53","646","1098","0","58.83","37.89"
"65","000","00","009","0906","1926","653","526","127","56","709","1296","0","54.71","40.59"
"65","000","00","009","0906","1927","599","450","149","63","662","1240","0","53.39","36.29"
"65","000","00","009","0906","1928","759","576","183","49","808","1531","0","52.78","37.62"
"65","000","00","009","0907","0000","2415","1890","525","183","2598","5025","0","51.7","37.61"
"65","000","00","009","0907","1952","762","604","158","61","823","1634","0","50.37","36.96"
"65","000","00","009","0907","1953","853","656","197","58","911","1716","0","53.09","38.23"
"65","000","00","009","0907","1954","800","630","170","64","864","1675","0","51.58","37.61"
"65","000","00","009","0908","0000","4028","3087","941","295","4323","8724","0","49.55","35.39"
"65","000","00","009","0908","1929","652","525","127","42","694","1444","0","48.06","36.36"
"65","000","00","009","0908","1930","661","509","152","69","730","1347","0","54.19","37.79"
"65","000","00","009","0908","1931","725","525","200","53","778","1455","0","53.47","36.08"
"65","000","00","009","0908","1932","667","523","144","38","705","1556","0","45.31","33.61"
"65","000","00","009","0908","1933","557","407","150","39","596","1390","0","42.88","29.28"
"65","000","00","009","0908","1934","766","598","168","54","820","1532","0","53.52","39.03"
"65","000","00","009","0909","0000","3989","3159","830","212","4201","8053","0","52.17","39.23"
"65","000","00","009","0909","1935","610","466","144","64","674","1377","0","48.95","33.84"
"65","000","00","009","0909","1936","835","663","172","59","894","1731","0","51.65","38.3"
"65","000","00","009","0909","1937","818","635","183","31","849","1705","0","49.79","37.24"
"65","000","00","009","0909","1938","828","666","162","33","861","1590","0","54.15","41.89"
"65","000","00","009","0909","1939","898","729","169","25","923","1650","0","55.94","44.18"
"65","000","00","009","0910","0000","1682","1315","367","184","1866","3638","0","51.29","36.15"
"65","000","00","009","0910","1966","556","424","132","74","630","1389","0","45.36","30.53"
"65","000","00","009","0910","1967","592","447","145","75","667","1315","0","50.72","33.99"
"65","000","00","009","0910","1968","534","444","90","35","569","934","0","60.92","47.54"
"65","000","00","009","0911","0000","968","719","249","83","1051","2199","0","47.79","32.7"
"65","000","00","009","0911","1969","559","423","136","35","594","1270","0","46.77","33.31"
"65","000","00","009","0911","1970","409","296","113","48","457","929","0","49.19","31.86"
"65","000","00","009","0912","0000","484","372","112","19","503","1035","0","48.6","35.94"
"65","000","00","009","0912","1971","484","372","112","19","503","1035","0","48.6","35.94"
"65","000","00","009","0913","0000","196","158","38","24","220","502","0","43.82","31.47"
"65","000","00","009","0913","1972","196","158","38","24","220","502","0","43.82","31.47"
"65","000","00","009","0914","0000","352","263","89","55","407","836","0","48.68","31.46"
"65","000","00","009","0914","1973","352","263","89","55","407","836","0","48.68","31.46"
"65","000","00","009","0915","0000","272","204","68","55","327","669","0","48.88","30.49"
"65","000","00","009","0915","1974","272","204","68","55","327","669","0","48.88","30.49"
"65","000","00","009","0916","0000","360","260","100","71","431","733","0","58.8","35.47"
"65","000","00","009","0916","1975","360","260","100","71","431","733","0","58.8","35.47"
"65","000","00","009","0917","0000","1032","760","272","75","1107","2138","0","51.78","35.55"
"65","000","00","009","0917","1979","401","293","108","43","444","771","0","57.59","38.0"
"65","000","00","009","0917","1980","631","467","164","32","663","1367","0","48.5","34.16"
"65","000","00","009","0918","0000","611","469","142","48","659","1394","0","47.27","33.64"
"65","000","00","009","0918","1978","611","469","142","48","659","1394","0","47.27","33.64"
"65","000","00","009","0919","0000","1260","974","286","96","1356","2761","0","49.11","35.28"
"65","000","00","009","0919","1981","585","449","136","59","644","1241","0","51.89","36.18"
"65","000","00","009","0919","1982","675","525","150","37","712","1520","0","46.84","34.54"
"65","000","00","009","0920","0000","505","387","118","52","557","873","0","63.8","44.33"
"65","000","00","009","0920","1983","505","387","118","52","557","873","0","63.8","44.33"
"65","000","00","009","0921","0000","505","390","115","66","571","1322","0","43.19","29.5"
"65","000","00","009","0921","1986","505","390","115","66","571","1322","0","43.19","29.5"
"65","000","00","009","0922","0000","769","567","202","115","884","1865","0","47.4","30.4"
"65","000","00","009","0922","1984","296","207","89","77","373","768","0","48.57","26.95"
"65","000","00","009","0922","1985","473","360","113","38","511","1097","0","46.58","32.82"
"65","000","00","009","0923","0000","2738","2106","632","191","2929","5947","0","49.25","35.41"
"65","000","00","009","0923","1959","658","509","149","70","728","1363","0","53.41","37.34"
"65","000","00","009","0923","1960","795","630","165","45","840","1624","0","51.72","38.79"
"65","000","00","009","0923","1961","703","541","162","52","755","1352","0","55.84","40.01"
"65","000","00","009","0923","1962","582","426","156","24","606","1608","0","37.69","26.49"
"65","000","00","009","0924","0000","3081","2379","702","226","3307","6635","0","49.84","35.86"
"65","000","00","009","0924","1955","668","513","155","51","719","1649","0","43.6","31.11"
"65","000","00","009","0924","1956","713","537","176","73","786","1489","0","52.79","36.06"
"65","000","00","009","0924","1957","814","650","164","50","864","1771","0","48.79","36.7"
"65","000","00","009","0924","1958","886","679","207","52","938","1726","0","54.35","39.34"
"65","000","00","009","0925","0000","2162","1662","500","215","2377","4629","0","51.35","35.9"
"65","000","00","009","0925","1963","715","561","154","63","778","1458","0","53.36","38.48"
"65","000","00","009","0925","1964","743","578","165","46","789","1641","0","48.08","35.22"
"65","000","00","009","0925","1965","704","523","181","106","810","1530","0","52.94","34.18"
"65","000","00","009","0926","0000","1672","1300","372","110","1782","3198","0","55.72","40.65"
"65","000","00","009","0926","1976","872","677","195","67","939","1560","0","60.19","43.4"
"65","000","00","009","0926","1977","800","623","177","43","843","1638","0","51.47","38.03"
"65","000","00","009","0927","0000","6615","5426","1189","229","6844","12019","0","56.94","45.15"
"65","000","00","009","0927","1944","833","678","155","24","857","1579","0","54.27","42.94"
"65","000","00","009","0927","1945","741","601","140","21","762","1435","0","53.1","41.88"
"65","000","00","009","0927","1946","937","769","168","32","969","1659","0","58.41","46.35"
"65","000","00","009","0927","1947","881","723","158","34","915","1512","0","60.52","47.82"
"65","000","00","009","0927","1948","805","654","151","42","847","1463","0","57.89","44.7"
"65","000","00","009","0927","1949","810","669","141","24","834","1465","0","56.93","45.67"
"65","000","00","009","0927","1950","814","679","135","21","835","1463","0","57.07","46.41"
"65","000","00","009","0927","1951","794","653","141","31","825","1443","0","57.17","45.25"
"65","000","00","009","0928","0000","2909","2318","591","110","3019","5488","0","55.01","42.24"
"65","000","00","009","0928","1940","753","601","152","29","782","1441","0","54.27","41.71"
"65","000","00","009","0928","1941","793","629","164","23","816","1404","0","58.12","44.8"
"65","000","00","009","0928","1942","737","592","145","33","770","1295","0","59.46","45.71"
"65","000","00","009","0928","1943","626","496","130","25","651","1348","0","48.29","36.8"
"65","000","00","010","0000","0000","72628","56884","15744","4275","76903","147272","172677","52.22","38.63"
"65","000","00","010","1001","0000","251","173","78","37","288","544","0","52.94","31.8"
"65","000","00","010","1001","0029","251","173","78","37","288","544","0","52.94","31.8"
"65","000","00","010","1002","0000","518","376","142","58","576","1044","0","55.17","36.02"
"65","000","00","010","1002","0030","518","376","142","58","576","1044","0","55.17","36.02"
"65","000","00","010","1003","0000","686","513","173","39","725","1462","0","49.59","35.09"
"65","000","00","010","1003","0031","686","513","173","39","725","1462","0","49.59","35.09"
"65","000","00","010","1004","0000","721","535","186","71","792","1525","0","51.93","35.08"
"65","000","00","010","1004","0032","721","535","186","71","792","1525","0","51.93","35.08"
"65","000","00","010","1005","0000","421","324","97","46","467","986","0","47.36","32.86"
"65","000","00","010","1005","0033","421","324","97","46","467","986","0","47.36","32.86"
"65","000","00","010","1006","0000","1159","907","252","122","1281","2516","0","50.91","36.05"
"65","000","00","010","1006","0035","583","447","136","73","656","1173","0","55.92","38.11"
"65","000","00","010","1006","0036","576","460","116","49","625","1343","0","46.54","34.25"
"65","000","00","010","1007","0000","414","332","82","33","447","806","0","55.46","41.19"
"65","000","00","010","1007","0034","414","332","82","33","447","806","0","55.46","41.19"
"65","000","00","010","1008","0000","5458","4433","1025","236","5694","12236","0","46.53","36.23"
"65","000","00","010","1008","0065","932","774","158","46","978","1837","0","53.24","42.13"
"65","000","00","010","1008","0066","629","501","128","22","651","1924","0","33.84","26.04"
"65","000","00","010","1008","0067","1122","904","218","35","1157","2340","0","49.44","38.63"
"65","000","00","010","1008","0068","738","596","142","51","789","1704","0","46.3","34.98"
"65","000","00","010","1008","0069","682","536","146","36","718","1363","0","52.68","39.33"
"65","000","00","010","1008","0070","1355","1122","233","46","1401","3068","0","45.66","36.57"
"65","000","00","010","1009","0000","703","560","143","40","743","1528","0","48.63","36.65"
"65","000","00","010","1009","0071","703","560","143","40","743","1528","0","48.63","36.65"
"65","000","00","010","1010","0000","3087","2447","640","191","3278","6351","0","51.61","38.53"
"65","000","00","010","1010","0079","710","566","144","71","781","1373","0","56.88","41.22"
"65","000","00","010","1010","0080","885","735","150","35","920","1732","0","53.12","42.44"
"65","000","00","010","1010","0081","711","548","163","51","762","1519","0","50.16","36.08"
"65","000","00","010","1010","0082","781","598","183","34","815","1727","0","47.19","34.63"
"65","000","00","010","1011","0000","2497","1968","529","184","2681","5041","0","53.18","39.04"
"65","000","00","010","1011","0072","743","568","175","59","802","1600","0","50.13","35.5"
"65","000","00","010","1011","0073","985","787","198","60","1045","1874","0","55.76","42.0"
"65","000","00","010","1011","0074","769","613","156","65","834","1567","0","53.22","39.12"
"65","000","00","010","1012","0000","4359","3443","916","197","4556","8417","0","54.13","40.91"
"65","000","00","010","1012","0093","918","753","165","45","963","1804","0","53.38","41.74"
"65","000","00","010","1012","0094","660","500","160","41","701","1322","0","53.03","37.82"
"65","000","00","010","1012","0095","1001","798","203","31","1032","2019","0","51.11","39.52"
"65","000","00","010","1012","0096","934","737","197","48","982","1696","0","57.9","43.46"
"65","000","00","010","1012","0097","846","655","191","32","878","1576","0","55.71","41.56"
"65","000","00","010","1013","0000","839","605","234","69","908","2027","0","44.8","29.85"
"65","000","00","010","1013","0037","457","342","115","33","490","1153","0","42.5","29.66"
"65","000","00","010","1013","0038","382","263","119","36","418","874","0","47.83","30.09"
"65","000","00","010","1014","0000","496","360","136","89","585","1063","0","55.03","33.87"
"65","000","00","010","1014","0039","496","360","136","89","585","1063","0","55.03","33.87"
"65","000","00","010","1015","0000","582","448","134","43","625","1309","0","47.75","34.22"
"65","000","00","010","1015","0040","582","448","134","43","625","1309","0","47.75","34.22"
"65","000","00","010","1016","0000","643","487","156","48","691","1290","0","53.57","37.75"
"65","000","00","010","1016","0041","643","487","156","48","691","1290","0","53.57","37.75"
"65","000","00","010","1017","0000","3251","2526","725","160","3411","6129","0","55.65","41.21"
"65","000","00","010","1017","0042","903","716","187","34","937","1675","0","55.94","42.75"
"65","000","00","010","1017","0043","838","636","202","42","880","1589","0","55.38","40.03"
"65","000","00","010","1017","0044","892","693","199","48","940","1624","0","57.88","42.67"
"65","000","00","010","1017","0045","618","481","137","36","654","1241","0","52.7","38.76"
"65","000","00","010","1018","0000","2946","2367","579","174","3120","5578","0","55.93","42.43"
"65","000","00","010","1018","0046","642","493","149","62","704","1317","0","53.45","37.43"
"65","000","00","010","1018","0047","670","588","82","22","692","1225","0","56.49","48.0"
"65","000","00","010","1018","0048","747","596","151","41","788","1426","0","55.26","41.8"
"65","000","00","010","1018","0049","887","690","197","49","936","1610","0","58.14","42.86"
"65","000","00","010","1019","0000","3233","2487","746","227","3460","6426","0","53.84","38.7"
"65","000","00","010","1019","0052","870","652","218","52","922","1822","0","50.6","35.78"
"65","000","00","010","1019","0053","667","496","171","71","738","1232","0","59.9","40.26"
"65","000","00","010","1019","0054","832","655","177","71","903","1588","0","56.86","41.25"
"65","000","00","010","1019","0055","864","684","180","33","897","1784","0","50.28","38.34"
"65","000","00","010","1020","0000","2605","2036","569","152","2757","5205","0","52.97","39.12"
"65","000","00","010","1020","0056","857","639","218","68","925","1762","0","52.5","36.27"
"65","000","00","010","1020","0057","778","595","183","41","819","1546","0","52.98","38.49"
"65","000","00","010","1020","0058","970","802","168","43","1013","1897","0","53.4","42.28"
"65","000","00","010","1021","0000","4588","3640","948","197","4785","9332","0","51.28","39.01"
"65","000","00","010","1021","0059","757","606","151","41","798","1489","0","53.59","40.7"
"65","000","00","010","1021","0060","812","640","172","43","855","1679","0","50.92","38.12"
"65","000","00","010","1021","0061","801","622","179","39","840","1693","0","49.62","36.74"
"65","000","00","010","1021","0062","779","628","151","23","802","1674","0","47.91","37.51"
"65","000","00","010","1021","0063","696","547","149","28","724","1330","0","54.44","41.13"
"65","000","00","010","1021","0064","743","597","146","23","766","1467","0","52.22","40.7"
"65","000","00","010","1022","0000","2878","2221","657","154","3032","5459","0","55.54","40.69"
"65","000","00","010","1022","0098","950","747","203","43","993","1781","0","55.76","41.94"
"65","000","00","010","1022","0099","922","706","216","48","970","1665","0","58.26","42.4"
"65","000","00","010","1022","0100","1006","768","238","63","1069","2013","0","53.1","38.15"
"65","000","00","010","1023","0000","1847","1454","393","102","1949","3659","0","53.27","39.74"
"65","000","00","010","1023","0106","569","436","133","29","598","1289","0","46.39","33.82"
"65","000","00","010","1023","0107","734","583","151","49","783","1319","0","59.36","44.2"
"65","000","00","010","1023","0108","544","435","109","24","568","1051","0","54.04","41.39"
"65","000","00","010","1024","0000","682","537","145","35","717","1348","0","53.19","39.84"
"65","000","00","010","1024","0109","682","537","145","35","717","1348","0","53.19","39.84"
"65","000","00","010","1025","0000","527","400","127","37","564","1106","0","50.99","36.17"
"65","000","00","010","1025","0110","527","400","127","37","564","1106","0","50.99","36.17"
"65","000","00","010","1026","0000","390","301","89","28","418","717","0","58.3","41.98"
"65","000","00","010","1026","0111","390","301","89","28","418","717","0","58.3","41.98"
"65","000","00","010","1027","0000","680","517","163","34","714","1385","0","51.55","37.33"
"65","000","00","010","1027","0112","680","517","163","34","714","1385","0","51.55","37.33"
"65","000","00","010","1028","0000","466","342","124","36","502","841","0","59.69","40.67"
"65","000","00","010","1028","0113","466","342","124","36","502","841","0","59.69","40.67"
"65","000","00","010","1029","0000","351","272","79","27","378","665","0","56.84","40.9"
"65","000","00","010","1029","0114","351","272","79","27","378","665","0","56.84","40.9"
"65","000","00","010","1030","0000","231","173","58","19","250","419","0","59.67","41.29"
"65","000","00","010","1030","0115","231","173","58","19","250","419","0","59.67","41.29"
"65","000","00","010","1031","0000","845","660","185","29","874","1599","0","54.66","41.28"
"65","000","00","010","1031","0116","845","660","185","29","874","1599","0","54.66","41.28"
"65","000","00","010","1032","0000","2458","1896","562","164","2622","4930","0","53.18","38.46"
"65","000","00","010","1032","0117","830","642","188","50","880","1670","0","52.69","38.44"
"65","000","00","010","1032","0118","896","689","207","55","951","1683","0","56.51","40.94"
"65","000","00","010","1032","0119","732","565","167","59","791","1577","0","50.16","35.83"
"65","000","00","010","1033","0000","1748","1383","365","96","1844","3832","0","48.12","36.09"
"65","000","00","010","1033","0120","765","598","167","51","816","1618","0","50.43","36.96"
"65","000","00","010","1033","0121","983","785","198","45","1028","2214","0","46.43","35.46"
"65","000","00","010","1034","0000","1905","1504","401","142","2047","3750","0","54.59","40.11"
"65","000","00","010","1034","0083","678","541","137","32","710","1297","0","54.74","41.71"
"65","000","00","010","1034","0084","516","398","118","53","569","1066","0","53.38","37.34"
"65","000","00","010","1034","0085","711","565","146","57","768","1387","0","55.37","40.74"
"65","000","00","010","1035","0000","3671","2878","793","194","3865","7408","0","52.17","38.85"
"65","000","00","010","1035","0086","985","742","243","51","1036","1909","0","54.27","38.87"
"65","000","00","010","1035","0087","900","685","215","47","947","1770","0","53.5","38.7"
"65","000","00","010","1035","0088","920","768","152","57","977","2049","0","47.68","37.48"
"65","000","00","010","1035","0089","866","683","183","39","905","1680","0","53.87","40.65"
"65","000","00","010","1036","0000","2282","1788","494","141","2423","4250","0","57.01","42.07"
"65","000","00","010","1036","0090","785","602","183","60","845","1433","0","58.97","42.01"
"65","000","00","010","1036","0091","689","534","155","32","721","1365","0","52.82","39.12"
"65","000","00","010","1036","0092","808","652","156","49","857","1452","0","59.02","44.9"
"65","000","00","010","1037","0000","2067","1680","387","91","2158","4020","0","53.68","41.79"
"65","000","00","010","1037","0077","1048","857","191","44","1092","1992","0","54.82","43.02"
"65","000","00","010","1037","0078","1019","823","196","47","1066","2028","0","52.56","40.58"
"65","000","00","010","1038","0000","1251","969","282","76","1327","2456","0","54.03","39.45"
"65","000","00","010","1038","0075","648","506","142","50","698","1245","0","56.06","40.64"
"65","000","00","010","1038","0076","603","463","140","26","629","1211","0","51.94","38.23"
"65","000","00","010","1039","0000","1885","1439","446","86","1971","3906","0","50.46","36.84"
"65","000","00","010","1039","0050","1040","797","243","36","1076","1982","0","54.29","40.21"
"65","000","00","010","1039","0051","845","642","203","50","895","1924","0","46.52","33.37"
"65","000","00","010","1040","0000","1835","1405","430","101","1936","3612","0","53.6","38.9"
"65","000","00","010","1040","0101","558","411","147","36","594","1108","0","53.61","37.09"
"65","000","00","010","1040","0102","664","531","133","49","713","1305","0","54.64","40.69"
"65","000","00","010","1040","0103","613","463","150","16","629","1199","0","52.46","38.62"
"65","000","00","010","1041","0000","1974","1510","464","122","2096","4142","0","50.6","36.46"
"65","000","00","010","1041","0104","1004","767","237","60","1064","2017","0","52.75","38.03"
"65","000","00","010","1041","0105","970","743","227","62","1032","2125","0","48.56","34.96"
"65","000","00","010","1042","0000","3198","2588","610","148","3346","6953","0","48.12","37.22"
"65","000","00","010","1042","0122","892","694","198","55","947","1832","0","51.69","37.88"
"65","000","00","010","1042","0123","1042","824","218","66","1108","2123","0","52.19","38.81"
"65","000","00","010","1042","0124","1264","1070","194","27","1291","2998","0","43.06","35.69"
"65","000","00","011","0000","0000","85461","66826","18635","5764","91225","173831","200217","52.48","38.44"
"65","000","00","011","1101","0000","662","531","131","44","706","1262","0","55.94","42.08"
"65","000","00","011","1101","2337","662","531","131","44","706","1262","0","55.94","42.08"
"65","000","00","011","1102","0000","477","350","127","64","541","917","0","59.0","38.17"
"65","000","00","011","1102","2338","477","350","127","64","541","917","0","59.0","38.17"
"65","000","00","011","1103","0000","2123","1659","464","128","2251","4156","0","54.16","39.92"
"65","000","00","011","1103","2339","1006","800","206","61","1067","1929","0","55.31","41.47"
"65","000","00","011","1103","2340","1117","859","258","67","1184","2227","0","53.17","38.57"
"65","000","00","011","1104","0000","153","113","40","20","173","322","0","53.73","35.09"
"65","000","00","011","1104","2343","153","113","40","20","173","322","0","53.73","35.09"
"65","000","00","011","1105","0000","1232","963","269","97","1329","2564","0","51.83","37.56"
"65","000","00","011","1105","2373","610","475","135","56","666","1244","0","53.54","38.18"
"65","000","00","011","1105","2374","622","488","134","41","663","1320","0","50.23","36.97"
"65","000","00","011","1106","0000","1693","1288","405","130","1823","4797","0","38.0","26.85"
"65","000","00","011","1106","2350","328","240","88","28","356","1809","0","19.68","13.27"
"65","000","00","011","1106","2351","694","520","174","36","730","1601","0","45.6","32.48"
"65","000","00","011","1106","2352","671","528","143","66","737","1387","0","53.14","38.07"
"65","000","00","011","1107","0000","2364","1824","540","125","2489","4840","0","51.43","37.69"
"65","000","00","011","1107","2344","777","584","193","7","784","1460","0","53.7","40.0"
"65","000","00","011","1107","2345","814","618","196","63","877","1719","0","51.02","35.95"
"65","000","00","011","1107","2346","773","622","151","55","828","1661","0","49.85","37.45"
"65","000","00","011","1108","0000","3235","2572","663","140","3375","6144","0","54.93","41.86"
"65","000","00","011","1108","2355","1067","830","237","44","1111","2072","0","53.62","40.06"
"65","000","00","011","1108","2356","1175","942","233","56","1231","2120","0","58.07","44.43"
"65","000","00","011","1108","2357","993","800","193","40","1033","1952","0","52.92","40.98"
"65","000","00","011","1109","0000","1837","1386","451","183","2020","3964","0","50.96","34.96"
"65","000","00","011","1109","2365","641","509","132","77","718","1363","0","52.68","37.34"
"65","000","00","011","1109","2366","645","470","175","52","697","1368","0","50.95","34.36"
"65","000","00","011","1109","2367","551","407","144","54","605","1233","0","49.07","33.01"
"65","000","00","011","1110","0000","686","535","151","51","737","1481","0","49.76","36.12"
"65","000","00","011","1110","2378","686","535","151","51","737","1481","0","49.76","36.12"
"65","000","00","011","1111","0000","703","541","162","66","769","1497","0","51.37","36.14"
"65","000","00","011","1111","2379","703","541","162","66","769","1497","0","51.37","36.14"
"65","000","00","011","1112","0000","1866","1498","368","96","1962","3940","0","49.8","38.02"
"65","000","00","011","1112","2381","893","721","172","55","948","1913","0","49.56","37.69"
"65","000","00","011","1112","2382","973","777","196","41","1014","2027","0","50.02","38.33"
"65","000","00","011","1113","0000","981","765","216","70","1051","2127","0","49.41","35.97"
"65","000","00","011","1113","2385","981","765","216","70","1051","2127","0","49.41","35.97"
"65","000","00","011","1114","0000","2454","1878","576","191","2645","5447","0","48.56","34.48"
"65","000","00","011","1114","2386","719","545","174","56","775","1642","0","47.2","33.19"
"65","000","00","011","1114","2387","924","724","200","73","997","1912","0","52.14","37.87"
"65","000","00","011","1114","2388","811","609","202","62","873","1893","0","46.12","32.17"
"65","000","00","011","1115","0000","2086","1622","464","201","2287","4554","0","50.22","35.62"
"65","000","00","011","1115","2389","645","482","163","69","714","1466","0","48.7","32.88"
"65","000","00","011","1115","2390","705","568","137","87","792","1538","0","51.5","36.93"
"65","000","00","011","1115","2391","736","572","164","45","781","1550","0","50.39","36.9"
"65","000","00","011","1116","0000","664","492","172","68","732","1456","0","50.27","33.79"
"65","000","00","011","1116","2392","664","492","172","68","732","1456","0","50.27","33.79"
"65","000","00","011","1117","0000","514","395","119","58","572","947","0","60.4","41.71"
"65","000","00","011","1117","2393","514","395","119","58","572","947","0","60.4","41.71"
"65","000","00","011","1118","0000","830","627","203","28","858","1988","0","43.16","31.54"
"65","000","00","011","1118","2400","830","627","203","28","858","1988","0","43.16","31.54"
"65","000","00","011","1119","0000","1785","1291","494","201","1986","4055","0","48.98","31.84"
"65","000","00","011","1119","2395","908","661","247","118","1026","2043","0","50.22","32.35"
"65","000","00","011","1119","2396","877","630","247","83","960","2012","0","47.71","31.31"
"65","000","00","011","1120","0000","2755","2168","587","233","2988","5100","0","58.59","42.51"
"65","000","00","011","1120","2431","706","551","155","59","765","1335","0","57.3","41.27"
"65","000","00","011","1120","2432","750","601","149","56","806","1324","0","60.88","45.39"
"65","000","00","011","1120","2433","706","564","142","75","781","1286","0","60.73","43.86"
"65","000","00","011","1120","2434","593","452","141","43","636","1155","0","55.06","39.13"
"65","000","00","011","1121","0000","1671","1300","371","106","1777","3847","0","46.19","33.79"
"65","000","00","011","1121","2363","813","633","180","55","868","1941","0","44.72","32.61"
"65","000","00","011","1121","2364","858","667","191","51","909","1906","0","47.69","34.99"
"65","000","00","011","1122","0000","2134","1642","492","187","2321","4215","0","55.07","38.96"
"65","000","00","011","1122","2438","1094","832","262","110","1204","2184","0","55.13","38.1"
"65","000","00","011","1122","2439","1040","810","230","77","1117","2031","0","55.0","39.88"
"65","000","00","011","1123","0000","287","223","64","17","304","556","0","54.68","40.11"
"65","000","00","011","1123","2380","287","223","64","17","304","556","0","54.68","40.11"
"65","000","00","011","1124","0000","1731","1343","388","141","1872","3336","0","56.12","40.26"
"65","000","00","011","1124","2440","901","700","201","77","978","1759","0","55.6","39.8"
"65","000","00","011","1124","2441","830","643","187","64","894","1577","0","56.69","40.77"
"65","000","00","011","1125","0000","1423","1136","287","69","1492","2765","0","53.96","41.08"
"65","000","00","011","1125","2442","684","542","142","24","708","1364","0","51.91","39.74"
"65","000","00","011","1125","2443","739","594","145","45","784","1401","0","55.96","42.4"
"65","000","00","011","1126","0000","3200","2463","737","230","3430","6938","0","49.44","35.5"
"65","000","00","011","1126","2411","838","651","187","49","887","1765","0","50.25","36.88"
"65","000","00","011","1126","2412","759","587","172","36","795","1815","0","43.8","32.34"
"65","000","00","011","1126","2413","812","605","207","63","875","1778","0","49.21","34.03"
"65","000","00","011","1126","2414","791","620","171","82","873","1580","0","55.25","39.24"
"65","000","00","011","1127","0000","2611","2034","577","129","2740","5304","0","51.66","38.35"
"65","000","00","011","1127","2422","932","708","224","52","984","2035","0","48.35","34.79"
"65","000","00","011","1127","2423","923","709","214","57","980","1895","0","51.72","37.41"
"65","000","00","011","1127","2424","756","617","139","20","776","1374","0","56.48","44.91"
"65","000","00","011","1128","0000","774","592","182","85","859","1595","0","53.86","37.12"
"65","000","00","011","1128","2336","774","592","182","85","859","1595","0","53.86","37.12"
"65","000","00","011","1129","0000","3137","2500","637","165","3302","6514","0","50.69","38.38"
"65","000","00","011","1129","2405","748","606","142","28","776","1511","0","51.36","40.11"
"65","000","00","011","1129","2406","769","608","161","35","804","1691","0","47.55","35.96"
"65","000","00","011","1129","2407","822","654","168","44","866","1636","0","52.93","39.98"
"65","000","00","011","1129","2408","798","632","166","58","856","1676","0","51.07","37.71"
"65","000","00","011","1130","0000","3544","2786","758","264","3808","7292","0","52.22","38.21"
"65","000","00","011","1130","2401","1041","831","210","50","1091","2198","0","49.64","37.81"
"65","000","00","011","1130","2402","812","619","193","58","870","1712","0","50.82","36.16"
"65","000","00","011","1130","2403","941","742","199","68","1009","1806","0","55.87","41.09"
"65","000","00","011","1130","2404","750","594","156","88","838","1576","0","53.17","37.69"
"65","000","00","011","1131","0000","2418","1892","526","180","2598","4725","0","54.98","40.04"
"65","000","00","011","1131","2358","807","636","171","71","878","1654","0","53.08","38.45"
"65","000","00","011","1131","2359","696","536","160","62","758","1444","0","52.49","37.12"
"65","000","00","011","1131","2360","915","720","195","47","962","1627","0","59.13","44.25"
"65","000","00","011","1132","0000","1879","1475","404","112","1991","3817","0","52.16","38.64"
"65","000","00","011","1132","2361","839","643","196","68","907","1751","0","51.8","36.72"
"65","000","00","011","1132","2362","1040","832","208","44","1084","2066","0","52.47","40.27"
"65","000","00","011","1133","0000","2169","1727","442","139","2308","4604","0","50.13","37.51"
"65","000","00","011","1133","2397","632","515","117","38","670","1471","0","45.55","35.01"
"65","000","00","011","1133","2398","767","594","173","47","814","1603","0","50.78","37.06"
"65","000","00","011","1133","2399","770","618","152","54","824","1530","0","53.86","40.39"
"65","000","00","011","1134","0000","1410","1108","302","101","1511","2941","0","51.38","37.67"
"65","000","00","011","1134","2415","747","588","159","59","806","1516","0","53.17","38.79"
"65","000","00","011","1134","2416","663","520","143","42","705","1425","0","49.47","36.49"
"65","000","00","011","1135","0000","1448","1141","307","88","1536","2824","0","54.39","40.4"
"65","000","00","011","1135","2417","724","578","146","34","758","1388","0","54.61","41.64"
"65","000","00","011","1135","2418","724","563","161","54","778","1436","0","54.18","39.21"
"65","000","00","011","1136","0000","2224","1755","469","107","2331","4624","0","50.41","37.95"
"65","000","00","011","1136","2419","788","627","161","51","839","1591","0","52.73","39.41"
"65","000","00","011","1136","2420","779","596","183","32","811","1639","0","49.48","36.36"
"65","000","00","011","1136","2421","657","532","125","24","681","1394","0","48.85","38.16"
"65","000","00","011","1137","0000","1854","1470","384","100","1954","3176","0","61.52","46.28"
"65","000","00","011","1137","2435","990","776","214","41","1031","1682","0","61.3","46.14"
"65","000","00","011","1137","2436","864","694","170","59","923","1494","0","61.78","46.45"
"65","000","00","011","1138","0000","626","463","163","73","699","1166","0","59.95","39.71"
"65","000","00","011","1138","2437","626","463","163","73","699","1166","0","59.95","39.71"
"65","000","00","011","1139","0000","2014","1586","428","93","2107","3753","0","56.14","42.26"
"65","000","00","011","1139","2444","651","481","170","42","693","1173","0","59.08","41.01"
"65","000","00","011","1139","2445","554","453","101","25","579","993","0","58.31","45.62"
"65","000","00","011","1139","2446","809","652","157","26","835","1587","0","52.61","41.08"
"65","000","00","011","1140","0000","1181","912","269","74","1255","2429","0","51.67","37.55"
"65","000","00","011","1140","2409","615","469","146","39","654","1264","0","51.74","37.1"
"65","000","00","011","1140","2410","566","443","123","35","601","1165","0","51.59","38.03"
"65","000","00","011","1141","0000","1258","1013","245","96","1354","2510","0","53.94","40.36"
"65","000","00","011","1141","2341","538","444","94","59","597","1143","0","52.23","38.85"
"65","000","00","011","1141","2342","720","569","151","37","757","1367","0","55.38","41.62"
"65","000","00","011","1142","0000","2141","1687","454","97","2238","4378","0","51.12","38.53"
"65","000","00","011","1142","2368","729","578","151","37","766","1554","0","49.29","37.19"
"65","000","00","011","1142","2369","808","628","180","36","844","1700","0","49.65","36.94"
"65","000","00","011","1142","2370","604","481","123","24","628","1124","0","55.87","42.79"
"65","000","00","011","1143","0000","3055","2457","598","170","3225","5763","0","55.96","42.63"
"65","000","00","011","1143","2427","809","661","148","42","851","1548","0","54.97","42.7"
"65","000","00","011","1143","2428","744","595","149","29","773","1350","0","57.26","44.07"
"65","000","00","011","1143","2429","780","616","164","34","814","1499","0","54.3","41.09"
"65","000","00","011","1143","2430","722","585","137","65","787","1366","0","57.61","42.83"
"65","000","00","011","1144","0000","485","357","128","20","505","923","0","54.71","38.68"
"65","000","00","011","1144","2394","485","357","128","20","505","923","0","54.71","38.68"
"65","000","00","011","1145","0000","2573","2083","490","166","2739","4938","0","55.47","42.18"
"65","000","00","011","1145","2347","846","671","175","53","899","1590","0","56.54","42.2"
"65","000","00","011","1145","2348","810","647","163","61","871","1599","0","54.47","40.46"
"65","000","00","011","1145","2349","917","765","152","52","969","1749","0","55.4","43.74"
"65","000","00","011","1146","0000","2006","1525","481","156","2162","3853","0","56.11","39.58"
"65","000","00","011","1146","2353","913","691","222","85","998","1779","0","56.1","38.84"
"65","000","00","011","1146","2354","1093","834","259","71","1164","2074","0","56.12","40.21"
"65","000","00","011","1147","0000","2424","1942","482","139","2563","4541","0","56.44","42.77"
"65","000","00","011","1147","2375","788","608","180","45","833","1473","0","56.55","41.28"
"65","000","00","011","1147","2376","934","764","170","56","990","1802","0","54.94","42.4"
"65","000","00","011","1147","2377","702","570","132","38","740","1266","0","58.45","45.02"
"65","000","00","011","1148","0000","2045","1614","431","129","2174","3950","0","55.04","40.86"
"65","000","00","011","1148","2371","1015","785","230","67","1082","1900","0","56.95","41.32"
"65","000","00","011","1148","2372","1030","829","201","62","1092","2050","0","53.27","40.44"
"65","000","00","011","1149","0000","1396","1127","269","48","1444","2373","0","60.85","47.49"
"65","000","00","011","1149","2425","602","482","120","20","622","1061","0","58.62","45.43"
"65","000","00","011","1149","2426","794","645","149","28","822","1312","0","62.65","49.16"
"65","000","00","011","1150","0000","1243","975","268","89","1332","2623","0","50.78","37.17"
"65","000","00","011","1150","2383","899","714","185","45","944","1927","0","48.99","37.05"
"65","000","00","011","1150","2384","344","261","83","44","388","696","0","55.75","37.5"
"65","000","00","012","0000","0000","15388","11889","3499","1389","16777","35036","40022","47.89","33.93"
"65","000","00","012","1201","0000","385","311","74","35","420","725","0","57.93","42.9"
"65","000","00","012","1201","2220","385","311","74","35","420","725","0","57.93","42.9"
"65","000","00","012","1202","0000","947","754","193","74","1021","1899","0","53.77","39.71"
"65","000","00","012","1202","2221","552","440","112","52","604","1074","0","56.24","40.97"
"65","000","00","012","1202","2222","395","314","81","22","417","825","0","50.55","38.06"
"65","000","00","012","1203","0000","643","502","141","32","675","1242","0","54.35","40.42"
"65","000","00","012","1203","2223","643","502","141","32","675","1242","0","54.35","40.42"
"65","000","00","012","1204","0000","752","568","184","81","833","1632","0","51.04","34.8"
"65","000","00","012","1204","2225","428","330","98","39","467","872","0","53.56","37.84"
"65","000","00","012","1204","2226","324","238","86","42","366","760","0","48.16","31.32"
"65","000","00","012","1205","0000","589","459","130","37","626","1330","0","47.07","34.51"
"65","000","00","012","1205","2227","589","459","130","37","626","1330","0","47.07","34.51"
"65","000","00","012","1206","0000","299","225","74","25","324","598","0","54.18","37.63"
"65","000","00","012","1206","2224","299","225","74","25","324","598","0","54.18","37.63"
"65","000","00","012","1207","0000","1653","1299","354","158","1811","3609","0","50.18","35.99"
"65","000","00","012","1207","2228","718","561","157","67","785","1683","0","46.64","33.33"
"65","000","00","012","1207","2229","476","386","90","50","526","980","0","53.67","39.39"
"65","000","00","012","1207","2230","459","352","107","41","500","946","0","52.85","37.21"
"65","000","00","012","1208","0000","494","358","136","63","557","1089","0","51.15","32.87"
"65","000","00","012","1208","2235","494","358","136","63","557","1089","0","51.15","32.87"
"65","000","00","012","1209","0000","681","514","167","53","734","1623","0","45.22","31.67"
"65","000","00","012","1209","2233","396","308","88","24","420","978","0","42.94","31.49"
"65","000","00","012","1209","2234","285","206","79","29","314","645","0","48.68","31.94"
"65","000","00","012","1210","0000","537","425","112","57","594","1291","0","46.01","32.92"
"65","000","00","012","1210","2245","317","258","59","46","363","673","0","53.94","38.34"
"65","000","00","012","1210","2246","220","167","53","11","231","618","0","37.38","27.02"
"65","000","00","012","1211","0000","799","612","187","109","908","1701","0","53.38","35.98"
"65","000","00","012","1211","2240","407","319","88","41","448","817","0","54.83","39.05"
"65","000","00","012","1211","2241","392","293","99","68","460","884","0","52.04","33.14"
"65","000","00","012","1212","0000","1293","1018","275","93","1386","2985","0","46.43","34.1"
"65","000","00","012","1212","2242","572","442","130","42","614","1333","0","46.06","33.16"
"65","000","00","012","1212","2243","226","191","35","7","233","607","0","38.39","31.47"
"65","000","00","012","1212","2244","495","385","110","44","539","1045","0","51.58","36.84"
"65","000","00","012","1213","0000","884","692","192","73","957","1923","0","49.77","35.99"
"65","000","00","012","1213","2247","461","371","90","31","492","1063","0","46.28","34.9"
"65","000","00","012","1213","2248","423","321","102","42","465","860","0","54.07","37.33"
"65","000","00","012","1214","0000","197","134","63","33","230","461","0","49.89","29.07"
"65","000","00","012","1214","2237","197","134","63","33","230","461","0","49.89","29.07"
"65","000","00","012","1215","0000","119","86","33","18","137","274","0","50.0","31.39"
"65","000","00","012","1215","2238","119","86","33","18","137","274","0","50.0","31.39"
"65","000","00","012","1216","0000","110","87","23","11","121","286","0","42.31","30.42"
"65","000","00","012","1216","2236","110","87","23","11","121","286","0","42.31","30.42"
"65","000","00","012","1217","0000","80","59","21","13","93","155","0","60.0","38.06"
"65","000","00","012","1217","2239","80","59","21","13","93","155","0","60.0","38.06"
"65","000","00","012","1218","0000","125","93","32","2","127","432","0","29.4","21.53"
"65","000","00","012","1218","2249","125","93","32","2","127","432","0","29.4","21.53"
"65","000","00","012","1219","0000","162","121","41","8","170","445","0","38.2","27.19"
"65","000","00","012","1219","2250","162","121","41","8","170","445","0","38.2","27.19"
"65","000","00","012","1220","0000","120","104","16","12","132","318","0","41.51","32.7"
"65","000","00","012","1220","2251","120","104","16","12","132","318","0","41.51","32.7"
"65","000","00","012","1221","0000","65","48","17","12","77","159","0","48.43","30.19"
"65","000","00","012","1221","2252","65","48","17","12","77","159","0","48.43","30.19"
"65","000","00","012","1222","0000","131","93","38","14","145","337","0","43.03","27.6"
"65","000","00","012","1222","2253","131","93","38","14","145","337","0","43.03","27.6"
"65","000","00","012","1223","0000","171","132","39","20","191","369","0","51.76","35.77"
"65","000","00","012","1223","2256","171","132","39","20","191","369","0","51.76","35.77"
"65","000","00","012","1224","0000","90","70","20","8","98","180","0","54.44","38.89"
"65","000","00","012","1224","2254","90","70","20","8","98","180","0","54.44","38.89"
"65","000","00","012","1225","0000","68","50","18","14","82","187","0","43.85","26.74"
"65","000","00","012","1225","2255","68","50","18","14","82","187","0","43.85","26.74"
"65","000","00","012","1226","0000","165","114","51","22","187","335","0","55.82","34.03"
"65","000","00","012","1226","2257","165","114","51","22","187","335","0","55.82","34.03"
"65","000","00","012","1227","0000","109","85","24","6","115","297","0","38.72","28.62"
"65","000","00","012","1227","2259","109","85","24","6","115","297","0","38.72","28.62"
"65","000","00","012","1228","0000","182","141","41","18","200","470","0","42.55","30.0"
"65","000","00","012","1228","2258","182","141","41","18","200","470","0","42.55","30.0"
"65","000","00","012","1229","0000","426","332","94","26","452","1241","0","36.42","26.75"
"65","000","00","012","1229","2262","426","332","94","26","452","1241","0","36.42","26.75"
"65","000","00","012","1230","0000","888","646","242","142","1030","1946","0","52.93","33.2"
"65","000","00","012","1230","2263","451","321","130","81","532","998","0","53.31","32.16"
"65","000","00","012","1230","2264","437","325","112","61","498","948","0","52.53","34.28"
"65","000","00","012","1231","0000","478","380","98","32","510","1308","0","38.99","29.05"
"65","000","00","012","1231","2265","478","380","98","32","510","1308","0","38.99","29.05"
"65","000","00","012","1232","0000","156","132","24","8","164","267","0","61.42","49.44"
"65","000","00","012","1232","2260","156","132","24","8","164","267","0","61.42","49.44"
"65","000","00","012","1233","0000","219","167","52","6","225","876","0","25.68","19.06"
"65","000","00","012","1233","2261","219","167","52","6","225","876","0","25.68","19.06"
"65","000","00","012","1234","0000","1371","1078","293","74","1445","3046","0","47.44","35.39"
"65","000","00","012","1234","2231","603","483","120","20","623","1375","0","45.31","35.13"
"65","000","00","012","1234","2232","768","595","173","54","822","1671","0","49.19","35.61"
"65","000","00","013","0000","0000","101496","78444","23052","8032","109528","200783","236964","54.55","39.07"
"65","000","00","013","1301","0000","1701","1325","376","158","1859","4869","0","38.18","27.21"
"65","000","00","013","1301","1799","498","378","120","51","549","2518","0","21.8","15.01"
"65","000","00","013","1301","1800","619","478","141","43","662","1218","0","54.35","39.24"
"65","000","00","013","1301","1801","584","469","115","64","648","1133","0","57.19","41.39"
"65","000","00","013","1302","0000","945","691","254","97","1042","1825","0","57.1","37.86"
"65","000","00","013","1302","1802","455","336","119","39","494","894","0","55.26","37.58"
"65","000","00","013","1302","1803","490","355","135","58","548","931","0","58.86","38.13"
"65","000","00","013","1303","0000","2813","2186","627","193","3006","5283","0","56.9","41.38"
"65","000","00","013","1303","1808","726","564","162","54","780","1378","0","56.6","40.93"
"65","000","00","013","1303","1809","767","571","196","60","827","1421","0","58.2","40.18"
"65","000","00","013","1303","1810","684","567","117","37","721","1340","0","53.81","42.31"
"65","000","00","013","1303","1811","636","484","152","42","678","1144","0","59.27","42.31"
"65","000","00","013","1304","0000","2424","1884","540","187","2611","4954","0","52.7","38.03"
"65","000","00","013","1304","1795","662","509","153","35","697","1292","0","53.95","39.4"
"65","000","00","013","1304","1796","614","486","128","32","646","1324","0","48.79","36.71"
"65","000","00","013","1304","1797","552","420","132","61","613","1155","0","53.07","36.36"
"65","000","00","013","1304","1798","596","469","127","59","655","1183","0","55.37","39.64"
"65","000","00","013","1305","0000","1111","937","174","41","1152","1820","0","63.3","51.48"
"65","000","00","013","1305","1804","1111","937","174","41","1152","1820","0","63.3","51.48"
"65","000","00","013","1306","0000","2118","1630","488","245","2363","4161","0","56.79","39.17"
"65","000","00","013","1306","1820","686","525","161","93","779","1356","0","57.45","38.72"
"65","000","00","013","1306","1821","762","599","163","77","839","1496","0","56.08","40.04"
"65","000","00","013","1306","1822","670","506","164","75","745","1309","0","56.91","38.66"
"65","000","00","013","1307","0000","2715","2013","702","273","2988","5067","0","58.97","39.73"
"65","000","00","013","1307","1816","633","476","157","67","700","1230","0","56.91","38.7"
"65","000","00","013","1307","1817","696","516","180","74","770","1342","0","57.38","38.45"
"65","000","00","013","1307","1818","684","492","192","60","744","1268","0","58.68","38.8"
"65","000","00","013","1307","1819","702","529","173","72","774","1227","0","63.08","43.11"
"65","000","00","013","1308","0000","1992","1551","441","173","2165","3900","0","55.51","39.77"
"65","000","00","013","1308","1827","590","437","153","75","665","1182","0","56.26","36.97"
"65","000","00","013","1308","1828","783","627","156","54","837","1558","0","53.72","40.24"
"65","000","00","013","1308","1829","619","487","132","44","663","1160","0","57.16","41.98"
"65","000","00","013","1309","0000","1541","1191","350","112","1653","2965","0","55.75","40.17"
"65","000","00","013","1309","1858","720","553","167","53","773","1445","0","53.49","38.27"
"65","000","00","013","1309","1859","821","638","183","59","880","1520","0","57.89","41.97"
"65","000","00","013","1310","0000","3960","3090","870","296","4256","7503","0","56.72","41.18"
"65","000","00","013","1310","1840","779","606","173","81","860","1576","0","54.57","38.45"
"65","000","00","013","1310","1841","773","587","186","62","835","1458","0","57.27","40.26"
"65","000","00","013","1310","1842","795","612","183","75","870","1517","0","57.35","40.34"
"65","000","00","013","1310","1843","810","647","163","41","851","1489","0","57.15","43.45"
"65","000","00","013","1310","1844","803","638","165","37","840","1463","0","57.42","43.61"
"65","000","00","013","1311","0000","1398","1067","331","158","1556","2821","0","55.16","37.82"
"65","000","00","013","1311","1830","698","530","168","66","764","1357","0","56.3","39.06"
"65","000","00","013","1311","1831","700","537","163","92","792","1464","0","54.1","36.68"
"65","000","00","013","1312","0000","3598","2777","821","267","3865","7204","0","53.65","38.55"
"65","000","00","013","1312","1875","721","534","187","60","781","1402","0","55.71","38.09"
"65","000","00","013","1312","1876","705","541","164","51","756","1379","0","54.82","39.23"
"65","000","00","013","1312","1877","706","557","149","49","755","1471","0","51.33","37.87"
"65","000","00","013","1312","1878","709","575","134","36","745","1410","0","52.84","40.78"
"65","000","00","013","1312","1879","757","570","187","71","828","1542","0","53.7","36.96"
"65","000","00","013","1313","0000","2551","1925","626","223","2774","5586","0","49.66","34.46"
"65","000","00","013","1313","1864","603","427","176","51","654","1337","0","48.92","31.94"
"65","000","00","013","1313","1865","522","389","133","60","582","1325","0","43.92","29.36"
"65","000","00","013","1313","1866","659","494","165","48","707","1390","0","50.86","35.54"
"65","000","00","013","1313","1867","767","615","152","64","831","1534","0","54.17","40.09"
"65","000","00","013","1314","0000","2049","1617","432","149","2198","3850","0","57.09","42.0"
"65","000","00","013","1314","1880","625","472","153","58","683","1238","0","55.17","38.13"
"65","000","00","013","1314","1881","616","497","119","57","673","1301","0","51.73","38.2"
"65","000","00","013","1314","1882","808","648","160","34","842","1311","0","64.23","49.43"
"65","000","00","013","1315","0000","707","530","177","79","786","1484","0","52.96","35.71"
"65","000","00","013","1315","1868","707","530","177","79","786","1484","0","52.96","35.71"
"65","000","00","013","1316","0000","3082","2426","656","286","3368","6156","0","54.71","39.41"
"65","000","00","013","1316","1869","689","537","152","105","794","1532","0","51.83","35.05"
"65","000","00","013","1316","1870","775","611","164","71","846","1507","0","56.14","40.54"
"65","000","00","013","1316","1871","820","648","172","51","871","1550","0","56.19","41.81"
"65","000","00","013","1316","1872","798","630","168","59","857","1567","0","54.69","40.2"
"65","000","00","013","1317","0000","3175","2437","738","285","3460","6530","0","52.99","37.32"
"65","000","00","013","1317","1892","635","475","160","68","703","1312","0","53.58","36.2"
"65","000","00","013","1317","1893","615","494","121","60","675","1301","0","51.88","37.97"
"65","000","00","013","1317","1894","608","449","159","57","665","1254","0","53.03","35.81"
"65","000","00","013","1317","1895","578","445","133","45","623","1215","0","51.28","36.63"
"65","000","00","013","1317","1896","739","574","165","55","794","1448","0","54.83","39.64"
"65","000","00","013","1318","0000","3143","2404","739","246","3389","6194","0","54.71","38.81"
"65","000","00","013","1318","1906","766","584","182","58","824","1550","0","53.16","37.68"
"65","000","00","013","1318","1907","837","626","211","74","911","1606","0","56.72","38.98"
"65","000","00","013","1318","1908","779","595","184","48","827","1509","0","54.8","39.43"
"65","000","00","013","1318","1909","761","599","162","66","827","1529","0","54.09","39.18"
"65","000","00","013","1319","0000","2275","1816","459","121","2396","4283","0","55.94","42.4"
"65","000","00","013","1319","1886","753","599","154","36","789","1335","0","59.1","44.87"
"65","000","00","013","1319","1887","756","609","147","49","805","1459","0","55.17","41.74"
"65","000","00","013","1319","1888","766","608","158","36","802","1489","0","53.86","40.83"
"65","000","00","013","1320","0000","2205","1672","533","184","2389","4330","0","55.17","38.61"
"65","000","00","013","1320","1792","620","462","158","73","693","1206","0","57.46","38.31"
"65","000","00","013","1320","1793","690","492","198","37","727","1255","0","57.93","39.2"
"65","000","00","013","1320","1794","895","718","177","74","969","1869","0","51.85","38.42"
"65","000","00","013","1321","0000","3599","2787","812","275","3874","7156","0","54.14","38.95"
"65","000","00","013","1321","1787","684","507","177","59","743","1424","0","52.18","35.6"
"65","000","00","013","1321","1788","714","546","168","70","784","1455","0","53.88","37.53"
"65","000","00","013","1321","1789","679","515","164","55","734","1419","0","51.73","36.29"
"65","000","00","013","1321","1790","765","612","153","46","811","1357","0","59.76","45.1"
"65","000","00","013","1321","1791","757","607","150","45","802","1501","0","53.43","40.44"
"65","000","00","013","1322","0000","2005","1535","470","156","2161","4013","0","53.85","38.25"
"65","000","00","013","1322","1784","658","517","141","47","705","1378","0","51.16","37.52"
"65","000","00","013","1322","1785","618","465","153","48","666","1256","0","53.03","37.02"
"65","000","00","013","1322","1786","729","553","176","61","790","1379","0","57.29","40.1"
"65","000","00","013","1323","0000","2176","1659","517","179","2355","4405","0","53.46","37.66"
"65","000","00","013","1323","1781","760","578","182","60","820","1499","0","54.7","38.56"
"65","000","00","013","1323","1782","726","570","156","49","775","1495","0","51.84","38.13"
"65","000","00","013","1323","1783","690","511","179","70","760","1411","0","53.86","36.22"
"65","000","00","013","1324","0000","2222","1700","522","191","2413","4638","0","52.03","36.65"
"65","000","00","013","1324","1778","721","536","185","80","801","1474","0","54.34","36.36"
"65","000","00","013","1324","1779","700","537","163","54","754","1489","0","50.64","36.06"
"65","000","00","013","1324","1780","801","627","174","57","858","1675","0","51.22","37.43"
"65","000","00","013","1325","0000","1390","1115","275","70","1460","2448","0","59.64","45.55"
"65","000","00","013","1325","1776","707","573","134","39","746","1242","0","60.06","46.14"
"65","000","00","013","1325","1777","683","542","141","31","714","1206","0","59.2","44.94"
"65","000","00","013","1326","0000","733","546","187","68","801","1505","0","53.22","36.28"
"65","000","00","013","1326","1775","733","546","187","68","801","1505","0","53.22","36.28"
"65","000","00","013","1327","0000","2338","1811","527","200","2538","4640","0","54.7","39.03"
"65","000","00","013","1327","1847","826","634","192","74","900","1598","0","56.32","39.67"
"65","000","00","013","1327","1848","709","540","169","87","796","1500","0","53.07","36.0"
"65","000","00","013","1327","1849","803","637","166","39","842","1542","0","54.6","41.31"
"65","000","00","013","1328","0000","2476","1919","557","160","2636","5032","0","52.38","38.14"
"65","000","00","013","1328","1835","834","652","182","68","902","1639","0","55.03","39.78"
"65","000","00","013","1328","1836","919","698","221","60","979","1728","0","56.66","40.39"
"65","000","00","013","1328","1837","723","569","154","32","755","1665","0","45.35","34.17"
"65","000","00","013","1329","0000","1614","1269","345","99","1713","3140","0","54.55","40.41"
"65","000","00","013","1329","1850","895","711","184","64","959","1619","0","59.23","43.92"
"65","000","00","013","1329","1851","719","558","161","35","754","1521","0","49.57","36.69"
"65","000","00","013","1330","0000","2061","1574","487","196","2257","3975","0","56.78","39.6"
"65","000","00","013","1330","1900","740","561","179","71","811","1366","0","59.37","41.07"
"65","000","00","013","1330","1901","671","508","163","59","730","1292","0","56.5","39.32"
"65","000","00","013","1330","1902","650","505","145","66","716","1317","0","54.37","38.34"
"65","000","00","013","1331","0000","2199","1693","506","215","2414","4421","0","54.6","38.29"
"65","000","00","013","1331","1910","682","537","145","79","761","1458","0","52.19","36.83"
"65","000","00","013","1331","1911","756","578","178","90","846","1468","0","57.63","39.37"
"65","000","00","013","1331","1912","761","578","183","46","807","1495","0","53.98","38.66"
"65","000","00","013","1332","0000","1369","1087","282","78","1447","2605","0","55.55","41.73"
"65","000","00","013","1332","1862","642","503","139","34","676","1262","0","53.57","39.86"
"65","000","00","013","1332","1863","727","584","143","44","771","1343","0","57.41","43.48"
"65","000","00","013","1333","0000","2618","2031","587","246","2864","4947","0","57.89","41.06"
"65","000","00","013","1333","1812","666","497","169","60","726","1268","0","57.26","39.2"
"65","000","00","013","1333","1813","606","468","138","83","689","1196","0","57.61","39.13"
"65","000","00","013","1333","1814","735","577","158","43","778","1308","0","59.48","44.11"
"65","000","00","013","1333","1815","611","489","122","60","671","1175","0","57.11","41.62"
"65","000","00","013","1334","0000","1848","1377","471","180","2028","3896","0","52.05","35.34"
"65","000","00","013","1334","1897","662","508","154","65","727","1321","0","55.03","38.46"
"65","000","00","013","1334","1898","540","397","143","62","602","1150","0","52.35","34.52"
"65","000","00","013","1334","1899","646","472","174","53","699","1425","0","49.05","33.12"
"65","000","00","013","1335","0000","2107","1556","551","200","2307","4116","0","56.05","37.8"
"65","000","00","013","1335","1832","625","444","181","71","696","1335","0","52.13","33.26"
"65","000","00","013","1335","1833","674","507","167","75","749","1346","0","55.65","37.67"
"65","000","00","013","1335","1834","808","605","203","54","862","1435","0","60.07","42.16"
"65","000","00","013","1336","0000","2533","1968","565","237","2770","4896","0","56.58","40.2"
"65","000","00","013","1336","1823","629","472","157","67","696","1175","0","59.23","40.17"
"65","000","00","013","1336","1824","624","484","140","73","697","1237","0","56.35","39.13"
"65","000","00","013","1336","1825","653","522","131","64","717","1256","0","57.09","41.56"
"65","000","00","013","1336","1826","627","490","137","33","660","1228","0","53.75","39.9"
"65","000","00","013","1337","0000","1984","1526","458","128","2112","3975","0","53.13","38.39"
"65","000","00","013","1337","1805","652","525","127","33","685","1320","0","51.89","39.77"
"65","000","00","013","1337","1806","610","464","146","42","652","1241","0","52.54","37.39"
"65","000","00","013","1337","1807","722","537","185","53","775","1414","0","54.81","37.98"
"65","000","00","013","1338","0000","2217","1713","504","171","2388","4680","0","51.03","36.6"
"65","000","00","013","1338","1883","695","553","142","32","727","1511","0","48.11","36.6"
"65","000","00","013","1338","1884","744","564","180","70","814","1531","0","53.17","36.84"
"65","000","00","013","1338","1885","778","596","182","69","847","1638","0","51.71","36.39"
"65","000","00","013","1339","0000","1593","1194","399","126","1719","2900","0","59.28","41.17"
"65","000","00","013","1339","1838","734","544","190","74","808","1333","0","60.62","40.81"
"65","000","00","013","1339","1839","859","650","209","52","911","1567","0","58.14","41.48"
"65","000","00","013","1340","0000","2924","2238","686","245","3169","5663","0","55.96","39.52"
"65","000","00","013","1340","1913","659","486","173","80","739","1303","0","56.72","37.3"
"65","000","00","013","1340","1914","714","549","165","49","763","1365","0","55.9","40.22"
"65","000","00","013","1340","1915","741","553","188","79","820","1476","0","55.56","37.47"
"65","000","00","013","1340","1916","810","650","160","37","847","1519","0","55.76","42.79"
"65","000","00","013","1341","0000","1343","1050","293","62","1405","2846","0","49.37","36.89"
"65","000","00","013","1341","1860","650","519","131","29","679","1484","0","45.75","34.97"
"65","000","00","013","1341","1861","693","531","162","33","726","1362","0","53.3","38.99"
"65","000","00","013","1342","0000","2333","1832","501","139","2472","4173","0","59.24","43.9"
"65","000","00","013","1342","1855","763","629","134","25","788","1423","0","55.38","44.2"
"65","000","00","013","1342","1856","752","549","203","57","809","1321","0","61.24","41.56"
"65","000","00","013","1342","1857","818","654","164","57","875","1429","0","61.23","45.77"
"65","000","00","013","1343","0000","2685","2073","612","128","2813","5120","0","54.94","40.49"
"65","000","00","013","1343","1852","869","656","213","38","907","1691","0","53.64","38.79"
"65","000","00","013","1343","1853","829","642","187","52","881","1657","0","53.17","38.74"
"65","000","00","013","1343","1854","987","775","212","38","1025","1772","0","57.84","43.74"
"65","000","00","013","1344","0000","1585","1258","327","65","1650","3048","0","54.13","41.27"
"65","000","00","013","1344","1845","827","660","167","24","851","1584","0","53.72","41.67"
"65","000","00","013","1344","1846","758","598","160","41","799","1464","0","54.58","40.85"
"65","000","00","013","1345","0000","1380","1058","322","95","1475","2660","0","55.45","39.77"
"65","000","00","013","1345","1873","744","565","179","38","782","1367","0","57.21","41.33"
"65","000","00","013","1345","1874","636","493","143","57","693","1293","0","53.6","38.13"
"65","000","00","013","1346","0000","2758","2224","534","158","2916","5364","0","54.36","41.46"
"65","000","00","013","1346","1889","921","725","196","38","959","1774","0","54.06","40.87"
"65","000","00","013","1346","1890","926","754","172","52","978","1792","0","54.58","42.08"
"65","000","00","013","1346","1891","911","745","166","68","979","1798","0","54.45","41.43"
"65","000","00","013","1347","0000","1903","1482","421","192","2095","3736","0","56.08","39.67"
"65","000","00","013","1347","1903","699","538","161","54","753","1324","0","56.87","40.63"
"65","000","00","013","1347","1904","573","460","113","61","634","1189","0","53.32","38.69"
"65","000","00","013","1347","1905","631","484","147","77","708","1223","0","57.89","39.57"
"65","000","00","014","0000","0000","82087","62795","19292","6999","89086","167457","201173","53.2","37.5"
"65","000","00","014","1401","0000","5715","4529","1186","296","6011","10484","0","57.33","43.2"
"65","000","00","014","1401","0581","992","748","244","56","1048","1791","0","58.51","41.76"
"65","000","00","014","1401","0582","980","790","190","61","1041","1714","0","60.74","46.09"
"65","000","00","014","1401","0583","969","780","189","41","1010","1780","0","56.74","43.82"
"65","000","00","014","1401","0584","910","718","192","43","953","1713","0","55.63","41.91"
"65","000","00","014","1401","0585","935","749","186","53","988","1720","0","57.44","43.55"
"65","000","00","014","1401","0586","929","744","185","42","971","1766","0","54.98","42.13"
"65","000","00","014","1402","0000","2566","2006","560","214","2780","4958","0","56.07","40.46"
"65","000","00","014","1402","0573","876","660","216","75","951","1652","0","57.57","39.95"
"65","000","00","014","1402","0574","811","619","192","100","911","1650","0","55.21","37.52"
"65","000","00","014","1402","0575","879","727","152","39","918","1656","0","55.43","43.9"
"65","000","00","014","1403","0000","1532","1191","341","89","1621","3576","0","45.33","33.31"
"65","000","00","014","1403","0561","643","504","139","31","674","1779","0","37.89","28.33"
"65","000","00","014","1403","0562","889","687","202","58","947","1797","0","52.7","38.23"
"65","000","00","014","1404","0000","2405","1812","593","260","2665","4665","0","57.13","38.84"
"65","000","00","014","1404","0555","828","612","216","90","918","1600","0","57.38","38.25"
"65","000","00","014","1404","0556","789","603","186","71","860","1549","0","55.52","38.93"
"65","000","00","014","1404","0557","788","597","191","99","887","1516","0","58.51","39.38"
"65","000","00","014","1405","0000","1635","1247","388","173","1808","3361","0","53.79","37.1"
"65","000","00","014","1405","0655","789","607","182","77","866","1673","0","51.76","36.28"
"65","000","00","014","1405","0656","846","640","206","96","942","1688","0","55.81","37.91"
"65","000","00","014","1406","0000","4262","3273","989","352","4614","9051","0","50.98","36.16"
"65","000","00","014","1406","0640","907","694","213","85","992","1851","0","53.59","37.49"
"65","000","00","014","1406","0641","809","620","189","67","876","1791","0","48.91","34.62"
"65","000","00","014","1406","0642","839","631","208","81","920","1853","0","49.65","34.05"
"65","000","00","014","1406","0643","809","628","181","49","858","1758","0","48.81","35.72"
"65","000","00","014","1406","0644","898","700","198","70","968","1798","0","53.84","38.93"
"65","000","00","014","1407","0000","2597","1965","632","222","2819","5589","0","50.44","35.16"
"65","000","00","014","1407","0604","887","670","217","74","961","1806","0","53.21","37.1"
"65","000","00","014","1407","0605","910","675","235","85","995","1910","0","52.09","35.34"
"65","000","00","014","1407","0606","800","620","180","63","863","1873","0","46.08","33.1"
"65","000","00","014","1408","0000","2466","1846","620","193","2659","4826","0","55.1","38.25"
"65","000","00","014","1408","0616","812","611","201","71","883","1634","0","54.04","37.39"
"65","000","00","014","1408","0617","795","597","198","70","865","1573","0","54.99","37.95"
"65","000","00","014","1408","0618","859","638","221","52","911","1619","0","56.27","39.41"
"65","000","00","014","1409","0000","2704","2056","648","225","2929","5491","0","53.34","37.44"
"65","000","00","014","1409","0619","864","664","200","90","954","1878","0","50.8","35.36"
"65","000","00","014","1409","0620","869","645","224","95","964","1797","0","53.64","35.89"
"65","000","00","014","1409","0621","971","747","224","40","1011","1816","0","55.67","41.13"
"65","000","00","014","1410","0000","1533","1102","431","139","1672","2836","0","58.96","38.86"
"65","000","00","014","1410","0622","719","523","196","77","796","1344","0","59.23","38.91"
"65","000","00","014","1410","0623","814","579","235","62","876","1492","0","58.71","38.81"
"65","000","00","014","1411","0000","1461","1100","361","120","1581","2963","0","53.36","37.12"
"65","000","00","014","1411","0636","824","624","200","64","888","1602","0","55.43","38.95"
"65","000","00","014","1411","0637","637","476","161","56","693","1361","0","50.92","34.97"
"65","000","00","014","1412","0000","1170","855","315","166","1336","2287","0","58.42","37.39"
"65","000","00","014","1412","0634","577","417","160","63","640","1111","0","57.61","37.53"
"65","000","00","014","1412","0635","593","438","155","103","696","1176","0","59.18","37.24"
"65","000","00","014","1413","0000","923","690","233","124","1047","1959","0","53.45","35.22"
"65","000","00","014","1413","0624","923","690","233","124","1047","1959","0","53.45","35.22"
"65","000","00","014","1414","0000","1379","1042","337","151","1530","2980","0","51.34","34.97"
"65","000","00","014","1414","0630","670","501","169","63","733","1332","0","55.03","37.61"
"65","000","00","014","1414","0631","709","541","168","88","797","1648","0","48.36","32.83"
"65","000","00","014","1415","0000","2643","2041","602","201","2844","5122","0","55.53","39.85"
"65","000","00","014","1415","0587","806","639","167","73","879","1623","0","54.16","39.37"
"65","000","00","014","1415","0588","897","681","216","52","949","1740","0","54.54","39.14"
"65","000","00","014","1415","0589","940","721","219","76","1016","1759","0","57.76","40.99"
"65","000","00","014","1416","0000","2917","2213","704","250","3167","5489","0","57.7","40.32"
"65","000","00","014","1416","0590","940","704","236","86","1026","1775","0","57.8","39.66"
"65","000","00","014","1416","0591","1020","789","231","69","1089","1909","0","57.05","41.33"
"65","000","00","014","1416","0592","957","720","237","95","1052","1805","0","58.28","39.89"
"65","000","00","014","1417","0000","2941","2277","664","204","3145","5952","0","52.84","38.26"
"65","000","00","014","1417","0597","698","557","141","58","756","1434","0","52.72","38.84"
"65","000","00","014","1417","0598","722","542","180","76","798","1450","0","55.03","37.38"
"65","000","00","014","1417","0599","747","576","171","25","772","1543","0","50.03","37.33"
"65","000","00","014","1417","0600","774","602","172","45","819","1525","0","53.7","39.48"
"65","000","00","014","1418","0000","1600","1199","401","118","1718","3545","0","48.46","33.82"
"65","000","00","014","1418","0607","799","621","178","49","848","1785","0","47.51","34.79"
"65","000","00","014","1418","0608","801","578","223","69","870","1760","0","49.43","32.84"
"65","000","00","014","1419","0000","2481","1917","564","193","2674","5146","0","51.96","37.25"
"65","000","00","014","1419","0609","959","755","204","68","1027","1841","0","55.78","41.01"
"65","000","00","014","1419","0610","869","682","187","48","917","1855","0","49.43","36.77"
"65","000","00","014","1419","0611","653","480","173","77","730","1450","0","50.34","33.1"
"65","000","00","014","1420","0000","1399","1053","346","208","1607","3126","0","51.41","33.69"
"65","000","00","014","1420","0612","750","555","195","81","831","1585","0","52.43","35.02"
"65","000","00","014","1420","0613","649","498","151","127","776","1541","0","50.36","32.32"
"65","000","00","014","1421","0000","3807","2924","883","347","4154","8323","0","49.91","35.13"
"65","000","00","014","1421","0645","844","660","184","66","910","1645","0","55.32","40.12"
"65","000","00","014","1421","0646","728","548","180","64","792","1612","0","49.13","34.0"
"65","000","00","014","1421","0647","762","591","171","93","855","1784","0","47.93","33.13"
"65","000","00","014","1421","0648","715","538","177","73","788","1701","0","46.33","31.63"
"65","000","00","014","1421","0649","758","587","171","51","809","1581","0","51.17","37.13"
"65","000","00","014","1422","0000","2441","1843","598","217","2658","4648","0","57.19","39.65"
"65","000","00","014","1422","0650","772","568","204","71","843","1534","0","54.95","37.03"
"65","000","00","014","1422","0651","858","640","218","70","928","1620","0","57.28","39.51"
"65","000","00","014","1422","0652","811","635","176","76","887","1494","0","59.37","42.5"
"65","000","00","014","1423","0000","1452","1114","338","129","1581","2881","0","54.88","38.67"
"65","000","00","014","1423","0579","654","505","149","66","720","1367","0","52.67","36.94"
"65","000","00","014","1423","0580","798","609","189","63","861","1514","0","56.87","40.22"
"65","000","00","014","1424","0000","2317","1795","522","175","2492","4810","0","51.81","37.32"
"65","000","00","014","1424","0566","754","590","164","56","810","1524","0","53.15","38.71"
"65","000","00","014","1424","0567","761","592","169","66","827","1612","0","51.3","36.72"
"65","000","00","014","1424","0568","802","613","189","53","855","1674","0","51.08","36.62"
"65","000","00","014","1425","0000","1491","1113","378","102","1593","2938","0","54.22","37.88"
"65","000","00","014","1425","0571","762","525","237","46","808","1473","0","54.85","35.64"
"65","000","00","014","1425","0572","729","588","141","56","785","1465","0","53.58","40.14"
"65","000","00","014","1426","0000","1318","1011","307","80","1398","2726","0","51.28","37.09"
"65","000","00","014","1426","0632","661","514","147","30","691","1355","0","51.0","37.93"
"65","000","00","014","1426","0633","657","497","160","50","707","1371","0","51.57","36.25"
"65","000","00","014","1427","0000","2355","1879","476","260","2615","4838","0","54.05","38.84"
"65","000","00","014","1427","0625","779","563","216","104","883","1611","0","54.81","34.95"
"65","000","00","014","1427","0626","726","669","57","77","803","1574","0","51.02","42.5"
"65","000","00","014","1427","0627","850","647","203","79","929","1653","0","56.2","39.14"
"65","000","00","014","1428","0000","1889","1400","489","132","2021","4897","0","41.27","28.59"
"65","000","00","014","1428","0628","993","753","240","61","1054","3085","0","34.17","24.41"
"65","000","00","014","1428","0629","896","647","249","71","967","1812","0","53.37","35.71"
"65","000","00","014","1429","0000","2139","1681","458","227","2366","4270","0","55.41","39.37"
"65","000","00","014","1429","0558","684","536","148","90","774","1404","0","55.13","38.18"
"65","000","00","014","1429","0559","667","506","161","87","754","1381","0","54.6","36.64"
"65","000","00","014","1429","0560","788","639","149","50","838","1485","0","56.43","43.03"
"65","000","00","014","1430","0000","1335","1024","311","125","1460","2725","0","53.58","37.58"
"65","000","00","014","1430","0657","633","483","150","49","682","1249","0","54.6","38.67"
"65","000","00","014","1430","0658","702","541","161","76","778","1476","0","52.71","36.65"
"65","000","00","014","1431","0000","2240","1682","558","189","2429","4569","0","53.16","36.81"
"65","000","00","014","1431","0576","762","556","206","59","821","1571","0","52.26","35.39"
"65","000","00","014","1431","0577","740","551","189","79","819","1523","0","53.78","36.18"
"65","000","00","014","1431","0578","738","575","163","51","789","1475","0","53.49","38.98"
"65","000","00","014","1432","0000","1213","924","289","138","1351","2455","0","55.03","37.64"
"65","000","00","014","1432","0638","758","584","174","66","824","1530","0","53.86","38.17"
"65","000","00","014","1432","0639","455","340","115","72","527","925","0","56.97","36.76"
"65","000","00","014","1433","0000","1132","858","274","94","1226","2168","0","56.55","39.58"
"65","000","00","014","1433","0653","614","471","143","42","656","1183","0","55.45","39.81"
"65","000","00","014","1433","0654","518","387","131","52","570","985","0","57.87","39.29"
"65","000","00","014","1434","0000","1439","1105","334","145","1584","2867","0","55.25","38.54"
"65","000","00","014","1434","0614","795","605","190","74","869","1626","0","53.44","37.21"
"65","000","00","014","1434","0615","644","500","144","71","715","1241","0","57.61","40.29"
"65","000","00","014","1435","0000","2262","1746","516","182","2444","4566","0","53.53","38.24"
"65","000","00","014","1435","0563","712","533","179","78","790","1364","0","57.92","39.08"
"65","000","00","014","1435","0564","851","665","186","59","910","1635","0","55.66","40.67"
"65","000","00","014","1435","0565","699","548","151","45","744","1567","0","47.48","34.97"
"65","000","00","014","1436","0000","1635","1238","397","114","1749","3652","0","47.89","33.9"
"65","000","00","014","1436","0569","856","639","217","62","918","1838","0","49.95","34.77"
"65","000","00","014","1436","0570","779","599","180","52","831","1814","0","45.81","33.02"
"65","000","00","014","1437","0000","3314","2551","763","244","3558","6697","0","53.13","38.09"
"65","000","00","014","1437","0593","814","635","179","55","869","1642","0","52.92","38.67"
"65","000","00","014","1437","0594","866","669","197","50","916","1713","0","53.47","39.05"
"65","000","00","014","1437","0595","819","630","189","80","899","1746","0","51.49","36.08"
"65","000","00","014","1437","0596","815","617","198","59","874","1596","0","54.76","38.66"
"65","000","00","014","1438","0000","1979","1493","486","201","2180","4021","0","54.22","37.13"
"65","000","00","014","1438","0601","657","480","177","77","734","1419","0","51.73","33.83"
"65","000","00","014","1438","0602","690","530","160","50","740","1298","0","57.01","40.83"
"65","000","00","014","1438","0603","632","483","149","74","706","1304","0","54.14","37.04"
"65","000","00","015","0000","0000","35317","27203","8114","2891","38208","72443","86156","52.74","37.55"
"65","000","00","015","1501","0000","2069","1558","511","231","2300","4225","0","54.44","36.88"
"65","000","00","015","1501","0207","691","509","182","103","794","1456","0","54.53","34.96"
"65","000","00","015","1501","0208","707","555","152","77","784","1482","0","52.9","37.45"
"65","000","00","015","1501","0209","671","494","177","51","722","1287","0","56.1","38.38"
"65","000","00","015","1502","0000","512","365","147","44","556","1106","0","50.27","33.0"
"65","000","00","015","1502","0210","512","365","147","44","556","1106","0","50.27","33.0"
"65","000","00","015","1503","0000","1705","1384","321","155","1860","3437","0","54.12","40.27"
"65","000","00","015","1503","0212","859","752","107","63","922","1833","0","50.3","41.03"
"65","000","00","015","1503","0213","603","464","139","52","655","1141","0","57.41","40.67"
"65","000","00","015","1503","0214","243","168","75","40","283","463","0","61.12","36.29"
"65","000","00","015","1504","0000","593","443","150","87","680","1283","0","53.0","34.53"
"65","000","00","015","1504","0211","593","443","150","87","680","1283","0","53.0","34.53"
"65","000","00","015","1505","0000","2408","1816","592","211","2619","5271","0","49.69","34.45"
"65","000","00","015","1505","0219","840","623","217","125","965","1832","0","52.67","34.01"
"65","000","00","015","1505","0220","762","568","194","35","797","1542","0","51.69","36.84"
"65","000","00","015","1505","0221","806","625","181","51","857","1897","0","45.18","32.95"
"65","000","00","015","1506","0000","2449","1754","695","288","2737","5478","0","49.96","32.02"
"65","000","00","015","1506","0222","853","664","189","104","957","1964","0","48.73","33.81"
"65","000","00","015","1506","0223","798","587","211","87","885","1779","0","49.75","33.0"
"65","000","00","015","1506","0224","798","503","295","97","895","1735","0","51.59","28.99"
"65","000","00","015","1507","0000","558","409","149","37","595","1281","0","46.45","31.93"
"65","000","00","015","1507","0229","558","409","149","37","595","1281","0","46.45","31.93"
"65","000","00","015","1508","0000","1856","1392","464","175","2031","3910","0","51.94","35.6"
"65","000","00","015","1508","0236","478","353","125","41","519","1333","0","38.93","26.48"
"65","000","00","015","1508","0237","696","532","164","54","750","1263","0","59.38","42.12"
"65","000","00","015","1508","0238","682","507","175","80","762","1314","0","57.99","38.58"
"65","000","00","015","1509","0000","1429","1096","333","108","1537","3126","0","49.17","35.06"
"65","000","00","015","1509","0230","768","579","189","75","843","1566","0","53.83","36.97"
"65","000","00","015","1509","0231","661","517","144","33","694","1560","0","44.49","33.14"
"65","000","00","015","1510","0000","2296","1760","536","162","2458","4643","0","52.94","37.91"
"65","000","00","015","1510","0239","728","544","184","36","764","1513","0","50.5","35.96"
"65","000","00","015","1510","0240","773","599","174","46","819","1517","0","53.99","39.49"
"65","000","00","015","1510","0241","795","617","178","80","875","1613","0","54.25","38.25"
"65","000","00","015","1511","0000","1109","938","171","65","1174","2281","0","51.47","41.12"
"65","000","00","015","1511","0253","548","460","88","25","573","1127","0","50.84","40.82"
"65","000","00","015","1511","0254","561","478","83","40","601","1154","0","52.08","41.42"
"65","000","00","015","1512","0000","1516","1273","243","123","1639","2709","0","60.5","46.99"
"65","000","00","015","1512","0251","788","655","133","63","851","1397","0","60.92","46.89"
"65","000","00","015","1512","0252","728","618","110","60","788","1312","0","60.06","47.1"
"65","000","00","015","1513","0000","2073","1646","427","140","2213","3916","0","56.51","42.03"
"65","000","00","015","1513","0248","715","571","144","27","742","1441","0","51.49","39.63"
"65","000","00","015","1513","0249","693","574","119","58","751","1305","0","57.55","43.98"
"65","000","00","015","1513","0250","665","501","164","55","720","1170","0","61.54","42.82"
"65","000","00","015","1514","0000","1394","1035","359","172","1566","2819","0","55.55","36.72"
"65","000","00","015","1514","0217","758","556","202","84","842","1534","0","54.89","36.25"
"65","000","00","015","1514","0218","636","479","157","88","724","1285","0","56.34","37.28"
"65","000","00","015","1515","0000","1710","1338","372","101","1811","3401","0","53.25","39.34"
"65","000","00","015","1515","0232","812","642","170","49","861","1622","0","53.08","39.58"
"65","000","00","015","1515","0233","898","696","202","52","950","1779","0","53.4","39.12"
"65","000","00","015","1516","0000","1699","1309","390","96","1795","3446","0","52.09","37.99"
"65","000","00","015","1516","0215","891","729","162","58","949","1786","0","53.14","40.82"
"65","000","00","015","1516","0216","808","580","228","38","846","1660","0","50.96","34.94"
"65","000","00","015","1517","0000","1503","1158","345","125","1628","3054","0","53.31","37.92"
"65","000","00","015","1517","0234","696","526","170","74","770","1487","0","51.78","35.37"
"65","000","00","015","1517","0235","807","632","175","51","858","1567","0","54.75","40.33"
"65","000","00","015","1518","0000","3545","2774","771","262","3807","7389","0","51.52","37.54"
"65","000","00","015","1518","0225","1070","863","207","55","1125","2299","0","48.93","37.54"
"65","000","00","015","1518","0226","784","599","185","60","844","1755","0","48.09","34.13"
"65","000","00","015","1518","0227","855","660","195","66","921","1674","0","55.02","39.43"
"65","000","00","015","1518","0228","836","652","184","81","917","1661","0","55.21","39.25"
"65","000","00","015","1519","0000","3403","2592","811","189","3592","6815","0","52.71","38.03"
"65","000","00","015","1519","0242","794","621","173","76","870","1616","0","53.84","38.43"
"65","000","00","015","1519","0243","791","597","194","74","865","1616","0","53.53","36.94"
"65","000","00","015","1519","0244","900","654","246","12","912","1689","0","54.0","38.72"
"65","000","00","015","1519","0245","918","720","198","27","945","1894","0","49.89","38.01"
"65","000","00","015","1520","0000","1490","1163","327","120","1610","2853","0","56.43","40.76"
"65","000","00","015","1520","0246","697","531","166","65","762","1210","0","62.98","43.88"
"65","000","00","015","1520","0247","793","632","161","55","848","1643","0","51.61","38.47"
"65","000","00","016","0000","0000","32828","25751","7077","2195","35023","64252","78683","54.51","40.08"
"65","000","00","016","1601","0000","402","306","96","40","442","829","0","53.32","36.91"
"65","000","00","016","1601","0255","295","218","77","33","328","643","0","51.01","33.9"
"65","000","00","016","1601","0256","107","88","19","7","114","186","0","61.29","47.31"
"65","000","00","016","1602","0000","1509","1184","325","109","1618","3051","0","53.03","38.81"
"65","000","00","016","1602","0257","684","540","144","44","728","1457","0","49.97","37.06"
"65","000","00","016","1602","0258","825","644","181","65","890","1594","0","55.83","40.4"
"65","000","00","016","1603","0000","2843","2270","573","220","3063","5921","0","51.73","38.34"
"65","000","00","016","1603","0259","742","606","136","60","802","1598","0","50.19","37.92"
"65","000","00","016","1603","0260","714","574","140","37","751","1503","0","49.97","38.19"
"65","000","00","016","1603","0261","678","541","137","70","748","1436","0","52.09","37.67"
"65","000","00","016","1603","0262","709","549","160","53","762","1384","0","55.06","39.67"
"65","000","00","016","1604","0000","1265","986","279","85","1350","2526","0","53.44","39.03"
"65","000","00","016","1604","0263","633","486","147","55","688","1231","0","55.89","39.48"
"65","000","00","016","1604","0264","632","500","132","30","662","1295","0","51.12","38.61"
"65","000","00","016","1605","0000","2014","1554","460","116","2130","3901","0","54.6","39.84"
"65","000","00","016","1605","0267","645","512","133","32","677","1253","0","54.03","40.86"
"65","000","00","016","1605","0268","618","484","134","46","664","1294","0","51.31","37.4"
"65","000","00","016","1605","0269","751","558","193","38","789","1354","0","58.27","41.21"
"65","000","00","016","1606","0000","1848","1429","419","87","1935","3605","0","53.68","39.64"
"65","000","00","016","1606","0270","638","503","135","38","676","1259","0","53.69","39.95"
"65","000","00","016","1606","0271","673","520","153","22","695","1252","0","55.51","41.53"
"65","000","00","016","1606","0272","537","406","131","27","564","1094","0","51.55","37.11"
"65","000","00","016","1607","0000","2059","1581","478","199","2258","4048","0","55.78","39.06"
"65","000","00","016","1607","0280","671","510","161","59","730","1201","0","60.78","42.46"
"65","000","00","016","1607","0281","590","427","163","65","655","1182","0","55.41","36.13"
"65","000","00","016","1607","0282","798","644","154","75","873","1665","0","52.43","38.68"
"65","000","00","016","1608","0000","1737","1325","412","134","1871","3306","0","56.59","40.08"
"65","000","00","016","1608","0287","558","439","119","41","599","1152","0","52.0","38.11"
"65","000","00","016","1608","0288","580","432","148","45","625","1114","0","56.1","38.78"
"65","000","00","016","1608","0289","599","454","145","48","647","1040","0","62.21","43.65"
"65","000","00","016","1609","0000","1818","1411","407","102","1920","3517","0","54.59","40.12"
"65","000","00","016","1609","0294","633","480","153","41","674","1211","0","55.66","39.64"
"65","000","00","016","1609","0295","646","503","143","23","669","1237","0","54.08","40.66"
"65","000","00","016","1609","0296","539","428","111","38","577","1069","0","53.98","40.04"
"65","000","00","016","1610","0000","2155","1785","370","117","2272","4348","0","52.25","41.05"
"65","000","00","016","1610","0299","692","568","124","35","727","1420","0","51.2","40.0"
"65","000","00","016","1610","0300","720","567","153","39","759","1337","0","56.77","42.41"
"65","000","00","016","1610","0301","743","650","93","43","786","1591","0","49.4","40.85"
"65","000","00","016","1611","0000","1671","1258","413","126","1797","3224","0","55.74","39.02"
"65","000","00","016","1611","0273","833","642","191","57","890","1590","0","55.97","40.38"
"65","000","00","016","1611","0274","838","616","222","69","907","1634","0","55.51","37.7"
"65","000","00","016","1612","0000","3618","2806","812","267","3885","7245","0","53.62","38.73"
"65","000","00","016","1612","0283","934","701","233","75","1009","1855","0","54.39","37.79"
"65","000","00","016","1612","0284","938","719","219","89","1027","1866","0","55.04","38.53"
"65","000","00","016","1612","0285","977","768","209","54","1031","1935","0","53.28","39.69"
"65","000","00","016","1612","0286","769","618","151","49","818","1589","0","51.48","38.89"
"65","000","00","016","1613","0000","1101","854","247","67","1168","1978","0","59.05","43.17"
"65","000","00","016","1613","0290","555","437","118","43","598","1003","0","59.62","43.57"
"65","000","00","016","1613","0291","546","417","129","24","570","975","0","58.46","42.77"
"65","000","00","016","1614","0000","1487","1151","336","62","1549","2920","0","53.05","39.42"
"65","000","00","016","1614","0292","746","571","175","40","786","1440","0","54.58","39.65"
"65","000","00","016","1614","0293","741","580","161","22","763","1480","0","51.55","39.19"
"65","000","00","016","1615","0000","1780","1412","368","117","1897","3331","0","56.95","42.39"
"65","000","00","016","1615","0297","914","734","180","72","986","1680","0","58.69","43.69"
"65","000","00","016","1615","0298","866","678","188","45","911","1651","0","55.18","41.07"
"65","000","00","016","1616","0000","1704","1354","350","126","1830","3173","0","57.67","42.67"
"65","000","00","016","1616","0265","835","654","181","62","897","1563","0","57.39","41.84"
"65","000","00","016","1616","0266","869","700","169","64","933","1610","0","57.95","43.48"
"65","000","00","016","1617","0000","3817","3085","732","221","4038","7329","0","55.1","42.09"
"65","000","00","016","1617","0275","689","535","154","40","729","1536","0","47.46","34.83"
"65","000","00","016","1617","0276","838","669","169","45","883","1534","0","57.56","43.61"
"65","000","00","016","1617","0277","890","751","139","58","948","1545","0","61.36","48.61"
"65","000","00","016","1617","0278","733","608","125","49","782","1399","0","55.9","43.46"
"65","000","00","016","1617","0279","667","522","145","29","696","1315","0","52.93","39.7"
"65","000","00","017","0000","0000","45482","36130","9352","2631","48113","86203","108950","55.81","41.91"
"65","000","00","017","1701","0000","1815","1368","447","166","1981","3657","0","54.17","37.41"
"65","000","00","017","1701","0145","613","439","174","63","676","1268","0","53.31","34.62"
"65","000","00","017","1701","0146","556","417","139","51","607","1171","0","51.84","35.61"
"65","000","00","017","1701","0147","646","512","134","52","698","1218","0","57.31","42.04"
"65","000","00","017","1702","0000","2294","1744","550","191","2485","4861","0","51.12","35.88"
"65","000","00","017","1702","0148","855","660","195","55","910","1788","0","50.89","36.91"
"65","000","00","017","1702","0149","752","554","198","69","821","1625","0","50.52","34.09"
"65","000","00","017","1702","0150","687","530","157","67","754","1448","0","52.07","36.6"
"65","000","00","017","1703","0000","4277","3389","888","293","4570","8259","0","55.33","41.03"
"65","000","00","017","1703","0151","602","467","135","81","683","1328","0","51.43","35.17"
"65","000","00","017","1703","0152","644","494","150","63","707","1523","0","46.42","32.44"
"65","000","00","017","1703","0153","644","521","123","40","684","1245","0","54.94","41.85"
"65","000","00","017","1703","0154","795","649","146","36","831","1329","0","62.53","48.83"
"65","000","00","017","1703","0155","815","642","173","42","857","1465","0","58.5","43.82"
"65","000","00","017","1703","0156","777","616","161","31","808","1369","0","59.02","45.0"
"65","000","00","017","1704","0000","2085","1662","423","148","2233","3818","0","58.49","43.53"
"65","000","00","017","1704","0157","731","559","172","57","788","1346","0","58.54","41.53"
"65","000","00","017","1704","0158","585","432","153","64","649","1181","0","54.95","36.58"
"65","000","00","017","1704","0159","769","671","98","27","796","1291","0","61.66","51.98"
"65","000","00","017","1705","0000","1916","1506","410","135","2051","3654","0","56.13","41.22"
"65","000","00","017","1705","0160","625","494","131","48","673","1213","0","55.48","40.73"
"65","000","00","017","1705","0161","699","577","122","35","734","1256","0","58.44","45.94"
"65","000","00","017","1705","0162","592","435","157","52","644","1185","0","54.35","36.71"
"65","000","00","017","1706","0000","680","514","166","56","736","1361","0","54.08","37.77"
"65","000","00","017","1706","0163","680","514","166","56","736","1361","0","54.08","37.77"
"65","000","00","017","1707","0000","9199","7506","1693","391","9590","17256","0","55.57","43.5"
"65","000","00","017","1707","0164","866","733","133","29","895","1756","0","50.97","41.74"
"65","000","00","017","1707","0165","825","683","142","40","865","1676","0","51.61","40.75"
"65","000","00","017","1707","0166","844","694","150","25","869","1540","0","56.43","45.06"
"65","000","00","017","1707","0167","811","695","116","37","848","1569","0","54.05","44.3"
"65","000","00","017","1707","0168","802","643","159","35","837","1514","0","55.28","42.47"
"65","000","00","017","1707","0169","666","538","128","26","692","1193","0","58.01","45.1"
"65","000","00","017","1707","0170","887","713","174","29","916","1610","0","56.89","44.29"
"65","000","00","017","1707","0171","734","604","130","39","773","1338","0","57.77","45.14"
"65","000","00","017","1707","0172","616","480","136","35","651","1141","0","57.06","42.07"
"65","000","00","017","1707","0173","705","559","146","33","738","1307","0","56.47","42.77"
"65","000","00","017","1707","0174","733","587","146","29","762","1327","0","57.42","44.24"
"65","000","00","017","1707","0175","710","577","133","34","744","1285","0","57.9","44.9"
"65","000","00","017","1708","0000","8423","6841","1582","335","8758","15777","0","55.51","43.36"
"65","000","00","017","1708","0176","791","638","153","38","829","1481","0","55.98","43.08"
"65","000","00","017","1708","0177","837","685","152","23","860","1510","0","56.95","45.36"
"65","000","00","017","1708","0178","908","717","191","42","950","1785","0","53.22","40.17"
"65","000","00","017","1708","0179","941","750","191","29","970","1792","0","54.13","41.85"
"65","000","00","017","1708","0180","825","678","147","31","856","1517","0","56.43","44.69"
"65","000","00","017","1708","0181","868","703","165","31","899","1564","0","57.48","44.95"
"65","000","00","017","1708","0182","865","725","140","30","895","1560","0","57.37","46.47"
"65","000","00","017","1708","0183","801","643","158","38","839","1544","0","54.34","41.65"
"65","000","00","017","1708","0184","820","673","147","38","858","1593","0","53.86","42.25"
"65","000","00","017","1708","0185","767","629","138","35","802","1431","0","56.04","43.96"
"65","000","00","017","1709","0000","2870","2255","615","178","3048","5291","0","57.61","42.62"
"65","000","00","017","1709","0195","778","613","165","40","818","1380","0","59.28","44.42"
"65","000","00","017","1709","0196","712","551","161","53","765","1367","0","55.96","40.31"
"65","000","00","017","1709","0197","724","565","159","42","766","1350","0","56.74","41.85"
"65","000","00","017","1709","0198","656","526","130","43","699","1194","0","58.54","44.05"
"65","000","00","017","1710","0000","458","329","129","44","502","1026","0","48.93","32.07"
"65","000","00","017","1710","0202","458","329","129","44","502","1026","0","48.93","32.07"
"65","000","00","017","1711","0000","619","466","153","52","671","1210","0","55.45","38.51"
"65","000","00","017","1711","0203","619","466","153","52","671","1210","0","55.45","38.51"
"65","000","00","017","1712","0000","447","335","112","66","513","912","0","56.25","36.73"
"65","000","00","017","1712","0204","447","335","112","66","513","912","0","56.25","36.73"
"65","000","00","017","1713","0000","439","324","115","36","475","824","0","57.65","39.32"
"65","000","00","017","1713","0205","439","324","115","36","475","824","0","57.65","39.32"
"65","000","00","017","1714","0000","748","579","169","84","832","1411","0","58.97","41.03"
"65","000","00","017","1714","0206","748","579","169","84","832","1411","0","58.97","41.03"
"65","000","00","017","1715","0000","3190","2492","698","166","3356","5852","0","57.35","42.58"
"65","000","00","017","1715","0186","806","620","186","41","847","1571","0","53.91","39.47"
"65","000","00","017","1715","0187","793","628","165","35","828","1439","0","57.54","43.64"
"65","000","00","017","1715","0188","794","619","175","47","841","1451","0","57.96","42.66"
"65","000","00","017","1715","0189","797","625","172","43","840","1391","0","60.39","44.93"
"65","000","00","017","1716","0000","4072","3266","806","158","4230","7417","0","57.03","44.03"
"65","000","00","017","1716","0190","787","634","153","24","811","1461","0","55.51","43.39"
"65","000","00","017","1716","0191","874","697","177","20","894","1691","0","52.87","41.22"
"65","000","00","017","1716","0192","799","629","170","49","848","1524","0","55.64","41.27"
"65","000","00","017","1716","0193","805","658","147","33","838","1343","0","62.4","48.99"
"65","000","00","017","1716","0194","807","648","159","32","839","1398","0","60.01","46.35"
"65","000","00","017","1717","0000","1950","1554","396","132","2082","3617","0","57.56","42.96"
"65","000","00","017","1717","0199","677","543","134","60","737","1344","0","54.84","40.4"
"65","000","00","017","1717","0200","616","486","130","35","651","1154","0","56.41","42.11"
"65","000","00","017","1717","0201","657","525","132","37","694","1119","0","62.02","46.92"
"65","000","00","018","0000","0000","10492","8138","2354","709","11201","20624","23617","54.31","39.46"
"65","000","00","018","1801","0000","1428","1122","306","91","1519","3004","0","50.57","37.35"
"65","000","00","018","1801","2169","638","505","133","20","658","1496","0","43.98","33.76"
"65","000","00","018","1801","2170","790","617","173","71","861","1508","0","57.1","40.92"
"65","000","00","018","1802","0000","1174","906","268","81","1255","2281","0","55.02","39.72"
"65","000","00","018","1802","2163","552","417","135","33","585","1142","0","51.23","36.51"
"65","000","00","018","1802","2164","622","489","133","48","670","1139","0","58.82","42.93"
"65","000","00","018","1803","0000","1257","979","278","91","1348","2710","0","49.74","36.13"
"65","000","00","018","1803","2167","623","483","140","53","676","1330","0","50.83","36.32"
"65","000","00","018","1803","2168","634","496","138","38","672","1380","0","48.7","35.94"
"65","000","00","018","1804","0000","1010","805","205","43","1053","1946","0","54.11","41.37"
"65","000","00","018","1804","2174","362","274","88","23","385","782","0","49.23","35.04"
"65","000","00","018","1804","2175","648","531","117","20","668","1164","0","57.39","45.62"
"65","000","00","018","1805","0000","309","245","64","29","338","556","0","60.79","44.06"
"65","000","00","018","1805","2178","309","245","64","29","338","556","0","60.79","44.06"
"65","000","00","018","1806","0000","2952","2263","689","192","3144","5579","0","56.35","40.56"
"65","000","00","018","1806","2171","851","653","198","76","927","1624","0","57.08","40.21"
"65","000","00","018","1806","2172","1109","853","256","56","1165","2165","0","53.81","39.4"
"65","000","00","018","1806","2173","992","757","235","60","1052","1790","0","58.77","42.29"
"65","000","00","018","1807","0000","1189","911","278","100","1289","2465","0","52.29","36.96"
"65","000","00","018","1807","2165","522","380","142","51","573","1065","0","53.8","35.68"
"65","000","00","018","1807","2166","667","531","136","49","716","1400","0","51.14","37.93"
"65","000","00","018","1808","0000","1173","907","266","82","1255","2083","0","60.25","43.54"
"65","000","00","018","1808","2176","745","582","163","55","800","1344","0","59.52","43.3"
"65","000","00","018","1808","2177","428","325","103","27","455","739","0","61.57","43.98"
"65","000","00","019","0000","0000","3096","2295","801","305","3401","6861","7727","49.57","33.45"
"65","000","00","019","1901","0000","220","161","59","23","243","391","0","62.15","41.18"
"65","000","00","019","1901","2179","220","161","59","23","243","391","0","62.15","41.18"
"65","000","00","019","1902","0000","354","271","83","43","397","789","0","50.32","34.35"
"65","000","00","019","1902","2180","354","271","83","43","397","789","0","50.32","34.35"
"65","000","00","019","1903","0000","294","204","90","15","309","683","0","45.24","29.87"
"65","000","00","019","1903","2185","294","204","90","15","309","683","0","45.24","29.87"
"65","000","00","019","1904","0000","253","185","68","23","276","662","0","41.69","27.95"
"65","000","00","019","1904","2181","253","185","68","23","276","662","0","41.69","27.95"
"65","000","00","019","1905","0000","142","103","39","13","155","310","0","50.0","33.23"
"65","000","00","019","1905","2182","142","103","39","13","155","310","0","50.0","33.23"
"65","000","00","019","1906","0000","164","121","43","22","186","373","0","49.87","32.44"
"65","000","00","019","1906","2183","131","103","28","17","148","280","0","52.86","36.79"
"65","000","00","019","1906","2184","33","18","15","5","38","93","0","40.86","19.35"
"65","000","00","019","1907","0000","281","210","71","34","315","591","0","53.3","35.53"
"65","000","00","019","1907","2188","281","210","71","34","315","591","0","53.3","35.53"
"65","000","00","019","1908","0000","245","192","53","13","258","726","0","35.54","26.45"
"65","000","00","019","1908","2187","245","192","53","13","258","726","0","35.54","26.45"
"65","000","00","019","1909","0000","159","115","44","30","189","282","0","67.02","40.78"
"65","000","00","019","1909","2189","159","115","44","30","189","282","0","67.02","40.78"
"65","000","00","019","1910","0000","194","148","46","10","204","323","0","63.16","45.82"
"65","000","00","019","1910","2186","194","148","46","10","204","323","0","63.16","45.82"
"65","000","00","019","1911","0000","294","230","64","20","314","788","0","39.85","29.19"
"65","000","00","019","1911","2190","294","230","64","20","314","788","0","39.85","29.19"
"65","000","00","019","1912","0000","496","355","141","59","555","943","0","58.85","37.65"
"65","000","00","019","1912","2191","496","355","141","59","555","943","0","58.85","37.65"
"65","000","00","020","0000","0000","2574","1953","621","354","2928","5891","6570","49.7","33.15"
"65","000","00","020","2001","0000","413","313","100","70","483","843","0","57.3","37.13"
"65","000","00","020","2001","2196","281","213","68","50","331","595","0","55.63","35.8"
"65","000","00","020","2001","2197","132","100","32","20","152","248","0","61.29","40.32"
"65","000","00","020","2002","0000","579","442","137","57","636","1248","0","50.96","35.42"
"65","000","00","020","2002","2192","579","442","137","57","636","1248","0","50.96","35.42"
"65","000","00","020","2003","0000","547","419","128","103","650","1141","0","56.97","36.72"
"65","000","00","020","2003","2194","547","419","128","103","650","1141","0","56.97","36.72"
"65","000","00","020","2004","0000","149","110","39","11","160","417","0","38.37","26.38"
"65","000","00","020","2004","2195","149","110","39","11","160","417","0","38.37","26.38"
"65","000","00","020","2005","0000","336","259","77","32","368","816","0","45.1","31.74"
"65","000","00","020","2005","2198","148","115","33","14","162","338","0","47.93","34.02"
"65","000","00","020","2005","2199","188","144","44","18","206","478","0","43.1","30.13"
"65","000","00","020","2006","0000","251","197","54","41","292","612","0","47.71","32.19"
"65","000","00","020","2006","2193","251","197","54","41","292","612","0","47.71","32.19"
"65","000","00","020","2007","0000","299","213","86","40","339","814","0","41.65","26.17"
"65","000","00","020","2007","2200","134","93","41","12","146","390","0","37.44","23.85"
"65","000","00","020","2007","2201","165","120","45","28","193","424","0","45.52","28.3"
"65","000","00","021","0000","0000","8787","6678","2109","749","9536","20119","23010","47.4","33.19"
"65","000","00","021","2101","0000","136","102","34","12","148","312","0","47.44","32.69"
"65","000","00","021","2101","0011","136","102","34","12","148","312","0","47.44","32.69"
"65","000","00","021","2102","0000","2237","1727","510","156","2393","4806","0","49.79","35.93"
"65","000","00","021","2102","0012","639","513","126","30","669","1421","0","47.08","36.1"
"65","000","00","021","2102","0013","747","561","186","54","801","1557","0","51.45","36.03"
"65","000","00","021","2102","0014","851","653","198","72","923","1828","0","50.49","35.72"
"65","000","00","021","2103","0000","495","377","118","45","540","1060","0","50.94","35.57"
"65","000","00","021","2103","0015","495","377","118","45","540","1060","0","50.94","35.57"
"65","000","00","021","2104","0000","316","238","78","40","356","819","0","43.47","29.06"
"65","000","00","021","2104","0016","316","238","78","40","356","819","0","43.47","29.06"
"65","000","00","021","2105","0000","2480","1864","616","218","2698","6140","0","43.94","30.36"
"65","000","00","021","2105","0017","673","511","162","42","715","1701","0","42.03","30.04"
"65","000","00","021","2105","0018","765","569","196","72","837","1740","0","48.1","32.7"
"65","000","00","021","2105","0019","528","389","139","43","571","1451","0","39.35","26.81"
"65","000","00","021","2105","0020","514","395","119","61","575","1248","0","46.07","31.65"
"65","000","00","021","2106","0000","305","227","78","15","320","629","0","50.87","36.09"
"65","000","00","021","2106","0021","305","227","78","15","320","629","0","50.87","36.09"
"65","000","00","021","2107","0000","215","166","49","19","234","504","0","46.43","32.94"
"65","000","00","021","2107","0022","215","166","49","19","234","504","0","46.43","32.94"
"65","000","00","021","2108","0000","294","221","73","13","307","698","0","43.98","31.66"
"65","000","00","021","2108","0023","294","221","73","13","307","698","0","43.98","31.66"
"65","000","00","021","2109","0000","905","733","172","52","957","2069","0","46.25","35.43"
"65","000","00","021","2109","0024","905","733","172","52","957","2069","0","46.25","35.43"
"65","000","00","021","2110","0000","380","282","98","34","414","784","0","52.81","35.97"
"65","000","00","021","2110","0025","380","282","98","34","414","784","0","52.81","35.97"
"65","000","00","021","2111","0000","233","157","76","30","263","522","0","50.38","30.08"
"65","000","00","021","2111","0026","233","157","76","30","263","522","0","50.38","30.08"
"65","000","00","021","2112","0000","238","176","62","65","303","587","0","51.62","29.98"
"65","000","00","021","2112","0027","238","176","62","65","303","587","0","51.62","29.98"
"65","000","00","021","2113","0000","553","408","145","50","603","1189","0","50.71","34.31"
"65","000","00","021","2113","0028","553","408","145","50","603","1189","0","50.71","34.31"
"65","000","00","022","0000","0000","4893","3763","1130","535","5428","10528","12158","51.56","35.74"
"65","000","00","022","2201","0000","525","366","159","54","579","1121","0","51.65","32.65"
"65","000","00","022","2201","0001","525","366","159","54","579","1121","0","51.65","32.65"
"65","000","00","022","2202","0000","593","459","134","76","669","1389","0","48.16","33.05"
"65","000","00","022","2202","0002","593","459","134","76","669","1389","0","48.16","33.05"
"65","000","00","022","2203","0000","979","763","216","128","1107","2177","0","50.85","35.05"
"65","000","00","022","2203","0003","431","337","94","58","489","933","0","52.41","36.12"
"65","000","00","022","2203","0004","548","426","122","70","618","1244","0","49.68","34.24"
"65","000","00","022","2204","0000","417","325","92","68","485","883","0","54.93","36.81"
"65","000","00","022","2204","0005","417","325","92","68","485","883","0","54.93","36.81"
"65","000","00","022","2205","0000","778","619","159","50","828","1564","0","52.94","39.58"
"65","000","00","022","2205","0006","778","619","159","50","828","1564","0","52.94","39.58"
"65","000","00","022","2206","0000","731","546","185","64","795","1500","0","53.0","36.4"
"65","000","00","022","2206","0007","731","546","185","64","795","1500","0","53.0","36.4"
"65","000","00","022","2207","0000","132","114","18","19","151","328","0","46.04","34.76"
"65","000","00","022","2207","0008","132","114","18","19","151","328","0","46.04","34.76"
"65","000","00","022","2208","0000","367","281","86","36","403","651","0","61.9","43.16"
"65","000","00","022","2208","0009","367","281","86","36","403","651","0","61.9","43.16"
"65","000","00","022","2209","0000","371","290","81","40","411","915","0","44.92","31.69"
"65","000","00","022","2209","0010","371","290","81","40","411","915","0","44.92","31.69"
"65","000","00","023","0000","0000","16114","12479","3635","1313","17427","32970","38861","52.86","37.85"
"65","000","00","023","2301","0000","3151","2448","703","230","3381","6595","0","51.27","37.12"
"65","000","00","023","2301","0125","681","524","157","65","746","1498","0","49.8","34.98"
"65","000","00","023","2301","0126","853","663","190","38","891","1939","0","45.95","34.19"
"65","000","00","023","2301","0127","742","591","151","67","809","1516","0","53.36","38.98"
"65","000","00","023","2301","0128","875","670","205","60","935","1642","0","56.94","40.8"
"65","000","00","023","2302","0000","1469","1121","348","161","1630","3203","0","50.89","35.0"
"65","000","00","023","2302","0129","840","639","201","99","939","1927","0","48.73","33.16"
"65","000","00","023","2302","0130","629","482","147","62","691","1276","0","54.15","37.77"
"65","000","00","023","2303","0000","1466","1128","338","102","1568","2752","0","56.98","40.99"
"65","000","00","023","2303","0131","737","572","165","48","785","1349","0","58.19","42.4"
"65","000","00","023","2303","0132","729","556","173","54","783","1403","0","55.81","39.63"
"65","000","00","023","2304","0000","1756","1370","386","112","1868","3497","0","53.42","39.18"
"65","000","00","023","2304","0133","837","644","193","50","887","1644","0","53.95","39.17"
"65","000","00","023","2304","0134","919","726","193","62","981","1853","0","52.94","39.18"
"65","000","00","023","2305","0000","963","753","210","80","1043","1793","0","58.17","42.0"
"65","000","00","023","2305","0135","963","753","210","80","1043","1793","0","58.17","42.0"
"65","000","00","023","2306","0000","3204","2464","740","229","3433","6457","0","53.17","38.16"
"65","000","00","023","2306","0136","835","645","190","47","882","1644","0","53.65","39.23"
"65","000","00","023","2306","0137","892","681","211","72","964","1846","0","52.22","36.89"
"65","000","00","023","2306","0138","659","506","153","58","717","1346","0","53.27","37.59"
"65","000","00","023","2306","0139","818","632","186","52","870","1621","0","53.67","38.99"
"65","000","00","023","2307","0000","1795","1362","433","148","1943","4077","0","47.66","33.41"
"65","000","00","023","2307","0140","867","670","197","74","941","2110","0","44.6","31.75"
"65","000","00","023","2307","0141","928","692","236","74","1002","1967","0","50.94","35.18"
"65","000","00","023","2308","0000","828","664","164","69","897","1626","0","55.17","40.84"
"65","000","00","023","2308","0142","828","664","164","69","897","1626","0","55.17","40.84"
"65","000","00","023","2309","0000","751","581","170","81","832","1514","0","54.95","38.38"
"65","000","00","023","2309","0143","751","581","170","81","832","1514","0","54.95","38.38"
"65","000","00","023","2310","0000","731","588","143","101","832","1456","0","57.14","40.38"
"65","000","00","023","2310","0144","731","588","143","101","832","1456","0","57.14","40.38"
"65","000","00","024","0000","0000","1796","1356","440","231","2027","4321","4687","46.91","31.38"
"65","000","00","024","2401","0000","161","125","36","26","187","384","0","48.7","32.55"
"65","000","00","024","2401","2208","161","125","36","26","187","384","0","48.7","32.55"
"65","000","00","024","2402","0000","90","73","17","5","95","232","0","40.95","31.47"
"65","000","00","024","2402","2209","90","73","17","5","95","232","0","40.95","31.47"
"65","000","00","024","2403","0000","127","95","32","13","140","249","0","56.22","38.15"
"65","000","00","024","2403","2210","127","95","32","13","140","249","0","56.22","38.15"
"65","000","00","024","2404","0000","215","155","60","37","252","458","0","55.02","33.84"
"65","000","00","024","2404","2211","215","155","60","37","252","458","0","55.02","33.84"
"65","000","00","024","2405","0000","111","82","29","18","129","232","0","55.6","35.34"
"65","000","00","024","2405","2212","111","82","29","18","129","232","0","55.6","35.34"
"65","000","00","024","2406","0000","235","180","55","20","255","635","0","40.16","28.35"
"65","000","00","024","2406","2213","235","180","55","20","255","635","0","40.16","28.35"
"65","000","00","024","2407","0000","198","147","51","38","236","427","0","55.27","34.43"
"65","000","00","024","2407","2214","198","147","51","38","236","427","0","55.27","34.43"
"65","000","00","024","2408","0000","70","52","18","3","73","147","0","49.66","35.37"
"65","000","00","024","2408","2216","70","52","18","3","73","147","0","49.66","35.37"
"65","000","00","024","2409","0000","123","98","25","12","135","365","0","36.99","26.85"
"65","000","00","024","2409","2217","123","98","25","12","135","365","0","36.99","26.85"
"65","000","00","024","2410","0000","91","68","23","18","109","177","0","61.58","38.42"
"65","000","00","024","2410","2219","91","68","23","18","109","177","0","61.58","38.42"
"65","000","00","024","2411","0000","310","242","68","33","343","862","0","39.79","28.07"
"65","000","00","024","2411","2215","310","242","68","33","343","862","0","39.79","28.07"
"65","000","00","024","2412","0000","65","39","26","8","73","153","0","47.71","25.49"
"65","000","00","024","2412","2218","65","39","26","8","73","153","0","47.71","25.49"
"65","000","00","025","0000","0000","3447","2684","763","415","3862","7999","8872","48.28","33.55"
"65","000","00","025","2501","0000","186","146","40","28","214","455","0","47.03","32.09"
"65","000","00","025","2501","2266","186","146","40","28","214","455","0","47.03","32.09"
"65","000","00","025","2502","0000","176","143","33","23","199","391","0","50.9","36.57"
"65","000","00","025","2502","2278","58","45","13","7","65","120","0","54.17","37.5"
"65","000","00","025","2502","2279","118","98","20","16","134","271","0","49.45","36.16"
"65","000","00","025","2503","0000","389","312","77","34","423","782","0","54.09","39.9"
"65","000","00","025","2503","2267","135","107","28","13","148","286","0","51.75","37.41"
"65","000","00","025","2503","2268","254","205","49","21","275","496","0","55.44","41.33"
"65","000","00","025","2504","0000","343","270","73","62","405","733","0","55.25","36.83"
"65","000","00","025","2504","2280","180","142","38","32","212","362","0","58.56","39.23"
"65","000","00","025","2504","2281","163","128","35","30","193","371","0","52.02","34.5"
"65","000","00","025","2505","0000","148","124","24","12","160","383","0","41.78","32.38"
"65","000","00","025","2505","2269","148","124","24","12","160","383","0","41.78","32.38"
"65","000","00","025","2506","0000","582","430","152","73","655","1539","0","42.56","27.94"
"65","000","00","025","2506","2270","337","256","81","40","377","887","0","42.5","28.86"
"65","000","00","025","2506","2271","245","174","71","33","278","652","0","42.64","26.69"
"65","000","00","025","2507","0000","152","114","38","15","167","333","0","50.15","34.23"
"65","000","00","025","2507","2272","152","114","38","15","167","333","0","50.15","34.23"
"65","000","00","025","2508","0000","406","317","89","49","455","924","0","49.24","34.31"
"65","000","00","025","2508","2273","285","224","61","35","320","642","0","49.84","34.89"
"65","000","00","025","2508","2274","121","93","28","14","135","282","0","47.87","32.98"
"65","000","00","025","2509","0000","242","187","55","26","268","621","0","43.16","30.11"
"65","000","00","025","2509","2275","242","187","55","26","268","621","0","43.16","30.11"
"65","000","00","025","2510","0000","151","115","36","17","168","422","0","39.81","27.25"
"65","000","00","025","2510","2276","151","115","36","17","168","422","0","39.81","27.25"
"65","000","00","025","2511","0000","107","81","26","27","134","369","0","36.31","21.95"
"65","000","00","025","2511","2277","107","81","26","27","134","369","0","36.31","21.95"
"65","000","00","025","2512","0000","565","445","120","49","614","1047","0","58.64","42.5"
"65","000","00","025","2512","2282","565","445","120","49","614","1047","0","58.64","42.5"
"65","000","00","026","0000","0000","4315","3212","1103","491","4806","11279","12364","42.61","28.48"
"65","000","00","026","2601","0000","386","290","96","49","435","876","0","49.66","33.11"
"65","000","00","026","2601","2283","386","290","96","49","435","876","0","49.66","33.11"
"65","000","00","026","2602","0000","184","146","38","17","201","516","0","38.95","28.29"
"65","000","00","026","2602","2285","184","146","38","17","201","516","0","38.95","28.29"
"65","000","00","026","2603","0000","242","175","67","58","300","686","0","43.73","25.51"
"65","000","00","026","2603","2286","125","90","35","26","151","373","0","40.48","24.13"
"65","000","00","026","2603","2287","117","85","32","32","149","313","0","47.6","27.16"
"65","000","00","026","2604","0000","193","140","53","25","218","433","0","50.35","32.33"
"65","000","00","026","2604","2284","193","140","53","25","218","433","0","50.35","32.33"
"65","000","00","026","2605","0000","231","159","72","32","263","676","0","38.91","23.52"
"65","000","00","026","2605","2292","231","159","72","32","263","676","0","38.91","23.52"
"65","000","00","026","2606","0000","660","487","173","74","734","1673","0","43.87","29.11"
"65","000","00","026","2606","2290","297","230","67","25","322","812","0","39.66","28.33"
"65","000","00","026","2606","2291","363","257","106","49","412","861","0","47.85","29.85"
"65","000","00","026","2607","0000","693","519","174","50","743","1731","0","42.92","29.98"
"65","000","00","026","2607","2295","270","209","61","10","280","769","0","36.41","27.18"
"65","000","00","026","2607","2296","423","310","113","40","463","962","0","48.13","32.22"
"65","000","00","026","2608","0000","701","539","162","72","773","2046","0","37.78","26.34"
"65","000","00","026","2608","2293","364","279","85","23","387","1091","0","35.47","25.57"
"65","000","00","026","2608","2294","337","260","77","49","386","955","0","40.42","27.23"
"65","000","00","026","2609","0000","393","277","116","52","445","900","0","49.44","30.78"
"65","000","00","026","2609","2288","219","163","56","16","235","485","0","48.45","33.61"
"65","000","00","026","2609","2289","174","114","60","36","210","415","0","50.6","27.47"
"65","000","00","026","2610","0000","325","260","65","11","336","739","0","45.47","35.18"
"65","000","00","026","2610","2297","182","148","34","9","191","390","0","48.97","37.95"
"65","000","00","026","2610","2298","143","112","31","2","145","349","0","41.55","32.09"
"65","000","00","026","2611","0000","307","220","87","51","358","1003","0","35.69","21.93"
"65","000","00","026","2611","2299","160","111","49","37","197","508","0","38.78","21.85"
"65","000","00","026","2611","2300","147","109","38","14","161","495","0","32.53","22.02"
"65","000","00","027","0000","0000","8644","6592","2052","929","9573","18978","21821","50.44","34.73"
"65","000","00","027","2701","0000","232","129","103","30","262","481","0","54.47","26.82"
"65","000","00","027","2701","2301","232","129","103","30","262","481","0","54.47","26.82"
"65","000","00","027","2702","0000","346","241","105","33","379","715","0","53.01","33.71"
"65","000","00","027","2702","2302","346","241","105","33","379","715","0","53.01","33.71"
"65","000","00","027","2703","0000","187","143","44","27","214","481","0","44.49","29.73"
"65","000","00","027","2703","2303","187","143","44","27","214","481","0","44.49","29.73"
"65","000","00","027","2704","0000","742","581","161","84","826","1792","0","46.09","32.42"
"65","000","00","027","2704","2304","742","581","161","84","826","1792","0","46.09","32.42"
"65","000","00","027","2705","0000","1826","1413","413","160","1986","3791","0","52.39","37.27"
"65","000","00","027","2705","2305","839","634","205","73","912","1781","0","51.21","35.6"
"65","000","00","027","2705","2306","987","779","208","87","1074","2010","0","53.43","38.76"
"65","000","00","027","2706","0000","817","629","188","67","884","1716","0","51.52","36.66"
"65","000","00","027","2706","2310","396","312","84","38","434","828","0","52.42","37.68"
"65","000","00","027","2706","2311","421","317","104","29","450","888","0","50.68","35.7"
"65","000","00","027","2707","0000","533","399","134","79","612","1211","0","50.54","32.95"
"65","000","00","027","2707","2312","533","399","134","79","612","1211","0","50.54","32.95"
"65","000","00","027","2708","0000","224","171","53","15","239","416","0","57.45","41.11"
"65","000","00","027","2708","2313","224","171","53","15","239","416","0","57.45","41.11"
"65","000","00","027","2709","0000","353","267","86","46","399","682","0","58.5","39.15"
"65","000","00","027","2709","2314","353","267","86","46","399","682","0","58.5","39.15"
"65","000","00","027","2710","0000","291","234","57","57","348","644","0","54.04","36.34"
"65","000","00","027","2710","2315","291","234","57","57","348","644","0","54.04","36.34"
"65","000","00","027","2711","0000","361","283","78","48","409","830","0","49.28","34.1"
"65","000","00","027","2711","2316","361","283","78","48","409","830","0","49.28","34.1"
"65","000","00","027","2712","0000","231","161","70","28","259","469","0","55.22","34.33"
"65","000","00","027","2712","2318","231","161","70","28","259","469","0","55.22","34.33"
"65","000","00","027","2713","0000","88","62","26","11","99","188","0","52.66","32.98"
"65","000","00","027","2713","2317","88","62","26","11","99","188","0","52.66","32.98"
"65","000","00","027","2714","0000","177","142","35","36","213","582","0","36.6","24.4"
"65","000","00","027","2714","2319","177","142","35","36","213","582","0","36.6","24.4"
"65","000","00","027","2715","0000","2236","1737","499","208","2444","4980","0","49.08","34.88"
"65","000","00","027","2715","2307","700","530","170","63","763","1572","0","48.54","33.72"
"65","000","00","027","2715","2308","827","653","174","81","908","1777","0","51.1","36.75"
"65","000","00","027","2715","2309","709","554","155","64","773","1631","0","47.39","33.97"
"65","000","00","028","0000","0000","8666","6706","1960","881","9547","19297","22102","49.47","34.75"
"65","000","00","028","2801","0000","2087","1627","460","153","2240","4309","0","51.98","37.76"
"65","000","00","028","2801","2320","649","506","143","47","696","1286","0","54.12","39.35"
"65","000","00","028","2801","2321","799","634","165","60","859","1576","0","54.51","40.23"
"65","000","00","028","2801","2322","639","487","152","46","685","1447","0","47.34","33.66"
"65","000","00","028","2802","0000","1057","830","227","107","1164","2532","0","45.97","32.78"
"65","000","00","028","2802","2325","429","333","96","46","475","1215","0","39.09","27.41"
"65","000","00","028","2802","2326","628","497","131","61","689","1317","0","52.32","37.74"
"65","000","00","028","2803","0000","1313","1019","294","150","1463","3226","0","45.35","31.59"
"65","000","00","028","2803","2327","652","513","139","71","723","1676","0","43.14","30.61"
"65","000","00","028","2803","2328","661","506","155","79","740","1550","0","47.74","32.65"
"65","000","00","028","2804","0000","1397","1096","301","145","1542","2705","0","57.01","40.52"
"65","000","00","028","2804","2329","525","421","104","59","584","945","0","61.8","44.55"
"65","000","00","028","2804","2330","872","675","197","86","958","1760","0","54.43","38.35"
"65","000","00","028","2805","0000","261","201","60","26","287","570","0","50.35","35.26"
"65","000","00","028","2805","2331","261","201","60","26","287","570","0","50.35","35.26"
"65","000","00","028","2806","0000","411","282","129","35","446","952","0","46.85","29.62"
"65","000","00","028","2806","2332","411","282","129","35","446","952","0","46.85","29.62"
"65","000","00","028","2807","0000","335","261","74","60","395","674","0","58.61","38.72"
"65","000","00","028","2807","2333","335","261","74","60","395","674","0","58.61","38.72"
"65","000","00","028","2808","0000","189","138","51","19","208","405","0","51.36","34.07"
"65","000","00","028","2808","2334","189","138","51","19","208","405","0","51.36","34.07"
"65","000","00","028","2809","0000","483","370","113","65","548","1089","0","50.32","33.98"
"65","000","00","028","2809","2335","483","370","113","65","548","1089","0","50.32","33.98"
"65","000","00","028","2810","0000","1133","882","251","121","1254","2835","0","44.23","31.11"
"65","000","00","028","2810","2323","603","475","128","66","669","1466","0","45.63","32.4"
"65","000","00","028","2810","2324","530","407","123","55","585","1369","0","42.73","29.73"
"65","000","00","029","0000","0000","2529","1998","531","167","2696","5264","6383","51.22","37.96"
"65","000","00","029","2901","0000","1076","855","221","52","1128","2367","0","47.66","36.12"
"65","000","00","029","2901","2203","561","441","120","20","581","1198","0","48.5","36.81"
"65","000","00","029","2901","2204","515","414","101","32","547","1169","0","46.79","35.41"
"65","000","00","029","2902","0000","859","671","188","60","919","1568","0","58.61","42.79"
"65","000","00","029","2902","2202","859","671","188","60","919","1568","0","58.61","42.79"
"65","000","00","029","2903","0000","251","194","57","23","274","615","0","44.55","31.54"
"65","000","00","029","2903","2207","251","194","57","23","274","615","0","44.55","31.54"
"65","000","00","029","2904","0000","235","187","48","28","263","486","0","54.12","38.48"
"65","000","00","029","2904","2206","235","187","48","28","263","486","0","54.12","38.48"
"65","000","00","029","2905","0000","108","91","17","4","112","228","0","49.12","39.91"
"65","000","00","029","2905","2205","108","91","17","4","112","228","0","49.12","39.91"
"68","000","00","000","0000","0000","866582","688091","178491","53039","919621","1801823","2215615","51.04","38.19"
"68","000","00","001","0000","0000","171300","135146","36154","9713","181013","359790","446246","50.31","37.56"
"68","000","00","001","0101","0000","342","256","86","19","361","690","0","52.32","37.1"
"68","000","00","001","0101","0032","342","256","86","19","361","690","0","52.32","37.1"
"68","000","00","001","0102","0000","723","552","171","57","780","1353","0","57.65","40.8"
"68","000","00","001","0102","0034","723","552","171","57","780","1353","0","57.65","40.8"
"68","000","00","001","0103","0000","674","508","166","49","723","1582","0","45.7","32.11"
"68","000","00","001","0103","0043","674","508","166","49","723","1582","0","45.7","32.11"
"68","000","00","001","0104","0000","3069","2416","653","174","3243","6636","0","48.87","36.41"
"68","000","00","001","0104","0001","748","564","184","57","805","1593","0","50.53","35.4"
"68","000","00","001","0104","0002","825","639","186","30","855","1934","0","44.21","33.04"
"68","000","00","001","0104","0003","856","686","170","59","915","1661","0","55.09","41.3"
"68","000","00","001","0104","0004","640","527","113","28","668","1448","0","46.13","36.4"
"68","000","00","001","0105","0000","1590","1268","322","70","1660","3483","0","47.66","36.41"
"68","000","00","001","0105","0190","809","651","158","42","851","1790","0","47.54","36.37"
"68","000","00","001","0105","0191","781","617","164","28","809","1693","0","47.78","36.44"
"68","000","00","001","0106","0000","4073","3259","814","163","4236","9063","0","46.74","35.96"
"68","000","00","001","0106","0204","858","673","185","37","895","1796","0","49.83","37.47"
"68","000","00","001","0106","0205","880","719","161","23","903","1878","0","48.08","38.29"
"68","000","00","001","0106","0206","801","631","170","41","842","1729","0","48.7","36.5"
"68","000","00","001","0106","0207","783","622","161","30","813","1843","0","44.11","33.75"
"68","000","00","001","0106","0208","751","614","137","32","783","1817","0","43.09","33.79"
"68","000","00","001","0107","0000","541","397","144","41","582","1028","0","56.61","38.62"
"68","000","00","001","0107","0044","541","397","144","41","582","1028","0","56.61","38.62"
"68","000","00","001","0108","0000","687","514","173","52","739","1452","0","50.9","35.4"
"68","000","00","001","0108","0036","687","514","173","52","739","1452","0","50.9","35.4"
"68","000","00","001","0109","0000","805","619","186","62","867","1681","0","51.58","36.82"
"68","000","00","001","0109","0037","805","619","186","62","867","1681","0","51.58","36.82"
"68","000","00","001","0110","0000","2421","1915","506","146","2567","5078","0","50.55","37.71"
"68","000","00","001","0110","0187","772","587","185","53","825","1764","0","46.77","33.28"
"68","000","00","001","0110","0188","962","788","174","70","1032","1899","0","54.34","41.5"
"68","000","00","001","0110","0189","687","540","147","23","710","1415","0","50.18","38.16"
"68","000","00","001","0111","0000","2104","1714","390","161","2265","4509","0","50.23","38.01"
"68","000","00","001","0111","0113","625","489","136","55","680","1308","0","51.99","37.39"
"68","000","00","001","0111","0114","649","592","57","56","705","1583","0","44.54","37.4"
"68","000","00","001","0111","0115","830","633","197","50","880","1618","0","54.39","39.12"
"68","000","00","001","0112","0000","2054","1636","418","146","2200","4668","0","47.13","35.05"
"68","000","00","001","0112","0131","755","612","143","57","812","1689","0","48.08","36.23"
"68","000","00","001","0112","0132","626","477","149","38","664","1542","0","43.06","30.93"
"68","000","00","001","0112","0133","673","547","126","51","724","1437","0","50.38","38.07"
"68","000","00","001","0113","0000","1430","1097","333","64","1494","2928","0","51.02","37.47"
"68","000","00","001","0113","0193","635","488","147","25","660","1434","0","46.03","34.03"
"68","000","00","001","0113","0194","795","609","186","39","834","1494","0","55.82","40.76"
"68","000","00","001","0114","0000","870","665","205","48","918","1916","0","47.91","34.71"
"68","000","00","001","0114","0192","870","665","205","48","918","1916","0","47.91","34.71"
"68","000","00","001","0115","0000","511","381","130","41","552","979","0","56.38","38.92"
"68","000","00","001","0115","0209","511","381","130","41","552","979","0","56.38","38.92"
"68","000","00","001","0116","0000","1617","1246","371","88","1705","3565","0","47.83","34.95"
"68","000","00","001","0116","0134","794","621","173","36","830","1679","0","49.43","36.99"
"68","000","00","001","0116","0135","823","625","198","52","875","1886","0","46.39","33.14"
"68","000","00","001","0117","0000","1223","964","259","87","1310","2210","0","59.28","43.62"
"68","000","00","001","0117","0105","644","515","129","44","688","1149","0","59.88","44.82"
"68","000","00","001","0117","0106","579","449","130","43","622","1061","0","58.62","42.32"
"68","000","00","001","0118","0000","1425","1145","280","100","1525","3058","0","49.87","37.44"
"68","000","00","001","0118","0127","892","733","159","57","949","1995","0","47.57","36.74"
"68","000","00","001","0118","0128","533","412","121","43","576","1063","0","54.19","38.76"
"68","000","00","001","0119","0000","722","575","147","44","766","1587","0","48.27","36.23"
"68","000","00","001","0119","0041","722","575","147","44","766","1587","0","48.27","36.23"
"68","000","00","001","0120","0000","705","532","173","89","794","1375","0","57.75","38.69"
"68","000","00","001","0120","0028","705","532","173","89","794","1375","0","57.75","38.69"
"68","000","00","001","0121","0000","481","364","117","33","514","852","0","60.33","42.72"
"68","000","00","001","0121","0033","481","364","117","33","514","852","0","60.33","42.72"
"68","000","00","001","0122","0000","4491","3535","956","241","4732","9234","0","51.25","38.28"
"68","000","00","001","0122","0155","864","671","193","45","909","1807","0","50.3","37.13"
"68","000","00","001","0122","0156","906","730","176","42","948","1857","0","51.05","39.31"
"68","000","00","001","0122","0157","820","639","181","69","889","1589","0","55.95","40.21"
"68","000","00","001","0122","0158","990","765","225","50","1040","2088","0","49.81","36.64"
"68","000","00","001","0122","0159","911","730","181","35","946","1893","0","49.97","38.56"
"68","000","00","001","0123","0000","3350","2759","591","123","3473","6570","0","52.86","41.99"
"68","000","00","001","0123","0050","753","612","141","39","792","1489","0","53.19","41.1"
"68","000","00","001","0123","0051","987","795","192","21","1008","1821","0","55.35","43.66"
"68","000","00","001","0123","0052","709","576","133","22","731","1563","0","46.77","36.85"
"68","000","00","001","0123","0053","901","776","125","41","942","1697","0","55.51","45.73"
"68","000","00","001","0124","0000","2846","2263","583","189","3035","6075","0","49.96","37.25"
"68","000","00","001","0124","0151","678","520","158","56","734","1569","0","46.78","33.14"
"68","000","00","001","0124","0152","703","571","132","41","744","1505","0","49.44","37.94"
"68","000","00","001","0124","0153","705","554","151","51","756","1496","0","50.53","37.03"
"68","000","00","001","0124","0154","760","618","142","41","801","1505","0","53.22","41.06"
"68","000","00","001","0125","0000","742","566","176","67","809","1451","0","55.75","39.01"
"68","000","00","001","0125","0042","742","566","176","67","809","1451","0","55.75","39.01"
"68","000","00","001","0126","0000","2810","2179","631","179","2989","5866","0","50.95","37.15"
"68","000","00","001","0126","0045","904","682","222","62","966","1934","0","49.95","35.26"
"68","000","00","001","0126","0046","500","395","105","52","552","1016","0","54.33","38.88"
"68","000","00","001","0126","0047","548","412","136","35","583","1079","0","54.03","38.18"
"68","000","00","001","0126","0048","858","690","168","30","888","1837","0","48.34","37.56"
"68","000","00","001","0127","0000","689","513","176","58","747","1390","0","53.74","36.91"
"68","000","00","001","0127","0049","689","513","176","58","747","1390","0","53.74","36.91"
"68","000","00","001","0128","0000","2402","1814","588","202","2604","4944","0","52.67","36.69"
"68","000","00","001","0128","0081","762","576","186","69","831","1449","0","57.35","39.75"
"68","000","00","001","0128","0082","795","602","193","80","875","1803","0","48.53","33.39"
"68","000","00","001","0128","0083","845","636","209","53","898","1692","0","53.07","37.59"
"68","000","00","001","0129","0000","2291","1775","516","129","2420","4421","0","54.74","40.15"
"68","000","00","001","0129","0060","628","477","151","37","665","1115","0","59.64","42.78"
"68","000","00","001","0129","0061","813","596","217","46","859","1562","0","54.99","38.16"
"68","000","00","001","0129","0062","850","702","148","46","896","1744","0","51.38","40.25"
"68","000","00","001","0130","0000","2570","2011","559","151","2721","5152","0","52.81","39.03"
"68","000","00","001","0130","0057","886","710","176","49","935","1766","0","52.94","40.2"
"68","000","00","001","0130","0058","778","604","174","53","831","1555","0","53.44","38.84"
"68","000","00","001","0130","0059","906","697","209","49","955","1831","0","52.16","38.07"
"68","000","00","001","0131","0000","606","477","129","26","632","1698","0","37.22","28.09"
"68","000","00","001","0131","0035","606","477","129","26","632","1698","0","37.22","28.09"
"68","000","00","001","0132","0000","3049","2404","645","179","3228","5981","0","53.97","40.19"
"68","000","00","001","0132","0013","732","569","163","44","776","1482","0","52.36","38.39"
"68","000","00","001","0132","0014","728","558","170","46","774","1423","0","54.39","39.21"
"68","000","00","001","0132","0015","772","602","170","55","827","1509","0","54.8","39.89"
"68","000","00","001","0132","0016","817","675","142","34","851","1567","0","54.31","43.08"
"68","000","00","001","0133","0000","2830","2311","519","177","3007","5805","0","51.8","39.81"
"68","000","00","001","0133","0020","733","551","182","48","781","1399","0","55.83","39.39"
"68","000","00","001","0133","0021","715","648","67","48","763","1540","0","49.55","42.08"
"68","000","00","001","0133","0022","762","608","154","39","801","1638","0","48.9","37.12"
"68","000","00","001","0133","0023","620","504","116","42","662","1228","0","53.91","41.04"
"68","000","00","001","0134","0000","2407","1818","589","165","2572","4781","0","53.8","38.03"
"68","000","00","001","0134","0038","794","603","191","58","852","1669","0","51.05","36.13"
"68","000","00","001","0134","0039","814","622","192","56","870","1530","0","56.86","40.65"
"68","000","00","001","0134","0040","799","593","206","51","850","1582","0","53.73","37.48"
"68","000","00","001","0135","0000","1542","1220","322","150","1692","3529","0","47.95","34.57"
"68","000","00","001","0135","0086","533","415","118","52","585","1173","0","49.87","35.38"
"68","000","00","001","0135","0087","528","440","88","26","554","1162","0","47.68","37.87"
"68","000","00","001","0135","0088","481","365","116","72","553","1194","0","46.31","30.57"
"68","000","00","001","0136","0000","2603","2100","503","148","2751","5705","0","48.22","36.81"
"68","000","00","001","0136","0092","821","650","171","78","899","1780","0","50.51","36.52"
"68","000","00","001","0136","0093","833","680","153","39","872","1904","0","45.8","35.71"
"68","000","00","001","0136","0094","949","770","179","31","980","2021","0","48.49","38.1"
"68","000","00","001","0137","0000","1827","1400","427","83","1910","3870","0","49.35","36.18"
"68","000","00","001","0137","0185","924","719","205","39","963","1925","0","50.03","37.35"
"68","000","00","001","0137","0186","903","681","222","44","947","1945","0","48.69","35.01"
"68","000","00","001","0138","0000","2160","1630","530","159","2319","4271","0","54.3","38.16"
"68","000","00","001","0138","0195","655","490","165","63","718","1311","0","54.77","37.38"
"68","000","00","001","0138","0196","727","542","185","43","770","1476","0","52.17","36.72"
"68","000","00","001","0138","0197","778","598","180","53","831","1484","0","56.0","40.3"
"68","000","00","001","0139","0000","980","737","243","72","1052","1970","0","53.4","37.41"
"68","000","00","001","0139","0202","528","393","135","42","570","1015","0","56.16","38.72"
"68","000","00","001","0139","0203","452","344","108","30","482","955","0","50.47","36.02"
"68","000","00","001","0140","0000","2576","1949","627","176","2752","5333","0","51.6","36.55"
"68","000","00","001","0140","0029","887","666","221","48","935","1743","0","53.64","38.21"
"68","000","00","001","0140","0030","842","623","219","69","911","1862","0","48.93","33.46"
"68","000","00","001","0140","0031","847","660","187","59","906","1728","0","52.43","38.19"
"68","000","00","001","0141","0000","2992","2343","649","203","3195","6230","0","51.28","37.61"
"68","000","00","001","0141","0024","759","606","153","67","826","1649","0","50.09","36.75"
"68","000","00","001","0141","0025","801","617","184","36","837","1601","0","52.28","38.54"
"68","000","00","001","0141","0026","683","520","163","67","750","1477","0","50.78","35.21"
"68","000","00","001","0141","0027","749","600","149","33","782","1503","0","52.03","39.92"
"68","000","00","001","0142","0000","2376","1830","546","174","2550","5170","0","49.32","35.4"
"68","000","00","001","0142","0010","716","574","142","48","764","1590","0","48.05","36.1"
"68","000","00","001","0142","0011","778","589","189","55","833","1637","0","50.89","35.98"
"68","000","00","001","0142","0012","882","667","215","71","953","1943","0","49.05","34.33"
"68","000","00","001","0143","0000","2358","1833","525","161","2519","5024","0","50.14","36.48"
"68","000","00","001","0143","0007","840","655","185","41","881","1800","0","48.94","36.39"
"68","000","00","001","0143","0008","817","639","178","50","867","1598","0","54.26","39.99"
"68","000","00","001","0143","0009","701","539","162","70","771","1626","0","47.42","33.15"
"68","000","00","001","0144","0000","2082","1674","408","114","2196","4160","0","52.79","40.24"
"68","000","00","001","0144","0017","666","556","110","40","706","1305","0","54.1","42.61"
"68","000","00","001","0144","0018","643","514","129","39","682","1416","0","48.16","36.3"
"68","000","00","001","0144","0019","773","604","169","35","808","1439","0","56.15","41.97"
"68","000","00","001","0145","0000","2277","1823","454","89","2366","4197","0","56.37","43.44"
"68","000","00","001","0145","0173","828","673","155","18","846","1432","0","59.08","47.0"
"68","000","00","001","0145","0174","784","631","153","44","828","1421","0","58.27","44.41"
"68","000","00","001","0145","0175","665","519","146","27","692","1344","0","51.49","38.62"
"68","000","00","001","0146","0000","2368","1857","511","147","2515","5384","0","46.71","34.49"
"68","000","00","001","0146","0182","738","591","147","42","780","1860","0","41.94","31.77"
"68","000","00","001","0146","0183","810","635","175","56","866","1726","0","50.17","36.79"
"68","000","00","001","0146","0184","820","631","189","49","869","1798","0","48.33","35.09"
"68","000","00","001","0147","0000","2821","2209","612","170","2991","6097","0","49.06","36.23"
"68","000","00","001","0147","0198","730","544","186","38","768","1514","0","50.73","35.93"
"68","000","00","001","0147","0199","682","532","150","74","756","1446","0","52.28","36.79"
"68","000","00","001","0147","0200","721","595","126","22","743","1573","0","47.23","37.83"
"68","000","00","001","0147","0201","688","538","150","36","724","1564","0","46.29","34.4"
"68","000","00","001","0148","0000","3181","2413","768","212","3393","6901","0","49.17","34.97"
"68","000","00","001","0148","0139","863","657","206","69","932","1846","0","50.49","35.59"
"68","000","00","001","0148","0140","733","514","219","43","776","1644","0","47.2","31.27"
"68","000","00","001","0148","0141","749","595","154","54","803","1674","0","47.97","35.54"
"68","000","00","001","0148","0142","836","647","189","46","882","1737","0","50.78","37.25"
"68","000","00","001","0149","0000","2696","2120","576","125","2821","5873","0","48.03","36.1"
"68","000","00","001","0149","0107","811","633","178","36","847","1831","0","46.26","34.57"
"68","000","00","001","0149","0108","1012","794","218","56","1068","2168","0","49.26","36.62"
"68","000","00","001","0149","0109","873","693","180","33","906","1874","0","48.35","36.98"
"68","000","00","001","0150","0000","3865","3115","750","215","4080","8384","0","48.66","37.15"
"68","000","00","001","0150","0116","952","726","226","78","1030","2127","0","48.43","34.13"
"68","000","00","001","0150","0117","934","731","203","19","953","2033","0","46.88","35.96"
"68","000","00","001","0150","0118","1017","824","193","41","1058","2098","0","50.43","39.28"
"68","000","00","001","0150","0119","962","834","128","77","1039","2126","0","48.87","39.23"
"68","000","00","001","0151","0000","4110","3217","893","174","4284","8396","0","51.02","38.32"
"68","000","00","001","0151","0146","864","675","189","41","905","1774","0","51.01","38.05"
"68","000","00","001","0151","0147","831","664","167","32","863","1666","0","51.8","39.86"
"68","000","00","001","0151","0148","772","612","160","22","794","1528","0","51.96","40.05"
"68","000","00","001","0151","0149","818","622","196","51","869","1709","0","50.85","36.4"
"68","000","00","001","0151","0150","825","644","181","28","853","1719","0","49.62","37.46"
"68","000","00","001","0152","0000","1391","1084","307","85","1476","2598","0","56.81","41.72"
"68","000","00","001","0152","0079","726","542","184","49","775","1404","0","55.2","38.6"
"68","000","00","001","0152","0080","665","542","123","36","701","1194","0","58.71","45.39"
"68","000","00","001","0153","0000","1825","1461","364","100","1925","3728","0","51.64","39.19"
"68","000","00","001","0153","0084","934","727","207","52","986","1913","0","51.54","38.0"
"68","000","00","001","0153","0085","891","734","157","48","939","1815","0","51.74","40.44"
"68","000","00","001","0154","0000","1806","1433","373","103","1909","3914","0","48.77","36.61"
"68","000","00","001","0154","0074","888","694","194","53","941","1949","0","48.28","35.61"
"68","000","00","001","0154","0075","918","739","179","50","968","1965","0","49.26","37.61"
"68","000","00","001","0155","0000","3003","2351","652","191","3194","6512","0","49.05","36.1"
"68","000","00","001","0155","0076","1029","803","226","60","1089","2414","0","45.11","33.26"
"68","000","00","001","0155","0077","932","742","190","60","992","1942","0","51.08","38.21"
"68","000","00","001","0155","0078","1042","806","236","71","1113","2156","0","51.62","37.38"
"68","000","00","001","0156","0000","2310","1869","441","114","2424","4845","0","50.03","38.58"
"68","000","00","001","0156","0095","747","603","144","48","795","1545","0","51.46","39.03"
"68","000","00","001","0156","0096","749","604","145","32","781","1617","0","48.3","37.35"
"68","000","00","001","0156","0097","814","662","152","34","848","1683","0","50.39","39.33"
"68","000","00","001","0157","0000","2652","2181","471","107","2759","5884","0","46.89","37.07"
"68","000","00","001","0157","0176","862","649","213","37","899","1942","0","46.29","33.42"
"68","000","00","001","0157","0177","955","758","197","45","1000","2001","0","49.98","37.88"
"68","000","00","001","0157","0178","835","774","61","25","860","1941","0","44.31","39.88"
"68","000","00","001","0158","0000","3609","2821","788","217","3826","8196","0","46.68","34.42"
"68","000","00","001","0158","0213","1005","783","222","61","1066","2164","0","49.26","36.18"
"68","000","00","001","0158","0214","905","692","213","63","968","2020","0","47.92","34.26"
"68","000","00","001","0158","0215","802","645","157","52","854","1924","0","44.39","33.52"
"68","000","00","001","0158","0216","897","701","196","41","938","2088","0","44.92","33.57"
"68","000","00","001","0159","0000","3374","2721","653","142","3516","9237","0","38.06","29.46"
"68","000","00","001","0159","0101","888","722","166","32","920","1873","0","49.12","38.55"
"68","000","00","001","0159","0102","715","587","128","35","750","3687","0","20.34","15.92"
"68","000","00","001","0159","0103","902","696","206","33","935","1850","0","50.54","37.62"
"68","000","00","001","0159","0104","869","716","153","42","911","1827","0","49.86","39.19"
"68","000","00","001","0160","0000","2484","1973","511","120","2604","5084","0","51.22","38.81"
"68","000","00","001","0160","0089","845","658","187","48","893","1695","0","52.68","38.82"
"68","000","00","001","0160","0090","861","673","188","36","897","1797","0","49.92","37.45"
"68","000","00","001","0160","0091","778","642","136","36","814","1592","0","51.13","40.33"
"68","000","00","001","0161","0000","3520","2772","748","179","3699","7274","0","50.85","38.11"
"68","000","00","001","0161","0123","820","637","183","38","858","1691","0","50.74","37.67"
"68","000","00","001","0161","0124","916","744","172","48","964","1900","0","50.74","39.16"
"68","000","00","001","0161","0125","876","689","187","59","935","1761","0","53.09","39.13"
"68","000","00","001","0161","0126","908","702","206","34","942","1922","0","49.01","36.52"
"68","000","00","001","0162","0000","2651","2054","597","172","2823","5712","0","49.42","35.96"
"68","000","00","001","0162","0063","814","628","186","45","859","1838","0","46.74","34.17"
"68","000","00","001","0162","0064","955","739","216","70","1025","1889","0","54.26","39.12"
"68","000","00","001","0162","0065","882","687","195","57","939","1985","0","47.3","34.61"
"68","000","00","001","0163","0000","2398","1875","523","144","2542","4811","0","52.84","38.97"
"68","000","00","001","0163","0136","832","656","176","59","891","1657","0","53.77","39.59"
"68","000","00","001","0163","0137","674","511","163","41","715","1349","0","53.0","37.88"
"68","000","00","001","0163","0138","892","708","184","44","936","1805","0","51.86","39.22"
"68","000","00","001","0164","0000","2378","1890","488","98","2476","4605","0","53.77","41.04"
"68","000","00","001","0164","0054","902","722","180","37","939","1740","0","53.97","41.49"
"68","000","00","001","0164","0055","804","627","177","46","850","1626","0","52.28","38.56"
"68","000","00","001","0164","0056","672","541","131","15","687","1239","0","55.45","43.66"
"68","000","00","001","0165","0000","2539","2034","505","128","2667","4555","0","58.55","44.65"
"68","000","00","001","0165","0066","829","665","164","46","875","1524","0","57.41","43.64"
"68","000","00","001","0165","0067","831","655","176","41","872","1425","0","61.19","45.96"
"68","000","00","001","0165","0068","879","714","165","41","920","1606","0","57.29","44.46"
"68","000","00","001","0166","0000","2179","1751","428","68","2247","4066","0","55.26","43.06"
"68","000","00","001","0166","0069","1108","887","221","33","1141","2056","0","55.5","43.14"
"68","000","00","001","0166","0070","1071","864","207","35","1106","2010","0","55.02","42.99"
"68","000","00","001","0167","0000","2268","1772","496","119","2387","4702","0","50.77","37.69"
"68","000","00","001","0167","0143","788","605","183","48","836","1566","0","53.38","38.63"
"68","000","00","001","0167","0144","771","611","160","39","810","1517","0","53.39","40.28"
"68","000","00","001","0167","0145","709","556","153","32","741","1619","0","45.77","34.34"
"68","000","00","001","0168","0000","2901","2303","598","95","2996","5893","0","50.84","39.08"
"68","000","00","001","0168","0168","1181","938","243","41","1222","2204","0","55.44","42.56"
"68","000","00","001","0168","0169","896","678","218","34","930","2033","0","45.75","33.35"
"68","000","00","001","0168","0170","824","687","137","20","844","1656","0","50.97","41.49"
"68","000","00","001","0169","0000","2206","1782","424","107","2313","4541","0","50.94","39.24"
"68","000","00","001","0169","0110","672","530","142","29","701","1524","0","46.0","34.78"
"68","000","00","001","0169","0111","776","623","153","32","808","1528","0","52.88","40.77"
"68","000","00","001","0169","0112","758","629","129","46","804","1489","0","54.0","42.24"
"68","000","00","001","0170","0000","2744","2312","432","116","2860","5371","0","53.25","43.05"
"68","000","00","001","0170","0071","1043","850","193","59","1102","2245","0","49.09","37.86"
"68","000","00","001","0170","0072","808","637","171","33","841","1590","0","52.89","40.06"
"68","000","00","001","0170","0073","893","825","68","24","917","1536","0","59.7","53.71"
"68","000","00","001","0171","0000","2710","2134","576","123","2833","5717","0","49.55","37.33"
"68","000","00","001","0171","0098","939","750","189","59","998","1834","0","54.42","40.89"
"68","000","00","001","0171","0099","921","707","214","39","960","2055","0","46.72","34.4"
"68","000","00","001","0171","0100","850","677","173","25","875","1828","0","47.87","37.04"
"68","000","00","001","0172","0000","2771","2257","514","146","2917","5843","0","49.92","38.63"
"68","000","00","001","0172","0120","905","745","160","45","950","1917","0","49.56","38.86"
"68","000","00","001","0172","0121","917","741","176","53","970","1997","0","48.57","37.11"
"68","000","00","001","0172","0122","949","771","178","48","997","1929","0","51.68","39.97"
"68","000","00","001","0173","0000","1584","1247","337","69","1653","3158","0","52.34","39.49"
"68","000","00","001","0173","0129","684","548","136","46","730","1412","0","51.7","38.81"
"68","000","00","001","0173","0130","900","699","201","23","923","1746","0","52.86","40.03"
"68","000","00","001","0174","0000","3658","2968","690","178","3836","7902","0","48.54","37.56"
"68","000","00","001","0174","0164","977","797","180","42","1019","2103","0","48.45","37.9"
"68","000","00","001","0174","0165","920","755","165","42","962","1943","0","49.51","38.86"
"68","000","00","001","0174","0166","926","727","199","48","974","1927","0","50.54","37.73"
"68","000","00","001","0174","0167","835","689","146","46","881","1929","0","45.67","35.72"
"68","000","00","001","0175","0000","2661","2125","536","151","2812","5729","0","49.08","37.09"
"68","000","00","001","0175","0160","547","443","104","36","583","1303","0","44.74","34.0"
"68","000","00","001","0175","0161","714","561","153","37","751","1416","0","53.04","39.62"
"68","000","00","001","0175","0162","627","499","128","35","662","1351","0","49.0","36.94"
"68","000","00","001","0175","0163","773","622","151","43","816","1659","0","49.19","37.49"
"68","000","00","001","0176","0000","1601","1213","388","114","1715","3450","0","49.71","35.16"
"68","000","00","001","0176","0171","787","583","204","57","844","1712","0","49.3","34.05"
"68","000","00","001","0176","0172","814","630","184","57","871","1738","0","50.12","36.25"
"68","000","00","001","0177","0000","1684","1332","352","128","1812","3856","0","46.99","34.54"
"68","000","00","001","0177","0005","903","734","169","43","946","1974","0","47.92","37.18"
"68","000","00","001","0177","0006","781","598","183","85","866","1882","0","46.01","31.77"
"68","000","00","001","0178","0000","2369","1852","517","122","2491","4835","0","51.52","38.3"
"68","000","00","001","0178","0179","843","649","194","46","889","1702","0","52.23","38.13"
"68","000","00","001","0178","0180","775","603","172","42","817","1589","0","51.42","37.95"
"68","000","00","001","0178","0181","751","600","151","34","785","1544","0","50.84","38.86"
"68","000","00","001","0179","0000","2060","1661","399","85","2145","4217","0","50.87","39.39"
"68","000","00","001","0179","0210","691","535","156","34","725","1363","0","53.19","39.25"
"68","000","00","001","0179","0211","744","608","136","20","764","1546","0","49.42","39.33"
"68","000","00","001","0179","0212","625","518","107","31","656","1308","0","50.15","39.6"
"68","000","00","002","0000","0000","165272","133601","31671","9376","174648","334402","411135","52.23","39.95"
"68","000","00","002","0201","0000","1306","1108","198","121","1427","2916","0","48.94","38.0"
"68","000","00","002","0201","0617","594","528","66","38","632","1329","0","47.55","39.73"
"68","000","00","002","0201","0618","712","580","132","83","795","1587","0","50.09","36.55"
"68","000","00","002","0202","0000","2703","2258","445","129","2832","5418","0","52.27","41.68"
"68","000","00","002","0202","0614","977","826","151","50","1027","1818","0","56.49","45.43"
"68","000","00","002","0202","0615","911","758","153","51","962","1991","0","48.32","38.07"
"68","000","00","002","0202","0616","815","674","141","28","843","1609","0","52.39","41.89"
"68","000","00","002","0203","0000","1546","1264","282","89","1635","3033","0","53.91","41.67"
"68","000","00","002","0203","0654","802","643","159","53","855","1588","0","53.84","40.49"
"68","000","00","002","0203","0655","744","621","123","36","780","1445","0","53.98","42.98"
"68","000","00","002","0204","0000","455","359","96","44","499","943","0","52.92","38.07"
"68","000","00","002","0204","0763","455","359","96","44","499","943","0","52.92","38.07"
"68","000","00","002","0205","0000","1049","825","224","69","1118","2152","0","51.95","38.34"
"68","000","00","002","0205","0689","500","391","109","18","518","1087","0","47.65","35.97"
"68","000","00","002","0205","0690","549","434","115","51","600","1065","0","56.34","40.75"
"68","000","00","002","0206","0000","2070","1628","442","157","2227","4283","0","52.0","38.01"
"68","000","00","002","0206","0691","924","718","206","71","995","1844","0","53.96","38.94"
"68","000","00","002","0206","0692","527","420","107","52","579","1220","0","47.46","34.43"
"68","000","00","002","0206","0693","619","490","129","34","653","1219","0","53.57","40.2"
"68","000","00","002","0207","0000","2513","2009","504","124","2637","5415","0","48.7","37.1"
"68","000","00","002","0207","0771","967","768","199","55","1022","2156","0","47.4","35.62"
"68","000","00","002","0207","0772","660","510","150","25","685","1479","0","46.32","34.48"
"68","000","00","002","0207","0773","886","731","155","44","930","1780","0","52.25","41.07"
"68","000","00","002","0208","0000","2404","2034","370","174","2578","5136","0","50.19","39.6"
"68","000","00","002","0208","0679","770","654","116","48","818","1659","0","49.31","39.42"
"68","000","00","002","0208","0680","875","728","147","81","956","1874","0","51.01","38.85"
"68","000","00","002","0208","0681","759","652","107","45","804","1603","0","50.16","40.67"
"68","000","00","002","0209","0000","1733","1389","344","119","1852","3474","0","53.31","39.98"
"68","000","00","002","0209","0675","790","627","163","73","863","1659","0","52.02","37.79"
"68","000","00","002","0209","0676","943","762","181","46","989","1815","0","54.49","41.98"
"68","000","00","002","0210","0000","1878","1574","304","107","1985","3758","0","52.82","41.88"
"68","000","00","002","0210","0662","741","644","97","38","779","1489","0","52.32","43.25"
"68","000","00","002","0210","0663","430","352","78","31","461","827","0","55.74","42.56"
"68","000","00","002","0210","0664","707","578","129","38","745","1442","0","51.66","40.08"
"68","000","00","002","0211","0000","2198","1811","387","131","2329","4303","0","54.13","42.09"
"68","000","00","002","0211","0602","707","585","122","47","754","1281","0","58.86","45.67"
"68","000","00","002","0211","0603","795","661","134","28","823","1462","0","56.29","45.21"
"68","000","00","002","0211","0604","696","565","131","56","752","1560","0","48.21","36.22"
"68","000","00","002","0212","0000","2585","2079","506","149","2734","5378","0","50.84","38.66"
"68","000","00","002","0212","0619","938","775","163","41","979","1955","0","50.08","39.64"
"68","000","00","002","0212","0620","839","652","187","46","885","1711","0","51.72","38.11"
"68","000","00","002","0212","0621","808","652","156","62","870","1712","0","50.82","38.08"
"68","000","00","002","0213","0000","1735","1353","382","80","1815","3009","0","60.32","44.97"
"68","000","00","002","0213","0652","912","731","181","42","954","1625","0","58.71","44.98"
"68","000","00","002","0213","0653","823","622","201","38","861","1384","0","62.21","44.94"
"68","000","00","002","0214","0000","1060","823","237","69","1129","2061","0","54.78","39.93"
"68","000","00","002","0214","0754","429","325","104","36","465","852","0","54.58","38.15"
"68","000","00","002","0214","0755","631","498","133","33","664","1209","0","54.92","41.19"
"68","000","00","002","0215","0000","1985","1567","418","95","2080","3498","0","59.46","44.8"
"68","000","00","002","0215","0721","818","653","165","30","848","1384","0","61.27","47.18"
"68","000","00","002","0215","0722","607","475","132","21","628","1122","0","55.97","42.34"
"68","000","00","002","0215","0723","560","439","121","44","604","992","0","60.89","44.25"
"68","000","00","002","0216","0000","2063","1657","406","112","2175","4141","0","52.52","40.01"
"68","000","00","002","0216","0627","632","502","130","37","669","1201","0","55.7","41.8"
"68","000","00","002","0216","0628","672","534","138","40","712","1353","0","52.62","39.47"
"68","000","00","002","0216","0629","759","621","138","35","794","1587","0","50.03","39.13"
"68","000","00","002","0217","0000","1742","1439","303","85","1827","5573","0","32.78","25.82"
"68","000","00","002","0217","0642","673","535","138","32","705","3474","0","20.29","15.4"
"68","000","00","002","0217","0643","1069","904","165","53","1122","2099","0","53.45","43.07"
"68","000","00","002","0218","0000","1602","1286","316","74","1676","3540","0","47.34","36.33"
"68","000","00","002","0218","0648","926","748","178","39","965","1900","0","50.79","39.37"
"68","000","00","002","0218","0649","676","538","138","35","711","1640","0","43.35","32.8"
"68","000","00","002","0219","0000","2380","1944","436","113","2493","4845","0","51.46","40.12"
"68","000","00","002","0219","0667","781","640","141","40","821","1764","0","46.54","36.28"
"68","000","00","002","0219","0668","800","673","127","26","826","1488","0","55.51","45.23"
"68","000","00","002","0219","0669","799","631","168","47","846","1593","0","53.11","39.61"
"68","000","00","002","0220","0000","1512","1250","262","58","1570","3362","0","46.7","37.18"
"68","000","00","002","0220","0665","842","690","152","26","868","1842","0","47.12","37.46"
"68","000","00","002","0220","0666","670","560","110","32","702","1520","0","46.18","36.84"
"68","000","00","002","0221","0000","1656","1307","349","97","1753","3334","0","52.58","39.2"
"68","000","00","002","0221","0732","925","728","197","54","979","1951","0","50.18","37.31"
"68","000","00","002","0221","0733","731","579","152","43","774","1383","0","55.97","41.87"
"68","000","00","002","0222","0000","2326","1821","505","123","2449","4872","0","50.27","37.38"
"68","000","00","002","0222","0787","510","386","124","52","562","1097","0","51.23","35.19"
"68","000","00","002","0222","0788","915","727","188","20","935","1917","0","48.77","37.92"
"68","000","00","002","0222","0789","901","708","193","51","952","1858","0","51.24","38.11"
"68","000","00","002","0223","0000","1265","1009","256","54","1319","2506","0","52.63","40.26"
"68","000","00","002","0223","0673","593","455","138","24","617","1249","0","49.4","36.43"
"68","000","00","002","0223","0674","672","554","118","30","702","1257","0","55.85","44.07"
"68","000","00","002","0224","0000","1916","1467","449","129","2045","3776","0","54.16","38.85"
"68","000","00","002","0224","0768","520","421","99","37","557","1028","0","54.18","40.95"
"68","000","00","002","0224","0769","624","466","158","42","666","1157","0","57.56","40.28"
"68","000","00","002","0224","0770","772","580","192","50","822","1591","0","51.67","36.46"
"68","000","00","002","0225","0000","1762","1399","363","101","1863","3667","0","50.8","38.15"
"68","000","00","002","0225","0724","875","675","200","46","921","1820","0","50.6","37.09"
"68","000","00","002","0225","0725","887","724","163","55","942","1847","0","51.0","39.2"
"68","000","00","002","0226","0000","1844","1500","344","129","1973","3712","0","53.15","40.41"
"68","000","00","002","0226","0696","859","675","184","78","937","1733","0","54.07","38.95"
"68","000","00","002","0226","0697","985","825","160","51","1036","1979","0","52.35","41.69"
"68","000","00","002","0227","0000","3428","2760","668","158","3586","6638","0","54.02","41.58"
"68","000","00","002","0227","0716","904","737","167","35","939","1798","0","52.22","40.99"
"68","000","00","002","0227","0717","982","777","205","57","1039","1822","0","57.03","42.65"
"68","000","00","002","0227","0718","825","665","160","25","850","1613","0","52.7","41.23"
"68","000","00","002","0227","0719","717","581","136","41","758","1405","0","53.95","41.35"
"68","000","00","002","0228","0000","413","321","92","29","442","731","0","60.47","43.91"
"68","000","00","002","0228","0764","413","321","92","29","442","731","0","60.47","43.91"
"68","000","00","002","0229","0000","2389","1952","437","203","2592","4672","0","55.48","41.78"
"68","000","00","002","0229","0608","791","647","144","93","884","1627","0","54.33","39.77"
"68","000","00","002","0229","0609","825","675","150","34","859","1519","0","56.55","44.44"
"68","000","00","002","0229","0610","773","630","143","76","849","1526","0","55.64","41.28"
"68","000","00","002","0230","0000","1376","1117","259","98","1474","2836","0","51.97","39.39"
"68","000","00","002","0230","0658","734","612","122","54","788","1546","0","50.97","39.59"
"68","000","00","002","0230","0659","642","505","137","44","686","1290","0","53.18","39.15"
"68","000","00","002","0231","0000","1818","1439","379","141","1959","3544","0","55.28","40.6"
"68","000","00","002","0231","0737","922","722","200","66","988","1703","0","58.02","42.4"
"68","000","00","002","0231","0738","896","717","179","75","971","1841","0","52.74","38.95"
"68","000","00","002","0232","0000","1742","1416","326","58","1800","3507","0","51.33","40.38"
"68","000","00","002","0232","0752","957","778","179","34","991","1987","0","49.87","39.15"
"68","000","00","002","0232","0753","785","638","147","24","809","1520","0","53.22","41.97"
"68","000","00","002","0233","0000","4157","3428","729","217","4374","8947","0","48.89","38.31"
"68","000","00","002","0233","0701","891","723","168","67","958","1943","0","49.31","37.21"
"68","000","00","002","0233","0702","683","573","110","28","711","1363","0","52.16","42.04"
"68","000","00","002","0233","0703","950","766","184","52","1002","2172","0","46.13","35.27"
"68","000","00","002","0233","0704","834","704","130","45","879","1798","0","48.89","39.15"
"68","000","00","002","0233","0705","799","662","137","25","824","1671","0","49.31","39.62"
"68","000","00","002","0234","0000","4185","3402","783","240","4425","8663","0","51.08","39.27"
"68","000","00","002","0234","0709","765","623","142","48","813","1923","0","42.28","32.4"
"68","000","00","002","0234","0710","836","680","156","56","892","1572","0","56.74","43.26"
"68","000","00","002","0234","0711","977","810","167","36","1013","1850","0","54.76","43.78"
"68","000","00","002","0234","0712","768","617","151","50","818","1583","0","51.67","38.98"
"68","000","00","002","0234","0713","839","672","167","50","889","1735","0","51.24","38.73"
"68","000","00","002","0235","0000","1009","784","225","57","1066","1957","0","54.47","40.06"
"68","000","00","002","0235","0758","1009","784","225","57","1066","1957","0","54.47","40.06"
"68","000","00","002","0236","0000","3700","2971","729","197","3897","7473","0","52.15","39.76"
"68","000","00","002","0236","0741","897","740","157","38","935","1636","0","57.15","45.23"
"68","000","00","002","0236","0742","832","698","134","38","870","1528","0","56.94","45.68"
"68","000","00","002","0236","0743","1032","805","227","76","1108","2289","0","48.41","35.17"
"68","000","00","002","0236","0744","939","728","211","45","984","2020","0","48.71","36.04"
"68","000","00","002","0237","0000","2340","1898","442","94","2434","4365","0","55.76","43.48"
"68","000","00","002","0237","0636","696","553","143","16","712","1368","0","52.05","40.42"
"68","000","00","002","0237","0637","803","672","131","43","846","1424","0","59.41","47.19"
"68","000","00","002","0237","0638","841","673","168","35","876","1573","0","55.69","42.78"
"68","000","00","002","0238","0000","901","677","224","70","971","1730","0","56.13","39.13"
"68","000","00","002","0238","0720","901","677","224","70","971","1730","0","56.13","39.13"
"68","000","00","002","0239","0000","2502","2119","383","198","2700","4878","0","55.35","43.44"
"68","000","00","002","0239","0611","795","650","145","78","873","1618","0","53.96","40.17"
"68","000","00","002","0239","0612","853","744","109","51","904","1554","0","58.17","47.88"
"68","000","00","002","0239","0613","854","725","129","69","923","1706","0","54.1","42.5"
"68","000","00","002","0240","0000","516","389","127","35","551","1011","0","54.5","38.48"
"68","000","00","002","0240","0766","516","389","127","35","551","1011","0","54.5","38.48"
"68","000","00","002","0241","0000","1432","1169","263","106","1538","3045","0","50.51","38.39"
"68","000","00","002","0241","0756","716","565","151","84","800","1481","0","54.02","38.15"
"68","000","00","002","0241","0757","716","604","112","22","738","1564","0","47.19","38.62"
"68","000","00","002","0242","0000","2261","1811","450","152","2413","4841","0","49.85","37.41"
"68","000","00","002","0242","0591","694","579","115","48","742","1401","0","52.96","41.33"
"68","000","00","002","0242","0592","845","652","193","57","902","1798","0","50.17","36.26"
"68","000","00","002","0242","0593","722","580","142","47","769","1642","0","46.83","35.32"
"68","000","00","002","0243","0000","2694","2128","566","184","2878","6378","0","45.12","33.36"
"68","000","00","002","0243","0798","949","730","219","78","1027","2068","0","49.66","35.3"
"68","000","00","002","0243","0799","838","675","163","53","891","2152","0","41.4","31.37"
"68","000","00","002","0243","0800","907","723","184","53","960","2158","0","44.49","33.5"
"68","000","00","002","0244","0000","3009","2414","595","155","3164","6013","0","52.62","40.15"
"68","000","00","002","0244","0779","718","551","167","42","760","1426","0","53.3","38.64"
"68","000","00","002","0244","0780","737","583","154","37","774","1618","0","47.84","36.03"
"68","000","00","002","0244","0781","731","601","130","53","784","1441","0","54.41","41.71"
"68","000","00","002","0244","0782","823","679","144","23","846","1528","0","55.37","44.44"
"68","000","00","002","0245","0000","791","630","161","39","830","1532","0","54.18","41.12"
"68","000","00","002","0245","0767","791","630","161","39","830","1532","0","54.18","41.12"
"68","000","00","002","0246","0000","1580","1230","350","140","1720","3344","0","51.44","36.78"
"68","000","00","002","0246","0785","735","577","158","63","798","1534","0","52.02","37.61"
"68","000","00","002","0246","0786","845","653","192","77","922","1810","0","50.94","36.08"
"68","000","00","002","0247","0000","2659","2072","587","217","2876","5162","0","55.71","40.14"
"68","000","00","002","0247","0793","1010","761","249","105","1115","2037","0","54.74","37.36"
"68","000","00","002","0247","0794","659","524","135","40","699","1158","0","60.36","45.25"
"68","000","00","002","0247","0795","990","787","203","72","1062","1967","0","53.99","40.01"
"68","000","00","002","0248","0000","1435","1134","301","69","1504","3148","0","47.78","36.02"
"68","000","00","002","0248","0777","701","549","152","42","743","1609","0","46.18","34.12"
"68","000","00","002","0248","0778","734","585","149","27","761","1539","0","49.45","38.01"
"68","000","00","002","0249","0000","1705","1350","355","123","1828","3686","0","49.59","36.63"
"68","000","00","002","0249","0796","852","699","153","75","927","1830","0","50.66","38.2"
"68","000","00","002","0249","0797","853","651","202","48","901","1856","0","48.55","35.08"
"68","000","00","002","0250","0000","437","334","103","50","487","851","0","57.23","39.25"
"68","000","00","002","0250","0765","437","334","103","50","487","851","0","57.23","39.25"
"68","000","00","002","0251","0000","2397","1896","501","120","2517","4643","0","54.21","40.84"
"68","000","00","002","0251","0790","809","651","158","38","847","1576","0","53.74","41.31"
"68","000","00","002","0251","0791","787","624","163","43","830","1478","0","56.16","42.22"
"68","000","00","002","0251","0792","801","621","180","39","840","1589","0","52.86","39.08"
"68","000","00","002","0252","0000","2310","1906","404","115","2425","4812","0","50.39","39.61"
"68","000","00","002","0252","0729","689","554","135","46","735","1234","0","59.56","44.89"
"68","000","00","002","0252","0730","899","756","143","53","952","2023","0","47.06","37.37"
"68","000","00","002","0252","0731","722","596","126","16","738","1555","0","47.46","38.33"
"68","000","00","002","0253","0000","1423","1169","254","78","1501","2587","0","58.02","45.19"
"68","000","00","002","0253","0634","638","541","97","31","669","1177","0","56.84","45.96"
"68","000","00","002","0253","0635","785","628","157","47","832","1410","0","59.01","44.54"
"68","000","00","002","0254","0000","1495","1185","310","103","1598","2767","0","57.75","42.83"
"68","000","00","002","0254","0761","585","443","142","45","630","1066","0","59.1","41.56"
"68","000","00","002","0254","0762","910","742","168","58","968","1701","0","56.91","43.62"
"68","000","00","002","0255","0000","2633","2069","564","126","2759","5434","0","50.77","38.08"
"68","000","00","002","0255","0774","832","639","193","58","890","1651","0","53.91","38.7"
"68","000","00","002","0255","0775","959","756","203","41","1000","1870","0","53.48","40.43"
"68","000","00","002","0255","0776","842","674","168","27","869","1913","0","45.43","35.23"
"68","000","00","002","0256","0000","2663","2278","385","158","2821","5294","0","53.29","43.03"
"68","000","00","002","0256","0706","912","750","162","60","972","1969","0","49.37","38.09"
"68","000","00","002","0256","0707","830","779","51","45","875","1563","0","55.98","49.84"
"68","000","00","002","0256","0708","921","749","172","53","974","1762","0","55.28","42.51"
"68","000","00","002","0257","0000","2358","1902","456","98","2456","4543","0","54.06","41.87"
"68","000","00","002","0257","0698","805","644","161","34","839","1621","0","51.76","39.73"
"68","000","00","002","0257","0699","738","561","177","38","776","1391","0","55.79","40.33"
"68","000","00","002","0257","0700","815","697","118","26","841","1531","0","54.93","45.53"
"68","000","00","002","0258","0000","1506","1155","351","113","1619","2854","0","56.73","40.47"
"68","000","00","002","0258","0694","644","471","173","48","692","1260","0","54.92","37.38"
"68","000","00","002","0258","0695","862","684","178","65","927","1594","0","58.16","42.91"
"68","000","00","002","0259","0000","1273","992","281","56","1329","2557","0","51.97","38.8"
"68","000","00","002","0259","0714","639","478","161","33","672","1292","0","52.01","37.0"
"68","000","00","002","0259","0715","634","514","120","23","657","1265","0","51.94","40.63"
"68","000","00","002","0260","0000","1667","1334","333","77","1744","3331","0","52.36","40.05"
"68","000","00","002","0260","0630","951","763","188","53","1004","1883","0","53.32","40.52"
"68","000","00","002","0260","0631","716","571","145","24","740","1448","0","51.1","39.43"
"68","000","00","002","0261","0000","1814","1440","374","112","1926","3726","0","51.69","38.65"
"68","000","00","002","0261","0632","904","718","186","42","946","1810","0","52.27","39.67"
"68","000","00","002","0261","0633","910","722","188","70","980","1916","0","51.15","37.68"
"68","000","00","002","0262","0000","2455","1990","465","133","2588","4657","0","55.57","42.73"
"68","000","00","002","0262","0594","825","664","161","61","886","1670","0","53.05","39.76"
"68","000","00","002","0262","0595","766","616","150","24","790","1456","0","54.26","42.31"
"68","000","00","002","0262","0596","864","710","154","48","912","1531","0","59.57","46.37"
"68","000","00","002","0263","0000","1736","1467","269","85","1821","3576","0","50.92","41.02"
"68","000","00","002","0263","0597","886","725","161","46","932","1623","0","57.42","44.67"
"68","000","00","002","0263","0598","850","742","108","39","889","1953","0","45.52","37.99"
"68","000","00","002","0264","0000","1827","1423","404","130","1957","3628","0","53.94","39.22"
"68","000","00","002","0264","0783","829","636","193","54","883","1683","0","52.47","37.79"
"68","000","00","002","0264","0784","998","787","211","76","1074","1945","0","55.22","40.46"
"68","000","00","002","0265","0000","2203","1802","401","84","2287","4082","0","56.03","44.15"
"68","000","00","002","0265","0605","890","736","154","36","926","1602","0","57.8","45.94"
"68","000","00","002","0265","0606","619","505","114","27","646","1006","0","64.21","50.2"
"68","000","00","002","0265","0607","694","561","133","21","715","1474","0","48.51","38.06"
"68","000","00","002","0266","0000","2159","1717","442","110","2269","4296","0","52.82","39.97"
"68","000","00","002","0266","0639","618","492","126","27","645","1152","0","55.99","42.71"
"68","000","00","002","0266","0640","612","497","115","23","635","1178","0","53.9","42.19"
"68","000","00","002","0266","0641","929","728","201","60","989","1966","0","50.31","37.03"
"68","000","00","002","0267","0000","1242","1027","215","79","1321","2125","0","62.16","48.33"
"68","000","00","002","0267","0650","562","453","109","30","592","994","0","59.56","45.57"
"68","000","00","002","0267","0651","680","574","106","49","729","1131","0","64.46","50.75"
"68","000","00","002","0268","0000","2378","1947","431","90","2468","4658","0","52.98","41.8"
"68","000","00","002","0268","0670","772","604","168","31","803","1505","0","53.36","40.13"
"68","000","00","002","0268","0671","818","677","141","33","851","1661","0","51.23","40.76"
"68","000","00","002","0268","0672","788","666","122","26","814","1492","0","54.56","44.64"
"68","000","00","002","0269","0000","1403","1141","262","105","1508","2575","0","58.56","44.31"
"68","000","00","002","0269","0644","608","497","111","43","651","1178","0","55.26","42.19"
"68","000","00","002","0269","0645","795","644","151","62","857","1397","0","61.35","46.1"
"68","000","00","002","0270","0000","1855","1480","375","93","1948","3756","0","51.86","39.4"
"68","000","00","002","0270","0646","878","687","191","44","922","1669","0","55.24","41.16"
"68","000","00","002","0270","0647","977","793","184","49","1026","2087","0","49.16","38.0"
"68","000","00","002","0271","0000","1638","1343","295","124","1762","3596","0","49.0","37.35"
"68","000","00","002","0271","0660","957","813","144","87","1044","2145","0","48.67","37.9"
"68","000","00","002","0271","0661","681","530","151","37","718","1451","0","49.48","36.53"
"68","000","00","002","0272","0000","2289","1879","410","112","2401","4686","0","51.24","40.1"
"68","000","00","002","0272","0622","783","649","134","53","836","1448","0","57.73","44.82"
"68","000","00","002","0272","0623","772","598","174","45","817","1605","0","50.9","37.26"
"68","000","00","002","0272","0624","734","632","102","14","748","1633","0","45.81","38.7"
"68","000","00","002","0273","0000","2779","2268","511","129","2908","5990","0","48.55","37.86"
"68","000","00","002","0273","0745","1002","811","191","46","1048","2027","0","51.7","40.01"
"68","000","00","002","0273","0746","806","671","135","26","832","1883","0","44.18","35.63"
"68","000","00","002","0273","0747","971","786","185","57","1028","2080","0","49.42","37.79"
"68","000","00","002","0274","0000","3023","2423","600","138","3161","5466","0","57.83","44.33"
"68","000","00","002","0274","0748","313","240","73","17","330","646","0","51.08","37.15"
"68","000","00","002","0274","0749","1048","833","215","58","1106","1780","0","62.13","46.8"
"68","000","00","002","0274","0750","755","635","120","19","774","1372","0","56.41","46.28"
"68","000","00","002","0274","0751","907","715","192","44","951","1668","0","57.01","42.87"
"68","000","00","002","0275","0000","1577","1297","280","75","1652","3555","0","46.47","36.48"
"68","000","00","002","0275","0656","753","615","138","42","795","1743","0","45.61","35.28"
"68","000","00","002","0275","0657","824","682","142","33","857","1812","0","47.3","37.64"
"68","000","00","002","0276","0000","1835","1503","332","91","1926","3484","0","55.28","43.14"
"68","000","00","002","0276","0625","951","789","162","63","1014","1795","0","56.49","43.96"
"68","000","00","002","0276","0626","884","714","170","28","912","1689","0","54.0","42.27"
"68","000","00","002","0277","0000","1710","1420","290","96","1806","3448","0","52.38","41.18"
"68","000","00","002","0277","0685","912","772","140","55","967","1739","0","55.61","44.39"
"68","000","00","002","0277","0686","798","648","150","41","839","1709","0","49.09","37.92"
"68","000","00","002","0278","0000","1721","1443","278","71","1792","3319","0","53.99","43.48"
"68","000","00","002","0278","0687","878","708","170","34","912","1655","0","55.11","42.78"
"68","000","00","002","0278","0688","843","735","108","37","880","1664","0","52.88","44.17"
"68","000","00","002","0279","0000","2329","1934","395","131","2460","4416","0","55.71","43.8"
"68","000","00","002","0279","0734","648","545","103","54","702","1164","0","60.31","46.82"
"68","000","00","002","0279","0735","784","658","126","29","813","1482","0","54.86","44.4"
"68","000","00","002","0279","0736","897","731","166","48","945","1770","0","53.39","41.3"
"68","000","00","002","0280","0000","1310","1017","293","96","1406","2405","0","58.46","42.29"
"68","000","00","002","0280","0759","684","530","154","53","737","1223","0","60.26","43.34"
"68","000","00","002","0280","0760","626","487","139","43","669","1182","0","56.6","41.2"
"68","000","00","002","0281","0000","1600","1414","186","62","1662","3243","0","51.25","43.6"
"68","000","00","002","0281","0677","814","653","161","42","856","1702","0","50.29","38.37"
"68","000","00","002","0281","0678","786","761","25","20","806","1541","0","52.3","49.38"
"68","000","00","002","0282","0000","2251","1863","388","102","2353","4712","0","49.94","39.54"
"68","000","00","002","0282","0599","633","508","125","26","659","1155","0","57.06","43.98"
"68","000","00","002","0282","0600","794","653","141","47","841","1800","0","46.72","36.28"
"68","000","00","002","0282","0601","824","702","122","29","853","1757","0","48.55","39.95"
"68","000","00","002","0283","0000","2464","1994","470","96","2560","5423","0","47.21","36.77"
"68","000","00","002","0283","0682","836","667","169","40","876","1735","0","50.49","38.44"
"68","000","00","002","0283","0683","878","727","151","23","901","1815","0","49.64","40.06"
"68","000","00","002","0283","0684","750","600","150","33","783","1873","0","41.8","32.03"
"68","000","00","002","0284","0000","2094","1661","433","141","2235","3731","0","59.9","44.52"
"68","000","00","002","0284","0726","705","571","134","52","757","1302","0","58.14","43.86"
"68","000","00","002","0284","0727","644","513","131","42","686","1203","0","57.02","42.64"
"68","000","00","002","0284","0728","745","577","168","47","792","1226","0","64.6","47.06"
"68","000","00","002","0285","0000","2088","1717","371","85","2173","3970","0","54.74","43.25"
"68","000","00","002","0285","0739","1020","821","199","41","1061","1941","0","54.66","42.3"
"68","000","00","002","0285","0740","1068","896","172","44","1112","2029","0","54.81","44.16"
"68","000","00","003","0000","0000","37633","29096","8537","3237","40870","78285","94862","52.21","37.17"
"68","000","00","003","0301","0000","756","549","207","68","824","1477","0","55.79","37.17"
"68","000","00","003","0301","0522","756","549","207","68","824","1477","0","55.79","37.17"
"68","000","00","003","0302","0000","495","372","123","48","543","1006","0","53.98","36.98"
"68","000","00","003","0302","0523","495","372","123","48","543","1006","0","53.98","36.98"
"68","000","00","003","0303","0000","2159","1638","521","133","2292","4752","0","48.23","34.47"
"68","000","00","003","0303","0527","696","526","170","55","751","1585","0","47.38","33.19"
"68","000","00","003","0303","0528","793","606","187","43","836","1612","0","51.86","37.59"
"68","000","00","003","0303","0529","670","506","164","35","705","1555","0","45.34","32.54"
"68","000","00","003","0304","0000","2777","2107","670","232","3009","5544","0","54.27","38.01"
"68","000","00","003","0304","0530","727","558","169","43","770","1282","0","60.06","43.53"
"68","000","00","003","0304","0531","672","536","136","60","732","1392","0","52.59","38.51"
"68","000","00","003","0304","0532","662","478","184","57","719","1422","0","50.56","33.61"
"68","000","00","003","0304","0533","716","535","181","72","788","1448","0","54.42","36.95"
"68","000","00","003","0305","0000","718","539","179","57","775","1269","0","61.07","42.47"
"68","000","00","003","0305","0534","718","539","179","57","775","1269","0","61.07","42.47"
"68","000","00","003","0306","0000","509","334","175","82","591","977","0","60.49","34.19"
"68","000","00","003","0306","0535","509","334","175","82","591","977","0","60.49","34.19"
"68","000","00","003","0307","0000","1429","1085","344","141","1570","3036","0","51.71","35.74"
"68","000","00","003","0307","0539","484","351","133","38","522","1056","0","49.43","33.24"
"68","000","00","003","0307","0540","594","479","115","58","652","1263","0","51.62","37.93"
"68","000","00","003","0307","0541","351","255","96","45","396","717","0","55.23","35.56"
"68","000","00","003","0308","0000","990","741","249","81","1071","2275","0","47.08","32.57"
"68","000","00","003","0308","0542","507","364","143","25","532","1299","0","40.95","28.02"
"68","000","00","003","0308","0543","483","377","106","56","539","976","0","55.23","38.63"
"68","000","00","003","0309","0000","451","348","103","52","503","938","0","53.62","37.1"
"68","000","00","003","0309","0544","451","348","103","52","503","938","0","53.62","37.1"
"68","000","00","003","0310","0000","360","268","92","45","405","832","0","48.68","32.21"
"68","000","00","003","0310","0545","360","268","92","45","405","832","0","48.68","32.21"
"68","000","00","003","0311","0000","695","520","175","58","753","1359","0","55.41","38.26"
"68","000","00","003","0311","0536","695","520","175","58","753","1359","0","55.41","38.26"
"68","000","00","003","0312","0000","933","669","264","105","1038","1795","0","57.83","37.27"
"68","000","00","003","0312","0537","617","436","181","69","686","1135","0","60.44","38.41"
"68","000","00","003","0312","0538","316","233","83","36","352","660","0","53.33","35.3"
"68","000","00","003","0313","0000","1200","901","299","108","1308","2713","0","48.21","33.21"
"68","000","00","003","0313","0548","620","451","169","42","662","1410","0","46.95","31.99"
"68","000","00","003","0313","0549","580","450","130","66","646","1303","0","49.58","34.54"
"68","000","00","003","0314","0000","658","505","153","58","716","1560","0","45.9","32.37"
"68","000","00","003","0314","0546","360","291","69","25","385","866","0","44.46","33.6"
"68","000","00","003","0314","0547","298","214","84","33","331","694","0","47.69","30.84"
"68","000","00","003","0315","0000","1254","1039","215","117","1371","2852","0","48.07","36.43"
"68","000","00","003","0315","0557","681","556","125","64","745","1446","0","51.52","38.45"
"68","000","00","003","0315","0558","573","483","90","53","626","1406","0","44.52","34.35"
"68","000","00","003","0316","0000","1304","1084","220","74","1378","2542","0","54.21","42.64"
"68","000","00","003","0316","0555","631","540","91","46","677","1173","0","57.72","46.04"
"68","000","00","003","0316","0556","673","544","129","28","701","1369","0","51.21","39.74"
"68","000","00","003","0317","0000","1851","1467","384","134","1985","3603","0","55.09","40.72"
"68","000","00","003","0317","0550","536","424","112","53","589","1125","0","52.36","37.69"
"68","000","00","003","0317","0551","598","494","104","36","634","1170","0","54.19","42.22"
"68","000","00","003","0317","0552","717","549","168","45","762","1308","0","58.26","41.97"
"68","000","00","003","0318","0000","2417","2024","393","163","2580","5012","0","51.48","40.38"
"68","000","00","003","0318","0562","801","653","148","24","825","1684","0","48.99","38.78"
"68","000","00","003","0318","0563","910","819","91","66","976","1959","0","49.82","41.81"
"68","000","00","003","0318","0564","706","552","154","73","779","1369","0","56.9","40.32"
"68","000","00","003","0319","0000","1352","1082","270","98","1450","3088","0","46.96","35.04"
"68","000","00","003","0319","0565","731","590","141","66","797","1431","0","55.7","41.23"
"68","000","00","003","0319","0566","621","492","129","32","653","1657","0","39.41","29.69"
"68","000","00","003","0320","0000","675","516","159","33","708","1514","0","46.76","34.08"
"68","000","00","003","0320","0575","675","516","159","33","708","1514","0","46.76","34.08"
"68","000","00","003","0321","0000","2110","1566","544","264","2374","4947","0","47.99","31.66"
"68","000","00","003","0321","0570","702","524","178","82","784","1511","0","51.89","34.68"
"68","000","00","003","0321","0571","709","507","202","88","797","1719","0","46.36","29.49"
"68","000","00","003","0321","0572","699","535","164","94","793","1717","0","46.19","31.16"
"68","000","00","003","0322","0000","1825","1444","381","148","1973","3732","0","52.87","38.69"
"68","000","00","003","0322","0578","452","360","92","19","471","831","0","56.68","43.32"
"68","000","00","003","0322","0579","722","575","147","59","781","1407","0","55.51","40.87"
"68","000","00","003","0322","0580","651","509","142","70","721","1494","0","48.26","34.07"
"68","000","00","003","0323","0000","1174","906","268","148","1322","2395","0","55.2","37.83"
"68","000","00","003","0323","0573","574","433","141","76","650","1207","0","53.85","35.87"
"68","000","00","003","0323","0574","600","473","127","72","672","1188","0","56.57","39.81"
"68","000","00","003","0324","0000","1478","1179","299","118","1596","2789","0","57.22","42.27"
"68","000","00","003","0324","0576","779","634","145","75","854","1529","0","55.85","41.47"
"68","000","00","003","0324","0577","699","545","154","43","742","1260","0","58.89","43.25"
"68","000","00","003","0325","0000","2193","1670","523","223","2416","4508","0","53.59","37.05"
"68","000","00","003","0325","0524","734","563","171","81","815","1553","0","52.48","36.25"
"68","000","00","003","0325","0525","798","614","184","76","874","1597","0","54.73","38.45"
"68","000","00","003","0325","0526","661","493","168","66","727","1358","0","53.53","36.3"
"68","000","00","003","0326","0000","1825","1413","412","132","1957","3875","0","50.5","36.46"
"68","000","00","003","0326","0567","565","426","139","28","593","1387","0","42.75","30.71"
"68","000","00","003","0326","0568","519","410","109","50","569","1085","0","52.44","37.79"
"68","000","00","003","0326","0569","741","577","164","54","795","1403","0","56.66","41.13"
"68","000","00","003","0327","0000","2405","1883","522","193","2598","4648","0","55.9","40.51"
"68","000","00","003","0327","0559","824","674","150","35","859","1592","0","53.96","42.34"
"68","000","00","003","0327","0560","781","607","174","72","853","1497","0","56.98","40.55"
"68","000","00","003","0327","0561","800","602","198","86","886","1559","0","56.83","38.61"
"68","000","00","003","0328","0000","1640","1247","393","124","1764","3247","0","54.33","38.4"
"68","000","00","003","0328","0553","554","422","132","65","619","1094","0","56.58","38.57"
"68","000","00","003","0328","0554","1086","825","261","59","1145","2153","0","53.18","38.32"
"68","000","00","004","0000","0000","65633","52981","12652","3838","69471","137917","169991","50.37","38.42"
"68","000","00","004","0401","0000","1752","1431","321","88","1840","3705","0","49.66","38.62"
"68","000","00","004","0401","0960","898","728","170","53","951","1943","0","48.94","37.47"
"68","000","00","004","0401","0961","854","703","151","35","889","1762","0","50.45","39.9"
"68","000","00","004","0402","0000","539","447","92","35","574","1083","0","53.0","41.27"
"68","000","00","004","0402","0962","539","447","92","35","574","1083","0","53.0","41.27"
"68","000","00","004","0403","0000","1393","1130","263","116","1509","2633","0","57.31","42.92"
"68","000","00","004","0403","0964","665","523","142","62","727","1274","0","57.06","41.05"
"68","000","00","004","0403","0965","728","607","121","54","782","1359","0","57.54","44.67"
"68","000","00","004","0404","0000","2812","2274","538","137","2949","6964","0","42.35","32.65"
"68","000","00","004","0404","0966","819","652","167","52","871","2444","0","35.64","26.68"
"68","000","00","004","0404","0967","960","787","173","36","996","2298","0","43.34","34.25"
"68","000","00","004","0404","0968","1033","835","198","49","1082","2222","0","48.69","37.58"
"68","000","00","004","0405","0000","1546","1205","341","165","1711","3237","0","52.86","37.23"
"68","000","00","004","0405","0969","775","603","172","71","846","1610","0","52.55","37.45"
"68","000","00","004","0405","0970","771","602","169","94","865","1627","0","53.17","37.0"
"68","000","00","004","0406","0000","1169","939","230","88","1257","2776","0","45.28","33.83"
"68","000","00","004","0406","0973","709","562","147","65","774","1776","0","43.58","31.64"
"68","000","00","004","0406","0974","460","377","83","23","483","1000","0","48.3","37.7"
"68","000","00","004","0407","0000","2177","1762","415","149","2326","4112","0","56.57","42.85"
"68","000","00","004","0407","1003","766","630","136","31","797","1448","0","55.04","43.51"
"68","000","00","004","0407","1004","720","583","137","48","768","1351","0","56.85","43.15"
"68","000","00","004","0407","1005","691","549","142","70","761","1313","0","57.96","41.81"
"68","000","00","004","0408","0000","1314","1081","233","55","1369","2602","0","52.61","41.54"
"68","000","00","004","0408","0989","595","486","109","31","626","1194","0","52.43","40.7"
"68","000","00","004","0408","0990","719","595","124","24","743","1408","0","52.77","42.26"
"68","000","00","004","0409","0000","982","795","187","65","1047","2027","0","51.65","39.22"
"68","000","00","004","0409","0963","982","795","187","65","1047","2027","0","51.65","39.22"
"68","000","00","004","0410","0000","1622","1407","215","90","1712","3300","0","51.88","42.64"
"68","000","00","004","0410","0956","745","689","56","30","775","1713","0","45.24","40.22"
"68","000","00","004","0410","0957","877","718","159","60","937","1587","0","59.04","45.24"
"68","000","00","004","0411","0000","746","600","146","55","801","1434","0","55.86","41.84"
"68","000","00","004","0411","0929","746","600","146","55","801","1434","0","55.86","41.84"
"68","000","00","004","0412","0000","611","498","113","34","645","1137","0","56.73","43.8"
"68","000","00","004","0412","0932","611","498","113","34","645","1137","0","56.73","43.8"
"68","000","00","004","0413","0000","2463","1976","487","170","2633","5314","0","49.55","37.18"
"68","000","00","004","0413","0936","748","587","161","67","815","1449","0","56.25","40.51"
"68","000","00","004","0413","0937","811","650","161","56","867","1877","0","46.19","34.63"
"68","000","00","004","0413","0938","904","739","165","47","951","1988","0","47.84","37.17"
"68","000","00","004","0414","0000","2016","1649","367","78","2094","4219","0","49.63","39.09"
"68","000","00","004","0414","0933","1057","877","180","43","1100","2211","0","49.75","39.67"
"68","000","00","004","0414","0934","959","772","187","35","994","2008","0","49.5","38.45"
"68","000","00","004","0415","0000","1807","1443","364","65","1872","3730","0","50.19","38.69"
"68","000","00","004","0415","0942","890","695","195","33","923","1848","0","49.95","37.61"
"68","000","00","004","0415","0943","917","748","169","32","949","1882","0","50.43","39.74"
"68","000","00","004","0416","0000","1638","1337","301","72","1710","3657","0","46.76","36.56"
"68","000","00","004","0416","0991","736","578","158","34","770","1737","0","44.33","33.28"
"68","000","00","004","0416","0992","902","759","143","38","940","1920","0","48.96","39.53"
"68","000","00","004","0417","0000","1644","1321","323","96","1740","3378","0","51.51","39.11"
"68","000","00","004","0417","0997","825","663","162","64","889","1692","0","52.54","39.18"
"68","000","00","004","0417","0998","819","658","161","32","851","1686","0","50.47","39.03"
"68","000","00","004","0418","0000","2150","1753","397","145","2295","3923","0","58.5","44.69"
"68","000","00","004","0418","0926","653","514","139","55","708","1269","0","55.79","40.5"
"68","000","00","004","0418","0927","719","586","133","50","769","1246","0","61.72","47.03"
"68","000","00","004","0418","0928","778","653","125","40","818","1408","0","58.1","46.38"
"68","000","00","004","0419","0000","1462","1201","261","103","1565","3172","0","49.34","37.86"
"68","000","00","004","0419","0930","711","604","107","55","766","1515","0","50.56","39.87"
"68","000","00","004","0419","0931","751","597","154","48","799","1657","0","48.22","36.03"
"68","000","00","004","0420","0000","836","669","167","82","918","1861","0","49.33","35.95"
"68","000","00","004","0420","0977","836","669","167","82","918","1861","0","49.33","35.95"
"68","000","00","004","0421","0000","1737","1388","349","124","1861","3841","0","48.45","36.14"
"68","000","00","004","0421","0975","967","807","160","76","1043","2290","0","45.55","35.24"
"68","000","00","004","0421","0976","770","581","189","48","818","1551","0","52.74","37.46"
"68","000","00","004","0422","0000","1306","1010","296","117","1423","2685","0","53.0","37.62"
"68","000","00","004","0422","0980","732","575","157","68","800","1498","0","53.4","38.38"
"68","000","00","004","0422","0981","574","435","139","49","623","1187","0","52.49","36.65"
"68","000","00","004","0423","0000","1728","1366","362","105","1833","3752","0","48.85","36.41"
"68","000","00","004","0423","1006","814","643","171","61","875","1689","0","51.81","38.07"
"68","000","00","004","0423","1007","914","723","191","44","958","2063","0","46.44","35.05"
"68","000","00","004","0424","0000","1354","1070","284","99","1453","2694","0","53.93","39.72"
"68","000","00","004","0424","0982","649","498","151","56","705","1270","0","55.51","39.21"
"68","000","00","004","0424","0983","705","572","133","43","748","1424","0","52.53","40.17"
"68","000","00","004","0425","0000","2353","1877","476","157","2510","5412","0","46.38","34.68"
"68","000","00","004","0425","0986","744","587","157","70","814","1783","0","45.65","32.92"
"68","000","00","004","0425","0987","789","644","145","23","812","1709","0","47.51","37.68"
"68","000","00","004","0425","0988","820","646","174","64","884","1920","0","46.04","33.65"
"68","000","00","004","0426","0000","1584","1293","291","69","1653","3007","0","54.97","43.0"
"68","000","00","004","0426","0958","753","619","134","29","782","1416","0","55.23","43.71"
"68","000","00","004","0426","0959","831","674","157","40","871","1591","0","54.75","42.36"
"68","000","00","004","0427","0000","2944","2403","541","139","3083","6381","0","48.32","37.66"
"68","000","00","004","0427","0950","948","770","178","43","991","2101","0","47.17","36.65"
"68","000","00","004","0427","0951","1006","819","187","62","1068","2054","0","52.0","39.87"
"68","000","00","004","0427","0952","990","814","176","34","1024","2226","0","46.0","36.57"
"68","000","00","004","0428","0000","1807","1418","389","69","1876","3687","0","50.88","38.46"
"68","000","00","004","0428","0946","679","535","144","14","693","1562","0","44.37","34.25"
"68","000","00","004","0428","0947","1128","883","245","55","1183","2125","0","55.67","41.55"
"68","000","00","004","0429","0000","1561","1248","313","61","1622","3248","0","49.94","38.42"
"68","000","00","004","0429","0953","736","588","148","14","750","1405","0","53.38","41.85"
"68","000","00","004","0429","0954","825","660","165","47","872","1843","0","47.31","35.81"
"68","000","00","004","0430","0000","1680","1327","353","128","1808","3347","0","54.02","39.65"
"68","000","00","004","0430","0971","820","651","169","50","870","1589","0","54.75","40.97"
"68","000","00","004","0430","0972","860","676","184","78","938","1758","0","53.36","38.45"
"68","000","00","004","0431","0000","1699","1367","332","78","1777","3883","0","45.76","35.2"
"68","000","00","004","0431","0995","897","729","168","45","942","2020","0","46.63","36.09"
"68","000","00","004","0431","0996","802","638","164","33","835","1863","0","44.82","34.25"
"68","000","00","004","0432","0000","1724","1376","348","129","1853","3492","0","53.06","39.4"
"68","000","00","004","0432","1001","874","691","183","55","929","1603","0","57.95","43.11"
"68","000","00","004","0432","1002","850","685","165","74","924","1889","0","48.91","36.26"
"68","000","00","004","0433","0000","1636","1334","302","90","1726","3183","0","54.23","41.91"
"68","000","00","004","0433","0999","826","670","156","62","888","1626","0","54.61","41.21"
"68","000","00","004","0433","1000","810","664","146","28","838","1557","0","53.82","42.65"
"68","000","00","004","0434","0000","2751","2279","472","100","2851","5546","0","51.41","41.09"
"68","000","00","004","0434","0939","987","809","178","28","1015","1931","0","52.56","41.9"
"68","000","00","004","0434","0940","911","752","159","44","955","1938","0","49.28","38.8"
"68","000","00","004","0434","0941","853","718","135","28","881","1677","0","52.53","42.81"
"68","000","00","004","0435","0000","957","776","181","41","998","1911","0","52.22","40.61"
"68","000","00","004","0435","0935","957","776","181","41","998","1911","0","52.22","40.61"
"68","000","00","004","0436","0000","1473","1210","263","64","1537","3479","0","44.18","34.78"
"68","000","00","004","0436","0944","582","479","103","20","602","1541","0","39.07","31.08"
"68","000","00","004","0436","0945","891","731","160","44","935","1938","0","48.25","37.72"
"68","000","00","004","0437","0000","1384","1076","308","94","1478","2725","0","54.24","39.49"
"68","000","00","004","0437","0993","615","461","154","34","649","1234","0","52.59","37.36"
"68","000","00","004","0437","0994","769","615","154","60","829","1491","0","55.6","41.25"
"68","000","00","004","0438","0000","1289","1007","282","108","1397","2926","0","47.74","34.42"
"68","000","00","004","0438","0978","482","353","129","54","536","1141","0","46.98","30.94"
"68","000","00","004","0438","0979","807","654","153","54","861","1785","0","48.24","36.64"
"68","000","00","004","0439","0000","980","785","195","50","1030","2324","0","44.32","33.78"
"68","000","00","004","0439","0955","980","785","195","50","1030","2324","0","44.32","33.78"
"68","000","00","004","0440","0000","1703","1351","352","77","1780","3323","0","53.57","40.66"
"68","000","00","004","0440","0948","840","668","172","48","888","1516","0","58.58","44.06"
"68","000","00","004","0440","0949","863","683","180","29","892","1807","0","49.36","37.8"
"68","000","00","004","0441","0000","1304","1102","202","51","1355","2807","0","48.27","39.26"
"68","000","00","004","0441","0984","649","623","26","21","670","1273","0","52.63","48.94"
"68","000","00","004","0441","0985","655","479","176","30","685","1534","0","44.65","31.23"
"68","000","00","005","0000","0000","61129","47832","13297","3997","65126","129252","164057","50.39","37.01"
"68","000","00","005","0501","0000","1294","951","343","182","1476","2896","0","50.97","32.84"
"68","000","00","005","0501","0396","609","458","151","94","703","1358","0","51.77","33.73"
"68","000","00","005","0501","0397","685","493","192","88","773","1538","0","50.26","32.05"
"68","000","00","005","0502","0000","1676","1305","371","139","1815","3791","0","47.88","34.42"
"68","000","00","005","0502","0398","817","628","189","70","887","2118","0","41.88","29.65"
"68","000","00","005","0502","0399","859","677","182","69","928","1673","0","55.47","40.47"
"68","000","00","005","0503","0000","2094","1647","447","131","2225","4816","0","46.2","34.2"
"68","000","00","005","0503","0404","618","492","126","32","650","1446","0","44.95","34.02"
"68","000","00","005","0503","0405","693","527","166","62","755","1623","0","46.52","32.47"
"68","000","00","005","0503","0406","783","628","155","37","820","1747","0","46.94","35.95"
"68","000","00","005","0504","0000","2111","1694","417","130","2241","4687","0","47.81","36.14"
"68","000","00","005","0504","0411","1021","804","217","66","1087","2189","0","49.66","36.73"
"68","000","00","005","0504","0412","1090","890","200","64","1154","2498","0","46.2","35.63"
"68","000","00","005","0506","0000","1699","1311","388","172","1871","4088","0","45.77","32.07"
"68","000","00","005","0506","0414","789","599","190","92","881","1991","0","44.25","30.09"
"68","000","00","005","0506","0415","910","712","198","80","990","2097","0","47.21","33.95"
"68","000","00","005","0507","0000","1661","1278","383","90","1751","3567","0","49.09","35.83"
"68","000","00","005","0507","0430","903","685","218","61","964","1864","0","51.72","36.75"
"68","000","00","005","0507","0431","758","593","165","29","787","1703","0","46.21","34.82"
"68","000","00","005","0508","0000","1845","1413","432","115","1960","3815","0","51.38","37.04"
"68","000","00","005","0508","0432","859","672","187","44","903","1893","0","47.7","35.5"
"68","000","00","005","0508","0433","986","741","245","71","1057","1922","0","54.99","38.55"
"68","000","00","005","0509","0000","1246","1016","230","73","1319","2380","0","55.42","42.69"
"68","000","00","005","0509","0440","660","543","117","51","711","1181","0","60.2","45.98"
"68","000","00","005","0509","0441","586","473","113","22","608","1199","0","50.71","39.45"
"68","000","00","005","0510","0000","1166","898","268","151","1317","2521","0","52.24","35.62"
"68","000","00","005","0510","0459","504","395","109","56","560","1318","0","42.49","29.97"
"68","000","00","005","0510","0460","662","503","159","95","757","1203","0","62.93","41.81"
"68","000","00","005","0511","0000","771","603","168","30","801","1771","0","45.23","34.05"
"68","000","00","005","0511","0461","771","603","168","30","801","1771","0","45.23","34.05"
"68","000","00","005","0512","0000","1527","1118","409","195","1722","3595","0","47.9","31.1"
"68","000","00","005","0512","0462","734","531","203","95","829","1832","0","45.25","28.98"
"68","000","00","005","0512","0463","793","587","206","100","893","1763","0","50.65","33.3"
"68","000","00","005","0513","0000","579","526","53","20","599","1497","0","40.01","35.14"
"68","000","00","005","0513","0464","579","526","53","20","599","1497","0","40.01","35.14"
"68","000","00","005","0514","0000","867","671","196","121","988","1671","0","59.13","40.16"
"68","000","00","005","0514","0465","867","671","196","121","988","1671","0","59.13","40.16"
"68","000","00","005","0515","0000","1203","874","329","200","1403","2488","0","56.39","35.13"
"68","000","00","005","0515","0466","453","341","112","80","533","929","0","57.37","36.71"
"68","000","00","005","0515","0467","750","533","217","120","870","1559","0","55.81","34.19"
"68","000","00","005","0516","0000","1529","1187","342","121","1650","2938","0","56.16","40.4"
"68","000","00","005","0516","0468","702","568","134","37","739","1497","0","49.37","37.94"
"68","000","00","005","0516","0469","827","619","208","84","911","1441","0","63.22","42.96"
"68","000","00","005","0517","0000","1464","1153","311","58","1522","3161","0","48.15","36.48"
"68","000","00","005","0517","0428","688","515","173","25","713","1668","0","42.75","30.88"
"68","000","00","005","0517","0429","776","638","138","33","809","1493","0","54.19","42.73"
"68","000","00","005","0518","0000","2478","1950","528","128","2606","5039","0","51.72","38.7"
"68","000","00","005","0518","0416","804","628","176","43","847","1558","0","54.36","40.31"
"68","000","00","005","0518","0417","942","754","188","45","987","1891","0","52.19","39.87"
"68","000","00","005","0518","0418","732","568","164","40","772","1590","0","48.55","35.72"
"68","000","00","005","0519","0000","1173","925","248","76","1249","2588","0","48.26","35.74"
"68","000","00","005","0519","0438","574","442","132","31","605","1232","0","49.11","35.88"
"68","000","00","005","0519","0439","599","483","116","45","644","1356","0","47.49","35.62"
"68","000","00","005","0520","0000","1516","1183","333","92","1608","3150","0","51.05","37.56"
"68","000","00","005","0520","0436","820","667","153","35","855","1688","0","50.65","39.51"
"68","000","00","005","0520","0437","696","516","180","57","753","1462","0","51.5","35.29"
"68","000","00","005","0521","0000","657","557","100","33","690","1322","0","52.19","42.13"
"68","000","00","005","0521","0413","657","557","100","33","690","1322","0","52.19","42.13"
"68","000","00","005","0522","0000","1651","1289","362","122","1773","3425","0","51.77","37.64"
"68","000","00","005","0522","0407","946","720","226","73","1019","1988","0","51.26","36.22"
"68","000","00","005","0522","0408","705","569","136","49","754","1437","0","52.47","39.6"
"68","000","00","005","0523","0000","1431","1112","319","112","1543","2979","0","51.8","37.33"
"68","000","00","005","0523","0409","783","596","187","69","852","1532","0","55.61","38.9"
"68","000","00","005","0523","0410","648","516","132","43","691","1447","0","47.75","35.66"
"68","000","00","005","0524","0000","1599","1266","333","104","1703","3172","0","53.69","39.91"
"68","000","00","005","0524","0457","802","619","183","54","856","1483","0","57.72","41.74"
"68","000","00","005","0524","0458","797","647","150","50","847","1689","0","50.15","38.31"
"68","000","00","005","0525","0000","2084","1655","429","90","2174","4595","0","47.31","36.02"
"68","000","00","005","0525","0453","1259","1006","253","52","1311","2727","0","48.07","36.89"
"68","000","00","005","0525","0454","825","649","176","38","863","1868","0","46.2","34.74"
"68","000","00","005","0526","0000","2022","1574","448","90","2112","4233","0","49.89","37.18"
"68","000","00","005","0526","0446","974","769","205","52","1026","2055","0","49.93","37.42"
"68","000","00","005","0526","0447","1048","805","243","38","1086","2178","0","49.86","36.96"
"68","000","00","005","0527","0000","1674","1309","365","82","1756","3551","0","49.45","36.86"
"68","000","00","005","0527","0425","790","607","183","44","834","1731","0","48.18","35.07"
"68","000","00","005","0527","0426","884","702","182","38","922","1820","0","50.66","38.57"
"68","000","00","005","0528","0000","2219","1767","452","104","2323","4926","0","47.16","35.87"
"68","000","00","005","0528","0419","1018","788","230","56","1074","2404","0","44.68","32.78"
"68","000","00","005","0528","0420","1201","979","222","48","1249","2522","0","49.52","38.82"
"68","000","00","005","0529","0000","1637","1292","345","85","1722","3348","0","51.43","38.59"
"68","000","00","005","0529","0421","804","628","176","37","841","1633","0","51.5","38.46"
"68","000","00","005","0529","0422","833","664","169","48","881","1715","0","51.37","38.72"
"68","000","00","005","0530","0000","814","634","180","61","875","1633","0","53.58","38.82"
"68","000","00","005","0530","0427","814","634","180","61","875","1633","0","53.58","38.82"
"68","000","00","005","0531","0000","2789","2249","540","136","2925","5379","0","54.38","41.81"
"68","000","00","005","0531","0449","864","697","167","53","917","1667","0","55.01","41.81"
"68","000","00","005","0531","0450","903","737","166","35","938","1745","0","53.75","42.23"
"68","000","00","005","0531","0451","1022","815","207","48","1070","1967","0","54.4","41.43"
"68","000","00","005","0532","0000","1827","1427","400","79","1906","3511","0","54.29","40.64"
"68","000","00","005","0532","0448","867","672","195","44","911","1709","0","53.31","39.32"
"68","000","00","005","0532","0452","960","755","205","35","995","1802","0","55.22","41.9"
"68","000","00","005","0533","0000","1571","1243","328","68","1639","3133","0","52.31","39.67"
"68","000","00","005","0533","0442","889","691","198","27","916","1710","0","53.57","40.41"
"68","000","00","005","0533","0443","682","552","130","41","723","1423","0","50.81","38.79"
"68","000","00","005","0534","0000","1611","1239","372","78","1689","3161","0","53.43","39.2"
"68","000","00","005","0534","0444","771","592","179","44","815","1522","0","53.55","38.9"
"68","000","00","005","0534","0445","840","647","193","34","874","1639","0","53.33","39.48"
"68","000","00","005","0535","0000","1392","1074","318","82","1474","2731","0","53.97","39.33"
"68","000","00","005","0535","0434","700","553","147","40","740","1393","0","53.12","39.7"
"68","000","00","005","0535","0435","692","521","171","42","734","1338","0","54.86","38.94"
"68","000","00","005","0536","0000","2085","1697","388","87","2172","4604","0","47.18","36.86"
"68","000","00","005","0536","0402","1079","891","188","58","1137","2250","0","50.53","39.6"
"68","000","00","005","0536","0403","1006","806","200","29","1035","2354","0","43.97","34.24"
"68","000","00","005","0537","0000","1599","1274","325","88","1687","3199","0","52.74","39.82"
"68","000","00","005","0537","0400","746","597","149","34","780","1500","0","52.0","39.8"
"68","000","00","005","0537","0401","853","677","176","54","907","1699","0","53.38","39.85"
"68","000","00","005","0538","0000","1545","1172","373","77","1622","3153","0","51.44","37.17"
"68","000","00","005","0538","0455","739","567","172","39","778","1537","0","50.62","36.89"
"68","000","00","005","0538","0456","806","605","201","38","844","1616","0","52.23","37.44"
"68","000","00","005","0539","0000","1882","1447","435","72","1954","4244","0","46.04","34.1"
"68","000","00","005","0539","0423","944","713","231","30","974","2215","0","43.97","32.19"
"68","000","00","005","0539","0424","938","734","204","42","980","2029","0","48.3","36.18"
"68","000","00","005","0540","0000","1141","852","289","123","1264","2494","0","50.68","34.16"
"68","000","00","005","0540","0470","669","508","161","67","736","1465","0","50.24","34.68"
"68","000","00","005","0540","0471","472","344","128","56","528","1029","0","51.31","33.43"
"68","000","00","006","0000","0000","33892","26424","7468","2188","36080","73900","90407","48.82","35.76"
"68","000","00","006","0601","0000","2805","2198","607","186","2991","6145","0","48.67","35.77"
"68","000","00","006","0601","0472","649","497","152","55","704","1538","0","45.77","32.31"
"68","000","00","006","0601","0473","610","480","130","30","640","1616","0","39.6","29.7"
"68","000","00","006","0601","0474","752","580","172","56","808","1437","0","56.23","40.36"
"68","000","00","006","0601","0475","794","641","153","45","839","1554","0","53.99","41.25"
"68","000","00","006","0602","0000","2998","2356","642","206","3204","6471","0","49.51","36.41"
"68","000","00","006","0602","0476","596","459","137","46","642","1237","0","51.9","37.11"
"68","000","00","006","0602","0477","637","490","147","58","695","1347","0","51.6","36.38"
"68","000","00","006","0602","0478","580","456","124","30","610","1261","0","48.37","36.16"
"68","000","00","006","0602","0479","594","481","113","41","635","1256","0","50.56","38.3"
"68","000","00","006","0602","0480","591","470","121","31","622","1370","0","45.4","34.31"
"68","000","00","006","0603","0000","1938","1480","458","125","2063","4617","0","44.68","32.06"
"68","000","00","006","0603","0481","691","520","171","47","738","1610","0","45.84","32.3"
"68","000","00","006","0603","0482","654","494","160","52","706","1419","0","49.75","34.81"
"68","000","00","006","0603","0483","593","466","127","26","619","1588","0","38.98","29.35"
"68","000","00","006","0604","0000","752","594","158","50","802","1612","0","49.75","36.85"
"68","000","00","006","0604","0484","752","594","158","50","802","1612","0","49.75","36.85"
"68","000","00","006","0605","0000","4878","3829","1049","291","5169","10011","0","51.63","38.25"
"68","000","00","006","0605","0485","665","510","155","47","712","1440","0","49.44","35.42"
"68","000","00","006","0605","0486","595","438","157","49","644","1326","0","48.57","33.03"
"68","000","00","006","0605","0487","761","605","156","57","818","1455","0","56.22","41.58"
"68","000","00","006","0605","0488","777","611","166","60","837","1562","0","53.59","39.12"
"68","000","00","006","0605","0489","677","541","136","36","713","1284","0","55.53","42.13"
"68","000","00","006","0605","0490","667","525","142","20","687","1454","0","47.25","36.11"
"68","000","00","006","0605","0491","736","599","137","22","758","1490","0","50.87","40.2"
"68","000","00","006","0606","0000","2192","1688","504","191","2383","4861","0","49.02","34.73"
"68","000","00","006","0606","0492","667","516","151","47","714","1617","0","44.16","31.91"
"68","000","00","006","0606","0493","739","558","181","86","825","1594","0","51.76","35.01"
"68","000","00","006","0606","0494","786","614","172","58","844","1650","0","51.15","37.21"
"68","000","00","006","0607","0000","2698","2102","596","151","2849","5896","0","48.32","35.65"
"68","000","00","006","0607","0495","639","495","144","25","664","1467","0","45.26","33.74"
"68","000","00","006","0607","0496","703","540","163","37","740","1494","0","49.53","36.14"
"68","000","00","006","0607","0497","710","561","149","62","772","1538","0","50.2","36.48"
"68","000","00","006","0607","0498","646","506","140","27","673","1397","0","48.17","36.22"
"68","000","00","006","0608","0000","727","572","155","29","756","1637","0","46.18","34.94"
"68","000","00","006","0608","0499","727","572","155","29","756","1637","0","46.18","34.94"
"68","000","00","006","0610","0000","1392","1085","307","116","1508","2866","0","52.62","37.86"
"68","000","00","006","0610","0500","641","498","143","58","699","1452","0","48.14","34.3"
"68","000","00","006","0610","0501","751","587","164","58","809","1414","0","57.21","41.51"
"68","000","00","006","0611","0000","2792","2250","542","162","2954","6871","0","42.99","32.75"
"68","000","00","006","0611","0502","754","588","166","49","803","1670","0","48.08","35.21"
"68","000","00","006","0611","0503","620","568","52","28","648","1701","0","38.1","33.39"
"68","000","00","006","0611","0504","698","542","156","39","737","1813","0","40.65","29.9"
"68","000","00","006","0611","0505","720","552","168","46","766","1687","0","45.41","32.72"
"68","000","00","006","0612","0000","1615","1301","314","65","1680","3206","0","52.4","40.58"
"68","000","00","006","0612","0506","800","652","148","16","816","1650","0","49.45","39.52"
"68","000","00","006","0612","0507","815","649","166","49","864","1556","0","55.53","41.71"
"68","000","00","006","0613","0000","767","575","192","44","811","1844","0","43.98","31.18"
"68","000","00","006","0613","0508","767","575","192","44","811","1844","0","43.98","31.18"
"68","000","00","006","0614","0000","1313","972","341","124","1437","2750","0","52.25","35.35"
"68","000","00","006","0614","0509","593","451","142","60","653","1336","0","48.88","33.76"
"68","000","00","006","0614","0510","720","521","199","64","784","1414","0","55.45","36.85"
"68","000","00","006","0615","0000","1358","1047","311","119","1477","2465","0","59.92","42.47"
"68","000","00","006","0615","0511","674","529","145","62","736","1238","0","59.45","42.73"
"68","000","00","006","0615","0512","684","518","166","57","741","1227","0","60.39","42.22"
"68","000","00","006","0616","0000","1125","838","287","55","1180","2548","0","46.31","32.89"
"68","000","00","006","0616","0513","548","414","134","29","577","1199","0","48.12","34.53"
"68","000","00","006","0616","0514","577","424","153","26","603","1349","0","44.7","31.43"
"68","000","00","006","0617","0000","1044","812","232","57","1101","2200","0","50.05","36.91"
"68","000","00","006","0617","0515","526","414","112","29","555","1120","0","49.55","36.96"
"68","000","00","006","0617","0516","518","398","120","28","546","1080","0","50.56","36.85"
"68","000","00","006","0618","0000","1281","977","304","87","1368","2686","0","50.93","36.37"
"68","000","00","006","0618","0517","611","475","136","46","657","1341","0","48.99","35.42"
"68","000","00","006","0618","0518","670","502","168","41","711","1345","0","52.86","37.32"
"68","000","00","006","0619","0000","2217","1748","469","130","2347","5214","0","45.01","33.53"
"68","000","00","006","0619","0519","657","518","139","48","705","1565","0","45.05","33.1"
"68","000","00","006","0619","0520","634","504","130","23","657","1519","0","43.25","33.18"
"68","000","00","006","0619","0521","926","726","200","59","985","2130","0","46.24","34.08"
"68","000","00","007","0000","0000","60290","46731","13559","3728","64018","131702","160182","48.61","35.48"
"68","000","00","007","0701","0000","1849","1391","458","93","1942","3735","0","51.99","37.24"
"68","000","00","007","0701","0270","704","515","189","22","726","1455","0","49.9","35.4"
"68","000","00","007","0701","0271","1145","876","269","71","1216","2280","0","53.33","38.42"
"68","000","00","007","0702","0000","3206","2462","744","227","3433","6706","0","51.19","36.71"
"68","000","00","007","0702","0231","1044","812","232","64","1108","2178","0","50.87","37.28"
"68","000","00","007","0702","0232","822","611","211","72","894","1672","0","53.47","36.54"
"68","000","00","007","0702","0233","639","520","119","42","681","1376","0","49.49","37.79"
"68","000","00","007","0702","0234","701","519","182","49","750","1480","0","50.68","35.07"
"68","000","00","007","0703","0000","1919","1456","463","195","2114","4353","0","48.56","33.45"
"68","000","00","007","0703","0261","394","299","95","34","428","841","0","50.89","35.55"
"68","000","00","007","0703","0262","950","716","234","96","1046","2284","0","45.8","31.35"
"68","000","00","007","0703","0263","575","441","134","65","640","1228","0","52.12","35.91"
"68","000","00","007","0704","0000","2771","2159","612","184","2955","5735","0","51.53","37.65"
"68","000","00","007","0704","0235","651","505","146","40","691","1258","0","54.93","40.14"
"68","000","00","007","0704","0236","715","569","146","23","738","1464","0","50.41","38.87"
"68","000","00","007","0704","0237","827","625","202","95","922","1844","0","50.0","33.89"
"68","000","00","007","0704","0238","578","460","118","26","604","1169","0","51.67","39.35"
"68","000","00","007","0705","0000","1534","1220","314","88","1622","3253","0","49.86","37.5"
"68","000","00","007","0705","0245","890","722","168","36","926","1788","0","51.79","40.38"
"68","000","00","007","0705","0246","644","498","146","52","696","1465","0","47.51","33.99"
"68","000","00","007","0706","0000","2381","1825","556","131","2512","5386","0","46.64","33.88"
"68","000","00","007","0706","0239","701","546","155","34","735","1921","0","38.26","28.42"
"68","000","00","007","0706","0240","766","576","190","30","796","1694","0","46.99","34.0"
"68","000","00","007","0706","0241","914","703","211","67","981","1771","0","55.39","39.7"
"68","000","00","007","0707","0000","1815","1555","260","116","1931","3629","0","53.21","42.85"
"68","000","00","007","0707","0220","891","785","106","58","949","1744","0","54.42","45.01"
"68","000","00","007","0707","0221","924","770","154","58","982","1885","0","52.1","40.85"
"68","000","00","007","0708","0000","2450","2011","439","141","2591","5033","0","51.48","39.96"
"68","000","00","007","0708","0217","455","390","65","27","482","874","0","55.15","44.62"
"68","000","00","007","0708","0218","995","825","170","79","1074","2014","0","53.33","40.96"
"68","000","00","007","0708","0219","1000","796","204","35","1035","2145","0","48.25","37.11"
"68","000","00","007","0709","0000","581","427","154","36","617","1156","0","53.37","36.94"
"68","000","00","007","0709","0276","581","427","154","36","617","1156","0","53.37","36.94"
"68","000","00","007","0710","0000","1639","1250","389","86","1725","3553","0","48.55","35.18"
"68","000","00","007","0710","0272","798","594","204","43","841","1668","0","50.42","35.61"
"68","000","00","007","0710","0273","841","656","185","43","884","1885","0","46.9","34.8"
"68","000","00","007","0711","0000","874","653","221","105","979","1840","0","53.21","35.49"
"68","000","00","007","0711","0289","874","653","221","105","979","1840","0","53.21","35.49"
"68","000","00","007","0712","0000","841","666","175","62","903","1917","0","47.1","34.74"
"68","000","00","007","0712","0267","841","666","175","62","903","1917","0","47.1","34.74"
"68","000","00","007","0713","0000","2071","1585","486","181","2252","4707","0","47.84","33.67"
"68","000","00","007","0713","0222","686","524","162","66","752","1546","0","48.64","33.89"
"68","000","00","007","0713","0223","765","592","173","71","836","1684","0","49.64","35.15"
"68","000","00","007","0713","0224","620","469","151","44","664","1477","0","44.96","31.75"
"68","000","00","007","0714","0000","2079","1573","506","218","2297","4832","0","47.54","32.55"
"68","000","00","007","0714","0242","728","546","182","61","789","1665","0","47.39","32.79"
"68","000","00","007","0714","0243","647","481","166","87","734","1439","0","51.01","33.43"
"68","000","00","007","0714","0244","704","546","158","70","774","1728","0","44.79","31.6"
"68","000","00","007","0715","0000","2728","2108","620","215","2943","5448","0","54.02","38.69"
"68","000","00","007","0715","0227","778","609","169","62","840","1525","0","55.08","39.93"
"68","000","00","007","0715","0228","551","413","138","59","610","1041","0","58.6","39.67"
"68","000","00","007","0715","0229","646","496","150","36","682","1404","0","48.58","35.33"
"68","000","00","007","0715","0230","753","590","163","58","811","1478","0","54.87","39.92"
"68","000","00","007","0716","0000","1883","1410","473","149","2032","3952","0","51.42","35.68"
"68","000","00","007","0716","0256","485","351","134","49","534","1005","0","53.13","34.93"
"68","000","00","007","0716","0257","740","578","162","39","779","1449","0","53.76","39.89"
"68","000","00","007","0716","0258","658","481","177","61","719","1498","0","48.0","32.11"
"68","000","00","007","0717","0000","815","626","189","69","884","1752","0","50.46","35.73"
"68","000","00","007","0717","0250","815","626","189","69","884","1752","0","50.46","35.73"
"68","000","00","007","0718","0000","1063","798","265","89","1152","2439","0","47.23","32.72"
"68","000","00","007","0718","0265","579","433","146","40","619","1378","0","44.92","31.42"
"68","000","00","007","0718","0266","484","365","119","49","533","1061","0","50.24","34.4"
"68","000","00","007","0719","0000","1604","1217","387","99","1703","4057","0","41.98","30.0"
"68","000","00","007","0719","0277","820","620","200","64","884","2114","0","41.82","29.33"
"68","000","00","007","0719","0278","784","597","187","35","819","1943","0","42.15","30.73"
"68","000","00","007","0720","0000","2773","2097","676","153","2926","6056","0","48.32","34.63"
"68","000","00","007","0720","0286","1040","773","267","65","1105","2187","0","50.53","35.35"
"68","000","00","007","0720","0287","906","701","205","47","953","1959","0","48.65","35.78"
"68","000","00","007","0720","0288","827","623","204","41","868","1910","0","45.45","32.62"
"68","000","00","007","0721","0000","1080","852","228","51","1131","2266","0","49.91","37.6"
"68","000","00","007","0721","0290","1080","852","228","51","1131","2266","0","49.91","37.6"
"68","000","00","007","0722","0000","1996","1559","437","97","2093","5170","0","40.48","30.15"
"68","000","00","007","0722","0247","653","509","144","37","690","1659","0","41.59","30.68"
"68","000","00","007","0722","0248","691","538","153","34","725","1693","0","42.82","31.78"
"68","000","00","007","0722","0249","652","512","140","26","678","1818","0","37.29","28.16"
"68","000","00","007","0723","0000","724","574","150","56","780","1979","0","39.41","29.0"
"68","000","00","007","0723","0264","724","574","150","56","780","1979","0","39.41","29.0"
"68","000","00","007","0724","0000","1554","1150","404","64","1618","3317","0","48.78","34.67"
"68","000","00","007","0724","0251","845","601","244","41","886","1818","0","48.73","33.06"
"68","000","00","007","0724","0252","709","549","160","23","732","1499","0","48.83","36.62"
"68","000","00","007","0725","0000","2660","2027","633","150","2810","5847","0","48.06","34.67"
"68","000","00","007","0725","0253","901","714","187","53","954","1916","0","49.79","37.27"
"68","000","00","007","0725","0254","803","593","210","61","864","1804","0","47.89","32.87"
"68","000","00","007","0725","0255","956","720","236","36","992","2127","0","46.64","33.85"
"68","000","00","007","0726","0000","1524","1153","371","85","1609","3920","0","41.05","29.41"
"68","000","00","007","0726","0259","900","666","234","55","955","2149","0","44.44","30.99"
"68","000","00","007","0726","0260","624","487","137","30","654","1771","0","36.93","27.5"
"68","000","00","007","0727","0000","2418","1831","587","114","2532","5139","0","49.27","35.63"
"68","000","00","007","0727","0279","808","610","198","26","834","1800","0","46.33","33.89"
"68","000","00","007","0727","0280","916","691","225","53","969","2020","0","47.97","34.21"
"68","000","00","007","0727","0281","694","530","164","35","729","1319","0","55.27","40.18"
"68","000","00","007","0728","0000","4018","3166","852","164","4182","8591","0","48.68","36.85"
"68","000","00","007","0728","0282","1121","856","265","43","1164","2229","0","52.22","38.4"
"68","000","00","007","0728","0283","907","718","189","31","938","1992","0","47.09","36.04"
"68","000","00","007","0728","0284","993","787","206","59","1052","2237","0","47.03","35.18"
"68","000","00","007","0728","0285","997","805","192","31","1028","2133","0","48.2","37.74"
"68","000","00","007","0729","0000","1780","1336","444","58","1838","3553","0","51.73","37.6"
"68","000","00","007","0729","0274","868","682","186","28","896","1849","0","48.46","36.88"
"68","000","00","007","0729","0275","912","654","258","30","942","1704","0","55.28","38.38"
"68","000","00","007","0730","0000","1075","879","196","73","1148","2956","0","38.84","29.74"
"68","000","00","007","0730","0225","799","664","135","58","857","1528","0","56.09","43.46"
"68","000","00","007","0730","0226","276","215","61","15","291","1428","0","20.38","15.06"
"68","000","00","007","0731","0000","2977","2414","563","109","3086","6452","0","47.83","37.41"
"68","000","00","007","0731","0291","1030","864","166","29","1059","2387","0","44.37","36.2"
"68","000","00","007","0731","0292","749","596","153","36","785","1692","0","46.39","35.22"
"68","000","00","007","0731","0293","446","348","98","14","460","904","0","50.88","38.5"
"68","000","00","007","0731","0294","752","606","146","30","782","1469","0","53.23","41.25"
"68","000","00","007","0732","0000","1608","1301","307","70","1678","2973","0","56.44","43.76"
"68","000","00","007","0732","0268","862","674","188","42","904","1540","0","58.7","43.77"
"68","000","00","007","0732","0269","746","627","119","28","774","1433","0","54.01","43.75"
"68","000","00","008","0000","0000","77486","61711","15775","5315","82801","165065","201493","50.16","37.39"
"68","000","00","008","0801","0000","2702","2205","497","164","2866","7162","0","40.02","30.79"
"68","000","00","008","0801","0295","755","582","173","74","829","1761","0","47.08","33.05"
"68","000","00","008","0801","0296","705","643","62","17","722","1804","0","40.02","35.64"
"68","000","00","008","0801","0297","474","362","112","36","510","1813","0","28.13","19.97"
"68","000","00","008","0801","0298","768","618","150","37","805","1784","0","45.12","34.64"
"68","000","00","008","0802","0000","3501","2815","686","176","3677","8278","0","44.42","34.01"
"68","000","00","008","0802","0299","906","741","165","43","949","2257","0","42.05","32.83"
"68","000","00","008","0802","0300","710","575","135","37","747","1857","0","40.23","30.96"
"68","000","00","008","0802","0301","953","761","192","42","995","2261","0","44.01","33.66"
"68","000","00","008","0802","0302","932","738","194","54","986","1903","0","51.81","38.78"
"68","000","00","008","0803","0000","1624","1287","337","57","1681","3620","0","46.44","35.55"
"68","000","00","008","0803","0303","931","734","197","46","977","1955","0","49.97","37.54"
"68","000","00","008","0803","0304","693","553","140","11","704","1665","0","42.28","33.21"
"68","000","00","008","0804","0000","1508","1213","295","116","1624","3216","0","50.5","37.72"
"68","000","00","008","0804","0310","830","655","175","74","904","1630","0","55.46","40.18"
"68","000","00","008","0804","0311","678","558","120","42","720","1586","0","45.4","35.18"
"68","000","00","008","0805","0000","1577","1251","326","175","1752","3559","0","49.23","35.15"
"68","000","00","008","0805","0312","773","608","165","88","861","1649","0","52.21","36.87"
"68","000","00","008","0805","0313","804","643","161","87","891","1910","0","46.65","33.66"
"68","000","00","008","0806","0000","1604","1297","307","135","1739","3252","0","53.47","39.88"
"68","000","00","008","0806","0314","804","637","167","88","892","1612","0","55.33","39.52"
"68","000","00","008","0806","0315","800","660","140","47","847","1640","0","51.65","40.24"
"68","000","00","008","0807","0000","1561","1258","303","138","1699","3273","0","51.91","38.44"
"68","000","00","008","0807","0318","811","644","167","55","866","1711","0","50.61","37.64"
"68","000","00","008","0807","0319","750","614","136","83","833","1562","0","53.33","39.31"
"68","000","00","008","0808","0000","2192","1781","411","146","2338","4415","0","52.96","40.34"
"68","000","00","008","0808","0320","830","693","137","52","882","1735","0","50.84","39.94"
"68","000","00","008","0808","0321","799","643","156","45","844","1658","0","50.9","38.78"
"68","000","00","008","0808","0322","563","445","118","49","612","1022","0","59.88","43.54"
"68","000","00","008","0809","0000","1509","1210","299","91","1600","3414","0","46.87","35.44"
"68","000","00","008","0809","0323","711","562","149","54","765","1673","0","45.73","33.59"
"68","000","00","008","0809","0324","798","648","150","37","835","1741","0","47.96","37.22"
"68","000","00","008","0810","0000","988","799","189","78","1066","2110","0","50.52","37.87"
"68","000","00","008","0810","0325","988","799","189","78","1066","2110","0","50.52","37.87"
"68","000","00","008","0811","0000","1345","1073","272","97","1442","2519","0","57.24","42.6"
"68","000","00","008","0811","0331","719","569","150","42","761","1341","0","56.75","42.43"
"68","000","00","008","0811","0332","626","504","122","55","681","1178","0","57.81","42.78"
"68","000","00","008","0812","0000","1461","1124","337","144","1605","3871","0","41.46","29.04"
"68","000","00","008","0812","0335","772","596","176","71","843","1943","0","43.39","30.67"
"68","000","00","008","0812","0336","689","528","161","73","762","1928","0","39.52","27.39"
"68","000","00","008","0813","0000","1450","1127","323","98","1548","3147","0","49.19","35.81"
"68","000","00","008","0813","0339","838","636","202","53","891","1947","0","45.76","32.67"
"68","000","00","008","0813","0340","612","491","121","45","657","1200","0","54.75","40.92"
"68","000","00","008","0814","0000","1665","1274","391","142","1807","3883","0","46.54","32.81"
"68","000","00","008","0814","0341","816","628","188","76","892","1895","0","47.07","33.14"
"68","000","00","008","0814","0342","849","646","203","66","915","1988","0","46.03","32.49"
"68","000","00","008","0815","0000","1744","1365","379","128","1872","3410","0","54.9","40.03"
"68","000","00","008","0815","0348","650","493","157","60","710","1317","0","53.91","37.43"
"68","000","00","008","0815","0349","1094","872","222","68","1162","2093","0","55.52","41.66"
"68","000","00","008","0816","0000","1720","1360","360","83","1803","3545","0","50.86","38.36"
"68","000","00","008","0816","0351","857","677","180","52","909","1782","0","51.01","37.99"
"68","000","00","008","0816","0352","863","683","180","31","894","1763","0","50.71","38.74"
"68","000","00","008","0817","0000","3264","2673","591","190","3454","6933","0","49.82","38.55"
"68","000","00","008","0817","0359","958","765","193","62","1020","1998","0","51.05","38.29"
"68","000","00","008","0817","0360","479","385","94","31","510","916","0","55.68","42.03"
"68","000","00","008","0817","0361","874","705","169","55","929","1943","0","47.81","36.28"
"68","000","00","008","0817","0362","953","818","135","42","995","2076","0","47.93","39.4"
"68","000","00","008","0818","0000","779","628","151","58","837","1505","0","55.61","41.73"
"68","000","00","008","0818","0371","779","628","151","58","837","1505","0","55.61","41.73"
"68","000","00","008","0819","0000","1591","1254","337","142","1733","3303","0","52.47","37.97"
"68","000","00","008","0819","0373","808","617","191","70","878","1618","0","54.26","38.13"
"68","000","00","008","0819","0374","783","637","146","72","855","1685","0","50.74","37.8"
"68","000","00","008","0820","0000","1657","1327","330","128","1785","3716","0","48.04","35.71"
"68","000","00","008","0820","0375","787","629","158","54","841","1835","0","45.83","34.28"
"68","000","00","008","0820","0376","870","698","172","74","944","1881","0","50.19","37.11"
"68","000","00","008","0821","0000","788","630","158","46","834","1766","0","47.23","35.67"
"68","000","00","008","0821","0377","788","630","158","46","834","1766","0","47.23","35.67"
"68","000","00","008","0822","0000","2874","2312","562","165","3039","5083","0","59.79","45.48"
"68","000","00","008","0822","0385","917","718","199","53","970","1685","0","57.57","42.61"
"68","000","00","008","0822","0386","884","688","196","60","944","1748","0","54.0","39.36"
"68","000","00","008","0822","0387","1073","906","167","52","1125","1650","0","68.18","54.91"
"68","000","00","008","0823","0000","1952","1495","457","131","2083","3923","0","53.1","38.11"
"68","000","00","008","0823","0390","900","710","190","118","1018","1841","0","55.3","38.57"
"68","000","00","008","0823","0391","1052","785","267","13","1065","2082","0","51.15","37.7"
"68","000","00","008","0824","0000","1561","1207","354","131","1692","3578","0","47.29","33.73"
"68","000","00","008","0824","0365","712","555","157","71","783","1474","0","53.12","37.65"
"68","000","00","008","0824","0366","164","133","31","10","174","718","0","24.23","18.52"
"68","000","00","008","0824","0367","685","519","166","50","735","1386","0","53.03","37.45"
"68","000","00","008","0825","0000","1298","1061","237","75","1373","2483","0","55.3","42.73"
"68","000","00","008","0825","0355","623","500","123","38","661","1170","0","56.5","42.74"
"68","000","00","008","0825","0356","675","561","114","37","712","1313","0","54.23","42.73"
"68","000","00","008","0826","0000","1776","1378","398","85","1861","4169","0","44.64","33.05"
"68","000","00","008","0826","0344","883","696","187","13","896","2061","0","43.47","33.77"
"68","000","00","008","0826","0345","893","682","211","72","965","2108","0","45.78","32.35"
"68","000","00","008","0827","0000","1928","1562","366","121","2049","4015","0","51.03","38.9"
"68","000","00","008","0827","0378","831","639","192","87","918","1817","0","50.52","35.17"
"68","000","00","008","0827","0379","1097","923","174","34","1131","2198","0","51.46","41.99"
"68","000","00","008","0828","0000","2149","1713","436","138","2287","4185","0","54.65","40.93"
"68","000","00","008","0828","0307","811","643","168","71","882","1583","0","55.72","40.62"
"68","000","00","008","0828","0308","649","523","126","35","684","1246","0","54.9","41.97"
"68","000","00","008","0828","0309","689","547","142","32","721","1356","0","53.17","40.34"
"68","000","00","008","0829","0000","1407","1104","303","111","1518","2854","0","53.19","38.68"
"68","000","00","008","0829","0363","670","525","145","59","729","1363","0","53.48","38.52"
"68","000","00","008","0829","0364","737","579","158","52","789","1491","0","52.92","38.83"
"68","000","00","008","0830","0000","1983","1602","381","115","2098","3951","0","53.1","40.55"
"68","000","00","008","0830","0382","639","504","135","37","676","1257","0","53.78","40.1"
"68","000","00","008","0830","0383","599","464","135","56","655","1267","0","51.7","36.62"
"68","000","00","008","0830","0384","745","634","111","22","767","1427","0","53.75","44.43"
"68","000","00","008","0831","0000","1545","1236","309","107","1652","3085","0","53.55","40.06"
"68","000","00","008","0831","0388","733","579","154","54","787","1478","0","53.25","39.17"
"68","000","00","008","0831","0389","812","657","155","53","865","1607","0","53.83","40.88"
"68","000","00","008","0832","0000","957","737","220","83","1040","2006","0","51.84","36.74"
"68","000","00","008","0832","0343","957","737","220","83","1040","2006","0","51.84","36.74"
"68","000","00","008","0833","0000","1620","1312","308","86","1706","3543","0","48.15","37.03"
"68","000","00","008","0833","0346","836","671","165","51","887","1862","0","47.64","36.04"
"68","000","00","008","0833","0347","784","641","143","35","819","1681","0","48.72","38.13"
"68","000","00","008","0834","0000","789","605","184","63","852","1499","0","56.84","40.36"
"68","000","00","008","0834","0350","789","605","184","63","852","1499","0","56.84","40.36"
"68","000","00","008","0835","0000","636","487","149","65","701","1436","0","48.82","33.91"
"68","000","00","008","0835","0372","636","487","149","65","701","1436","0","48.82","33.91"
"68","000","00","008","0836","0000","1071","849","222","57","1128","2209","0","51.06","38.43"
"68","000","00","008","0836","0393","1071","849","222","57","1128","2209","0","51.06","38.43"
"68","000","00","008","0837","0000","833","641","192","66","899","1959","0","45.89","32.72"
"68","000","00","008","0837","0392","833","641","192","66","899","1959","0","45.89","32.72"
"68","000","00","008","0838","0000","1989","1602","387","106","2095","4531","0","46.24","35.36"
"68","000","00","008","0838","0328","767","610","157","27","794","1848","0","42.97","33.01"
"68","000","00","008","0838","0329","666","543","123","52","718","1334","0","53.82","40.7"
"68","000","00","008","0838","0330","556","449","107","27","583","1349","0","43.22","33.28"
"68","000","00","008","0839","0000","1357","1043","314","95","1452","3075","0","47.22","33.92"
"68","000","00","008","0839","0337","618","463","155","32","650","1403","0","46.33","33.0"
"68","000","00","008","0839","0338","739","580","159","63","802","1672","0","47.97","34.69"
"68","000","00","008","0840","0000","1368","1061","307","98","1466","2694","0","54.42","39.38"
"68","000","00","008","0840","0305","720","550","170","61","781","1431","0","54.58","38.43"
"68","000","00","008","0840","0306","648","511","137","37","685","1263","0","54.24","40.46"
"68","000","00","008","0841","0000","1305","1021","284","98","1403","2537","0","55.3","40.24"
"68","000","00","008","0841","0353","623","474","149","58","681","1226","0","55.55","38.66"
"68","000","00","008","0841","0354","682","547","135","40","722","1311","0","55.07","41.72"
"68","000","00","008","0842","0000","1888","1531","357","84","1972","3821","0","51.61","40.07"
"68","000","00","008","0842","0380","851","691","160","44","895","1732","0","51.67","39.9"
"68","000","00","008","0842","0381","1037","840","197","40","1077","2089","0","51.56","40.21"
"68","000","00","008","0843","0000","1828","1484","344","118","1946","3864","0","50.36","38.41"
"68","000","00","008","0843","0394","924","774","150","50","974","1864","0","52.25","41.52"
"68","000","00","008","0843","0395","904","710","194","68","972","2000","0","48.6","35.5"
"68","000","00","008","0844","0000","1373","1075","298","99","1472","2716","0","54.2","39.58"
"68","000","00","008","0844","0316","625","476","149","38","663","1303","0","50.88","36.53"
"68","000","00","008","0844","0317","748","599","149","61","809","1413","0","57.25","42.39"
"68","000","00","008","0845","0000","1140","938","202","64","1204","2155","0","55.87","43.53"
"68","000","00","008","0845","0326","577","480","97","27","604","1145","0","52.75","41.92"
"68","000","00","008","0845","0327","563","458","105","37","600","1010","0","59.41","45.35"
"68","000","00","008","0846","0000","1977","1624","353","224","2201","4294","0","51.26","37.82"
"68","000","00","008","0846","0368","703","574","129","71","774","1487","0","52.05","38.6"
"68","000","00","008","0846","0369","730","604","126","82","812","1552","0","52.32","38.92"
"68","000","00","008","0846","0370","544","446","98","71","615","1255","0","49.0","35.54"
"68","000","00","008","0847","0000","1358","1031","327","122","1480","2836","0","52.19","36.35"
"68","000","00","008","0847","0333","695","541","154","50","745","1374","0","54.22","39.37"
"68","000","00","008","0847","0334","663","490","173","72","735","1462","0","50.27","33.52"
"68","000","00","008","0848","0000","1294","1049","245","76","1370","2667","0","51.37","39.33"
"68","000","00","008","0848","0357","621","510","111","28","649","1186","0","54.72","43.0"
"68","000","00","008","0848","0358","673","539","134","48","721","1481","0","48.68","36.39"
"68","000","00","009","0000","0000","50896","40992","9904","2941","53837","101574","122981","53.0","40.36"
"68","000","00","009","0901","0000","2177","1750","427","109","2286","4513","0","50.65","38.78"
"68","000","00","009","0901","1008","709","564","145","29","738","1482","0","49.8","38.06"
"68","000","00","009","0901","1009","732","600","132","39","771","1528","0","50.46","39.27"
"68","000","00","009","0901","1010","736","586","150","41","777","1503","0","51.7","38.99"
"68","000","00","009","0902","0000","2773","2223","550","196","2969","5661","0","52.45","39.27"
"68","000","00","009","0902","1013","882","700","182","67","949","2088","0","45.45","33.52"
"68","000","00","009","0902","1014","1026","831","195","86","1112","1987","0","55.96","41.82"
"68","000","00","009","0902","1015","865","692","173","43","908","1586","0","57.25","43.63"
"68","000","00","009","0903","0000","1766","1404","362","99","1865","4006","0","46.56","35.05"
"68","000","00","009","0903","1018","923","731","192","56","979","2081","0","47.04","35.13"
"68","000","00","009","0903","1019","843","673","170","43","886","1925","0","46.03","34.96"
"68","000","00","009","0904","0000","1459","1185","274","89","1548","3188","0","48.56","37.17"
"68","000","00","009","0904","1064","776","620","156","38","814","1649","0","49.36","37.6"
"68","000","00","009","0904","1065","683","565","118","51","734","1539","0","47.69","36.71"
"68","000","00","009","0906","0000","1742","1317","425","158","1900","3662","0","51.88","35.96"
"68","000","00","009","0906","1022","822","615","207","58","880","1790","0","49.16","34.36"
"68","000","00","009","0906","1023","920","702","218","100","1020","1872","0","54.49","37.5"
"68","000","00","009","0907","0000","2057","1638","419","114","2171","4152","0","52.29","39.45"
"68","000","00","009","0907","1026","703","576","127","32","735","1398","0","52.58","41.2"
"68","000","00","009","0907","1027","632","487","145","34","666","1345","0","49.52","36.21"
"68","000","00","009","0907","1028","722","575","147","48","770","1409","0","54.65","40.81"
"68","000","00","009","0908","0000","290","223","67","29","319","678","0","47.05","32.89"
"68","000","00","009","0908","1071","290","223","67","29","319","678","0","47.05","32.89"
"68","000","00","009","0909","0000","2155","1686","469","117","2272","4282","0","53.06","39.37"
"68","000","00","009","0909","1031","778","605","173","51","829","1597","0","51.91","37.88"
"68","000","00","009","0909","1032","713","548","165","13","726","1410","0","51.49","38.87"
"68","000","00","009","0909","1033","664","533","131","53","717","1275","0","56.24","41.8"
"68","000","00","009","0910","0000","2821","2307","514","129","2950","5372","0","54.91","42.94"
"68","000","00","009","0910","1037","953","773","180","54","1007","1786","0","56.38","43.28"
"68","000","00","009","0910","1038","905","726","179","41","946","1756","0","53.87","41.34"
"68","000","00","009","0910","1039","963","808","155","34","997","1830","0","54.48","44.15"
"68","000","00","009","0911","0000","1028","822","206","65","1093","1909","0","57.26","43.06"
"68","000","00","009","0911","1034","1028","822","206","65","1093","1909","0","57.26","43.06"
"68","000","00","009","0912","0000","2273","1783","490","138","2411","4369","0","55.18","40.81"
"68","000","00","009","0912","1066","826","645","181","54","880","1541","0","57.11","41.86"
"68","000","00","009","0912","1067","696","534","162","53","749","1375","0","54.47","38.84"
"68","000","00","009","0912","1068","751","604","147","31","782","1453","0","53.82","41.57"
"68","000","00","009","0913","0000","1624","1339","285","67","1691","3597","0","47.01","37.23"
"68","000","00","009","0913","1042","843","693","150","36","879","1805","0","48.7","38.39"
"68","000","00","009","0913","1043","781","646","135","31","812","1792","0","45.31","36.05"
"68","000","00","009","0914","0000","2012","1610","402","113","2125","4268","0","49.79","37.72"
"68","000","00","009","0914","1049","644","511","133","50","694","1297","0","53.51","39.4"
"68","000","00","009","0914","1050","644","526","118","18","662","1407","0","47.05","37.38"
"68","000","00","009","0914","1051","724","573","151","45","769","1564","0","49.17","36.64"
"68","000","00","009","0915","0000","1782","1445","337","116","1898","3485","0","54.46","41.46"
"68","000","00","009","0915","1054","873","683","190","47","920","1721","0","53.46","39.69"
"68","000","00","009","0915","1055","909","762","147","69","978","1764","0","55.44","43.2"
"68","000","00","009","0916","0000","1295","1030","265","65","1360","2373","0","57.31","43.4"
"68","000","00","009","0916","1069","567","437","130","43","610","1074","0","56.8","40.69"
"68","000","00","009","0916","1070","728","593","135","22","750","1299","0","57.74","45.65"
"68","000","00","009","0917","0000","740","580","160","65","805","1499","0","53.7","38.69"
"68","000","00","009","0917","1056","740","580","160","65","805","1499","0","53.7","38.69"
"68","000","00","009","0918","0000","954","774","180","47","1001","2151","0","46.54","35.98"
"68","000","00","009","0918","1057","954","774","180","47","1001","2151","0","46.54","35.98"
"68","000","00","009","0919","0000","1652","1337","315","57","1709","2980","0","57.35","44.87"
"68","000","00","009","0919","1058","817","667","150","31","848","1524","0","55.64","43.77"
"68","000","00","009","0919","1059","835","670","165","26","861","1456","0","59.13","46.02"
"68","000","00","009","0920","0000","1317","1025","292","107","1424","2784","0","51.15","36.82"
"68","000","00","009","0920","1011","742","562","180","52","794","1568","0","50.64","35.84"
"68","000","00","009","0920","1012","575","463","112","55","630","1216","0","51.81","38.08"
"68","000","00","009","0921","0000","1171","903","268","90","1261","2355","0","53.55","38.34"
"68","000","00","009","0921","1016","574","427","147","44","618","1221","0","50.61","34.97"
"68","000","00","009","0921","1017","597","476","121","46","643","1134","0","56.7","41.98"
"68","000","00","009","0922","0000","2190","1848","342","89","2279","4135","0","55.11","44.69"
"68","000","00","009","0922","1020","1083","907","176","40","1123","2095","0","53.6","43.29"
"68","000","00","009","0922","1021","1107","941","166","49","1156","2040","0","56.67","46.13"
"68","000","00","009","0923","0000","1799","1413","386","141","1940","3518","0","55.14","40.16"
"68","000","00","009","0923","1024","898","704","194","74","972","1726","0","56.32","40.79"
"68","000","00","009","0923","1025","901","709","192","67","968","1792","0","54.02","39.56"
"68","000","00","009","0924","0000","1486","1154","332","88","1574","3012","0","52.26","38.31"
"68","000","00","009","0924","1029","604","482","122","35","639","1362","0","46.92","35.39"
"68","000","00","009","0924","1030","882","672","210","53","935","1650","0","56.67","40.73"
"68","000","00","009","0925","0000","2089","1710","379","78","2167","4026","0","53.83","42.47"
"68","000","00","009","0925","1035","1056","878","178","33","1089","2024","0","53.8","43.38"
"68","000","00","009","0925","1036","1033","832","201","45","1078","2002","0","53.85","41.56"
"68","000","00","009","0926","0000","1753","1468","285","75","1828","3216","0","56.84","45.65"
"68","000","00","009","0926","1040","966","808","158","32","998","1697","0","58.81","47.61"
"68","000","00","009","0926","1041","787","660","127","43","830","1519","0","54.64","43.45"
"68","000","00","009","0927","0000","808","637","171","67","875","1500","0","58.33","42.47"
"68","000","00","009","0927","1044","808","637","171","67","875","1500","0","58.33","42.47"
"68","000","00","009","0928","0000","1924","1533","391","124","2048","3980","0","51.46","38.52"
"68","000","00","009","0928","1046","604","468","136","46","650","1444","0","45.01","32.41"
"68","000","00","009","0928","1047","623","496","127","48","671","1321","0","50.79","37.55"
"68","000","00","009","0928","1048","697","569","128","30","727","1215","0","59.84","46.83"
"68","000","00","009","0929","0000","1094","868","226","111","1205","2340","0","51.5","37.09"
"68","000","00","009","0929","1052","633","494","139","64","697","1317","0","52.92","37.51"
"68","000","00","009","0929","1053","461","374","87","47","508","1023","0","49.66","36.56"
"68","000","00","009","0930","0000","2145","1818","327","82","2227","3746","0","59.45","48.53"
"68","000","00","009","0930","1060","1063","915","148","39","1102","1847","0","59.66","49.54"
"68","000","00","009","0930","1061","1082","903","179","43","1125","1899","0","59.24","47.55"
"68","000","00","009","0931","0000","1855","1633","222","87","1942","3390","0","57.29","48.17"
"68","000","00","009","0931","1062","894","849","45","36","930","1725","0","53.91","49.22"
"68","000","00","009","0931","1063","961","784","177","51","1012","1665","0","60.78","47.09"
"68","000","00","009","0932","0000","665","529","136","29","694","1427","0","48.63","37.07"
"68","000","00","009","0932","1045","665","529","136","29","694","1427","0","48.63","37.07"
"68","000","00","010","0000","0000","91559","73505","18054","4915","96474","183560","225897","52.56","40.04"
"68","000","00","010","1001","0000","2317","1864","453","121","2438","4781","0","50.99","38.99"
"68","000","00","010","1001","0864","788","662","126","24","812","1717","0","47.29","38.56"
"68","000","00","010","1001","0865","674","522","152","41","715","1319","0","54.21","39.58"
"68","000","00","010","1001","0866","855","680","175","56","911","1745","0","52.21","38.97"
"68","000","00","010","1002","0000","2260","1796","464","120","2380","4129","0","57.64","43.5"
"68","000","00","010","1002","0867","882","689","193","62","944","1721","0","54.85","40.03"
"68","000","00","010","1002","0868","628","503","125","30","658","1206","0","54.56","41.71"
"68","000","00","010","1002","0869","750","604","146","28","778","1202","0","64.73","50.25"
"68","000","00","010","1003","0000","2818","2251","567","95","2913","5256","0","55.42","42.83"
"68","000","00","010","1003","0850","640","507","133","29","669","1044","0","64.08","48.56"
"68","000","00","010","1003","0851","596","482","114","15","611","1124","0","54.36","42.88"
"68","000","00","010","1003","0852","791","643","148","27","818","1517","0","53.92","42.39"
"68","000","00","010","1003","0853","791","619","172","24","815","1571","0","51.88","39.4"
"68","000","00","010","1004","0000","2826","2279","547","187","3013","5442","0","55.37","41.88"
"68","000","00","010","1004","0840","661","533","128","49","710","1307","0","54.32","40.78"
"68","000","00","010","1004","0841","685","545","140","49","734","1337","0","54.9","40.76"
"68","000","00","010","1004","0842","599","486","113","36","635","980","0","64.8","49.59"
"68","000","00","010","1004","0843","881","715","166","53","934","1818","0","51.38","39.33"
"68","000","00","010","1005","0000","2500","1981","519","103","2603","5083","0","51.21","38.97"
"68","000","00","010","1005","0857","822","663","159","33","855","1555","0","54.98","42.64"
"68","000","00","010","1005","0858","919","726","193","42","961","2051","0","46.86","35.4"
"68","000","00","010","1005","0859","759","592","167","28","787","1477","0","53.28","40.08"
"68","000","00","010","1006","0000","1844","1512","332","95","1939","3895","0","49.78","38.82"
"68","000","00","010","1006","0835","956","773","183","60","1016","1901","0","53.45","40.66"
"68","000","00","010","1006","0836","888","739","149","35","923","1994","0","46.29","37.06"
"68","000","00","010","1007","0000","1950","1548","402","85","2035","3585","0","56.76","43.18"
"68","000","00","010","1007","0875","551","439","112","29","580","1010","0","57.43","43.47"
"68","000","00","010","1007","0876","666","521","145","28","694","1261","0","55.04","41.32"
"68","000","00","010","1007","0877","733","588","145","28","761","1314","0","57.91","44.75"
"68","000","00","010","1008","0000","2921","2321","600","123","3044","6426","0","47.37","36.12"
"68","000","00","010","1008","0883","625","442","183","24","649","2213","0","29.33","19.97"
"68","000","00","010","1008","0884","567","472","95","25","592","949","0","62.38","49.74"
"68","000","00","010","1008","0885","916","734","182","48","964","1621","0","59.47","45.28"
"68","000","00","010","1008","0886","813","673","140","26","839","1643","0","51.07","40.96"
"68","000","00","010","1009","0000","1361","1089","272","88","1449","2475","0","58.55","44.0"
"68","000","00","010","1009","0870","664","531","133","41","705","1208","0","58.36","43.96"
"68","000","00","010","1009","0871","697","558","139","47","744","1267","0","58.72","44.04"
"68","000","00","010","1010","0000","2128","1702","426","124","2252","3993","0","56.4","42.62"
"68","000","00","010","1010","0891","578","447","131","32","610","1039","0","58.71","43.02"
"68","000","00","010","1010","0892","729","584","145","47","776","1318","0","58.88","44.31"
"68","000","00","010","1010","0893","821","671","150","45","866","1636","0","52.93","41.01"
"68","000","00","010","1011","0000","1964","1605","359","112","2076","4038","0","51.41","39.75"
"68","000","00","010","1011","0896","647","523","124","54","701","1480","0","47.36","35.34"
"68","000","00","010","1011","0897","669","564","105","27","696","1330","0","52.33","42.41"
"68","000","00","010","1011","0898","648","518","130","31","679","1228","0","55.29","42.18"
"68","000","00","010","1012","0000","2146","1252","894","145","2291","4431","0","51.7","28.26"
"68","000","00","010","1012","0801","678","521","157","45","723","1487","0","48.62","35.04"
"68","000","00","010","1012","0802","711","575","136","50","761","1453","0","52.37","39.57"
"68","000","00","010","1012","0803","757","156","601","50","807","1491","0","54.12","10.46"
"68","000","00","010","1013","0000","2754","2250","504","128","2882","5762","0","50.02","39.05"
"68","000","00","010","1013","0806","842","677","165","39","881","1921","0","45.86","35.24"
"68","000","00","010","1013","0807","1016","847","169","52","1068","1974","0","54.1","42.91"
"68","000","00","010","1013","0808","896","726","170","37","933","1867","0","49.97","38.89"
"68","000","00","010","1014","0000","2288","1846","442","162","2450","4440","0","55.18","41.58"
"68","000","00","010","1014","0827","512","403","109","49","561","1048","0","53.53","38.45"
"68","000","00","010","1014","0828","653","527","126","55","708","1259","0","56.24","41.86"
"68","000","00","010","1014","0829","525","422","103","22","547","1061","0","51.56","39.77"
"68","000","00","010","1014","0830","598","494","104","36","634","1072","0","59.14","46.08"
"68","000","00","010","1015","0000","1088","910","178","64","1152","2326","0","49.53","39.12"
"68","000","00","010","1015","0820","504","420","84","21","525","1130","0","46.46","37.17"
"68","000","00","010","1015","0821","584","490","94","43","627","1196","0","52.42","40.97"
"68","000","00","010","1016","0000","2360","1933","427","90","2450","5300","0","46.23","36.47"
"68","000","00","010","1016","0824","742","594","148","41","783","1564","0","50.06","37.98"
"68","000","00","010","1016","0825","735","622","113","24","759","1824","0","41.61","34.1"
"68","000","00","010","1016","0826","883","717","166","25","908","1912","0","47.49","37.5"
"68","000","00","010","1017","0000","1376","1128","248","107","1483","2780","0","53.35","40.58"
"68","000","00","010","1017","0917","674","549","125","72","746","1385","0","53.86","39.64"
"68","000","00","010","1017","0918","702","579","123","35","737","1395","0","52.83","41.51"
"68","000","00","010","1018","0000","1602","1347","255","82","1684","3342","0","50.39","40.31"
"68","000","00","010","1018","0919","818","683","135","33","851","1711","0","49.74","39.92"
"68","000","00","010","1018","0920","784","664","120","49","833","1631","0","51.07","40.71"
"68","000","00","010","1019","0000","1276","1054","222","120","1396","2541","0","54.94","41.48"
"68","000","00","010","1019","0923","569","453","116","50","619","1127","0","54.92","40.2"
"68","000","00","010","1019","0924","707","601","106","70","777","1414","0","54.95","42.5"
"68","000","00","010","1020","0000","997","854","143","49","1046","1931","0","54.17","44.23"
"68","000","00","010","1020","0922","997","854","143","49","1046","1931","0","54.17","44.23"
"68","000","00","010","1021","0000","588","500","88","16","604","1110","0","54.41","45.05"
"68","000","00","010","1021","0921","588","500","88","16","604","1110","0","54.41","45.05"
"68","000","00","010","1022","0000","796","666","130","46","842","1609","0","52.33","41.39"
"68","000","00","010","1022","0925","796","666","130","46","842","1609","0","52.33","41.39"
"68","000","00","010","1023","0000","2126","1736","390","162","2288","4199","0","54.49","41.34"
"68","000","00","010","1023","0902","645","506","139","65","710","1243","0","57.12","40.71"
"68","000","00","010","1023","0903","800","669","131","40","840","1590","0","52.83","42.08"
"68","000","00","010","1023","0904","681","561","120","57","738","1366","0","54.03","41.07"
"68","000","00","010","1024","0000","2593","2073","520","199","2792","5390","0","51.8","38.46"
"68","000","00","010","1024","0913","478","381","97","34","512","1052","0","48.67","36.22"
"68","000","00","010","1024","0914","646","518","128","61","707","1154","0","61.27","44.89"
"68","000","00","010","1024","0915","777","629","148","25","802","1645","0","48.75","38.24"
"68","000","00","010","1024","0916","692","545","147","79","771","1539","0","50.1","35.41"
"68","000","00","010","1025","0000","1285","1032","253","81","1366","2811","0","48.59","36.71"
"68","000","00","010","1025","0908","649","511","138","54","703","1351","0","52.04","37.82"
"68","000","00","010","1025","0909","636","521","115","27","663","1460","0","45.41","35.68"
"68","000","00","010","1026","0000","2083","1685","398","86","2169","4327","0","50.13","38.94"
"68","000","00","010","1026","0910","885","706","179","42","927","1841","0","50.35","38.35"
"68","000","00","010","1026","0911","668","552","116","17","685","1475","0","46.44","37.42"
"68","000","00","010","1026","0912","530","427","103","27","557","1011","0","55.09","42.24"
"68","000","00","010","1027","0000","1446","1138","308","92","1538","3006","0","51.16","37.86"
"68","000","00","010","1027","0804","643","486","157","57","700","1346","0","52.01","36.11"
"68","000","00","010","1027","0805","803","652","151","35","838","1660","0","50.48","39.28"
"68","000","00","010","1028","0000","3138","2507","631","181","3319","6483","0","51.2","38.67"
"68","000","00","010","1028","0860","756","610","146","22","778","1501","0","51.83","40.64"
"68","000","00","010","1028","0861","716","569","147","58","774","1405","0","55.09","40.5"
"68","000","00","010","1028","0862","811","634","177","68","879","1656","0","53.08","38.29"
"68","000","00","010","1028","0863","855","694","161","33","888","1921","0","46.23","36.13"
"68","000","00","010","1029","0000","842","689","153","53","895","1788","0","50.06","38.53"
"68","000","00","010","1029","0831","842","689","153","53","895","1788","0","50.06","38.53"
"68","000","00","010","1030","0000","2164","1732","432","137","2301","4320","0","53.26","40.09"
"68","000","00","010","1030","0832","756","619","137","39","795","1510","0","52.65","40.99"
"68","000","00","010","1030","0833","691","552","139","48","739","1403","0","52.67","39.34"
"68","000","00","010","1030","0834","717","561","156","50","767","1407","0","54.51","39.87"
"68","000","00","010","1031","0000","2003","1597","406","122","2125","3761","0","56.5","42.46"
"68","000","00","010","1031","0844","757","593","164","46","803","1463","0","54.89","40.53"
"68","000","00","010","1031","0845","681","555","126","25","706","1213","0","58.2","45.75"
"68","000","00","010","1031","0846","565","449","116","51","616","1085","0","56.77","41.38"
"68","000","00","010","1032","0000","1653","1360","293","97","1750","3217","0","54.4","42.28"
"68","000","00","010","1032","0822","819","678","141","53","872","1685","0","51.75","40.24"
"68","000","00","010","1032","0823","834","682","152","44","878","1532","0","57.31","44.52"
"68","000","00","010","1033","0000","2864","2357","507","118","2982","6014","0","49.58","39.19"
"68","000","00","010","1033","0809","878","754","124","40","918","1786","0","51.4","42.22"
"68","000","00","010","1033","0810","656","529","127","29","685","1634","0","41.92","32.37"
"68","000","00","010","1033","0811","561","458","103","21","582","1080","0","53.89","42.41"
"68","000","00","010","1033","0812","769","616","153","28","797","1514","0","52.64","40.69"
"68","000","00","010","1034","0000","2072","1606","466","136","2208","4262","0","51.81","37.68"
"68","000","00","010","1034","0847","682","547","135","34","716","1458","0","49.11","37.52"
"68","000","00","010","1034","0848","722","555","167","51","773","1408","0","54.9","39.42"
"68","000","00","010","1034","0849","668","504","164","51","719","1396","0","51.5","36.1"
"68","000","00","010","1035","0000","1537","1256","281","82","1619","3094","0","52.33","40.59"
"68","000","00","010","1035","0889","729","583","146","51","780","1577","0","49.46","36.97"
"68","000","00","010","1035","0890","808","673","135","31","839","1517","0","55.31","44.36"
"68","000","00","010","1036","0000","2183","1794","389","94","2277","3806","0","59.83","47.14"
"68","000","00","010","1036","0899","775","632","143","35","810","1377","0","58.82","45.9"
"68","000","00","010","1036","0900","701","579","122","22","723","1198","0","60.35","48.33"
"68","000","00","010","1036","0901","707","583","124","37","744","1231","0","60.44","47.36"
"68","000","00","010","1037","0000","2506","2026","480","121","2627","5039","0","52.13","40.21"
"68","000","00","010","1037","0880","716","569","147","29","745","1399","0","53.25","40.67"
"68","000","00","010","1037","0881","931","755","176","59","990","1968","0","50.3","38.36"
"68","000","00","010","1037","0882","859","702","157","33","892","1672","0","53.35","41.99"
"68","000","00","010","1038","0000","1948","1571","377","101","2049","4201","0","48.77","37.4"
"68","000","00","010","1038","0905","671","547","124","49","720","1332","0","54.05","41.07"
"68","000","00","010","1038","0906","548","449","99","21","569","1201","0","47.38","37.39"
"68","000","00","010","1038","0907","729","575","154","31","760","1668","0","45.56","34.47"
"68","000","00","010","1039","0000","1502","1174","328","59","1561","2790","0","55.95","42.08"
"68","000","00","010","1039","0894","712","565","147","32","744","1316","0","56.53","42.93"
"68","000","00","010","1039","0895","790","609","181","27","817","1474","0","55.43","41.32"
"68","000","00","010","1040","0000","796","616","180","66","862","1561","0","55.22","39.46"
"68","000","00","010","1040","0878","384","301","83","38","422","722","0","58.45","41.69"
"68","000","00","010","1040","0879","412","315","97","28","440","839","0","52.44","37.54"
"68","000","00","010","1041","0000","2044","1656","388","92","2136","3703","0","57.68","44.72"
"68","000","00","010","1041","0872","586","489","97","23","609","1094","0","55.67","44.7"
"68","000","00","010","1041","0873","766","593","173","52","818","1394","0","58.68","42.54"
"68","000","00","010","1041","0874","692","574","118","17","709","1215","0","58.35","47.24"
"68","000","00","010","1042","0000","2702","2195","507","106","2808","4896","0","57.35","44.83"
"68","000","00","010","1042","0854","940","770","170","32","972","1752","0","55.48","43.95"
"68","000","00","010","1042","0855","825","671","154","30","855","1434","0","59.62","46.79"
"68","000","00","010","1042","0856","937","754","183","44","981","1710","0","57.37","44.09"
"68","000","00","010","1043","0000","2714","2185","529","89","2803","5358","0","52.31","40.78"
"68","000","00","010","1043","0837","858","676","182","9","867","1730","0","50.12","39.08"
"68","000","00","010","1043","0838","955","781","174","50","1005","1905","0","52.76","41.0"
"68","000","00","010","1043","0839","901","728","173","30","931","1723","0","54.03","42.25"
"68","000","00","010","1044","0000","1881","1514","367","71","1952","3596","0","54.28","42.1"
"68","000","00","010","1044","0887","971","782","189","36","1007","1844","0","54.61","42.41"
"68","000","00","010","1044","0888","910","732","178","35","945","1752","0","53.94","41.78"
"68","000","00","010","1045","0000","2157","1713","444","191","2348","4767","0","49.26","35.93"
"68","000","00","010","1045","0813","806","653","153","79","885","1918","0","46.14","34.05"
"68","000","00","010","1045","0814","586","445","141","73","659","1182","0","55.75","37.65"
"68","000","00","010","1045","0815","765","615","150","39","804","1667","0","48.23","36.89"
"68","000","00","010","1046","0000","3160","2605","555","117","3277","6496","0","50.45","40.1"
"68","000","00","010","1046","0816","741","606","135","33","774","1640","0","47.2","36.95"
"68","000","00","010","1046","0817","786","637","149","34","820","1603","0","51.15","39.74"
"68","000","00","010","1046","0818","840","703","137","13","853","1556","0","54.82","45.18"
"68","000","00","010","1046","0819","793","659","134","37","830","1697","0","48.91","38.83"
"68","000","00","011","0000","0000","21338","16624","4714","1533","22871","41461","49159","55.16","40.1"
"68","000","00","011","1101","0000","1550","1200","350","68","1618","2862","0","56.53","41.93"
"68","000","00","011","1101","1072","730","586","144","25","755","1306","0","57.81","44.87"
"68","000","00","011","1101","1073","820","614","206","43","863","1556","0","55.46","39.46"
"68","000","00","011","1102","0000","2140","1706","434","156","2296","3945","0","58.2","43.24"
"68","000","00","011","1102","1074","1044","809","235","72","1116","1849","0","60.36","43.75"
"68","000","00","011","1102","1075","1096","897","199","84","1180","2096","0","56.3","42.8"
"68","000","00","011","1103","0000","748","578","170","48","796","1517","0","52.47","38.1"
"68","000","00","011","1103","1076","748","578","170","48","796","1517","0","52.47","38.1"
"68","000","00","011","1104","0000","1943","1510","433","108","2051","3951","0","51.91","38.22"
"68","000","00","011","1104","1077","1126","879","247","63","1189","2095","0","56.75","41.96"
"68","000","00","011","1104","1078","817","631","186","45","862","1856","0","46.44","34.0"
"68","000","00","011","1105","0000","2132","1712","420","129","2261","4024","0","56.19","42.54"
"68","000","00","011","1105","1086","1024","847","177","48","1072","1992","0","53.82","42.52"
"68","000","00","011","1105","1087","1108","865","243","81","1189","2032","0","58.51","42.57"
"68","000","00","011","1106","0000","1372","1034","338","92","1464","2542","0","57.59","40.68"
"68","000","00","011","1106","1082","728","541","187","54","782","1271","0","61.53","42.56"
"68","000","00","011","1106","1083","644","493","151","38","682","1271","0","53.66","38.79"
"68","000","00","011","1107","0000","1208","898","310","99","1307","2319","0","56.36","38.72"
"68","000","00","011","1107","1084","653","481","172","49","702","1234","0","56.89","38.98"
"68","000","00","011","1107","1085","555","417","138","50","605","1085","0","55.76","38.43"
"68","000","00","011","1108","0000","641","505","136","41","682","1385","0","49.24","36.46"
"68","000","00","011","1108","1081","641","505","136","41","682","1385","0","49.24","36.46"
"68","000","00","011","1109","0000","624","495","129","49","673","1425","0","47.23","34.74"
"68","000","00","011","1109","1080","624","495","129","49","673","1425","0","47.23","34.74"
"68","000","00","011","1110","0000","1012","801","211","73","1085","1986","0","54.63","40.33"
"68","000","00","011","1110","1079","1012","801","211","73","1085","1986","0","54.63","40.33"
"68","000","00","011","1111","0000","377","297","80","27","404","741","0","54.52","40.08"
"68","000","00","011","1111","1098","377","297","80","27","404","741","0","54.52","40.08"
"68","000","00","011","1112","0000","822","642","180","79","901","1714","0","52.57","37.46"
"68","000","00","011","1112","1100","822","642","180","79","901","1714","0","52.57","37.46"
"68","000","00","011","1113","0000","515","380","135","67","582","943","0","61.72","40.3"
"68","000","00","011","1113","1099","515","380","135","67","582","943","0","61.72","40.3"
"68","000","00","011","1114","0000","673","536","137","22","695","1340","0","51.87","40.0"
"68","000","00","011","1114","1101","673","536","137","22","695","1340","0","51.87","40.0"
"68","000","00","011","1115","0000","444","339","105","39","483","995","0","48.54","34.07"
"68","000","00","011","1115","1097","444","339","105","39","483","995","0","48.54","34.07"
"68","000","00","011","1116","0000","1211","957","254","113","1324","2265","0","58.45","42.25"
"68","000","00","011","1116","1095","482","380","102","25","507","896","0","56.58","42.41"
"68","000","00","011","1116","1096","729","577","152","88","817","1369","0","59.68","42.15"
"68","000","00","011","1117","0000","611","467","144","56","667","1050","0","63.52","44.48"
"68","000","00","011","1117","1094","611","467","144","56","667","1050","0","63.52","44.48"
"68","000","00","011","1118","0000","366","280","86","42","408","663","0","61.54","42.23"
"68","000","00","011","1118","1092","366","280","86","42","408","663","0","61.54","42.23"
"68","000","00","011","1119","0000","433","318","115","25","458","908","0","50.44","35.02"
"68","000","00","011","1119","1091","433","318","115","25","458","908","0","50.44","35.02"
"68","000","00","011","1120","0000","521","402","119","57","578","1088","0","53.13","36.95"
"68","000","00","011","1120","1093","521","402","119","57","578","1088","0","53.13","36.95"
"68","000","00","011","1121","0000","600","470","130","47","647","1106","0","58.5","42.5"
"68","000","00","011","1121","1090","600","470","130","47","647","1106","0","58.5","42.5"
"68","000","00","011","1122","0000","647","503","144","55","702","1291","0","54.38","38.96"
"68","000","00","011","1122","1088","647","503","144","55","702","1291","0","54.38","38.96"
"68","000","00","011","1123","0000","748","594","154","41","789","1401","0","56.32","42.4"
"68","000","00","011","1123","1089","748","594","154","41","789","1401","0","56.32","42.4"
"68","000","00","012","0000","0000","25623","19925","5698","1844","27467","55149","67208","49.81","36.13"
"68","000","00","012","1201","0000","1116","874","242","66","1182","2733","0","43.25","31.98"
"68","000","00","012","1201","1102","586","454","132","39","625","1371","0","45.59","33.11"
"68","000","00","012","1201","1103","530","420","110","27","557","1362","0","40.9","30.84"
"68","000","00","012","1202","0000","463","306","157","67","530","997","0","53.16","30.69"
"68","000","00","012","1202","1104","463","306","157","67","530","997","0","53.16","30.69"
"68","000","00","012","1203","0000","617","497","120","32","649","1407","0","46.13","35.32"
"68","000","00","012","1203","1105","617","497","120","32","649","1407","0","46.13","35.32"
"68","000","00","012","1204","0000","840","671","169","31","871","1692","0","51.48","39.66"
"68","000","00","012","1204","1106","840","671","169","31","871","1692","0","51.48","39.66"
"68","000","00","012","1205","0000","465","355","110","38","503","892","0","56.39","39.8"
"68","000","00","012","1205","1109","465","355","110","38","503","892","0","56.39","39.8"
"68","000","00","012","1206","0000","1005","803","202","47","1052","2070","0","50.82","38.79"
"68","000","00","012","1206","1107","620","503","117","27","647","1279","0","50.59","39.33"
"68","000","00","012","1206","1108","385","300","85","20","405","791","0","51.2","37.93"
"68","000","00","012","1207","0000","506","403","103","26","532","886","0","60.05","45.49"
"68","000","00","012","1207","1110","506","403","103","26","532","886","0","60.05","45.49"
"68","000","00","012","1208","0000","359","291","68","39","398","712","0","55.9","40.87"
"68","000","00","012","1208","1111","359","291","68","39","398","712","0","55.9","40.87"
"68","000","00","012","1209","0000","703","533","170","109","812","1609","0","50.47","33.13"
"68","000","00","012","1209","1112","703","533","170","109","812","1609","0","50.47","33.13"
"68","000","00","012","1210","0000","1208","920","288","74","1282","2625","0","48.84","35.05"
"68","000","00","012","1210","1113","652","478","174","54","706","1274","0","55.42","37.52"
"68","000","00","012","1210","1114","556","442","114","20","576","1351","0","42.64","32.72"
"68","000","00","012","1211","0000","1308","1049","259","126","1434","2504","0","57.27","41.89"
"68","000","00","012","1211","1115","668","534","134","60","728","1262","0","57.69","42.31"
"68","000","00","012","1211","1116","640","515","125","66","706","1242","0","56.84","41.47"
"68","000","00","012","1212","0000","1485","1142","343","112","1597","3074","0","51.95","37.15"
"68","000","00","012","1212","1117","708","545","163","69","777","1461","0","53.18","37.3"
"68","000","00","012","1212","1118","777","597","180","43","820","1613","0","50.84","37.01"
"68","000","00","012","1213","0000","738","575","163","53","791","1479","0","53.48","38.88"
"68","000","00","012","1213","1119","738","575","163","53","791","1479","0","53.48","38.88"
"68","000","00","012","1214","0000","2177","1564","613","154","2331","4760","0","48.97","32.86"
"68","000","00","012","1214","1120","687","516","171","57","744","1552","0","47.94","33.25"
"68","000","00","012","1214","1121","717","444","273","35","752","1517","0","49.57","29.27"
"68","000","00","012","1214","1122","773","604","169","62","835","1691","0","49.38","35.72"
"68","000","00","012","1215","0000","1883","1612","271","96","1979","3762","0","52.6","42.85"
"68","000","00","012","1215","1123","610","486","124","21","631","1157","0","54.54","42.01"
"68","000","00","012","1215","1124","692","644","48","49","741","1455","0","50.93","44.26"
"68","000","00","012","1215","1125","581","482","99","26","607","1150","0","52.78","41.91"
"68","000","00","012","1216","0000","1161","904","257","70","1231","2363","0","52.09","38.26"
"68","000","00","012","1216","1126","574","435","139","50","624","1112","0","56.12","39.12"
"68","000","00","012","1216","1127","587","469","118","20","607","1251","0","48.52","37.49"
"68","000","00","012","1217","0000","1374","1036","338","192","1566","2939","0","53.28","35.25"
"68","000","00","012","1217","1128","687","528","159","91","778","1446","0","53.8","36.51"
"68","000","00","012","1217","1129","687","508","179","101","788","1493","0","52.78","34.03"
"68","000","00","012","1218","0000","1249","991","258","109","1358","2476","0","54.85","40.02"
"68","000","00","012","1218","1130","636","502","134","66","702","1339","0","52.43","37.49"
"68","000","00","012","1218","1131","613","489","124","43","656","1137","0","57.7","43.01"
"68","000","00","012","1219","0000","486","379","107","40","526","1043","0","50.43","36.34"
"68","000","00","012","1219","1132","486","379","107","40","526","1043","0","50.43","36.34"
"68","000","00","012","1220","0000","892","662","230","53","945","1968","0","48.02","33.64"
"68","000","00","012","1220","1133","433","323","110","27","460","993","0","46.32","32.53"
"68","000","00","012","1220","1134","459","339","120","26","485","975","0","49.74","34.77"
"68","000","00","012","1221","0000","809","628","181","53","862","2029","0","42.48","30.95"
"68","000","00","012","1221","1135","809","628","181","53","862","2029","0","42.48","30.95"
"68","000","00","012","1222","0000","1404","1096","308","96","1500","3802","0","39.45","28.83"
"68","000","00","012","1222","1139","756","603","153","56","812","1870","0","43.42","32.25"
"68","000","00","012","1222","1140","648","493","155","40","688","1932","0","35.61","25.52"
"68","000","00","012","1223","0000","746","574","172","28","774","1884","0","41.08","30.47"
"68","000","00","012","1223","1141","352","257","95","13","365","899","0","40.6","28.59"
"68","000","00","012","1223","1142","394","317","77","15","409","985","0","41.52","32.18"
"68","000","00","012","1224","0000","2629","2060","569","133","2762","5443","0","50.74","37.85"
"68","000","00","012","1224","1136","902","701","201","42","944","1765","0","53.48","39.72"
"68","000","00","012","1224","1137","871","692","179","49","920","1809","0","50.86","38.25"
"68","000","00","012","1224","1138","856","667","189","42","898","1869","0","48.05","35.69"
"68","000","00","013","0000","0000","4531","3523","1008","414","4945","9766","11997","50.63","36.07"
"68","000","00","013","1301","0000","990","766","224","111","1101","1991","0","55.3","38.47"
"68","000","00","013","1301","0581","990","766","224","111","1101","1991","0","55.3","38.47"
"68","000","00","013","1302","0000","690","531","159","93","783","1392","0","56.25","38.15"
"68","000","00","013","1302","0582","690","531","159","93","783","1392","0","56.25","38.15"
"68","000","00","013","1303","0000","314","237","77","28","342","716","0","47.77","33.1"
"68","000","00","013","1303","0584","314","237","77","28","342","716","0","47.77","33.1"
"68","000","00","013","1304","0000","274","214","60","19","293","564","0","51.95","37.94"
"68","000","00","013","1304","0583","274","214","60","19","293","564","0","51.95","37.94"
"68","000","00","013","1305","0000","254","193","61","14","268","669","0","40.06","28.85"
"68","000","00","013","1305","0586","254","193","61","14","268","669","0","40.06","28.85"
"68","000","00","013","1306","0000","225","188","37","7","232","683","0","33.97","27.53"
"68","000","00","013","1306","0589","225","188","37","7","232","683","0","33.97","27.53"
"68","000","00","013","1307","0000","331","268","63","23","354","760","0","46.58","35.26"
"68","000","00","013","1307","0587","331","268","63","23","354","760","0","46.58","35.26"
"68","000","00","013","1308","0000","550","429","121","41","591","1224","0","48.28","35.05"
"68","000","00","013","1308","0590","550","429","121","41","591","1224","0","48.28","35.05"
"68","000","00","013","1309","0000","569","443","126","57","626","1016","0","61.61","43.6"
"68","000","00","013","1309","0585","569","443","126","57","626","1016","0","61.61","43.6"
"68","000","00","013","1310","0000","334","254","80","21","355","751","0","47.27","33.82"
"68","000","00","013","1310","0588","334","254","80","21","355","751","0","47.27","33.82"
"66","000","00","000","0000","0000","1236361","979821","256540","81945","1318306","2295642","2799254","57.43","42.68"
"66","000","00","001","0000","0000","7614","5791","1823","526","8140","14696","18557","55.39","39.41"
"66","000","00","001","0101","0000","810","600","210","58","868","1531","0","56.69","39.19"
"66","000","00","001","0101","1071","810","600","210","58","868","1531","0","56.69","39.19"
"66","000","00","001","0102","0000","1081","800","281","92","1173","2046","0","57.33","39.1"
"66","000","00","001","0102","1075","632","468","164","54","686","1191","0","57.6","39.29"
"66","000","00","001","0102","1076","449","332","117","38","487","855","0","56.96","38.83"
"66","000","00","001","0103","0000","939","729","210","69","1008","1652","0","61.02","44.13"
"66","000","00","001","0103","1070","939","729","210","69","1008","1652","0","61.02","44.13"
"66","000","00","001","0104","0000","759","562","197","32","791","1431","0","55.28","39.27"
"66","000","00","001","0104","1072","759","562","197","32","791","1431","0","55.28","39.27"
"66","000","00","001","0105","0000","1071","832","239","94","1165","2042","0","57.05","40.74"
"66","000","00","001","0105","1073","574","450","124","43","617","1060","0","58.21","42.45"
"66","000","00","001","0105","1074","497","382","115","51","548","982","0","55.8","38.9"
"66","000","00","001","0106","0000","881","671","210","46","927","1840","0","50.38","36.47"
"66","000","00","001","0106","1077","503","384","119","28","531","1135","0","46.78","33.83"
"66","000","00","001","0106","1078","378","287","91","18","396","705","0","56.17","40.71"
"66","000","00","001","0107","0000","1231","947","284","99","1330","2313","0","57.5","40.94"
"66","000","00","001","0107","1079","565","449","116","29","594","1009","0","58.87","44.5"
"66","000","00","001","0107","1080","666","498","168","70","736","1304","0","56.44","38.19"
"66","000","00","001","0108","0000","842","650","192","36","878","1841","0","47.69","35.31"
"66","000","00","001","0108","1081","842","650","192","36","878","1841","0","47.69","35.31"
"66","000","00","002","0000","0000","35017","27322","7695","2488","37505","64291","76070","58.34","42.5"
"66","000","00","002","0201","0000","1439","1116","323","82","1521","2999","0","50.72","37.21"
"66","000","00","002","0201","1148","414","307","107","25","439","1138","0","38.58","26.98"
"66","000","00","002","0201","1149","539","428","111","20","559","984","0","56.81","43.5"
"66","000","00","002","0201","1150","486","381","105","37","523","877","0","59.64","43.44"
"66","000","00","002","0202","0000","1780","1341","439","153","1933","3129","0","61.78","42.86"
"66","000","00","002","0202","1151","619","474","145","54","673","1070","0","62.9","44.3"
"66","000","00","002","0202","1152","638","483","155","45","683","1106","0","61.75","43.67"
"66","000","00","002","0202","1153","523","384","139","54","577","953","0","60.55","40.29"
"66","000","00","002","0203","0000","1939","1494","445","137","2076","3636","0","57.1","41.09"
"66","000","00","002","0203","1154","668","531","137","31","699","1195","0","58.49","44.44"
"66","000","00","002","0203","1155","654","518","136","55","709","1251","0","56.67","41.41"
"66","000","00","002","0203","1156","617","445","172","51","668","1190","0","56.13","37.39"
"66","000","00","002","0204","0000","1539","1172","367","123","1662","2837","0","58.58","41.31"
"66","000","00","002","0204","1157","730","560","170","60","790","1394","0","56.67","40.17"
"66","000","00","002","0204","1158","809","612","197","63","872","1443","0","60.43","42.41"
"66","000","00","002","0205","0000","1142","857","285","93","1235","1966","0","62.82","43.59"
"66","000","00","002","0205","1161","685","481","204","69","754","1211","0","62.26","39.72"
"66","000","00","002","0205","1162","457","376","81","24","481","755","0","63.71","49.8"
"66","000","00","002","0206","0000","1070","843","227","94","1164","1902","0","61.2","44.32"
"66","000","00","002","0206","1159","396","310","86","45","441","762","0","57.87","40.68"
"66","000","00","002","0206","1160","674","533","141","49","723","1140","0","63.42","46.75"
"66","000","00","002","0207","0000","1272","960","312","95","1367","2491","0","54.88","38.54"
"66","000","00","002","0207","1163","770","585","185","65","835","1491","0","56.0","39.24"
"66","000","00","002","0207","1164","502","375","127","30","532","1000","0","53.2","37.5"
"66","000","00","002","0208","0000","1197","890","307","97","1294","2215","0","58.42","40.18"
"66","000","00","002","0208","1165","620","449","171","58","678","1114","0","60.86","40.31"
"66","000","00","002","0208","1166","577","441","136","39","616","1101","0","55.95","40.05"
"66","000","00","002","0209","0000","3738","2912","826","259","3997","6563","0","60.9","44.37"
"66","000","00","002","0209","1167","698","535","163","62","760","1169","0","65.01","45.77"
"66","000","00","002","0209","1168","739","575","164","68","807","1283","0","62.9","44.82"
"66","000","00","002","0209","1169","696","557","139","40","736","1168","0","63.01","47.69"
"66","000","00","002","0209","1170","717","539","178","37","754","1386","0","54.4","38.89"
"66","000","00","002","0209","1171","888","706","182","52","940","1557","0","60.37","45.34"
"66","000","00","002","0210","0000","2594","1999","595","157","2751","4658","0","59.06","42.92"
"66","000","00","002","0210","1172","747","547","200","67","814","1380","0","58.99","39.64"
"66","000","00","002","0210","1173","893","688","205","47","940","1674","0","56.15","41.1"
"66","000","00","002","0210","1174","954","764","190","43","997","1604","0","62.16","47.63"
"66","000","00","002","0211","0000","2158","1737","421","130","2288","3743","0","61.13","46.41"
"66","000","00","002","0211","1179","710","588","122","39","749","1252","0","59.82","46.96"
"66","000","00","002","0211","1180","746","577","169","45","791","1250","0","63.28","46.16"
"66","000","00","002","0211","1181","702","572","130","46","748","1241","0","60.27","46.09"
"66","000","00","002","0212","0000","1327","1011","316","112","1439","2606","0","55.22","38.8"
"66","000","00","002","0212","1182","661","496","165","46","707","1318","0","53.64","37.63"
"66","000","00","002","0212","1183","666","515","151","66","732","1288","0","56.83","39.98"
"66","000","00","002","0213","0000","2284","1857","427","185","2469","4096","0","60.28","45.34"
"66","000","00","002","0213","1184","807","644","163","86","893","1442","0","61.93","44.66"
"66","000","00","002","0213","1185","673","539","134","45","718","1202","0","59.73","44.84"
"66","000","00","002","0213","1186","804","674","130","54","858","1452","0","59.09","46.42"
"66","000","00","002","0214","0000","831","694","137","48","879","1693","0","51.92","40.99"
"66","000","00","002","0214","1190","831","694","137","48","879","1693","0","51.92","40.99"
"66","000","00","002","0215","0000","2175","1775","400","130","2305","4083","0","56.45","43.47"
"66","000","00","002","0215","1187","786","636","150","40","826","1480","0","55.81","42.97"
"66","000","00","002","0215","1188","939","801","138","44","983","1736","0","56.62","46.14"
"66","000","00","002","0215","1189","450","338","112","46","496","867","0","57.21","38.99"
"66","000","00","002","0216","0000","4805","3751","1054","356","5161","8717","0","59.21","43.03"
"66","000","00","002","0216","1191","864","703","161","72","936","1538","0","60.86","45.71"
"66","000","00","002","0216","1192","899","651","248","104","1003","1593","0","62.96","40.87"
"66","000","00","002","0216","1193","785","620","165","23","808","1481","0","54.56","41.86"
"66","000","00","002","0216","1194","818","668","150","46","864","1414","0","61.1","47.24"
"66","000","00","002","0216","1195","672","541","131","46","718","1297","0","55.36","41.71"
"66","000","00","002","0216","1196","767","568","199","65","832","1394","0","59.68","40.75"
"66","000","00","002","0217","0000","3727","2913","814","237","3964","6957","0","56.98","41.87"
"66","000","00","002","0217","1175","1043","815","228","49","1092","1815","0","60.17","44.9"
"66","000","00","002","0217","1176","888","698","190","57","945","1700","0","55.59","41.06"
"66","000","00","002","0217","1177","850","668","182","59","909","1592","0","57.1","41.96"
"66","000","00","002","0217","1178","946","732","214","72","1018","1850","0","55.03","39.57"
"66","000","00","003","0000","0000","59587","46759","12828","3822","63409","103643","125726","61.18","45.12"
"66","000","00","003","0301","0000","2020","1548","472","204","2224","3607","0","61.66","42.92"
"66","000","00","003","0301","1201","636","497","139","78","714","1130","0","63.19","43.98"
"66","000","00","003","0301","1202","715","543","172","68","783","1239","0","63.2","43.83"
"66","000","00","003","0301","1203","669","508","161","58","727","1238","0","58.72","41.03"
"66","000","00","003","0302","0000","2182","1644","538","178","2360","3862","0","61.11","42.57"
"66","000","00","003","0302","1204","728","551","177","60","788","1272","0","61.95","43.32"
"66","000","00","003","0302","1205","720","554","166","46","766","1273","0","60.17","43.52"
"66","000","00","003","0302","1206","734","539","195","72","806","1317","0","61.2","40.93"
"66","000","00","003","0303","0000","2107","1604","503","148","2255","3476","0","64.87","46.14"
"66","000","00","003","0303","1207","747","577","170","42","789","1160","0","68.02","49.74"
"66","000","00","003","0303","1208","725","541","184","60","785","1205","0","65.15","44.9"
"66","000","00","003","0303","1209","635","486","149","46","681","1111","0","61.3","43.74"
"66","000","00","003","0304","0000","1674","1276","398","109","1783","2826","0","63.09","45.15"
"66","000","00","003","0304","1210","871","661","210","58","929","1407","0","66.03","46.98"
"66","000","00","003","0304","1211","803","615","188","51","854","1419","0","60.18","43.34"
"66","000","00","003","0305","0000","1433","1139","294","101","1534","2572","0","59.64","44.28"
"66","000","00","003","0305","1212","672","520","152","61","733","1157","0","63.35","44.94"
"66","000","00","003","0305","1213","761","619","142","40","801","1415","0","56.61","43.75"
"66","000","00","003","0306","0000","1606","1228","378","119","1725","2743","0","62.89","44.77"
"66","000","00","003","0306","1214","785","608","177","64","849","1289","0","65.87","47.17"
"66","000","00","003","0306","1215","821","620","201","55","876","1454","0","60.25","42.64"
"66","000","00","003","0307","0000","2399","1920","479","141","2540","4315","0","58.86","44.5"
"66","000","00","003","0307","1216","790","648","142","62","852","1491","0","57.14","43.46"
"66","000","00","003","0307","1217","801","640","161","27","828","1394","0","59.4","45.91"
"66","000","00","003","0307","1218","808","632","176","52","860","1430","0","60.14","44.2"
"66","000","00","003","0308","0000","2222","1707","515","243","2465","3836","0","64.26","44.5"
"66","000","00","003","0308","1219","726","578","148","110","836","1342","0","62.3","43.07"
"66","000","00","003","0308","1220","793","588","205","91","884","1304","0","67.79","45.09"
"66","000","00","003","0308","1221","703","541","162","42","745","1190","0","62.61","45.46"
"66","000","00","003","0309","0000","3052","2391","661","238","3290","5320","0","61.84","44.94"
"66","000","00","003","0309","1222","704","564","140","57","761","1273","0","59.78","44.3"
"66","000","00","003","0309","1223","837","661","176","67","904","1387","0","65.18","47.66"
"66","000","00","003","0309","1224","755","566","189","55","810","1356","0","59.73","41.74"
"66","000","00","003","0309","1225","756","600","156","59","815","1304","0","62.5","46.01"
"66","000","00","003","0310","0000","2136","1638","498","131","2267","3842","0","59.01","42.63"
"66","000","00","003","0310","1230","743","568","175","55","798","1308","0","61.01","43.43"
"66","000","00","003","0310","1231","696","546","150","33","729","1250","0","58.32","43.68"
"66","000","00","003","0310","1232","697","524","173","43","740","1284","0","57.63","40.81"
"66","000","00","003","0311","0000","4527","3586","941","216","4743","7672","0","61.82","46.74"
"66","000","00","003","0311","1240","994","793","201","50","1044","1643","0","63.54","48.27"
"66","000","00","003","0311","1241","847","647","200","45","892","1423","0","62.68","45.47"
"66","000","00","003","0311","1242","872","689","183","51","923","1542","0","59.86","44.68"
"66","000","00","003","0311","1243","889","712","177","6","895","1533","0","58.38","46.44"
"66","000","00","003","0311","1244","925","745","180","64","989","1531","0","64.6","48.66"
"66","000","00","003","0312","0000","6110","4883","1227","301","6411","10764","0","59.56","45.36"
"66","000","00","003","0312","1248","944","749","195","43","987","1799","0","54.86","41.63"
"66","000","00","003","0312","1249","1031","829","202","53","1084","1708","0","63.47","48.54"
"66","000","00","003","0312","1250","920","727","193","56","976","1700","0","57.41","42.76"
"66","000","00","003","0312","1251","1052","874","178","35","1087","1751","0","62.08","49.91"
"66","000","00","003","0312","1252","1215","968","247","59","1274","2109","0","60.41","45.9"
"66","000","00","003","0312","1253","948","736","212","55","1003","1697","0","59.1","43.37"
"66","000","00","003","0313","0000","4881","3925","956","256","5137","7918","0","64.88","49.57"
"66","000","00","003","0313","1258","755","576","179","38","793","1274","0","62.24","45.21"
"66","000","00","003","0313","1259","873","716","157","42","915","1390","0","65.83","51.51"
"66","000","00","003","0313","1260","836","679","157","30","866","1295","0","66.87","52.43"
"66","000","00","003","0313","1261","740","592","148","70","810","1312","0","61.74","45.12"
"66","000","00","003","0313","1262","868","689","179","33","901","1417","0","63.59","48.62"
"66","000","00","003","0313","1263","809","673","136","43","852","1230","0","69.27","54.72"
"66","000","00","003","0314","0000","2321","1776","545","192","2513","4174","0","60.21","42.55"
"66","000","00","003","0314","1264","723","546","177","58","781","1308","0","59.71","41.74"
"66","000","00","003","0314","1265","792","584","208","86","878","1467","0","59.85","39.81"
"66","000","00","003","0314","1266","806","646","160","48","854","1399","0","61.04","46.18"
"66","000","00","003","0315","0000","1140","872","268","88","1228","1938","0","63.36","44.99"
"66","000","00","003","0315","1197","531","409","122","41","572","937","0","61.05","43.65"
"66","000","00","003","0315","1198","609","463","146","47","656","1001","0","65.53","46.25"
"66","000","00","003","0316","0000","1522","1200","322","117","1639","2451","0","66.87","48.96"
"66","000","00","003","0316","1199","755","598","157","66","821","1249","0","65.73","47.88"
"66","000","00","003","0316","1200","767","602","165","51","818","1202","0","68.05","50.08"
"66","000","00","003","0317","0000","3232","2532","700","164","3396","5388","0","63.03","46.99"
"66","000","00","003","0317","1226","769","614","155","30","799","1256","0","63.61","48.89"
"66","000","00","003","0317","1227","842","656","186","36","878","1364","0","64.37","48.09"
"66","000","00","003","0317","1228","771","573","198","76","847","1361","0","62.23","42.1"
"66","000","00","003","0317","1229","850","689","161","22","872","1407","0","61.98","48.97"
"66","000","00","003","0318","0000","2061","1611","450","170","2231","3501","0","63.72","46.02"
"66","000","00","003","0318","1233","687","542","145","66","753","1175","0","64.09","46.13"
"66","000","00","003","0318","1234","726","570","156","41","767","1158","0","66.23","49.22"
"66","000","00","003","0318","1235","648","499","149","63","711","1168","0","60.87","42.72"
"66","000","00","003","0319","0000","3697","2952","745","168","3865","7241","0","53.38","40.77"
"66","000","00","003","0319","1236","980","795","185","56","1036","1626","0","63.71","48.89"
"66","000","00","003","0319","1237","837","646","191","39","876","2115","0","41.42","30.54"
"66","000","00","003","0319","1238","966","788","178","39","1005","1805","0","55.68","43.66"
"66","000","00","003","0319","1239","914","723","191","34","948","1695","0","55.93","42.65"
"66","000","00","003","0320","0000","2422","1914","508","128","2550","4415","0","57.76","43.35"
"66","000","00","003","0320","1245","710","553","157","36","746","1392","0","53.59","39.73"
"66","000","00","003","0320","1246","867","706","161","44","911","1592","0","57.22","44.35"
"66","000","00","003","0320","1247","845","655","190","48","893","1431","0","62.4","45.77"
"66","000","00","003","0321","0000","3847","3067","780","218","4065","6474","0","62.79","47.37"
"66","000","00","003","0321","1254","812","646","166","53","865","1456","0","59.41","44.37"
"66","000","00","003","0321","1255","1094","840","254","53","1147","1726","0","66.45","48.67"
"66","000","00","003","0321","1256","1023","841","182","57","1080","1723","0","62.68","48.81"
"66","000","00","003","0321","1257","918","740","178","55","973","1569","0","62.01","47.16"
"66","000","00","003","0322","0000","2996","2346","650","192","3188","5308","0","60.06","44.2"
"66","000","00","003","0322","1267","670","517","153","61","731","1207","0","60.56","42.83"
"66","000","00","003","0322","1268","727","573","154","50","777","1317","0","59.0","43.51"
"66","000","00","003","0322","1269","869","673","196","43","912","1563","0","58.35","43.06"
"66","000","00","003","0322","1270","730","583","147","38","768","1221","0","62.9","47.75"
"66","000","00","004","0000","0000","52150","40385","11765","2891","55041","95040","115551","57.91","42.49"
"66","000","00","004","0401","0000","1079","823","256","70","1149","1798","0","63.9","45.77"
"66","000","00","004","0401","1085","594","453","141","42","636","1020","0","62.35","44.41"
"66","000","00","004","0401","1086","485","370","115","28","513","778","0","65.94","47.56"
"66","000","00","004","0402","0000","803","636","167","45","848","1416","0","59.89","44.92"
"66","000","00","004","0402","1084","803","636","167","45","848","1416","0","59.89","44.92"
"66","000","00","004","0403","0000","1006","793","213","52","1058","2261","0","46.79","35.07"
"66","000","00","004","0403","1082","481","393","88","32","513","1400","0","36.64","28.07"
"66","000","00","004","0403","1083","525","400","125","20","545","861","0","63.3","46.46"
"66","000","00","004","0404","0000","1401","1074","327","89","1490","2295","0","64.92","46.8"
"66","000","00","004","0404","1090","758","584","174","47","805","1251","0","64.35","46.68"
"66","000","00","004","0404","1091","643","490","153","42","685","1044","0","65.61","46.93"
"66","000","00","004","0405","0000","748","586","162","51","799","1465","0","54.54","40.0"
"66","000","00","004","0405","1087","748","586","162","51","799","1465","0","54.54","40.0"
"66","000","00","004","0406","0000","1079","838","241","39","1118","1885","0","59.31","44.46"
"66","000","00","004","0406","1088","572","446","126","18","590","1017","0","58.01","43.85"
"66","000","00","004","0406","1089","507","392","115","21","528","868","0","60.83","45.16"
"66","000","00","004","0407","0000","2643","2057","586","149","2792","4791","0","58.28","42.93"
"66","000","00","004","0407","1092","814","630","184","39","853","1487","0","57.36","42.37"
"66","000","00","004","0407","1093","856","668","188","51","907","1573","0","57.66","42.47"
"66","000","00","004","0407","1094","973","759","214","59","1032","1731","0","59.62","43.85"
"66","000","00","004","0408","0000","2219","1758","461","108","2327","3948","0","58.94","44.53"
"66","000","00","004","0408","1095","693","551","142","27","720","1209","0","59.55","45.57"
"66","000","00","004","0408","1096","847","673","174","41","888","1564","0","56.78","43.03"
"66","000","00","004","0408","1097","679","534","145","40","719","1175","0","61.19","45.45"
"66","000","00","004","0409","0000","2997","2338","659","126","3123","5680","0","54.98","41.16"
"66","000","00","004","0409","1098","809","634","175","33","842","1505","0","55.95","42.13"
"66","000","00","004","0409","1099","810","629","181","38","848","1418","0","59.8","44.36"
"66","000","00","004","0409","1100","664","530","134","15","679","1497","0","45.36","35.4"
"66","000","00","004","0409","1101","714","545","169","40","754","1260","0","59.84","43.25"
"66","000","00","004","0410","0000","1218","908","310","101","1319","2330","0","56.61","38.97"
"66","000","00","004","0410","1116","585","432","153","69","654","1129","0","57.93","38.26"
"66","000","00","004","0410","1117","633","476","157","32","665","1201","0","55.37","39.63"
"66","000","00","004","0411","0000","1666","1309","357","88","1754","3196","0","54.88","40.96"
"66","000","00","004","0411","1114","892","711","181","54","946","1822","0","51.92","39.02"
"66","000","00","004","0411","1115","774","598","176","34","808","1374","0","58.81","43.52"
"66","000","00","004","0412","0000","1882","1428","454","140","2022","3502","0","57.74","40.78"
"66","000","00","004","0412","1118","864","660","204","68","932","1639","0","56.86","40.27"
"66","000","00","004","0412","1119","1018","768","250","72","1090","1863","0","58.51","41.22"
"66","000","00","004","0413","0000","1577","1193","384","94","1671","2846","0","58.71","41.92"
"66","000","00","004","0413","1102","797","596","201","53","850","1399","0","60.76","42.6"
"66","000","00","004","0413","1103","780","597","183","41","821","1447","0","56.74","41.26"
"66","000","00","004","0414","0000","3553","2758","795","212","3765","6488","0","58.03","42.51"
"66","000","00","004","0414","1104","931","711","220","58","989","1683","0","58.76","42.25"
"66","000","00","004","0414","1105","884","694","190","60","944","1585","0","59.56","43.79"
"66","000","00","004","0414","1106","885","681","204","43","928","1557","0","59.6","43.74"
"66","000","00","004","0414","1107","853","672","181","51","904","1663","0","54.36","40.41"
"66","000","00","004","0415","0000","3153","2451","702","191","3344","5656","0","59.12","43.33"
"66","000","00","004","0415","1122","721","544","177","43","764","1308","0","58.41","41.59"
"66","000","00","004","0415","1123","777","621","156","63","840","1433","0","58.62","43.34"
"66","000","00","004","0415","1124","781","591","190","37","818","1450","0","56.41","40.76"
"66","000","00","004","0415","1125","874","695","179","48","922","1465","0","62.94","47.44"
"66","000","00","004","0416","0000","2993","2306","687","160","3153","5663","0","55.68","40.72"
"66","000","00","004","0416","1140","643","491","152","35","678","1139","0","59.53","43.11"
"66","000","00","004","0416","1141","636","493","143","39","675","1105","0","61.09","44.62"
"66","000","00","004","0416","1142","810","631","179","47","857","1498","0","57.21","42.12"
"66","000","00","004","0416","1143","904","691","213","39","943","1921","0","49.09","35.97"
"66","000","00","004","0417","0000","3477","2741","736","175","3652","6075","0","60.12","45.12"
"66","000","00","004","0417","1133","916","733","183","44","960","1613","0","59.52","45.44"
"66","000","00","004","0417","1134","799","633","166","49","848","1454","0","58.32","43.54"
"66","000","00","004","0417","1135","918","708","210","33","951","1597","0","59.55","44.33"
"66","000","00","004","0417","1136","844","667","177","49","893","1411","0","63.29","47.27"
"66","000","00","004","0418","0000","2934","2230","704","156","3090","5581","0","55.37","39.96"
"66","000","00","004","0418","1108","1065","791","274","57","1122","1921","0","58.41","41.18"
"66","000","00","004","0418","1109","963","739","224","52","1015","1952","0","52.0","37.86"
"66","000","00","004","0418","1110","906","700","206","47","953","1708","0","55.8","40.98"
"66","000","00","004","0419","0000","3216","2448","768","195","3411","5667","0","60.19","43.2"
"66","000","00","004","0419","1144","727","535","192","58","785","1340","0","58.58","39.93"
"66","000","00","004","0419","1145","891","684","207","33","924","1536","0","60.16","44.53"
"66","000","00","004","0419","1146","729","536","193","76","805","1361","0","59.15","39.38"
"66","000","00","004","0419","1147","869","693","176","28","897","1430","0","62.73","48.46"
"66","000","00","004","0420","0000","1486","1114","372","95","1581","2794","0","56.59","39.87"
"66","000","00","004","0420","1128","801","583","218","54","855","1428","0","59.87","40.83"
"66","000","00","004","0420","1129","685","531","154","41","726","1366","0","53.15","38.87"
"66","000","00","004","0421","0000","1898","1385","513","122","2020","3600","0","56.11","38.47"
"66","000","00","004","0421","1126","924","690","234","66","990","1818","0","54.46","37.95"
"66","000","00","004","0421","1127","974","695","279","56","1030","1782","0","57.8","39.0"
"66","000","00","004","0422","0000","2665","2079","586","161","2826","4803","0","58.84","43.29"
"66","000","00","004","0422","1137","820","635","185","62","882","1493","0","59.08","42.53"
"66","000","00","004","0422","1138","935","746","189","42","977","1600","0","61.06","46.63"
"66","000","00","004","0422","1139","910","698","212","57","967","1710","0","56.55","40.82"
"66","000","00","004","0423","0000","2357","1898","459","108","2465","4187","0","58.87","45.33"
"66","000","00","004","0423","1130","805","626","179","38","843","1498","0","56.28","41.79"
"66","000","00","004","0423","1131","774","632","142","45","819","1350","0","60.67","46.81"
"66","000","00","004","0423","1132","778","640","138","25","803","1339","0","59.97","47.8"
"66","000","00","004","0424","0000","1653","1304","349","81","1734","2791","0","62.13","46.72"
"66","000","00","004","0424","1120","788","643","145","33","821","1287","0","63.79","49.96"
"66","000","00","004","0424","1121","865","661","204","48","913","1504","0","60.7","43.95"
"66","000","00","004","0425","0000","2447","1930","517","83","2530","4322","0","58.54","44.66"
"66","000","00","004","0425","1111","691","555","136","20","711","1131","0","62.86","49.07"
"66","000","00","004","0425","1112","1005","798","207","40","1045","1916","0","54.54","41.65"
"66","000","00","004","0425","1113","751","577","174","23","774","1275","0","60.71","45.25"
"66","000","00","005","0000","0000","65832","52039","13793","3502","69334","124621","147528","55.64","41.76"
"66","000","00","005","0501","0000","1051","824","227","75","1126","2047","0","55.01","40.25"
"66","000","00","005","0501","0985","506","403","103","37","543","1051","0","51.67","38.34"
"66","000","00","005","0501","0986","545","421","124","38","583","996","0","58.53","42.27"
"66","000","00","005","0502","0000","1867","1491","376","121","1988","3365","0","59.08","44.31"
"66","000","00","005","0502","0987","832","700","132","31","863","1504","0","57.38","46.54"
"66","000","00","005","0502","0988","548","403","145","55","603","975","0","61.85","41.33"
"66","000","00","005","0502","0989","487","388","99","35","522","886","0","58.92","43.79"
"66","000","00","005","0503","0000","697","550","147","71","768","1404","0","54.7","39.17"
"66","000","00","005","0503","0992","697","550","147","71","768","1404","0","54.7","39.17"
"66","000","00","005","0504","0000","820","664","156","36","856","1532","0","55.87","43.34"
"66","000","00","005","0504","0997","388","310","78","16","404","773","0","52.26","40.1"
"66","000","00","005","0504","0998","432","354","78","20","452","759","0","59.55","46.64"
"66","000","00","005","0505","0000","905","718","187","48","953","1683","0","56.63","42.66"
"66","000","00","005","0505","0995","412","332","80","20","432","704","0","61.36","47.16"
"66","000","00","005","0505","0996","493","386","107","28","521","979","0","53.22","39.43"
"66","000","00","005","0506","0000","1403","1193","210","68","1471","2650","0","55.51","45.02"
"66","000","00","005","0506","0999","801","687","114","46","847","1438","0","58.9","47.77"
"66","000","00","005","0506","1000","602","506","96","22","624","1212","0","51.49","41.75"
"66","000","00","005","0507","0000","1757","1378","379","86","1843","3176","0","58.03","43.39"
"66","000","00","005","0507","1001","904","711","193","45","949","1731","0","54.82","41.07"
"66","000","00","005","0507","1002","853","667","186","41","894","1445","0","61.87","46.16"
"66","000","00","005","0508","0000","2708","2176","532","154","2862","5461","0","52.41","39.85"
"66","000","00","005","0508","1003","972","755","217","51","1023","1855","0","55.15","40.7"
"66","000","00","005","0508","1004","813","653","160","59","872","1728","0","50.46","37.79"
"66","000","00","005","0508","1005","923","768","155","44","967","1878","0","51.49","40.89"
"66","000","00","005","0509","0000","1655","1336","319","69","1724","3340","0","51.62","40.0"
"66","000","00","005","0509","1008","828","660","168","30","858","1761","0","48.72","37.48"
"66","000","00","005","0509","1009","827","676","151","39","866","1579","0","54.84","42.81"
"66","000","00","005","0510","0000","1400","1125","275","73","1473","2482","0","59.35","45.33"
"66","000","00","005","0510","1012","803","643","160","46","849","1476","0","57.52","43.56"
"66","000","00","005","0510","1013","597","482","115","27","624","1006","0","62.03","47.91"
"66","000","00","005","0511","0000","2266","1823","443","112","2378","4309","0","55.19","42.31"
"66","000","00","005","0511","1014","764","628","136","37","801","1403","0","57.09","44.76"
"66","000","00","005","0511","1015","737","604","133","25","762","1446","0","52.7","41.77"
"66","000","00","005","0511","1016","765","591","174","50","815","1460","0","55.82","40.48"
"66","000","00","005","0512","0000","1312","1021","291","47","1359","2260","0","60.13","45.18"
"66","000","00","005","0512","1017","667","524","143","21","688","1233","0","55.8","42.5"
"66","000","00","005","0512","1018","645","497","148","26","671","1027","0","65.34","48.39"
"66","000","00","005","0513","0000","3122","2441","681","145","3267","5590","0","58.44","43.67"
"66","000","00","005","0513","1019","672","541","131","19","691","1207","0","57.25","44.82"
"66","000","00","005","0513","1020","675","523","152","38","713","1167","0","61.1","44.82"
"66","000","00","005","0513","1021","620","478","142","24","644","1150","0","56.0","41.57"
"66","000","00","005","0513","1022","595","473","122","33","628","1061","0","59.19","44.58"
"66","000","00","005","0513","1023","560","426","134","31","591","1005","0","58.81","42.39"
"66","000","00","005","0514","0000","2254","1756","498","126","2380","4077","0","58.38","43.07"
"66","000","00","005","0514","1024","676","516","160","18","694","1250","0","55.52","41.28"
"66","000","00","005","0514","1025","798","624","174","56","854","1448","0","58.98","43.09"
"66","000","00","005","0514","1026","780","616","164","52","832","1379","0","60.33","44.67"
"66","000","00","005","0515","0000","2212","1778","434","104","2316","5070","0","45.68","35.07"
"66","000","00","005","0515","1029","524","412","112","24","548","2078","0","26.37","19.83"
"66","000","00","005","0515","1030","901","716","185","44","945","1562","0","60.5","45.84"
"66","000","00","005","0515","1031","787","650","137","36","823","1430","0","57.55","45.45"
"66","000","00","005","0516","0000","2369","1909","460","87","2456","4440","0","55.32","43.0"
"66","000","00","005","0516","1045","717","571","146","28","745","1461","0","50.99","39.08"
"66","000","00","005","0516","1046","785","628","157","28","813","1310","0","62.06","47.94"
"66","000","00","005","0516","1047","867","710","157","31","898","1669","0","53.8","42.54"
"66","000","00","005","0517","0000","1947","1530","417","101","2048","3614","0","56.67","42.34"
"66","000","00","005","0517","1048","1044","827","217","72","1116","1932","0","57.76","42.81"
"66","000","00","005","0517","1049","903","703","200","29","932","1682","0","55.41","41.8"
"66","000","00","005","0518","0000","2572","1993","579","127","2699","4932","0","54.72","40.41"
"66","000","00","005","0518","1050","955","702","253","29","984","1891","0","52.04","37.12"
"66","000","00","005","0518","1051","994","794","200","71","1065","1882","0","56.59","42.19"
"66","000","00","005","0518","1052","623","497","126","27","650","1159","0","56.08","42.88"
"66","000","00","005","0519","0000","1405","1114","291","122","1527","2613","0","58.44","42.63"
"66","000","00","005","0519","1068","734","578","156","64","798","1346","0","59.29","42.94"
"66","000","00","005","0519","1069","671","536","135","58","729","1267","0","57.54","42.3"
"66","000","00","005","0520","0000","1961","1524","437","150","2111","3752","0","56.26","40.62"
"66","000","00","005","0520","1010","1095","854","241","86","1181","2192","0","53.88","38.96"
"66","000","00","005","0520","1011","866","670","196","64","930","1560","0","59.62","42.95"
"66","000","00","005","0521","0000","3436","2647","789","193","3629","6457","0","56.2","40.99"
"66","000","00","005","0521","1053","817","643","174","55","872","1553","0","56.15","41.4"
"66","000","00","005","0521","1054","842","639","203","41","883","1607","0","54.95","39.76"
"66","000","00","005","0521","1055","950","718","232","43","993","1773","0","56.01","40.5"
"66","000","00","005","0521","1056","827","647","180","54","881","1524","0","57.81","42.45"
"66","000","00","005","0522","0000","2942","2311","631","173","3115","5282","0","58.97","43.75"
"66","000","00","005","0522","1057","939","725","214","61","1000","1613","0","62.0","44.95"
"66","000","00","005","0522","1058","1036","837","199","47","1083","1877","0","57.7","44.59"
"66","000","00","005","0522","1059","967","749","218","65","1032","1792","0","57.59","41.8"
"66","000","00","005","0523","0000","3167","2418","749","145","3312","6037","0","54.86","40.05"
"66","000","00","005","0523","1062","893","677","216","40","933","1556","0","59.96","43.51"
"66","000","00","005","0523","1063","801","596","205","23","824","1497","0","55.04","39.81"
"66","000","00","005","0523","1064","814","652","162","50","864","1550","0","55.74","42.06"
"66","000","00","005","0523","1065","659","493","166","32","691","1434","0","48.19","34.38"
"66","000","00","005","0524","0000","2019","1578","441","94","2113","3734","0","56.59","42.26"
"66","000","00","005","0524","1040","688","543","145","26","714","1243","0","57.44","43.68"
"66","000","00","005","0524","1041","617","491","126","23","640","1219","0","52.5","40.28"
"66","000","00","005","0524","1042","714","544","170","45","759","1272","0","59.67","42.77"
"66","000","00","005","0525","0000","2080","1688","392","98","2178","3777","0","57.66","44.69"
"66","000","00","005","0525","1034","755","610","145","32","787","1432","0","54.96","42.6"
"66","000","00","005","0525","1035","680","555","125","26","706","1157","0","61.02","47.97"
"66","000","00","005","0525","1036","645","523","122","40","685","1188","0","57.66","44.02"
"66","000","00","005","0526","0000","725","550","175","34","759","1437","0","52.82","38.27"
"66","000","00","005","0526","0983","725","550","175","34","759","1437","0","52.82","38.27"
"66","000","00","005","0527","0000","836","620","216","77","913","1708","0","53.45","36.3"
"66","000","00","005","0527","0984","836","620","216","77","913","1708","0","53.45","36.3"
"66","000","00","005","0528","0000","990","786","204","69","1059","2214","0","47.83","35.5"
"66","000","00","005","0528","0990","538","433","105","35","573","1276","0","44.91","33.93"
"66","000","00","005","0528","0991","452","353","99","34","486","938","0","51.81","37.63"
"66","000","00","005","0529","0000","972","726","246","76","1048","1865","0","56.19","38.93"
"66","000","00","005","0529","0993","534","414","120","20","554","996","0","55.62","41.57"
"66","000","00","005","0529","0994","438","312","126","56","494","869","0","56.85","35.9"
"66","000","00","005","0530","0000","1734","1536","198","100","1834","3348","0","54.78","45.88"
"66","000","00","005","0530","1006","854","668","186","81","935","1793","0","52.15","37.26"
"66","000","00","005","0530","1007","880","868","12","19","899","1555","0","57.81","55.82"
"66","000","00","005","0531","0000","1873","1491","382","95","1968","3519","0","55.92","42.37"
"66","000","00","005","0531","1027","902","722","180","55","957","1652","0","57.93","43.7"
"66","000","00","005","0531","1028","971","769","202","40","1011","1867","0","54.15","41.19"
"66","000","00","005","0532","0000","2291","1797","494","114","2405","4305","0","55.87","41.74"
"66","000","00","005","0532","1037","758","589","169","38","796","1419","0","56.1","41.51"
"66","000","00","005","0532","1038","846","676","170","31","877","1653","0","53.06","40.9"
"66","000","00","005","0532","1039","687","532","155","45","732","1233","0","59.37","43.15"
"66","000","00","005","0533","0000","1470","1158","312","77","1547","2689","0","57.53","43.06"
"66","000","00","005","0533","1060","778","615","163","46","824","1392","0","59.2","44.18"
"66","000","00","005","0533","1061","692","543","149","31","723","1297","0","55.74","41.87"
"66","000","00","005","0534","0000","1984","1546","438","98","2082","3659","0","56.9","42.25"
"66","000","00","005","0534","1066","977","771","206","61","1038","1793","0","57.89","43.0"
"66","000","00","005","0534","1067","1007","775","232","37","1044","1866","0","55.95","41.53"
"66","000","00","005","0535","0000","1682","1322","360","65","1747","3065","0","57.0","43.13"
"66","000","00","005","0535","1043","710","571","139","26","736","1285","0","57.28","44.44"
"66","000","00","005","0535","1044","972","751","221","39","1011","1780","0","56.8","42.19"
"66","000","00","005","0536","0000","1948","1521","427","72","2020","3728","0","54.18","40.8"
"66","000","00","005","0536","1032","1114","864","250","44","1158","2018","0","57.38","42.81"
"66","000","00","005","0536","1033","834","657","177","28","862","1710","0","50.41","38.42"
"66","000","00","006","0000","0000","100297","79926","20371","5642","105939","183814","228128","57.63","43.48"
"66","000","00","006","0601","0000","2642","2075","567","153","2795","4749","0","58.85","43.69"
"66","000","00","006","0601","0625","959","739","220","60","1019","1638","0","62.21","45.12"
"66","000","00","006","0601","0626","689","544","145","42","731","1335","0","54.76","40.75"
"66","000","00","006","0601","0627","994","792","202","51","1045","1776","0","58.84","44.59"
"66","000","00","006","0602","0000","2810","2245","565","178","2988","5323","0","56.13","42.18"
"66","000","00","006","0602","0634","903","709","194","73","976","1749","0","55.8","40.54"
"66","000","00","006","0602","0635","1027","844","183","61","1088","1877","0","57.96","44.97"
"66","000","00","006","0602","0636","880","692","188","44","924","1697","0","54.45","40.78"
"66","000","00","006","0603","0000","2632","2070","562","136","2768","5447","0","50.82","38.0"
"66","000","00","006","0603","0637","862","687","175","40","902","1480","0","60.95","46.42"
"66","000","00","006","0603","0638","919","723","196","53","972","1483","0","65.54","48.75"
"66","000","00","006","0603","0639","851","660","191","43","894","2484","0","35.99","26.57"
"66","000","00","006","0604","0000","478","370","108","44","522","781","0","66.84","47.38"
"66","000","00","006","0604","0640","478","370","108","44","522","781","0","66.84","47.38"
"66","000","00","006","0605","0000","7258","5791","1467","296","7554","13148","0","57.45","44.04"
"66","000","00","006","0605","0641","837","666","171","50","887","1477","0","60.05","45.09"
"66","000","00","006","0605","0642","954","763","191","33","987","1784","0","55.33","42.77"
"66","000","00","006","0605","0643","935","772","163","33","968","1686","0","57.41","45.79"
"66","000","00","006","0605","0644","915","718","197","39","954","1692","0","56.38","42.43"
"66","000","00","006","0605","0645","877","725","152","18","895","1659","0","53.95","43.7"
"66","000","00","006","0605","0646","901","723","178","38","939","1648","0","56.98","43.87"
"66","000","00","006","0605","0647","886","683","203","39","925","1536","0","60.22","44.47"
"66","000","00","006","0605","0648","953","741","212","46","999","1666","0","59.96","44.48"
"66","000","00","006","0606","0000","2600","2143","457","134","2734","4812","0","56.82","44.53"
"66","000","00","006","0606","0649","801","658","143","49","850","1428","0","59.52","46.08"
"66","000","00","006","0606","0650","938","777","161","52","990","1810","0","54.7","42.93"
"66","000","00","006","0606","0651","861","708","153","33","894","1574","0","56.8","44.98"
"66","000","00","006","0607","0000","2400","1932","468","123","2523","4314","0","58.48","44.78"
"66","000","00","006","0607","0658","944","747","197","32","976","1714","0","56.94","43.58"
"66","000","00","006","0607","0659","798","646","152","48","846","1424","0","59.41","45.37"
"66","000","00","006","0607","0660","658","539","119","43","701","1176","0","59.61","45.83"
"66","000","00","006","0608","0000","1612","1411","201","80","1692","2739","0","61.77","51.52"
"66","000","00","006","0608","0665","783","690","93","58","841","1355","0","62.07","50.92"
"66","000","00","006","0608","0666","829","721","108","22","851","1384","0","61.49","52.1"
"66","000","00","006","0609","0000","2583","2026","557","156","2739","5068","0","54.04","39.98"
"66","000","00","006","0609","0679","890","693","197","72","962","1699","0","56.62","40.79"
"66","000","00","006","0609","0680","840","663","177","45","885","1715","0","51.6","38.66"
"66","000","00","006","0609","0681","853","670","183","39","892","1654","0","53.93","40.51"
"66","000","00","006","0610","0000","1771","1373","398","103","1874","3175","0","59.02","43.24"
"66","000","00","006","0610","0667","918","715","203","48","966","1613","0","59.89","44.33"
"66","000","00","006","0610","0668","853","658","195","55","908","1562","0","58.13","42.13"
"66","000","00","006","0611","0000","2244","1734","510","145","2389","3774","0","63.3","45.95"
"66","000","00","006","0611","0695","706","547","159","29","735","1221","0","60.2","44.8"
"66","000","00","006","0611","0696","780","613","167","63","843","1252","0","67.33","48.96"
"66","000","00","006","0611","0697","758","574","184","53","811","1301","0","62.34","44.12"
"66","000","00","006","0612","0000","1241","1069","172","103","1344","2162","0","62.16","49.44"
"66","000","00","006","0612","0698","627","535","92","40","667","1049","0","63.58","51.0"
"66","000","00","006","0612","0699","614","534","80","63","677","1113","0","60.83","47.98"
"66","000","00","006","0613","0000","1696","1367","329","104","1800","3197","0","56.3","42.76"
"66","000","00","006","0613","0700","801","661","140","54","855","1557","0","54.91","42.45"
"66","000","00","006","0613","0701","895","706","189","50","945","1640","0","57.62","43.05"
"66","000","00","006","0614","0000","2597","2060","537","208","2805","4807","0","58.35","42.85"
"66","000","00","006","0614","0702","870","688","182","70","940","1402","0","67.05","49.07"
"66","000","00","006","0614","0703","836","675","161","70","906","1717","0","52.77","39.31"
"66","000","00","006","0614","0704","891","697","194","68","959","1688","0","56.81","41.29"
"66","000","00","006","0615","0000","2539","2003","536","188","2727","4904","0","55.61","40.84"
"66","000","00","006","0615","0705","626","480","146","91","717","1168","0","61.39","41.1"
"66","000","00","006","0615","0706","897","716","181","49","946","1729","0","54.71","41.41"
"66","000","00","006","0615","0707","1016","807","209","48","1064","2007","0","53.01","40.21"
"66","000","00","006","0616","0000","1227","968","259","107","1334","2364","0","56.43","40.95"
"66","000","00","006","0616","0708","714","556","158","81","795","1296","0","61.34","42.9"
"66","000","00","006","0616","0709","513","412","101","26","539","1068","0","50.47","38.58"
"66","000","00","006","0617","0000","1749","1396","353","127","1876","3343","0","56.12","41.76"
"66","000","00","006","0617","0710","827","664","163","78","905","1707","0","53.02","38.9"
"66","000","00","006","0617","0711","922","732","190","49","971","1636","0","59.35","44.74"
"66","000","00","006","0618","0000","6412","5170","1242","303","6715","12239","0","54.87","42.24"
"66","000","00","006","0618","0712","789","657","132","49","838","1761","0","47.59","37.31"
"66","000","00","006","0618","0713","723","559","164","47","770","1314","0","58.6","42.54"
"66","000","00","006","0618","0714","745","601","144","43","788","1233","0","63.91","48.74"
"66","000","00","006","0618","0715","808","636","172","48","856","1549","0","55.26","41.06"
"66","000","00","006","0618","0716","842","691","151","29","871","1639","0","53.14","42.16"
"66","000","00","006","0618","0717","768","626","142","44","812","1486","0","54.64","42.13"
"66","000","00","006","0618","0718","962","775","187","21","983","1806","0","54.43","42.91"
"66","000","00","006","0618","0719","775","625","150","22","797","1451","0","54.93","43.07"
"66","000","00","006","0619","0000","1522","1231","291","87","1609","2655","0","60.6","46.37"
"66","000","00","006","0619","0720","731","617","114","36","767","1302","0","58.91","47.39"
"66","000","00","006","0619","0721","791","614","177","51","842","1353","0","62.23","45.38"
"66","000","00","006","0620","0000","2526","1960","566","183","2709","4520","0","59.93","43.36"
"66","000","00","006","0620","0741","615","482","133","57","672","1206","0","55.72","39.97"
"66","000","00","006","0620","0742","632","469","163","51","683","1086","0","62.89","43.19"
"66","000","00","006","0620","0743","637","510","127","41","678","1088","0","62.32","46.88"
"66","000","00","006","0620","0744","642","499","143","34","676","1140","0","59.3","43.77"
"66","000","00","006","0621","0000","3369","2637","732","169","3538","6178","0","57.27","42.68"
"66","000","00","006","0621","0682","876","714","162","24","900","1636","0","55.01","43.64"
"66","000","00","006","0621","0683","684","525","159","34","718","1298","0","55.32","40.45"
"66","000","00","006","0621","0684","789","596","193","48","837","1391","0","60.17","42.85"
"66","000","00","006","0621","0685","1020","802","218","63","1083","1853","0","58.45","43.28"
"66","000","00","006","0622","0000","1837","1563","274","111","1948","3629","0","53.68","43.07"
"66","000","00","006","0622","0686","846","760","86","64","910","1820","0","50.0","41.76"
"66","000","00","006","0622","0687","991","803","188","47","1038","1809","0","57.38","44.39"
"66","000","00","006","0623","0000","3732","2925","807","190","3922","6663","0","58.86","43.9"
"66","000","00","006","0623","0691","937","729","208","45","982","1674","0","58.66","43.55"
"66","000","00","006","0623","0692","952","741","211","53","1005","1610","0","62.42","46.02"
"66","000","00","006","0623","0693","945","755","190","45","990","1695","0","58.41","44.54"
"66","000","00","006","0623","0694","898","700","198","47","945","1684","0","56.12","41.57"
"66","000","00","006","0624","0000","2509","2031","478","142","2651","4890","0","54.21","41.53"
"66","000","00","006","0624","0631","857","700","157","32","889","1710","0","51.99","40.94"
"66","000","00","006","0624","0632","769","592","177","54","823","1595","0","51.6","37.12"
"66","000","00","006","0624","0633","883","739","144","56","939","1585","0","59.24","46.62"
"66","000","00","006","0625","0000","2385","1872","513","117","2502","4205","0","59.5","44.52"
"66","000","00","006","0625","0672","882","709","173","51","933","1494","0","62.45","47.46"
"66","000","00","006","0625","0673","712","574","138","32","744","1325","0","56.15","43.32"
"66","000","00","006","0625","0674","791","589","202","34","825","1386","0","59.52","42.5"
"66","000","00","006","0626","0000","2373","1866","507","127","2500","4271","0","58.53","43.69"
"66","000","00","006","0626","0628","748","581","167","25","773","1351","0","57.22","43.01"
"66","000","00","006","0626","0629","766","598","168","51","817","1338","0","61.06","44.69"
"66","000","00","006","0626","0630","859","687","172","51","910","1582","0","57.52","43.43"
"66","000","00","006","0627","0000","2701","2134","567","133","2834","4987","0","56.83","42.79"
"66","000","00","006","0627","0652","917","753","164","17","934","1650","0","56.61","45.64"
"66","000","00","006","0627","0653","899","708","191","72","971","1681","0","57.76","42.12"
"66","000","00","006","0627","0654","885","673","212","44","929","1656","0","56.1","40.64"
"66","000","00","006","0628","0000","2439","1954","485","151","2590","4145","0","62.48","47.14"
"66","000","00","006","0628","0655","715","579","136","50","765","1243","0","61.54","46.58"
"66","000","00","006","0628","0656","869","698","171","62","931","1471","0","63.29","47.45"
"66","000","00","006","0628","0657","855","677","178","39","894","1431","0","62.47","47.31"
"66","000","00","006","0629","0000","3105","2528","577","209","3314","5327","0","62.21","47.46"
"66","000","00","006","0629","0661","807","630","177","69","876","1456","0","60.16","43.27"
"66","000","00","006","0629","0662","863","710","153","47","910","1451","0","62.72","48.93"
"66","000","00","006","0629","0663","664","551","113","31","695","1063","0","65.38","51.83"
"66","000","00","006","0629","0664","771","637","134","62","833","1357","0","61.39","46.94"
"66","000","00","006","0630","0000","2046","1580","466","149","2195","3585","0","61.23","44.07"
"66","000","00","006","0630","0669","732","563","169","63","795","1219","0","65.22","46.19"
"66","000","00","006","0630","0670","682","521","161","39","721","1235","0","58.38","42.19"
"66","000","00","006","0630","0671","632","496","136","47","679","1131","0","60.04","43.85"
"66","000","00","006","0631","0000","3823","3046","777","249","4072","7145","0","56.99","42.63"
"66","000","00","006","0631","0675","999","775","224","75","1074","1816","0","59.14","42.68"
"66","000","00","006","0631","0676","895","717","178","36","931","1734","0","53.69","41.35"
"66","000","00","006","0631","0677","996","808","188","71","1067","1777","0","60.05","45.47"
"66","000","00","006","0631","0678","933","746","187","67","1000","1818","0","55.01","41.03"
"66","000","00","006","0632","0000","2466","1937","529","160","2626","4359","0","60.24","44.44"
"66","000","00","006","0632","0688","793","625","168","49","842","1352","0","62.28","46.23"
"66","000","00","006","0632","0689","818","644","174","65","883","1521","0","58.05","42.34"
"66","000","00","006","0632","0690","855","668","187","46","901","1486","0","60.63","44.95"
"66","000","00","006","0633","0000","2447","1853","594","145","2592","4285","0","60.49","43.24"
"66","000","00","006","0633","0733","857","651","206","51","908","1526","0","59.5","42.66"
"66","000","00","006","0633","0734","803","631","172","61","864","1425","0","60.63","44.28"
"66","000","00","006","0633","0735","787","571","216","33","820","1334","0","61.47","42.8"
"66","000","00","006","0634","0000","1759","1409","350","74","1833","3215","0","57.01","43.83"
"66","000","00","006","0634","0736","945","755","190","34","979","1649","0","59.37","45.79"
"66","000","00","006","0634","0737","814","654","160","40","854","1566","0","54.53","41.76"
"66","000","00","006","0635","0000","2714","2181","533","126","2840","4699","0","60.44","46.41"
"66","000","00","006","0635","0738","945","768","177","46","991","1629","0","60.83","47.15"
"66","000","00","006","0635","0739","927","724","203","40","967","1628","0","59.4","44.47"
"66","000","00","006","0635","0740","842","689","153","40","882","1442","0","61.17","47.78"
"66","000","00","006","0636","0000","1505","1195","310","73","1578","3043","0","51.86","39.27"
"66","000","00","006","0636","0731","709","565","144","34","743","1541","0","48.22","36.66"
"66","000","00","006","0636","0732","796","630","166","39","835","1502","0","55.59","41.94"
"66","000","00","006","0637","0000","1574","1273","301","51","1625","2917","0","55.71","43.64"
"66","000","00","006","0637","0729","786","640","146","27","813","1402","0","57.99","45.65"
"66","000","00","006","0637","0730","788","633","155","24","812","1515","0","53.6","41.78"
"66","000","00","006","0638","0000","3942","3107","835","170","4112","7133","0","57.65","43.56"
"66","000","00","006","0638","0725","988","782","206","45","1033","1847","0","55.93","42.34"
"66","000","00","006","0638","0726","959","764","195","45","1004","1738","0","57.77","43.96"
"66","000","00","006","0638","0727","963","750","213","42","1005","1640","0","61.28","45.73"
"66","000","00","006","0638","0728","1032","811","221","38","1070","1908","0","56.08","42.51"
"66","000","00","006","0639","0000","3032","2441","591","138","3170","5617","0","56.44","43.46"
"66","000","00","006","0639","0722","1199","973","226","53","1252","2162","0","57.91","45.0"
"66","000","00","006","0639","0723","820","626","194","45","865","1520","0","56.91","41.18"
"66","000","00","006","0639","0724","1013","842","171","40","1053","1935","0","54.42","43.51"
"66","000","00","007","0000","0000","77143","60752","16391","4455","81598","135448","170160","60.24","44.85"
"66","000","00","007","0701","0000","4843","3849","994","268","5111","8349","0","61.22","46.1"
"66","000","00","007","0701","0745","743","581","162","64","807","1321","0","61.09","43.98"
"66","000","00","007","0701","0746","781","588","193","63","844","1346","0","62.7","43.68"
"66","000","00","007","0701","0747","810","625","185","48","858","1428","0","60.08","43.77"
"66","000","00","007","0701","0748","798","653","145","36","834","1442","0","57.84","45.28"
"66","000","00","007","0701","0749","882","719","163","27","909","1408","0","64.56","51.07"
"66","000","00","007","0701","0750","829","683","146","30","859","1404","0","61.18","48.65"
"66","000","00","007","0702","0000","6467","5021","1446","322","6789","10909","0","62.23","46.03"
"66","000","00","007","0702","0751","812","664","148","48","860","1354","0","63.52","49.04"
"66","000","00","007","0702","0752","784","614","170","53","837","1332","0","62.84","46.1"
"66","000","00","007","0702","0753","875","663","212","49","924","1463","0","63.16","45.32"
"66","000","00","007","0702","0754","811","588","223","41","852","1413","0","60.3","41.61"
"66","000","00","007","0702","0755","749","588","161","25","774","1218","0","63.55","48.28"
"66","000","00","007","0702","0756","728","561","167","33","761","1308","0","58.18","42.89"
"66","000","00","007","0702","0757","932","735","197","40","972","1527","0","63.65","48.13"
"66","000","00","007","0702","0758","776","608","168","33","809","1294","0","62.52","46.99"
"66","000","00","007","0703","0000","3170","2462","708","240","3410","5848","0","58.31","42.1"
"66","000","00","007","0703","0759","765","571","194","51","816","1516","0","53.83","37.66"
"66","000","00","007","0703","0760","862","664","198","86","948","1529","0","62.0","43.43"
"66","000","00","007","0703","0761","796","616","180","63","859","1397","0","61.49","44.09"
"66","000","00","007","0703","0762","747","611","136","40","787","1406","0","55.97","43.46"
"66","000","00","007","0704","0000","2206","1723","483","167","2373","4409","0","53.82","39.08"
"66","000","00","007","0704","0763","778","613","165","50","828","1497","0","55.31","40.95"
"66","000","00","007","0704","0764","748","578","170","70","818","1424","0","57.44","40.59"
"66","000","00","007","0704","0765","680","532","148","47","727","1488","0","48.86","35.75"
"66","000","00","007","0705","0000","3192","2578","614","191","3383","6387","0","52.97","40.36"
"66","000","00","007","0705","0768","667","520","147","65","732","1190","0","61.51","43.7"
"66","000","00","007","0705","0769","628","507","121","35","663","1174","0","56.47","43.19"
"66","000","00","007","0705","0770","698","574","124","17","715","1224","0","58.42","46.9"
"66","000","00","007","0705","0771","655","535","120","43","698","1466","0","47.61","36.49"
"66","000","00","007","0705","0772","544","442","102","31","575","1333","0","43.14","33.16"
"66","000","00","007","0706","0000","458","347","111","62","520","814","0","63.88","42.63"
"66","000","00","007","0706","0773","458","347","111","62","520","814","0","63.88","42.63"
"66","000","00","007","0707","0000","5211","4136","1075","344","5555","9662","0","57.49","42.81"
"66","000","00","007","0707","0774","729","572","157","61","790","1436","0","55.01","39.83"
"66","000","00","007","0707","0775","846","657","189","59","905","1515","0","59.74","43.37"
"66","000","00","007","0707","0776","720","572","148","81","801","1545","0","51.84","37.02"
"66","000","00","007","0707","0777","777","626","151","37","814","1383","0","58.86","45.26"
"66","000","00","007","0707","0778","822","667","155","39","861","1433","0","60.08","46.55"
"66","000","00","007","0707","0779","594","457","137","28","622","1134","0","54.85","40.3"
"66","000","00","007","0707","0780","723","585","138","39","762","1216","0","62.66","48.11"
"66","000","00","007","0708","0000","760","522","238","50","810","1397","0","57.98","37.37"
"66","000","00","007","0708","0785","760","522","238","50","810","1397","0","57.98","37.37"
"66","000","00","007","0709","0000","2669","2109","560","168","2837","4800","0","59.1","43.94"
"66","000","00","007","0709","0786","854","646","208","71","925","1607","0","57.56","40.2"
"66","000","00","007","0709","0787","896","720","176","48","944","1582","0","59.67","45.51"
"66","000","00","007","0709","0788","919","743","176","49","968","1611","0","60.09","46.12"
"66","000","00","007","0710","0000","3929","3080","849","184","4113","6621","0","62.12","46.52"
"66","000","00","007","0710","0789","795","616","179","46","841","1322","0","63.62","46.6"
"66","000","00","007","0710","0790","819","641","178","38","857","1321","0","64.88","48.52"
"66","000","00","007","0710","0791","767","622","145","45","812","1360","0","59.71","45.74"
"66","000","00","007","0710","0792","802","631","171","15","817","1361","0","60.03","46.36"
"66","000","00","007","0710","0793","746","570","176","40","786","1257","0","62.53","45.35"
"66","000","00","007","0711","0000","3088","2425","663","164","3252","5151","0","63.13","47.08"
"66","000","00","007","0711","0809","718","552","166","33","751","1171","0","64.13","47.14"
"66","000","00","007","0711","0810","753","575","178","56","809","1349","0","59.97","42.62"
"66","000","00","007","0711","0811","841","657","184","33","874","1368","0","63.89","48.03"
"66","000","00","007","0711","0812","776","641","135","42","818","1263","0","64.77","50.75"
"66","000","00","007","0712","0000","3555","2728","827","204","3759","6052","0","62.11","45.08"
"66","000","00","007","0712","0822","990","781","209","44","1034","1544","0","66.97","50.58"
"66","000","00","007","0712","0823","935","682","253","47","982","1482","0","66.26","46.02"
"66","000","00","007","0712","0824","860","663","197","68","928","1488","0","62.37","44.56"
"66","000","00","007","0712","0825","770","602","168","45","815","1538","0","52.99","39.14"
"66","000","00","007","0713","0000","2596","2072","524","160","2756","4239","0","65.02","48.88"
"66","000","00","007","0713","0805","631","494","137","59","690","981","0","70.34","50.36"
"66","000","00","007","0713","0806","653","532","121","53","706","1097","0","64.36","48.5"
"66","000","00","007","0713","0807","622","506","116","25","647","991","0","65.29","51.06"
"66","000","00","007","0713","0808","690","540","150","23","713","1170","0","60.94","46.15"
"66","000","00","007","0714","0000","826","609","217","110","936","1421","0","65.87","42.86"
"66","000","00","007","0714","0766","362","285","77","46","408","608","0","67.11","46.88"
"66","000","00","007","0714","0767","464","324","140","64","528","813","0","64.94","39.85"
"66","000","00","007","0715","0000","2815","2200","615","147","2962","4733","0","62.58","46.48"
"66","000","00","007","0715","0836","739","588","151","27","766","1278","0","59.94","46.01"
"66","000","00","007","0715","0837","708","557","151","46","754","1144","0","65.91","48.69"
"66","000","00","007","0715","0838","668","508","160","32","700","1140","0","61.4","44.56"
"66","000","00","007","0715","0839","700","547","153","42","742","1171","0","63.36","46.71"
"66","000","00","007","0716","0000","2126","1705","421","138","2264","3673","0","61.64","46.42"
"66","000","00","007","0716","0829","732","599","133","51","783","1217","0","64.34","49.22"
"66","000","00","007","0716","0830","750","589","161","53","803","1347","0","59.61","43.73"
"66","000","00","007","0716","0831","644","517","127","34","678","1109","0","61.14","46.62"
"66","000","00","007","0717","0000","2931","2335","596","146","3077","5144","0","59.82","45.39"
"66","000","00","007","0717","0832","858","701","157","37","895","1546","0","57.89","45.34"
"66","000","00","007","0717","0833","869","701","168","39","908","1408","0","64.49","49.79"
"66","000","00","007","0717","0834","561","448","113","20","581","1057","0","54.97","42.38"
"66","000","00","007","0717","0835","643","485","158","50","693","1133","0","61.17","42.81"
"66","000","00","007","0718","0000","2665","2099","566","175","2840","5184","0","54.78","40.49"
"66","000","00","007","0718","0826","982","773","209","74","1056","1674","0","63.08","46.18"
"66","000","00","007","0718","0827","826","645","181","36","862","1996","0","43.19","32.31"
"66","000","00","007","0718","0828","857","681","176","65","922","1514","0","60.9","44.98"
"66","000","00","007","0719","0000","2119","1655","464","131","2250","3517","0","63.97","47.06"
"66","000","00","007","0719","0843","692","524","168","42","734","1139","0","64.44","46.01"
"66","000","00","007","0719","0844","726","563","163","54","780","1216","0","64.14","46.3"
"66","000","00","007","0719","0845","701","568","133","35","736","1162","0","63.34","48.88"
"66","000","00","007","0720","0000","2395","1892","503","134","2529","4276","0","59.14","44.25"
"66","000","00","007","0720","0840","795","614","181","42","837","1303","0","64.24","47.12"
"66","000","00","007","0720","0841","733","590","143","43","776","1402","0","55.35","42.08"
"66","000","00","007","0720","0842","867","688","179","49","916","1571","0","58.31","43.79"
"66","000","00","007","0721","0000","3545","2746","799","173","3718","6405","0","58.05","42.87"
"66","000","00","007","0721","0813","921","705","216","41","962","1547","0","62.18","45.57"
"66","000","00","007","0721","0814","933","714","219","53","986","1649","0","59.79","43.3"
"66","000","00","007","0721","0815","880","706","174","36","916","1629","0","56.23","43.34"
"66","000","00","007","0721","0816","811","621","190","43","854","1580","0","54.05","39.3"
"66","000","00","007","0722","0000","4149","3300","849","195","4344","7096","0","61.22","46.51"
"66","000","00","007","0722","0817","911","745","166","36","947","1444","0","65.58","51.59"
"66","000","00","007","0722","0818","791","654","137","25","816","1413","0","57.75","46.28"
"66","000","00","007","0722","0819","771","625","146","38","809","1377","0","58.75","45.39"
"66","000","00","007","0722","0820","887","658","229","44","931","1527","0","60.97","43.09"
"66","000","00","007","0722","0821","789","618","171","52","841","1335","0","63.0","46.29"
"66","000","00","007","0723","0000","2796","2192","604","178","2974","5132","0","57.95","42.71"
"66","000","00","007","0723","0781","664","510","154","71","735","1271","0","57.83","40.13"
"66","000","00","007","0723","0782","638","522","116","24","662","1203","0","55.03","43.39"
"66","000","00","007","0723","0783","710","552","158","33","743","1268","0","58.6","43.53"
"66","000","00","007","0723","0784","784","608","176","50","834","1390","0","60.0","43.74"
"66","000","00","007","0724","0000","4787","3883","904","242","5029","7974","0","63.07","48.7"
"66","000","00","007","0724","0799","665","536","129","50","715","1102","0","64.88","48.64"
"66","000","00","007","0724","0800","1021","847","174","37","1058","1630","0","64.91","51.96"
"66","000","00","007","0724","0801","791","635","156","41","832","1333","0","62.42","47.64"
"66","000","00","007","0724","0802","778","611","167","36","814","1292","0","63.0","47.29"
"66","000","00","007","0724","0803","746","602","144","40","786","1272","0","61.79","47.33"
"66","000","00","007","0724","0804","786","652","134","38","824","1345","0","61.26","48.48"
"66","000","00","007","0725","0000","3845","3084","761","162","4007","6255","0","64.06","49.3"
"66","000","00","007","0725","0794","754","612","142","27","781","1207","0","64.71","50.7"
"66","000","00","007","0725","0795","778","640","138","34","812","1282","0","63.34","49.92"
"66","000","00","007","0725","0796","789","637","152","30","819","1248","0","65.63","51.04"
"66","000","00","007","0725","0797","812","629","183","40","852","1304","0","65.34","48.24"
"66","000","00","007","0725","0798","712","566","146","31","743","1214","0","61.2","46.62"
"66","000","00","008","0000","0000","122294","98529","23765","7061","129355","227720","278096","56.8","43.27"
"66","000","00","008","0801","0000","1636","1312","324","107","1743","3258","0","53.5","40.27"
"66","000","00","008","0801","0850","570","462","108","17","587","1107","0","53.03","41.73"
"66","000","00","008","0801","0851","1066","850","216","90","1156","2151","0","53.74","39.52"
"66","000","00","008","0802","0000","1856","1484","372","118","1974","3376","0","58.47","43.96"
"66","000","00","008","0802","0846","977","784","193","61","1038","1670","0","62.16","46.95"
"66","000","00","008","0802","0847","879","700","179","57","936","1706","0","54.87","41.03"
"66","000","00","008","0803","0000","3727","3003","724","161","3888","7049","0","55.16","42.6"
"66","000","00","008","0803","0852","925","751","174","28","953","1612","0","59.12","46.59"
"66","000","00","008","0803","0853","929","743","186","46","975","1743","0","55.94","42.63"
"66","000","00","008","0803","0854","1018","817","201","55","1073","2099","0","51.12","38.92"
"66","000","00","008","0803","0855","855","692","163","32","887","1595","0","55.61","43.39"
"66","000","00","008","0804","0000","2969","2379","590","146","3115","5567","0","55.95","42.73"
"66","000","00","008","0804","0924","874","687","187","34","908","1640","0","55.37","41.89"
"66","000","00","008","0804","0925","1079","872","207","58","1137","2052","0","55.41","42.5"
"66","000","00","008","0804","0926","1016","820","196","54","1070","1875","0","57.07","43.73"
"66","000","00","008","0805","0000","2797","2201","596","154","2951","5056","0","58.37","43.53"
"66","000","00","008","0805","0943","944","757","187","64","1008","1661","0","60.69","45.57"
"66","000","00","008","0805","0944","923","715","208","43","966","1667","0","57.95","42.89"
"66","000","00","008","0805","0945","930","729","201","47","977","1728","0","56.54","42.19"
"66","000","00","008","0806","0000","2258","1844","414","126","2384","4533","0","52.59","40.68"
"66","000","00","008","0806","0860","800","641","159","48","848","1563","0","54.25","41.01"
"66","000","00","008","0806","0861","784","633","151","56","840","1559","0","53.88","40.6"
"66","000","00","008","0806","0862","674","570","104","22","696","1411","0","49.33","40.4"
"66","000","00","008","0807","0000","3217","2573","644","189","3406","5930","0","57.44","43.39"
"66","000","00","008","0807","0894","813","646","167","54","867","1445","0","60.0","44.71"
"66","000","00","008","0807","0895","946","755","191","37","983","1842","0","53.37","40.99"
"66","000","00","008","0807","0896","669","536","133","46","715","1187","0","60.24","45.16"
"66","000","00","008","0807","0897","789","636","153","52","841","1456","0","57.76","43.68"
"66","000","00","008","0808","0000","7297","5918","1379","429","7726","12981","0","59.52","45.59"
"66","000","00","008","0808","0863","990","831","159","39","1029","1761","0","58.43","47.19"
"66","000","00","008","0808","0864","790","634","156","66","856","1361","0","62.89","46.58"
"66","000","00","008","0808","0865","949","771","178","85","1034","1852","0","55.83","41.63"
"66","000","00","008","0808","0866","1053","824","229","53","1106","1928","0","57.37","42.74"
"66","000","00","008","0808","0867","920","756","164","39","959","1492","0","64.28","50.67"
"66","000","00","008","0808","0868","1026","815","211","69","1095","1998","0","54.8","40.79"
"66","000","00","008","0808","0869","787","643","144","40","827","1272","0","65.02","50.55"
"66","000","00","008","0808","0870","782","644","138","38","820","1317","0","62.26","48.9"
"66","000","00","008","0809","0000","6119","5078","1041","386","6505","11817","0","55.05","42.97"
"66","000","00","008","0809","0871","641","510","131","58","699","1327","0","52.68","38.43"
"66","000","00","008","0809","0872","647","518","129","28","675","1280","0","52.73","40.47"
"66","000","00","008","0809","0873","822","739","83","58","880","1865","0","47.18","39.62"
"66","000","00","008","0809","0874","720","652","68","63","783","1230","0","63.66","53.01"
"66","000","00","008","0809","0875","679","549","130","48","727","1356","0","53.61","40.49"
"66","000","00","008","0809","0876","933","771","162","57","990","1732","0","57.16","44.52"
"66","000","00","008","0809","0877","896","730","166","42","938","1586","0","59.14","46.03"
"66","000","00","008","0809","0878","781","609","172","32","813","1441","0","56.42","42.26"
"66","000","00","008","0810","0000","5132","4260","872","287","5419","9996","0","54.21","42.62"
"66","000","00","008","0810","0879","1026","907","119","80","1106","2045","0","54.08","44.35"
"66","000","00","008","0810","0880","938","729","209","69","1007","1914","0","52.61","38.09"
"66","000","00","008","0810","0881","1025","862","163","50","1075","1918","0","56.05","44.94"
"66","000","00","008","0810","0882","1054","890","164","30","1084","2079","0","52.14","42.81"
"66","000","00","008","0810","0883","1089","872","217","58","1147","2040","0","56.23","42.75"
"66","000","00","008","0811","0000","938","742","196","54","992","2037","0","48.7","36.43"
"66","000","00","008","0811","0890","938","742","196","54","992","2037","0","48.7","36.43"
"66","000","00","008","0812","0000","531","435","96","49","580","985","0","58.88","44.16"
"66","000","00","008","0812","0889","531","435","96","49","580","985","0","58.88","44.16"
"66","000","00","008","0813","0000","4987","4070","917","233","5220","9749","0","53.54","41.75"
"66","000","00","008","0813","0884","955","746","209","54","1009","2027","0","49.78","36.8"
"66","000","00","008","0813","0885","741","597","144","46","787","1402","0","56.13","42.58"
"66","000","00","008","0813","0886","1000","805","195","67","1067","1826","0","58.43","44.09"
"66","000","00","008","0813","0887","1203","1047","156","40","1243","2162","0","57.49","48.43"
"66","000","00","008","0813","0888","1088","875","213","26","1114","2332","0","47.77","37.52"
"66","000","00","008","0814","0000","1162","934","228","85","1247","2094","0","59.55","44.6"
"66","000","00","008","0814","0891","589","465","124","40","629","1032","0","60.95","45.06"
"66","000","00","008","0814","0892","573","469","104","45","618","1062","0","58.19","44.16"
"66","000","00","008","0815","0000","461","377","84","61","522","909","0","57.43","41.47"
"66","000","00","008","0815","0893","461","377","84","61","522","909","0","57.43","41.47"
"66","000","00","008","0816","0000","4617","3638","979","288","4905","8139","0","60.27","44.7"
"66","000","00","008","0816","0915","827","633","194","58","885","1458","0","60.7","43.42"
"66","000","00","008","0816","0916","970","774","196","60","1030","1571","0","65.56","49.27"
"66","000","00","008","0816","0917","859","642","217","79","938","1579","0","59.4","40.66"
"66","000","00","008","0816","0918","1042","845","197","47","1089","1849","0","58.9","45.7"
"66","000","00","008","0816","0919","919","744","175","44","963","1682","0","57.25","44.23"
"66","000","00","008","0817","0000","4253","3480","773","190","4443","8903","0","49.9","39.09"
"66","000","00","008","0817","0949","1162","965","197","53","1215","2078","0","58.47","46.44"
"66","000","00","008","0817","0950","1108","902","206","56","1164","2059","0","56.53","43.81"
"66","000","00","008","0817","0951","977","806","171","43","1020","1792","0","56.92","44.98"
"66","000","00","008","0817","0952","1006","807","199","38","1044","2974","0","35.1","27.14"
"66","000","00","008","0818","0000","4510","3653","857","215","4725","7936","0","59.54","46.03"
"66","000","00","008","0818","0954","1129","926","203","54","1183","2099","0","56.36","44.12"
"66","000","00","008","0818","0955","1126","896","230","51","1177","1823","0","64.56","49.15"
"66","000","00","008","0818","0956","1158","938","220","75","1233","2022","0","60.98","46.39"
"66","000","00","008","0818","0957","1097","893","204","35","1132","1992","0","56.83","44.83"
"66","000","00","008","0819","0000","913","714","199","59","972","1585","0","61.32","45.05"
"66","000","00","008","0819","0958","913","714","199","59","972","1585","0","61.32","45.05"
"66","000","00","008","0820","0000","5562","4643","919","267","5829","9652","0","60.39","48.1"
"66","000","00","008","0820","0962","1010","861","149","38","1048","1755","0","59.72","49.06"
"66","000","00","008","0820","0963","955","783","172","44","999","1497","0","66.73","52.3"
"66","000","00","008","0820","0964","913","775","138","65","978","1567","0","62.41","49.46"
"66","000","00","008","0820","0965","865","730","135","42","907","1624","0","55.85","44.95"
"66","000","00","008","0820","0966","942","773","169","44","986","1614","0","61.09","47.89"
"66","000","00","008","0820","0967","877","721","156","34","911","1595","0","57.12","45.2"
"66","000","00","008","0821","0000","2852","2258","594","153","3005","5219","0","57.58","43.26"
"66","000","00","008","0821","0959","910","728","182","54","964","1565","0","61.6","46.52"
"66","000","00","008","0821","0960","852","663","189","42","894","1780","0","50.22","37.25"
"66","000","00","008","0821","0961","1090","867","223","57","1147","1874","0","61.21","46.26"
"66","000","00","008","0822","0000","576","465","111","53","629","1072","0","58.68","43.38"
"66","000","00","008","0822","0953","576","465","111","53","629","1072","0","58.68","43.38"
"66","000","00","008","0823","0000","3644","2837","807","315","3959","6608","0","59.91","42.93"
"66","000","00","008","0823","0979","977","748","229","106","1083","1785","0","60.67","41.9"
"66","000","00","008","0823","0980","909","726","183","70","979","1596","0","61.34","45.49"
"66","000","00","008","0823","0981","981","756","225","66","1047","1731","0","60.49","43.67"
"66","000","00","008","0823","0982","777","607","170","73","850","1496","0","56.82","40.57"
"66","000","00","008","0824","0000","2525","2012","513","178","2703","4576","0","59.07","43.97"
"66","000","00","008","0824","0971","706","548","158","52","758","1372","0","55.25","39.94"
"66","000","00","008","0824","0972","790","630","160","59","849","1415","0","60.0","44.52"
"66","000","00","008","0824","0973","1029","834","195","67","1096","1789","0","61.26","46.62"
"66","000","00","008","0825","0000","2108","1668","440","163","2271","4210","0","53.94","39.62"
"66","000","00","008","0825","0968","887","701","186","67","954","1782","0","53.54","39.34"
"66","000","00","008","0825","0969","652","511","141","39","691","1357","0","50.92","37.66"
"66","000","00","008","0825","0970","569","456","113","57","626","1071","0","58.45","42.58"
"66","000","00","008","0826","0000","2759","2184","575","190","2949","5209","0","56.61","41.93"
"66","000","00","008","0826","0930","1036","841","195","53","1089","1889","0","57.65","44.52"
"66","000","00","008","0826","0931","896","693","203","70","966","1728","0","55.9","40.1"
"66","000","00","008","0826","0932","827","650","177","67","894","1592","0","56.16","40.83"
"66","000","00","008","0827","0000","1618","1269","349","133","1751","3180","0","55.06","39.91"
"66","000","00","008","0827","0933","845","659","186","72","917","1656","0","55.37","39.79"
"66","000","00","008","0827","0934","773","610","163","61","834","1524","0","54.72","40.03"
"66","000","00","008","0828","0000","3205","2518","687","182","3387","6168","0","54.91","40.82"
"66","000","00","008","0828","0940","1006","807","199","60","1066","2033","0","52.43","39.7"
"66","000","00","008","0828","0941","1017","803","214","49","1066","1947","0","54.75","41.24"
"66","000","00","008","0828","0942","1182","908","274","73","1255","2188","0","57.36","41.5"
"66","000","00","008","0829","0000","2538","2027","511","180","2718","4803","0","56.59","42.2"
"66","000","00","008","0829","0908","910","717","193","62","972","1601","0","60.71","44.78"
"66","000","00","008","0829","0909","797","646","151","59","856","1527","0","56.06","42.31"
"66","000","00","008","0829","0910","831","664","167","59","890","1675","0","53.13","39.64"
"66","000","00","008","0830","0000","2780","2333","447","146","2926","5216","0","56.1","44.73"
"66","000","00","008","0830","0898","1012","885","127","58","1070","1866","0","57.34","47.43"
"66","000","00","008","0830","0899","846","695","151","56","902","1667","0","54.11","41.69"
"66","000","00","008","0830","0900","922","753","169","32","954","1683","0","56.68","44.74"
"66","000","00","008","0831","0000","2693","2172","521","135","2828","4895","0","57.77","44.37"
"66","000","00","008","0831","0976","826","654","172","54","880","1541","0","57.11","42.44"
"66","000","00","008","0831","0977","942","746","196","50","992","1669","0","59.44","44.7"
"66","000","00","008","0831","0978","925","772","153","31","956","1685","0","56.74","45.82"
"66","000","00","008","0832","0000","3488","2839","649","110","3598","6364","0","56.54","44.61"
"66","000","00","008","0832","0901","878","695","183","31","909","1642","0","55.36","42.33"
"66","000","00","008","0832","0902","825","646","179","23","848","1475","0","57.49","43.8"
"66","000","00","008","0832","0903","862","732","130","28","890","1644","0","54.14","44.53"
"66","000","00","008","0832","0904","923","766","157","28","951","1603","0","59.33","47.79"
"66","000","00","008","0833","0000","2994","2422","572","141","3135","5179","0","60.53","46.77"
"66","000","00","008","0833","0905","1087","891","196","65","1152","1949","0","59.11","45.72"
"66","000","00","008","0833","0906","1100","900","200","34","1134","1790","0","63.35","50.28"
"66","000","00","008","0833","0907","807","631","176","42","849","1440","0","58.96","43.82"
"66","000","00","008","0834","0000","1717","1339","378","131","1848","3159","0","58.5","42.39"
"66","000","00","008","0834","0848","787","616","171","76","863","1507","0","57.27","40.88"
"66","000","00","008","0834","0849","930","723","207","55","985","1652","0","59.62","43.77"
"66","000","00","008","0835","0000","2602","2070","532","141","2743","4735","0","57.93","43.72"
"66","000","00","008","0835","0935","830","628","202","43","873","1502","0","58.12","41.81"
"66","000","00","008","0835","0936","954","787","167","43","997","1772","0","56.26","44.41"
"66","000","00","008","0835","0937","818","655","163","55","873","1461","0","59.75","44.83"
"66","000","00","008","0836","0000","1910","1501","409","96","2006","3663","0","54.76","40.98"
"66","000","00","008","0836","0938","849","689","160","33","882","1769","0","49.86","38.95"
"66","000","00","008","0836","0939","1061","812","249","63","1124","1894","0","59.35","42.87"
"66","000","00","008","0837","0000","3247","2604","643","231","3478","6379","0","54.52","40.82"
"66","000","00","008","0837","0911","733","583","150","49","782","1579","0","49.53","36.92"
"66","000","00","008","0837","0912","803","638","165","82","885","1524","0","58.07","41.86"
"66","000","00","008","0837","0913","863","695","168","53","916","1677","0","54.62","41.44"
"66","000","00","008","0837","0914","848","688","160","47","895","1599","0","55.97","43.03"
"66","000","00","008","0838","0000","2672","2146","526","107","2779","4844","0","57.37","44.3"
"66","000","00","008","0838","0946","862","700","162","41","903","1688","0","53.5","41.47"
"66","000","00","008","0838","0947","826","660","166","28","854","1475","0","57.9","44.75"
"66","000","00","008","0838","0948","984","786","198","38","1022","1681","0","60.8","46.76"
"66","000","00","008","0839","0000","3679","2895","784","165","3844","6576","0","58.45","44.02"
"66","000","00","008","0839","0920","925","753","172","41","966","1760","0","54.89","42.78"
"66","000","00","008","0839","0921","924","727","197","66","990","1699","0","58.27","42.79"
"66","000","00","008","0839","0922","962","749","213","50","1012","1626","0","62.24","46.06"
"66","000","00","008","0839","0923","868","666","202","8","876","1491","0","58.75","44.67"
"66","000","00","008","0840","0000","2386","1871","515","172","2558","4436","0","57.66","42.18"
"66","000","00","008","0840","0927","816","655","161","32","848","1559","0","54.39","42.01"
"66","000","00","008","0840","0928","804","640","164","77","881","1480","0","59.53","43.24"
"66","000","00","008","0840","0929","766","576","190","63","829","1397","0","59.34","41.23"
"66","000","00","008","0841","0000","3112","2537","575","204","3316","5762","0","57.55","44.03"
"66","000","00","008","0841","0856","952","763","189","64","1016","1923","0","52.83","39.68"
"66","000","00","008","0841","0857","840","688","152","64","904","1641","0","55.09","41.93"
"66","000","00","008","0841","0858","696","572","124","36","732","1157","0","63.27","49.44"
"66","000","00","008","0841","0859","624","514","110","40","664","1041","0","63.78","49.38"
"66","000","00","008","0842","0000","2247","1824","423","131","2378","3915","0","60.74","46.59"
"66","000","00","008","0842","0974","1121","915","206","73","1194","1907","0","62.61","47.98"
"66","000","00","008","0842","0975","1126","909","217","58","1184","2008","0","58.96","45.27"
"66","000","00","009","0000","0000","76229","60188","16041","5127","81356","136658","166867","59.53","44.04"
"66","000","00","009","0901","0000","1238","941","297","96","1334","2292","0","58.2","41.06"
"66","000","00","009","0901","0394","506","402","104","50","556","983","0","56.56","40.9"
"66","000","00","009","0901","0395","732","539","193","46","778","1309","0","59.43","41.18"
"66","000","00","009","0902","0000","557","423","134","44","601","945","0","63.6","44.76"
"66","000","00","009","0902","0397","557","423","134","44","601","945","0","63.6","44.76"
"66","000","00","009","0903","0000","489","364","125","63","552","850","0","64.94","42.82"
"66","000","00","009","0903","0398","489","364","125","63","552","850","0","64.94","42.82"
"66","000","00","009","0904","0000","642","465","177","53","695","1116","0","62.28","41.67"
"66","000","00","009","0904","0396","642","465","177","53","695","1116","0","62.28","41.67"
"66","000","00","009","0905","0000","453","362","91","35","488","760","0","64.21","47.63"
"66","000","00","009","0905","0399","453","362","91","35","488","760","0","64.21","47.63"
"66","000","00","009","0906","0000","488","364","124","46","534","759","0","70.36","47.96"
"66","000","00","009","0906","0419","488","364","124","46","534","759","0","70.36","47.96"
"66","000","00","009","0907","0000","380","266","114","42","422","642","0","65.73","41.43"
"66","000","00","009","0907","0420","380","266","114","42","422","642","0","65.73","41.43"
"66","000","00","009","0908","0000","875","665","210","38","913","1647","0","55.43","40.38"
"66","000","00","009","0908","0415","875","665","210","38","913","1647","0","55.43","40.38"
"66","000","00","009","0909","0000","2938","2334","604","175","3113","4979","0","62.52","46.88"
"66","000","00","009","0909","0421","865","664","201","34","899","1528","0","58.84","43.46"
"66","000","00","009","0909","0422","1072","855","217","65","1137","1788","0","63.59","47.82"
"66","000","00","009","0909","0423","1001","815","186","76","1077","1663","0","64.76","49.01"
"66","000","00","009","0910","0000","1295","1035","260","92","1387","2162","0","64.15","47.87"
"66","000","00","009","0910","0424","810","646","164","59","869","1260","0","68.97","51.27"
"66","000","00","009","0910","0425","485","389","96","33","518","902","0","57.43","43.13"
"66","000","00","009","0911","0000","855","642","213","56","911","1457","0","62.53","44.06"
"66","000","00","009","0911","0437","855","642","213","56","911","1457","0","62.53","44.06"
"66","000","00","009","0912","0000","689","521","168","44","733","1184","0","61.91","44.0"
"66","000","00","009","0912","0438","689","521","168","44","733","1184","0","61.91","44.0"
"66","000","00","009","0913","0000","1344","1008","336","84","1428","2507","0","56.96","40.21"
"66","000","00","009","0913","0403","611","435","176","49","660","1145","0","57.64","37.99"
"66","000","00","009","0913","0404","733","573","160","35","768","1362","0","56.39","42.07"
"66","000","00","009","0914","0000","1688","1339","349","90","1778","2919","0","60.91","45.87"
"66","000","00","009","0914","0405","793","641","152","44","837","1389","0","60.26","46.15"
"66","000","00","009","0914","0406","895","698","197","46","941","1530","0","61.5","45.62"
"66","000","00","009","0915","0000","2194","1705","489","228","2422","4043","0","59.91","42.17"
"66","000","00","009","0915","0407","794","619","175","89","883","1471","0","60.03","42.08"
"66","000","00","009","0915","0408","786","608","178","81","867","1410","0","61.49","43.12"
"66","000","00","009","0915","0409","614","478","136","58","672","1162","0","57.83","41.14"
"66","000","00","009","0916","0000","4981","3978","1003","256","5237","8802","0","59.5","45.19"
"66","000","00","009","0916","0410","895","701","194","40","935","1656","0","56.46","42.33"
"66","000","00","009","0916","0411","995","816","179","49","1044","1838","0","56.8","44.4"
"66","000","00","009","0916","0412","891","696","195","56","947","1666","0","56.84","41.78"
"66","000","00","009","0916","0413","1054","847","207","45","1099","1821","0","60.35","46.51"
"66","000","00","009","0916","0414","1146","918","228","66","1212","1821","0","66.56","50.41"
"66","000","00","009","0917","0000","760","597","163","78","838","1256","0","66.72","47.53"
"66","000","00","009","0917","0416","760","597","163","78","838","1256","0","66.72","47.53"
"66","000","00","009","0918","0000","1931","1528","403","113","2044","3345","0","61.11","45.68"
"66","000","00","009","0918","0417","937","733","204","61","998","1552","0","64.3","47.23"
"66","000","00","009","0918","0418","994","795","199","52","1046","1793","0","58.34","44.34"
"66","000","00","009","0919","0000","5286","4224","1062","391","5677","9838","0","57.7","42.94"
"66","000","00","009","0919","0428","1028","824","204","76","1104","1873","0","58.94","43.99"
"66","000","00","009","0919","0429","993","826","167","70","1063","1867","0","56.94","44.24"
"66","000","00","009","0919","0430","970","756","214","90","1060","1823","0","58.15","41.47"
"66","000","00","009","0919","0431","967","759","208","67","1034","1962","0","52.7","38.69"
"66","000","00","009","0919","0432","1328","1059","269","88","1416","2313","0","61.22","45.78"
"66","000","00","009","0920","0000","3584","2850","734","234","3818","6232","0","61.26","45.73"
"66","000","00","009","0920","0433","872","687","185","63","935","1510","0","61.92","45.5"
"66","000","00","009","0920","0434","1040","842","198","61","1101","1824","0","60.36","46.16"
"66","000","00","009","0920","0435","763","600","163","48","811","1363","0","59.5","44.02"
"66","000","00","009","0920","0436","909","721","188","62","971","1535","0","63.26","46.97"
"66","000","00","009","0921","0000","1630","1309","321","65","1695","2949","0","57.48","44.39"
"66","000","00","009","0921","0426","704","571","133","25","729","1357","0","53.72","42.08"
"66","000","00","009","0921","0427","926","738","188","40","966","1592","0","60.68","46.36"
"66","000","00","009","0922","0000","3223","2582","641","186","3409","6306","0","54.06","40.95"
"66","000","00","009","0922","0439","1055","838","217","63","1118","2299","0","48.63","36.45"
"66","000","00","009","0922","0440","1074","863","211","79","1153","1940","0","59.43","44.48"
"66","000","00","009","0922","0441","1094","881","213","44","1138","2067","0","55.06","42.62"
"66","000","00","009","0923","0000","5093","4159","934","442","5535","10123","0","54.68","41.08"
"66","000","00","009","0923","0442","1065","831","234","88","1153","2038","0","56.58","40.78"
"66","000","00","009","0923","0443","682","676","6","67","749","1835","0","40.82","36.84"
"66","000","00","009","0923","0444","1080","845","235","95","1175","1979","0","59.37","42.7"
"66","000","00","009","0923","0445","1049","859","190","94","1143","2014","0","56.75","42.65"
"66","000","00","009","0923","0446","1217","948","269","98","1315","2257","0","58.26","42.0"
"66","000","00","009","0924","0000","2678","2124","554","176","2854","4596","0","62.1","46.21"
"66","000","00","009","0924","0447","821","624","197","66","887","1406","0","63.09","44.38"
"66","000","00","009","0924","0448","802","648","154","51","853","1418","0","60.16","45.7"
"66","000","00","009","0924","0449","1055","852","203","59","1114","1772","0","62.87","48.08"
"66","000","00","009","0925","0000","6010","4838","1172","351","6361","10381","0","61.28","46.6"
"66","000","00","009","0925","0452","1003","785","218","80","1083","1758","0","61.6","44.65"
"66","000","00","009","0925","0453","938","753","185","57","995","1546","0","64.36","48.71"
"66","000","00","009","0925","0454","1070","886","184","53","1123","1815","0","61.87","48.82"
"66","000","00","009","0925","0455","1093","867","226","62","1155","1932","0","59.78","44.88"
"66","000","00","009","0925","0456","1084","878","206","54","1138","1770","0","64.29","49.6"
"66","000","00","009","0925","0457","822","669","153","45","867","1560","0","55.58","42.88"
"66","000","00","009","0926","0000","1578","1249","329","78","1656","2649","0","62.51","47.15"
"66","000","00","009","0926","0450","724","553","171","38","762","1202","0","63.39","46.01"
"66","000","00","009","0926","0451","854","696","158","40","894","1447","0","61.78","48.1"
"66","000","00","009","0927","0000","7216","5712","1504","521","7737","13032","0","59.37","43.83"
"66","000","00","009","0927","0458","1003","805","198","42","1045","1810","0","57.73","44.48"
"66","000","00","009","0927","0459","986","797","189","49","1035","1653","0","62.61","48.22"
"66","000","00","009","0927","0460","800","648","152","61","861","1444","0","59.63","44.88"
"66","000","00","009","0927","0461","790","637","153","47","837","1318","0","63.51","48.33"
"66","000","00","009","0927","0462","865","670","195","83","948","1566","0","60.54","42.78"
"66","000","00","009","0927","0463","955","754","201","65","1020","1748","0","58.35","43.14"
"66","000","00","009","0927","0464","892","686","206","87","979","1772","0","55.25","38.71"
"66","000","00","009","0927","0465","925","715","210","87","1012","1721","0","58.8","41.55"
"66","000","00","009","0928","0000","2797","2249","548","109","2906","5065","0","57.37","44.4"
"66","000","00","009","0928","0400","895","706","189","9","904","1617","0","55.91","43.66"
"66","000","00","009","0928","0401","825","675","150","59","884","1677","0","52.71","40.25"
"66","000","00","009","0928","0402","1077","868","209","41","1118","1771","0","63.13","49.01"
"66","000","00","009","0929","0000","893","689","204","55","948","1578","0","60.08","43.66"
"66","000","00","009","0929","0466","893","689","204","55","948","1578","0","60.08","43.66"
"66","000","00","009","0930","0000","2854","2181","673","187","3041","5227","0","58.18","41.73"
"66","000","00","009","0930","0467","985","727","258","81","1066","1859","0","57.34","39.11"
"66","000","00","009","0930","0468","825","632","193","51","876","1479","0","59.23","42.73"
"66","000","00","009","0930","0469","1044","822","222","55","1099","1889","0","58.18","43.52"
"66","000","00","009","0931","0000","1738","1360","378","111","1849","3224","0","57.35","42.18"
"66","000","00","009","0931","0470","988","789","199","45","1033","1803","0","57.29","43.76"
"66","000","00","009","0931","0471","750","571","179","66","816","1421","0","57.42","40.18"
"66","000","00","009","0932","0000","1945","1541","404","165","2110","3359","0","62.82","45.88"
"66","000","00","009","0932","0472","917","720","197","83","1000","1585","0","63.09","45.43"
"66","000","00","009","0932","0473","1028","821","207","82","1110","1774","0","62.57","46.28"
"66","000","00","009","0933","0000","1181","942","239","74","1255","2132","0","58.86","44.18"
"66","000","00","009","0933","0474","1181","942","239","74","1255","2132","0","58.86","44.18"
"66","000","00","009","0934","0000","1525","1203","322","85","1610","2874","0","56.02","41.86"
"66","000","00","009","0934","0475","846","655","191","59","905","1515","0","59.74","43.23"
"66","000","00","009","0934","0476","679","548","131","26","705","1359","0","51.88","40.32"
"66","000","00","009","0935","0000","1198","877","321","107","1305","2082","0","62.68","42.12"
"66","000","00","009","0935","0477","545","390","155","50","595","948","0","62.76","41.14"
"66","000","00","009","0935","0478","653","487","166","57","710","1134","0","62.61","42.95"
"66","000","00","009","0936","0000","2003","1562","441","157","2160","3346","0","64.55","46.68"
"66","000","00","009","0936","0479","693","545","148","56","749","1114","0","67.24","48.92"
"66","000","00","009","0936","0480","587","438","149","50","637","1050","0","60.67","41.71"
"66","000","00","009","0936","0481","723","579","144","51","774","1182","0","65.48","48.98"
"66","000","00","010","0000","0000","22891","18187","4704","2135","25026","43181","50308","57.96","42.12"
"66","000","00","010","1001","0000","792","643","149","70","862","1357","0","63.52","47.38"
"66","000","00","010","1001","1540","792","643","149","70","862","1357","0","63.52","47.38"
"66","000","00","010","1002","0000","517","431","86","58","575","865","0","66.47","49.83"
"66","000","00","010","1002","1539","517","431","86","58","575","865","0","66.47","49.83"
"66","000","00","010","1003","0000","534","429","105","102","636","1031","0","61.69","41.61"
"66","000","00","010","1003","1538","534","429","105","102","636","1031","0","61.69","41.61"
"66","000","00","010","1004","0000","1093","906","187","77","1170","1850","0","63.24","48.97"
"66","000","00","010","1004","1536","548","442","106","35","583","984","0","59.25","44.92"
"66","000","00","010","1004","1537","545","464","81","42","587","866","0","67.78","53.58"
"66","000","00","010","1005","0000","1232","986","246","149","1381","2196","0","62.89","44.9"
"66","000","00","010","1005","1534","651","513","138","88","739","1169","0","63.22","43.88"
"66","000","00","010","1005","1535","581","473","108","61","642","1027","0","62.51","46.06"
"66","000","00","010","1006","0000","563","435","128","24","587","977","0","60.08","44.52"
"66","000","00","010","1006","1532","563","435","128","24","587","977","0","60.08","44.52"
"66","000","00","010","1007","0000","710","597","113","50","760","1395","0","54.48","42.8"
"66","000","00","010","1007","1533","710","597","113","50","760","1395","0","54.48","42.8"
"66","000","00","010","1008","0000","1982","1569","413","132","2114","3486","0","60.64","45.01"
"66","000","00","010","1008","1529","652","528","124","28","680","1222","0","55.65","43.21"
"66","000","00","010","1008","1530","739","573","166","70","809","1228","0","65.88","46.66"
"66","000","00","010","1008","1531","591","468","123","34","625","1036","0","60.33","45.17"
"66","000","00","010","1009","0000","940","766","174","95","1035","1878","0","55.11","40.79"
"66","000","00","010","1009","1527","444","374","70","24","468","872","0","53.67","42.89"
"66","000","00","010","1009","1528","496","392","104","71","567","1006","0","56.36","38.97"
"66","000","00","010","1010","0000","2003","1638","365","178","2181","3662","0","59.56","44.73"
"66","000","00","010","1010","1523","770","632","138","55","825","1372","0","60.13","46.06"
"66","000","00","010","1010","1524","796","645","151","43","839","1412","0","59.42","45.68"
"66","000","00","010","1010","1525","437","361","76","80","517","878","0","58.88","41.12"
"66","000","00","010","1011","0000","663","511","152","87","750","1475","0","50.85","34.64"
"66","000","00","010","1011","1526","663","511","152","87","750","1475","0","50.85","34.64"
"66","000","00","010","1012","0000","2671","2102","569","212","2883","4908","0","58.74","42.83"
"66","000","00","010","1012","1519","643","493","150","56","699","1335","0","52.36","36.93"
"66","000","00","010","1012","1520","652","516","136","47","699","1092","0","64.01","47.25"
"66","000","00","010","1012","1521","620","488","132","49","669","1050","0","63.71","46.48"
"66","000","00","010","1012","1522","756","605","151","60","816","1431","0","57.02","42.28"
"66","000","00","010","1013","0000","798","638","160","113","911","1628","0","55.96","39.19"
"66","000","00","010","1013","1518","798","638","160","113","911","1628","0","55.96","39.19"
"66","000","00","010","1014","0000","562","432","130","86","648","991","0","65.39","43.59"
"66","000","00","010","1014","1516","562","432","130","86","648","991","0","65.39","43.59"
"66","000","00","010","1015","0000","413","340","73","25","438","863","0","50.75","39.4"
"66","000","00","010","1015","1517","413","340","73","25","438","863","0","50.75","39.4"
"66","000","00","010","1016","0000","927","709","218","115","1042","1866","0","55.84","38.0"
"66","000","00","010","1016","1514","508","386","122","55","563","1007","0","55.91","38.33"
"66","000","00","010","1016","1515","419","323","96","60","479","859","0","55.76","37.6"
"66","000","00","010","1017","0000","652","524","128","70","722","1299","0","55.58","40.34"
"66","000","00","010","1017","1513","652","524","128","70","722","1299","0","55.58","40.34"
"66","000","00","010","1018","0000","1120","905","215","80","1200","1957","0","61.32","46.24"
"66","000","00","010","1018","1544","540","442","98","35","575","950","0","60.53","46.53"
"66","000","00","010","1018","1545","580","463","117","45","625","1007","0","62.07","45.98"
"66","000","00","010","1019","0000","1134","910","224","87","1221","2050","0","59.56","44.39"
"66","000","00","010","1019","1541","421","344","77","30","451","736","0","61.28","46.74"
"66","000","00","010","1019","1542","713","566","147","57","770","1314","0","58.6","43.07"
"66","000","00","010","1020","0000","799","608","191","109","908","1677","0","54.14","36.26"
"66","000","00","010","1020","1543","799","608","191","109","908","1677","0","54.14","36.26"
"66","000","00","010","1021","0000","565","388","177","55","620","1214","0","51.07","31.96"
"66","000","00","010","1021","1546","565","388","177","55","620","1214","0","51.07","31.96"
"66","000","00","010","1022","0000","937","733","204","78","1015","1809","0","56.11","40.52"
"66","000","00","010","1022","1547","485","367","118","32","517","907","0","57.0","40.46"
"66","000","00","010","1022","1548","452","366","86","46","498","902","0","55.21","40.58"
"66","000","00","010","1023","0000","307","231","76","12","319","720","0","44.31","32.08"
"66","000","00","010","1023","1549","307","231","76","12","319","720","0","44.31","32.08"
"66","000","00","010","1024","0000","293","219","74","12","305","666","0","45.8","32.88"
"66","000","00","010","1024","1550","293","219","74","12","305","666","0","45.8","32.88"
"66","000","00","010","1025","0000","684","537","147","59","743","1361","0","54.59","39.46"
"66","000","00","010","1025","1551","684","537","147","59","743","1361","0","54.59","39.46"
"66","000","00","011","0000","0000","33181","26358","6823","2601","35782","63069","77697","56.73","41.79"
"66","000","00","011","1101","0000","726","592","134","79","805","1356","0","59.37","43.66"
"66","000","00","011","1101","0001","726","592","134","79","805","1356","0","59.37","43.66"
"66","000","00","011","1102","0000","619","496","123","41","660","1059","0","62.32","46.84"
"66","000","00","011","1102","0002","619","496","123","41","660","1059","0","62.32","46.84"
"66","000","00","011","1103","0000","886","660","226","71","957","1568","0","61.03","42.09"
"66","000","00","011","1103","0003","400","295","105","41","441","694","0","63.54","42.51"
"66","000","00","011","1103","0004","486","365","121","30","516","874","0","59.04","41.76"
"66","000","00","011","1104","0000","408","315","93","21","429","763","0","56.23","41.28"
"66","000","00","011","1104","0005","408","315","93","21","429","763","0","56.23","41.28"
"66","000","00","011","1105","0000","1191","959","232","85","1276","2105","0","60.62","45.56"
"66","000","00","011","1105","0006","504","402","102","43","547","856","0","63.9","46.96"
"66","000","00","011","1105","0007","687","557","130","42","729","1249","0","58.37","44.6"
"66","000","00","011","1106","0000","1114","865","249","79","1193","2111","0","56.51","40.98"
"66","000","00","011","1106","0008","466","363","103","32","498","922","0","54.01","39.37"
"66","000","00","011","1106","0009","648","502","146","47","695","1189","0","58.45","42.22"
"66","000","00","011","1107","0000","1893","1513","380","194","2087","3374","0","61.86","44.84"
"66","000","00","011","1107","0010","616","503","113","67","683","1065","0","64.13","47.23"
"66","000","00","011","1107","0011","721","578","143","80","801","1252","0","63.98","46.17"
"66","000","00","011","1107","0012","556","432","124","47","603","1057","0","57.05","40.87"
"66","000","00","011","1108","0000","1179","920","259","76","1255","2091","0","60.02","44.0"
"66","000","00","011","1108","0013","560","447","113","28","588","1031","0","57.03","43.36"
"66","000","00","011","1108","0014","619","473","146","48","667","1060","0","62.92","44.62"
"66","000","00","011","1109","0000","2299","1932","367","165","2464","4405","0","55.94","43.86"
"66","000","00","011","1109","0015","711","566","145","55","766","1311","0","58.43","43.17"
"66","000","00","011","1109","0016","767","624","143","53","820","1424","0","57.58","43.82"
"66","000","00","011","1109","0017","821","742","79","57","878","1670","0","52.57","44.43"
"66","000","00","011","1110","0000","430","346","84","46","476","812","0","58.62","42.61"
"66","000","00","011","1110","0018","430","346","84","46","476","812","0","58.62","42.61"
"66","000","00","011","1111","0000","477","386","91","30","507","863","0","58.75","44.73"
"66","000","00","011","1111","0019","477","386","91","30","507","863","0","58.75","44.73"
"66","000","00","011","1112","0000","1756","1421","335","92","1848","3186","0","58.0","44.6"
"66","000","00","011","1112","0020","904","714","190","44","948","1598","0","59.32","44.68"
"66","000","00","011","1112","0021","852","707","145","48","900","1588","0","56.68","44.52"
"66","000","00","011","1113","0000","639","512","127","55","694","1197","0","57.98","42.77"
"66","000","00","011","1113","0022","639","512","127","55","694","1197","0","57.98","42.77"
"66","000","00","011","1114","0000","522","385","137","90","612","1106","0","55.33","34.81"
"66","000","00","011","1114","0023","522","385","137","90","612","1106","0","55.33","34.81"
"66","000","00","011","1115","0000","1016","807","209","92","1108","1772","0","62.53","45.54"
"66","000","00","011","1115","0024","517","413","104","50","567","903","0","62.79","45.74"
"66","000","00","011","1115","0025","499","394","105","42","541","869","0","62.26","45.34"
"66","000","00","011","1116","0000","2876","2203","673","214","3090","5269","0","58.64","41.81"
"66","000","00","011","1116","0026","738","544","194","36","774","1350","0","57.33","40.3"
"66","000","00","011","1116","0027","596","463","133","92","688","1144","0","60.14","40.47"
"66","000","00","011","1116","0028","683","533","150","49","732","1208","0","60.6","44.12"
"66","000","00","011","1116","0029","859","663","196","37","896","1567","0","57.18","42.31"
"66","000","00","011","1117","0000","1229","999","230","73","1302","2013","0","64.68","49.63"
"66","000","00","011","1117","0030","750","611","139","36","786","1246","0","63.08","49.04"
"66","000","00","011","1117","0031","479","388","91","37","516","767","0","67.28","50.59"
"66","000","00","011","1118","0000","976","796","180","84","1060","1762","0","60.16","45.18"
"66","000","00","011","1118","0032","433","332","101","47","480","790","0","60.76","42.03"
"66","000","00","011","1118","0033","543","464","79","37","580","972","0","59.67","47.74"
"66","000","00","011","1119","0000","708","561","147","56","764","1388","0","55.04","40.42"
"66","000","00","011","1119","0034","708","561","147","56","764","1388","0","55.04","40.42"
"66","000","00","011","1120","0000","2384","1906","478","134","2518","4432","0","56.81","43.01"
"66","000","00","011","1120","0035","660","523","137","41","701","1331","0","52.67","39.29"
"66","000","00","011","1120","0036","680","547","133","43","723","1167","0","61.95","46.87"
"66","000","00","011","1120","0037","1044","836","208","50","1094","1934","0","56.57","43.23"
"66","000","00","011","1121","0000","605","477","128","49","654","1263","0","51.78","37.77"
"66","000","00","011","1121","0038","605","477","128","49","654","1263","0","51.78","37.77"
"66","000","00","011","1122","0000","1995","1559","436","129","2124","3973","0","53.46","39.24"
"66","000","00","011","1122","0039","743","583","160","50","793","1390","0","57.05","41.94"
"66","000","00","011","1122","0040","520","406","114","40","560","1186","0","47.22","34.23"
"66","000","00","011","1122","0041","732","570","162","39","771","1397","0","55.19","40.8"
"66","000","00","011","1123","0000","1162","917","245","106","1268","2571","0","49.32","35.67"
"66","000","00","011","1123","0042","476","389","87","20","496","1173","0","42.28","33.16"
"66","000","00","011","1123","0043","686","528","158","86","772","1398","0","55.22","37.77"
"66","000","00","011","1124","0000","2660","2148","512","181","2841","5453","0","52.1","39.39"
"66","000","00","011","1124","0044","590","456","134","49","639","1228","0","52.04","37.13"
"66","000","00","011","1124","0045","628","487","141","53","681","1258","0","54.13","38.71"
"66","000","00","011","1124","0046","656","609","47","29","685","1435","0","47.74","42.44"
"66","000","00","011","1124","0047","786","596","190","50","836","1532","0","54.57","38.9"
"66","000","00","011","1125","0000","725","581","144","75","800","1522","0","52.56","38.17"
"66","000","00","011","1125","0048","335","280","55","41","376","652","0","57.67","42.94"
"66","000","00","011","1125","0049","390","301","89","34","424","870","0","48.74","34.6"
"66","000","00","011","1126","0000","849","635","214","62","911","1675","0","54.39","37.91"
"66","000","00","011","1126","0050","427","328","99","31","458","891","0","51.4","36.81"
"66","000","00","011","1126","0051","422","307","115","31","453","784","0","57.78","39.16"
"66","000","00","011","1127","0000","656","532","124","88","744","1368","0","54.39","38.89"
"66","000","00","011","1127","0052","656","532","124","88","744","1368","0","54.39","38.89"
"66","000","00","011","1128","0000","550","437","113","53","603","1126","0","53.55","38.81"
"66","000","00","011","1128","0053","550","437","113","53","603","1126","0","53.55","38.81"
"66","000","00","011","1129","0000","651","498","153","81","732","1486","0","49.26","33.51"
"66","000","00","011","1129","0054","651","498","153","81","732","1486","0","49.26","33.51"
"66","000","00","012","0000","0000","38771","30691","8080","3018","41789","71528","86659","58.42","42.91"
"66","000","00","012","1201","0000","551","430","121","30","581","1076","0","54.0","39.96"
"66","000","00","012","1201","0091","551","430","121","30","581","1076","0","54.0","39.96"
"66","000","00","012","1202","0000","575","448","127","50","625","953","0","65.58","47.01"
"66","000","00","012","1202","0092","575","448","127","50","625","953","0","65.58","47.01"
"66","000","00","012","1203","0000","1189","935","254","108","1297","2057","0","63.05","45.45"
"66","000","00","012","1203","0093","513","384","129","54","567","914","0","62.04","42.01"
"66","000","00","012","1203","0094","676","551","125","54","730","1143","0","63.87","48.21"
"66","000","00","012","1204","0000","399","303","96","26","425","680","0","62.5","44.56"
"66","000","00","012","1204","0095","399","303","96","26","425","680","0","62.5","44.56"
"66","000","00","012","1205","0000","1052","832","220","85","1137","1797","0","63.27","46.3"
"66","000","00","012","1205","0096","524","419","105","38","562","904","0","62.17","46.35"
"66","000","00","012","1205","0097","528","413","115","47","575","893","0","64.39","46.25"
"66","000","00","012","1206","0000","877","682","195","42","919","1577","0","58.28","43.25"
"66","000","00","012","1206","0098","877","682","195","42","919","1577","0","58.28","43.25"
"66","000","00","012","1207","0000","381","310","71","25","406","690","0","58.84","44.93"
"66","000","00","012","1207","0099","381","310","71","25","406","690","0","58.84","44.93"
"66","000","00","012","1208","0000","220","169","51","26","246","403","0","61.04","41.94"
"66","000","00","012","1208","0100","220","169","51","26","246","403","0","61.04","41.94"
"66","000","00","012","1209","0000","1184","918","266","115","1299","2190","0","59.32","41.92"
"66","000","00","012","1209","0101","771","609","162","70","841","1413","0","59.52","43.1"
"66","000","00","012","1209","0102","413","309","104","45","458","777","0","58.94","39.77"
"66","000","00","012","1210","0000","5296","4274","1022","281","5577","9237","0","60.38","46.27"
"66","000","00","012","1210","0103","737","592","145","50","787","1313","0","59.94","45.09"
"66","000","00","012","1210","0104","822","579","243","51","873","1439","0","60.67","40.24"
"66","000","00","012","1210","0105","653","527","126","27","680","1265","0","53.75","41.66"
"66","000","00","012","1210","0106","759","626","133","40","799","1277","0","62.57","49.02"
"66","000","00","012","1210","0107","718","612","106","49","767","1276","0","60.11","47.96"
"66","000","00","012","1210","0108","829","688","141","37","866","1376","0","62.94","50.0"
"66","000","00","012","1210","0109","778","650","128","27","805","1291","0","62.35","50.35"
"66","000","00","012","1211","0000","858","669","189","61","919","1510","0","60.86","44.3"
"66","000","00","012","1211","0110","858","669","189","61","919","1510","0","60.86","44.3"
"66","000","00","012","1212","0000","834","764","70","74","908","1524","0","59.58","50.13"
"66","000","00","012","1212","0111","834","764","70","74","908","1524","0","59.58","50.13"
"66","000","00","012","1213","0000","2343","1891","452","161","2504","4302","0","58.21","43.96"
"66","000","00","012","1213","0112","747","602","145","36","783","1474","0","53.12","40.84"
"66","000","00","012","1213","0113","807","661","146","53","860","1507","0","57.07","43.86"
"66","000","00","012","1213","0114","789","628","161","72","861","1321","0","65.18","47.54"
"66","000","00","012","1214","0000","1738","1367","371","115","1853","3293","0","56.27","41.51"
"66","000","00","012","1214","0115","570","437","133","36","606","1157","0","52.38","37.77"
"66","000","00","012","1214","0116","706","583","123","44","750","1255","0","59.76","46.45"
"66","000","00","012","1214","0117","462","347","115","35","497","881","0","56.41","39.39"
"66","000","00","012","1215","0000","1164","944","220","83","1247","2034","0","61.31","46.41"
"66","000","00","012","1215","0118","617","507","110","52","669","1083","0","61.77","46.81"
"66","000","00","012","1215","0119","547","437","110","31","578","951","0","60.78","45.95"
"66","000","00","012","1216","0000","2650","2090","560","210","2860","5145","0","55.59","40.62"
"66","000","00","012","1216","0120","740","587","153","41","781","1424","0","54.85","41.22"
"66","000","00","012","1216","0121","610","455","155","65","675","1233","0","54.74","36.9"
"66","000","00","012","1216","0122","574","448","126","54","628","1288","0","48.76","34.78"
"66","000","00","012","1216","0123","726","600","126","50","776","1200","0","64.67","50.0"
"66","000","00","012","1217","0000","1600","1329","271","67","1667","2745","0","60.73","48.42"
"66","000","00","012","1217","0124","914","782","132","45","959","1609","0","59.6","48.6"
"66","000","00","012","1217","0125","686","547","139","22","708","1136","0","62.32","48.15"
"66","000","00","012","1218","0000","667","526","141","56","723","1302","0","55.53","40.4"
"66","000","00","012","1218","0126","667","526","141","56","723","1302","0","55.53","40.4"
"66","000","00","012","1219","0000","697","538","159","71","768","1373","0","55.94","39.18"
"66","000","00","012","1219","0127","697","538","159","71","768","1373","0","55.94","39.18"
"66","000","00","012","1220","0000","587","443","144","69","656","1257","0","52.19","35.24"
"66","000","00","012","1220","0128","587","443","144","69","656","1257","0","52.19","35.24"
"66","000","00","012","1221","0000","551","449","102","64","615","1184","0","51.94","37.92"
"66","000","00","012","1221","0129","551","449","102","64","615","1184","0","51.94","37.92"
"66","000","00","012","1222","0000","687","554","133","62","749","1322","0","56.66","41.91"
"66","000","00","012","1222","0130","687","554","133","62","749","1322","0","56.66","41.91"
"66","000","00","012","1223","0000","1057","805","252","117","1174","2120","0","55.38","37.97"
"66","000","00","012","1223","0131","582","448","134","50","632","1193","0","52.98","37.55"
"66","000","00","012","1223","0132","475","357","118","67","542","927","0","58.47","38.51"
"66","000","00","012","1224","0000","1269","963","306","118","1387","2236","0","62.03","43.07"
"66","000","00","012","1224","0133","619","469","150","50","669","1073","0","62.35","43.71"
"66","000","00","012","1224","0134","650","494","156","68","718","1163","0","61.74","42.48"
"66","000","00","012","1225","0000","863","643","220","118","981","1757","0","55.83","36.6"
"66","000","00","012","1225","0135","425","319","106","52","477","855","0","55.79","37.31"
"66","000","00","012","1225","0136","438","324","114","66","504","902","0","55.88","35.92"
"66","000","00","012","1226","0000","1300","1024","276","94","1394","2481","0","56.19","41.27"
"66","000","00","012","1226","0137","757","605","152","59","816","1415","0","57.67","42.76"
"66","000","00","012","1226","0138","543","419","124","35","578","1066","0","54.22","39.31"
"66","000","00","012","1227","0000","3871","3110","761","277","4148","7264","0","57.1","42.81"
"66","000","00","012","1227","0139","715","555","160","68","783","1391","0","56.29","39.9"
"66","000","00","012","1227","0140","720","593","127","43","763","1449","0","52.66","40.92"
"66","000","00","012","1227","0141","763","598","165","63","826","1377","0","59.99","43.43"
"66","000","00","012","1227","0142","781","640","141","59","840","1423","0","59.03","44.98"
"66","000","00","012","1227","0143","892","724","168","44","936","1624","0","57.64","44.58"
"66","000","00","012","1228","0000","1434","945","489","174","1608","2822","0","56.98","33.49"
"66","000","00","012","1228","0144","683","327","356","72","755","1358","0","55.6","24.08"
"66","000","00","012","1228","0145","751","618","133","102","853","1464","0","58.27","42.21"
"66","000","00","012","1229","0000","679","523","156","68","747","1211","0","61.68","43.19"
"66","000","00","012","1229","0146","679","523","156","68","747","1211","0","61.68","43.19"
"66","000","00","012","1230","0000","644","538","106","83","727","1162","0","62.56","46.3"
"66","000","00","012","1230","0148","644","538","106","83","727","1162","0","62.56","46.3"
"66","000","00","012","1231","0000","822","682","140","60","882","1368","0","64.47","49.85"
"66","000","00","012","1231","0149","822","682","140","60","882","1368","0","64.47","49.85"
"66","000","00","012","1232","0000","732","593","139","28","760","1456","0","52.2","40.73"
"66","000","00","012","1232","0147","732","593","139","28","760","1456","0","52.2","40.73"
"66","000","00","013","0000","0000","39319","31524","7795","2682","42001","74207","93720","56.6","42.48"
"66","000","00","013","1301","0000","700","677","23","38","738","1380","0","53.48","49.06"
"66","000","00","013","1301","0186","700","677","23","38","738","1380","0","53.48","49.06"
"66","000","00","013","1302","0000","1162","935","227","81","1243","2028","0","61.29","46.1"
"66","000","00","013","1302","0187","479","371","108","41","520","852","0","61.03","43.54"
"66","000","00","013","1302","0188","683","564","119","40","723","1176","0","61.48","47.96"
"66","000","00","013","1303","0000","580","414","166","67","647","958","0","67.54","43.22"
"66","000","00","013","1303","0189","580","414","166","67","647","958","0","67.54","43.22"
"66","000","00","013","1304","0000","309","241","68","30","339","488","0","69.47","49.39"
"66","000","00","013","1304","0190","309","241","68","30","339","488","0","69.47","49.39"
"66","000","00","013","1305","0000","1331","1017","314","98","1429","2462","0","58.04","41.31"
"66","000","00","013","1305","0191","646","494","152","43","689","1177","0","58.54","41.97"
"66","000","00","013","1305","0192","685","523","162","55","740","1285","0","57.59","40.7"
"66","000","00","013","1306","0000","2365","1893","472","161","2526","4336","0","58.26","43.66"
"66","000","00","013","1306","0195","758","615","143","36","794","1469","0","54.05","41.87"
"66","000","00","013","1306","0196","829","656","173","43","872","1423","0","61.28","46.1"
"66","000","00","013","1306","0197","778","622","156","82","860","1444","0","59.56","43.07"
"66","000","00","013","1307","0000","2724","2201","523","215","2939","5046","0","58.24","43.62"
"66","000","00","013","1307","0198","779","641","138","78","857","1469","0","58.34","43.64"
"66","000","00","013","1307","0199","1008","815","193","89","1097","1902","0","57.68","42.85"
"66","000","00","013","1307","0200","937","745","192","48","985","1675","0","58.81","44.48"
"66","000","00","013","1308","0000","3686","2963","723","277","3963","6728","0","58.9","44.04"
"66","000","00","013","1308","0201","587","444","143","48","635","1098","0","57.83","40.44"
"66","000","00","013","1308","0202","861","659","202","74","935","1539","0","60.75","42.82"
"66","000","00","013","1308","0203","748","595","153","38","786","1329","0","59.14","44.77"
"66","000","00","013","1308","0204","658","523","135","48","706","1255","0","56.25","41.67"
"66","000","00","013","1308","0205","832","742","90","69","901","1507","0","59.79","49.24"
"66","000","00","013","1309","0000","3849","3061","788","339","4188","7300","0","57.37","41.93"
"66","000","00","013","1309","0206","805","604","201","86","891","1463","0","60.9","41.29"
"66","000","00","013","1309","0207","636","509","127","70","706","1279","0","55.2","39.8"
"66","000","00","013","1309","0208","495","405","90","39","534","1024","0","52.15","39.55"
"66","000","00","013","1309","0209","679","565","114","74","753","1388","0","54.25","40.71"
"66","000","00","013","1309","0210","618","477","141","36","654","1074","0","60.89","44.41"
"66","000","00","013","1309","0211","616","501","115","34","650","1072","0","60.63","46.74"
"66","000","00","013","1310","0000","623","505","118","64","687","1107","0","62.06","45.62"
"66","000","00","013","1310","0212","623","505","118","64","687","1107","0","62.06","45.62"
"66","000","00","013","1311","0000","2349","1880","469","156","2505","4771","0","52.5","39.4"
"66","000","00","013","1311","0215","898","728","170","54","952","1633","0","58.3","44.58"
"66","000","00","013","1311","0216","743","595","148","59","802","1533","0","52.32","38.81"
"66","000","00","013","1311","0217","708","557","151","43","751","1605","0","46.79","34.7"
"66","000","00","013","1312","0000","1772","1446","326","115","1887","3629","0","52.0","39.85"
"66","000","00","013","1312","0213","940","775","165","45","985","1947","0","50.59","39.8"
"66","000","00","013","1312","0214","832","671","161","70","902","1682","0","53.63","39.89"
"66","000","00","013","1313","0000","837","674","163","27","864","1694","0","51.0","39.79"
"66","000","00","013","1313","0218","837","674","163","27","864","1694","0","51.0","39.79"
"66","000","00","013","1314","0000","2622","2117","505","122","2744","4944","0","55.5","42.82"
"66","000","00","013","1314","0219","824","666","158","50","874","1628","0","53.69","40.91"
"66","000","00","013","1314","0220","943","771","172","21","964","1665","0","57.9","46.31"
"66","000","00","013","1314","0221","855","680","175","51","906","1651","0","54.88","41.19"
"66","000","00","013","1315","0000","1898","1536","362","78","1976","3289","0","60.08","46.7"
"66","000","00","013","1315","0222","662","531","131","11","673","1108","0","60.74","47.92"
"66","000","00","013","1315","0223","669","548","121","36","705","1142","0","61.73","47.99"
"66","000","00","013","1315","0224","567","457","110","31","598","1039","0","57.56","43.98"
"66","000","00","013","1316","0000","2720","2203","517","171","2891","5270","0","54.86","41.8"
"66","000","00","013","1316","0225","947","780","167","66","1013","1840","0","55.05","42.39"
"66","000","00","013","1316","0226","992","801","191","45","1037","1872","0","55.4","42.79"
"66","000","00","013","1316","0227","781","622","159","60","841","1558","0","53.98","39.92"
"66","000","00","013","1317","0000","2324","1854","470","128","2452","4314","0","56.84","42.98"
"66","000","00","013","1317","0232","859","666","193","46","905","1593","0","56.81","41.81"
"66","000","00","013","1317","0233","497","387","110","28","525","981","0","53.52","39.45"
"66","000","00","013","1317","0234","968","801","167","54","1022","1740","0","58.74","46.03"
"66","000","00","013","1318","0000","1287","1027","260","80","1367","2294","0","59.59","44.77"
"66","000","00","013","1318","0235","703","542","161","60","763","1247","0","61.19","43.46"
"66","000","00","013","1318","0236","584","485","99","20","604","1047","0","57.69","46.32"
"66","000","00","013","1319","0000","1115","874","241","95","1210","2144","0","56.44","40.76"
"66","000","00","013","1319","0237","592","453","139","74","666","1119","0","59.52","40.48"
"66","000","00","013","1319","0238","523","421","102","21","544","1025","0","53.07","41.07"
"66","000","00","013","1320","0000","1773","1343","430","156","1929","3364","0","57.34","39.92"
"66","000","00","013","1320","0193","850","652","198","82","932","1736","0","53.69","37.56"
"66","000","00","013","1320","0194","923","691","232","74","997","1628","0","61.24","42.44"
"66","000","00","013","1321","0000","3293","2663","630","184","3477","6661","0","52.2","39.98"
"66","000","00","013","1321","0228","853","698","155","45","898","1739","0","51.64","40.14"
"66","000","00","013","1321","0229","796","633","163","46","842","1672","0","50.36","37.86"
"66","000","00","013","1321","0230","864","701","163","47","911","1634","0","55.75","42.9"
"66","000","00","013","1321","0231","780","631","149","46","826","1616","0","51.11","39.05"
"66","000","00","014","0000","0000","24871","19604","5267","1888","26759","47040","58189","56.89","41.68"
"66","000","00","014","1401","0000","1636","1170","466","114","1750","3122","0","56.05","37.48"
"66","000","00","014","1401","0150","806","629","177","63","869","1541","0","56.39","40.82"
"66","000","00","014","1401","0151","830","541","289","51","881","1581","0","55.72","34.22"
"66","000","00","014","1402","0000","1089","865","224","75","1164","1959","0","59.42","44.16"
"66","000","00","014","1402","0152","593","464","129","43","636","1083","0","58.73","42.84"
"66","000","00","014","1402","0153","496","401","95","32","528","876","0","60.27","45.78"
"66","000","00","014","1403","0000","2032","1620","412","155","2187","3929","0","55.66","41.23"
"66","000","00","014","1403","0154","549","412","137","69","618","1043","0","59.25","39.5"
"66","000","00","014","1403","0155","747","609","138","33","780","1502","0","51.93","40.55"
"66","000","00","014","1403","0156","736","599","137","53","789","1384","0","57.01","43.28"
"66","000","00","014","1404","0000","313","244","69","32","345","517","0","66.73","47.2"
"66","000","00","014","1404","0157","313","244","69","32","345","517","0","66.73","47.2"
"66","000","00","014","1405","0000","689","574","115","59","748","1169","0","63.99","49.1"
"66","000","00","014","1405","0158","689","574","115","59","748","1169","0","63.99","49.1"
"66","000","00","014","1406","0000","492","363","129","32","524","863","0","60.72","42.06"
"66","000","00","014","1406","0159","492","363","129","32","524","863","0","60.72","42.06"
"66","000","00","014","1407","0000","3173","2395","778","221","3394","6128","0","55.39","39.08"
"66","000","00","014","1407","0160","603","477","126","40","643","1277","0","50.35","37.35"
"66","000","00","014","1407","0161","890","623","267","49","939","1742","0","53.9","35.76"
"66","000","00","014","1407","0162","740","582","158","49","789","1342","0","58.79","43.37"
"66","000","00","014","1407","0163","940","713","227","83","1023","1767","0","57.89","40.35"
"66","000","00","014","1408","0000","2448","1948","500","170","2618","4974","0","52.63","39.16"
"66","000","00","014","1408","0164","726","564","162","56","782","1542","0","50.71","36.58"
"66","000","00","014","1408","0165","850","682","168","47","897","1636","0","54.83","41.69"
"66","000","00","014","1408","0166","872","702","170","67","939","1796","0","52.28","39.09"
"66","000","00","014","1409","0000","2233","1785","448","216","2449","4364","0","56.12","40.9"
"66","000","00","014","1409","0167","740","579","161","57","797","1450","0","54.97","39.93"
"66","000","00","014","1409","0168","727","570","157","122","849","1548","0","54.84","36.82"
"66","000","00","014","1409","0169","766","636","130","37","803","1366","0","58.78","46.56"
"66","000","00","014","1410","0000","4040","3262","778","293","4333","7342","0","59.02","44.43"
"66","000","00","014","1410","0170","571","474","97","41","612","955","0","64.08","49.63"
"66","000","00","014","1410","0171","663","517","146","54","717","1305","0","54.94","39.62"
"66","000","00","014","1410","0172","688","552","136","39","727","1239","0","58.68","44.55"
"66","000","00","014","1410","0173","605","485","120","62","667","1079","0","61.82","44.95"
"66","000","00","014","1410","0174","644","531","113","35","679","1220","0","55.66","43.52"
"66","000","00","014","1410","0175","869","703","166","62","931","1544","0","60.3","45.53"
"66","000","00","014","1411","0000","3012","2387","625","226","3238","5607","0","57.75","42.57"
"66","000","00","014","1411","0176","822","634","188","57","879","1460","0","60.21","43.42"
"66","000","00","014","1411","0177","728","586","142","57","785","1292","0","60.76","45.36"
"66","000","00","014","1411","0178","674","542","132","65","739","1300","0","56.85","41.69"
"66","000","00","014","1411","0179","788","625","163","47","835","1555","0","53.7","40.19"
"66","000","00","014","1412","0000","1229","994","235","110","1339","2308","0","58.02","43.07"
"66","000","00","014","1412","0180","528","421","107","45","573","1031","0","55.58","40.83"
"66","000","00","014","1412","0181","701","573","128","65","766","1277","0","59.98","44.87"
"66","000","00","014","1413","0000","1182","924","258","98","1280","2224","0","57.55","41.55"
"66","000","00","014","1413","0182","534","409","125","41","575","1037","0","55.45","39.44"
"66","000","00","014","1413","0183","648","515","133","57","705","1187","0","59.39","43.39"
"66","000","00","014","1414","0000","1303","1073","230","87","1390","2534","0","54.85","42.34"
"66","000","00","014","1414","0184","710","573","137","42","752","1399","0","53.75","40.96"
"66","000","00","014","1414","0185","593","500","93","45","638","1135","0","56.21","44.05"
"66","000","00","015","0000","0000","24142","18978","5164","1842","25984","44962","54682","57.79","42.21"
"66","000","00","015","1501","0000","1086","853","233","105","1191","1987","0","59.94","42.93"
"66","000","00","015","1501","0357","498","398","100","45","543","852","0","63.73","46.71"
"66","000","00","015","1501","0358","588","455","133","60","648","1135","0","57.09","40.09"
"66","000","00","015","1502","0000","524","406","118","52","576","1079","0","53.38","37.63"
"66","000","00","015","1502","0359","524","406","118","52","576","1079","0","53.38","37.63"
"66","000","00","015","1503","0000","1706","1349","357","129","1835","3130","0","58.63","43.1"
"66","000","00","015","1503","0360","848","680","168","62","910","1539","0","59.13","44.18"
"66","000","00","015","1503","0361","858","669","189","67","925","1591","0","58.14","42.05"
"66","000","00","015","1504","0000","2103","1663","440","187","2290","3701","0","61.88","44.93"
"66","000","00","015","1504","0364","767","619","148","83","850","1428","0","59.52","43.35"
"66","000","00","015","1504","0365","726","581","145","57","783","1178","0","66.47","49.32"
"66","000","00","015","1504","0366","610","463","147","47","657","1095","0","60.0","42.28"
"66","000","00","015","1505","0000","1120","879","241","71","1191","2126","0","56.02","41.35"
"66","000","00","015","1505","0367","508","394","114","25","533","963","0","55.35","40.91"
"66","000","00","015","1505","0368","612","485","127","46","658","1163","0","56.58","41.7"
"66","000","00","015","1506","0000","2656","2159","497","184","2840","4712","0","60.27","45.82"
"66","000","00","015","1506","0369","580","461","119","39","619","1018","0","60.81","45.28"
"66","000","00","015","1506","0370","510","415","95","40","550","854","0","64.4","48.59"
"66","000","00","015","1506","0371","764","614","150","49","813","1485","0","54.75","41.35"
"66","000","00","015","1506","0372","802","669","133","56","858","1355","0","63.32","49.37"
"66","000","00","015","1507","0000","1055","842","213","98","1153","1986","0","58.06","42.4"
"66","000","00","015","1507","0373","416","325","91","50","466","840","0","55.48","38.69"
"66","000","00","015","1507","0374","639","517","122","48","687","1146","0","59.95","45.11"
"66","000","00","015","1508","0000","1900","1293","607","162","2062","3342","0","61.7","38.69"
"66","000","00","015","1508","0375","955","754","201","66","1021","1669","0","61.17","45.18"
"66","000","00","015","1508","0376","945","539","406","96","1041","1673","0","62.22","32.22"
"66","000","00","015","1509","0000","1861","1483","378","134","1995","3454","0","57.76","42.94"
"66","000","00","015","1509","0377","817","661","156","48","865","1493","0","57.94","44.27"
"66","000","00","015","1509","0378","586","458","128","65","651","1052","0","61.88","43.54"
"66","000","00","015","1509","0379","458","364","94","21","479","909","0","52.7","40.04"
"66","000","00","015","1510","0000","1355","1068","287","133","1488","2433","0","61.16","43.9"
"66","000","00","015","1510","0380","601","466","135","68","669","1091","0","61.32","42.71"
"66","000","00","015","1510","0381","754","602","152","65","819","1342","0","61.03","44.86"
"66","000","00","015","1511","0000","1129","878","251","101","1230","2115","0","58.16","41.51"
"66","000","00","015","1511","0382","580","444","136","60","640","1138","0","56.24","39.02"
"66","000","00","015","1511","0383","549","434","115","41","590","977","0","60.39","44.42"
"66","000","00","015","1512","0000","710","577","133","35","745","1584","0","47.03","36.43"
"66","000","00","015","1512","0384","710","577","133","35","745","1584","0","47.03","36.43"
"66","000","00","015","1513","0000","1171","919","252","89","1260","2140","0","58.88","42.94"
"66","000","00","015","1513","0385","493","390","103","30","523","915","0","57.16","42.62"
"66","000","00","015","1513","0386","678","529","149","59","737","1225","0","60.16","43.18"
"66","000","00","015","1514","0000","1662","1368","294","67","1729","3152","0","54.85","43.4"
"66","000","00","015","1514","0387","813","669","144","41","854","1552","0","55.03","43.11"
"66","000","00","015","1514","0388","849","699","150","26","875","1600","0","54.69","43.69"
"66","000","00","015","1515","0000","667","517","150","59","726","1340","0","54.18","38.58"
"66","000","00","015","1515","0393","667","517","150","59","726","1340","0","54.18","38.58"
"66","000","00","015","1516","0000","1090","846","244","99","1189","2122","0","56.03","39.87"
"66","000","00","015","1516","0391","519","407","112","40","559","1055","0","52.99","38.58"
"66","000","00","015","1516","0392","571","439","132","59","630","1067","0","59.04","41.14"
"66","000","00","015","1517","0000","994","779","215","62","1056","1885","0","56.02","41.33"
"66","000","00","015","1517","0389","501","396","105","31","532","942","0","56.48","42.04"
"66","000","00","015","1517","0390","493","383","110","31","524","943","0","55.57","40.62"
"66","000","00","015","1518","0000","1353","1099","254","75","1428","2674","0","53.4","41.1"
"66","000","00","015","1518","0362","673","561","112","41","714","1376","0","51.89","40.77"
"66","000","00","015","1518","0363","680","538","142","34","714","1298","0","55.01","41.45"
"66","000","00","016","0000","0000","29696","23245","6451","2231","31927","54565","65692","58.51","42.6"
"66","000","00","016","1601","0000","1807","1447","360","110","1917","3243","0","59.11","44.62"
"66","000","00","016","1601","0482","937","771","166","61","998","1684","0","59.26","45.78"
"66","000","00","016","1601","0483","870","676","194","49","919","1559","0","58.95","43.36"
"66","000","00","016","1602","0000","1241","992","249","84","1325","2139","0","61.94","46.38"
"66","000","00","016","1602","0484","582","466","116","34","616","1095","0","56.26","42.56"
"66","000","00","016","1602","0485","659","526","133","50","709","1044","0","67.91","50.38"
"66","000","00","016","1603","0000","1521","1165","356","160","1681","2604","0","64.55","44.74"
"66","000","00","016","1603","0486","784","609","175","69","853","1310","0","65.11","46.49"
"66","000","00","016","1603","0487","737","556","181","91","828","1294","0","63.99","42.97"
"66","000","00","016","1604","0000","1213","930","283","107","1320","2165","0","60.97","42.96"
"66","000","00","016","1604","0488","631","493","138","56","687","1143","0","60.1","43.13"
"66","000","00","016","1604","0489","582","437","145","51","633","1022","0","61.94","42.76"
"66","000","00","016","1605","0000","3832","3047","785","252","4084","7265","0","56.21","41.94"
"66","000","00","016","1605","0498","749","582","167","39","788","1452","0","54.27","40.08"
"66","000","00","016","1605","0499","877","697","180","76","953","1551","0","61.44","44.94"
"66","000","00","016","1605","0500","792","653","139","66","858","1567","0","54.75","41.67"
"66","000","00","016","1605","0501","801","634","167","42","843","1449","0","58.18","43.75"
"66","000","00","016","1605","0502","613","481","132","29","642","1246","0","51.52","38.6"
"66","000","00","016","1606","0000","2993","2378","615","232","3225","5267","0","61.23","45.15"
"66","000","00","016","1606","0503","780","638","142","66","846","1431","0","59.12","44.58"
"66","000","00","016","1606","0504","675","540","135","60","735","1163","0","63.2","46.43"
"66","000","00","016","1606","0505","832","644","188","63","895","1402","0","63.84","45.93"
"66","000","00","016","1606","0506","706","556","150","43","749","1271","0","58.93","43.75"
"66","000","00","016","1607","0000","1409","1137","272","120","1529","2510","0","60.92","45.3"
"66","000","00","016","1607","0507","673","536","137","51","724","1198","0","60.43","44.74"
"66","000","00","016","1607","0508","736","601","135","69","805","1312","0","61.36","45.81"
"66","000","00","016","1608","0000","1581","1237","344","92","1673","2885","0","57.99","42.88"
"66","000","00","016","1608","0512","886","687","199","54","940","1483","0","63.39","46.33"
"66","000","00","016","1608","0513","695","550","145","38","733","1402","0","52.28","39.23"
"66","000","00","016","1609","0000","2248","1772","476","139","2387","4329","0","55.14","40.93"
"66","000","00","016","1609","0509","835","651","184","69","904","1590","0","56.86","40.94"
"66","000","00","016","1609","0510","695","536","159","29","724","1324","0","54.68","40.48"
"66","000","00","016","1609","0511","718","585","133","41","759","1415","0","53.64","41.34"
"66","000","00","016","1610","0000","3864","2998","866","293","4157","7224","0","57.54","41.5"
"66","000","00","016","1610","0514","666","529","137","44","710","1275","0","55.69","41.49"
"66","000","00","016","1610","0515","647","480","167","58","705","1288","0","54.74","37.27"
"66","000","00","016","1610","0516","562","431","131","53","615","1080","0","56.94","39.91"
"66","000","00","016","1610","0517","690","550","140","28","718","1344","0","53.42","40.92"
"66","000","00","016","1610","0518","605","478","127","60","665","1061","0","62.68","45.05"
"66","000","00","016","1610","0519","694","530","164","50","744","1176","0","63.27","45.07"
"66","000","00","016","1611","0000","1506","1166","340","123","1629","2562","0","63.58","45.51"
"66","000","00","016","1611","0520","715","534","181","62","777","1244","0","62.46","42.93"
"66","000","00","016","1611","0521","791","632","159","61","852","1318","0","64.64","47.95"
"66","000","00","016","1612","0000","1537","1206","331","139","1676","2794","0","59.99","43.16"
"66","000","00","016","1612","0522","750","587","163","51","801","1471","0","54.45","39.9"
"66","000","00","016","1612","0523","787","619","168","88","875","1323","0","66.14","46.79"
"66","000","00","016","1613","0000","1130","887","243","72","1202","2354","0","51.06","37.68"
"66","000","00","016","1613","0490","642","494","148","51","693","1269","0","54.61","38.93"
"66","000","00","016","1613","0491","488","393","95","21","509","1085","0","46.91","36.22"
"66","000","00","016","1614","0000","2137","1609","528","186","2323","4090","0","56.8","39.34"
"66","000","00","016","1614","0494","717","534","183","55","772","1390","0","55.54","38.42"
"66","000","00","016","1614","0495","779","594","185","89","868","1372","0","63.27","43.29"
"66","000","00","016","1614","0496","641","481","160","42","683","1328","0","51.43","36.22"
"66","000","00","016","1615","0000","1135","862","273","99","1234","2096","0","58.87","41.13"
"66","000","00","016","1615","0492","525","395","130","67","592","942","0","62.85","41.93"
"66","000","00","016","1615","0493","610","467","143","32","642","1154","0","55.63","40.47"
"66","000","00","016","1616","0000","542","412","130","23","565","1038","0","54.43","39.69"
"66","000","00","016","1616","0497","542","412","130","23","565","1038","0","54.43","39.69"
"66","000","00","017","0000","0000","47921","38184","9737","2886","50807","89487","108777","56.78","42.67"
"66","000","00","017","1701","0000","5855","4760","1095","336","6191","10976","0","56.4","43.37"
"66","000","00","017","1701","0573","936","745","191","67","1003","1630","0","61.53","45.71"
"66","000","00","017","1701","0574","837","691","146","39","876","1532","0","57.18","45.1"
"66","000","00","017","1701","0575","829","637","192","39","868","1677","0","51.76","37.98"
"66","000","00","017","1701","0576","869","704","165","55","924","1744","0","52.98","40.37"
"66","000","00","017","1701","0577","976","854","122","57","1033","1795","0","57.55","47.58"
"66","000","00","017","1701","0578","630","501","129","41","671","1171","0","57.3","42.78"
"66","000","00","017","1701","0579","778","628","150","38","816","1427","0","57.18","44.01"
"66","000","00","017","1702","0000","735","593","142","51","786","1306","0","60.18","45.41"
"66","000","00","017","1702","0570","735","593","142","51","786","1306","0","60.18","45.41"
"66","000","00","017","1703","0000","1333","1059","274","101","1434","2287","0","62.7","46.31"
"66","000","00","017","1703","0571","645","502","143","43","688","1128","0","60.99","44.5"
"66","000","00","017","1703","0572","688","557","131","58","746","1159","0","64.37","48.06"
"66","000","00","017","1704","0000","5506","4363","1143","318","5824","10187","0","57.17","42.83"
"66","000","00","017","1704","0580","942","724","218","63","1005","1709","0","58.81","42.36"
"66","000","00","017","1704","0581","938","751","187","40","978","1723","0","56.76","43.59"
"66","000","00","017","1704","0582","933","730","203","51","984","1782","0","55.22","40.97"
"66","000","00","017","1704","0583","729","593","136","39","768","1407","0","54.58","42.15"
"66","000","00","017","1704","0584","970","771","199","35","1005","1771","0","56.75","43.53"
"66","000","00","017","1704","0585","994","794","200","90","1084","1795","0","60.39","44.23"
"66","000","00","017","1705","0000","2656","2065","591","141","2797","5195","0","53.84","39.75"
"66","000","00","017","1705","0586","955","762","193","54","1009","1612","0","62.59","47.27"
"66","000","00","017","1705","0587","899","692","207","40","939","1894","0","49.58","36.54"
"66","000","00","017","1705","0588","802","611","191","47","849","1689","0","50.27","36.18"
"66","000","00","017","1706","0000","5087","4106","981","294","5381","9343","0","57.59","43.95"
"66","000","00","017","1706","0599","946","791","155","48","994","1666","0","59.66","47.48"
"66","000","00","017","1706","0600","924","722","202","63","987","1750","0","56.4","41.26"
"66","000","00","017","1706","0601","763","639","124","47","810","1437","0","56.37","44.47"
"66","000","00","017","1706","0602","928","765","163","45","973","1735","0","56.08","44.09"
"66","000","00","017","1706","0603","857","632","225","54","911","1612","0","56.51","39.21"
"66","000","00","017","1706","0604","669","557","112","37","706","1143","0","61.77","48.73"
"66","000","00","017","1707","0000","6423","5154","1269","336","6759","11996","0","56.34","42.96"
"66","000","00","017","1707","0605","1073","857","216","47","1120","2096","0","53.44","40.89"
"66","000","00","017","1707","0606","873","679","194","63","936","1549","0","60.43","43.83"
"66","000","00","017","1707","0607","860","685","175","33","893","1573","0","56.77","43.55"
"66","000","00","017","1707","0608","799","649","150","40","839","1585","0","52.93","40.95"
"66","000","00","017","1707","0609","845","678","167","40","885","1572","0","56.3","43.13"
"66","000","00","017","1707","0610","996","830","166","42","1038","1738","0","59.72","47.76"
"66","000","00","017","1707","0611","977","776","201","71","1048","1883","0","55.66","41.21"
"66","000","00","017","1708","0000","1555","1209","346","84","1639","2753","0","59.54","43.92"
"66","000","00","017","1708","0612","776","598","178","31","807","1401","0","57.6","42.68"
"66","000","00","017","1708","0613","779","611","168","53","832","1352","0","61.54","45.19"
"66","000","00","017","1709","0000","3154","2522","632","202","3356","5805","0","57.81","43.45"
"66","000","00","017","1709","0614","1149","914","235","87","1236","2085","0","59.28","43.84"
"66","000","00","017","1709","0615","1157","941","216","84","1241","2047","0","60.63","45.97"
"66","000","00","017","1709","0616","848","667","181","31","879","1673","0","52.54","39.87"
"66","000","00","017","1710","0000","2426","1867","559","206","2632","4599","0","57.23","40.6"
"66","000","00","017","1710","0617","1018","785","233","98","1116","1874","0","59.55","41.89"
"66","000","00","017","1710","0618","569","423","146","65","634","1051","0","60.32","40.25"
"66","000","00","017","1710","0619","839","659","180","43","882","1674","0","52.69","39.37"
"66","000","00","017","1711","0000","2025","1566","459","137","2162","3834","0","56.39","40.85"
"66","000","00","017","1711","0620","1009","779","230","71","1080","1831","0","58.98","42.55"
"66","000","00","017","1711","0621","1016","787","229","66","1082","2003","0","54.02","39.29"
"66","000","00","017","1712","0000","815","654","161","48","863","1535","0","56.22","42.61"
"66","000","00","017","1712","0622","815","654","161","48","863","1535","0","56.22","42.61"
"66","000","00","017","1713","0000","2005","1601","404","162","2167","4147","0","52.25","38.61"
"66","000","00","017","1713","0623","1065","842","223","105","1170","2286","0","51.18","36.83"
"66","000","00","017","1713","0624","940","759","181","57","997","1861","0","53.57","40.78"
"66","000","00","017","1714","0000","2285","1816","469","156","2441","4347","0","56.15","41.78"
"66","000","00","017","1714","0589","741","579","162","51","792","1525","0","51.93","37.97"
"66","000","00","017","1714","0590","879","700","179","45","924","1622","0","56.97","43.16"
"66","000","00","017","1714","0591","665","537","128","60","725","1200","0","60.42","44.75"
"66","000","00","017","1715","0000","3538","2846","692","150","3688","6729","0","54.81","42.29"
"66","000","00","017","1715","0592","705","567","138","16","721","1355","0","53.21","41.85"
"66","000","00","017","1715","0593","926","732","194","36","962","1777","0","54.14","41.19"
"66","000","00","017","1715","0594","1050","850","200","34","1084","1923","0","56.37","44.2"
"66","000","00","017","1715","0595","857","697","160","64","921","1674","0","55.02","41.64"
"66","000","00","017","1716","0000","2523","2003","520","164","2687","4448","0","60.41","45.03"
"66","000","00","017","1716","0596","854","694","160","53","907","1451","0","62.51","47.83"
"66","000","00","017","1716","0597","818","649","169","55","873","1486","0","58.75","43.67"
"66","000","00","017","1716","0598","851","660","191","56","907","1511","0","60.03","43.68"
"66","000","00","018","0000","0000","41164","33234","7930","2665","43829","77189","95703","56.78","43.06"
"66","000","00","018","1801","0000","2503","1981","522","150","2653","4378","0","60.6","45.25"
"66","000","00","018","1801","0527","899","720","179","43","942","1537","0","61.29","46.84"
"66","000","00","018","1801","0528","814","637","177","59","873","1439","0","60.67","44.27"
"66","000","00","018","1801","0529","790","624","166","48","838","1402","0","59.77","44.51"
"66","000","00","018","1802","0000","5069","4062","1007","394","5463","9096","0","60.06","44.66"
"66","000","00","018","1802","0553","936","754","182","69","1005","1568","0","64.09","48.09"
"66","000","00","018","1802","0554","929","710","219","81","1010","1761","0","57.35","40.32"
"66","000","00","018","1802","0555","966","781","185","103","1069","1752","0","61.02","44.58"
"66","000","00","018","1802","0556","714","578","136","46","760","1264","0","60.13","45.73"
"66","000","00","018","1802","0557","746","613","133","40","786","1302","0","60.37","47.08"
"66","000","00","018","1802","0558","778","626","152","55","833","1449","0","57.49","43.2"
"66","000","00","018","1803","0000","3260","2618","642","232","3492","6169","0","56.61","42.44"
"66","000","00","018","1803","0559","914","724","190","82","996","1621","0","61.44","44.66"
"66","000","00","018","1803","0560","838","668","170","81","919","1647","0","55.8","40.56"
"66","000","00","018","1803","0561","744","609","135","39","783","1441","0","54.34","42.26"
"66","000","00","018","1803","0562","764","617","147","30","794","1460","0","54.38","42.26"
"66","000","00","018","1804","0000","1862","1467","395","135","1997","3203","0","62.35","45.8"
"66","000","00","018","1804","0563","1060","836","224","66","1126","1832","0","61.46","45.63"
"66","000","00","018","1804","0564","802","631","171","69","871","1371","0","63.53","46.02"
"66","000","00","018","1805","0000","1773","1445","328","169","1942","3617","0","53.69","39.95"
"66","000","00","018","1805","0568","913","750","163","66","979","1733","0","56.49","43.28"
"66","000","00","018","1805","0569","860","695","165","103","963","1884","0","51.11","36.89"
"66","000","00","018","1806","0000","2235","1797","438","108","2343","4226","0","55.44","42.52"
"66","000","00","018","1806","0565","676","534","142","11","687","1418","0","48.45","37.66"
"66","000","00","018","1806","0566","829","681","148","34","863","1473","0","58.59","46.23"
"66","000","00","018","1806","0567","730","582","148","63","793","1335","0","59.4","43.6"
"66","000","00","018","1807","0000","2858","2316","542","162","3020","5183","0","58.27","44.68"
"66","000","00","018","1807","0533","1036","877","159","47","1083","1887","0","57.39","46.48"
"66","000","00","018","1807","0534","847","668","179","58","905","1480","0","61.15","45.14"
"66","000","00","018","1807","0535","975","771","204","57","1032","1816","0","56.83","42.46"
"66","000","00","018","1808","0000","2526","2016","510","173","2699","4728","0","57.09","42.64"
"66","000","00","018","1808","0542","861","693","168","70","931","1635","0","56.94","42.39"
"66","000","00","018","1808","0543","880","717","163","51","931","1565","0","59.49","45.81"
"66","000","00","018","1808","0544","785","606","179","52","837","1528","0","54.78","39.66"
"66","000","00","018","1809","0000","2997","2398","599","148","3145","6020","0","52.24","39.83"
"66","000","00","018","1809","0545","954","773","181","35","989","1963","0","50.38","39.38"
"66","000","00","018","1809","0546","1011","808","203","49","1060","2073","0","51.13","38.98"
"66","000","00","018","1809","0547","1032","817","215","64","1096","1984","0","55.24","41.18"
"66","000","00","018","1810","0000","3066","2562","504","215","3281","5882","0","55.78","43.56"
"66","000","00","018","1810","0536","894","718","176","93","987","1898","0","52.0","37.83"
"66","000","00","018","1810","0537","1080","952","128","68","1148","2008","0","57.17","47.41"
"66","000","00","018","1810","0538","1092","892","200","54","1146","1976","0","58.0","45.14"
"66","000","00","018","1811","0000","2532","2155","377","114","2646","4464","0","59.27","48.28"
"66","000","00","018","1811","0539","924","743","181","50","974","1673","0","58.22","44.41"
"66","000","00","018","1811","0540","829","658","171","39","868","1409","0","61.6","46.7"
"66","000","00","018","1811","0541","779","754","25","25","804","1382","0","58.18","54.56"
"66","000","00","018","1812","0000","3027","2428","599","157","3184","5906","0","53.91","41.11"
"66","000","00","018","1812","0524","1099","878","221","73","1172","2027","0","57.82","43.32"
"66","000","00","018","1812","0525","951","752","199","36","987","1967","0","50.18","38.23"
"66","000","00","018","1812","0526","977","798","179","48","1025","1912","0","53.61","41.74"
"66","000","00","018","1813","0000","3135","2506","629","197","3332","5941","0","56.08","42.18"
"66","000","00","018","1813","0530","1044","842","202","71","1115","2013","0","55.39","41.83"
"66","000","00","018","1813","0531","1045","834","211","74","1119","1917","0","58.37","43.51"
"66","000","00","018","1813","0532","1046","830","216","52","1098","2011","0","54.6","41.27"
"66","000","00","018","1814","0000","2604","2086","518","196","2800","4776","0","58.63","43.68"
"66","000","00","018","1814","0548","882","712","170","59","941","1688","0","55.75","42.18"
"66","000","00","018","1814","0549","775","603","172","52","827","1387","0","59.63","43.48"
"66","000","00","018","1814","0550","947","771","176","85","1032","1701","0","60.67","45.33"
"66","000","00","018","1815","0000","1717","1397","320","115","1832","3600","0","50.89","38.81"
"66","000","00","018","1815","0551","909","739","170","59","968","1721","0","56.25","42.94"
"66","000","00","018","1815","0552","808","658","150","56","864","1879","0","45.98","35.02"
"66","000","00","019","0000","0000","10100","8051","2049","760","10860","20860","24605","52.06","38.6"
"66","000","00","019","1901","0000","1779","1436","343","87","1866","3259","0","57.26","44.06"
"66","000","00","019","1901","1562","535","429","106","25","560","1011","0","55.39","42.43"
"66","000","00","019","1901","1563","637","503","134","39","676","1195","0","56.57","42.09"
"66","000","00","019","1901","1564","607","504","103","23","630","1053","0","59.83","47.86"
"66","000","00","019","1902","0000","839","663","176","37","876","1880","0","46.6","35.27"
"66","000","00","019","1902","1565","382","291","91","21","403","961","0","41.94","30.28"
"66","000","00","019","1902","1566","457","372","85","16","473","919","0","51.47","40.48"
"66","000","00","019","1903","0000","773","622","151","64","837","1367","0","61.23","45.5"
"66","000","00","019","1903","1567","773","622","151","64","837","1367","0","61.23","45.5"
"66","000","00","019","1904","0000","484","369","115","41","525","1010","0","51.98","36.53"
"66","000","00","019","1904","1568","484","369","115","41","525","1010","0","51.98","36.53"
"66","000","00","019","1905","0000","505","388","117","53","558","1169","0","47.73","33.19"
"66","000","00","019","1905","1569","505","388","117","53","558","1169","0","47.73","33.19"
"66","000","00","019","1906","0000","955","764","191","76","1031","1883","0","54.75","40.57"
"66","000","00","019","1906","1570","508","387","121","55","563","989","0","56.93","39.13"
"66","000","00","019","1906","1571","447","377","70","21","468","894","0","52.35","42.17"
"66","000","00","019","1907","0000","1295","1051","244","77","1372","2936","0","46.73","35.8"
"66","000","00","019","1907","1572","505","415","90","28","533","1033","0","51.6","40.17"
"66","000","00","019","1907","1573","405","335","70","32","437","1058","0","41.3","31.66"
"66","000","00","019","1907","1574","385","301","84","17","402","845","0","47.57","35.62"
"66","000","00","019","1908","0000","359","285","74","33","392","576","0","68.06","49.48"
"66","000","00","019","1908","1575","359","285","74","33","392","576","0","68.06","49.48"
"66","000","00","019","1909","0000","1300","1010","290","124","1424","2900","0","49.1","34.83"
"66","000","00","019","1909","1576","565","450","115","60","625","1229","0","50.85","36.62"
"66","000","00","019","1909","1577","370","285","85","34","404","890","0","45.39","32.02"
"66","000","00","019","1909","1578","365","275","90","30","395","781","0","50.58","35.21"
"66","000","00","019","1910","0000","618","505","113","61","679","1244","0","54.58","40.59"
"66","000","00","019","1910","1579","618","505","113","61","679","1244","0","54.58","40.59"
"66","000","00","019","1911","0000","351","267","84","37","388","889","0","43.64","30.03"
"66","000","00","019","1911","1580","69","51","18","10","79","213","0","37.09","23.94"
"66","000","00","019","1911","1581","282","216","66","27","309","676","0","45.71","31.95"
"66","000","00","019","1912","0000","257","201","56","22","279","585","0","47.69","34.36"
"66","000","00","019","1912","1582","257","201","56","22","279","585","0","47.69","34.36"
"66","000","00","019","1913","0000","585","490","95","48","633","1162","0","54.48","42.17"
"66","000","00","019","1913","1583","479","399","80","44","523","938","0","55.76","42.54"
"66","000","00","019","1913","1584","106","91","15","4","110","224","0","49.11","40.63"
"66","000","00","020","0000","0000","7038","5462","1576","585","7623","12880","14968","59.18","42.41"
"66","000","00","020","2001","0000","684","530","154","47","731","1244","0","58.76","42.6"
"66","000","00","020","2001","1552","684","530","154","47","731","1244","0","58.76","42.6"
"66","000","00","020","2002","0000","804","631","173","57","861","1539","0","55.95","41.0"
"66","000","00","020","2002","1553","804","631","173","57","861","1539","0","55.95","41.0"
"66","000","00","020","2003","0000","669","512","157","41","710","1202","0","59.07","42.6"
"66","000","00","020","2003","1554","669","512","157","41","710","1202","0","59.07","42.6"
"66","000","00","020","2004","0000","629","486","143","68","697","1272","0","54.8","38.21"
"66","000","00","020","2004","1555","629","486","143","68","697","1272","0","54.8","38.21"
"66","000","00","020","2005","0000","357","279","78","34","391","652","0","59.97","42.79"
"66","000","00","020","2005","1556","357","279","78","34","391","652","0","59.97","42.79"
"66","000","00","020","2006","0000","875","691","184","81","956","1457","0","65.61","47.43"
"66","000","00","020","2006","1557","875","691","184","81","956","1457","0","65.61","47.43"
"66","000","00","020","2007","0000","959","731","228","76","1035","1836","0","56.37","39.81"
"66","000","00","020","2007","1558","959","731","228","76","1035","1836","0","56.37","39.81"
"66","000","00","020","2008","0000","530","415","115","56","586","1001","0","58.54","41.46"
"66","000","00","020","2008","1559","530","415","115","56","586","1001","0","58.54","41.46"
"66","000","00","020","2009","0000","838","637","201","54","892","1448","0","61.6","43.99"
"66","000","00","020","2009","1560","838","637","201","54","892","1448","0","61.6","43.99"
"66","000","00","020","2010","0000","693","550","143","71","764","1229","0","62.16","44.75"
"66","000","00","020","2010","1561","693","550","143","71","764","1229","0","62.16","44.75"
"66","000","00","021","0000","0000","14714","11940","2774","1017","15731","27059","32202","58.14","44.13"
"66","000","00","021","2101","0000","559","434","125","43","602","1059","0","56.85","40.98"
"66","000","00","021","2101","0071","559","434","125","43","602","1059","0","56.85","40.98"
"66","000","00","021","2102","0000","1238","1001","237","67","1305","2163","0","60.33","46.28"
"66","000","00","021","2102","0072","574","463","111","19","593","1013","0","58.54","45.71"
"66","000","00","021","2102","0073","664","538","126","48","712","1150","0","61.91","46.78"
"66","000","00","021","2103","0000","982","778","204","88","1070","1902","0","56.26","40.9"
"66","000","00","021","2103","0081","982","778","204","88","1070","1902","0","56.26","40.9"
"66","000","00","021","2104","0000","2711","2238","473","141","2852","4635","0","61.53","48.28"
"66","000","00","021","2104","0074","1109","920","189","68","1177","1855","0","63.45","49.6"
"66","000","00","021","2104","0075","767","628","139","28","795","1327","0","59.91","47.32"
"66","000","00","021","2104","0076","835","690","145","45","880","1453","0","60.56","47.49"
"66","000","00","021","2105","0000","2019","1590","429","168","2187","3446","0","63.46","46.14"
"66","000","00","021","2105","0082","682","550","132","49","731","1138","0","64.24","48.33"
"66","000","00","021","2105","0083","607","471","136","73","680","1065","0","63.85","44.23"
"66","000","00","021","2105","0084","730","569","161","46","776","1243","0","62.43","45.78"
"66","000","00","021","2106","0000","3296","2779","517","201","3497","6297","0","55.53","44.13"
"66","000","00","021","2106","0077","859","805","54","72","931","1653","0","56.32","48.7"
"66","000","00","021","2106","0078","834","682","152","40","874","1615","0","54.12","42.23"
"66","000","00","021","2106","0079","740","622","118","36","776","1470","0","52.79","42.31"
"66","000","00","021","2106","0080","863","670","193","53","916","1559","0","58.76","42.98"
"66","000","00","021","2107","0000","751","622","129","44","795","1391","0","57.15","44.72"
"66","000","00","021","2107","0088","751","622","129","44","795","1391","0","57.15","44.72"
"66","000","00","021","2108","0000","721","590","131","59","780","1216","0","64.14","48.52"
"66","000","00","021","2108","0087","721","590","131","59","780","1216","0","64.14","48.52"
"66","000","00","021","2109","0000","1094","872","222","87","1181","2131","0","55.42","40.92"
"66","000","00","021","2109","0085","488","380","108","41","529","962","0","54.99","39.5"
"66","000","00","021","2109","0086","606","492","114","46","652","1169","0","55.77","42.09"
"66","000","00","021","2110","0000","823","622","201","84","907","1616","0","56.13","38.49"
"66","000","00","021","2110","0089","823","622","201","84","907","1616","0","56.13","38.49"
"66","000","00","021","2111","0000","520","414","106","35","555","1203","0","46.13","34.41"
"66","000","00","021","2111","0090","520","414","106","35","555","1203","0","46.13","34.41"
"66","000","00","022","0000","0000","8781","6877","1904","907","9688","16520","19250","58.64","41.63"
"66","000","00","022","2201","0000","503","405","98","67","570","1068","0","53.37","37.92"
"66","000","00","022","2201","0055","503","405","98","67","570","1068","0","53.37","37.92"
"66","000","00","022","2202","0000","541","419","122","72","613","1050","0","58.38","39.9"
"66","000","00","022","2202","0056","541","419","122","72","613","1050","0","58.38","39.9"
"66","000","00","022","2203","0000","1391","1072","319","141","1532","2643","0","57.96","40.56"
"66","000","00","022","2203","0057","665","515","150","85","750","1246","0","60.19","41.33"
"66","000","00","022","2203","0058","726","557","169","56","782","1397","0","55.98","39.87"
"66","000","00","022","2204","0000","846","663","183","95","941","1581","0","59.52","41.94"
"66","000","00","022","2204","0061","541","419","122","55","596","914","0","65.21","45.84"
"66","000","00","022","2204","0062","305","244","61","40","345","667","0","51.72","36.58"
"66","000","00","022","2205","0000","614","481","133","73","687","1170","0","58.72","41.11"
"66","000","00","022","2205","0060","614","481","133","73","687","1170","0","58.72","41.11"
"66","000","00","022","2206","0000","692","558","134","67","759","1227","0","61.86","45.48"
"66","000","00","022","2206","0059","692","558","134","67","759","1227","0","61.86","45.48"
"66","000","00","022","2207","0000","434","341","93","49","483","890","0","54.27","38.31"
"66","000","00","022","2207","0063","434","341","93","49","483","890","0","54.27","38.31"
"66","000","00","022","2208","0000","875","680","195","94","969","1744","0","55.56","38.99"
"66","000","00","022","2208","0064","661","515","146","67","728","1289","0","56.48","39.95"
"66","000","00","022","2208","0065","214","165","49","27","241","455","0","52.97","36.26"
"66","000","00","022","2209","0000","539","418","121","43","582","1028","0","56.61","40.66"
"66","000","00","022","2209","0066","539","418","121","43","582","1028","0","56.61","40.66"
"66","000","00","022","2210","0000","782","623","159","79","861","1446","0","59.54","43.08"
"66","000","00","022","2210","0067","782","623","159","79","861","1446","0","59.54","43.08"
"66","000","00","022","2211","0000","999","805","194","93","1092","1750","0","62.4","46.0"
"66","000","00","022","2211","0068","409","340","69","37","446","688","0","64.83","49.42"
"66","000","00","022","2211","0069","590","465","125","56","646","1062","0","60.83","43.79"
"66","000","00","022","2212","0000","565","412","153","34","599","923","0","64.9","44.64"
"66","000","00","022","2212","0070","565","412","153","34","599","923","0","64.9","44.64"
"66","000","00","023","0000","0000","33409","26319","7090","2506","35915","61705","75275","58.2","42.65"
"66","000","00","023","2301","0000","4733","3692","1041","330","5063","8455","0","59.88","43.67"
"66","000","00","023","2301","0317","849","631","218","79","928","1480","0","62.7","42.64"
"66","000","00","023","2301","0318","1059","840","219","72","1131","1841","0","61.43","45.63"
"66","000","00","023","2301","0319","929","720","209","69","998","1751","0","57.0","41.12"
"66","000","00","023","2301","0320","887","680","207","62","949","1547","0","61.34","43.96"
"66","000","00","023","2301","0321","1009","821","188","48","1057","1836","0","57.57","44.72"
"66","000","00","023","2302","0000","1413","1072","341","157","1570","2534","0","61.96","42.3"
"66","000","00","023","2302","0322","734","542","192","94","828","1239","0","66.83","43.74"
"66","000","00","023","2302","0323","679","530","149","63","742","1295","0","57.3","40.93"
"66","000","00","023","2303","0000","2467","1958","509","179","2646","4707","0","56.21","41.6"
"66","000","00","023","2303","0324","652","510","142","57","709","1263","0","56.14","40.38"
"66","000","00","023","2303","0325","868","677","191","39","907","1622","0","55.92","41.74"
"66","000","00","023","2303","0326","947","771","176","83","1030","1822","0","56.53","42.32"
"66","000","00","023","2304","0000","2641","2127","514","156","2797","4813","0","58.11","44.19"
"66","000","00","023","2304","0327","1034","828","206","65","1099","1966","0","55.9","42.12"
"66","000","00","023","2304","0328","895","731","164","56","951","1615","0","58.89","45.26"
"66","000","00","023","2304","0329","712","568","144","35","747","1232","0","60.63","46.1"
"66","000","00","023","2305","0000","1275","1030","245","79","1354","2512","0","53.9","41.0"
"66","000","00","023","2305","0330","689","569","120","37","726","1347","0","53.9","42.24"
"66","000","00","023","2305","0331","586","461","125","42","628","1165","0","53.91","39.57"
"66","000","00","023","2306","0000","6938","5545","1393","466","7404","12812","0","57.79","43.28"
"66","000","00","023","2306","0332","929","734","195","54","983","1664","0","59.07","44.11"
"66","000","00","023","2306","0333","714","547","167","57","771","1230","0","62.68","44.47"
"66","000","00","023","2306","0334","905","687","218","75","980","1574","0","62.26","43.65"
"66","000","00","023","2306","0335","868","679","189","51","919","1452","0","63.29","46.76"
"66","000","00","023","2306","0336","899","736","163","75","974","1879","0","51.84","39.17"
"66","000","00","023","2306","0337","841","672","169","53","894","1601","0","55.84","41.97"
"66","000","00","023","2306","0338","897","700","197","57","954","1546","0","61.71","45.28"
"66","000","00","023","2306","0339","885","790","95","44","929","1866","0","49.79","42.34"
"66","000","00","023","2307","0000","4032","3185","847","278","4310","7449","0","57.86","42.76"
"66","000","00","023","2307","0340","1081","851","230","76","1157","1938","0","59.7","43.91"
"66","000","00","023","2307","0341","948","736","212","75","1023","1759","0","58.16","41.84"
"66","000","00","023","2307","0342","1050","836","214","79","1129","2061","0","54.78","40.56"
"66","000","00","023","2307","0343","953","762","191","48","1001","1691","0","59.2","45.06"
"66","000","00","023","2308","0000","1320","1039","281","77","1397","2260","0","61.81","45.97"
"66","000","00","023","2308","0344","632","486","146","38","670","1039","0","64.49","46.78"
"66","000","00","023","2308","0345","688","553","135","39","727","1221","0","59.54","45.29"
"66","000","00","023","2309","0000","907","695","212","89","996","1650","0","60.36","42.12"
"66","000","00","023","2309","0346","907","695","212","89","996","1650","0","60.36","42.12"
"66","000","00","023","2310","0000","1223","953","270","85","1308","2157","0","60.64","44.18"
"66","000","00","023","2310","0347","537","409","128","42","579","937","0","61.79","43.65"
"66","000","00","023","2310","0348","686","544","142","43","729","1220","0","59.75","44.59"
"66","000","00","023","2311","0000","1017","783","234","128","1145","2139","0","53.53","36.61"
"66","000","00","023","2311","0349","1017","783","234","128","1145","2139","0","53.53","36.61"
"66","000","00","023","2312","0000","2354","1859","495","209","2563","4356","0","58.84","42.68"
"66","000","00","023","2312","0350","802","633","169","74","876","1371","0","63.89","46.17"
"66","000","00","023","2312","0351","701","557","144","50","751","1277","0","58.81","43.62"
"66","000","00","023","2312","0352","851","669","182","85","936","1708","0","54.8","39.17"
"66","000","00","023","2313","0000","1068","848","220","77","1145","2048","0","55.91","41.41"
"66","000","00","023","2313","0353","1068","848","220","77","1145","2048","0","55.91","41.41"
"66","000","00","023","2314","0000","853","630","223","62","915","1632","0","56.07","38.6"
"66","000","00","023","2314","0354","853","630","223","62","915","1632","0","56.07","38.6"
"66","000","00","023","2315","0000","741","576","165","64","805","1327","0","60.66","43.41"
"66","000","00","023","2315","0355","741","576","165","64","805","1327","0","60.66","43.41"
"66","000","00","023","2316","0000","427","327","100","70","497","854","0","58.2","38.29"
"66","000","00","023","2316","0356","427","327","100","70","497","854","0","58.2","38.29"
"66","000","00","024","0000","0000","25433","20208","5225","1993","27426","47457","57267","57.79","42.58"
"66","000","00","024","2401","0000","2276","1780","496","180","2456","4327","0","56.76","41.14"
"66","000","00","024","2401","0284","747","589","158","42","789","1415","0","55.76","41.63"
"66","000","00","024","2401","0285","682","528","154","64","746","1392","0","53.59","37.93"
"66","000","00","024","2401","0286","847","663","184","74","921","1520","0","60.59","43.62"
"66","000","00","024","2402","0000","520","402","118","63","583","862","0","67.63","46.64"
"66","000","00","024","2402","0287","520","402","118","63","583","862","0","67.63","46.64"
"66","000","00","024","2403","0000","1978","1547","431","162","2140","3558","0","60.15","43.48"
"66","000","00","024","2403","0288","725","581","144","52","777","1256","0","61.86","46.26"
"66","000","00","024","2403","0289","681","529","152","66","747","1292","0","57.82","40.94"
"66","000","00","024","2403","0290","572","437","135","44","616","1010","0","60.99","43.27"
"66","000","00","024","2404","0000","830","644","186","88","918","1485","0","61.82","43.37"
"66","000","00","024","2404","0291","830","644","186","88","918","1485","0","61.82","43.37"
"66","000","00","024","2405","0000","1366","1122","244","133","1499","2440","0","61.43","45.98"
"66","000","00","024","2405","0292","686","572","114","71","757","1190","0","63.61","48.07"
"66","000","00","024","2405","0293","680","550","130","62","742","1250","0","59.36","44.0"
"66","000","00","024","2406","0000","1414","1138","276","99","1513","2604","0","58.1","43.7"
"66","000","00","024","2406","0294","726","587","139","51","777","1310","0","59.31","44.81"
"66","000","00","024","2406","0295","688","551","137","48","736","1294","0","56.88","42.58"
"66","000","00","024","2407","0000","1702","1337","365","127","1829","3050","0","59.97","43.84"
"66","000","00","024","2407","0296","1019","807","212","64","1083","1734","0","62.46","46.54"
"66","000","00","024","2407","0297","683","530","153","63","746","1316","0","56.69","40.27"
"66","000","00","024","2408","0000","1221","962","259","84","1305","2127","0","61.35","45.23"
"66","000","00","024","2408","0298","470","353","117","41","511","854","0","59.84","41.33"
"66","000","00","024","2408","0299","751","609","142","43","794","1273","0","62.37","47.84"
"66","000","00","024","2409","0000","499","409","90","32","531","851","0","62.4","48.06"
"66","000","00","024","2409","0300","499","409","90","32","531","851","0","62.4","48.06"
"66","000","00","024","2410","0000","865","709","156","38","903","1629","0","55.43","43.52"
"66","000","00","024","2410","0301","865","709","156","38","903","1629","0","55.43","43.52"
"66","000","00","024","2411","0000","852","670","182","104","956","1709","0","55.94","39.2"
"66","000","00","024","2411","0302","852","670","182","104","956","1709","0","55.94","39.2"
"66","000","00","024","2412","0000","476","383","93","34","510","953","0","53.52","40.19"
"66","000","00","024","2412","0303","476","383","93","34","510","953","0","53.52","40.19"
"66","000","00","024","2413","0000","761","594","167","51","812","1336","0","60.78","44.46"
"66","000","00","024","2413","0304","761","594","167","51","812","1336","0","60.78","44.46"
"66","000","00","024","2414","0000","3815","3050","765","271","4086","7282","0","56.11","41.88"
"66","000","00","024","2414","0305","1069","824","245","74","1143","2113","0","54.09","39.0"
"66","000","00","024","2414","0306","917","716","201","100","1017","1730","0","58.79","41.39"
"66","000","00","024","2414","0307","900","740","160","43","943","1692","0","55.73","43.74"
"66","000","00","024","2414","0308","929","770","159","54","983","1747","0","56.27","44.08"
"66","000","00","024","2415","0000","2600","2086","514","177","2777","5020","0","55.32","41.55"
"66","000","00","024","2415","0309","894","743","151","67","961","1672","0","57.48","44.44"
"66","000","00","024","2415","0310","827","649","178","51","878","1675","0","52.42","38.75"
"66","000","00","024","2415","0311","879","694","185","59","938","1673","0","56.07","41.48"
"66","000","00","024","2416","0000","2400","1887","513","184","2584","4732","0","54.61","39.88"
"66","000","00","024","2416","0312","910","732","178","49","959","1636","0","58.62","44.74"
"66","000","00","024","2416","0313","848","646","202","97","945","1753","0","53.91","36.85"
"66","000","00","024","2416","0314","642","509","133","38","680","1343","0","50.63","37.9"
"66","000","00","024","2417","0000","1858","1488","370","166","2024","3492","0","57.96","42.61"
"66","000","00","024","2417","0315","926","733","193","65","991","1822","0","54.39","40.23"
"66","000","00","024","2417","0316","932","755","177","101","1033","1670","0","61.86","45.21"
"66","000","00","025","0000","0000","33225","26267","6958","2229","35454","63584","77922","55.76","41.31"
"66","000","00","025","2501","0000","1627","1265","362","125","1752","3033","0","57.76","41.71"
"66","000","00","025","2501","0239","937","730","207","89","1026","1758","0","58.36","41.52"
"66","000","00","025","2501","0240","690","535","155","36","726","1275","0","56.94","41.96"
"66","000","00","025","2502","0000","1324","1049","275","89","1413","2782","0","50.79","37.71"
"66","000","00","025","2502","0241","633","500","133","32","665","1379","0","48.22","36.26"
"66","000","00","025","2502","0242","691","549","142","57","748","1403","0","53.31","39.13"
"66","000","00","025","2503","0000","1014","795","219","82","1096","1875","0","58.45","42.4"
"66","000","00","025","2503","0243","519","397","122","42","561","974","0","57.6","40.76"
"66","000","00","025","2503","0244","495","398","97","40","535","901","0","59.38","44.17"
"66","000","00","025","2504","0000","1801","1424","377","139","1940","3388","0","57.26","42.03"
"66","000","00","025","2504","0245","913","713","200","70","983","1779","0","55.26","40.08"
"66","000","00","025","2504","0246","888","711","177","69","957","1609","0","59.48","44.19"
"66","000","00","025","2505","0000","508","400","108","29","537","1038","0","51.73","38.54"
"66","000","00","025","2505","0247","508","400","108","29","537","1038","0","51.73","38.54"
"66","000","00","025","2506","0000","1272","984","288","95","1367","2249","0","60.78","43.75"
"66","000","00","025","2506","0248","745","583","162","60","805","1328","0","60.62","43.9"
"66","000","00","025","2506","0249","527","401","126","35","562","921","0","61.02","43.54"
"66","000","00","025","2507","0000","2373","1873","500","173","2546","5028","0","50.64","37.25"
"66","000","00","025","2507","0250","779","625","154","64","843","1609","0","52.39","38.84"
"66","000","00","025","2507","0251","551","432","119","23","574","1227","0","46.78","35.21"
"66","000","00","025","2507","0252","663","528","135","60","723","1278","0","56.57","41.31"
"66","000","00","025","2507","0253","380","288","92","26","406","914","0","44.42","31.51"
"66","000","00","025","2508","0000","1325","1051","274","93","1418","2911","0","48.71","36.1"
"66","000","00","025","2508","0254","750","596","154","44","794","1678","0","47.32","35.52"
"66","000","00","025","2508","0255","575","455","120","49","624","1233","0","50.61","36.9"
"66","000","00","025","2509","0000","2549","2003","546","175","2724","4945","0","55.09","40.51"
"66","000","00","025","2509","0256","784","624","160","76","860","1520","0","56.58","41.05"
"66","000","00","025","2509","0257","929","736","193","38","967","1905","0","50.76","38.64"
"66","000","00","025","2509","0258","836","643","193","61","897","1520","0","59.01","42.3"
"66","000","00","025","2510","0000","2943","2351","592","159","3102","5692","0","54.5","41.3"
"66","000","00","025","2510","0259","691","538","153","59","750","1385","0","54.15","38.84"
"66","000","00","025","2510","0260","650","505","145","36","686","1212","0","56.6","41.67"
"66","000","00","025","2510","0261","786","652","134","23","809","1432","0","56.49","45.53"
"66","000","00","025","2510","0262","816","656","160","41","857","1663","0","51.53","39.45"
"66","000","00","025","2511","0000","3787","3056","731","204","3991","7249","0","55.06","42.16"
"66","000","00","025","2511","0263","712","558","154","40","752","1422","0","52.88","39.24"
"66","000","00","025","2511","0264","753","596","157","60","813","1616","0","50.31","36.88"
"66","000","00","025","2511","0265","779","633","146","59","838","1422","0","58.93","44.51"
"66","000","00","025","2511","0266","663","555","108","25","688","1165","0","59.06","47.64"
"66","000","00","025","2511","0267","880","714","166","20","900","1624","0","55.42","43.97"
"66","000","00","025","2512","0000","1397","1116","281","94","1491","2556","0","58.33","43.66"
"66","000","00","025","2512","0268","859","691","168","46","905","1613","0","56.11","42.84"
"66","000","00","025","2512","0269","538","425","113","48","586","943","0","62.14","45.07"
"66","000","00","025","2513","0000","3138","2489","649","262","3400","6091","0","55.82","40.86"
"66","000","00","025","2513","0270","762","591","171","90","852","1595","0","53.42","37.05"
"66","000","00","025","2513","0271","810","661","149","78","888","1508","0","58.89","43.83"
"66","000","00","025","2513","0272","745","594","151","43","788","1479","0","53.28","40.16"
"66","000","00","025","2513","0273","821","643","178","51","872","1509","0","57.79","42.61"
"66","000","00","025","2514","0000","868","693","175","68","936","1582","0","59.17","43.81"
"66","000","00","025","2514","0274","868","693","175","68","936","1582","0","59.17","43.81"
"66","000","00","025","2515","0000","2643","2026","617","175","2818","4692","0","60.06","43.18"
"66","000","00","025","2515","0280","623","480","143","39","662","1121","0","59.05","42.82"
"66","000","00","025","2515","0281","577","437","140","38","615","987","0","62.31","44.28"
"66","000","00","025","2515","0282","641","461","180","56","697","1206","0","57.79","38.23"
"66","000","00","025","2515","0283","802","648","154","42","844","1378","0","61.25","47.02"
"66","000","00","025","2516","0000","4656","3692","964","267","4923","8473","0","58.1","43.57"
"66","000","00","025","2516","0275","919","737","182","56","975","1725","0","56.52","42.72"
"66","000","00","025","2516","0276","858","712","146","46","904","1616","0","55.94","44.06"
"66","000","00","025","2516","0277","925","738","187","49","974","1657","0","58.78","44.54"
"66","000","00","025","2516","0278","977","781","196","59","1036","1774","0","58.4","44.02"
"66","000","00","025","2516","0279","977","724","253","57","1034","1701","0","60.79","42.56"
"66","000","00","026","0000","0000","30644","24158","6486","2571","33215","55225","65632","60.14","43.74"
"66","000","00","026","2601","0000","709","559","150","34","743","1205","0","61.66","46.39"
"66","000","00","026","2601","1470","709","559","150","34","743","1205","0","61.66","46.39"
"66","000","00","026","2602","0000","5093","4031","1062","325","5418","9281","0","58.38","43.43"
"66","000","00","026","2602","1471","866","666","200","51","917","1620","0","56.6","41.11"
"66","000","00","026","2602","1472","893","713","180","61","954","1559","0","61.19","45.73"
"66","000","00","026","2602","1473","893","702","191","61","954","1660","0","57.47","42.29"
"66","000","00","026","2602","1474","925","734","191","50","975","1602","0","60.86","45.82"
"66","000","00","026","2602","1475","683","547","136","45","728","1325","0","54.94","41.28"
"66","000","00","026","2602","1476","833","669","164","57","890","1515","0","58.75","44.16"
"66","000","00","026","2603","0000","2426","1886","540","188","2614","4738","0","55.17","39.81"
"66","000","00","026","2603","1477","804","623","181","75","879","1561","0","56.31","39.91"
"66","000","00","026","2603","1478","846","656","190","62","908","1691","0","53.7","38.79"
"66","000","00","026","2603","1479","776","607","169","51","827","1486","0","55.65","40.85"
"66","000","00","026","2604","0000","1340","1079","261","119","1459","2333","0","62.54","46.25"
"66","000","00","026","2604","1480","557","423","134","55","612","975","0","62.77","43.38"
"66","000","00","026","2604","1481","783","656","127","64","847","1358","0","62.37","48.31"
"66","000","00","026","2605","0000","1224","981","243","92","1316","1996","0","65.93","49.15"
"66","000","00","026","2605","1482","720","569","151","32","752","1141","0","65.91","49.87"
"66","000","00","026","2605","1483","504","412","92","60","564","855","0","65.96","48.19"
"66","000","00","026","2606","0000","648","513","135","72","720","1202","0","59.9","42.68"
"66","000","00","026","2606","1484","648","513","135","72","720","1202","0","59.9","42.68"
"66","000","00","026","2607","0000","554","437","117","46","600","1078","0","55.66","40.54"
"66","000","00","026","2607","1485","554","437","117","46","600","1078","0","55.66","40.54"
"66","000","00","026","2608","0000","3348","2789","559","224","3572","5834","0","61.23","47.81"
"66","000","00","026","2608","1486","826","644","182","69","895","1456","0","61.47","44.23"
"66","000","00","026","2608","1487","918","817","101","42","960","1573","0","61.03","51.94"
"66","000","00","026","2608","1488","887","728","159","51","938","1591","0","58.96","45.76"
"66","000","00","026","2608","1489","717","600","117","62","779","1214","0","64.17","49.42"
"66","000","00","026","2609","0000","1662","1340","322","152","1814","2936","0","61.78","45.64"
"66","000","00","026","2609","1508","777","637","140","73","850","1363","0","62.36","46.74"
"66","000","00","026","2609","1509","885","703","182","79","964","1573","0","61.28","44.69"
"66","000","00","026","2610","0000","2075","1637","438","183","2258","3910","0","57.75","41.87"
"66","000","00","026","2610","1490","660","528","132","63","723","1267","0","57.06","41.67"
"66","000","00","026","2610","1491","691","558","133","66","757","1277","0","59.28","43.7"
"66","000","00","026","2610","1492","724","551","173","54","778","1366","0","56.95","40.34"
"66","000","00","026","2611","0000","1144","872","272","83","1227","1857","0","66.07","46.96"
"66","000","00","026","2611","1493","642","487","155","44","686","994","0","69.01","48.99"
"66","000","00","026","2611","1494","502","385","117","39","541","863","0","62.69","44.61"
"66","000","00","026","2612","0000","1289","983","306","121","1410","2436","0","57.88","40.35"
"66","000","00","026","2612","1495","680","510","170","50","730","1274","0","57.3","40.03"
"66","000","00","026","2612","1496","609","473","136","71","680","1162","0","58.52","40.71"
"66","000","00","026","2613","0000","1422","1112","310","144","1566","2574","0","60.84","43.2"
"66","000","00","026","2613","1497","694","543","151","83","777","1252","0","62.06","43.37"
"66","000","00","026","2613","1498","728","569","159","61","789","1322","0","59.68","43.04"
"66","000","00","026","2614","0000","1382","1071","311","141","1523","2642","0","57.65","40.54"
"66","000","00","026","2614","1504","645","493","152","69","714","1314","0","54.34","37.52"
"66","000","00","026","2614","1505","737","578","159","72","809","1328","0","60.92","43.52"
"66","000","00","026","2615","0000","1147","902","245","133","1280","2077","0","61.63","43.43"
"66","000","00","026","2615","1506","523","406","117","67","590","989","0","59.66","41.05"
"66","000","00","026","2615","1507","624","496","128","66","690","1088","0","63.42","45.59"
"66","000","00","026","2616","0000","587","457","130","62","649","1117","0","58.1","40.91"
"66","000","00","026","2616","1510","587","457","130","62","649","1117","0","58.1","40.91"
"66","000","00","026","2617","0000","1399","1059","340","141","1540","2366","0","65.09","44.76"
"66","000","00","026","2617","1511","786","603","183","71","857","1342","0","63.86","44.93"
"66","000","00","026","2617","1512","613","456","157","70","683","1024","0","66.7","44.53"
"66","000","00","026","2618","0000","1289","945","344","141","1430","2272","0","62.94","41.59"
"66","000","00","026","2618","1499","639","475","164","64","703","1116","0","62.99","42.56"
"66","000","00","026","2618","1500","650","470","180","77","727","1156","0","62.89","40.66"
"66","000","00","026","2619","0000","1234","978","256","114","1348","2075","0","64.96","47.13"
"66","000","00","026","2619","1501","659","526","133","61","720","1147","0","62.77","45.86"
"66","000","00","026","2619","1502","575","452","123","53","628","928","0","67.67","48.71"
"66","000","00","026","2620","0000","672","527","145","56","728","1296","0","56.17","40.66"
"66","000","00","026","2620","1503","672","527","145","56","728","1296","0","56.17","40.66"
"66","000","00","027","0000","0000","80144","63860","16284","5343","85487","157926","191097","54.13","40.44"
"66","000","00","027","2701","0000","2746","2147","599","217","2963","5448","0","54.39","39.41"
"66","000","00","027","2701","1271","911","685","226","84","995","1821","0","54.64","37.62"
"66","000","00","027","2701","1272","794","631","163","46","840","1680","0","50.0","37.56"
"66","000","00","027","2701","1273","1041","831","210","87","1128","1947","0","57.94","42.68"
"66","000","00","027","2702","0000","3028","2279","749","201","3229","5757","0","56.09","39.59"
"66","000","00","027","2702","1274","1048","819","229","94","1142","1910","0","59.79","42.88"
"66","000","00","027","2702","1275","958","641","317","49","1007","1894","0","53.17","33.84"
"66","000","00","027","2702","1276","1022","819","203","58","1080","1953","0","55.3","41.94"
"66","000","00","027","2703","0000","2022","1621","401","115","2137","4067","0","52.54","39.86"
"66","000","00","027","2703","1281","1004","799","205","77","1081","2011","0","53.75","39.73"
"66","000","00","027","2703","1282","1018","822","196","38","1056","2056","0","51.36","39.98"
"66","000","00","027","2704","0000","1863","1430","433","129","1992","3317","0","60.05","43.11"
"66","000","00","027","2704","1287","1064","824","240","66","1130","1886","0","59.92","43.69"
"66","000","00","027","2704","1288","799","606","193","63","862","1431","0","60.24","42.35"
"66","000","00","027","2705","0000","1468","1144","324","118","1586","2924","0","54.24","39.12"
"66","000","00","027","2705","1297","673","528","145","79","752","1378","0","54.57","38.32"
"66","000","00","027","2705","1298","795","616","179","39","834","1546","0","53.95","39.84"
"66","000","00","027","2706","0000","2053","1662","391","142","2195","4083","0","53.76","40.71"
"66","000","00","027","2706","1291","1031","843","188","80","1111","2048","0","54.25","41.16"
"66","000","00","027","2706","1292","1022","819","203","62","1084","2035","0","53.27","40.25"
"66","000","00","027","2707","0000","2997","2418","579","195","3192","6114","0","52.21","39.55"
"66","000","00","027","2707","1316","873","739","134","39","912","1623","0","56.19","45.53"
"66","000","00","027","2707","1317","709","564","145","55","764","1548","0","49.35","36.43"
"66","000","00","027","2707","1318","737","596","141","58","795","1442","0","55.13","41.33"
"66","000","00","027","2707","1319","678","519","159","43","721","1501","0","48.03","34.58"
"66","000","00","027","2708","0000","1662","1361","301","124","1786","3605","0","49.54","37.75"
"66","000","00","027","2708","1312","934","761","173","83","1017","1654","0","61.49","46.01"
"66","000","00","027","2708","1313","728","600","128","41","769","1951","0","39.42","30.75"
"66","000","00","027","2709","0000","1814","1487","327","140","1954","3281","0","59.56","45.32"
"66","000","00","027","2709","1301","875","704","171","80","955","1582","0","60.37","44.5"
"66","000","00","027","2709","1302","939","783","156","60","999","1699","0","58.8","46.09"
"66","000","00","027","2710","0000","2488","2014","474","154","2642","5163","0","51.17","39.01"
"66","000","00","027","2710","1307","857","696","161","43","900","1776","0","50.68","39.19"
"66","000","00","027","2710","1308","891","712","179","46","937","1729","0","54.19","41.18"
"66","000","00","027","2710","1309","740","606","134","65","805","1658","0","48.55","36.55"
"66","000","00","027","2711","0000","3812","3087","725","214","4026","7262","0","55.44","42.51"
"66","000","00","027","2711","1325","1133","917","216","75","1208","2075","0","58.22","44.19"
"66","000","00","027","2711","1326","849","677","172","56","905","1723","0","52.52","39.29"
"66","000","00","027","2711","1327","1081","897","184","58","1139","2049","0","55.59","43.78"
"66","000","00","027","2711","1328","749","596","153","25","774","1415","0","54.7","42.12"
"66","000","00","027","2712","0000","3726","3002","724","225","3951","7197","0","54.9","41.71"
"66","000","00","027","2712","1335","796","623","173","53","849","1667","0","50.93","37.37"
"66","000","00","027","2712","1336","942","755","187","71","1013","1793","0","56.5","42.11"
"66","000","00","027","2712","1337","1026","866","160","40","1066","1903","0","56.02","45.51"
"66","000","00","027","2712","1338","962","758","204","61","1023","1834","0","55.78","41.33"
"66","000","00","027","2713","0000","2823","2351","472","144","2967","5993","0","49.51","39.23"
"66","000","00","027","2713","1346","822","756","66","57","879","1974","0","44.53","38.3"
"66","000","00","027","2713","1347","974","769","205","46","1020","1828","0","55.8","42.07"
"66","000","00","027","2713","1348","1027","826","201","41","1068","2191","0","48.74","37.7"
"66","000","00","027","2714","0000","880","697","183","93","973","1825","0","53.32","38.19"
"66","000","00","027","2714","1349","880","697","183","93","973","1825","0","53.32","38.19"
"66","000","00","027","2715","0000","603","486","117","81","684","1225","0","55.84","39.67"
"66","000","00","027","2715","1351","603","486","117","81","684","1225","0","55.84","39.67"
"66","000","00","027","2716","0000","1585","1255","330","160","1745","3179","0","54.89","39.48"
"66","000","00","027","2716","1352","887","725","162","60","947","1678","0","56.44","43.21"
"66","000","00","027","2716","1353","698","530","168","100","798","1501","0","53.16","35.31"
"66","000","00","027","2717","0000","1528","1185","343","109","1637","3094","0","52.91","38.3"
"66","000","00","027","2717","1357","643","487","156","27","670","1428","0","46.92","34.1"
"66","000","00","027","2717","1358","885","698","187","82","967","1666","0","58.04","41.9"
"66","000","00","027","2718","0000","2360","1874","486","173","2533","4710","0","53.78","39.79"
"66","000","00","027","2718","1361","622","498","124","45","667","1166","0","57.2","42.71"
"66","000","00","027","2718","1362","980","793","187","77","1057","1790","0","59.05","44.3"
"66","000","00","027","2718","1363","758","583","175","51","809","1754","0","46.12","33.24"
"66","000","00","027","2719","0000","401","309","92","47","448","699","0","64.09","44.21"
"66","000","00","027","2719","1356","401","309","92","47","448","699","0","64.09","44.21"
"66","000","00","027","2720","0000","3561","2847","714","212","3773","6563","0","57.49","43.38"
"66","000","00","027","2720","1277","981","776","205","74","1055","1846","0","57.15","42.04"
"66","000","00","027","2720","1278","828","663","165","48","876","1493","0","58.67","44.41"
"66","000","00","027","2720","1279","842","668","174","55","897","1605","0","55.89","41.62"
"66","000","00","027","2720","1280","910","740","170","35","945","1619","0","58.37","45.71"
"66","000","00","027","2721","0000","2021","1583","438","155","2176","4094","0","53.15","38.67"
"66","000","00","027","2721","1289","978","776","202","73","1051","1930","0","54.46","40.21"
"66","000","00","027","2721","1290","1043","807","236","82","1125","2164","0","51.99","37.29"
"66","000","00","027","2722","0000","1833","1410","423","175","2008","3870","0","51.89","36.43"
"66","000","00","027","2722","1293","847","641","206","86","933","1685","0","55.37","38.04"
"66","000","00","027","2722","1294","986","769","217","89","1075","2185","0","49.2","35.19"
"66","000","00","027","2723","0000","1421","1127","294","78","1499","2773","0","54.06","40.64"
"66","000","00","027","2723","1295","588","463","125","26","614","1176","0","52.21","39.37"
"66","000","00","027","2723","1296","833","664","169","52","885","1597","0","55.42","41.58"
"66","000","00","027","2724","0000","1854","1489","365","143","1997","3691","0","54.1","40.34"
"66","000","00","027","2724","1283","943","764","179","73","1016","1876","0","54.16","40.72"
"66","000","00","027","2724","1284","911","725","186","70","981","1815","0","54.05","39.94"
"66","000","00","027","2725","0000","1239","964","275","115","1354","2285","0","59.26","42.19"
"66","000","00","027","2725","1285","659","505","154","49","708","1281","0","55.27","39.42"
"66","000","00","027","2725","1286","580","459","121","66","646","1004","0","64.34","45.72"
"66","000","00","027","2726","0000","1417","1123","294","170","1587","2943","0","53.92","38.16"
"66","000","00","027","2726","1299","883","701","182","110","993","1890","0","52.54","37.09"
"66","000","00","027","2726","1300","534","422","112","60","594","1053","0","56.41","40.08"
"66","000","00","027","2727","0000","2576","2135","441","94","2670","4703","0","56.77","45.4"
"66","000","00","027","2727","1339","772","638","134","35","807","1526","0","52.88","41.81"
"66","000","00","027","2727","1340","884","743","141","28","912","1483","0","61.5","50.1"
"66","000","00","027","2727","1341","920","754","166","31","951","1694","0","56.14","44.51"
"66","000","00","027","2728","0000","3658","2956","702","167","3825","6795","0","56.29","43.5"
"66","000","00","027","2728","1342","928","739","189","48","976","1952","0","50.0","37.86"
"66","000","00","027","2728","1343","1032","837","195","40","1072","1995","0","53.73","41.95"
"66","000","00","027","2728","1344","738","598","140","23","761","1311","0","58.05","45.61"
"66","000","00","027","2728","1345","960","782","178","56","1016","1537","0","66.1","50.88"
"66","000","00","027","2729","0000","2852","2251","601","148","3000","5574","0","53.82","40.38"
"66","000","00","027","2729","1329","931","741","190","44","975","1778","0","54.84","41.68"
"66","000","00","027","2729","1330","853","663","190","54","907","1706","0","53.17","38.86"
"66","000","00","027","2729","1331","1068","847","221","50","1118","2090","0","53.49","40.53"
"66","000","00","027","2730","0000","2463","1997","466","122","2585","5269","0","49.06","37.9"
"66","000","00","027","2730","1332","990","796","194","50","1040","2093","0","49.69","38.03"
"66","000","00","027","2730","1333","756","612","144","36","792","1688","0","46.92","36.26"
"66","000","00","027","2730","1334","717","589","128","36","753","1488","0","50.6","39.58"
"66","000","00","027","2731","0000","2831","2244","587","164","2995","6065","0","49.38","37.0"
"66","000","00","027","2731","1320","933","740","193","27","960","2025","0","47.41","36.54"
"66","000","00","027","2731","1321","919","740","179","64","983","1885","0","52.15","39.26"
"66","000","00","027","2731","1322","979","764","215","73","1052","2155","0","48.82","35.45"
"66","000","00","027","2732","0000","1694","1321","373","121","1815","3796","0","47.81","34.8"
"66","000","00","027","2732","1323","841","644","197","41","882","1775","0","49.69","36.28"
"66","000","00","027","2732","1324","853","677","176","80","933","2021","0","46.17","33.5"
"66","000","00","027","2733","0000","1881","1543","338","141","2022","3762","0","53.75","41.02"
"66","000","00","027","2733","1310","1003","836","167","64","1067","2010","0","53.08","41.59"
"66","000","00","027","2733","1311","878","707","171","77","955","1752","0","54.51","40.35"
"66","000","00","027","2734","0000","2538","2000","538","144","2682","4401","0","60.94","45.44"
"66","000","00","027","2734","1314","1262","1009","253","87","1349","2170","0","62.17","46.5"
"66","000","00","027","2734","1315","1276","991","285","57","1333","2231","0","59.75","44.42"
"66","000","00","027","2735","0000","1254","980","274","113","1367","2556","0","53.48","38.34"
"66","000","00","027","2735","1303","744","579","165","66","810","1493","0","54.25","38.78"
"66","000","00","027","2735","1304","510","401","109","47","557","1063","0","52.4","37.72"
"66","000","00","027","2736","0000","1229","1013","216","95","1324","2201","0","60.15","46.02"
"66","000","00","027","2736","1305","624","498","126","50","674","1117","0","60.34","44.58"
"66","000","00","027","2736","1306","605","515","90","45","650","1084","0","59.96","47.51"
"66","000","00","027","2737","0000","736","560","176","12","748","1559","0","47.98","35.92"
"66","000","00","027","2737","1350","736","560","176","12","748","1559","0","47.98","35.92"
"66","000","00","027","2738","0000","1870","1450","420","80","1950","3576","0","54.53","40.55"
"66","000","00","027","2738","1354","845","651","194","0","845","1450","0","58.28","44.9"
"66","000","00","027","2738","1355","1025","799","226","80","1105","2126","0","51.98","37.58"
"66","000","00","027","2739","0000","1357","1058","299","113","1470","2507","0","58.64","42.2"
"66","000","00","027","2739","1359","649","489","160","44","693","1241","0","55.84","39.4"
"66","000","00","027","2739","1360","708","569","139","69","777","1266","0","61.37","44.94"
"66","000","00","028","0000","0000","89484","70764","18720","6179","95663","171769","211860","55.69","41.2"
"66","000","00","028","2801","0000","1837","1406","431","165","2002","3508","0","57.07","40.08"
"66","000","00","028","2801","1373","854","668","186","65","919","1697","0","54.15","39.36"
"66","000","00","028","2801","1374","983","738","245","100","1083","1811","0","59.8","40.75"
"66","000","00","028","2802","0000","5063","4016","1047","336","5399","9923","0","54.41","40.47"
"66","000","00","028","2802","1375","932","725","207","57","989","1830","0","54.04","39.62"
"66","000","00","028","2802","1376","822","653","169","109","931","2228","0","41.79","29.31"
"66","000","00","028","2802","1377","1041","841","200","89","1130","1997","0","56.58","42.11"
"66","000","00","028","2802","1378","1258","1030","228","38","1296","2033","0","63.75","50.66"
"66","000","00","028","2802","1379","1010","767","243","43","1053","1835","0","57.38","41.8"
"66","000","00","028","2803","0000","1700","1289","411","147","1847","3418","0","54.04","37.71"
"66","000","00","028","2803","1384","805","629","176","71","876","1621","0","54.04","38.8"
"66","000","00","028","2803","1385","895","660","235","76","971","1797","0","54.03","36.73"
"66","000","00","028","2804","0000","3604","2799","805","219","3823","7122","0","53.68","39.3"
"66","000","00","028","2804","1422","930","752","178","54","984","1875","0","52.48","40.11"
"66","000","00","028","2804","1423","893","685","208","62","955","1670","0","57.19","41.02"
"66","000","00","028","2804","1424","951","734","217","61","1012","1898","0","53.32","38.67"
"66","000","00","028","2804","1425","830","628","202","42","872","1679","0","51.94","37.4"
"66","000","00","028","2805","0000","3586","2852","734","298","3884","6924","0","56.09","41.19"
"66","000","00","028","2805","1386","601","498","103","39","640","1230","0","52.03","40.49"
"66","000","00","028","2805","1387","761","616","145","55","816","1488","0","54.84","41.4"
"66","000","00","028","2805","1388","727","554","173","72","799","1459","0","54.76","37.97"
"66","000","00","028","2805","1389","869","696","173","64","933","1647","0","56.65","42.26"
"66","000","00","028","2805","1390","628","488","140","68","696","1100","0","63.27","44.36"
"66","000","00","028","2806","0000","2098","1692","406","182","2280","3956","0","57.63","42.77"
"66","000","00","028","2806","1434","651","525","126","44","695","1103","0","63.01","47.6"
"66","000","00","028","2806","1435","731","591","140","64","795","1419","0","56.03","41.65"
"66","000","00","028","2806","1436","716","576","140","74","790","1434","0","55.09","40.17"
"66","000","00","028","2807","0000","2741","2186","555","127","2868","5587","0","51.33","39.13"
"66","000","00","028","2807","1437","849","687","162","39","888","1875","0","47.36","36.64"
"66","000","00","028","2807","1438","948","733","215","53","1001","1862","0","53.76","39.37"
"66","000","00","028","2807","1439","944","766","178","35","979","1850","0","52.92","41.41"
"66","000","00","028","2808","0000","4175","3378","797","272","4447","8258","0","53.85","40.91"
"66","000","00","028","2808","1391","760","603","157","47","807","1410","0","57.23","42.77"
"66","000","00","028","2808","1392","883","716","167","74","957","1807","0","52.96","39.62"
"66","000","00","028","2808","1393","687","541","146","62","749","1331","0","56.27","40.65"
"66","000","00","028","2808","1394","922","755","167","45","967","1801","0","53.69","41.92"
"66","000","00","028","2808","1395","923","763","160","44","967","1909","0","50.65","39.97"
"66","000","00","028","2809","0000","1691","1357","334","126","1817","3355","0","54.16","40.45"
"66","000","00","028","2809","1399","863","690","173","77","940","1753","0","53.62","39.36"
"66","000","00","028","2809","1400","828","667","161","49","877","1602","0","54.74","41.64"
"66","000","00","028","2810","0000","2617","2075","542","205","2822","5278","0","53.47","39.31"
"66","000","00","028","2810","1451","944","771","173","54","998","1759","0","56.74","43.83"
"66","000","00","028","2810","1452","869","682","187","72","941","1783","0","52.78","38.25"
"66","000","00","028","2810","1453","804","622","182","79","883","1736","0","50.86","35.83"
"66","000","00","028","2811","0000","3785","3030","755","297","4082","7599","0","53.72","39.87"
"66","000","00","028","2811","1458","946","772","174","81","1027","1836","0","55.94","42.05"
"66","000","00","028","2811","1459","966","763","203","79","1045","1913","0","54.63","39.88"
"66","000","00","028","2811","1460","935","730","205","77","1012","1913","0","52.9","38.16"
"66","000","00","028","2811","1461","938","765","173","60","998","1937","0","51.52","39.49"
"66","000","00","028","2812","0000","2150","1714","436","184","2334","4237","0","55.09","40.45"
"66","000","00","028","2812","1401","601","445","156","66","667","1144","0","58.3","38.9"
"66","000","00","028","2812","1402","791","689","102","71","862","1655","0","52.08","41.63"
"66","000","00","028","2812","1403","758","580","178","47","805","1438","0","55.98","40.33"
"66","000","00","028","2813","0000","533","415","118","61","594","1000","0","59.4","41.5"
"66","000","00","028","2813","1404","533","415","118","61","594","1000","0","59.4","41.5"
"66","000","00","028","2814","0000","4349","3464","885","281","4630","8369","0","55.32","41.39"
"66","000","00","028","2814","1405","884","697","187","72","956","1711","0","55.87","40.74"
"66","000","00","028","2814","1406","854","723","131","11","865","1698","0","50.94","42.58"
"66","000","00","028","2814","1407","989","762","227","86","1075","1914","0","56.17","39.81"
"66","000","00","028","2814","1408","790","630","160","41","831","1465","0","56.72","43.0"
"66","000","00","028","2814","1409","832","652","180","71","903","1581","0","57.12","41.24"
"66","000","00","028","2815","0000","2018","1619","399","115","2133","4438","0","48.06","36.48"
"66","000","00","028","2815","1414","549","414","135","33","582","1204","0","48.34","34.39"
"66","000","00","028","2815","1415","801","650","151","49","850","1761","0","48.27","36.91"
"66","000","00","028","2815","1416","668","555","113","33","701","1473","0","47.59","37.68"
"66","000","00","028","2816","0000","4404","3469","935","378","4782","8428","0","56.74","41.16"
"66","000","00","028","2816","1417","887","693","194","61","948","1675","0","56.6","41.37"
"66","000","00","028","2816","1418","924","765","159","64","988","1755","0","56.3","43.59"
"66","000","00","028","2816","1419","845","657","188","97","942","1593","0","59.13","41.24"
"66","000","00","028","2816","1420","922","707","215","74","996","1799","0","55.36","39.3"
"66","000","00","028","2816","1421","826","647","179","82","908","1606","0","56.54","40.29"
"66","000","00","028","2817","0000","6047","4810","1237","395","6442","11504","0","56.0","41.81"
"66","000","00","028","2817","1462","781","637","144","40","821","1508","0","54.44","42.24"
"66","000","00","028","2817","1463","746","603","143","30","776","1340","0","57.91","45.0"
"66","000","00","028","2817","1464","910","730","180","60","970","1656","0","58.57","44.08"
"66","000","00","028","2817","1465","683","552","131","51","734","1290","0","56.9","42.79"
"66","000","00","028","2817","1466","875","685","190","47","922","1655","0","55.71","41.39"
"66","000","00","028","2817","1467","588","460","128","24","612","1260","0","48.57","36.51"
"66","000","00","028","2817","1468","698","548","150","45","743","1247","0","59.58","43.95"
"66","000","00","028","2817","1469","766","595","171","98","864","1548","0","55.81","38.44"
"66","000","00","028","2818","0000","4956","3501","1455","399","5355","9578","0","55.91","36.55"
"66","000","00","028","2818","1445","815","637","178","77","892","1701","0","52.44","37.45"
"66","000","00","028","2818","1446","763","589","174","68","831","1549","0","53.65","38.02"
"66","000","00","028","2818","1447","860","684","176","64","924","1567","0","58.97","43.65"
"66","000","00","028","2818","1448","856","676","180","59","915","1614","0","56.69","41.88"
"66","000","00","028","2818","1449","957","750","207","83","1040","1811","0","57.43","41.41"
"66","000","00","028","2818","1450","705","165","540","48","753","1336","0","56.36","12.35"
"66","000","00","028","2819","0000","5036","4030","1006","306","5342","10155","0","52.6","39.68"
"66","000","00","028","2819","1364","803","628","175","48","851","1614","0","52.73","38.91"
"66","000","00","028","2819","1365","766","608","158","37","803","1599","0","50.22","38.02"
"66","000","00","028","2819","1366","816","640","176","57","873","1715","0","50.9","37.32"
"66","000","00","028","2819","1367","677","548","129","27","704","1264","0","55.7","43.35"
"66","000","00","028","2819","1368","695","572","123","45","740","1416","0","52.26","40.4"
"66","000","00","028","2819","1369","619","512","107","33","652","1188","0","54.88","43.1"
"66","000","00","028","2819","1370","660","522","138","59","719","1359","0","52.91","38.41"
"66","000","00","028","2820","0000","1561","1217","344","110","1671","2860","0","58.43","42.55"
"66","000","00","028","2820","1371","785","615","170","58","843","1457","0","57.86","42.21"
"66","000","00","028","2820","1372","776","602","174","52","828","1403","0","59.02","42.91"
"66","000","00","028","2821","0000","3259","2658","601","165","3424","5775","0","59.29","46.03"
"66","000","00","028","2821","1380","683","542","141","36","719","1268","0","56.7","42.74"
"66","000","00","028","2821","1381","892","716","176","57","949","1645","0","57.69","43.53"
"66","000","00","028","2821","1382","874","744","130","40","914","1561","0","58.55","47.66"
"66","000","00","028","2821","1383","810","656","154","32","842","1301","0","64.72","50.42"
"66","000","00","028","2822","0000","2146","1724","422","166","2312","4102","0","56.36","42.03"
"66","000","00","028","2822","1426","689","554","135","58","747","1373","0","54.41","40.35"
"66","000","00","028","2822","1427","689","538","151","63","752","1299","0","57.89","41.42"
"66","000","00","028","2822","1428","768","632","136","45","813","1430","0","56.85","44.2"
"66","000","00","028","2823","0000","5572","4533","1039","238","5810","9149","0","63.5","49.55"
"66","000","00","028","2823","1429","1089","869","220","49","1138","1805","0","63.05","48.14"
"66","000","00","028","2823","1430","1125","900","225","35","1160","1806","0","64.23","49.83"
"66","000","00","028","2823","1431","1127","918","209","62","1189","1826","0","65.12","50.27"
"66","000","00","028","2823","1432","1134","931","203","38","1172","1805","0","64.93","51.58"
"66","000","00","028","2823","1433","1097","915","182","54","1151","1907","0","60.36","47.98"
"66","000","00","028","2824","0000","4728","3733","995","305","5033","8472","0","59.41","44.06"
"66","000","00","028","2824","1440","876","700","176","56","932","1622","0","57.46","43.16"
"66","000","00","028","2824","1441","932","736","196","76","1008","1638","0","61.54","44.93"
"66","000","00","028","2824","1442","929","697","232","88","1017","1633","0","62.28","42.68"
"66","000","00","028","2824","1443","902","706","196","45","947","1662","0","56.98","42.48"
"66","000","00","028","2824","1444","1089","894","195","40","1129","1917","0","58.89","46.64"
"66","000","00","028","2825","0000","2624","2099","525","218","2842","5238","0","54.26","40.07"
"66","000","00","028","2825","1396","783","620","163","77","860","1699","0","50.62","36.49"
"66","000","00","028","2825","1397","874","704","170","69","943","1627","0","57.96","43.27"
"66","000","00","028","2825","1398","967","775","192","72","1039","1912","0","54.34","40.53"
"66","000","00","028","2826","0000","4038","3165","873","271","4309","7648","0","56.34","41.38"
"66","000","00","028","2826","1454","971","754","217","76","1047","1874","0","55.87","40.23"
"66","000","00","028","2826","1455","981","770","211","85","1066","1889","0","56.43","40.76"
"66","000","00","028","2826","1456","1015","795","220","50","1065","1947","0","54.7","40.83"
"66","000","00","028","2826","1457","1071","846","225","60","1131","1938","0","58.36","43.65"
"66","000","00","028","2827","0000","3166","2533","633","213","3379","5888","0","57.39","43.02"
"66","000","00","028","2827","1410","823","665","158","78","901","1509","0","59.71","44.07"
"66","000","00","028","2827","1411","787","642","145","34","821","1570","0","52.29","40.89"
"66","000","00","028","2827","1412","796","625","171","43","839","1425","0","58.88","43.86"
"66","000","00","028","2827","1413","760","601","159","58","818","1384","0","59.1","43.42"
"66","000","00","029","0000","0000","5270","4219","1051","393","5663","9498","11066","59.62","44.42"
"66","000","00","029","2901","0000","1133","885","248","104","1237","1919","0","64.46","46.12"
"66","000","00","029","2901","1585","567","426","141","47","614","956","0","64.23","44.56"
"66","000","00","029","2901","1586","566","459","107","57","623","963","0","64.69","47.66"
"66","000","00","029","2902","0000","245","182","63","14","259","456","0","56.8","39.91"
"66","000","00","029","2902","1587","245","182","63","14","259","456","0","56.8","39.91"
"66","000","00","029","2903","0000","940","761","179","68","1008","1647","0","61.2","46.21"
"66","000","00","029","2903","1588","590","486","104","46","636","1011","0","62.91","48.07"
"66","000","00","029","2903","1589","350","275","75","22","372","636","0","58.49","43.24"
"66","000","00","029","2904","0000","297","238","59","9","306","451","0","67.85","52.77"
"66","000","00","029","2904","1595","297","238","59","9","306","451","0","67.85","52.77"
"66","000","00","029","2905","0000","679","555","124","48","727","1051","0","69.17","52.81"
"66","000","00","029","2905","1590","120","90","30","8","128","270","0","47.41","33.33"
"66","000","00","029","2905","1591","329","280","49","28","357","460","0","77.61","60.87"
"66","000","00","029","2905","1592","230","185","45","12","242","321","0","75.39","57.63"
"66","000","00","029","2906","0000","642","504","138","48","690","1119","0","61.66","45.04"
"66","000","00","029","2906","1593","459","365","94","31","490","783","0","62.58","46.62"
"66","000","00","029","2906","1594","183","139","44","17","200","336","0","59.52","41.37"
"66","000","00","029","2907","0000","931","757","174","78","1009","1985","0","50.83","38.14"
"66","000","00","029","2907","1596","171","130","41","20","191","366","0","52.19","35.52"
"66","000","00","029","2907","1597","319","272","47","12","331","771","0","42.93","35.28"
"66","000","00","029","2907","1598","290","239","51","28","318","574","0","55.4","41.64"
"66","000","00","029","2907","1599","151","116","35","18","169","274","0","61.68","42.34"
"66","000","00","029","2908","0000","403","337","66","24","427","870","0","49.08","38.74"
"66","000","00","029","2908","1600","80","64","16","6","86","157","0","54.78","40.76"
"66","000","00","029","2908","1601","323","273","50","18","341","713","0","47.83","38.29"
"67","000","00","000","0000","0000","738868","560594","178274","60334","799202","1594821","1883804","50.11","35.15"
"67","000","00","001","0000","0000","29623","22908","6715","1878","31501","64949","77651","48.5","35.27"
"67","000","00","001","0101","0000","2275","1763","512","180","2455","4741","0","51.78","37.19"
"67","000","00","001","0101","0116","723","557","166","64","787","1693","0","46.49","32.9"
"67","000","00","001","0101","0117","806","640","166","62","868","1561","0","55.61","41.0"
"67","000","00","001","0101","0118","746","566","180","54","800","1487","0","53.8","38.06"
"67","000","00","001","0102","0000","1083","831","252","61","1144","2299","0","49.76","36.15"
"67","000","00","001","0102","0119","582","443","139","28","610","1232","0","49.51","35.96"
"67","000","00","001","0102","0120","501","388","113","33","534","1067","0","50.05","36.36"
"67","000","00","001","0103","0000","1321","1035","286","65","1386","2885","0","48.04","35.88"
"67","000","00","001","0103","0121","591","436","155","32","623","1419","0","43.9","30.73"
"67","000","00","001","0103","0122","730","599","131","33","763","1466","0","52.05","40.86"
"67","000","00","001","0107","0000","1384","1040","344","73","1457","2940","0","49.56","35.37"
"67","000","00","001","0107","0126","453","325","128","36","489","888","0","55.07","36.6"
"67","000","00","001","0107","0127","524","391","133","16","540","1115","0","48.43","35.07"
"67","000","00","001","0107","0128","407","324","83","21","428","937","0","45.68","34.58"
"67","000","00","001","0108","0000","2039","1591","448","112","2151","4214","0","51.04","37.76"
"67","000","00","001","0108","0129","644","489","155","36","680","1387","0","49.03","35.26"
"67","000","00","001","0108","0130","705","557","148","43","748","1526","0","49.02","36.5"
"67","000","00","001","0108","0131","690","545","145","33","723","1301","0","55.57","41.89"
"67","000","00","001","0109","0000","639","500","139","44","683","1193","0","57.25","41.91"
"67","000","00","001","0109","0136","639","500","139","44","683","1193","0","57.25","41.91"
"67","000","00","001","0110","0000","507","392","115","7","514","1439","0","35.72","27.24"
"67","000","00","001","0110","0137","507","392","115","7","514","1439","0","35.72","27.24"
"67","000","00","001","0112","0000","938","733","205","46","984","2460","0","40.0","29.8"
"67","000","00","001","0112","0140","462","352","110","29","491","1233","0","39.82","28.55"
"67","000","00","001","0112","0141","476","381","95","17","493","1227","0","40.18","31.05"
"67","000","00","001","0113","0000","949","736","213","65","1014","1797","0","56.43","40.96"
"67","000","00","001","0113","0138","760","599","161","45","805","1438","0","55.98","41.66"
"67","000","00","001","0113","0139","189","137","52","20","209","359","0","58.22","38.16"
"67","000","00","001","0114","0000","1284","991","293","44","1328","3250","0","40.86","30.49"
"67","000","00","001","0114","0142","541","425","116","23","564","1320","0","42.73","32.2"
"67","000","00","001","0114","0143","743","566","177","21","764","1930","0","39.59","29.33"
"67","000","00","001","0115","0000","1979","1521","458","140","2119","4419","0","47.95","34.42"
"67","000","00","001","0115","0150","775","592","183","52","827","1595","0","51.85","37.12"
"67","000","00","001","0115","0151","388","305","83","18","406","959","0","42.34","31.8"
"67","000","00","001","0115","0152","816","624","192","70","886","1865","0","47.51","33.46"
"67","000","00","001","0116","0000","692","510","182","87","779","1678","0","46.42","30.39"
"67","000","00","001","0116","0153","692","510","182","87","779","1678","0","46.42","30.39"
"67","000","00","001","0117","0000","557","430","127","59","616","1373","0","44.87","31.32"
"67","000","00","001","0117","0154","557","430","127","59","616","1373","0","44.87","31.32"
"67","000","00","001","0118","0000","582","413","169","31","613","1722","0","35.6","23.98"
"67","000","00","001","0118","0155","488","348","140","27","515","1431","0","35.99","24.32"
"67","000","00","001","0118","0156","94","65","29","4","98","291","0","33.68","22.34"
"67","000","00","001","0119","0000","750","549","201","41","791","1749","0","45.23","31.39"
"67","000","00","001","0119","0157","750","549","201","41","791","1749","0","45.23","31.39"
"67","000","00","001","0120","0000","1682","1350","332","130","1812","3683","0","49.2","36.65"
"67","000","00","001","0120","0158","786","618","168","42","828","1862","0","44.47","33.19"
"67","000","00","001","0120","0159","896","732","164","88","984","1821","0","54.04","40.2"
"67","000","00","001","0121","0000","790","621","169","56","846","1845","0","45.85","33.66"
"67","000","00","001","0121","0160","790","621","169","56","846","1845","0","45.85","33.66"
"67","000","00","001","0125","0000","736","535","201","92","828","1644","0","50.36","32.54"
"67","000","00","001","0125","0163","353","252","101","57","410","703","0","58.32","35.85"
"67","000","00","001","0125","0164","383","283","100","35","418","941","0","44.42","30.07"
"67","000","00","001","0126","0000","312","245","67","12","324","944","0","34.32","25.95"
"67","000","00","001","0126","0161","181","143","38","9","190","542","0","35.06","26.38"
"67","000","00","001","0126","0162","131","102","29","3","134","402","0","33.33","25.37"
"67","000","00","001","0127","0000","2287","1790","497","144","2431","4729","0","51.41","37.85"
"67","000","00","001","0127","0144","735","565","170","52","787","1501","0","52.43","37.64"
"67","000","00","001","0127","0145","678","539","139","37","715","1475","0","48.47","36.54"
"67","000","00","001","0127","0146","874","686","188","55","929","1753","0","52.99","39.13"
"67","000","00","001","0128","0000","2287","1782","505","107","2394","4922","0","48.64","36.2"
"67","000","00","001","0128","0147","809","621","188","36","845","1748","0","48.34","35.53"
"67","000","00","001","0128","0148","831","656","175","47","878","1741","0","50.43","37.68"
"67","000","00","001","0128","0149","647","505","142","24","671","1433","0","46.82","35.24"
"67","000","00","001","0129","0000","3261","2585","676","174","3435","6235","0","55.09","41.46"
"67","000","00","001","0129","0132","806","627","179","58","864","1538","0","56.18","40.77"
"67","000","00","001","0129","0133","806","635","171","47","853","1584","0","53.85","40.09"
"67","000","00","001","0129","0134","855","693","162","37","892","1583","0","56.35","43.78"
"67","000","00","001","0129","0135","794","630","164","32","826","1530","0","53.99","41.18"
"67","000","00","001","0130","0000","1289","965","324","108","1397","2788","0","50.11","34.61"
"67","000","00","001","0130","0123","510","376","134","55","565","932","0","60.62","40.34"
"67","000","00","001","0130","0124","460","336","124","25","485","1099","0","44.13","30.57"
"67","000","00","001","0130","0125","319","253","66","28","347","757","0","45.84","33.42"
"67","000","00","002","0000","0000","9345","6972","2373","886","10231","22121","25397","46.25","31.52"
"67","000","00","002","0201","0000","721","539","182","85","806","1517","0","53.13","35.53"
"67","000","00","002","0201","0085","486","375","111","64","550","1037","0","53.04","36.16"
"67","000","00","002","0201","0086","235","164","71","21","256","480","0","53.33","34.17"
"67","000","00","002","0208","0000","1603","1188","415","109","1712","3743","0","45.74","31.74"
"67","000","00","002","0208","0093","334","251","83","21","355","863","0","41.14","29.08"
"67","000","00","002","0208","0094","585","424","161","24","609","1373","0","44.36","30.88"
"67","000","00","002","0208","0095","684","513","171","64","748","1507","0","49.64","34.04"
"67","000","00","002","0210","0000","283","204","79","40","323","921","0","35.07","22.15"
"67","000","00","002","0210","0099","283","204","79","40","323","921","0","35.07","22.15"
"67","000","00","002","0211","0000","1653","1260","393","169","1822","3640","0","50.05","34.62"
"67","000","00","002","0211","0096","659","489","170","67","726","1374","0","52.84","35.59"
"67","000","00","002","0211","0097","513","393","120","49","562","1244","0","45.18","31.59"
"67","000","00","002","0211","0098","481","378","103","53","534","1022","0","52.25","36.99"
"67","000","00","002","0214","0000","661","483","178","62","723","1653","0","43.74","29.22"
"67","000","00","002","0214","0107","386","286","100","27","413","925","0","44.65","30.92"
"67","000","00","002","0214","0108","275","197","78","35","310","728","0","42.58","27.06"
"67","000","00","002","0226","0000","747","581","166","77","824","1454","0","56.67","39.96"
"67","000","00","002","0226","0087","348","270","78","30","378","636","0","59.43","42.45"
"67","000","00","002","0226","0088","141","107","34","11","152","321","0","47.35","33.33"
"67","000","00","002","0226","0089","258","204","54","36","294","497","0","59.15","41.05"
"67","000","00","002","0227","0000","793","623","170","54","847","1607","0","52.71","38.77"
"67","000","00","002","0227","0090","401","312","89","13","414","759","0","54.55","41.11"
"67","000","00","002","0227","0091","144","124","20","18","162","341","0","47.51","36.36"
"67","000","00","002","0227","0092","248","187","61","23","271","507","0","53.45","36.88"
"67","000","00","002","0228","0000","646","474","172","56","702","1539","0","45.61","30.8"
"67","000","00","002","0228","0102","326","242","84","13","339","761","0","44.55","31.8"
"67","000","00","002","0228","0103","126","91","35","10","136","285","0","47.72","31.93"
"67","000","00","002","0228","0104","194","141","53","33","227","493","0","46.04","28.6"
"67","000","00","002","0229","0000","621","446","175","53","674","1583","0","42.58","28.17"
"67","000","00","002","0229","0100","411","280","131","46","457","847","0","53.96","33.06"
"67","000","00","002","0229","0101","210","166","44","7","217","736","0","29.48","22.55"
"67","000","00","002","0230","0000","327","243","84","27","354","1013","0","34.95","23.99"
"67","000","00","002","0230","0105","212","159","53","16","228","621","0","36.71","25.6"
"67","000","00","002","0230","0106","115","84","31","11","126","392","0","32.14","21.43"
"67","000","00","002","0231","0000","383","266","117","46","429","1120","0","38.3","23.75"
"67","000","00","002","0231","0112","258","182","76","27","285","755","0","37.75","24.11"
"67","000","00","002","0231","0113","125","84","41","19","144","365","0","39.45","23.01"
"67","000","00","002","0232","0000","354","263","91","52","406","902","0","45.01","29.16"
"67","000","00","002","0232","0109","61","44","17","19","80","214","0","37.38","20.56"
"67","000","00","002","0232","0110","164","131","33","12","176","387","0","45.48","33.85"
"67","000","00","002","0232","0111","129","88","41","21","150","301","0","49.83","29.24"
"67","000","00","002","0233","0000","553","402","151","56","609","1429","0","42.62","28.13"
"67","000","00","002","0233","0114","363","260","103","31","394","935","0","42.14","27.81"
"67","000","00","002","0233","0115","190","142","48","25","215","494","0","43.52","28.74"
"67","000","00","003","0000","0000","9351","6981","2370","909","10260","24894","28152","41.21","28.04"
"67","000","00","003","0301","0000","800","609","191","89","889","1722","0","51.63","35.37"
"67","000","00","003","0301","0030","549","410","139","72","621","1176","0","52.81","34.86"
"67","000","00","003","0301","0031","251","199","52","17","268","546","0","49.08","36.45"
"67","000","00","003","0302","0000","1416","1072","344","105","1521","2921","0","52.07","36.7"
"67","000","00","003","0302","0032","430","319","111","30","460","859","0","53.55","37.14"
"67","000","00","003","0302","0033","476","367","109","38","514","946","0","54.33","38.79"
"67","000","00","003","0302","0034","510","386","124","37","547","1116","0","49.01","34.59"
"67","000","00","003","0303","0000","466","357","109","29","495","1397","0","35.43","25.55"
"67","000","00","003","0303","0035","466","357","109","29","495","1397","0","35.43","25.55"
"67","000","00","003","0304","0000","628","491","137","71","699","1627","0","42.96","30.18"
"67","000","00","003","0304","0036","257","197","60","20","277","756","0","36.64","26.06"
"67","000","00","003","0304","0037","371","294","77","51","422","871","0","48.45","33.75"
"67","000","00","003","0305","0000","406","314","92","34","440","897","0","49.05","35.01"
"67","000","00","003","0305","0038","406","314","92","34","440","897","0","49.05","35.01"
"67","000","00","003","0306","0000","436","323","113","56","492","1356","0","36.28","23.82"
"67","000","00","003","0306","0039","222","165","57","39","261","784","0","33.29","21.05"
"67","000","00","003","0306","0040","214","158","56","17","231","572","0","40.38","27.62"
"67","000","00","003","0307","0000","126","102","24","7","133","457","0","29.1","22.32"
"67","000","00","003","0307","0041","126","102","24","7","133","457","0","29.1","22.32"
"67","000","00","003","0308","0000","186","150","36","10","196","600","0","32.67","25.0"
"67","000","00","003","0308","0042","186","150","36","10","196","600","0","32.67","25.0"
"67","000","00","003","0309","0000","100","74","26","6","106","375","0","28.27","19.73"
"67","000","00","003","0309","0043","100","74","26","6","106","375","0","28.27","19.73"
"67","000","00","003","0310","0000","115","82","33","10","125","508","0","24.61","16.14"
"67","000","00","003","0310","0044","115","82","33","10","125","508","0","24.61","16.14"
"67","000","00","003","0311","0000","365","276","89","26","391","1305","0","29.96","21.15"
"67","000","00","003","0311","0047","226","167","59","12","238","799","0","29.79","20.9"
"67","000","00","003","0311","0048","139","109","30","14","153","506","0","30.24","21.54"
"67","000","00","003","0312","0000","266","197","69","23","289","1022","0","28.28","19.28"
"67","000","00","003","0312","0045","167","123","44","11","178","631","0","28.21","19.49"
"67","000","00","003","0312","0046","99","74","25","12","111","391","0","28.39","18.93"
"67","000","00","003","0314","0000","460","348","112","23","483","1443","0","33.47","24.12"
"67","000","00","003","0314","0051","224","165","59","9","233","744","0","31.32","22.18"
"67","000","00","003","0314","0052","236","183","53","14","250","699","0","35.77","26.18"
"67","000","00","003","0318","0000","327","246","81","52","379","884","0","42.87","27.83"
"67","000","00","003","0318","0055","327","246","81","52","379","884","0","42.87","27.83"
"67","000","00","003","0319","0000","178","136","42","12","190","740","0","25.68","18.38"
"67","000","00","003","0319","0056","178","136","42","12","190","740","0","25.68","18.38"
"67","000","00","003","0320","0000","493","362","131","50","543","1334","0","40.7","27.14"
"67","000","00","003","0320","0057","493","362","131","50","543","1334","0","40.7","27.14"
"67","000","00","003","0321","0000","291","210","81","61","352","723","0","48.69","29.05"
"67","000","00","003","0321","0058","291","210","81","61","352","723","0","48.69","29.05"
"67","000","00","003","0322","0000","312","220","92","61","373","682","0","54.69","32.26"
"67","000","00","003","0322","0059","312","220","92","61","373","682","0","54.69","32.26"
"67","000","00","003","0325","0000","791","564","227","56","847","2011","0","42.12","28.05"
"67","000","00","003","0325","0049","301","220","81","24","325","832","0","39.06","26.44"
"67","000","00","003","0325","0050","490","344","146","32","522","1179","0","44.27","29.18"
"67","000","00","003","0326","0000","605","437","168","63","668","1492","0","44.77","29.29"
"67","000","00","003","0326","0053","202","147","55","8","210","633","0","33.18","23.22"
"67","000","00","003","0326","0054","403","290","113","55","458","859","0","53.32","33.76"
"67","000","00","003","0327","0000","584","411","173","65","649","1398","0","46.42","29.4"
"67","000","00","003","0327","0060","394","283","111","44","438","855","0","51.23","33.1"
"67","000","00","003","0327","0061","190","128","62","21","211","543","0","38.86","23.57"
"67","000","00","004","0000","0000","8086","6152","1934","937","9023","18804","21212","47.98","32.72"
"67","000","00","004","0401","0000","835","614","221","61","896","1791","0","50.03","34.28"
"67","000","00","004","0401","0165","511","381","130","50","561","1166","0","48.11","32.68"
"67","000","00","004","0401","0166","324","233","91","11","335","625","0","53.6","37.28"
"67","000","00","004","0402","0000","694","548","146","46","740","1572","0","47.07","34.86"
"67","000","00","004","0402","0167","281","218","63","27","308","738","0","41.73","29.54"
"67","000","00","004","0402","0168","413","330","83","19","432","834","0","51.8","39.57"
"67","000","00","004","0403","0000","455","342","113","41","496","1104","0","44.93","30.98"
"67","000","00","004","0403","0169","455","342","113","41","496","1104","0","44.93","30.98"
"67","000","00","004","0404","0000","1212","947","265","141","1353","2735","0","49.47","34.63"
"67","000","00","004","0404","0170","401","304","97","18","419","1015","0","41.28","29.95"
"67","000","00","004","0404","0171","811","643","168","123","934","1720","0","54.3","37.38"
"67","000","00","004","0405","0000","584","448","136","71","655","1391","0","47.09","32.21"
"67","000","00","004","0405","0172","584","448","136","71","655","1391","0","47.09","32.21"
"67","000","00","004","0406","0000","277","221","56","27","304","743","0","40.92","29.74"
"67","000","00","004","0406","0173","173","137","36","6","179","425","0","42.12","32.24"
"67","000","00","004","0406","0174","104","84","20","21","125","318","0","39.31","26.42"
"67","000","00","004","0407","0000","633","484","149","84","717","1483","0","48.35","32.64"
"67","000","00","004","0407","0175","328","247","81","44","372","753","0","49.4","32.8"
"67","000","00","004","0407","0176","305","237","68","40","345","730","0","47.26","32.47"
"67","000","00","004","0408","0000","835","639","196","105","940","1809","0","51.96","35.32"
"67","000","00","004","0408","0177","311","234","77","38","349","725","0","48.14","32.28"
"67","000","00","004","0408","0178","387","300","87","34","421","787","0","53.49","38.12"
"67","000","00","004","0408","0179","137","105","32","33","170","297","0","57.24","35.35"
"67","000","00","004","0409","0000","619","471","148","108","727","1313","0","55.37","35.87"
"67","000","00","004","0409","0180","325","244","81","44","369","673","0","54.83","36.26"
"67","000","00","004","0409","0181","294","227","67","64","358","640","0","55.94","35.47"
"67","000","00","004","0410","0000","251","169","82","31","282","660","0","42.73","25.61"
"67","000","00","004","0410","0182","251","169","82","31","282","660","0","42.73","25.61"
"67","000","00","004","0411","0000","551","433","118","46","597","1414","0","42.22","30.62"
"67","000","00","004","0411","0183","468","365","103","40","508","1212","0","41.91","30.12"
"67","000","00","004","0411","0184","83","68","15","6","89","202","0","44.06","33.66"
"67","000","00","004","0412","0000","495","371","124","82","577","1207","0","47.8","30.74"
"67","000","00","004","0412","0185","425","324","101","81","506","1049","0","48.24","30.89"
"67","000","00","004","0412","0186","70","47","23","1","71","158","0","44.94","29.75"
"67","000","00","004","0413","0000","645","465","180","94","739","1582","0","46.71","29.39"
"67","000","00","004","0413","0187","396","274","122","68","464","921","0","50.38","29.75"
"67","000","00","004","0413","0188","188","143","45","22","210","504","0","41.67","28.37"
"67","000","00","004","0413","0189","61","48","13","4","65","157","0","41.4","30.57"
"67","000","00","005","0000","0000","8219","6290","1929","1046","9265","20841","23424","44.46","30.18"
"67","000","00","005","0501","0000","772","594","178","75","847","1641","0","51.61","36.2"
"67","000","00","005","0501","0001","370","284","86","56","426","743","0","57.34","38.22"
"67","000","00","005","0501","0002","402","310","92","19","421","898","0","46.88","34.52"
"67","000","00","005","0502","0000","535","392","143","101","636","1320","0","48.18","29.7"
"67","000","00","005","0502","0003","316","240","76","48","364","786","0","46.31","30.53"
"67","000","00","005","0502","0004","219","152","67","53","272","534","0","50.94","28.46"
"67","000","00","005","0503","0000","549","400","149","86","635","1266","0","50.16","31.6"
"67","000","00","005","0503","0005","461","351","110","68","529","1034","0","51.16","33.95"
"67","000","00","005","0503","0006","88","49","39","18","106","232","0","45.69","21.12"
"67","000","00","005","0504","0000","535","402","133","64","599","1316","0","45.52","30.55"
"67","000","00","005","0504","0007","197","150","47","36","233","479","0","48.64","31.32"
"67","000","00","005","0504","0008","338","252","86","28","366","837","0","43.73","30.11"
"67","000","00","005","0510","0000","516","405","111","41","557","1399","0","39.81","28.95"
"67","000","00","005","0510","0021","295","233","62","8","303","958","0","31.63","24.32"
"67","000","00","005","0510","0022","221","172","49","33","254","441","0","57.6","39.0"
"67","000","00","005","0511","0000","734","543","191","144","878","1673","0","52.48","32.46"
"67","000","00","005","0511","0023","291","211","80","68","359","677","0","53.03","31.17"
"67","000","00","005","0511","0024","443","332","111","76","519","996","0","52.11","33.33"
"67","000","00","005","0512","0000","493","391","102","31","524","1255","0","41.75","31.16"
"67","000","00","005","0512","0025","493","391","102","31","524","1255","0","41.75","31.16"
"67","000","00","005","0513","0000","458","362","96","27","485","1231","0","39.4","29.41"
"67","000","00","005","0513","0026","268","216","52","18","286","678","0","42.18","31.86"
"67","000","00","005","0513","0027","190","146","44","9","199","553","0","35.99","26.4"
"67","000","00","005","0514","0000","690","531","159","41","731","1805","0","40.5","29.42"
"67","000","00","005","0514","0028","189","151","38","16","205","616","0","33.28","24.51"
"67","000","00","005","0514","0029","501","380","121","25","526","1189","0","44.24","31.96"
"67","000","00","005","0518","0000","578","450","128","108","686","1475","0","46.51","30.51"
"67","000","00","005","0518","0013","147","122","25","25","172","371","0","46.36","32.88"
"67","000","00","005","0518","0014","273","205","68","51","324","676","0","47.93","30.33"
"67","000","00","005","0518","0015","158","123","35","32","190","428","0","44.39","28.74"
"67","000","00","005","0519","0000","369","274","95","57","426","1002","0","42.51","27.35"
"67","000","00","005","0519","0016","182","144","38","13","195","547","0","35.65","26.33"
"67","000","00","005","0519","0017","187","130","57","44","231","455","0","50.77","28.57"
"67","000","00","005","0522","0000","699","532","167","134","833","2003","0","41.59","26.56"
"67","000","00","005","0522","0018","331","250","81","70","401","984","0","40.75","25.41"
"67","000","00","005","0522","0019","175","131","44","34","209","483","0","43.27","27.12"
"67","000","00","005","0522","0020","193","151","42","30","223","536","0","41.6","28.17"
"67","000","00","005","0523","0000","743","571","172","53","796","2242","0","35.5","25.47"
"67","000","00","005","0523","0009","377","290","87","34","411","1085","0","37.88","26.73"
"67","000","00","005","0523","0010","366","281","85","19","385","1157","0","33.28","24.29"
"67","000","00","005","0524","0000","548","443","105","84","632","1213","0","52.1","36.52"
"67","000","00","005","0524","0011","328","270","58","56","384","755","0","50.86","35.76"
"67","000","00","005","0524","0012","220","173","47","28","248","458","0","54.15","37.77"
"67","000","00","006","0000","0000","6003","4446","1557","746","6749","18471","20870","36.54","24.07"
"67","000","00","006","0601","0000","562","406","156","62","624","1401","0","44.54","28.98"
"67","000","00","006","0601","0062","562","406","156","62","624","1401","0","44.54","28.98"
"67","000","00","006","0602","0000","901","708","193","88","989","2488","0","39.75","28.46"
"67","000","00","006","0602","0063","430","342","88","34","464","1185","0","39.16","28.86"
"67","000","00","006","0602","0064","471","366","105","54","525","1303","0","40.29","28.09"
"67","000","00","006","0603","0000","496","355","141","66","562","1453","0","38.68","24.43"
"67","000","00","006","0603","0065","260","186","74","32","292","732","0","39.89","25.41"
"67","000","00","006","0603","0066","236","169","67","34","270","721","0","37.45","23.44"
"67","000","00","006","0604","0000","335","269","66","27","362","943","0","38.39","28.53"
"67","000","00","006","0604","0068","335","269","66","27","362","943","0","38.39","28.53"
"67","000","00","006","0605","0000","350","226","124","47","397","1104","0","35.96","20.47"
"67","000","00","006","0605","0067","350","226","124","47","397","1104","0","35.96","20.47"
"67","000","00","006","0606","0000","348","270","78","75","423","1249","0","33.87","21.62"
"67","000","00","006","0606","0069","131","103","28","6","137","653","0","20.98","15.77"
"67","000","00","006","0606","0070","217","167","50","69","286","596","0","47.99","28.02"
"67","000","00","006","0607","0000","330","243","87","62","392","878","0","44.65","27.68"
"67","000","00","006","0607","0071","330","243","87","62","392","878","0","44.65","27.68"
"67","000","00","006","0608","0000","91","63","28","3","94","425","0","22.12","14.82"
"67","000","00","006","0608","0075","91","63","28","3","94","425","0","22.12","14.82"
"67","000","00","006","0609","0000","127","99","28","17","144","394","0","36.55","25.13"
"67","000","00","006","0609","0076","127","99","28","17","144","394","0","36.55","25.13"
"67","000","00","006","0610","0000","156","118","38","30","186","373","0","49.87","31.64"
"67","000","00","006","0610","0077","156","118","38","30","186","373","0","49.87","31.64"
"67","000","00","006","0611","0000","533","412","121","48","581","2144","0","27.1","19.22"
"67","000","00","006","0611","0078","349","272","77","40","389","1257","0","30.95","21.64"
"67","000","00","006","0611","0079","184","140","44","8","192","887","0","21.65","15.78"
"67","000","00","006","0612","0000","147","109","38","14","161","658","0","24.47","16.57"
"67","000","00","006","0612","0080","147","109","38","14","161","658","0","24.47","16.57"
"67","000","00","006","0613","0000","284","202","82","24","308","1101","0","27.97","18.35"
"67","000","00","006","0613","0081","284","202","82","24","308","1101","0","27.97","18.35"
"67","000","00","006","0614","0000","244","176","68","16","260","1057","0","24.6","16.65"
"67","000","00","006","0614","0082","244","176","68","16","260","1057","0","24.6","16.65"
"67","000","00","006","0615","0000","363","256","107","56","419","909","0","46.09","28.16"
"67","000","00","006","0615","0083","256","186","70","46","302","639","0","47.26","29.11"
"67","000","00","006","0615","0084","107","70","37","10","117","270","0","43.33","25.93"
"67","000","00","006","0616","0000","736","534","202","111","847","1894","0","44.72","28.19"
"67","000","00","006","0616","0072","265","173","92","54","319","771","0","41.37","22.44"
"67","000","00","006","0616","0073","185","137","48","24","209","483","0","43.27","28.36"
"67","000","00","006","0616","0074","286","224","62","33","319","640","0","49.84","35.0"
"67","000","00","007","0000","0000","16683","12403","4280","1193","17876","37963","44306","47.09","32.67"
"67","000","00","007","0703","0000","1343","1013","330","99","1442","2587","0","55.74","39.16"
"67","000","00","007","0703","0385","647","478","169","55","702","1262","0","55.63","37.88"
"67","000","00","007","0703","0386","696","535","161","44","740","1325","0","55.85","40.38"
"67","000","00","007","0704","0000","1151","835","316","62","1213","2505","0","48.42","33.33"
"67","000","00","007","0704","0387","618","454","164","37","655","1384","0","47.33","32.8"
"67","000","00","007","0704","0388","533","381","152","25","558","1121","0","49.78","33.99"
"67","000","00","007","0705","0000","995","724","271","55","1050","2120","0","49.53","34.15"
"67","000","00","007","0705","0383","257","175","82","18","275","523","0","52.58","33.46"
"67","000","00","007","0705","0384","738","549","189","37","775","1597","0","48.53","34.38"
"67","000","00","007","0706","0000","877","627","250","55","932","1975","0","47.19","31.75"
"67","000","00","007","0706","0389","457","326","131","12","469","1021","0","45.94","31.93"
"67","000","00","007","0706","0390","420","301","119","43","463","954","0","48.53","31.55"
"67","000","00","007","0707","0000","603","449","154","28","631","1513","0","41.71","29.68"
"67","000","00","007","0707","0391","603","449","154","28","631","1513","0","41.71","29.68"
"67","000","00","007","0709","0000","1526","1176","350","102","1628","3530","0","46.12","33.31"
"67","000","00","007","0709","0392","696","523","173","42","738","1726","0","42.76","30.3"
"67","000","00","007","0709","0393","830","653","177","60","890","1804","0","49.33","36.2"
"67","000","00","007","0710","0000","444","340","104","29","473","1106","0","42.77","30.74"
"67","000","00","007","0710","0394","444","340","104","29","473","1106","0","42.77","30.74"
"67","000","00","007","0711","0000","1292","964","328","95","1387","2805","0","49.45","34.37"
"67","000","00","007","0711","0395","683","498","185","48","731","1503","0","48.64","33.13"
"67","000","00","007","0711","0396","609","466","143","47","656","1302","0","50.38","35.79"
"67","000","00","007","0714","0000","954","724","230","65","1019","2330","0","43.73","31.07"
"67","000","00","007","0714","0399","671","502","169","48","719","1612","0","44.6","31.14"
"67","000","00","007","0714","0400","283","222","61","17","300","718","0","41.78","30.92"
"67","000","00","007","0715","0000","627","481","146","33","660","1656","0","39.86","29.05"
"67","000","00","007","0715","0401","627","481","146","33","660","1656","0","39.86","29.05"
"67","000","00","007","0717","0000","927","675","252","104","1031","2332","0","44.21","28.95"
"67","000","00","007","0717","0402","597","419","178","69","666","1355","0","49.15","30.92"
"67","000","00","007","0717","0403","330","256","74","35","365","977","0","37.36","26.2"
"67","000","00","007","0719","0000","835","623","212","59","894","2105","0","42.47","29.6"
"67","000","00","007","0719","0404","404","302","102","32","436","1012","0","43.08","29.84"
"67","000","00","007","0719","0405","305","224","81","22","327","626","0","52.24","35.78"
"67","000","00","007","0719","0406","126","97","29","5","131","467","0","28.05","20.77"
"67","000","00","007","0721","0000","521","394","127","24","545","1260","0","43.25","31.27"
"67","000","00","007","0721","0407","521","394","127","24","545","1260","0","43.25","31.27"
"67","000","00","007","0722","0000","516","378","138","41","557","1111","0","50.14","34.02"
"67","000","00","007","0722","0408","516","378","138","41","557","1111","0","50.14","34.02"
"67","000","00","007","0724","0000","621","443","178","66","687","1348","0","50.96","32.86"
"67","000","00","007","0724","0409","261","178","83","23","284","550","0","51.64","32.36"
"67","000","00","007","0724","0410","360","265","95","43","403","798","0","50.5","33.21"
"67","000","00","007","0728","0000","359","254","105","17","376","941","0","39.96","26.99"
"67","000","00","007","0728","0413","359","254","105","17","376","941","0","39.96","26.99"
"67","000","00","007","0730","0000","882","647","235","87","969","1865","0","51.96","34.69"
"67","000","00","007","0730","0381","549","413","136","52","601","1205","0","49.88","34.27"
"67","000","00","007","0730","0382","333","234","99","35","368","660","0","55.76","35.45"
"67","000","00","007","0731","0000","731","550","181","91","822","1682","0","48.87","32.7"
"67","000","00","007","0731","0411","426","315","111","80","506","852","0","59.39","36.97"
"67","000","00","007","0731","0412","305","235","70","11","316","830","0","38.07","28.31"
"67","000","00","007","0732","0000","784","579","205","37","821","1770","0","46.38","32.71"
"67","000","00","007","0732","0414","534","399","135","27","561","1158","0","48.45","34.46"
"67","000","00","007","0732","0415","250","180","70","10","260","612","0","42.48","29.41"
"67","000","00","007","0733","0000","695","527","168","44","739","1422","0","51.97","37.06"
"67","000","00","007","0733","0397","285","211","74","17","302","645","0","46.82","32.71"
"67","000","00","007","0733","0398","410","316","94","27","437","777","0","56.24","40.67"
"67","000","00","008","0000","0000","8472","6443","2029","969","9441","20947","23938","45.07","30.76"
"67","000","00","008","0801","0000","572","438","134","48","620","1558","0","39.79","28.11"
"67","000","00","008","0801","0343","572","438","134","48","620","1558","0","39.79","28.11"
"67","000","00","008","0802","0000","754","553","201","90","844","2005","0","42.09","27.58"
"67","000","00","008","0802","0344","391","285","106","31","422","1112","0","37.95","25.63"
"67","000","00","008","0802","0345","363","268","95","59","422","893","0","47.26","30.01"
"67","000","00","008","0803","0000","582","433","149","51","633","1623","0","39.0","26.68"
"67","000","00","008","0803","0346","582","433","149","51","633","1623","0","39.0","26.68"
"67","000","00","008","0804","0000","669","510","159","94","763","1568","0","48.66","32.53"
"67","000","00","008","0804","0347","669","510","159","94","763","1568","0","48.66","32.53"
"67","000","00","008","0805","0000","828","644","184","72","900","1938","0","46.44","33.23"
"67","000","00","008","0805","0348","451","339","112","54","505","985","0","51.27","34.42"
"67","000","00","008","0805","0349","377","305","72","18","395","953","0","41.45","32.0"
"67","000","00","008","0806","0000","953","732","221","100","1053","2108","0","49.95","34.72"
"67","000","00","008","0806","0350","425","321","104","32","457","1031","0","44.33","31.13"
"67","000","00","008","0806","0351","528","411","117","68","596","1077","0","55.34","38.16"
"67","000","00","008","0811","0000","816","639","177","96","912","1894","0","48.15","33.74"
"67","000","00","008","0811","0356","423","333","90","65","488","959","0","50.89","34.72"
"67","000","00","008","0811","0357","393","306","87","31","424","935","0","45.35","32.73"
"67","000","00","008","0812","0000","394","308","86","53","447","893","0","50.06","34.49"
"67","000","00","008","0812","0358","394","308","86","53","447","893","0","50.06","34.49"
"67","000","00","008","0813","0000","575","451","124","94","669","1293","0","51.74","34.88"
"67","000","00","008","0813","0359","575","451","124","94","669","1293","0","51.74","34.88"
"67","000","00","008","0816","0000","927","687","240","73","1000","2255","0","44.35","30.47"
"67","000","00","008","0816","0354","504","368","136","48","552","1164","0","47.42","31.62"
"67","000","00","008","0816","0355","423","319","104","25","448","1091","0","41.06","29.24"
"67","000","00","008","0817","0000","552","433","119","67","619","1557","0","39.76","27.81"
"67","000","00","008","0817","0352","232","175","57","48","280","703","0","39.83","24.89"
"67","000","00","008","0817","0353","320","258","62","19","339","854","0","39.7","30.21"
"67","000","00","008","0818","0000","850","615","235","131","981","2255","0","43.5","27.27"
"67","000","00","008","0818","0360","512","359","153","112","624","1185","0","52.66","30.3"
"67","000","00","008","0818","0361","338","256","82","19","357","1070","0","33.36","23.93"
"67","000","00","009","0000","0000","8210","6067","2143","895","9105","19144","22196","47.56","31.69"
"67","000","00","009","0901","0000","1307","995","312","113","1420","2908","0","48.83","34.22"
"67","000","00","009","0901","0362","408","307","101","56","464","819","0","56.65","37.48"
"67","000","00","009","0901","0363","293","222","71","20","313","645","0","48.53","34.42"
"67","000","00","009","0901","0364","606","466","140","37","643","1444","0","44.53","32.27"
"67","000","00","009","0902","0000","1001","713","288","110","1111","2725","0","40.77","26.17"
"67","000","00","009","0902","0365","573","402","171","58","631","1554","0","40.6","25.87"
"67","000","00","009","0902","0366","428","311","117","52","480","1171","0","40.99","26.56"
"67","000","00","009","0903","0000","578","436","142","69","647","1351","0","47.89","32.27"
"67","000","00","009","0903","0367","578","436","142","69","647","1351","0","47.89","32.27"
"67","000","00","009","0905","0000","768","548","220","129","897","1929","0","46.5","28.41"
"67","000","00","009","0905","0368","394","284","110","71","465","1010","0","46.04","28.12"
"67","000","00","009","0905","0369","374","264","110","58","432","919","0","47.01","28.73"
"67","000","00","009","0906","0000","1520","1129","391","181","1701","3360","0","50.63","33.6"
"67","000","00","009","0906","0370","587","414","173","64","651","1369","0","47.55","30.24"
"67","000","00","009","0906","0371","435","341","94","66","501","976","0","51.33","34.94"
"67","000","00","009","0906","0372","498","374","124","51","549","1015","0","54.09","36.85"
"67","000","00","009","0907","0000","906","679","227","84","990","2115","0","46.81","32.1"
"67","000","00","009","0907","0373","478","364","114","33","511","1176","0","43.45","30.95"
"67","000","00","009","0907","0374","428","315","113","51","479","939","0","51.01","33.55"
"67","000","00","009","0908","0000","742","543","199","86","828","1593","0","51.98","34.09"
"67","000","00","009","0908","0375","328","228","100","43","371","712","0","52.11","32.02"
"67","000","00","009","0908","0376","414","315","99","43","457","881","0","51.87","35.75"
"67","000","00","009","0909","0000","625","472","153","63","688","1184","0","58.11","39.86"
"67","000","00","009","0909","0377","625","472","153","63","688","1184","0","58.11","39.86"
"67","000","00","009","0910","0000","335","244","91","26","361","599","0","60.27","40.73"
"67","000","00","009","0910","0378","335","244","91","26","361","599","0","60.27","40.73"
"67","000","00","009","0911","0000","210","160","50","8","218","759","0","28.72","21.08"
"67","000","00","009","0911","0379","210","160","50","8","218","759","0","28.72","21.08"
"67","000","00","009","0912","0000","218","148","70","26","244","621","0","39.29","23.83"
"67","000","00","009","0912","0380","218","148","70","26","244","621","0","39.29","23.83"
"67","000","00","010","0000","0000","8068","5969","2099","687","8755","18675","21329","46.88","31.96"
"67","000","00","010","1001","0000","884","686","198","58","942","2069","0","45.53","33.16"
"67","000","00","010","1001","0416","451","364","87","17","468","1104","0","42.39","32.97"
"67","000","00","010","1001","0417","433","322","111","41","474","965","0","49.12","33.37"
"67","000","00","010","1002","0000","1444","1054","390","136","1580","3055","0","51.72","34.5"
"67","000","00","010","1002","0418","631","475","156","44","675","1402","0","48.15","33.88"
"67","000","00","010","1002","0419","813","579","234","92","905","1653","0","54.75","35.03"
"67","000","00","010","1005","0000","105","80","25","5","110","402","0","27.36","19.9"
"67","000","00","010","1005","0422","105","80","25","5","110","402","0","27.36","19.9"
"67","000","00","010","1006","0000","830","629","201","36","866","1957","0","44.25","32.14"
"67","000","00","010","1006","0423","452","338","114","10","462","982","0","47.05","34.42"
"67","000","00","010","1006","0424","378","291","87","26","404","975","0","41.44","29.85"
"67","000","00","010","1007","0000","1563","1143","420","117","1680","3375","0","49.78","33.87"
"67","000","00","010","1007","0425","355","255","100","42","397","802","0","49.5","31.8"
"67","000","00","010","1007","0426","550","401","149","47","597","1118","0","53.4","35.87"
"67","000","00","010","1007","0427","658","487","171","28","686","1455","0","47.15","33.47"
"67","000","00","010","1008","0000","557","410","147","29","586","1208","0","48.51","33.94"
"67","000","00","010","1008","0428","557","410","147","29","586","1208","0","48.51","33.94"
"67","000","00","010","1013","0000","307","245","62","19","326","873","0","37.34","28.06"
"67","000","00","010","1013","0435","307","245","62","19","326","873","0","37.34","28.06"
"67","000","00","010","1014","0000","491","342","149","71","562","1250","0","44.96","27.36"
"67","000","00","010","1014","0420","385","269","116","56","441","966","0","45.65","27.85"
"67","000","00","010","1014","0421","106","73","33","15","121","284","0","42.61","25.7"
"67","000","00","010","1015","0000","1149","834","315","139","1288","2586","0","49.81","32.25"
"67","000","00","010","1015","0431","209","144","65","30","239","501","0","47.7","28.74"
"67","000","00","010","1015","0432","350","265","85","48","398","728","0","54.67","36.4"
"67","000","00","010","1015","0433","358","255","103","19","377","842","0","44.77","30.29"
"67","000","00","010","1015","0434","232","170","62","42","274","515","0","53.2","33.01"
"67","000","00","010","1016","0000","738","546","192","77","815","1900","0","42.89","28.74"
"67","000","00","010","1016","0429","520","388","132","59","579","1293","0","44.78","30.01"
"67","000","00","010","1016","0430","218","158","60","18","236","607","0","38.88","26.03"
"67","000","00","011","0000","0000","3593","2718","875","429","4022","8654","9643","46.48","31.41"
"67","000","00","011","1101","0000","357","267","90","48","405","1021","0","39.67","26.15"
"67","000","00","011","1101","0436","276","208","68","46","322","759","0","42.42","27.4"
"67","000","00","011","1101","0437","81","59","22","2","83","262","0","31.68","22.52"
"67","000","00","011","1102","0000","198","148","50","15","213","646","0","32.97","22.91"
"67","000","00","011","1102","0438","198","148","50","15","213","646","0","32.97","22.91"
"67","000","00","011","1103","0000","519","409","110","65","584","1473","0","39.65","27.77"
"67","000","00","011","1103","0439","519","409","110","65","584","1473","0","39.65","27.77"
"67","000","00","011","1104","0000","420","324","96","71","491","915","0","53.66","35.41"
"67","000","00","011","1104","0440","420","324","96","71","491","915","0","53.66","35.41"
"67","000","00","011","1105","0000","387","286","101","41","428","779","0","54.94","36.71"
"67","000","00","011","1105","0441","387","286","101","41","428","779","0","54.94","36.71"
"67","000","00","011","1106","0000","342","248","94","46","388","637","0","60.91","38.93"
"67","000","00","011","1106","0442","342","248","94","46","388","637","0","60.91","38.93"
"67","000","00","011","1107","0000","384","272","112","29","413","993","0","41.59","27.39"
"67","000","00","011","1107","0443","384","272","112","29","413","993","0","41.59","27.39"
"67","000","00","011","1108","0000","370","284","86","38","408","766","0","53.26","37.08"
"67","000","00","011","1108","0444","370","284","86","38","408","766","0","53.26","37.08"
"67","000","00","011","1109","0000","374","294","80","35","409","841","0","48.63","34.96"
"67","000","00","011","1109","0445","374","294","80","35","409","841","0","48.63","34.96"
"67","000","00","011","1110","0000","242","186","56","41","283","583","0","48.54","31.9"
"67","000","00","011","1110","0446","242","186","56","41","283","583","0","48.54","31.9"
"67","000","00","012","0000","0000","23802","18292","5510","1986","25788","50407","59087","51.16","36.29"
"67","000","00","012","1201","0000","1158","890","268","91","1249","2220","0","56.26","40.09"
"67","000","00","012","1201","0282","714","552","162","56","770","1391","0","55.36","39.68"
"67","000","00","012","1201","0283","444","338","106","35","479","829","0","57.78","40.77"
"67","000","00","012","1202","0000","1154","867","287","53","1207","2853","0","42.31","30.39"
"67","000","00","012","1202","0284","575","418","157","32","607","1401","0","43.33","29.84"
"67","000","00","012","1202","0285","579","449","130","21","600","1452","0","41.32","30.92"
"67","000","00","012","1203","0000","2681","2070","611","237","2918","5611","0","52.0","36.89"
"67","000","00","012","1203","0286","667","510","157","66","733","1382","0","53.04","36.9"
"67","000","00","012","1203","0287","708","557","151","61","769","1463","0","52.56","38.07"
"67","000","00","012","1203","0288","573","452","121","39","612","1280","0","47.81","35.31"
"67","000","00","012","1203","0289","733","551","182","71","804","1486","0","54.1","37.08"
"67","000","00","012","1204","0000","1921","1477","444","182","2103","4204","0","50.02","35.13"
"67","000","00","012","1204","0297","657","494","163","50","707","1425","0","49.61","34.67"
"67","000","00","012","1204","0298","602","466","136","51","653","1255","0","52.03","37.13"
"67","000","00","012","1204","0299","662","517","145","81","743","1524","0","48.75","33.92"
"67","000","00","012","1205","0000","2847","2224","623","311","3158","5877","0","53.73","37.84"
"67","000","00","012","1205","0290","683","535","148","73","756","1378","0","54.86","38.82"
"67","000","00","012","1205","0291","742","570","172","60","802","1505","0","53.29","37.87"
"67","000","00","012","1205","0292","885","705","180","82","967","1860","0","51.99","37.9"
"67","000","00","012","1205","0293","537","414","123","96","633","1134","0","55.82","36.51"
"67","000","00","012","1206","0000","1925","1499","426","108","2033","4059","0","50.09","36.93"
"67","000","00","012","1206","0303","660","512","148","48","708","1381","0","51.27","37.07"
"67","000","00","012","1206","0304","623","496","127","27","650","1364","0","47.65","36.36"
"67","000","00","012","1206","0305","642","491","151","33","675","1314","0","51.37","37.37"
"67","000","00","012","1207","0000","1048","770","278","101","1149","2125","0","54.07","36.24"
"67","000","00","012","1207","0306","579","419","160","54","633","1164","0","54.38","36.0"
"67","000","00","012","1207","0307","469","351","118","47","516","961","0","53.69","36.52"
"67","000","00","012","1212","0000","977","738","239","81","1058","2209","0","47.89","33.41"
"67","000","00","012","1212","0312","659","514","145","55","714","1507","0","47.38","34.11"
"67","000","00","012","1212","0313","318","224","94","26","344","702","0","49.0","31.91"
"67","000","00","012","1219","0000","692","539","153","67","759","1513","0","50.17","35.62"
"67","000","00","012","1219","0319","692","539","153","67","759","1513","0","50.17","35.62"
"67","000","00","012","1220","0000","993","734","259","86","1079","2410","0","44.77","30.46"
"67","000","00","012","1220","0320","268","199","69","22","290","714","0","40.62","27.87"
"67","000","00","012","1220","0321","328","240","88","39","367","745","0","49.26","32.21"
"67","000","00","012","1220","0322","397","295","102","25","422","951","0","44.37","31.02"
"67","000","00","012","1222","0000","474","356","118","42","516","1072","0","48.13","33.21"
"67","000","00","012","1222","0310","321","238","83","26","347","689","0","50.36","34.54"
"67","000","00","012","1222","0311","153","118","35","16","169","383","0","44.13","30.81"
"67","000","00","012","1223","0000","2518","1985","533","181","2699","5111","0","52.81","38.84"
"67","000","00","012","1223","0294","698","548","150","55","753","1426","0","52.81","38.43"
"67","000","00","012","1223","0295","859","672","187","64","923","1779","0","51.88","37.77"
"67","000","00","012","1223","0296","961","765","196","62","1023","1906","0","53.67","40.14"
"67","000","00","012","1224","0000","980","732","248","73","1053","2137","0","49.27","34.25"
"67","000","00","012","1224","0308","534","405","129","53","587","1218","0","48.19","33.25"
"67","000","00","012","1224","0309","446","327","119","20","466","919","0","50.71","35.58"
"67","000","00","012","1225","0000","954","756","198","90","1044","1844","0","56.62","41.0"
"67","000","00","012","1225","0314","442","349","93","49","491","907","0","54.13","38.48"
"67","000","00","012","1225","0315","512","407","105","41","553","937","0","59.02","43.44"
"67","000","00","012","1226","0000","1249","922","327","137","1386","2798","0","49.54","32.95"
"67","000","00","012","1226","0316","470","339","131","63","533","1030","0","51.75","32.91"
"67","000","00","012","1226","0317","450","332","118","53","503","981","0","51.27","33.84"
"67","000","00","012","1226","0318","329","251","78","21","350","787","0","44.47","31.89"
"67","000","00","012","1227","0000","2231","1733","498","146","2377","4364","0","54.47","39.71"
"67","000","00","012","1227","0300","771","599","172","42","813","1631","0","49.85","36.73"
"67","000","00","012","1227","0301","809","630","179","54","863","1546","0","55.82","40.75"
"67","000","00","012","1227","0302","651","504","147","50","701","1187","0","59.06","42.46"
"67","000","00","013","0000","0000","9603","7318","2285","855","10458","22567","25725","46.34","32.43"
"67","000","00","013","1301","0000","1799","1435","364","170","1969","3852","0","51.12","37.25"
"67","000","00","013","1301","0216","643","519","124","43","686","1370","0","50.07","37.88"
"67","000","00","013","1301","0217","552","440","112","50","602","1117","0","53.89","39.39"
"67","000","00","013","1301","0218","604","476","128","77","681","1365","0","49.89","34.87"
"67","000","00","013","1302","0000","1004","785","219","44","1048","2235","0","46.89","35.12"
"67","000","00","013","1302","0221","483","373","110","20","503","1052","0","47.81","35.46"
"67","000","00","013","1302","0222","521","412","109","24","545","1183","0","46.07","34.83"
"67","000","00","013","1303","0000","408","313","95","25","433","1238","0","34.98","25.28"
"67","000","00","013","1303","0227","270","214","56","21","291","832","0","34.98","25.72"
"67","000","00","013","1303","0228","138","99","39","4","142","406","0","34.98","24.38"
"67","000","00","013","1304","0000","387","291","96","37","424","818","0","51.83","35.57"
"67","000","00","013","1304","0229","387","291","96","37","424","818","0","51.83","35.57"
"67","000","00","013","1305","0000","797","647","150","78","875","1900","0","46.05","34.05"
"67","000","00","013","1305","0213","288","233","55","35","323","635","0","50.87","36.69"
"67","000","00","013","1305","0214","341","277","64","25","366","822","0","44.53","33.7"
"67","000","00","013","1305","0215","168","137","31","18","186","443","0","41.99","30.93"
"67","000","00","013","1306","0000","1192","880","312","95","1287","2409","0","53.42","36.53"
"67","000","00","013","1306","0208","423","293","130","57","480","862","0","55.68","33.99"
"67","000","00","013","1306","0209","327","258","69","8","335","611","0","54.83","42.23"
"67","000","00","013","1306","0210","442","329","113","30","472","936","0","50.43","35.15"
"67","000","00","013","1307","0000","898","624","274","78","976","1935","0","50.44","32.25"
"67","000","00","013","1307","0211","452","307","145","46","498","1066","0","46.72","28.8"
"67","000","00","013","1307","0212","446","317","129","32","478","869","0","55.01","36.48"
"67","000","00","013","1308","0000","492","359","133","62","554","1241","0","44.64","28.93"
"67","000","00","013","1308","0224","492","359","133","62","554","1241","0","44.64","28.93"
"67","000","00","013","1309","0000","363","264","99","19","382","1052","0","36.31","25.1"
"67","000","00","013","1309","0230","363","264","99","19","382","1052","0","36.31","25.1"
"67","000","00","013","1310","0000","847","641","206","118","965","2116","0","45.6","30.29"
"67","000","00","013","1310","0219","631","491","140","80","711","1489","0","47.75","32.98"
"67","000","00","013","1310","0220","216","150","66","38","254","627","0","40.51","23.92"
"67","000","00","013","1311","0000","364","273","91","25","389","979","0","39.73","27.89"
"67","000","00","013","1311","0223","364","273","91","25","389","979","0","39.73","27.89"
"67","000","00","013","1312","0000","514","389","125","45","559","1369","0","40.83","28.41"
"67","000","00","013","1312","0231","216","159","57","12","228","578","0","39.45","27.51"
"67","000","00","013","1312","0232","148","105","43","20","168","430","0","39.07","24.42"
"67","000","00","013","1312","0233","150","125","25","13","163","361","0","45.15","34.63"
"67","000","00","013","1313","0000","538","417","121","59","597","1423","0","41.95","29.3"
"67","000","00","013","1313","0225","294","231","63","23","317","843","0","37.6","27.4"
"67","000","00","013","1313","0226","244","186","58","36","280","580","0","48.28","32.07"
"67","000","00","014","0000","0000","8844","6712","2132","761","9605","21564","24724","44.54","31.13"
"67","000","00","014","1401","0000","1402","1059","343","84","1486","3148","0","47.2","33.64"
"67","000","00","014","1401","0323","424","322","102","17","441","933","0","47.27","34.51"
"67","000","00","014","1401","0324","427","319","108","35","462","901","0","51.28","35.41"
"67","000","00","014","1401","0325","551","418","133","32","583","1314","0","44.37","31.81"
"67","000","00","014","1402","0000","949","718","231","68","1017","2401","0","42.36","29.9"
"67","000","00","014","1402","0329","666","509","157","55","721","1663","0","43.36","30.61"
"67","000","00","014","1402","0330","283","209","74","13","296","738","0","40.11","28.32"
"67","000","00","014","1403","0000","734","553","181","92","826","1593","0","51.85","34.71"
"67","000","00","014","1403","0331","582","441","141","64","646","1211","0","53.34","36.42"
"67","000","00","014","1403","0332","152","112","40","28","180","382","0","47.12","29.32"
"67","000","00","014","1404","0000","652","509","143","35","687","1624","0","42.3","31.34"
"67","000","00","014","1404","0333","303","241","62","21","324","786","0","41.22","30.66"
"67","000","00","014","1404","0334","349","268","81","14","363","838","0","43.32","31.98"
"67","000","00","014","1405","0000","524","392","132","46","570","1449","0","39.34","27.05"
"67","000","00","014","1405","0335","524","392","132","46","570","1449","0","39.34","27.05"
"67","000","00","014","1406","0000","521","395","126","31","552","1479","0","37.32","26.71"
"67","000","00","014","1406","0336","521","395","126","31","552","1479","0","37.32","26.71"
"67","000","00","014","1407","0000","350","270","80","72","422","763","0","55.31","35.39"
"67","000","00","014","1407","0337","350","270","80","72","422","763","0","55.31","35.39"
"67","000","00","014","1408","0000","491","393","98","30","521","1297","0","40.17","30.3"
"67","000","00","014","1408","0338","491","393","98","30","521","1297","0","40.17","30.3"
"67","000","00","014","1409","0000","560","419","141","40","600","1393","0","43.07","30.08"
"67","000","00","014","1409","0339","560","419","141","40","600","1393","0","43.07","30.08"
"67","000","00","014","1410","0000","515","384","131","37","552","1349","0","40.92","28.47"
"67","000","00","014","1410","0340","333","245","88","18","351","958","0","36.64","25.57"
"67","000","00","014","1410","0341","182","139","43","19","201","391","0","51.41","35.55"
"67","000","00","014","1411","0000","362","275","87","59","421","805","0","52.3","34.16"
"67","000","00","014","1411","0342","362","275","87","59","421","805","0","52.3","34.16"
"67","000","00","014","1412","0000","1784","1345","439","167","1951","4263","0","45.77","31.55"
"67","000","00","014","1412","0326","615","475","140","73","688","1349","0","51.0","35.21"
"67","000","00","014","1412","0327","500","382","118","60","560","1014","0","55.23","37.67"
"67","000","00","014","1412","0328","669","488","181","34","703","1900","0","37.0","25.68"
"67","000","00","015","0000","0000","7644","5754","1890","781","8425","19950","22810","42.23","28.84"
"67","000","00","015","1501","0000","441","337","104","33","474","1042","0","45.49","32.34"
"67","000","00","015","1501","0258","207","155","52","15","222","534","0","41.57","29.03"
"67","000","00","015","1501","0259","234","182","52","18","252","508","0","49.61","35.83"
"67","000","00","015","1502","0000","199","157","42","6","205","665","0","30.83","23.61"
"67","000","00","015","1502","0260","199","157","42","6","205","665","0","30.83","23.61"
"67","000","00","015","1504","0000","308","244","64","22","330","834","0","39.57","29.26"
"67","000","00","015","1504","0261","308","244","64","22","330","834","0","39.57","29.26"
"67","000","00","015","1505","0000","277","192","85","18","295","810","0","36.42","23.7"
"67","000","00","015","1505","0262","277","192","85","18","295","810","0","36.42","23.7"
"67","000","00","015","1506","0000","141","112","29","10","151","480","0","31.46","23.33"
"67","000","00","015","1506","0263","141","112","29","10","151","480","0","31.46","23.33"
"67","000","00","015","1507","0000","147","108","39","6","153","445","0","34.38","24.27"
"67","000","00","015","1507","0264","147","108","39","6","153","445","0","34.38","24.27"
"67","000","00","015","1508","0000","471","352","119","27","498","1618","0","30.78","21.76"
"67","000","00","015","1508","0266","238","171","67","9","247","838","0","29.47","20.41"
"67","000","00","015","1508","0267","233","181","52","18","251","780","0","32.18","23.21"
"67","000","00","015","1509","0000","168","123","45","14","182","350","0","52.0","35.14"
"67","000","00","015","1509","0268","168","123","45","14","182","350","0","52.0","35.14"
"67","000","00","015","1510","0000","450","335","115","69","519","907","0","57.22","36.93"
"67","000","00","015","1510","0269","450","335","115","69","519","907","0","57.22","36.93"
"67","000","00","015","1511","0000","295","243","52","20","315","780","0","40.38","31.15"
"67","000","00","015","1511","0270","295","243","52","20","315","780","0","40.38","31.15"
"67","000","00","015","1512","0000","969","750","219","81","1050","2571","0","40.84","29.17"
"67","000","00","015","1512","0271","627","481","146","47","674","1658","0","40.65","29.01"
"67","000","00","015","1512","0272","342","269","73","34","376","913","0","41.18","29.46"
"67","000","00","015","1515","0000","757","563","194","72","829","1898","0","43.68","29.66"
"67","000","00","015","1515","0273","527","389","138","63","590","1202","0","49.08","32.36"
"67","000","00","015","1515","0274","230","174","56","9","239","696","0","34.34","25.0"
"67","000","00","015","1517","0000","169","128","41","12","181","680","0","26.62","18.82"
"67","000","00","015","1517","0265","169","128","41","12","181","680","0","26.62","18.82"
"67","000","00","015","1518","0000","597","449","148","90","687","1269","0","54.14","35.38"
"67","000","00","015","1518","0275","263","188","75","39","302","647","0","46.68","29.06"
"67","000","00","015","1518","0276","334","261","73","51","385","622","0","61.9","41.96"
"67","000","00","015","1519","0000","850","641","209","118","968","1873","0","51.68","34.22"
"67","000","00","015","1519","0277","577","430","147","88","665","1175","0","56.6","36.6"
"67","000","00","015","1519","0278","273","211","62","30","303","698","0","43.41","30.23"
"67","000","00","015","1521","0000","440","339","101","70","510","983","0","51.88","34.49"
"67","000","00","015","1521","0279","440","339","101","70","510","983","0","51.88","34.49"
"67","000","00","015","1522","0000","436","327","109","41","477","1366","0","34.92","23.94"
"67","000","00","015","1522","0280","436","327","109","41","477","1366","0","34.92","23.94"
"67","000","00","015","1523","0000","529","354","175","72","601","1379","0","43.58","25.67"
"67","000","00","015","1523","0281","529","354","175","72","601","1379","0","43.58","25.67"
"67","000","00","016","0000","0000","6630","5072","1558","665","7295","17754","19691","41.09","28.57"
"67","000","00","016","1601","0000","548","398","150","73","621","1110","0","55.95","35.86"
"67","000","00","016","1601","0234","548","398","150","73","621","1110","0","55.95","35.86"
"67","000","00","016","1613","0000","294","213","81","11","305","849","0","35.92","25.09"
"67","000","00","016","1613","0250","294","213","81","11","305","849","0","35.92","25.09"
"67","000","00","016","1614","0000","226","177","49","30","256","645","0","39.69","27.44"
"67","000","00","016","1614","0251","226","177","49","30","256","645","0","39.69","27.44"
"67","000","00","016","1615","0000","393","293","100","34","427","1353","0","31.56","21.66"
"67","000","00","016","1615","0252","216","161","55","28","244","690","0","35.36","23.33"
"67","000","00","016","1615","0253","177","132","45","6","183","663","0","27.6","19.91"
"67","000","00","016","1616","0000","373","286","87","28","401","1175","0","34.13","24.34"
"67","000","00","016","1616","0254","373","286","87","28","401","1175","0","34.13","24.34"
"67","000","00","016","1617","0000","681","529","152","154","835","1898","0","43.99","27.87"
"67","000","00","016","1617","0255","250","193","57","30","280","837","0","33.45","23.06"
"67","000","00","016","1617","0256","431","336","95","124","555","1061","0","52.31","31.67"
"67","000","00","016","1618","0000","277","218","59","24","301","976","0","30.84","22.34"
"67","000","00","016","1618","0257","277","218","59","24","301","976","0","30.84","22.34"
"67","000","00","016","1619","0000","380","282","98","21","401","1223","0","32.79","23.06"
"67","000","00","016","1619","0245","210","152","58","9","219","650","0","33.69","23.38"
"67","000","00","016","1619","0246","170","130","40","12","182","573","0","31.76","22.69"
"67","000","00","016","1620","0000","994","766","228","53","1047","2387","0","43.86","32.09"
"67","000","00","016","1620","0235","595","472","123","27","622","1418","0","43.86","33.29"
"67","000","00","016","1620","0236","399","294","105","26","425","969","0","43.86","30.34"
"67","000","00","016","1621","0000","1066","833","233","116","1182","2482","0","47.62","33.56"
"67","000","00","016","1621","0237","259","201","58","41","300","519","0","57.8","38.73"
"67","000","00","016","1621","0238","477","399","78","22","499","1106","0","45.12","36.08"
"67","000","00","016","1621","0239","226","153","73","42","268","542","0","49.45","28.23"
"67","000","00","016","1621","0240","104","80","24","11","115","315","0","36.51","25.4"
"67","000","00","016","1622","0000","785","602","183","62","847","2032","0","41.68","29.63"
"67","000","00","016","1622","0241","217","166","51","19","236","584","0","40.41","28.42"
"67","000","00","016","1622","0242","165","127","38","7","172","398","0","43.22","31.91"
"67","000","00","016","1622","0243","206","155","51","16","222","608","0","36.51","25.49"
"67","000","00","016","1622","0244","197","154","43","20","217","442","0","49.1","34.84"
"67","000","00","016","1623","0000","613","475","138","59","672","1624","0","41.38","29.25"
"67","000","00","016","1623","0247","196","149","47","10","206","617","0","33.39","24.15"
"67","000","00","016","1623","0248","231","184","47","23","254","573","0","44.33","32.11"
"67","000","00","016","1623","0249","186","142","44","26","212","434","0","48.85","32.72"
"67","000","00","017","0000","0000","3509","2663","846","292","3801","9925","11099","38.3","26.83"
"67","000","00","017","1701","0000","498","384","114","19","517","1341","0","38.55","28.64"
"67","000","00","017","1701","0196","284","226","58","3","287","742","0","38.68","30.46"
"67","000","00","017","1701","0197","214","158","56","16","230","599","0","38.4","26.38"
"67","000","00","017","1702","0000","163","116","47","13","176","473","0","37.21","24.52"
"67","000","00","017","1702","0201","163","116","47","13","176","473","0","37.21","24.52"
"67","000","00","017","1705","0000","326","248","78","27","353","838","0","42.12","29.59"
"67","000","00","017","1705","0192","146","117","29","7","153","456","0","33.55","25.66"
"67","000","00","017","1705","0193","180","131","49","20","200","382","0","52.36","34.29"
"67","000","00","017","1706","0000","265","190","75","14","279","954","0","29.25","19.92"
"67","000","00","017","1706","0202","265","190","75","14","279","954","0","29.25","19.92"
"67","000","00","017","1707","0000","370","280","90","44","414","1200","0","34.5","23.33"
"67","000","00","017","1707","0204","202","151","51","15","217","679","0","31.96","22.24"
"67","000","00","017","1707","0205","168","129","39","29","197","521","0","37.81","24.76"
"67","000","00","017","1709","0000","278","218","60","32","310","745","0","41.61","29.26"
"67","000","00","017","1709","0194","150","116","34","25","175","356","0","49.16","32.58"
"67","000","00","017","1709","0195","128","102","26","7","135","389","0","34.7","26.22"
"67","000","00","017","1711","0000","351","267","84","37","388","737","0","52.65","36.23"
"67","000","00","017","1711","0203","351","267","84","37","388","737","0","52.65","36.23"
"67","000","00","017","1713","0000","338","260","78","25","363","885","0","41.02","29.38"
"67","000","00","017","1713","0190","189","132","57","11","200","484","0","41.32","27.27"
"67","000","00","017","1713","0191","149","128","21","14","163","401","0","40.65","31.92"
"67","000","00","017","1714","0000","525","391","134","57","582","1484","0","39.22","26.35"
"67","000","00","017","1714","0198","217","164","53","27","244","594","0","41.08","27.61"
"67","000","00","017","1714","0199","218","159","59","26","244","572","0","42.66","27.8"
"67","000","00","017","1714","0200","90","68","22","4","94","318","0","29.56","21.38"
"67","000","00","017","1715","0000","395","309","86","24","419","1268","0","33.04","24.37"
"67","000","00","017","1715","0206","193","148","45","14","207","632","0","32.75","23.42"
"67","000","00","017","1715","0207","202","161","41","10","212","636","0","33.33","25.31"
"67","000","00","018","0000","0000","17868","13548","4320","1826","19694","37296","43516","52.8","36.33"
"67","000","00","018","1801","0000","1704","1287","417","178","1882","3165","0","59.46","40.66"
"67","000","00","018","1801","0581","414","329","85","38","452","746","0","60.59","44.1"
"67","000","00","018","1801","0582","608","445","163","41","649","1102","0","58.89","40.38"
"67","000","00","018","1801","0583","190","153","37","24","214","370","0","57.84","41.35"
"67","000","00","018","1801","0584","492","360","132","75","567","947","0","59.87","38.01"
"67","000","00","018","1802","0000","1955","1507","448","213","2168","3951","0","54.87","38.14"
"67","000","00","018","1802","0585","548","428","120","64","612","1154","0","53.03","37.09"
"67","000","00","018","1802","0586","537","406","131","70","607","1082","0","56.1","37.52"
"67","000","00","018","1802","0587","557","425","132","54","611","1075","0","56.84","39.53"
"67","000","00","018","1802","0588","313","248","65","25","338","640","0","52.81","38.75"
"67","000","00","018","1803","0000","1212","901","311","106","1318","2757","0","47.81","32.68"
"67","000","00","018","1803","0589","180","128","52","20","200","410","0","48.78","31.22"
"67","000","00","018","1803","0590","240","185","55","30","270","533","0","50.66","34.71"
"67","000","00","018","1803","0591","403","300","103","27","430","836","0","51.44","35.89"
"67","000","00","018","1803","0592","389","288","101","29","418","978","0","42.74","29.45"
"67","000","00","018","1804","0000","2088","1571","517","178","2266","4380","0","51.74","35.87"
"67","000","00","018","1804","0593","664","492","172","47","711","1348","0","52.74","36.5"
"67","000","00","018","1804","0594","487","361","126","48","535","1015","0","52.71","35.57"
"67","000","00","018","1804","0595","535","415","120","33","568","1228","0","46.25","33.79"
"67","000","00","018","1804","0596","402","303","99","50","452","789","0","57.29","38.4"
"67","000","00","018","1809","0000","1569","1194","375","114","1683","3272","0","51.44","36.49"
"67","000","00","018","1809","0597","471","346","125","25","496","1022","0","48.53","33.86"
"67","000","00","018","1809","0598","458","355","103","23","481","1021","0","47.11","34.77"
"67","000","00","018","1809","0599","640","493","147","66","706","1229","0","57.45","40.11"
"67","000","00","018","1810","0000","949","735","214","36","985","2165","0","45.5","33.95"
"67","000","00","018","1810","0600","563","441","122","17","580","1153","0","50.3","38.25"
"67","000","00","018","1810","0601","386","294","92","19","405","1012","0","40.02","29.05"
"67","000","00","018","1811","0000","718","534","184","75","793","1458","0","54.39","36.63"
"67","000","00","018","1811","0602","718","534","184","75","793","1458","0","54.39","36.63"
"67","000","00","018","1812","0000","1626","1256","370","135","1761","3220","0","54.69","39.01"
"67","000","00","018","1812","0603","844","665","179","67","911","1645","0","55.38","40.43"
"67","000","00","018","1812","0604","525","396","129","58","583","1016","0","57.38","38.98"
"67","000","00","018","1812","0605","257","195","62","10","267","559","0","47.76","34.88"
"67","000","00","018","1813","0000","1488","1131","357","107","1595","2784","0","57.29","40.63"
"67","000","00","018","1813","0606","636","475","161","43","679","1222","0","55.56","38.87"
"67","000","00","018","1813","0607","852","656","196","64","916","1562","0","58.64","42.0"
"67","000","00","018","1814","0000","892","694","198","116","1008","2007","0","50.22","34.58"
"67","000","00","018","1814","0608","418","314","104","30","448","994","0","45.07","31.59"
"67","000","00","018","1814","0609","474","380","94","86","560","1013","0","55.28","37.51"
"67","000","00","018","1815","0000","1042","768","274","137","1179","2218","0","53.16","34.63"
"67","000","00","018","1815","0610","592","439","153","79","671","1197","0","56.06","36.68"
"67","000","00","018","1815","0611","450","329","121","58","508","1021","0","49.76","32.22"
"67","000","00","018","1816","0000","565","434","131","82","647","1428","0","45.31","30.39"
"67","000","00","018","1816","0612","565","434","131","82","647","1428","0","45.31","30.39"
"67","000","00","018","1817","0000","176","120","56","39","215","456","0","47.15","26.32"
"67","000","00","018","1817","0613","176","120","56","39","215","456","0","47.15","26.32"
"67","000","00","018","1818","0000","1038","793","245","151","1189","2134","0","55.72","37.16"
"67","000","00","018","1818","0614","519","390","129","58","577","1037","0","55.64","37.61"
"67","000","00","018","1818","0615","519","403","116","93","612","1097","0","55.79","36.74"
"67","000","00","018","1819","0000","438","315","123","59","497","902","0","55.1","34.92"
"67","000","00","018","1819","0616","438","315","123","59","497","902","0","55.1","34.92"
"67","000","00","018","1820","0000","408","308","100","100","508","999","0","50.85","30.83"
"67","000","00","018","1820","0617","408","308","100","100","508","999","0","50.85","30.83"
"67","000","00","019","0000","0000","18449","13857","4592","1620","20069","39950","48870","50.24","34.69"
"67","000","00","019","1901","0000","464","349","115","29","493","1132","0","43.55","30.83"
"67","000","00","019","1901","0492","464","349","115","29","493","1132","0","43.55","30.83"
"67","000","00","019","1902","0000","1787","1375","412","168","1955","3935","0","49.68","34.94"
"67","000","00","019","1902","0493","840","644","196","67","907","1845","0","49.16","34.91"
"67","000","00","019","1902","0494","947","731","216","101","1048","2090","0","50.14","34.98"
"67","000","00","019","1903","0000","2623","1986","637","225","2848","5301","0","53.73","37.46"
"67","000","00","019","1903","0495","789","619","170","83","872","1582","0","55.12","39.13"
"67","000","00","019","1903","0496","958","710","248","85","1043","1901","0","54.87","37.35"
"67","000","00","019","1903","0497","876","657","219","57","933","1818","0","51.32","36.14"
"67","000","00","019","1904","0000","1339","1030","309","104","1443","2700","0","53.44","38.15"
"67","000","00","019","1904","0498","776","602","174","71","847","1639","0","51.68","36.73"
"67","000","00","019","1904","0499","563","428","135","33","596","1061","0","56.17","40.34"
"67","000","00","019","1905","0000","883","666","217","100","983","1786","0","55.04","37.29"
"67","000","00","019","1905","0500","883","666","217","100","983","1786","0","55.04","37.29"
"67","000","00","019","1908","0000","711","531","180","74","785","1581","0","49.65","33.59"
"67","000","00","019","1908","0502","711","531","180","74","785","1581","0","49.65","33.59"
"67","000","00","019","1909","0000","566","404","162","88","654","1240","0","52.74","32.58"
"67","000","00","019","1909","0503","566","404","162","88","654","1240","0","52.74","32.58"
"67","000","00","019","1910","0000","616","453","163","32","648","1743","0","37.18","25.99"
"67","000","00","019","1910","0504","616","453","163","32","648","1743","0","37.18","25.99"
"67","000","00","019","1911","0000","632","459","173","63","695","1246","0","55.78","36.84"
"67","000","00","019","1911","0505","632","459","173","63","695","1246","0","55.78","36.84"
"67","000","00","019","1912","0000","838","637","201","44","882","1899","0","46.45","33.54"
"67","000","00","019","1912","0506","431","327","104","28","459","961","0","47.76","34.03"
"67","000","00","019","1912","0507","407","310","97","16","423","938","0","45.1","33.05"
"67","000","00","019","1913","0000","333","243","90","19","352","722","0","48.75","33.66"
"67","000","00","019","1913","0508","333","243","90","19","352","722","0","48.75","33.66"
"67","000","00","019","1914","0000","430","330","100","21","451","1062","0","42.47","31.07"
"67","000","00","019","1914","0509","430","330","100","21","451","1062","0","42.47","31.07"
"67","000","00","019","1915","0000","772","579","193","95","867","1715","0","50.55","33.76"
"67","000","00","019","1915","0510","772","579","193","95","867","1715","0","50.55","33.76"
"67","000","00","019","1918","0000","748","552","196","68","816","1574","0","51.84","35.07"
"67","000","00","019","1918","0513","748","552","196","68","816","1574","0","51.84","35.07"
"67","000","00","019","1919","0000","607","429","178","83","690","1535","0","44.95","27.95"
"67","000","00","019","1919","0514","607","429","178","83","690","1535","0","44.95","27.95"
"67","000","00","019","1920","0000","520","370","150","59","579","1106","0","52.35","33.45"
"67","000","00","019","1920","0515","520","370","150","59","579","1106","0","52.35","33.45"
"67","000","00","019","1921","0000","1981","1474","507","181","2162","4240","0","50.99","34.76"
"67","000","00","019","1921","0516","613","459","154","43","656","1402","0","46.79","32.74"
"67","000","00","019","1921","0517","775","569","206","93","868","1458","0","59.53","39.03"
"67","000","00","019","1921","0518","593","446","147","45","638","1380","0","46.23","32.32"
"67","000","00","019","1922","0000","543","416","127","42","585","1147","0","51.0","36.27"
"67","000","00","019","1922","0501","543","416","127","42","585","1147","0","51.0","36.27"
"67","000","00","019","1923","0000","861","638","223","103","964","1985","0","48.56","32.14"
"67","000","00","019","1923","0511","479","361","118","56","535","1120","0","47.77","32.23"
"67","000","00","019","1923","0512","382","277","105","47","429","865","0","49.6","32.02"
"67","000","00","019","1924","0000","1195","936","259","22","1217","2301","0","52.89","40.68"
"67","000","00","019","1924","0519","632","491","141","10","642","1232","0","52.11","39.85"
"67","000","00","019","1924","0520","563","445","118","12","575","1069","0","53.79","41.63"
"67","000","00","020","0000","0000","14777","11298","3479","1250","16027","30386","36824","52.74","37.18"
"67","000","00","020","2001","0000","1421","1081","340","93","1514","2928","0","51.71","36.92"
"67","000","00","020","2001","0545","424","330","94","26","450","960","0","46.88","34.38"
"67","000","00","020","2001","0546","611","454","157","39","650","1118","0","58.14","40.61"
"67","000","00","020","2001","0547","386","297","89","28","414","850","0","48.71","34.94"
"67","000","00","020","2002","0000","3061","2387","674","247","3308","6063","0","54.56","39.37"
"67","000","00","020","2002","0548","603","489","114","58","661","1241","0","53.26","39.4"
"67","000","00","020","2002","0549","659","508","151","41","700","1297","0","53.97","39.17"
"67","000","00","020","2002","0550","496","407","89","44","540","962","0","56.13","42.31"
"67","000","00","020","2002","0551","640","494","146","57","697","1237","0","56.35","39.94"
"67","000","00","020","2002","0552","663","489","174","47","710","1326","0","53.54","36.88"
"67","000","00","020","2003","0000","1245","930","315","105","1350","2516","0","53.66","36.96"
"67","000","00","020","2003","0553","631","483","148","63","694","1211","0","57.31","39.88"
"67","000","00","020","2003","0554","614","447","167","42","656","1305","0","50.27","34.25"
"67","000","00","020","2004","0000","317","242","75","59","376","688","0","54.65","35.17"
"67","000","00","020","2004","0555","317","242","75","59","376","688","0","54.65","35.17"
"67","000","00","020","2005","0000","476","357","119","36","512","911","0","56.2","39.19"
"67","000","00","020","2005","0556","476","357","119","36","512","911","0","56.2","39.19"
"67","000","00","020","2006","0000","662","493","169","57","719","1525","0","47.15","32.33"
"67","000","00","020","2006","0557","662","493","169","57","719","1525","0","47.15","32.33"
"67","000","00","020","2007","0000","1420","1129","291","65","1485","3262","0","45.52","34.61"
"67","000","00","020","2007","0558","413","335","78","6","419","1091","0","38.41","30.71"
"67","000","00","020","2007","0559","535","417","118","28","563","1122","0","50.18","37.17"
"67","000","00","020","2007","0560","472","377","95","31","503","1049","0","47.95","35.94"
"67","000","00","020","2008","0000","2022","1535","487","115","2137","4457","0","47.95","34.44"
"67","000","00","020","2008","0561","634","504","130","22","656","1564","0","41.94","32.23"
"67","000","00","020","2008","0562","754","566","188","54","808","1515","0","53.33","37.36"
"67","000","00","020","2008","0563","634","465","169","39","673","1378","0","48.84","33.74"
"67","000","00","020","2009","0000","967","746","221","155","1122","1787","0","62.79","41.75"
"67","000","00","020","2009","0564","451","354","97","62","513","827","0","62.03","42.81"
"67","000","00","020","2009","0565","516","392","124","93","609","960","0","63.44","40.83"
"67","000","00","020","2010","0000","1623","1202","421","167","1790","3388","0","52.83","35.48"
"67","000","00","020","2010","0566","440","323","117","58","498","951","0","52.37","33.96"
"67","000","00","020","2010","0567","629","458","171","67","696","1264","0","55.06","36.23"
"67","000","00","020","2010","0568","554","421","133","42","596","1173","0","50.81","35.89"
"67","000","00","020","2011","0000","1563","1196","367","151","1714","2861","0","59.91","41.8"
"67","000","00","020","2011","0569","358","252","106","25","383","684","0","55.99","36.84"
"67","000","00","020","2011","0570","572","442","130","75","647","1055","0","61.33","41.9"
"67","000","00","020","2011","0571","633","502","131","51","684","1122","0","60.96","44.74"
"67","000","00","021","0000","0000","12414","9470","2944","1263","13677","26104","30522","52.39","36.28"
"67","000","00","021","2101","0000","1097","832","265","141","1238","2150","0","57.58","38.7"
"67","000","00","021","2101","0521","675","504","171","93","768","1251","0","61.39","40.29"
"67","000","00","021","2101","0522","422","328","94","48","470","899","0","52.28","36.48"
"67","000","00","021","2102","0000","985","754","231","142","1127","2054","0","54.87","36.71"
"67","000","00","021","2102","0523","522","404","118","80","602","1106","0","54.43","36.53"
"67","000","00","021","2102","0524","463","350","113","62","525","948","0","55.38","36.92"
"67","000","00","021","2103","0000","636","488","148","33","669","1442","0","46.39","33.84"
"67","000","00","021","2103","0525","636","488","148","33","669","1442","0","46.39","33.84"
"67","000","00","021","2104","0000","984","747","237","114","1098","2186","0","50.23","34.17"
"67","000","00","021","2104","0526","577","426","151","63","640","1385","0","46.21","30.76"
"67","000","00","021","2104","0527","407","321","86","51","458","801","0","57.18","40.07"
"67","000","00","021","2106","0000","656","498","158","78","734","1517","0","48.38","32.83"
"67","000","00","021","2106","0528","297","213","84","36","333","736","0","45.24","28.94"
"67","000","00","021","2106","0529","359","285","74","42","401","781","0","51.34","36.49"
"67","000","00","021","2107","0000","849","649","200","73","922","1657","0","55.64","39.17"
"67","000","00","021","2107","0530","398","306","92","20","418","795","0","52.58","38.49"
"67","000","00","021","2107","0531","451","343","108","53","504","862","0","58.47","39.79"
"67","000","00","021","2108","0000","1312","1027","285","56","1368","2872","0","47.63","35.76"
"67","000","00","021","2108","0532","667","530","137","27","694","1487","0","46.67","35.64"
"67","000","00","021","2108","0533","645","497","148","29","674","1385","0","48.66","35.88"
"67","000","00","021","2109","0000","1214","936","278","96","1310","2612","0","50.15","35.83"
"67","000","00","021","2109","0534","640","489","151","34","674","1518","0","44.4","32.21"
"67","000","00","021","2109","0535","574","447","127","62","636","1094","0","58.14","40.86"
"67","000","00","021","2112","0000","353","262","91","47","400","716","0","55.87","36.59"
"67","000","00","021","2112","0538","353","262","91","47","400","716","0","55.87","36.59"
"67","000","00","021","2113","0000","1220","931","289","106","1326","2435","0","54.46","38.23"
"67","000","00","021","2113","0539","748","573","175","63","811","1492","0","54.36","38.4"
"67","000","00","021","2113","0540","472","358","114","43","515","943","0","54.61","37.96"
"67","000","00","021","2114","0000","1202","920","282","143","1345","2541","0","52.93","36.21"
"67","000","00","021","2114","0541","542","418","124","36","578","1157","0","49.96","36.13"
"67","000","00","021","2114","0542","660","502","158","107","767","1384","0","55.42","36.27"
"67","000","00","021","2117","0000","757","560","197","83","840","1578","0","53.23","35.49"
"67","000","00","021","2117","0543","462","344","118","57","519","967","0","53.67","35.57"
"67","000","00","021","2117","0544","295","216","79","26","321","611","0","52.54","35.35"
"67","000","00","021","2118","0000","1149","866","283","151","1300","2344","0","55.46","36.95"
"67","000","00","021","2118","0536","769","573","196","109","878","1590","0","55.22","36.04"
"67","000","00","021","2118","0537","380","293","87","42","422","754","0","55.97","38.86"
"67","000","00","022","0000","0000","2482","1873","609","275","2757","6511","7328","42.34","28.77"
"67","000","00","022","2201","0000","579","441","138","94","673","1691","0","39.8","26.08"
"67","000","00","022","2201","0572","303","226","77","54","357","855","0","41.75","26.43"
"67","000","00","022","2201","0573","276","215","61","40","316","836","0","37.8","25.72"
"67","000","00","022","2202","0000","648","489","159","88","736","1541","0","47.76","31.73"
"67","000","00","022","2202","0574","318","235","83","47","365","753","0","48.47","31.21"
"67","000","00","022","2202","0575","330","254","76","41","371","788","0","47.08","32.23"
"67","000","00","022","2203","0000","441","337","104","48","489","984","0","49.7","34.25"
"67","000","00","022","2203","0576","441","337","104","48","489","984","0","49.7","34.25"
"67","000","00","022","2204","0000","375","266","109","8","383","972","0","39.4","27.37"
"67","000","00","022","2204","0577","375","266","109","8","383","972","0","39.4","27.37"
"67","000","00","022","2205","0000","151","118","33","5","156","553","0","28.21","21.34"
"67","000","00","022","2205","0578","151","118","33","5","156","553","0","28.21","21.34"
"67","000","00","022","2206","0000","134","109","25","7","141","378","0","37.3","28.84"
"67","000","00","022","2206","0579","134","109","25","7","141","378","0","37.3","28.84"
"67","000","00","022","2207","0000","154","113","41","25","179","392","0","45.66","28.83"
"67","000","00","022","2207","0580","154","113","41","25","179","392","0","45.66","28.83"
"67","000","00","023","0000","0000","5290","4104","1186","505","5795","12357","14021","46.9","33.21"
"67","000","00","023","2301","0000","545","430","115","27","572","1242","0","46.05","34.62"
"67","000","00","023","2301","0466","545","430","115","27","572","1242","0","46.05","34.62"
"67","000","00","023","2302","0000","1698","1339","359","125","1823","3637","0","50.12","36.82"
"67","000","00","023","2302","0467","552","443","109","37","589","1141","0","51.62","38.83"
"67","000","00","023","2302","0468","302","223","79","21","323","698","0","46.28","31.95"
"67","000","00","023","2302","0469","387","302","85","17","404","849","0","47.59","35.57"
"67","000","00","023","2302","0470","457","371","86","50","507","949","0","53.42","39.09"
"67","000","00","023","2303","0000","497","391","106","33","530","1212","0","43.73","32.26"
"67","000","00","023","2303","0471","278","210","68","23","301","618","0","48.71","33.98"
"67","000","00","023","2303","0472","219","181","38","10","229","594","0","38.55","30.47"
"67","000","00","023","2304","0000","575","446","129","70","645","1439","0","44.82","30.99"
"67","000","00","023","2304","0473","353","280","73","21","374","927","0","40.35","30.2"
"67","000","00","023","2304","0474","222","166","56","49","271","512","0","52.93","32.42"
"67","000","00","023","2305","0000","209","161","48","33","242","509","0","47.54","31.63"
"67","000","00","023","2305","0475","209","161","48","33","242","509","0","47.54","31.63"
"67","000","00","023","2306","0000","237","186","51","24","261","496","0","52.62","37.5"
"67","000","00","023","2306","0476","237","186","51","24","261","496","0","52.62","37.5"
"67","000","00","023","2307","0000","303","234","69","15","318","759","0","41.9","30.83"
"67","000","00","023","2307","0477","303","234","69","15","318","759","0","41.9","30.83"
"67","000","00","023","2308","0000","544","397","147","76","620","1456","0","42.58","27.27"
"67","000","00","023","2308","0478","226","168","58","12","238","669","0","35.58","25.11"
"67","000","00","023","2308","0479","318","229","89","64","382","787","0","48.54","29.1"
"67","000","00","023","2309","0000","237","180","57","46","283","620","0","45.65","29.03"
"67","000","00","023","2309","0480","237","180","57","46","283","620","0","45.65","29.03"
"67","000","00","023","2310","0000","445","340","105","56","501","987","0","50.76","34.45"
"67","000","00","023","2310","0481","445","340","105","56","501","987","0","50.76","34.45"
"67","000","00","024","0000","0000","3316","2572","744","341","3657","8528","9572","42.88","30.16"
"67","000","00","024","2401","0000","846","631","215","102","948","1848","0","51.3","34.15"
"67","000","00","024","2401","0447","416","305","111","60","476","978","0","48.67","31.19"
"67","000","00","024","2401","0448","430","326","104","42","472","870","0","54.25","37.47"
"67","000","00","024","2402","0000","330","265","65","10","340","1160","0","29.31","22.84"
"67","000","00","024","2402","0449","330","265","65","10","340","1160","0","29.31","22.84"
"67","000","00","024","2403","0000","255","196","59","27","282","699","0","40.34","28.04"
"67","000","00","024","2403","0450","255","196","59","27","282","699","0","40.34","28.04"
"67","000","00","024","2404","0000","319","254","65","15","334","990","0","33.74","25.66"
"67","000","00","024","2404","0451","319","254","65","15","334","990","0","33.74","25.66"
"67","000","00","024","2405","0000","359","281","78","32","391","928","0","42.13","30.28"
"67","000","00","024","2405","0452","359","281","78","32","391","928","0","42.13","30.28"
"67","000","00","024","2406","0000","268","210","58","44","312","660","0","47.27","31.82"
"67","000","00","024","2406","0453","268","210","58","44","312","660","0","47.27","31.82"
"67","000","00","024","2407","0000","939","735","204","111","1050","2243","0","46.81","32.77"
"67","000","00","024","2407","0454","500","394","106","76","576","1187","0","48.53","33.19"
"67","000","00","024","2407","0455","439","341","98","35","474","1056","0","44.89","32.29"
"67","000","00","025","0000","0000","3264","2456","808","355","3619","7786","8741","46.48","31.54"
"67","000","00","025","2501","0000","645","476","169","103","748","1385","0","54.01","34.37"
"67","000","00","025","2501","0456","321","233","88","46","367","690","0","53.19","33.77"
"67","000","00","025","2501","0457","324","243","81","57","381","695","0","54.82","34.96"
"67","000","00","025","2502","0000","318","231","87","38","356","806","0","44.17","28.66"
"67","000","00","025","2502","0458","318","231","87","38","356","806","0","44.17","28.66"
"67","000","00","025","2503","0000","185","127","58","20","205","425","0","48.24","29.88"
"67","000","00","025","2503","0461","185","127","58","20","205","425","0","48.24","29.88"
"67","000","00","025","2504","0000","242","185","57","32","274","559","0","49.02","33.09"
"67","000","00","025","2504","0462","242","185","57","32","274","559","0","49.02","33.09"
"67","000","00","025","2505","0000","221","168","53","48","269","654","0","41.13","25.69"
"67","000","00","025","2505","0459","221","168","53","48","269","654","0","41.13","25.69"
"67","000","00","025","2506","0000","251","186","65","33","284","783","0","36.27","23.75"
"67","000","00","025","2506","0460","251","186","65","33","284","783","0","36.27","23.75"
"67","000","00","025","2507","0000","444","346","98","25","469","1189","0","39.44","29.1"
"67","000","00","025","2507","0463","444","346","98","25","469","1189","0","39.44","29.1"
"67","000","00","025","2508","0000","491","361","130","35","526","1044","0","50.38","34.58"
"67","000","00","025","2508","0464","491","361","130","35","526","1044","0","50.38","34.58"
"67","000","00","025","2509","0000","467","376","91","21","488","941","0","51.86","39.96"
"67","000","00","025","2509","0465","467","376","91","21","488","941","0","51.86","39.96"
"67","000","00","026","0000","0000","1673","1234","439","231","1904","4418","4801","43.1","27.93"
"67","000","00","026","2601","0000","167","130","37","20","187","392","0","47.7","33.16"
"67","000","00","026","2601","0482","167","130","37","20","187","392","0","47.7","33.16"
"67","000","00","026","2602","0000","294","230","64","41","335","644","0","52.02","35.71"
"67","000","00","026","2602","0483","294","230","64","41","335","644","0","52.02","35.71"
"67","000","00","026","2603","0000","163","116","47","18","181","468","0","38.68","24.79"
"67","000","00","026","2603","0484","163","116","47","18","181","468","0","38.68","24.79"
"67","000","00","026","2604","0000","265","181","84","47","312","753","0","41.43","24.04"
"67","000","00","026","2604","0485","265","181","84","47","312","753","0","41.43","24.04"
"67","000","00","026","2605","0000","134","103","31","23","157","345","0","45.51","29.86"
"67","000","00","026","2605","0486","134","103","31","23","157","345","0","45.51","29.86"
"67","000","00","026","2606","0000","151","112","39","13","164","393","0","41.73","28.5"
"67","000","00","026","2606","0487","151","112","39","13","164","393","0","41.73","28.5"
"67","000","00","026","2607","0000","174","122","52","45","219","504","0","43.45","24.21"
"67","000","00","026","2607","0491","174","122","52","45","219","504","0","43.45","24.21"
"67","000","00","026","2608","0000","160","122","38","13","173","420","0","41.19","29.05"
"67","000","00","026","2608","0488","160","122","38","13","173","420","0","41.19","29.05"
"67","000","00","026","2609","0000","104","79","25","8","112","313","0","35.78","25.24"
"67","000","00","026","2609","0489","104","79","25","8","112","313","0","35.78","25.24"
"67","000","00","026","2610","0000","61","39","22","3","64","186","0","34.41","20.97"
"67","000","00","026","2610","0490","61","39","22","3","64","186","0","34.41","20.97"
"67","000","00","027","0000","0000","31057","24009","7048","2573","33630","64632","75797","52.03","37.15"
"67","000","00","027","2701","0000","2653","2011","642","315","2968","5381","0","55.16","37.37"
"67","000","00","027","2701","1188","650","498","152","71","721","1318","0","54.7","37.78"
"67","000","00","027","2701","1189","688","533","155","80","768","1406","0","54.62","37.91"
"67","000","00","027","2701","1190","676","517","159","86","762","1465","0","52.01","35.29"
"67","000","00","027","2701","1191","639","463","176","78","717","1192","0","60.15","38.84"
"67","000","00","027","2702","0000","1359","1000","359","184","1543","2749","0","56.13","36.38"
"67","000","00","027","2702","1192","754","571","183","66","820","1429","0","57.38","39.96"
"67","000","00","027","2702","1193","605","429","176","118","723","1320","0","54.77","32.5"
"67","000","00","027","2703","0000","1435","1120","315","151","1586","2703","0","58.68","41.44"
"67","000","00","027","2703","1194","735","588","147","92","827","1373","0","60.23","42.83"
"67","000","00","027","2703","1195","700","532","168","59","759","1330","0","57.07","40.0"
"67","000","00","027","2704","0000","3533","2770","763","215","3748","7201","0","52.05","38.47"
"67","000","00","027","2704","1196","874","684","190","40","914","1687","0","54.18","40.55"
"67","000","00","027","2704","1197","697","529","168","57","754","1491","0","50.57","35.48"
"67","000","00","027","2704","1198","497","375","122","41","538","1151","0","46.74","32.58"
"67","000","00","027","2704","1199","691","573","118","24","715","1407","0","50.82","40.72"
"67","000","00","027","2704","1200","774","609","165","53","827","1465","0","56.45","41.57"
"67","000","00","027","2705","0000","4558","3464","1094","371","4929","9066","0","54.37","38.21"
"67","000","00","027","2705","1201","698","520","178","49","747","1335","0","55.96","38.95"
"67","000","00","027","2705","1202","712","539","173","71","783","1490","0","52.55","36.17"
"67","000","00","027","2705","1203","792","628","164","58","850","1453","0","58.5","43.22"
"67","000","00","027","2705","1204","455","328","127","27","482","990","0","48.69","33.13"
"67","000","00","027","2705","1205","816","641","175","65","881","1573","0","56.01","40.75"
"67","000","00","027","2705","1206","497","372","125","69","566","1031","0","54.9","36.08"
"67","000","00","027","2705","1207","588","436","152","32","620","1194","0","51.93","36.52"
"67","000","00","027","2706","0000","1552","1184","368","118","1670","3342","0","49.97","35.43"
"67","000","00","027","2706","1208","592","459","133","60","652","1268","0","51.42","36.2"
"67","000","00","027","2706","1209","467","338","129","42","509","929","0","54.79","36.38"
"67","000","00","027","2706","1210","493","387","106","16","509","1145","0","44.45","33.8"
"67","000","00","027","2707","0000","4454","3402","1052","362","4816","9116","0","52.83","37.32"
"67","000","00","027","2707","1211","644","500","144","61","705","1413","0","49.89","35.39"
"67","000","00","027","2707","1212","697","526","171","89","786","1465","0","53.65","35.9"
"67","000","00","027","2707","1213","738","571","167","58","796","1390","0","57.27","41.08"
"67","000","00","027","2707","1214","694","486","208","70","764","1396","0","54.73","34.81"
"67","000","00","027","2707","1215","945","724","221","48","993","1906","0","52.1","37.99"
"67","000","00","027","2707","1216","736","595","141","36","772","1546","0","49.94","38.49"
"67","000","00","027","2708","0000","2754","2132","622","229","2983","5833","0","51.14","36.55"
"67","000","00","027","2708","1217","637","492","145","33","670","1546","0","43.34","31.82"
"67","000","00","027","2708","1218","692","546","146","51","743","1399","0","53.11","39.03"
"67","000","00","027","2708","1219","823","636","187","102","925","1748","0","52.92","36.38"
"67","000","00","027","2708","1220","602","458","144","43","645","1140","0","56.58","40.18"
"67","000","00","027","2711","0000","1182","917","265","67","1249","2763","0","45.2","33.19"
"67","000","00","027","2711","1223","620","484","136","34","654","1414","0","46.25","34.23"
"67","000","00","027","2711","1224","562","433","129","33","595","1349","0","44.11","32.1"
"67","000","00","027","2712","0000","2165","1714","451","129","2294","4659","0","49.24","36.79"
"67","000","00","027","2712","1225","676","530","146","31","707","1471","0","48.06","36.03"
"67","000","00","027","2712","1226","624","482","142","20","644","1324","0","48.64","36.4"
"67","000","00","027","2712","1227","571","481","90","51","622","1310","0","47.48","36.72"
"67","000","00","027","2712","1228","294","221","73","27","321","554","0","57.94","39.89"
"67","000","00","027","2713","0000","705","601","104","43","748","1395","0","53.62","43.08"
"67","000","00","027","2713","1229","705","601","104","43","748","1395","0","53.62","43.08"
"67","000","00","027","2714","0000","601","503","98","18","619","1264","0","48.97","39.79"
"67","000","00","027","2714","1230","601","503","98","18","619","1264","0","48.97","39.79"
"67","000","00","027","2715","0000","907","700","207","118","1025","2108","0","48.62","33.21"
"67","000","00","027","2715","1231","529","424","105","87","616","1180","0","52.2","35.93"
"67","000","00","027","2715","1232","378","276","102","31","409","928","0","44.07","29.74"
"67","000","00","027","2716","0000","853","645","208","60","913","2084","0","43.81","30.95"
"67","000","00","027","2716","1233","392","294","98","25","417","965","0","43.21","30.47"
"67","000","00","027","2716","1234","461","351","110","35","496","1119","0","44.33","31.37"
"67","000","00","027","2717","0000","1178","920","258","115","1293","2672","0","48.39","34.43"
"67","000","00","027","2717","1235","577","446","131","71","648","1206","0","53.73","36.98"
"67","000","00","027","2717","1236","601","474","127","44","645","1466","0","44.0","32.33"
"67","000","00","027","2719","0000","1168","926","242","78","1246","2296","0","54.27","40.33"
"67","000","00","027","2719","1221","569","448","121","34","603","1277","0","47.22","35.08"
"67","000","00","027","2719","1222","599","478","121","44","643","1019","0","63.1","46.91"
"67","000","00","028","0000","0000","27319","20762","6557","2338","29657","57387","68391","51.68","36.18"
"67","000","00","028","2801","0000","2860","2131","729","263","3123","5916","0","52.79","36.02"
"67","000","00","028","2801","1237","723","539","184","73","796","1560","0","51.03","34.55"
"67","000","00","028","2801","1238","755","578","177","80","835","1383","0","60.38","41.79"
"67","000","00","028","2801","1239","728","540","188","39","767","1491","0","51.44","36.22"
"67","000","00","028","2801","1240","654","474","180","71","725","1482","0","48.92","31.98"
"67","000","00","028","2802","0000","1567","1146","421","142","1709","3756","0","45.5","30.51"
"67","000","00","028","2802","1244","510","371","139","48","558","1336","0","41.77","27.77"
"67","000","00","028","2802","1245","519","379","140","67","586","1183","0","49.54","32.04"
"67","000","00","028","2802","1246","538","396","142","27","565","1237","0","45.68","32.01"
"67","000","00","028","2803","0000","1155","866","289","111","1266","2293","0","55.21","37.77"
"67","000","00","028","2803","1271","642","486","156","68","710","1245","0","57.03","39.04"
"67","000","00","028","2803","1272","513","380","133","43","556","1048","0","53.05","36.26"
"67","000","00","028","2804","0000","1620","1228","392","152","1772","3286","0","53.93","37.37"
"67","000","00","028","2804","1249","537","416","121","7","544","1105","0","49.23","37.65"
"67","000","00","028","2804","1250","543","395","148","57","600","1099","0","54.6","35.94"
"67","000","00","028","2804","1251","540","417","123","88","628","1082","0","58.04","38.54"
"67","000","00","028","2805","0000","1510","1136","374","127","1637","3301","0","49.59","34.41"
"67","000","00","028","2805","1254","520","392","128","51","571","1090","0","52.39","35.96"
"67","000","00","028","2805","1255","514","383","131","37","551","1131","0","48.72","33.86"
"67","000","00","028","2805","1256","476","361","115","39","515","1080","0","47.69","33.43"
"67","000","00","028","2806","0000","1580","1166","414","135","1715","3285","0","52.21","35.49"
"67","000","00","028","2806","1259","539","383","156","74","613","1128","0","54.34","33.95"
"67","000","00","028","2806","1260","500","382","118","27","527","1055","0","49.95","36.21"
"67","000","00","028","2806","1261","541","401","140","34","575","1102","0","52.18","36.39"
"67","000","00","028","2807","0000","1048","807","241","123","1171","2101","0","55.74","38.41"
"67","000","00","028","2807","1262","529","417","112","49","578","1068","0","54.12","39.04"
"67","000","00","028","2807","1263","519","390","129","74","593","1033","0","57.41","37.75"
"67","000","00","028","2808","0000","629","492","137","44","673","1772","0","37.98","27.77"
"67","000","00","028","2808","1264","629","492","137","44","673","1772","0","37.98","27.77"
"67","000","00","028","2809","0000","1428","1107","321","115","1543","2943","0","52.43","37.61"
"67","000","00","028","2809","1265","690","523","167","82","772","1399","0","55.18","37.38"
"67","000","00","028","2809","1266","738","584","154","33","771","1544","0","49.94","37.82"
"67","000","00","028","2810","0000","278","220","58","12","290","684","0","42.4","32.16"
"67","000","00","028","2810","1267","278","220","58","12","290","684","0","42.4","32.16"
"67","000","00","028","2811","0000","959","683","276","114","1073","1853","0","57.91","36.86"
"67","000","00","028","2811","1268","441","312","129","46","487","839","0","58.05","37.19"
"67","000","00","028","2811","1269","518","371","147","68","586","1014","0","57.79","36.59"
"67","000","00","028","2812","0000","650","512","138","40","690","1906","0","36.2","26.86"
"67","000","00","028","2812","1270","650","512","138","40","690","1906","0","36.2","26.86"
"67","000","00","028","2813","0000","1148","883","265","60","1208","2586","0","46.71","34.15"
"67","000","00","028","2813","1273","537","410","127","29","566","1175","0","48.17","34.89"
"67","000","00","028","2813","1274","611","473","138","31","642","1411","0","45.5","33.52"
"67","000","00","028","2814","0000","1626","1248","378","132","1758","3192","0","55.08","39.1"
"67","000","00","028","2814","1275","800","621","179","55","855","1514","0","56.47","41.02"
"67","000","00","028","2814","1276","826","627","199","77","903","1678","0","53.81","37.37"
"67","000","00","028","2815","0000","1005","730","275","96","1101","1958","0","56.23","37.28"
"67","000","00","028","2815","1277","475","354","121","31","506","949","0","53.32","37.3"
"67","000","00","028","2815","1278","530","376","154","65","595","1009","0","58.97","37.26"
"67","000","00","028","2816","0000","977","755","222","48","1025","1740","0","58.91","43.39"
"67","000","00","028","2816","1279","576","445","131","5","581","984","0","59.04","45.22"
"67","000","00","028","2816","1280","401","310","91","43","444","756","0","58.73","41.01"
"67","000","00","028","2817","0000","1595","1233","362","141","1736","2945","0","58.95","41.87"
"67","000","00","028","2817","1281","802","626","176","69","871","1478","0","58.93","42.35"
"67","000","00","028","2817","1282","793","607","186","72","865","1467","0","58.96","41.38"
"67","000","00","028","2818","0000","2017","1526","491","116","2133","4145","0","51.46","36.82"
"67","000","00","028","2818","1241","643","478","165","33","676","1330","0","50.83","35.94"
"67","000","00","028","2818","1242","731","560","171","49","780","1399","0","55.75","40.03"
"67","000","00","028","2818","1243","643","488","155","34","677","1416","0","47.81","34.46"
"67","000","00","028","2819","0000","1098","816","282","112","1210","2457","0","49.25","33.21"
"67","000","00","028","2819","1257","462","352","110","28","490","1121","0","43.71","31.4"
"67","000","00","028","2819","1258","636","464","172","84","720","1336","0","53.89","34.73"
"67","000","00","028","2820","0000","1074","824","250","125","1199","2282","0","52.54","36.11"
"67","000","00","028","2820","1247","552","437","115","77","629","1133","0","55.52","38.57"
"67","000","00","028","2820","1248","522","387","135","48","570","1149","0","49.61","33.68"
"67","000","00","028","2821","0000","1495","1253","242","130","1625","2986","0","54.42","41.96"
"67","000","00","028","2821","1252","734","673","61","57","791","1519","0","52.07","44.31"
"67","000","00","028","2821","1253","761","580","181","73","834","1467","0","56.85","39.54"
"67","000","00","029","0000","0000","14126","10607","3519","1243","15369","29913","34387","51.38","35.46"
"67","000","00","029","2901","0000","1074","803","271","72","1146","2138","0","53.6","37.56"
"67","000","00","029","2901","1283","458","344","114","27","485","982","0","49.39","35.03"
"67","000","00","029","2901","1284","616","459","157","45","661","1156","0","57.18","39.71"
"67","000","00","029","2902","0000","1002","729","273","92","1094","2049","0","53.39","35.58"
"67","000","00","029","2902","1285","431","320","111","33","464","1006","0","46.12","31.81"
"67","000","00","029","2902","1286","571","409","162","59","630","1043","0","60.4","39.21"
"67","000","00","029","2903","0000","1509","1136","373","151","1660","3319","0","50.02","34.23"
"67","000","00","029","2903","1287","494","375","119","87","581","1012","0","57.41","37.06"
"67","000","00","029","2903","1288","412","312","100","23","435","1013","0","42.94","30.8"
"67","000","00","029","2903","1289","603","449","154","41","644","1294","0","49.77","34.7"
"67","000","00","029","2904","0000","1128","826","302","87","1215","2430","0","50.0","33.99"
"67","000","00","029","2904","1290","577","413","164","46","623","1264","0","49.29","32.67"
"67","000","00","029","2904","1291","551","413","138","41","592","1166","0","50.77","35.42"
"67","000","00","029","2905","0000","442","335","107","20","462","1018","0","45.38","32.91"
"67","000","00","029","2905","1292","442","335","107","20","462","1018","0","45.38","32.91"
"67","000","00","029","2906","0000","301","226","75","40","341","733","0","46.52","30.83"
"67","000","00","029","2906","1293","301","226","75","40","341","733","0","46.52","30.83"
"67","000","00","029","2907","0000","1655","1287","368","96","1751","3152","0","55.55","40.83"
"67","000","00","029","2907","1294","578","449","129","32","610","1093","0","55.81","41.08"
"67","000","00","029","2907","1295","548","446","102","23","571","1081","0","52.82","41.26"
"67","000","00","029","2907","1296","529","392","137","41","570","978","0","58.28","40.08"
"67","000","00","029","2908","0000","1456","1077","379","168","1624","3133","0","51.84","34.38"
"67","000","00","029","2908","1297","474","358","116","31","505","1116","0","45.25","32.08"
"67","000","00","029","2908","1298","469","353","116","48","517","972","0","53.19","36.32"
"67","000","00","029","2908","1299","513","366","147","89","602","1045","0","57.61","35.02"
"67","000","00","029","2909","0000","958","727","231","69","1027","1879","0","54.66","38.69"
"67","000","00","029","2909","1300","427","332","95","32","459","872","0","52.64","38.07"
"67","000","00","029","2909","1301","531","395","136","37","568","1007","0","56.41","39.23"
"67","000","00","029","2912","0000","707","516","191","90","797","1524","0","52.3","33.86"
"67","000","00","029","2912","1306","384","270","114","72","456","804","0","56.72","33.58"
"67","000","00","029","2912","1307","323","246","77","18","341","720","0","47.36","34.17"
"67","000","00","029","2913","0000","484","402","82","33","517","1201","0","43.05","33.47"
"67","000","00","029","2913","1308","330","278","52","22","352","843","0","41.76","32.98"
"67","000","00","029","2913","1309","154","124","30","11","165","358","0","46.09","34.64"
"67","000","00","029","2916","0000","819","612","207","47","866","1867","0","46.38","32.78"
"67","000","00","029","2916","1312","381","277","104","20","401","904","0","44.36","30.64"
"67","000","00","029","2916","1313","438","335","103","27","465","963","0","48.29","34.79"
"67","000","00","029","2917","0000","235","175","60","9","244","489","0","49.9","35.79"
"67","000","00","029","2917","1314","235","175","60","9","244","489","0","49.9","35.79"
"67","000","00","029","2918","0000","1710","1263","447","193","1903","3475","0","54.76","36.35"
"67","000","00","029","2918","1302","398","283","115","59","457","763","0","59.9","37.09"
"67","000","00","029","2918","1303","300","240","60","34","334","630","0","53.02","38.1"
"67","000","00","029","2918","1304","488","352","136","65","553","959","0","57.66","36.7"
"67","000","00","029","2918","1305","524","388","136","35","559","1123","0","49.78","34.55"
"67","000","00","029","2919","0000","646","493","153","76","722","1506","0","47.94","32.74"
"67","000","00","029","2919","1310","364","270","94","61","425","797","0","53.32","33.88"
"67","000","00","029","2919","1311","282","223","59","15","297","709","0","41.89","31.45"
"67","000","00","030","0000","0000","1539","1191","348","160","1699","3713","3999","45.76","32.08"
"67","000","00","030","3001","0000","466","353","113","67","533","1047","0","50.91","33.72"
"67","000","00","030","3001","1315","466","353","113","67","533","1047","0","50.91","33.72"
"67","000","00","030","3002","0000","249","198","51","19","268","630","0","42.54","31.43"
"67","000","00","030","3002","1316","249","198","51","19","268","630","0","42.54","31.43"
"67","000","00","030","3003","0000","46","34","12","3","49","141","0","34.75","24.11"
"67","000","00","030","3003","1317","46","34","12","3","49","141","0","34.75","24.11"
"67","000","00","030","3004","0000","159","114","45","15","174","367","0","47.41","31.06"
"67","000","00","030","3004","1318","159","114","45","15","174","367","0","47.41","31.06"
"67","000","00","030","3005","0000","150","116","34","10","160","337","0","47.48","34.42"
"67","000","00","030","3005","1319","150","116","34","10","160","337","0","47.48","34.42"
"67","000","00","030","3006","0000","119","94","25","6","125","318","0","39.31","29.56"
"67","000","00","030","3006","1320","119","94","25","6","125","318","0","39.31","29.56"
"67","000","00","030","3007","0000","187","162","25","26","213","427","0","49.88","37.94"
"67","000","00","030","3007","1321","187","162","25","26","213","427","0","49.88","37.94"
"67","000","00","030","3008","0000","163","120","43","14","177","446","0","39.69","26.91"
"67","000","00","030","3008","1322","163","120","43","14","177","446","0","39.69","26.91"
"67","000","00","031","0000","0000","92822","71529","21293","6646","99468","195001","234921","51.01","36.68"
"67","000","00","031","3101","0000","2557","1983","574","202","2759","5671","0","48.65","34.97"
"67","000","00","031","3101","0708","691","544","147","67","758","1398","0","54.22","38.91"
"67","000","00","031","3101","0709","581","448","133","42","623","1478","0","42.15","30.31"
"67","000","00","031","3101","0710","675","500","175","40","715","1442","0","49.58","34.67"
"67","000","00","031","3101","0711","610","491","119","53","663","1353","0","49.0","36.29"
"67","000","00","031","3102","0000","3108","2361","747","247","3355","6821","0","49.19","34.61"
"67","000","00","031","3102","0719","750","565","185","77","827","1709","0","48.39","33.06"
"67","000","00","031","3102","0720","769","591","178","65","834","1717","0","48.57","34.42"
"67","000","00","031","3102","0721","782","586","196","57","839","1759","0","47.7","33.31"
"67","000","00","031","3102","0722","807","619","188","48","855","1636","0","52.26","37.84"
"67","000","00","031","3103","0000","3692","2843","849","274","3966","8791","0","45.11","32.34"
"67","000","00","031","3103","0728","706","530","176","32","738","1389","0","53.13","38.16"
"67","000","00","031","3103","0729","647","495","152","70","717","1369","0","52.37","36.16"
"67","000","00","031","3103","0730","674","519","155","91","765","1415","0","54.06","36.68"
"67","000","00","031","3103","0731","579","453","126","19","598","1386","0","43.15","32.68"
"67","000","00","031","3103","0732","385","305","80","5","390","1747","0","22.32","17.46"
"67","000","00","031","3103","0733","701","541","160","57","758","1485","0","51.04","36.43"
"67","000","00","031","3104","0000","3173","2460","713","248","3421","7088","0","48.26","34.71"
"67","000","00","031","3104","0734","796","623","173","91","887","1747","0","50.77","35.66"
"67","000","00","031","3104","0735","707","541","166","41","748","1744","0","42.89","31.02"
"67","000","00","031","3104","0736","778","612","166","45","823","1797","0","45.8","34.06"
"67","000","00","031","3104","0737","892","684","208","71","963","1800","0","53.5","38.0"
"67","000","00","031","3105","0000","2894","2207","687","193","3087","5710","0","54.06","38.65"
"67","000","00","031","3105","0745","762","571","191","61","823","1531","0","53.76","37.3"
"67","000","00","031","3105","0746","703","539","164","54","757","1327","0","57.05","40.62"
"67","000","00","031","3105","0747","705","546","159","30","735","1456","0","50.48","37.5"
"67","000","00","031","3105","0748","724","551","173","48","772","1396","0","55.3","39.47"
"67","000","00","031","3106","0000","1229","955","274","119","1348","2525","0","53.39","37.82"
"67","000","00","031","3106","0785","648","497","151","86","734","1285","0","57.12","38.68"
"67","000","00","031","3106","0786","581","458","123","33","614","1240","0","49.52","36.94"
"67","000","00","031","3107","0000","1313","994","319","118","1431","2670","0","53.6","37.23"
"67","000","00","031","3107","0787","612","463","149","58","670","1343","0","49.89","34.48"
"67","000","00","031","3107","0788","701","531","170","60","761","1327","0","57.35","40.02"
"67","000","00","031","3108","0000","946","726","220","49","995","1862","0","53.44","38.99"
"67","000","00","031","3108","0758","447","333","114","16","463","924","0","50.11","36.04"
"67","000","00","031","3108","0759","499","393","106","33","532","938","0","56.72","41.9"
"67","000","00","031","3109","0000","728","559","169","86","814","1453","0","56.02","38.47"
"67","000","00","031","3109","0760","494","395","99","44","538","957","0","56.22","41.27"
"67","000","00","031","3109","0761","234","164","70","42","276","496","0","55.65","33.06"
"67","000","00","031","3110","0000","2254","1709","545","146","2400","4886","0","49.12","34.98"
"67","000","00","031","3110","0762","835","638","197","71","906","1717","0","52.77","37.16"
"67","000","00","031","3110","0763","695","528","167","49","744","1615","0","46.07","32.69"
"67","000","00","031","3110","0764","724","543","181","26","750","1554","0","48.26","34.94"
"67","000","00","031","3111","0000","1217","923","294","123","1340","2276","0","58.88","40.55"
"67","000","00","031","3111","0772","466","365","101","49","515","890","0","57.87","41.01"
"67","000","00","031","3111","0773","558","415","143","53","611","1018","0","60.02","40.77"
"67","000","00","031","3111","0774","193","143","50","21","214","368","0","58.15","38.86"
"67","000","00","031","3112","0000","1637","1260","377","151","1788","3366","0","53.12","37.43"
"67","000","00","031","3112","0795","512","399","113","75","587","1117","0","52.55","35.72"
"67","000","00","031","3112","0796","471","337","134","33","504","1069","0","47.15","31.52"
"67","000","00","031","3112","0797","654","524","130","43","697","1180","0","59.07","44.41"
"67","000","00","031","3113","0000","1726","1275","451","230","1956","3542","0","55.22","36.0"
"67","000","00","031","3113","0798","552","418","134","90","642","1176","0","54.59","35.54"
"67","000","00","031","3113","0799","550","391","159","56","606","1158","0","52.33","33.77"
"67","000","00","031","3113","0800","624","466","158","84","708","1208","0","58.61","38.58"
"67","000","00","031","3114","0000","3643","2815","828","296","3939","7237","0","54.43","38.9"
"67","000","00","031","3114","0801","708","524","184","91","799","1501","0","53.23","34.91"
"67","000","00","031","3114","0802","659","531","128","43","702","1298","0","54.08","40.91"
"67","000","00","031","3114","0803","728","558","170","34","762","1542","0","49.42","36.19"
"67","000","00","031","3114","0804","796","618","178","61","857","1537","0","55.76","40.21"
"67","000","00","031","3114","0805","752","584","168","67","819","1359","0","60.26","42.97"
"67","000","00","031","3115","0000","1685","1261","424","181","1866","3835","0","48.66","32.88"
"67","000","00","031","3115","0806","472","353","119","44","516","1139","0","45.3","30.99"
"67","000","00","031","3115","0807","527","393","134","46","573","1158","0","49.48","33.94"
"67","000","00","031","3115","0808","686","515","171","91","777","1538","0","50.52","33.49"
"67","000","00","031","3116","0000","2810","2099","711","186","2996","5872","0","51.02","35.75"
"67","000","00","031","3116","0809","507","395","112","32","539","1166","0","46.23","33.88"
"67","000","00","031","3116","0810","554","424","130","21","575","1228","0","46.82","34.53"
"67","000","00","031","3116","0811","610","453","157","59","669","1200","0","55.75","37.75"
"67","000","00","031","3116","0812","591","431","160","42","633","1131","0","55.97","38.11"
"67","000","00","031","3116","0813","548","396","152","32","580","1147","0","50.57","34.52"
"67","000","00","031","3117","0000","1802","1382","420","126","1928","4027","0","47.88","34.32"
"67","000","00","031","3117","0814","672","528","144","57","729","1442","0","50.55","36.62"
"67","000","00","031","3117","0815","599","455","144","33","632","1325","0","47.7","34.34"
"67","000","00","031","3117","0816","531","399","132","36","567","1260","0","45.0","31.67"
"67","000","00","031","3118","0000","1063","784","279","156","1219","2099","0","58.08","37.35"
"67","000","00","031","3118","0793","492","380","112","80","572","983","0","58.19","38.66"
"67","000","00","031","3118","0794","571","404","167","76","647","1116","0","57.97","36.2"
"67","000","00","031","3119","0000","837","657","180","80","917","1988","0","46.13","33.05"
"67","000","00","031","3119","0820","442","353","89","54","496","1012","0","49.01","34.88"
"67","000","00","031","3119","0821","395","304","91","26","421","976","0","43.14","31.15"
"67","000","00","031","3120","0000","3939","3101","838","263","4202","8430","0","49.85","36.79"
"67","000","00","031","3120","0825","651","515","136","47","698","1307","0","53.4","39.4"
"67","000","00","031","3120","0826","645","521","124","27","672","1482","0","45.34","35.16"
"67","000","00","031","3120","0827","578","459","119","40","618","1341","0","46.09","34.23"
"67","000","00","031","3120","0828","657","523","134","40","697","1376","0","50.65","38.01"
"67","000","00","031","3120","0829","639","492","147","51","690","1390","0","49.64","35.4"
"67","000","00","031","3120","0830","769","591","178","58","827","1534","0","53.91","38.53"
"67","000","00","031","3121","0000","843","677","166","91","934","1796","0","52.0","37.69"
"67","000","00","031","3121","0823","420","349","71","52","472","859","0","54.95","40.63"
"67","000","00","031","3121","0824","423","328","95","39","462","937","0","49.31","35.01"
"67","000","00","031","3122","0000","541","424","117","47","588","1151","0","51.09","36.84"
"67","000","00","031","3122","0838","541","424","117","47","588","1151","0","51.09","36.84"
"67","000","00","031","3123","0000","2988","2287","701","238","3226","5980","0","53.95","38.24"
"67","000","00","031","3123","0789","754","577","177","58","812","1565","0","51.88","36.87"
"67","000","00","031","3123","0790","733","570","163","89","822","1476","0","55.69","38.62"
"67","000","00","031","3123","0791","721","561","160","38","759","1476","0","51.42","38.01"
"67","000","00","031","3123","0792","780","579","201","53","833","1463","0","56.94","39.58"
"67","000","00","031","3124","0000","1095","880","215","69","1164","2097","0","55.51","41.96"
"67","000","00","031","3124","0839","615","501","114","45","660","1026","0","64.33","48.83"
"67","000","00","031","3124","0840","480","379","101","24","504","1071","0","47.06","35.39"
"67","000","00","031","3125","0000","1634","1243","391","103","1737","3387","0","51.28","36.7"
"67","000","00","031","3125","0843","832","641","191","62","894","1687","0","52.99","38.0"
"67","000","00","031","3125","0844","802","602","200","41","843","1700","0","49.59","35.41"
"67","000","00","031","3126","0000","3615","2792","823","207","3822","7729","0","49.45","36.12"
"67","000","00","031","3126","0845","760","564","196","44","804","1444","0","55.68","39.06"
"67","000","00","031","3126","0846","707","552","155","46","753","1485","0","50.71","37.17"
"67","000","00","031","3126","0847","765","607","158","37","802","1717","0","46.71","35.35"
"67","000","00","031","3126","0848","746","563","183","50","796","1701","0","46.8","33.1"
"67","000","00","031","3126","0849","637","506","131","30","667","1382","0","48.26","36.61"
"67","000","00","031","3127","0000","2739","2089","650","242","2981","6072","0","49.09","34.4"
"67","000","00","031","3127","0778","665","514","151","65","730","1405","0","51.96","36.58"
"67","000","00","031","3127","0779","654","481","173","68","722","1445","0","49.97","33.29"
"67","000","00","031","3127","0780","781","607","174","68","849","1687","0","50.33","35.98"
"67","000","00","031","3127","0781","639","487","152","41","680","1535","0","44.3","31.73"
"67","000","00","031","3128","0000","258","208","50","22","280","531","0","52.73","39.17"
"67","000","00","031","3128","0822","258","208","50","22","280","531","0","52.73","39.17"
"67","000","00","031","3129","0000","2753","2144","609","147","2900","5725","0","50.66","37.45"
"67","000","00","031","3129","0768","704","571","133","32","736","1457","0","50.51","39.19"
"67","000","00","031","3129","0769","715","568","147","22","737","1451","0","50.79","39.15"
"67","000","00","031","3129","0770","632","466","166","51","683","1423","0","48.0","32.75"
"67","000","00","031","3129","0771","702","539","163","42","744","1394","0","53.37","38.67"
"67","000","00","031","3130","0000","3576","2816","760","232","3808","7784","0","48.92","36.18"
"67","000","00","031","3130","0723","645","502","143","62","707","1442","0","49.03","34.81"
"67","000","00","031","3130","0724","731","579","152","50","781","1545","0","50.55","37.48"
"67","000","00","031","3130","0725","739","592","147","47","786","1565","0","50.22","37.83"
"67","000","00","031","3130","0726","765","593","172","44","809","1684","0","48.04","35.21"
"67","000","00","031","3130","0727","696","550","146","29","725","1548","0","46.83","35.53"
"67","000","00","031","3131","0000","2700","2082","618","181","2881","5428","0","53.08","38.36"
"67","000","00","031","3131","0715","607","472","135","48","655","1317","0","49.73","35.84"
"67","000","00","031","3131","0716","655","515","140","48","703","1376","0","51.09","37.43"
"67","000","00","031","3131","0717","685","509","176","39","724","1361","0","53.2","37.4"
"67","000","00","031","3131","0718","753","586","167","46","799","1374","0","58.15","42.65"
"67","000","00","031","3132","0000","1644","1271","373","82","1726","3447","0","50.07","36.87"
"67","000","00","031","3132","0712","541","404","137","28","569","1160","0","49.05","34.83"
"67","000","00","031","3132","0713","566","445","121","32","598","1122","0","53.3","39.66"
"67","000","00","031","3132","0714","537","422","115","22","559","1165","0","47.98","36.22"
"67","000","00","031","3133","0000","2838","2118","720","159","2997","5917","0","50.65","35.8"
"67","000","00","031","3133","0749","788","563","225","52","840","1636","0","51.34","34.41"
"67","000","00","031","3133","0750","800","612","188","51","851","1592","0","53.45","38.44"
"67","000","00","031","3133","0751","920","712","208","35","955","2017","0","47.35","35.3"
"67","000","00","031","3133","0752","330","231","99","21","351","672","0","52.23","34.38"
"67","000","00","031","3134","0000","2064","1553","511","84","2148","4811","0","44.65","32.28"
"67","000","00","031","3134","0755","705","551","154","21","726","1660","0","43.73","33.19"
"67","000","00","031","3134","0756","647","482","165","34","681","1561","0","43.63","30.88"
"67","000","00","031","3134","0757","712","520","192","29","741","1590","0","46.6","32.7"
"67","000","00","031","3135","0000","1450","1122","328","86","1536","3113","0","49.34","36.04"
"67","000","00","031","3135","0753","719","560","159","26","745","1611","0","46.24","34.76"
"67","000","00","031","3135","0754","731","562","169","60","791","1502","0","52.66","37.42"
"67","000","00","031","3136","0000","1856","1401","455","127","1983","3776","0","52.52","37.1"
"67","000","00","031","3136","0775","660","497","163","53","713","1208","0","59.02","41.14"
"67","000","00","031","3136","0776","531","379","152","39","570","1187","0","48.02","31.93"
"67","000","00","031","3136","0777","665","525","140","35","700","1381","0","50.69","38.02"
"67","000","00","031","3137","0000","4640","3633","1007","258","4898","9284","0","52.76","39.13"
"67","000","00","031","3137","0831","754","606","148","48","802","1460","0","54.93","41.51"
"67","000","00","031","3137","0832","658","514","144","29","687","1383","0","49.67","37.17"
"67","000","00","031","3137","0833","596","457","139","42","638","1299","0","49.11","35.18"
"67","000","00","031","3137","0834","667","524","143","30","697","1264","0","55.14","41.46"
"67","000","00","031","3137","0835","717","563","154","49","766","1355","0","56.53","41.55"
"67","000","00","031","3137","0836","651","526","125","29","680","1414","0","48.09","37.2"
"67","000","00","031","3137","0837","597","443","154","31","628","1109","0","56.63","39.95"
"67","000","00","031","3138","0000","3857","3007","850","250","4107","7603","0","54.02","39.55"
"67","000","00","031","3138","0740","777","603","174","31","808","1519","0","53.19","39.7"
"67","000","00","031","3138","0741","750","563","187","89","839","1497","0","56.05","37.61"
"67","000","00","031","3138","0742","703","559","144","23","726","1509","0","48.11","37.04"
"67","000","00","031","3138","0743","820","646","174","79","899","1542","0","58.3","41.89"
"67","000","00","031","3138","0744","807","636","171","28","835","1536","0","54.36","41.41"
"67","000","00","031","3139","0000","1564","1180","384","107","1671","2764","0","60.46","42.69"
"67","000","00","031","3139","0841","803","611","192","65","868","1387","0","62.58","44.05"
"67","000","00","031","3139","0842","761","569","192","42","803","1377","0","58.32","41.32"
"67","000","00","031","3140","0000","2244","1763","481","131","2375","4846","0","49.01","36.38"
"67","000","00","031","3140","0817","747","595","152","52","799","1631","0","48.99","36.48"
"67","000","00","031","3140","0818","717","565","152","51","768","1549","0","49.58","36.48"
"67","000","00","031","3140","0819","780","603","177","28","808","1666","0","48.5","36.19"
"67","000","00","031","3141","0000","1646","1313","333","73","1719","3428","0","50.15","38.3"
"67","000","00","031","3141","0738","776","621","155","28","804","1720","0","46.74","36.1"
"67","000","00","031","3141","0739","870","692","178","45","915","1708","0","53.57","40.52"
"67","000","00","031","3142","0000","2267","1794","473","125","2392","4498","0","53.18","39.88"
"67","000","00","031","3142","0782","780","613","167","55","835","1542","0","54.15","39.75"
"67","000","00","031","3142","0783","782","619","163","34","816","1618","0","50.43","38.26"
"67","000","00","031","3142","0784","705","562","143","36","741","1338","0","55.38","42.0"
"67","000","00","031","3143","0000","1757","1378","379","111","1868","3685","0","50.69","37.39"
"67","000","00","031","3143","0765","536","414","122","23","559","1196","0","46.74","34.62"
"67","000","00","031","3143","0766","615","495","120","44","659","1274","0","51.73","38.85"
"67","000","00","031","3143","0767","606","469","137","44","650","1215","0","53.5","38.6"
"67","000","00","032","0000","0000","77421","58738","18683","4959","82380","153359","186117","53.72","38.3"
"67","000","00","032","3201","0000","1068","782","286","58","1126","2191","0","51.39","35.69"
"67","000","00","032","3201","1170","1068","782","286","58","1126","2191","0","51.39","35.69"
"67","000","00","032","3202","0000","1484","1114","370","141","1625","2944","0","55.2","37.84"
"67","000","00","032","3202","1166","639","466","173","70","709","1287","0","55.09","36.21"
"67","000","00","032","3202","1167","845","648","197","71","916","1657","0","55.28","39.11"
"67","000","00","032","3203","0000","3183","2536","647","203","3386","6583","0","51.44","38.52"
"67","000","00","032","3203","1113","943","722","221","104","1047","2067","0","50.65","34.93"
"67","000","00","032","3203","1114","1079","886","193","36","1115","2153","0","51.79","41.15"
"67","000","00","032","3203","1115","1161","928","233","63","1224","2363","0","51.8","39.27"
"67","000","00","032","3204","0000","1561","1175","386","126","1687","2869","0","58.8","40.96"
"67","000","00","032","3204","1097","846","631","215","85","931","1491","0","62.44","42.32"
"67","000","00","032","3204","1098","715","544","171","41","756","1378","0","54.86","39.48"
"67","000","00","032","3205","0000","2314","1672","642","179","2493","4730","0","52.71","35.35"
"67","000","00","032","3205","1180","750","545","205","36","786","1486","0","52.89","36.68"
"67","000","00","032","3205","1181","798","559","239","71","869","1560","0","55.71","35.83"
"67","000","00","032","3205","1182","766","568","198","72","838","1684","0","49.76","33.73"
"67","000","00","032","3206","0000","1957","1512","445","156","2113","4455","0","47.43","33.94"
"67","000","00","032","3206","1118","886","688","198","66","952","2115","0","45.01","32.53"
"67","000","00","032","3206","1119","1071","824","247","90","1161","2340","0","49.62","35.21"
"67","000","00","032","3207","0000","1449","1053","396","123","1572","2932","0","53.62","35.91"
"67","000","00","032","3207","1139","728","537","191","49","777","1489","0","52.18","36.06"
"67","000","00","032","3207","1140","721","516","205","74","795","1443","0","55.09","35.76"
"67","000","00","032","3208","0000","2649","1979","670","95","2744","4858","0","56.48","40.74"
"67","000","00","032","3208","1141","866","621","245","40","906","1498","0","60.48","41.46"
"67","000","00","032","3208","1142","855","645","210","22","877","1622","0","54.07","39.77"
"67","000","00","032","3208","1143","928","713","215","33","961","1738","0","55.29","41.02"
"67","000","00","032","3209","0000","1256","951","305","90","1346","2433","0","55.32","39.09"
"67","000","00","032","3209","1161","551","430","121","24","575","1101","0","52.23","39.06"
"67","000","00","032","3209","1162","705","521","184","66","771","1332","0","57.88","39.11"
"67","000","00","032","3210","0000","1589","1161","428","70","1659","3086","0","53.76","37.62"
"67","000","00","032","3210","1158","790","572","218","27","817","1589","0","51.42","36.0"
"67","000","00","032","3210","1159","799","589","210","43","842","1497","0","56.25","39.35"
"67","000","00","032","3211","0000","682","489","193","53","735","1386","0","53.03","35.28"
"67","000","00","032","3211","1160","682","489","193","53","735","1386","0","53.03","35.28"
"67","000","00","032","3212","0000","2150","1666","484","113","2263","4048","0","55.9","41.16"
"67","000","00","032","3212","1173","1001","761","240","73","1074","1863","0","57.65","40.85"
"67","000","00","032","3212","1174","1149","905","244","40","1189","2185","0","54.42","41.42"
"67","000","00","032","3213","0000","2517","1920","597","197","2714","5122","0","52.99","37.49"
"67","000","00","032","3213","1129","802","611","191","72","874","1708","0","51.17","35.77"
"67","000","00","032","3213","1130","803","618","185","50","853","1560","0","54.68","39.62"
"67","000","00","032","3213","1131","912","691","221","75","987","1854","0","53.24","37.27"
"67","000","00","032","3214","0000","2289","1723","566","139","2428","4865","0","49.91","35.42"
"67","000","00","032","3214","1120","1123","830","293","69","1192","2474","0","48.18","33.55"
"67","000","00","032","3214","1121","1166","893","273","70","1236","2391","0","51.69","37.35"
"67","000","00","032","3215","0000","867","672","195","53","920","1602","0","57.43","41.95"
"67","000","00","032","3215","1177","867","672","195","53","920","1602","0","57.43","41.95"
"67","000","00","032","3216","0000","774","585","189","88","862","1556","0","55.4","37.6"
"67","000","00","032","3216","1176","774","585","189","88","862","1556","0","55.4","37.6"
"67","000","00","032","3217","0000","2198","1717","481","132","2330","4335","0","53.75","39.61"
"67","000","00","032","3217","1133","985","770","215","68","1053","2093","0","50.31","36.79"
"67","000","00","032","3217","1134","1213","947","266","64","1277","2242","0","56.96","42.24"
"67","000","00","032","3218","0000","713","556","157","46","759","1517","0","50.03","36.65"
"67","000","00","032","3218","1165","713","556","157","46","759","1517","0","50.03","36.65"
"67","000","00","032","3219","0000","2566","1930","636","203","2769","4992","0","55.47","38.66"
"67","000","00","032","3219","1102","879","661","218","60","939","1639","0","57.29","40.33"
"67","000","00","032","3219","1103","857","638","219","66","923","1724","0","53.54","37.01"
"67","000","00","032","3219","1104","830","631","199","77","907","1629","0","55.68","38.74"
"67","000","00","032","3220","0000","2187","1645","542","173","2360","4484","0","52.63","36.69"
"67","000","00","032","3220","1168","1106","833","273","104","1210","2238","0","54.07","37.22"
"67","000","00","032","3220","1169","1081","812","269","69","1150","2246","0","51.2","36.15"
"67","000","00","032","3221","0000","987","713","274","71","1058","1986","0","53.27","35.9"
"67","000","00","032","3221","1156","562","390","172","20","582","1090","0","53.39","35.78"
"67","000","00","032","3221","1157","425","323","102","51","476","896","0","53.13","36.05"
"67","000","00","032","3222","0000","2229","1758","471","147","2376","4242","0","56.01","41.44"
"67","000","00","032","3222","1148","783","625","158","42","825","1427","0","57.81","43.8"
"67","000","00","032","3222","1149","710","553","157","60","770","1427","0","53.96","38.75"
"67","000","00","032","3222","1150","736","580","156","45","781","1388","0","56.27","41.79"
"67","000","00","032","3223","0000","648","449","199","36","684","1131","0","60.48","39.7"
"67","000","00","032","3223","1151","648","449","199","36","684","1131","0","60.48","39.7"
"67","000","00","032","3224","0000","2441","1806","635","92","2533","4615","0","54.89","39.13"
"67","000","00","032","3224","1183","870","645","225","40","910","1653","0","55.05","39.02"
"67","000","00","032","3224","1184","813","592","221","26","839","1554","0","53.99","38.1"
"67","000","00","032","3224","1185","758","569","189","26","784","1408","0","55.68","40.41"
"67","000","00","032","3225","0000","2509","1885","624","156","2665","4874","0","54.68","38.67"
"67","000","00","032","3225","1122","870","634","236","49","919","1673","0","54.93","37.9"
"67","000","00","032","3225","1123","779","578","201","47","826","1594","0","51.82","36.26"
"67","000","00","032","3225","1124","860","673","187","60","920","1607","0","57.25","41.88"
"67","000","00","032","3226","0000","1544","1178","366","88","1632","2982","0","54.73","39.5"
"67","000","00","032","3226","1116","733","545","188","48","781","1427","0","54.73","38.19"
"67","000","00","032","3226","1117","811","633","178","40","851","1555","0","54.73","40.71"
"67","000","00","032","3227","0000","1754","1340","414","86","1840","3593","0","51.21","37.29"
"67","000","00","032","3227","1146","854","641","213","34","888","1829","0","48.55","35.05"
"67","000","00","032","3227","1147","900","699","201","52","952","1764","0","53.97","39.63"
"67","000","00","032","3228","0000","765","571","194","46","811","1721","0","47.12","33.18"
"67","000","00","032","3228","1175","765","571","194","46","811","1721","0","47.12","33.18"
"67","000","00","032","3229","0000","2177","1665","512","143","2320","4240","0","54.72","39.27"
"67","000","00","032","3229","1171","1015","789","226","59","1074","2063","0","52.06","38.25"
"67","000","00","032","3229","1172","1162","876","286","84","1246","2177","0","57.23","40.24"
"67","000","00","032","3230","0000","1302","1047","255","103","1405","2447","0","57.42","42.79"
"67","000","00","032","3230","1163","621","505","116","50","671","1185","0","56.62","42.62"
"67","000","00","032","3230","1164","681","542","139","53","734","1262","0","58.16","42.95"
"67","000","00","032","3231","0000","1501","1037","464","122","1623","2983","0","54.41","34.76"
"67","000","00","032","3231","1144","730","566","164","64","794","1501","0","52.9","37.71"
"67","000","00","032","3231","1145","771","471","300","58","829","1482","0","55.94","31.78"
"67","000","00","032","3232","0000","2373","1821","552","151","2524","4472","0","56.44","40.72"
"67","000","00","032","3232","1099","815","625","190","57","872","1552","0","56.19","40.27"
"67","000","00","032","3232","1100","734","574","160","24","758","1326","0","57.16","43.29"
"67","000","00","032","3232","1101","824","622","202","70","894","1594","0","56.09","39.02"
"67","000","00","032","3233","0000","1091","854","237","84","1175","2296","0","51.18","37.2"
"67","000","00","032","3233","1111","538","425","113","46","584","1039","0","56.21","40.9"
"67","000","00","032","3233","1112","553","429","124","38","591","1257","0","47.02","34.13"
"67","000","00","032","3234","0000","1040","761","279","42","1082","2278","0","47.5","33.41"
"67","000","00","032","3234","1132","1040","761","279","42","1082","2278","0","47.5","33.41"
"67","000","00","032","3235","0000","1492","1172","320","66","1558","2933","0","53.12","39.96"
"67","000","00","032","3235","1105","715","564","151","33","748","1399","0","53.47","40.31"
"67","000","00","032","3235","1106","777","608","169","33","810","1534","0","52.8","39.63"
"67","000","00","032","3236","0000","938","661","277","105","1043","1882","0","55.42","35.12"
"67","000","00","032","3236","1154","456","339","117","42","498","935","0","53.26","36.26"
"67","000","00","032","3236","1155","482","322","160","63","545","947","0","57.55","34.0"
"67","000","00","032","3237","0000","1006","768","238","80","1086","1996","0","54.41","38.48"
"67","000","00","032","3237","1152","492","370","122","41","533","1000","0","53.3","37.0"
"67","000","00","032","3237","1153","514","398","116","39","553","996","0","55.52","39.96"
"67","000","00","032","3238","0000","1364","1030","334","132","1496","2905","0","51.5","35.46"
"67","000","00","032","3238","1178","720","554","166","80","800","1523","0","52.53","36.38"
"67","000","00","032","3238","1179","644","476","168","52","696","1382","0","50.36","34.44"
"67","000","00","032","3239","0000","2116","1603","513","104","2220","3980","0","55.78","40.28"
"67","000","00","032","3239","1186","1145","869","276","39","1184","2084","0","56.81","41.7"
"67","000","00","032","3239","1187","971","734","237","65","1036","1896","0","54.64","38.71"
"67","000","00","032","3240","0000","1846","1398","448","99","1945","4492","0","43.3","31.12"
"67","000","00","032","3240","1095","986","764","222","58","1044","2681","0","38.94","28.5"
"67","000","00","032","3240","1096","860","634","226","41","901","1811","0","49.75","35.01"
"67","000","00","032","3241","0000","3173","2488","685","169","3342","5929","0","56.37","41.96"
"67","000","00","032","3241","1107","889","669","220","43","932","1656","0","56.28","40.4"
"67","000","00","032","3241","1108","667","526","141","61","728","1322","0","55.07","39.79"
"67","000","00","032","3241","1109","841","657","184","31","872","1620","0","53.83","40.56"
"67","000","00","032","3241","1110","776","636","140","34","810","1331","0","60.86","47.78"
"67","000","00","032","3242","0000","1600","1192","408","152","1752","3308","0","52.96","36.03"
"67","000","00","032","3242","1127","808","616","192","100","908","1696","0","53.54","36.32"
"67","000","00","032","3242","1128","792","576","216","52","844","1612","0","52.36","35.73"
"67","000","00","032","3243","0000","2475","1919","556","65","2540","4456","0","57.0","43.07"
"67","000","00","032","3243","1125","1160","898","262","33","1193","2087","0","57.16","43.03"
"67","000","00","032","3243","1126","1315","1021","294","32","1347","2369","0","56.86","43.1"
"67","000","00","032","3244","0000","1401","1076","325","85","1486","2470","0","60.16","43.56"
"67","000","00","032","3244","1135","629","473","156","61","690","1152","0","59.9","41.06"
"67","000","00","032","3244","1136","772","603","169","24","796","1318","0","60.39","45.75"
"67","000","00","032","3245","0000","2196","1708","488","97","2293","4160","0","55.12","41.06"
"67","000","00","032","3245","1137","1106","855","251","56","1162","2200","0","52.82","38.86"
"67","000","00","032","3245","1138","1090","853","237","41","1131","1960","0","57.7","43.52"
"67","000","00","033","0000","0000","49968","37203","12765","4367","54335","108650","124790","50.01","34.24"
"67","000","00","033","3301","0000","814","592","222","56","870","1637","0","53.15","36.16"
"67","000","00","033","3301","1024","814","592","222","56","870","1637","0","53.15","36.16"
"67","000","00","033","3303","0000","366","282","84","19","385","871","0","44.2","32.38"
"67","000","00","033","3303","1025","366","282","84","19","385","871","0","44.2","32.38"
"67","000","00","033","3304","0000","789","571","218","68","857","1390","0","61.65","41.08"
"67","000","00","033","3304","1026","312","229","83","22","334","589","0","56.71","38.88"
"67","000","00","033","3304","1027","477","342","135","46","523","801","0","65.29","42.7"
"67","000","00","033","3305","0000","1092","763","329","91","1183","2262","0","52.3","33.73"
"67","000","00","033","3305","1035","533","351","182","31","564","1127","0","50.04","31.14"
"67","000","00","033","3305","1036","559","412","147","60","619","1135","0","54.54","36.3"
"67","000","00","033","3306","0000","1068","796","272","96","1164","2277","0","51.12","34.96"
"67","000","00","033","3306","1037","607","432","175","63","670","1263","0","53.05","34.2"
"67","000","00","033","3306","1038","461","364","97","33","494","1014","0","48.72","35.9"
"67","000","00","033","3307","0000","1225","892","333","65","1290","2774","0","46.5","32.16"
"67","000","00","033","3307","1031","554","410","144","35","589","1204","0","48.92","34.05"
"67","000","00","033","3307","1032","671","482","189","30","701","1570","0","44.65","30.7"
"67","000","00","033","3308","0000","1716","1305","411","188","1904","3209","0","59.33","40.67"
"67","000","00","033","3308","1028","520","397","123","48","568","990","0","57.37","40.1"
"67","000","00","033","3308","1029","681","525","156","56","737","1222","0","60.31","42.96"
"67","000","00","033","3308","1030","515","383","132","84","599","997","0","60.08","38.42"
"67","000","00","033","3309","0000","1445","1077","368","150","1595","3006","0","53.06","35.83"
"67","000","00","033","3309","1047","767","567","200","59","826","1542","0","53.57","36.77"
"67","000","00","033","3309","1048","678","510","168","91","769","1464","0","52.53","34.84"
"67","000","00","033","3311","0000","1850","1360","490","217","2067","4217","0","49.02","32.25"
"67","000","00","033","3311","1052","587","422","165","87","674","1419","0","47.5","29.74"
"67","000","00","033","3311","1053","604","467","137","63","667","1333","0","50.04","35.03"
"67","000","00","033","3311","1054","659","471","188","67","726","1465","0","49.56","32.15"
"67","000","00","033","3313","0000","1634","1216","418","160","1794","3607","0","49.74","33.71"
"67","000","00","033","3313","1055","522","397","125","27","549","1099","0","49.95","36.12"
"67","000","00","033","3313","1056","507","381","126","28","535","1133","0","47.22","33.63"
"67","000","00","033","3313","1057","605","438","167","105","710","1375","0","51.64","31.85"
"67","000","00","033","3314","0000","826","572","254","92","918","2064","0","44.48","27.71"
"67","000","00","033","3314","1082","826","572","254","92","918","2064","0","44.48","27.71"
"67","000","00","033","3315","0000","965","722","243","113","1078","2173","0","49.61","33.23"
"67","000","00","033","3315","1079","568","432","136","80","648","1119","0","57.91","38.61"
"67","000","00","033","3315","1080","397","290","107","33","430","1054","0","40.8","27.51"
"67","000","00","033","3316","0000","544","380","164","95","639","1245","0","51.33","30.52"
"67","000","00","033","3316","1081","544","380","164","95","639","1245","0","51.33","30.52"
"67","000","00","033","3317","0000","1292","982","310","54","1346","3429","0","39.25","28.64"
"67","000","00","033","3317","1083","744","569","175","27","771","2056","0","37.5","27.68"
"67","000","00","033","3317","1084","548","413","135","27","575","1373","0","41.88","30.08"
"67","000","00","033","3318","0000","947","730","217","75","1022","2109","0","48.46","34.61"
"67","000","00","033","3318","1093","449","326","123","41","490","1093","0","44.83","29.83"
"67","000","00","033","3318","1094","498","404","94","34","532","1016","0","52.36","39.76"
"67","000","00","033","3319","0000","953","703","250","97","1050","2162","0","48.57","32.52"
"67","000","00","033","3319","1091","364","257","107","29","393","897","0","43.81","28.65"
"67","000","00","033","3319","1092","589","446","143","68","657","1265","0","51.94","35.26"
"67","000","00","033","3320","0000","1233","911","322","149","1382","2544","0","54.32","35.81"
"67","000","00","033","3320","1089","574","430","144","66","640","1186","0","53.96","36.26"
"67","000","00","033","3320","1090","659","481","178","83","742","1358","0","54.64","35.42"
"67","000","00","033","3321","0000","1209","942","267","66","1275","2272","0","56.12","41.46"
"67","000","00","033","3321","1017","627","485","142","38","665","1150","0","57.83","42.17"
"67","000","00","033","3321","1018","582","457","125","28","610","1122","0","54.37","40.73"
"67","000","00","033","3322","0000","2099","1584","515","177","2276","4507","0","50.5","35.15"
"67","000","00","033","3322","1019","629","485","144","53","682","1444","0","47.23","33.59"
"67","000","00","033","3322","1020","797","589","208","66","863","1765","0","48.9","33.37"
"67","000","00","033","3322","1021","673","510","163","58","731","1298","0","56.32","39.29"
"67","000","00","033","3323","0000","1542","1168","374","133","1675","3392","0","49.38","34.43"
"67","000","00","033","3323","1015","622","460","162","48","670","1221","0","54.87","37.67"
"67","000","00","033","3323","1016","920","708","212","85","1005","2171","0","46.29","32.61"
"67","000","00","033","3324","0000","1652","1349","303","72","1724","3398","0","50.74","39.7"
"67","000","00","033","3324","1022","766","609","157","38","804","1458","0","55.14","41.77"
"67","000","00","033","3324","1023","886","740","146","34","920","1940","0","47.42","38.14"
"67","000","00","033","3325","0000","1080","811","269","82","1162","2298","0","50.57","35.29"
"67","000","00","033","3325","1033","616","449","167","54","670","1222","0","54.83","36.74"
"67","000","00","033","3325","1034","464","362","102","28","492","1076","0","45.72","33.64"
"67","000","00","033","3326","0000","1521","1114","407","149","1670","3341","0","49.99","33.34"
"67","000","00","033","3326","1061","805","601","204","100","905","1640","0","55.18","36.65"
"67","000","00","033","3326","1062","716","513","203","49","765","1701","0","44.97","30.16"
"67","000","00","033","3327","0000","1623","1215","408","122","1745","3306","0","52.78","36.75"
"67","000","00","033","3327","1039","762","557","205","70","832","1491","0","55.8","37.36"
"67","000","00","033","3327","1040","861","658","203","52","913","1815","0","50.3","36.25"
"67","000","00","033","3328","0000","2347","1697","650","199","2546","5017","0","50.75","33.82"
"67","000","00","033","3328","1044","786","550","236","78","864","1626","0","53.14","33.83"
"67","000","00","033","3328","1045","773","564","209","43","816","1761","0","46.34","32.03"
"67","000","00","033","3328","1046","788","583","205","78","866","1630","0","53.13","35.77"
"67","000","00","033","3329","0000","1044","780","264","61","1105","2734","0","40.42","28.53"
"67","000","00","033","3329","1068","506","368","138","23","529","1657","0","31.93","22.21"
"67","000","00","033","3329","1069","538","412","126","38","576","1077","0","53.48","38.25"
"67","000","00","033","3330","0000","2392","1735","657","198","2590","5719","0","45.29","30.34"
"67","000","00","033","3330","1072","803","610","193","37","840","1985","0","42.32","30.73"
"67","000","00","033","3330","1073","828","576","252","78","906","2017","0","44.92","28.56"
"67","000","00","033","3330","1074","761","549","212","83","844","1717","0","49.16","31.97"
"67","000","00","033","3331","0000","834","603","231","66","900","1624","0","55.42","37.13"
"67","000","00","033","3331","1075","464","338","126","42","506","929","0","54.47","36.38"
"67","000","00","033","3331","1076","370","265","105","24","394","695","0","56.69","38.13"
"67","000","00","033","3332","0000","2476","1842","634","179","2655","5094","0","52.12","36.16"
"67","000","00","033","3332","1065","942","703","239","85","1027","1774","0","57.89","39.63"
"67","000","00","033","3332","1066","763","553","210","67","830","1613","0","51.46","34.28"
"67","000","00","033","3332","1067","771","586","185","27","798","1707","0","46.75","34.33"
"67","000","00","033","3333","0000","1542","1179","363","225","1767","3568","0","49.52","33.04"
"67","000","00","033","3333","1063","641","474","167","108","749","1541","0","48.6","30.76"
"67","000","00","033","3333","1064","901","705","196","117","1018","2027","0","50.22","34.78"
"67","000","00","033","3334","0000","2218","1691","527","143","2361","4809","0","49.1","35.16"
"67","000","00","033","3334","1058","739","565","174","43","782","1781","0","43.91","31.72"
"67","000","00","033","3334","1059","813","642","171","62","875","1542","0","56.74","41.63"
"67","000","00","033","3334","1060","666","484","182","38","704","1486","0","47.38","32.57"
"67","000","00","033","3335","0000","2364","1781","583","130","2494","5092","0","48.98","34.98"
"67","000","00","033","3335","1041","647","466","181","23","670","1398","0","47.93","33.33"
"67","000","00","033","3335","1042","837","645","192","52","889","2107","0","42.19","30.61"
"67","000","00","033","3335","1043","880","670","210","55","935","1587","0","58.92","42.22"
"67","000","00","033","3336","0000","697","545","152","54","751","1781","0","42.17","30.6"
"67","000","00","033","3336","1077","389","297","92","31","420","997","0","42.13","29.79"
"67","000","00","033","3336","1078","308","248","60","23","331","784","0","42.22","31.63"
"67","000","00","033","3337","0000","835","594","241","134","969","1775","0","54.59","33.46"
"67","000","00","033","3337","1087","478","338","140","82","560","1031","0","54.32","32.78"
"67","000","00","033","3337","1088","357","256","101","52","409","744","0","54.97","34.41"
"67","000","00","033","3338","0000","733","521","212","111","844","1762","0","47.9","29.57"
"67","000","00","033","3338","1085","367","261","106","39","406","1002","0","40.52","26.05"
"67","000","00","033","3338","1086","366","260","106","72","438","760","0","57.63","34.21"
"67","000","00","033","3339","0000","1178","866","312","103","1281","2434","0","52.63","35.58"
"67","000","00","033","3339","1070","584","448","136","42","626","1185","0","52.83","37.81"
"67","000","00","033","3339","1071","594","418","176","61","655","1249","0","52.44","33.47"
"67","000","00","033","3340","0000","1823","1332","491","178","2001","3751","0","53.35","35.51"
"67","000","00","033","3340","1049","803","586","217","101","904","1727","0","52.35","33.93"
"67","000","00","033","3340","1050","585","419","166","59","644","1085","0","59.35","38.62"
"67","000","00","033","3340","1051","435","327","108","18","453","939","0","48.24","34.82"
"67","000","00","034","0000","0000","54687","41607","13080","3729","58416","110906","132020","52.67","37.52"
"67","000","00","034","3401","0000","1558","1201","357","132","1690","3501","0","48.27","34.3"
"67","000","00","034","3401","0850","829","643","186","79","908","1793","0","50.64","35.86"
"67","000","00","034","3401","0851","729","558","171","53","782","1708","0","45.78","32.67"
"67","000","00","034","3404","0000","1118","883","235","71","1189","2030","0","58.57","43.5"
"67","000","00","034","3404","0862","584","482","102","39","623","1076","0","57.9","44.8"
"67","000","00","034","3404","0863","534","401","133","32","566","954","0","59.33","42.03"
"67","000","00","034","3405","0000","1265","977","288","89","1354","2451","0","55.24","39.86"
"67","000","00","034","3405","0858","569","434","135","46","615","1189","0","51.72","36.5"
"67","000","00","034","3405","0859","696","543","153","43","739","1262","0","58.56","43.03"
"67","000","00","034","3407","0000","977","758","219","30","1007","1964","0","51.27","38.59"
"67","000","00","034","3407","0867","476","369","107","16","492","974","0","50.51","37.89"
"67","000","00","034","3407","0868","501","389","112","14","515","990","0","52.02","39.29"
"67","000","00","034","3408","0000","1131","822","309","59","1190","2069","0","57.52","39.73"
"67","000","00","034","3408","0869","576","411","165","27","603","1016","0","59.35","40.45"
"67","000","00","034","3408","0870","555","411","144","32","587","1053","0","55.75","39.03"
"67","000","00","034","3418","0000","1944","1465","479","176","2120","4291","0","49.41","34.14"
"67","000","00","034","3418","0926","594","449","145","39","633","1502","0","42.14","29.89"
"67","000","00","034","3418","0927","731","555","176","50","781","1470","0","53.13","37.76"
"67","000","00","034","3418","0928","619","461","158","87","706","1319","0","53.53","34.95"
"67","000","00","034","3419","0000","966","750","216","54","1020","1864","0","54.72","40.24"
"67","000","00","034","3419","0860","565","443","122","30","595","1017","0","58.51","43.56"
"67","000","00","034","3419","0861","401","307","94","24","425","847","0","50.18","36.25"
"67","000","00","034","3420","0000","2547","1908","639","107","2654","4824","0","55.02","39.55"
"67","000","00","034","3420","0908","895","684","211","30","925","1709","0","54.13","40.02"
"67","000","00","034","3420","0909","865","645","220","43","908","1517","0","59.85","42.52"
"67","000","00","034","3420","0910","787","579","208","34","821","1598","0","51.38","36.23"
"67","000","00","034","3423","0000","1387","1024","363","93","1480","3203","0","46.21","31.97"
"67","000","00","034","3423","0894","481","353","128","25","506","1091","0","46.38","32.36"
"67","000","00","034","3423","0895","456","334","122","33","489","993","0","49.24","33.64"
"67","000","00","034","3423","0896","450","337","113","35","485","1119","0","43.34","30.12"
"67","000","00","034","3424","0000","2196","1665","531","166","2362","4442","0","53.17","37.48"
"67","000","00","034","3424","0897","840","636","204","83","923","1685","0","54.78","37.74"
"67","000","00","034","3424","0898","675","513","162","23","698","1368","0","51.02","37.5"
"67","000","00","034","3424","0899","681","516","165","60","741","1389","0","53.35","37.15"
"67","000","00","034","3425","0000","1603","1256","347","90","1693","3296","0","51.37","38.11"
"67","000","00","034","3425","0919","825","658","167","59","884","1662","0","53.19","39.59"
"67","000","00","034","3425","0920","778","598","180","31","809","1634","0","49.51","36.6"
"67","000","00","034","3426","0000","2543","1924","619","254","2797","5387","0","51.92","35.72"
"67","000","00","034","3426","0923","893","662","231","114","1007","1874","0","53.74","35.33"
"67","000","00","034","3426","0924","828","636","192","73","901","1760","0","51.19","36.14"
"67","000","00","034","3426","0925","822","626","196","67","889","1753","0","50.71","35.71"
"67","000","00","034","3432","0000","679","484","195","82","761","1466","0","51.91","33.02"
"67","000","00","034","3432","0871","679","484","195","82","761","1466","0","51.91","33.02"
"67","000","00","034","3433","0000","882","658","224","106","988","1829","0","54.02","35.98"
"67","000","00","034","3433","0884","451","329","122","61","512","892","0","57.4","36.88"
"67","000","00","034","3433","0885","431","329","102","45","476","937","0","50.8","35.11"
"67","000","00","034","3438","0000","1736","1325","411","84","1820","3800","0","47.89","34.87"
"67","000","00","034","3438","0852","488","379","109","21","509","997","0","51.05","38.01"
"67","000","00","034","3438","0853","608","465","143","42","650","1452","0","44.77","32.02"
"67","000","00","034","3438","0854","640","481","159","21","661","1351","0","48.93","35.6"
"67","000","00","034","3439","0000","1517","1135","382","136","1653","3079","0","53.69","36.86"
"67","000","00","034","3439","0872","781","594","187","68","849","1535","0","55.31","38.7"
"67","000","00","034","3439","0873","736","541","195","68","804","1544","0","52.07","35.04"
"67","000","00","034","3440","0000","2303","1745","558","133","2436","4317","0","56.43","40.42"
"67","000","00","034","3440","0905","718","553","165","68","786","1340","0","58.66","41.27"
"67","000","00","034","3440","0906","748","547","201","44","792","1464","0","54.1","37.36"
"67","000","00","034","3440","0907","837","645","192","21","858","1513","0","56.71","42.63"
"67","000","00","034","3441","0000","1543","1183","360","80","1623","2975","0","54.55","39.76"
"67","000","00","034","3441","0915","725","547","178","34","759","1391","0","54.57","39.32"
"67","000","00","034","3441","0916","818","636","182","46","864","1584","0","54.55","40.15"
"67","000","00","034","3442","0000","1874","1413","461","142","2016","3665","0","55.01","38.55"
"67","000","00","034","3442","0921","926","722","204","89","1015","1793","0","56.61","40.27"
"67","000","00","034","3442","0922","948","691","257","53","1001","1872","0","53.47","36.91"
"67","000","00","034","3443","0000","1800","1382","418","113","1913","3596","0","53.2","38.43"
"67","000","00","034","3443","0929","961","748","213","73","1034","1876","0","55.12","39.87"
"67","000","00","034","3443","0930","839","634","205","40","879","1720","0","51.1","36.86"
"67","000","00","034","3444","0000","1995","1577","418","161","2156","4008","0","53.79","39.35"
"67","000","00","034","3444","0864","621","493","128","65","686","1300","0","52.77","37.92"
"67","000","00","034","3444","0865","679","543","136","51","730","1390","0","52.52","39.06"
"67","000","00","034","3444","0866","695","541","154","45","740","1318","0","56.15","41.05"
"67","000","00","034","3445","0000","1892","1434","458","126","2018","3534","0","57.1","40.58"
"67","000","00","034","3445","0855","764","570","194","60","824","1323","0","62.28","43.08"
"67","000","00","034","3445","0856","547","409","138","35","582","1073","0","54.24","38.12"
"67","000","00","034","3445","0857","581","455","126","31","612","1138","0","53.78","39.98"
"67","000","00","034","3446","0000","2666","2022","644","189","2855","5305","0","53.82","38.11"
"67","000","00","034","3446","0874","902","697","205","72","974","1760","0","55.34","39.6"
"67","000","00","034","3446","0875","575","413","162","42","617","1372","0","44.97","30.1"
"67","000","00","034","3446","0876","553","426","127","33","586","1002","0","58.48","42.51"
"67","000","00","034","3446","0877","636","486","150","42","678","1171","0","57.9","41.5"
"67","000","00","034","3447","0000","1838","1397","441","125","1963","3964","0","49.52","35.24"
"67","000","00","034","3447","0891","697","521","176","38","735","1522","0","48.29","34.23"
"67","000","00","034","3447","0892","608","479","129","25","633","1278","0","49.53","37.48"
"67","000","00","034","3447","0893","533","397","136","62","595","1164","0","51.12","34.11"
"67","000","00","034","3448","0000","2366","1890","476","162","2528","4860","0","52.02","38.89"
"67","000","00","034","3448","0878","586","471","115","24","610","1285","0","47.47","36.65"
"67","000","00","034","3448","0879","500","410","90","38","538","1036","0","51.93","39.58"
"67","000","00","034","3448","0880","701","568","133","45","746","1392","0","53.59","40.8"
"67","000","00","034","3448","0881","579","441","138","55","634","1147","0","55.27","38.45"
"67","000","00","034","3449","0000","1356","1021","335","77","1433","3085","0","46.45","33.1"
"67","000","00","034","3449","0882","620","477","143","38","658","1526","0","43.12","31.26"
"67","000","00","034","3449","0883","736","544","192","39","775","1559","0","49.71","34.89"
"67","000","00","034","3450","0000","1296","943","353","73","1369","2797","0","48.95","33.71"
"67","000","00","034","3450","0889","651","451","200","57","708","1346","0","52.6","33.51"
"67","000","00","034","3450","0890","645","492","153","16","661","1451","0","45.55","33.91"
"67","000","00","034","3451","0000","1808","1315","493","185","1993","4176","0","47.73","31.49"
"67","000","00","034","3451","0886","738","538","200","91","829","1449","0","57.21","37.13"
"67","000","00","034","3451","0887","543","392","151","28","571","1160","0","49.22","33.79"
"67","000","00","034","3451","0888","527","385","142","66","593","1567","0","37.84","24.57"
"67","000","00","034","3452","0000","1677","1306","371","87","1764","3124","0","56.47","41.81"
"67","000","00","034","3452","0900","787","603","184","29","816","1469","0","55.55","41.05"
"67","000","00","034","3452","0901","890","703","187","58","948","1655","0","57.28","42.48"
"67","000","00","034","3453","0000","2185","1708","477","98","2283","4187","0","54.53","40.79"
"67","000","00","034","3453","0902","684","520","164","29","713","1261","0","56.54","41.24"
"67","000","00","034","3453","0903","718","583","135","26","744","1490","0","49.93","39.13"
"67","000","00","034","3453","0904","783","605","178","43","826","1436","0","57.52","42.13"
"67","000","00","034","3454","0000","1273","936","337","99","1372","2613","0","52.51","35.82"
"67","000","00","034","3454","0911","690","505","185","48","738","1399","0","52.75","36.1"
"67","000","00","034","3454","0912","583","431","152","51","634","1214","0","52.22","35.5"
"67","000","00","034","3455","0000","1218","918","300","78","1296","2212","0","58.59","41.5"
"67","000","00","034","3455","0913","569","427","142","26","595","1064","0","55.92","40.13"
"67","000","00","034","3455","0914","649","491","158","52","701","1148","0","61.06","42.77"
"67","000","00","034","3456","0000","1548","1182","366","72","1620","2992","0","54.14","39.51"
"67","000","00","034","3456","0917","845","645","200","43","888","1595","0","55.67","40.44"
"67","000","00","034","3456","0918","703","537","166","29","732","1397","0","52.4","38.44"
"67","000","00","035","0000","0000","75600","57329","18271","6561","82161","159654","193163","51.46","35.91"
"67","000","00","035","3501","0000","1259","976","283","42","1301","2549","0","51.04","38.29"
"67","000","00","035","3501","0618","1259","976","283","42","1301","2549","0","51.04","38.29"
"67","000","00","035","3502","0000","2131","1693","438","138","2269","4600","0","49.33","36.8"
"67","000","00","035","3502","0624","891","691","200","52","943","2143","0","44.0","32.24"
"67","000","00","035","3502","0625","1240","1002","238","86","1326","2457","0","53.97","40.78"
"67","000","00","035","3503","0000","2206","1646","560","163","2369","4477","0","52.91","36.77"
"67","000","00","035","3503","0619","1056","773","283","85","1141","2321","0","49.16","33.3"
"67","000","00","035","3503","0620","1150","873","277","78","1228","2156","0","56.96","40.49"
"67","000","00","035","3504","0000","2407","1802","605","258","2665","4799","0","55.53","37.55"
"67","000","00","035","3504","0621","892","660","232","78","970","1662","0","58.36","39.71"
"67","000","00","035","3504","0622","768","589","179","106","874","1512","0","57.8","38.96"
"67","000","00","035","3504","0623","747","553","194","74","821","1625","0","50.52","34.03"
"67","000","00","035","3505","0000","2206","1782","424","215","2421","4512","0","53.66","39.49"
"67","000","00","035","3505","0626","1087","810","277","110","1197","2148","0","55.73","37.71"
"67","000","00","035","3505","0627","1119","972","147","105","1224","2364","0","51.78","41.12"
"67","000","00","035","3506","0000","1470","1121","349","144","1614","2805","0","57.54","39.96"
"67","000","00","035","3506","0644","785","623","162","57","842","1447","0","58.19","43.05"
"67","000","00","035","3506","0645","685","498","187","87","772","1358","0","56.85","36.67"
"67","000","00","035","3507","0000","1813","1348","465","157","1970","3494","0","56.38","38.58"
"67","000","00","035","3507","0639","875","632","243","89","964","1721","0","56.01","36.72"
"67","000","00","035","3507","0640","938","716","222","68","1006","1773","0","56.74","40.38"
"67","000","00","035","3508","0000","1985","1512","473","166","2151","4546","0","47.32","33.26"
"67","000","00","035","3508","0631","927","686","241","85","1012","2291","0","44.17","29.94"
"67","000","00","035","3508","0632","1058","826","232","81","1139","2255","0","50.51","36.63"
"67","000","00","035","3509","0000","2805","2151","654","212","3017","5977","0","50.48","35.99"
"67","000","00","035","3509","0633","860","655","205","75","935","1940","0","48.2","33.76"
"67","000","00","035","3509","0634","1004","770","234","40","1044","2013","0","51.86","38.25"
"67","000","00","035","3509","0635","941","726","215","97","1038","2024","0","51.28","35.87"
"67","000","00","035","3510","0000","2880","2257","623","232","3112","5933","0","52.45","38.04"
"67","000","00","035","3510","0628","789","608","181","73","862","1868","0","46.15","32.55"
"67","000","00","035","3510","0629","951","734","217","86","1037","1797","0","57.71","40.85"
"67","000","00","035","3510","0630","1140","915","225","73","1213","2268","0","53.48","40.34"
"67","000","00","035","3511","0000","1037","795","242","120","1157","2188","0","52.88","36.33"
"67","000","00","035","3511","0654","1037","795","242","120","1157","2188","0","52.88","36.33"
"67","000","00","035","3512","0000","896","648","248","114","1010","1835","0","55.04","35.31"
"67","000","00","035","3512","0659","896","648","248","114","1010","1835","0","55.04","35.31"
"67","000","00","035","3513","0000","2027","1540","487","174","2201","4646","0","47.37","33.15"
"67","000","00","035","3513","0655","1077","831","246","94","1171","2399","0","48.81","34.64"
"67","000","00","035","3513","0656","950","709","241","80","1030","2247","0","45.84","31.55"
"67","000","00","035","3514","0000","635","470","165","86","721","1165","0","61.89","40.34"
"67","000","00","035","3514","0657","635","470","165","86","721","1165","0","61.89","40.34"
"67","000","00","035","3515","0000","2356","1768","588","255","2611","5476","0","47.68","32.29"
"67","000","00","035","3515","0670","613","464","149","84","697","1547","0","45.05","29.99"
"67","000","00","035","3515","0671","823","604","219","76","899","1784","0","50.39","33.86"
"67","000","00","035","3515","0672","920","700","220","95","1015","2145","0","47.32","32.63"
"67","000","00","035","3516","0000","1333","1012","321","126","1459","2728","0","53.48","37.1"
"67","000","00","035","3516","0668","873","653","220","71","944","1763","0","53.55","37.04"
"67","000","00","035","3516","0669","460","359","101","55","515","965","0","53.37","37.2"
"67","000","00","035","3517","0000","1074","786","288","132","1206","1978","0","60.97","39.74"
"67","000","00","035","3517","0693","500","354","146","52","552","905","0","60.99","39.12"
"67","000","00","035","3517","0694","574","432","142","80","654","1073","0","60.95","40.26"
"67","000","00","035","3518","0000","3467","2700","767","234","3701","7488","0","49.43","36.06"
"67","000","00","035","3518","0673","1208","955","253","84","1292","2443","0","52.89","39.09"
"67","000","00","035","3518","0674","1061","806","255","62","1123","2565","0","43.78","31.42"
"67","000","00","035","3518","0675","1198","939","259","88","1286","2480","0","51.85","37.86"
"67","000","00","035","3519","0000","555","416","139","65","620","977","0","63.46","42.58"
"67","000","00","035","3519","0662","555","416","139","65","620","977","0","63.46","42.58"
"67","000","00","035","3520","0000","2000","1479","521","205","2205","4517","0","48.82","32.74"
"67","000","00","035","3520","0676","945","704","241","109","1054","2349","0","44.87","29.97"
"67","000","00","035","3520","0677","1055","775","280","96","1151","2168","0","53.09","35.75"
"67","000","00","035","3521","0000","1472","1105","367","156","1628","3228","0","50.43","34.23"
"67","000","00","035","3521","0666","623","467","156","74","697","1319","0","52.84","35.41"
"67","000","00","035","3521","0667","849","638","211","82","931","1909","0","48.77","33.42"
"67","000","00","035","3522","0000","1586","1218","368","106","1692","3339","0","50.67","36.48"
"67","000","00","035","3522","0663","717","543","174","38","755","1642","0","45.98","33.07"
"67","000","00","035","3522","0664","869","675","194","68","937","1697","0","55.22","39.78"
"67","000","00","035","3523","0000","852","647","205","55","907","1966","0","46.13","32.91"
"67","000","00","035","3523","0665","852","647","205","55","907","1966","0","46.13","32.91"
"67","000","00","035","3524","0000","806","628","178","66","872","1501","0","58.09","41.84"
"67","000","00","035","3524","0707","806","628","178","66","872","1501","0","58.09","41.84"
"67","000","00","035","3525","0000","873","639","234","95","968","1797","0","53.87","35.56"
"67","000","00","035","3525","0660","873","639","234","95","968","1797","0","53.87","35.56"
"67","000","00","035","3526","0000","972","719","253","108","1080","2223","0","48.58","32.34"
"67","000","00","035","3526","0661","972","719","253","108","1080","2223","0","48.58","32.34"
"67","000","00","035","3527","0000","832","623","209","80","912","1579","0","57.76","39.46"
"67","000","00","035","3527","0695","832","623","209","80","912","1579","0","57.76","39.46"
"67","000","00","035","3528","0000","616","448","168","30","646","1462","0","44.19","30.64"
"67","000","00","035","3528","0700","616","448","168","30","646","1462","0","44.19","30.64"
"67","000","00","035","3529","0000","533","427","106","69","602","1044","0","57.66","40.9"
"67","000","00","035","3529","0701","533","427","106","69","602","1044","0","57.66","40.9"
"67","000","00","035","3530","0000","1395","1030","365","168","1563","3070","0","50.91","33.55"
"67","000","00","035","3530","0696","849","624","225","115","964","1876","0","51.39","33.26"
"67","000","00","035","3530","0697","546","406","140","53","599","1194","0","50.17","34.0"
"67","000","00","035","3531","0000","620","466","154","23","643","1380","0","46.59","33.77"
"67","000","00","035","3531","0699","620","466","154","23","643","1380","0","46.59","33.77"
"67","000","00","035","3532","0000","513","390","123","30","543","1475","0","36.81","26.44"
"67","000","00","035","3532","0698","513","390","123","30","543","1475","0","36.81","26.44"
"67","000","00","035","3533","0000","700","514","186","93","793","1293","0","61.33","39.75"
"67","000","00","035","3533","0702","333","239","94","62","395","603","0","65.51","39.64"
"67","000","00","035","3533","0703","367","275","92","31","398","690","0","57.68","39.86"
"67","000","00","035","3534","0000","662","510","152","53","715","1447","0","49.41","35.25"
"67","000","00","035","3534","0704","662","510","152","53","715","1447","0","49.41","35.25"
"67","000","00","035","3535","0000","547","414","133","50","597","910","0","65.6","45.49"
"67","000","00","035","3535","0705","547","414","133","50","597","910","0","65.6","45.49"
"67","000","00","035","3536","0000","791","599","192","90","881","1850","0","47.62","32.38"
"67","000","00","035","3536","0706","791","599","192","90","881","1850","0","47.62","32.38"
"67","000","00","035","3537","0000","1028","787","241","92","1120","2143","0","52.26","36.72"
"67","000","00","035","3537","0638","1028","787","241","92","1120","2143","0","52.26","36.72"
"67","000","00","035","3538","0000","1438","1087","351","134","1572","2791","0","56.32","38.95"
"67","000","00","035","3538","0636","893","671","222","91","984","1613","0","61.0","41.6"
"67","000","00","035","3538","0637","545","416","129","43","588","1178","0","49.92","35.31"
"67","000","00","035","3539","0000","2185","1651","534","140","2325","4412","0","52.7","37.42"
"67","000","00","035","3539","0641","678","516","162","26","704","1428","0","49.3","36.13"
"67","000","00","035","3539","0642","829","644","185","61","890","1626","0","54.74","39.61"
"67","000","00","035","3539","0643","678","491","187","53","731","1358","0","53.83","36.16"
"67","000","00","035","3540","0000","1614","1240","374","177","1791","3120","0","57.4","39.74"
"67","000","00","035","3540","0680","891","704","187","118","1009","1627","0","62.02","43.27"
"67","000","00","035","3540","0681","723","536","187","59","782","1493","0","52.38","35.9"
"67","000","00","035","3541","0000","2079","1564","515","178","2257","4273","0","52.82","36.6"
"67","000","00","035","3541","0682","705","511","194","79","784","1397","0","56.12","36.58"
"67","000","00","035","3541","0683","661","500","161","70","731","1416","0","51.62","35.31"
"67","000","00","035","3541","0684","713","553","160","29","742","1460","0","50.82","37.88"
"67","000","00","035","3542","0000","1602","1198","404","107","1709","3661","0","46.68","32.72"
"67","000","00","035","3542","0691","778","575","203","73","851","1815","0","46.89","31.68"
"67","000","00","035","3542","0692","824","623","201","34","858","1846","0","46.48","33.75"
"67","000","00","035","3543","0000","1973","1472","501","99","2072","4437","0","46.7","33.18"
"67","000","00","035","3543","0646","952","716","236","51","1003","2116","0","47.4","33.84"
"67","000","00","035","3543","0647","1021","756","265","48","1069","2321","0","46.06","32.57"
"67","000","00","035","3544","0000","1858","1296","562","115","1973","4044","0","48.79","32.05"
"67","000","00","035","3544","0648","977","751","226","45","1022","2117","0","48.28","35.47"
"67","000","00","035","3544","0649","881","545","336","70","951","1927","0","49.35","28.28"
"67","000","00","035","3545","0000","2028","1561","467","161","2189","4576","0","47.84","34.11"
"67","000","00","035","3545","0650","990","755","235","105","1095","2242","0","48.84","33.68"
"67","000","00","035","3545","0651","1038","806","232","56","1094","2334","0","46.87","34.53"
"67","000","00","035","3546","0000","1878","1439","439","167","2045","3809","0","53.69","37.78"
"67","000","00","035","3546","0686","992","766","226","104","1096","2070","0","52.95","37.0"
"67","000","00","035","3546","0687","886","673","213","63","949","1739","0","54.57","38.7"
"67","000","00","035","3547","0000","1437","1119","318","114","1551","3305","0","46.93","33.86"
"67","000","00","035","3547","0678","766","609","157","59","825","1630","0","50.61","37.36"
"67","000","00","035","3547","0679","671","510","161","55","726","1675","0","43.34","30.45"
"67","000","00","035","3548","0000","711","532","179","54","765","1539","0","49.71","34.57"
"67","000","00","035","3548","0658","711","532","179","54","765","1539","0","49.71","34.57"
"67","000","00","035","3549","0000","910","710","200","53","963","2222","0","43.34","31.95"
"67","000","00","035","3549","0685","910","710","200","53","963","2222","0","43.34","31.95"
"67","000","00","035","3550","0000","2744","2033","711","264","3008","5433","0","55.37","37.42"
"67","000","00","035","3550","0688","834","614","220","105","939","1830","0","51.31","33.55"
"67","000","00","035","3550","0689","972","727","245","82","1054","1803","0","58.46","40.32"
"67","000","00","035","3550","0690","938","692","246","77","1015","1800","0","56.39","38.44"
"67","000","00","035","3551","0000","1803","1361","442","196","1999","3635","0","54.99","37.44"
"67","000","00","035","3551","0652","905","693","212","85","990","1822","0","54.34","38.04"
"67","000","00","035","3551","0653","898","668","230","111","1009","1813","0","55.65","36.85"
"67","000","00","036","0000","0000","25923","19673","6250","1661","27584","55379","66677","49.81","35.52"
"67","000","00","036","3602","0000","898","694","204","91","989","2001","0","49.43","34.68"
"67","000","00","036","3602","1014","898","694","204","91","989","2001","0","49.43","34.68"
"67","000","00","036","3604","0000","170","126","44","9","179","438","0","40.87","28.77"
"67","000","00","036","3604","1007","170","126","44","9","179","438","0","40.87","28.77"
"67","000","00","036","3605","0000","2370","1793","577","132","2502","4954","0","50.5","36.19"
"67","000","00","036","3605","0986","1177","887","290","76","1253","2547","0","49.2","34.83"
"67","000","00","036","3605","0987","1193","906","287","56","1249","2407","0","51.89","37.64"
"67","000","00","036","3606","0000","1910","1461","449","89","1999","4202","0","47.57","34.77"
"67","000","00","036","3606","0988","886","677","209","49","935","2070","0","45.17","32.71"
"67","000","00","036","3606","0989","1024","784","240","40","1064","2132","0","49.91","36.77"
"67","000","00","036","3607","0000","2328","1770","558","136","2464","4810","0","51.23","36.8"
"67","000","00","036","3607","0990","728","568","160","25","753","1450","0","51.93","39.17"
"67","000","00","036","3607","0991","744","588","156","27","771","1605","0","48.04","36.64"
"67","000","00","036","3607","0992","856","614","242","84","940","1755","0","53.56","34.99"
"67","000","00","036","3608","0000","3217","2411","806","181","3398","7011","0","48.47","34.39"
"67","000","00","036","3608","0993","762","555","207","51","813","1728","0","47.05","32.12"
"67","000","00","036","3608","0994","695","509","186","23","718","1754","0","40.94","29.02"
"67","000","00","036","3608","0995","815","625","190","57","872","1686","0","51.72","37.07"
"67","000","00","036","3608","0996","945","722","223","50","995","1843","0","53.99","39.18"
"67","000","00","036","3609","0000","2526","1966","560","187","2713","4994","0","54.33","39.37"
"67","000","00","036","3609","0983","880","683","197","81","961","1753","0","54.82","38.96"
"67","000","00","036","3609","0984","890","696","194","58","948","1859","0","51.0","37.44"
"67","000","00","036","3609","0985","756","587","169","48","804","1382","0","58.18","42.47"
"67","000","00","036","3610","0000","3327","2500","827","206","3533","6842","0","51.64","36.54"
"67","000","00","036","3610","1003","855","661","194","68","923","1675","0","55.1","39.46"
"67","000","00","036","3610","1004","950","682","268","64","1014","1979","0","51.24","34.46"
"67","000","00","036","3610","1005","759","565","194","33","792","1602","0","49.44","35.27"
"67","000","00","036","3610","1006","763","592","171","41","804","1586","0","50.69","37.33"
"67","000","00","036","3611","0000","3453","2673","780","155","3608","7611","0","47.41","35.12"
"67","000","00","036","3611","0999","743","557","186","30","773","1653","0","46.76","33.7"
"67","000","00","036","3611","1000","777","612","165","25","802","1697","0","47.26","36.06"
"67","000","00","036","3611","1001","959","751","208","48","1007","2154","0","46.75","34.87"
"67","000","00","036","3611","1002","974","753","221","52","1026","2107","0","48.69","35.74"
"67","000","00","036","3612","0000","1466","1141","325","72","1538","2853","0","53.91","39.99"
"67","000","00","036","3612","0997","816","630","186","49","865","1565","0","55.27","40.26"
"67","000","00","036","3612","0998","650","511","139","23","673","1288","0","52.25","39.67"
"67","000","00","036","3615","0000","1532","1120","412","121","1653","3403","0","48.57","32.91"
"67","000","00","036","3615","1008","820","611","209","76","896","1780","0","50.34","34.33"
"67","000","00","036","3615","1009","712","509","203","45","757","1623","0","46.64","31.36"
"67","000","00","036","3616","0000","1498","1111","387","157","1655","3443","0","48.07","32.27"
"67","000","00","036","3616","1010","950","710","240","101","1051","2157","0","48.73","32.92"
"67","000","00","036","3616","1011","548","401","147","56","604","1286","0","46.97","31.18"
"67","000","00","036","3617","0000","1228","907","321","125","1353","2817","0","48.03","32.2"
"67","000","00","036","3617","1012","697","502","195","86","783","1492","0","52.48","33.65"
"67","000","00","036","3617","1013","531","405","126","39","570","1325","0","43.02","30.57"
"67","000","00","037","0000","0000","33188","24374","8814","2516","35704","65261","78093","54.71","37.35"
"67","000","00","037","3705","0000","1938","1364","574","177","2115","3854","0","54.88","35.39"
"67","000","00","037","3705","0931","679","470","209","55","734","1332","0","55.11","35.29"
"67","000","00","037","3705","0932","650","459","191","63","713","1246","0","57.22","36.84"
"67","000","00","037","3705","0933","609","435","174","59","668","1276","0","52.35","34.09"
"67","000","00","037","3707","0000","1629","1177","452","97","1726","3047","0","56.65","38.63"
"67","000","00","037","3707","0934","844","608","236","48","892","1583","0","56.35","38.41"
"67","000","00","037","3707","0935","785","569","216","49","834","1464","0","56.97","38.87"
"67","000","00","037","3709","0000","1350","1039","311","65","1415","2602","0","54.38","39.93"
"67","000","00","037","3709","0936","609","481","128","21","630","1234","0","51.05","38.98"
"67","000","00","037","3709","0937","741","558","183","44","785","1368","0","57.38","40.79"
"67","000","00","037","3711","0000","1168","862","306","86","1254","2538","0","49.41","33.96"
"67","000","00","037","3711","0938","582","434","148","32","614","1322","0","46.44","32.83"
"67","000","00","037","3711","0939","586","428","158","54","640","1216","0","52.63","35.2"
"67","000","00","037","3716","0000","1269","918","351","85","1354","2526","0","53.6","36.34"
"67","000","00","037","3716","0940","624","441","183","38","662","1289","0","51.36","34.21"
"67","000","00","037","3716","0941","645","477","168","47","692","1237","0","55.94","38.56"
"67","000","00","037","3722","0000","1713","1258","455","149","1862","3455","0","53.89","36.41"
"67","000","00","037","3722","0942","519","377","142","33","552","1189","0","46.43","31.71"
"67","000","00","037","3722","0943","619","447","172","56","675","1201","0","56.2","37.22"
"67","000","00","037","3722","0944","575","434","141","60","635","1065","0","59.62","40.75"
"67","000","00","037","3725","0000","1941","1493","448","125","2066","3505","0","58.94","42.6"
"67","000","00","037","3725","0945","549","424","125","48","597","1055","0","56.59","40.19"
"67","000","00","037","3725","0946","674","502","172","37","711","1170","0","60.77","42.91"
"67","000","00","037","3725","0947","718","567","151","40","758","1280","0","59.22","44.3"
"67","000","00","037","3731","0000","1331","981","350","108","1439","2515","0","57.22","39.01"
"67","000","00","037","3731","0948","649","463","186","40","689","1223","0","56.34","37.86"
"67","000","00","037","3731","0949","682","518","164","68","750","1292","0","58.05","40.09"
"67","000","00","037","3733","0000","2908","2168","740","167","3075","5398","0","56.97","40.16"
"67","000","00","037","3733","0950","555","413","142","21","576","993","0","58.01","41.59"
"67","000","00","037","3733","0951","768","580","188","58","826","1541","0","53.6","37.64"
"67","000","00","037","3733","0952","927","694","233","59","986","1652","0","59.69","42.01"
"67","000","00","037","3733","0953","658","481","177","29","687","1212","0","56.68","39.69"
"67","000","00","037","3734","0000","2522","1817","705","171","2693","4876","0","55.23","37.26"
"67","000","00","037","3734","0954","850","607","243","70","920","1621","0","56.76","37.45"
"67","000","00","037","3734","0955","865","618","247","41","906","1660","0","54.58","37.23"
"67","000","00","037","3734","0956","807","592","215","60","867","1595","0","54.36","37.12"
"67","000","00","037","3739","0000","1848","1351","497","163","2011","3557","0","56.54","37.98"
"67","000","00","037","3739","0957","698","505","193","64","762","1436","0","53.06","35.17"
"67","000","00","037","3739","0958","675","482","193","48","723","1265","0","57.15","38.1"
"67","000","00","037","3739","0959","475","364","111","51","526","856","0","61.45","42.52"
"67","000","00","037","3740","0000","1752","1283","469","148","1900","3297","0","57.63","38.91"
"67","000","00","037","3740","0960","576","410","166","45","621","1168","0","53.17","35.1"
"67","000","00","037","3740","0961","610","448","162","50","660","1134","0","58.2","39.51"
"67","000","00","037","3740","0962","566","425","141","53","619","995","0","62.21","42.71"
"67","000","00","037","3741","0000","1467","1105","362","85","1552","2578","0","60.2","42.86"
"67","000","00","037","3741","0963","768","597","171","36","804","1313","0","61.23","45.47"
"67","000","00","037","3741","0964","699","508","191","49","748","1265","0","59.13","40.16"
"67","000","00","037","3742","0000","1565","1152","413","142","1707","3150","0","54.19","36.57"
"67","000","00","037","3742","0965","601","429","172","48","649","1215","0","53.42","35.31"
"67","000","00","037","3742","0966","623","476","147","57","680","1248","0","54.49","38.14"
"67","000","00","037","3742","0967","341","247","94","37","378","687","0","55.02","35.95"
"67","000","00","037","3743","0000","1092","820","272","109","1201","2110","0","56.92","38.86"
"67","000","00","037","3743","0968","571","430","141","63","634","1139","0","55.66","37.75"
"67","000","00","037","3743","0969","521","390","131","46","567","971","0","58.39","40.16"
"67","000","00","037","3744","0000","1809","1365","444","152","1961","3978","0","49.3","34.31"
"67","000","00","037","3744","0970","486","355","131","58","544","1254","0","43.38","28.31"
"67","000","00","037","3744","0971","496","387","109","35","531","979","0","54.24","39.53"
"67","000","00","037","3744","0972","827","623","204","59","886","1745","0","50.77","35.7"
"67","000","00","037","3745","0000","1190","829","361","98","1288","2510","0","51.31","33.03"
"67","000","00","037","3745","0973","528","358","170","51","579","1074","0","53.91","33.33"
"67","000","00","037","3745","0974","662","471","191","47","709","1436","0","49.37","32.8"
"67","000","00","037","3746","0000","1033","724","309","94","1127","2029","0","55.54","35.68"
"67","000","00","037","3746","0975","444","306","138","46","490","865","0","56.65","35.38"
"67","000","00","037","3746","0976","589","418","171","48","637","1164","0","54.73","35.91"
"67","000","00","037","3747","0000","1776","1277","499","133","1909","4067","0","46.94","31.4"
"67","000","00","037","3747","0977","564","392","172","31","595","1285","0","46.3","30.51"
"67","000","00","037","3747","0978","543","383","160","48","591","1078","0","54.82","35.53"
"67","000","00","037","3747","0979","669","502","167","54","723","1704","0","42.43","29.46"
"67","000","00","037","3748","0000","1887","1391","496","162","2049","3669","0","55.85","37.91"
"67","000","00","037","3748","0980","666","496","170","88","754","1296","0","58.18","38.27"
"67","000","00","037","3748","0981","575","424","151","43","618","1128","0","54.79","37.59"
"67","000","00","037","3748","0982","646","471","175","31","677","1245","0","54.38","37.83"
"64","000","00","000","0000","0000","1258448","968007","290441","97698","1356146","2353342","2772624","57.63","41.13"
"64","000","00","001","0000","0000","11252","8309","2943","676","11928","21617","24098","55.18","38.44"
"64","000","00","001","0101","0000","745","541","204","62","807","1304","0","61.89","41.49"
"64","000","00","001","0101","0845","745","541","204","62","807","1304","0","61.89","41.49"
"64","000","00","001","0102","0000","193","132","61","23","216","357","0","60.5","36.97"
"64","000","00","001","0102","0846","193","132","61","23","216","357","0","60.5","36.97"
"64","000","00","001","0103","0000","348","242","106","29","377","651","0","57.91","37.17"
"64","000","00","001","0103","0847","348","242","106","29","377","651","0","57.91","37.17"
"64","000","00","001","0104","0000","615","464","151","30","645","1322","0","48.79","35.1"
"64","000","00","001","0104","0848","615","464","151","30","645","1322","0","48.79","35.1"
"64","000","00","001","0105","0000","554","516","38","27","581","1056","0","55.02","48.86"
"64","000","00","001","0105","0849","554","516","38","27","581","1056","0","55.02","48.86"
"64","000","00","001","0106","0000","1076","763","313","57","1133","2034","0","55.7","37.51"
"64","000","00","001","0106","0850","502","359","143","21","523","904","0","57.85","39.71"
"64","000","00","001","0106","0851","574","404","170","36","610","1130","0","53.98","35.75"
"64","000","00","001","0107","0000","484","378","106","19","503","840","0","59.88","45.0"
"64","000","00","001","0107","0852","484","378","106","19","503","840","0","59.88","45.0"
"64","000","00","001","0108","0000","403","290","113","32","435","616","0","70.62","47.08"
"64","000","00","001","0108","0853","403","290","113","32","435","616","0","70.62","47.08"
"64","000","00","001","0109","0000","677","482","195","40","717","1397","0","51.32","34.5"
"64","000","00","001","0109","0854","677","482","195","40","717","1397","0","51.32","34.5"
"64","000","00","001","0110","0000","409","293","116","16","425","766","0","55.48","38.25"
"64","000","00","001","0110","0855","409","293","116","16","425","766","0","55.48","38.25"
"64","000","00","001","0111","0000","925","708","217","61","986","1644","0","59.98","43.07"
"64","000","00","001","0111","0856","470","355","115","42","512","839","0","61.03","42.31"
"64","000","00","001","0111","0857","455","353","102","19","474","805","0","58.88","43.85"
"64","000","00","001","0112","0000","372","276","96","21","393","750","0","52.4","36.8"
"64","000","00","001","0112","0858","372","276","96","21","393","750","0","52.4","36.8"
"64","000","00","001","0113","0000","494","358","136","36","530","986","0","53.75","36.31"
"64","000","00","001","0113","0859","494","358","136","36","530","986","0","53.75","36.31"
"64","000","00","001","0114","0000","493","359","134","11","504","1068","0","47.19","33.61"
"64","000","00","001","0114","0860","493","359","134","11","504","1068","0","47.19","33.61"
"64","000","00","001","0115","0000","582","410","172","52","634","1060","0","59.81","38.68"
"64","000","00","001","0115","0861","582","410","172","52","634","1060","0","59.81","38.68"
"64","000","00","001","0116","0000","405","308","97","36","441","805","0","54.78","38.26"
"64","000","00","001","0116","0862","405","308","97","36","441","805","0","54.78","38.26"
"64","000","00","001","0117","0000","925","677","248","56","981","1994","0","49.2","33.95"
"64","000","00","001","0117","0863","494","383","111","21","515","1073","0","48.0","35.69"
"64","000","00","001","0117","0864","431","294","137","35","466","921","0","50.6","31.92"
"64","000","00","001","0118","0000","606","448","158","22","628","1171","0","53.63","38.26"
"64","000","00","001","0118","0865","606","448","158","22","628","1171","0","53.63","38.26"
"64","000","00","001","0119","0000","319","217","102","20","339","594","0","57.07","36.53"
"64","000","00","001","0119","0866","319","217","102","20","339","594","0","57.07","36.53"
"64","000","00","001","0120","0000","329","241","88","16","345","592","0","58.28","40.71"
"64","000","00","001","0120","0867","329","241","88","16","345","592","0","58.28","40.71"
"64","000","00","001","0121","0000","298","206","92","10","308","610","0","50.49","33.77"
"64","000","00","001","0121","0868","298","206","92","10","308","610","0","50.49","33.77"
"64","000","00","002","0000","0000","62819","48707","14112","4086","66905","114979","139894","58.19","42.36"
"64","000","00","002","0201","0000","1076","829","247","73","1149","1959","0","58.65","42.32"
"64","000","00","002","0201","0768","467","359","108","23","490","959","0","51.09","37.43"
"64","000","00","002","0201","0769","609","470","139","50","659","1000","0","65.9","47.0"
"64","000","00","002","0202","0000","1142","933","209","74","1216","1995","0","60.95","46.77"
"64","000","00","002","0202","0770","491","402","89","12","503","910","0","55.27","44.18"
"64","000","00","002","0202","0771","651","531","120","62","713","1085","0","65.71","48.94"
"64","000","00","002","0203","0000","2214","1723","491","150","2364","4147","0","57.01","41.55"
"64","000","00","002","0203","0772","659","512","147","54","713","1484","0","48.05","34.5"
"64","000","00","002","0203","0773","785","584","201","35","820","1393","0","58.87","41.92"
"64","000","00","002","0203","0774","770","627","143","61","831","1270","0","65.43","49.37"
"64","000","00","002","0204","0000","1850","1380","470","125","1975","3402","0","58.05","40.56"
"64","000","00","002","0204","0775","542","403","139","43","585","1055","0","55.45","38.2"
"64","000","00","002","0204","0776","625","462","163","30","655","1172","0","55.89","39.42"
"64","000","00","002","0204","0777","683","515","168","52","735","1175","0","62.55","43.83"
"64","000","00","002","0205","0000","693","515","178","52","745","1274","0","58.48","40.42"
"64","000","00","002","0205","0778","693","515","178","52","745","1274","0","58.48","40.42"
"64","000","00","002","0206","0000","505","373","132","53","558","1085","0","51.43","34.38"
"64","000","00","002","0206","0779","505","373","132","53","558","1085","0","51.43","34.38"
"64","000","00","002","0207","0000","1340","1014","326","128","1468","2444","0","60.07","41.49"
"64","000","00","002","0207","0780","766","590","176","68","834","1470","0","56.73","40.14"
"64","000","00","002","0207","0781","574","424","150","60","634","974","0","65.09","43.53"
"64","000","00","002","0208","0000","1981","1472","509","193","2174","3719","0","58.46","39.58"
"64","000","00","002","0208","0782","707","536","171","88","795","1275","0","62.35","42.04"
"64","000","00","002","0208","0783","611","437","174","73","684","1206","0","56.72","36.24"
"64","000","00","002","0208","0784","663","499","164","32","695","1238","0","56.14","40.31"
"64","000","00","002","0209","0000","470","415","55","23","493","721","0","68.38","57.56"
"64","000","00","002","0209","0785","470","415","55","23","493","721","0","68.38","57.56"
"64","000","00","002","0210","0000","611","478","133","34","645","1220","0","52.87","39.18"
"64","000","00","002","0210","0786","611","478","133","34","645","1220","0","52.87","39.18"
"64","000","00","002","0211","0000","856","650","206","56","912","1966","0","46.39","33.06"
"64","000","00","002","0211","0787","856","650","206","56","912","1966","0","46.39","33.06"
"64","000","00","002","0212","0000","1656","1249","407","121","1777","3442","0","51.63","36.29"
"64","000","00","002","0212","0788","816","611","205","92","908","1722","0","52.73","35.48"
"64","000","00","002","0212","0789","840","638","202","29","869","1720","0","50.52","37.09"
"64","000","00","002","0213","0000","1267","972","295","156","1423","2656","0","53.58","36.6"
"64","000","00","002","0213","0790","692","538","154","109","801","1287","0","62.24","41.8"
"64","000","00","002","0213","0791","575","434","141","47","622","1369","0","45.43","31.7"
"64","000","00","002","0214","0000","1581","1221","360","109","1690","2992","0","56.48","40.81"
"64","000","00","002","0214","0792","686","534","152","55","741","1222","0","60.64","43.7"
"64","000","00","002","0214","0793","895","687","208","54","949","1770","0","53.62","38.81"
"64","000","00","002","0215","0000","8463","6459","2004","409","8872","14867","0","59.68","43.45"
"64","000","00","002","0215","0794","1029","799","230","40","1069","1860","0","57.47","42.96"
"64","000","00","002","0215","0795","975","729","246","60","1035","1857","0","55.74","39.26"
"64","000","00","002","0215","0796","1027","772","255","52","1079","1841","0","58.61","41.93"
"64","000","00","002","0215","0797","1060","812","248","65","1125","1830","0","61.48","44.37"
"64","000","00","002","0215","0798","1006","779","227","66","1072","1809","0","59.26","43.06"
"64","000","00","002","0215","0799","1092","863","229","43","1135","1894","0","59.93","45.56"
"64","000","00","002","0215","0800","1118","845","273","30","1148","1882","0","61.0","44.9"
"64","000","00","002","0215","0801","1156","860","296","53","1209","1894","0","63.83","45.41"
"64","000","00","002","0216","0000","12365","9724","2641","498","12863","20876","0","61.62","46.58"
"64","000","00","002","0216","0802","957","793","164","42","999","1745","0","57.25","45.44"
"64","000","00","002","0216","0803","1020","792","228","21","1041","1887","0","55.17","41.97"
"64","000","00","002","0216","0804","1170","900","270","59","1229","1891","0","64.99","47.59"
"64","000","00","002","0216","0805","1113","901","212","52","1165","1903","0","61.22","47.35"
"64","000","00","002","0216","0806","1172","907","265","37","1209","1998","0","60.51","45.4"
"64","000","00","002","0216","0807","1119","894","225","61","1180","1912","0","61.72","46.76"
"64","000","00","002","0216","0808","1118","863","255","68","1186","1923","0","61.67","44.88"
"64","000","00","002","0216","0809","1129","865","264","33","1162","1888","0","61.55","45.82"
"64","000","00","002","0216","0810","1127","892","235","24","1151","1873","0","61.45","47.62"
"64","000","00","002","0216","0811","1257","974","283","49","1306","1959","0","66.67","49.72"
"64","000","00","002","0216","0812","1183","943","240","52","1235","1897","0","65.1","49.71"
"64","000","00","002","0217","0000","9240","7500","1740","381","9621","16100","0","59.76","46.58"
"64","000","00","002","0217","0813","1409","1104","305","53","1462","2362","0","61.9","46.74"
"64","000","00","002","0217","0814","1068","854","214","78","1146","1850","0","61.95","46.16"
"64","000","00","002","0217","0815","1141","1091","50","35","1176","1928","0","61.0","56.59"
"64","000","00","002","0217","0816","1063","860","203","33","1096","1937","0","56.58","44.4"
"64","000","00","002","0217","0817","1202","933","269","60","1262","2123","0","59.44","43.95"
"64","000","00","002","0217","0818","1054","825","229","38","1092","1861","0","58.68","44.33"
"64","000","00","002","0217","0819","1056","850","206","30","1086","1892","0","57.4","44.93"
"64","000","00","002","0217","0820","1247","983","264","54","1301","2147","0","60.6","45.78"
"64","000","00","002","0218","0000","2225","1750","475","94","2319","3938","0","58.89","44.44"
"64","000","00","002","0218","0821","1103","860","243","54","1157","1897","0","60.99","45.33"
"64","000","00","002","0218","0822","1122","890","232","40","1162","2041","0","56.93","43.61"
"64","000","00","002","0219","0000","1774","1414","360","111","1885","3176","0","59.35","44.52"
"64","000","00","002","0219","0823","720","570","150","55","775","1309","0","59.21","43.54"
"64","000","00","002","0219","0824","1054","844","210","56","1110","1867","0","59.45","45.21"
"64","000","00","002","0220","0000","1585","1248","337","102","1687","2556","0","66.0","48.83"
"64","000","00","002","0220","0825","732","589","143","49","781","1152","0","67.8","51.13"
"64","000","00","002","0220","0826","853","659","194","53","906","1404","0","64.53","46.94"
"64","000","00","002","0221","0000","423","341","82","29","452","1210","0","37.36","28.18"
"64","000","00","002","0221","0827","423","341","82","29","452","1210","0","37.36","28.18"
"64","000","00","002","0222","0000","575","421","154","53","628","1135","0","55.33","37.09"
"64","000","00","002","0222","0828","575","421","154","53","628","1135","0","55.33","37.09"
"64","000","00","002","0223","0000","574","437","137","89","663","1831","0","36.21","23.87"
"64","000","00","002","0223","0829","574","437","137","89","663","1831","0","36.21","23.87"
"64","000","00","002","0224","0000","684","522","162","68","752","1288","0","58.39","40.53"
"64","000","00","002","0224","0830","684","522","162","68","752","1288","0","58.39","40.53"
"64","000","00","002","0225","0000","607","473","134","44","651","1241","0","52.46","38.11"
"64","000","00","002","0225","0831","607","473","134","44","651","1241","0","52.46","38.11"
"64","000","00","002","0226","0000","752","568","184","73","825","1342","0","61.48","42.32"
"64","000","00","002","0226","0832","752","568","184","73","825","1342","0","61.48","42.32"
"64","000","00","002","0227","0000","755","570","185","114","869","1422","0","61.11","40.08"
"64","000","00","002","0227","0833","755","570","185","114","869","1422","0","61.11","40.08"
"64","000","00","002","0228","0000","801","613","188","112","913","1453","0","62.84","42.19"
"64","000","00","002","0228","0834","801","613","188","112","913","1453","0","62.84","42.19"
"64","000","00","002","0229","0000","352","256","96","46","398","616","0","64.61","41.56"
"64","000","00","002","0229","0835","352","256","96","46","398","616","0","64.61","41.56"
"64","000","00","002","0230","0000","423","300","123","75","498","834","0","59.71","35.97"
"64","000","00","002","0230","0836","423","300","123","75","498","834","0","59.71","35.97"
"64","000","00","002","0231","0000","496","352","144","73","569","969","0","58.72","36.33"
"64","000","00","002","0231","0837","496","352","144","73","569","969","0","58.72","36.33"
"64","000","00","002","0232","0000","485","346","139","84","569","978","0","58.18","35.38"
"64","000","00","002","0232","0838","485","346","139","84","569","978","0","58.18","35.38"
"64","000","00","002","0233","0000","420","286","134","65","485","760","0","63.82","37.63"
"64","000","00","002","0233","0839","420","286","134","65","485","760","0","63.82","37.63"
"64","000","00","002","0234","0000","667","500","167","76","743","1248","0","59.54","40.06"
"64","000","00","002","0234","0840","667","500","167","76","743","1248","0","59.54","40.06"
"64","000","00","002","0235","0000","544","380","164","29","573","1143","0","50.13","33.25"
"64","000","00","002","0235","0841","544","380","164","29","573","1143","0","50.13","33.25"
"64","000","00","002","0236","0000","594","433","161","79","673","1358","0","49.56","31.89"
"64","000","00","002","0236","0842","594","433","161","79","673","1358","0","49.56","31.89"
"64","000","00","002","0237","0000","492","391","101","18","510","1036","0","49.23","37.74"
"64","000","00","002","0237","0843","492","391","101","18","510","1036","0","49.23","37.74"
"64","000","00","002","0238","0000","281","199","82","17","298","580","0","51.38","34.31"
"64","000","00","002","0238","0844","281","199","82","17","298","580","0","51.38","34.31"
"64","000","00","003","0000","0000","90757","71184","19573","5424","96181","161367","196749","59.6","44.11"
"64","000","00","003","0301","0000","811","629","182","65","876","2604","0","33.64","24.16"
"64","000","00","003","0301","0534","811","629","182","65","876","2604","0","33.64","24.16"
"64","000","00","003","0302","0000","562","422","140","82","644","1037","0","62.1","40.69"
"64","000","00","003","0302","0535","562","422","140","82","644","1037","0","62.1","40.69"
"64","000","00","003","0303","0000","306","227","79","47","353","542","0","65.13","41.88"
"64","000","00","003","0303","0536","306","227","79","47","353","542","0","65.13","41.88"
"64","000","00","003","0304","0000","330","239","91","56","386","635","0","60.79","37.64"
"64","000","00","003","0304","0537","330","239","91","56","386","635","0","60.79","37.64"
"64","000","00","003","0305","0000","224","160","64","20","244","518","0","47.1","30.89"
"64","000","00","003","0305","0538","224","160","64","20","244","518","0","47.1","30.89"
"64","000","00","003","0306","0000","379","274","105","66","445","813","0","54.74","33.7"
"64","000","00","003","0306","0539","379","274","105","66","445","813","0","54.74","33.7"
"64","000","00","003","0307","0000","442","298","144","91","533","889","0","59.96","33.52"
"64","000","00","003","0307","0540","442","298","144","91","533","889","0","59.96","33.52"
"64","000","00","003","0308","0000","389","268","121","82","471","731","0","64.43","36.66"
"64","000","00","003","0308","0541","389","268","121","82","471","731","0","64.43","36.66"
"64","000","00","003","0309","0000","1657","862","795","113","1770","3301","0","53.62","26.11"
"64","000","00","003","0309","0542","751","165","586","56","807","1592","0","50.69","10.36"
"64","000","00","003","0309","0543","906","697","209","57","963","1709","0","56.35","40.78"
"64","000","00","003","0311","0000","859","709","150","66","925","1588","0","58.25","44.65"
"64","000","00","003","0311","0544","859","709","150","66","925","1588","0","58.25","44.65"
"64","000","00","003","0312","0000","189","166","23","8","197","358","0","55.03","46.37"
"64","000","00","003","0312","0545","189","166","23","8","197","358","0","55.03","46.37"
"64","000","00","003","0313","0000","436","381","55","20","456","666","0","68.47","57.21"
"64","000","00","003","0313","0546","436","381","55","20","456","666","0","68.47","57.21"
"64","000","00","003","0315","0000","921","743","178","81","1002","1748","0","57.32","42.51"
"64","000","00","003","0315","0547","921","743","178","81","1002","1748","0","57.32","42.51"
"64","000","00","003","0316","0000","1410","1087","323","141","1551","2436","0","63.67","44.62"
"64","000","00","003","0316","0548","694","529","165","73","767","1196","0","64.13","44.23"
"64","000","00","003","0316","0549","716","558","158","68","784","1240","0","63.23","45.0"
"64","000","00","003","0317","0000","1547","1368","179","73","1620","2575","0","62.91","53.13"
"64","000","00","003","0317","0550","820","724","96","51","871","1402","0","62.13","51.64"
"64","000","00","003","0317","0551","727","644","83","22","749","1173","0","63.85","54.9"
"64","000","00","003","0319","0000","439","365","74","21","460","641","0","71.76","56.94"
"64","000","00","003","0319","0552","439","365","74","21","460","641","0","71.76","56.94"
"64","000","00","003","0321","0000","478","327","151","45","523","951","0","54.99","34.38"
"64","000","00","003","0321","0553","478","327","151","45","523","951","0","54.99","34.38"
"64","000","00","003","0322","0000","362","254","108","54","416","732","0","56.83","34.7"
"64","000","00","003","0322","0554","362","254","108","54","416","732","0","56.83","34.7"
"64","000","00","003","0323","0000","166","122","44","14","180","339","0","53.1","35.99"
"64","000","00","003","0323","0555","166","122","44","14","180","339","0","53.1","35.99"
"64","000","00","003","0324","0000","271","205","66","18","289","519","0","55.68","39.5"
"64","000","00","003","0324","0556","271","205","66","18","289","519","0","55.68","39.5"
"64","000","00","003","0325","0000","284","191","93","58","342","514","0","66.54","37.16"
"64","000","00","003","0325","0557","284","191","93","58","342","514","0","66.54","37.16"
"64","000","00","003","0326","0000","392","296","96","66","458","720","0","63.61","41.11"
"64","000","00","003","0326","0558","392","296","96","66","458","720","0","63.61","41.11"
"64","000","00","003","0327","0000","216","152","64","53","269","411","0","65.45","36.98"
"64","000","00","003","0327","0559","216","152","64","53","269","411","0","65.45","36.98"
"64","000","00","003","0328","0000","348","244","104","48","396","603","0","65.67","40.46"
"64","000","00","003","0328","0560","348","244","104","48","396","603","0","65.67","40.46"
"64","000","00","003","0329","0000","478","389","89","77","555","904","0","61.39","43.03"
"64","000","00","003","0329","0561","478","389","89","77","555","904","0","61.39","43.03"
"64","000","00","003","0330","0000","611","474","137","45","656","1318","0","49.77","35.96"
"64","000","00","003","0330","0562","611","474","137","45","656","1318","0","49.77","35.96"
"64","000","00","003","0331","0000","463","338","125","29","492","966","0","50.93","34.99"
"64","000","00","003","0331","0563","463","338","125","29","492","966","0","50.93","34.99"
"64","000","00","003","0332","0000","3255","2714","541","206","3461","5792","0","59.75","46.86"
"64","000","00","003","0332","0564","803","655","148","38","841","1440","0","58.4","45.49"
"64","000","00","003","0332","0565","1102","901","201","49","1151","1990","0","57.84","45.28"
"64","000","00","003","0332","0566","633","547","86","42","675","1090","0","61.93","50.18"
"64","000","00","003","0332","0567","717","611","106","77","794","1272","0","62.42","48.03"
"64","000","00","003","0334","0000","1877","1486","391","66","1943","3059","0","63.52","48.58"
"64","000","00","003","0334","0568","946","750","196","32","978","1558","0","62.77","48.14"
"64","000","00","003","0334","0569","931","736","195","34","965","1501","0","64.29","49.03"
"64","000","00","003","0335","0000","239","202","37","9","248","360","0","68.89","56.11"
"64","000","00","003","0335","0570","239","202","37","9","248","360","0","68.89","56.11"
"64","000","00","003","0336","0000","1511","1327","184","67","1578","2694","0","58.57","49.26"
"64","000","00","003","0336","0571","747","668","79","39","786","1335","0","58.88","50.04"
"64","000","00","003","0336","0572","764","659","105","28","792","1359","0","58.28","48.49"
"64","000","00","003","0337","0000","868","698","170","65","933","1487","0","62.74","46.94"
"64","000","00","003","0337","0573","868","698","170","65","933","1487","0","62.74","46.94"
"64","000","00","003","0338","0000","855","690","165","71","926","1637","0","56.57","42.15"
"64","000","00","003","0338","0574","855","690","165","71","926","1637","0","56.57","42.15"
"64","000","00","003","0339","0000","7603","6032","1571","477","8080","13089","0","61.73","46.08"
"64","000","00","003","0339","0575","914","738","176","43","957","1553","0","61.62","47.52"
"64","000","00","003","0339","0576","930","720","210","72","1002","1564","0","64.07","46.04"
"64","000","00","003","0339","0577","1089","839","250","60","1149","1788","0","64.26","46.92"
"64","000","00","003","0339","0578","1150","905","245","93","1243","2028","0","61.29","44.63"
"64","000","00","003","0339","0579","1098","863","235","101","1199","2037","0","58.86","42.37"
"64","000","00","003","0339","0580","1245","1001","244","52","1297","2101","0","61.73","47.64"
"64","000","00","003","0339","0581","1177","966","211","56","1233","2018","0","61.1","47.87"
"64","000","00","003","0340","0000","14105","10890","3215","707","14812","25058","0","59.11","43.46"
"64","000","00","003","0340","0582","1157","845","312","85","1242","1925","0","64.52","43.9"
"64","000","00","003","0340","0583","1085","838","247","30","1115","1989","0","56.06","42.13"
"64","000","00","003","0340","0584","873","679","194","43","916","1780","0","51.46","38.15"
"64","000","00","003","0340","0585","1019","779","240","40","1059","1778","0","59.56","43.81"
"64","000","00","003","0340","0586","870","682","188","37","907","1496","0","60.63","45.59"
"64","000","00","003","0340","0587","913","697","216","46","959","1538","0","62.35","45.32"
"64","000","00","003","0340","0588","1184","898","286","72","1256","2058","0","61.03","43.63"
"64","000","00","003","0340","0589","1129","864","265","41","1170","1992","0","58.73","43.37"
"64","000","00","003","0340","0590","1180","911","269","81","1261","2058","0","61.27","44.27"
"64","000","00","003","0340","0591","1224","901","323","63","1287","2090","0","61.58","43.11"
"64","000","00","003","0340","0592","976","890","86","39","1015","2157","0","47.06","41.26"
"64","000","00","003","0340","0593","1267","982","285","45","1312","2096","0","62.6","46.85"
"64","000","00","003","0340","0594","1228","924","304","85","1313","2101","0","62.49","43.98"
"64","000","00","003","0341","0000","2690","2088","602","252","2942","4843","0","60.75","43.11"
"64","000","00","003","0341","0595","913","731","182","77","990","1649","0","60.04","44.33"
"64","000","00","003","0341","0596","806","596","210","89","895","1516","0","59.04","39.31"
"64","000","00","003","0341","0597","971","761","210","86","1057","1678","0","62.99","45.35"
"64","000","00","003","0342","0000","7323","5746","1577","376","7699","13054","0","58.98","44.02"
"64","000","00","003","0342","0598","1045","800","245","90","1135","1898","0","59.8","42.15"
"64","000","00","003","0342","0599","1008","782","226","56","1064","1837","0","57.92","42.57"
"64","000","00","003","0342","0600","1009","806","203","42","1051","1922","0","54.68","41.94"
"64","000","00","003","0342","0601","1052","792","260","68","1120","1785","0","62.75","44.37"
"64","000","00","003","0342","0602","1030","821","209","32","1062","1886","0","56.31","43.53"
"64","000","00","003","0342","0603","1115","891","224","47","1162","1895","0","61.32","47.02"
"64","000","00","003","0342","0604","1064","854","210","41","1105","1831","0","60.35","46.64"
"64","000","00","003","0343","0000","16049","12671","3378","731","16780","27814","0","60.33","45.56"
"64","000","00","003","0343","0605","1110","886","224","48","1158","2050","0","56.49","43.22"
"64","000","00","003","0343","0606","1430","1130","300","49","1479","2251","0","65.7","50.2"
"64","000","00","003","0343","0607","1284","1012","272","38","1322","2126","0","62.18","47.6"
"64","000","00","003","0343","0608","1015","806","209","36","1051","1928","0","54.51","41.8"
"64","000","00","003","0343","0609","1176","883","293","71","1247","2166","0","57.57","40.77"
"64","000","00","003","0343","0610","1159","922","237","55","1214","2031","0","59.77","45.4"
"64","000","00","003","0343","0611","1165","917","248","58","1223","1987","0","61.55","46.15"
"64","000","00","003","0343","0612","1282","1020","262","37","1319","2166","0","60.9","47.09"
"64","000","00","003","0343","0613","1068","827","241","71","1139","1856","0","61.37","44.56"
"64","000","00","003","0343","0614","1351","1065","286","49","1400","2289","0","61.16","46.53"
"64","000","00","003","0343","0615","1114","895","219","49","1163","1973","0","58.95","45.36"
"64","000","00","003","0343","0616","1034","821","213","93","1127","1818","0","61.99","45.16"
"64","000","00","003","0343","0617","869","678","191","27","896","1565","0","57.25","43.32"
"64","000","00","003","0343","0618","992","809","183","50","1042","1608","0","64.8","50.31"
"64","000","00","003","0344","0000","19412","15450","3962","858","20270","33421","0","60.65","46.23"
"64","000","00","003","0344","0619","1095","845","250","70","1165","1812","0","64.29","46.63"
"64","000","00","003","0344","0620","967","766","201","24","991","1821","0","54.42","42.06"
"64","000","00","003","0344","0621","1125","889","236","68","1193","1907","0","62.56","46.62"
"64","000","00","003","0344","0622","1088","836","252","46","1134","1812","0","62.58","46.14"
"64","000","00","003","0344","0623","1107","899","208","46","1153","1833","0","62.9","49.05"
"64","000","00","003","0344","0624","1077","825","252","59","1136","1850","0","61.41","44.59"
"64","000","00","003","0344","0625","962","766","196","69","1031","1738","0","59.32","44.07"
"64","000","00","003","0344","0626","1157","921","236","54","1211","1864","0","64.97","49.41"
"64","000","00","003","0344","0627","1141","913","228","47","1188","1887","0","62.96","48.38"
"64","000","00","003","0344","0628","1010","825","185","28","1038","1870","0","55.51","44.12"
"64","000","00","003","0344","0629","1060","867","193","27","1087","1866","0","58.25","46.46"
"64","000","00","003","0344","0630","1035","826","209","22","1057","1862","0","56.77","44.36"
"64","000","00","003","0344","0631","1061","840","221","36","1097","1816","0","60.41","46.26"
"64","000","00","003","0344","0632","1058","851","207","52","1110","1833","0","60.56","46.43"
"64","000","00","003","0344","0633","990","761","229","64","1054","1676","0","62.89","45.41"
"64","000","00","003","0344","0634","1078","878","200","54","1132","1843","0","61.42","47.64"
"64","000","00","003","0344","0635","1112","899","213","40","1152","1872","0","61.54","48.02"
"64","000","00","003","0344","0636","1289","1043","246","52","1341","2259","0","59.36","46.17"
"64","000","00","004","0000","0000","83874","65274","18600","7198","91072","153132","185318","59.47","42.63"
"64","000","00","004","0401","0000","11070","8668","2402","621","11691","20704","0","56.47","41.87"
"64","000","00","004","0401","0435","773","633","140","46","819","1309","0","62.57","48.36"
"64","000","00","004","0401","0436","790","598","192","43","833","1408","0","59.16","42.47"
"64","000","00","004","0401","0437","1028","815","213","64","1092","1851","0","59.0","44.03"
"64","000","00","004","0401","0438","909","706","203","66","975","1578","0","61.79","44.74"
"64","000","00","004","0401","0439","936","758","178","39","975","1715","0","56.85","44.2"
"64","000","00","004","0401","0440","859","622","237","31","890","1611","0","55.25","38.61"
"64","000","00","004","0401","0441","1054","852","202","56","1110","2024","0","54.84","42.09"
"64","000","00","004","0401","0442","964","747","217","42","1006","1890","0","53.23","39.52"
"64","000","00","004","0401","0443","848","671","177","32","880","1762","0","49.94","38.08"
"64","000","00","004","0401","0444","972","771","201","59","1031","1888","0","54.61","40.84"
"64","000","00","004","0401","0445","958","750","208","79","1037","1822","0","56.92","41.16"
"64","000","00","004","0401","0446","979","745","234","64","1043","1846","0","56.5","40.36"
"64","000","00","004","0402","0000","2306","1804","502","172","2478","3940","0","62.89","45.79"
"64","000","00","004","0402","0447","715","576","139","77","792","1268","0","62.46","45.43"
"64","000","00","004","0402","0448","748","594","154","60","808","1240","0","65.16","47.9"
"64","000","00","004","0402","0449","843","634","209","35","878","1432","0","61.31","44.27"
"64","000","00","004","0403","0000","3219","2470","749","275","3494","5991","0","58.32","41.23"
"64","000","00","004","0403","0450","824","633","191","62","886","1490","0","59.46","42.48"
"64","000","00","004","0403","0451","861","672","189","52","913","1464","0","62.36","45.9"
"64","000","00","004","0403","0452","717","538","179","82","799","1435","0","55.68","37.49"
"64","000","00","004","0403","0453","817","627","190","79","896","1602","0","55.93","39.14"
"64","000","00","004","0404","0000","1593","1215","378","174","1767","3091","0","57.17","39.31"
"64","000","00","004","0404","0454","767","589","178","68","835","1500","0","55.67","39.27"
"64","000","00","004","0404","0455","826","626","200","106","932","1591","0","58.58","39.35"
"64","000","00","004","0405","0000","1633","1225","408","175","1808","3197","0","56.55","38.32"
"64","000","00","004","0405","0458","797","606","191","87","884","1559","0","56.7","38.87"
"64","000","00","004","0405","0459","836","619","217","88","924","1638","0","56.41","37.79"
"64","000","00","004","0406","0000","1434","972","462","119","1553","3138","0","49.49","30.98"
"64","000","00","004","0406","0456","604","429","175","55","659","1669","0","39.48","25.7"
"64","000","00","004","0406","0457","830","543","287","64","894","1469","0","60.86","36.96"
"64","000","00","004","0407","0000","2088","1575","513","222","2310","3872","0","59.66","40.68"
"64","000","00","004","0407","0460","1072","823","249","89","1161","1960","0","59.23","41.99"
"64","000","00","004","0407","0461","1016","752","264","133","1149","1912","0","60.09","39.33"
"64","000","00","004","0408","0000","2539","2025","514","149","2688","4678","0","57.46","43.29"
"64","000","00","004","0408","0462","836","663","173","61","897","1559","0","57.54","42.53"
"64","000","00","004","0408","0463","757","613","144","47","804","1423","0","56.5","43.08"
"64","000","00","004","0408","0464","946","749","197","41","987","1696","0","58.2","44.16"
"64","000","00","004","0409","0000","1540","1110","430","264","1804","3020","0","59.74","36.75"
"64","000","00","004","0409","0465","719","509","210","163","882","1493","0","59.08","34.09"
"64","000","00","004","0409","0466","821","601","220","101","922","1527","0","60.38","39.36"
"64","000","00","004","0410","0000","1176","845","331","177","1353","2217","0","61.03","38.11"
"64","000","00","004","0410","0467","562","399","163","81","643","1020","0","63.04","39.12"
"64","000","00","004","0410","0468","614","446","168","96","710","1197","0","59.31","37.26"
"64","000","00","004","0411","0000","1586","1191","395","200","1786","3446","0","51.83","34.56"
"64","000","00","004","0411","0469","678","485","193","90","768","1528","0","50.26","31.74"
"64","000","00","004","0411","0470","908","706","202","110","1018","1918","0","53.08","36.81"
"64","000","00","004","0412","0000","742","550","192","100","842","1458","0","57.75","37.72"
"64","000","00","004","0412","0471","742","550","192","100","842","1458","0","57.75","37.72"
"64","000","00","004","0413","0000","2045","1582","463","203","2248","3635","0","61.84","43.52"
"64","000","00","004","0413","0472","998","767","231","108","1106","1790","0","61.79","42.85"
"64","000","00","004","0413","0473","1047","815","232","95","1142","1845","0","61.9","44.17"
"64","000","00","004","0414","0000","8584","6877","1707","567","9151","15761","0","58.06","43.63"
"64","000","00","004","0414","0474","1156","905","251","73","1229","2037","0","60.33","44.43"
"64","000","00","004","0414","0475","1048","842","206","63","1111","1964","0","56.57","42.87"
"64","000","00","004","0414","0476","1067","878","189","45","1112","2006","0","55.43","43.77"
"64","000","00","004","0414","0477","1042","818","224","61","1103","1951","0","56.54","41.93"
"64","000","00","004","0414","0478","1016","813","203","70","1086","1951","0","55.66","41.67"
"64","000","00","004","0414","0479","1099","913","186","105","1204","2008","0","59.96","45.47"
"64","000","00","004","0414","0480","1067","830","237","93","1160","1923","0","60.32","43.16"
"64","000","00","004","0414","0481","1089","878","211","57","1146","1921","0","59.66","45.71"
"64","000","00","004","0415","0000","545","438","107","35","580","832","0","69.71","52.64"
"64","000","00","004","0415","0482","545","438","107","35","580","832","0","69.71","52.64"
"64","000","00","004","0416","0000","1261","929","332","125","1386","2281","0","60.76","40.73"
"64","000","00","004","0416","0483","633","462","171","56","689","1156","0","59.6","39.97"
"64","000","00","004","0416","0484","628","467","161","69","697","1125","0","61.96","41.51"
"64","000","00","004","0417","0000","1455","1128","327","139","1594","2562","0","62.22","44.03"
"64","000","00","004","0417","0485","609","449","160","69","678","1060","0","63.96","42.36"
"64","000","00","004","0417","0486","846","679","167","70","916","1502","0","60.99","45.21"
"64","000","00","004","0418","0000","1497","1129","368","184","1681","2956","0","56.87","38.19"
"64","000","00","004","0418","0487","757","555","202","101","858","1404","0","61.11","39.53"
"64","000","00","004","0418","0488","740","574","166","83","823","1552","0","53.03","36.98"
"64","000","00","004","0419","0000","1409","1100","309","149","1558","2775","0","56.14","39.64"
"64","000","00","004","0419","0489","759","568","191","82","841","1460","0","57.6","38.9"
"64","000","00","004","0419","0490","650","532","118","67","717","1315","0","54.52","40.46"
"64","000","00","004","0420","0000","1196","955","241","135","1331","2140","0","62.2","44.63"
"64","000","00","004","0420","0491","599","471","128","71","670","1062","0","63.09","44.35"
"64","000","00","004","0420","0492","597","484","113","64","661","1078","0","61.32","44.9"
"64","000","00","004","0421","0000","1136","881","255","185","1321","1978","0","66.78","44.54"
"64","000","00","004","0421","0493","527","409","118","84","611","914","0","66.85","44.75"
"64","000","00","004","0421","0494","609","472","137","101","710","1064","0","66.73","44.36"
"64","000","00","004","0422","0000","3016","2402","614","231","3247","5350","0","60.69","44.9"
"64","000","00","004","0422","0495","958","728","230","83","1041","1705","0","61.06","42.7"
"64","000","00","004","0422","0496","971","776","195","76","1047","1728","0","60.59","44.91"
"64","000","00","004","0422","0497","1087","898","189","72","1159","1917","0","60.46","46.84"
"64","000","00","004","0423","0000","709","525","184","106","815","1439","0","56.64","36.48"
"64","000","00","004","0423","0498","709","525","184","106","815","1439","0","56.64","36.48"
"64","000","00","004","0424","0000","2462","1964","498","222","2684","4196","0","63.97","46.81"
"64","000","00","004","0424","0499","736","579","157","77","813","1287","0","63.17","44.99"
"64","000","00","004","0424","0500","879","712","167","76","955","1504","0","63.5","47.34"
"64","000","00","004","0424","0501","847","673","174","69","916","1405","0","65.2","47.9"
"64","000","00","004","0425","0000","1445","1098","347","150","1595","2582","0","61.77","42.53"
"64","000","00","004","0425","0502","698","514","184","87","785","1287","0","60.99","39.94"
"64","000","00","004","0425","0503","747","584","163","63","810","1295","0","62.55","45.1"
"64","000","00","004","0426","0000","1880","1484","396","138","2018","3132","0","64.43","47.38"
"64","000","00","004","0426","0504","859","677","182","66","925","1483","0","62.37","45.65"
"64","000","00","004","0426","0505","1021","807","214","72","1093","1649","0","66.28","48.94"
"64","000","00","004","0427","0000","1185","897","288","128","1313","2023","0","64.9","44.34"
"64","000","00","004","0427","0506","580","424","156","67","647","998","0","64.83","42.48"
"64","000","00","004","0427","0507","605","473","132","61","666","1025","0","64.98","46.15"
"64","000","00","004","0428","0000","1912","1470","442","168","2080","3124","0","66.58","47.06"
"64","000","00","004","0428","0508","1055","809","246","69","1124","1671","0","67.27","48.41"
"64","000","00","004","0428","0509","857","661","196","99","956","1453","0","65.79","45.49"
"64","000","00","004","0429","0000","1786","1423","363","168","1954","3326","0","58.75","42.78"
"64","000","00","004","0429","0510","893","691","202","107","1000","1673","0","59.77","41.3"
"64","000","00","004","0429","0511","893","732","161","61","954","1653","0","57.71","44.28"
"64","000","00","004","0430","0000","1299","1026","273","119","1418","2161","0","65.62","47.48"
"64","000","00","004","0430","0512","583","461","122","58","641","1034","0","61.99","44.58"
"64","000","00","004","0430","0513","716","565","151","61","777","1127","0","68.94","50.13"
"64","000","00","004","0431","0000","2430","1863","567","221","2651","4512","0","58.75","41.29"
"64","000","00","004","0431","0514","806","605","201","96","902","1575","0","57.27","38.41"
"64","000","00","004","0431","0515","884","691","193","65","949","1559","0","60.87","44.32"
"64","000","00","004","0431","0516","740","567","173","60","800","1378","0","58.06","41.15"
"64","000","00","004","0432","0000","1931","1483","448","166","2097","3435","0","61.05","43.17"
"64","000","00","004","0432","0517","967","734","233","82","1049","1714","0","61.2","42.82"
"64","000","00","004","0432","0518","964","749","215","84","1048","1721","0","60.89","43.52"
"64","000","00","004","0433","0000","4883","3850","1033","353","5236","8227","0","63.64","46.8"
"64","000","00","004","0433","0519","901","704","197","74","975","1628","0","59.89","43.24"
"64","000","00","004","0433","0520","974","770","204","89","1063","1590","0","66.86","48.43"
"64","000","00","004","0433","0521","931","733","198","65","996","1628","0","61.18","45.02"
"64","000","00","004","0433","0522","1083","839","244","56","1139","1739","0","65.5","48.25"
"64","000","00","004","0433","0523","994","804","190","69","1063","1642","0","64.74","48.96"
"64","000","00","004","0434","0000","2556","2056","500","205","2761","4997","0","55.25","41.14"
"64","000","00","004","0434","0524","899","700","199","85","984","1766","0","55.72","39.64"
"64","000","00","004","0434","0525","782","601","181","79","861","1482","0","58.1","40.55"
"64","000","00","004","0434","0526","875","755","120","41","916","1749","0","52.37","43.17"
"64","000","00","004","0435","0000","3864","3171","693","203","4067","6433","0","63.22","49.29"
"64","000","00","004","0435","0527","915","745","170","49","964","1591","0","60.59","46.83"
"64","000","00","004","0435","0528","947","787","160","45","992","1545","0","64.21","50.94"
"64","000","00","004","0435","0529","1029","839","190","41","1070","1651","0","64.81","50.82"
"64","000","00","004","0435","0530","973","800","173","68","1041","1646","0","63.24","48.6"
"64","000","00","004","0436","0000","872","677","195","94","966","1496","0","64.57","45.25"
"64","000","00","004","0436","0531","872","677","195","94","966","1496","0","64.57","45.25"
"64","000","00","004","0437","0000","1590","1216","374","156","1746","3027","0","57.68","40.17"
"64","000","00","004","0437","0532","705","519","186","103","808","1403","0","57.59","36.99"
"64","000","00","004","0437","0533","885","697","188","53","938","1624","0","57.76","42.92"
"64","000","00","005","0000","0000","157280","120091","37189","10524","167804","289519","341230","57.96","41.48"
"64","000","00","005","0501","0000","1939","1516","423","199","2138","3875","0","55.17","39.12"
"64","000","00","005","0501","0887","985","720","265","92","1077","1893","0","56.89","38.03"
"64","000","00","005","0501","0888","954","796","158","107","1061","1982","0","53.53","40.16"
"64","000","00","005","0502","0000","3936","3067","869","244","4180","7408","0","56.43","41.4"
"64","000","00","005","0502","0889","890","695","195","81","971","1661","0","58.46","41.84"
"64","000","00","005","0502","0890","990","768","222","24","1014","1894","0","53.54","40.55"
"64","000","00","005","0502","0891","984","763","221","60","1044","1839","0","56.77","41.49"
"64","000","00","005","0502","0892","1072","841","231","79","1151","2014","0","57.15","41.76"
"64","000","00","005","0503","0000","1965","1520","445","189","2154","3913","0","55.05","38.84"
"64","000","00","005","0503","0893","991","791","200","128","1119","1897","0","58.99","41.7"
"64","000","00","005","0503","0894","974","729","245","61","1035","2016","0","51.34","36.16"
"64","000","00","005","0504","0000","1922","1481","441","146","2068","3673","0","56.3","40.32"
"64","000","00","005","0504","0895","975","734","241","61","1036","1924","0","53.85","38.15"
"64","000","00","005","0504","0896","947","747","200","85","1032","1749","0","59.01","42.71"
"64","000","00","005","0505","0000","3851","3150","701","235","4086","7080","0","57.71","44.49"
"64","000","00","005","0505","0897","1093","1014","79","68","1161","1845","0","62.93","54.96"
"64","000","00","005","0505","0898","859","663","196","40","899","1724","0","52.15","38.46"
"64","000","00","005","0505","0899","1034","835","199","43","1077","1889","0","57.01","44.2"
"64","000","00","005","0505","0900","865","638","227","84","949","1622","0","58.51","39.33"
"64","000","00","005","0506","0000","1893","1385","508","104","1997","3393","0","58.86","40.82"
"64","000","00","005","0506","0901","997","729","268","44","1041","1870","0","55.67","38.98"
"64","000","00","005","0506","0902","896","656","240","60","956","1523","0","62.77","43.07"
"64","000","00","005","0507","0000","11304","8868","2436","616","11920","20639","0","57.75","42.97"
"64","000","00","005","0507","0903","957","714","243","64","1021","2006","0","50.9","35.59"
"64","000","00","005","0507","0904","1232","959","273","71","1303","2076","0","62.76","46.19"
"64","000","00","005","0507","0905","1130","877","253","38","1168","2073","0","56.34","42.31"
"64","000","00","005","0507","0906","1121","908","213","79","1200","2045","0","58.68","44.4"
"64","000","00","005","0507","0907","961","750","211","74","1035","2070","0","50.0","36.23"
"64","000","00","005","0507","0908","1050","778","272","72","1122","2035","0","55.14","38.23"
"64","000","00","005","0507","0909","1216","933","283","56","1272","2075","0","61.3","44.96"
"64","000","00","005","0507","0910","1158","961","197","43","1201","2053","0","58.5","46.81"
"64","000","00","005","0507","0911","1189","970","219","67","1256","2063","0","60.88","47.02"
"64","000","00","005","0507","0912","1290","1018","272","52","1342","2143","0","62.62","47.5"
"64","000","00","005","0508","0000","4515","3527","988","315","4830","8519","0","56.7","41.4"
"64","000","00","005","0508","0913","997","741","256","87","1084","1746","0","62.08","42.44"
"64","000","00","005","0508","0914","833","638","195","34","867","1735","0","49.97","36.77"
"64","000","00","005","0508","0915","845","696","149","69","914","1655","0","55.23","42.05"
"64","000","00","005","0508","0916","874","690","184","70","944","1583","0","59.63","43.59"
"64","000","00","005","0508","0917","966","762","204","55","1021","1800","0","56.72","42.33"
"64","000","00","005","0509","0000","3898","3044","854","188","4086","7001","0","58.36","43.48"
"64","000","00","005","0509","0918","972","779","193","43","1015","1730","0","58.67","45.03"
"64","000","00","005","0509","0919","930","730","200","28","958","1715","0","55.86","42.57"
"64","000","00","005","0509","0920","949","716","233","60","1009","1691","0","59.67","42.34"
"64","000","00","005","0509","0921","1047","819","228","57","1104","1865","0","59.2","43.91"
"64","000","00","005","0510","0000","1226","948","278","102","1328","1990","0","66.73","47.64"
"64","000","00","005","0510","0922","656","510","146","38","694","1073","0","64.68","47.53"
"64","000","00","005","0510","0923","570","438","132","64","634","917","0","69.14","47.76"
"64","000","00","005","0511","0000","907","668","239","71","978","1647","0","59.38","40.56"
"64","000","00","005","0511","0924","907","668","239","71","978","1647","0","59.38","40.56"
"64","000","00","005","0512","0000","2903","2230","673","196","3099","5126","0","60.46","43.5"
"64","000","00","005","0512","0925","925","693","232","78","1003","1654","0","60.64","41.9"
"64","000","00","005","0512","0926","938","727","211","49","987","1639","0","60.22","44.36"
"64","000","00","005","0512","0927","1040","810","230","69","1109","1833","0","60.5","44.19"
"64","000","00","005","0513","0000","2634","2078","556","132","2766","4401","0","62.85","47.22"
"64","000","00","005","0513","0928","840","654","186","39","879","1362","0","64.54","48.02"
"64","000","00","005","0513","0929","922","720","202","66","988","1557","0","63.46","46.24"
"64","000","00","005","0513","0930","872","704","168","27","899","1482","0","60.66","47.5"
"64","000","00","005","0514","0000","2710","2071","639","111","2821","4583","0","61.55","45.19"
"64","000","00","005","0514","0931","926","702","224","41","967","1563","0","61.87","44.91"
"64","000","00","005","0514","0932","861","650","211","34","895","1497","0","59.79","43.42"
"64","000","00","005","0514","0933","923","719","204","36","959","1523","0","62.97","47.21"
"64","000","00","005","0515","0000","4351","3394","957","257","4608","7198","0","64.02","47.15"
"64","000","00","005","0515","0934","808","628","180","55","863","1293","0","66.74","48.57"
"64","000","00","005","0515","0935","991","789","202","51","1042","1662","0","62.7","47.47"
"64","000","00","005","0515","0936","798","628","170","66","864","1441","0","59.96","43.58"
"64","000","00","005","0515","0937","841","650","191","51","892","1326","0","67.27","49.02"
"64","000","00","005","0515","0938","913","699","214","34","947","1476","0","64.16","47.36"
"64","000","00","005","0516","0000","1776","1355","421","53","1829","3586","0","51.0","37.79"
"64","000","00","005","0516","0939","974","762","212","26","1000","1968","0","50.81","38.72"
"64","000","00","005","0516","0940","802","593","209","27","829","1618","0","51.24","36.65"
"64","000","00","005","0517","0000","2711","2044","667","154","2865","5000","0","57.3","40.88"
"64","000","00","005","0517","0941","1024","794","230","58","1082","1873","0","57.77","42.39"
"64","000","00","005","0517","0942","817","605","212","75","892","1487","0","59.99","40.69"
"64","000","00","005","0517","0943","870","645","225","21","891","1640","0","54.33","39.33"
"64","000","00","005","0518","0000","1976","1521","455","71","2047","3858","0","53.06","39.42"
"64","000","00","005","0518","0944","964","719","245","32","996","1889","0","52.73","38.06"
"64","000","00","005","0518","0945","1012","802","210","39","1051","1969","0","53.38","40.73"
"64","000","00","005","0519","0000","3508","2624","884","376","3884","6475","0","59.98","40.53"
"64","000","00","005","0519","0946","701","481","220","192","893","1466","0","60.91","32.81"
"64","000","00","005","0519","0947","964","740","224","63","1027","1697","0","60.52","43.61"
"64","000","00","005","0519","0948","937","723","214","68","1005","1663","0","60.43","43.48"
"64","000","00","005","0519","0949","906","680","226","53","959","1649","0","58.16","41.24"
"64","000","00","005","0520","0000","1549","1210","339","80","1629","2981","0","54.65","40.59"
"64","000","00","005","0520","0950","783","613","170","47","830","1486","0","55.85","41.25"
"64","000","00","005","0520","0951","766","597","169","33","799","1495","0","53.44","39.93"
"64","000","00","005","0521","0000","1732","1351","381","57","1789","3041","0","58.83","44.43"
"64","000","00","005","0521","0952","928","745","183","35","963","1548","0","62.21","48.13"
"64","000","00","005","0521","0953","804","606","198","22","826","1493","0","55.32","40.59"
"64","000","00","005","0522","0000","4342","3432","910","238","4580","7649","0","59.88","44.87"
"64","000","00","005","0522","0954","857","674","183","33","890","1445","0","61.59","46.64"
"64","000","00","005","0522","0955","813","656","157","45","858","1529","0","56.12","42.9"
"64","000","00","005","0522","0956","799","623","176","32","831","1506","0","55.18","41.37"
"64","000","00","005","0522","0957","904","724","180","65","969","1549","0","62.56","46.74"
"64","000","00","005","0522","0958","969","755","214","63","1032","1620","0","63.7","46.6"
"64","000","00","005","0523","0000","1811","1392","419","110","1921","3038","0","63.23","45.82"
"64","000","00","005","0523","0959","921","710","211","61","982","1550","0","63.35","45.81"
"64","000","00","005","0523","0960","890","682","208","49","939","1488","0","63.1","45.83"
"64","000","00","005","0524","0000","1510","1157","353","121","1631","2667","0","61.15","43.38"
"64","000","00","005","0524","0961","755","583","172","59","814","1335","0","60.97","43.67"
"64","000","00","005","0524","0962","755","574","181","62","817","1332","0","61.34","43.09"
"64","000","00","005","0525","0000","2983","2262","721","213","3196","5268","0","60.67","42.94"
"64","000","00","005","0525","0963","997","757","240","86","1083","1764","0","61.39","42.91"
"64","000","00","005","0525","0964","987","759","228","52","1039","1811","0","57.37","41.91"
"64","000","00","005","0525","0965","999","746","253","75","1074","1693","0","63.44","44.06"
"64","000","00","005","0526","0000","2856","2206","650","182","3038","4867","0","62.42","45.33"
"64","000","00","005","0526","0966","1008","762","246","81","1089","1684","0","64.67","45.25"
"64","000","00","005","0526","0967","776","619","157","66","842","1464","0","57.51","42.28"
"64","000","00","005","0526","0968","1072","825","247","35","1107","1719","0","64.4","47.99"
"64","000","00","005","0527","0000","3756","2911","845","188","3944","6858","0","57.51","42.45"
"64","000","00","005","0527","0969","969","753","216","33","1002","1749","0","57.29","43.05"
"64","000","00","005","0527","0970","1000","782","218","38","1038","1908","0","54.4","40.99"
"64","000","00","005","0527","0971","909","715","194","68","977","1573","0","62.11","45.45"
"64","000","00","005","0527","0972","878","661","217","49","927","1628","0","56.94","40.6"
"64","000","00","005","0528","0000","2172","1690","482","177","2349","4095","0","57.36","41.27"
"64","000","00","005","0528","0973","647","491","156","60","707","1377","0","51.34","35.66"
"64","000","00","005","0528","0974","915","724","191","53","968","1530","0","63.27","47.32"
"64","000","00","005","0528","0975","610","475","135","64","674","1188","0","56.73","39.98"
"64","000","00","005","0529","0000","2731","2091","640","217","2948","6302","0","46.78","33.18"
"64","000","00","005","0529","0976","784","599","185","40","824","2791","0","29.52","21.46"
"64","000","00","005","0529","0977","1002","779","223","82","1084","1840","0","58.91","42.34"
"64","000","00","005","0529","0978","945","713","232","95","1040","1671","0","62.24","42.67"
"64","000","00","005","0530","0000","4695","3621","1074","273","4968","7969","0","62.34","45.44"
"64","000","00","005","0530","0979","911","705","206","69","980","1624","0","60.34","43.41"
"64","000","00","005","0530","0980","997","763","234","60","1057","1555","0","67.97","49.07"
"64","000","00","005","0530","0981","929","717","212","54","983","1489","0","66.02","48.15"
"64","000","00","005","0530","0982","966","737","229","70","1036","1662","0","62.33","44.34"
"64","000","00","005","0530","0983","892","699","193","20","912","1639","0","55.64","42.65"
"64","000","00","005","0531","0000","2053","1579","474","163","2216","3840","0","57.71","41.12"
"64","000","00","005","0531","0984","995","780","215","93","1088","1872","0","58.12","41.67"
"64","000","00","005","0531","0985","1058","799","259","70","1128","1968","0","57.32","40.6"
"64","000","00","005","0532","0000","1479","1135","344","197","1676","3005","0","55.77","37.77"
"64","000","00","005","0532","0986","666","514","152","120","786","1471","0","53.43","34.94"
"64","000","00","005","0532","0987","813","621","192","77","890","1534","0","58.02","40.48"
"64","000","00","005","0533","0000","2593","2010","583","186","2779","5282","0","52.61","38.05"
"64","000","00","005","0533","0988","815","630","185","88","903","1659","0","54.43","37.97"
"64","000","00","005","0533","0989","851","665","186","46","897","1815","0","49.42","36.64"
"64","000","00","005","0533","0990","927","715","212","52","979","1808","0","54.15","39.55"
"64","000","00","005","0534","0000","1338","1031","307","73","1411","2630","0","53.65","39.2"
"64","000","00","005","0534","0991","602","453","149","39","641","1224","0","52.37","37.01"
"64","000","00","005","0534","0992","736","578","158","34","770","1406","0","54.77","41.11"
"64","000","00","005","0535","0000","1051","782","269","80","1131","1889","0","59.87","41.4"
"64","000","00","005","0535","0993","502","382","120","29","531","945","0","56.19","40.42"
"64","000","00","005","0535","0994","549","400","149","51","600","944","0","63.56","42.37"
"64","000","00","005","0536","0000","1702","1287","415","183","1885","3142","0","59.99","40.96"
"64","000","00","005","0536","0995","890","671","219","79","969","1669","0","58.06","40.2"
"64","000","00","005","0536","0996","812","616","196","104","916","1473","0","62.19","41.82"
"64","000","00","005","0537","0000","1493","1122","371","124","1617","3558","0","45.45","31.53"
"64","000","00","005","0537","0997","893","682","211","64","957","1876","0","51.01","36.35"
"64","000","00","005","0537","0998","600","440","160","60","660","1682","0","39.24","26.16"
"64","000","00","005","0538","0000","6233","4751","1482","299","6532","11459","0","57.0","41.46"
"64","000","00","005","0538","0999","916","662","254","52","968","1791","0","54.05","36.96"
"64","000","00","005","0538","1000","1036","779","257","57","1093","1808","0","60.45","43.09"
"64","000","00","005","0538","1001","931","689","242","56","987","1798","0","54.89","38.32"
"64","000","00","005","0538","1002","1133","856","277","66","1199","2030","0","59.06","42.17"
"64","000","00","005","0538","1003","1115","890","225","29","1144","2034","0","56.24","43.76"
"64","000","00","005","0538","1004","1102","875","227","39","1141","1998","0","57.11","43.79"
"64","000","00","005","0539","0000","1959","1505","454","82","2041","3879","0","52.62","38.8"
"64","000","00","005","0539","1005","942","715","227","41","983","1914","0","51.36","37.36"
"64","000","00","005","0539","1006","1017","790","227","41","1058","1965","0","53.84","40.2"
"64","000","00","005","0540","0000","998","722","276","97","1095","1885","0","58.09","38.3"
"64","000","00","005","0540","1007","998","722","276","97","1095","1885","0","58.09","38.3"
"64","000","00","005","0541","0000","1254","951","303","98","1352","2277","0","59.38","41.77"
"64","000","00","005","0541","1008","704","540","164","14","718","1220","0","58.85","44.26"
"64","000","00","005","0541","1009","550","411","139","84","634","1057","0","59.98","38.88"
"64","000","00","005","0542","0000","1213","923","290","75","1288","2784","0","46.26","33.15"
"64","000","00","005","0542","1010","616","457","159","29","645","1434","0","44.98","31.87"
"64","000","00","005","0542","1011","597","466","131","46","643","1350","0","47.63","34.52"
"64","000","00","005","0543","0000","832","615","217","62","894","1826","0","48.96","33.68"
"64","000","00","005","0543","1012","370","282","88","32","402","872","0","46.1","32.34"
"64","000","00","005","0543","1013","462","333","129","30","492","954","0","51.57","34.91"
"64","000","00","005","0544","0000","2461","1884","577","132","2593","4415","0","58.73","42.67"
"64","000","00","005","0544","1014","971","775","196","27","998","1689","0","59.09","45.89"
"64","000","00","005","0544","1015","746","548","198","22","768","1390","0","55.25","39.42"
"64","000","00","005","0544","1016","744","561","183","83","827","1336","0","61.9","41.99"
"64","000","00","005","0545","0000","2568","1920","648","161","2729","4402","0","61.99","43.62"
"64","000","00","005","0545","1017","903","657","246","51","954","1437","0","66.39","45.72"
"64","000","00","005","0545","1018","816","623","193","28","844","1452","0","58.13","42.91"
"64","000","00","005","0545","1019","849","640","209","82","931","1513","0","61.53","42.3"
"64","000","00","005","0546","0000","1716","1240","476","174","1890","2848","0","66.36","43.54"
"64","000","00","005","0546","1020","867","641","226","89","956","1467","0","65.17","43.69"
"64","000","00","005","0546","1021","849","599","250","85","934","1381","0","67.63","43.37"
"64","000","00","005","0547","0000","1387","1012","375","87","1474","2444","0","60.31","41.41"
"64","000","00","005","0547","1022","606","434","172","50","656","1117","0","58.73","38.85"
"64","000","00","005","0547","1023","781","578","203","37","818","1327","0","61.64","43.56"
"64","000","00","005","0548","0000","729","542","187","48","777","1304","0","59.59","41.56"
"64","000","00","005","0548","1024","729","542","187","48","777","1304","0","59.59","41.56"
"64","000","00","005","0549","0000","727","519","208","38","765","1483","0","51.58","35.0"
"64","000","00","005","0549","1025","727","519","208","38","765","1483","0","51.58","35.0"
"64","000","00","005","0550","0000","852","638","214","52","904","1473","0","61.37","43.31"
"64","000","00","005","0550","1026","852","638","214","52","904","1473","0","61.37","43.31"
"64","000","00","005","0551","0000","565","419","146","32","597","980","0","60.92","42.76"
"64","000","00","005","0551","1027","565","419","146","32","597","980","0","60.92","42.76"
"64","000","00","005","0552","0000","1498","1104","394","124","1622","2639","0","61.46","41.83"
"64","000","00","005","0552","1028","800","610","190","71","871","1409","0","61.82","43.29"
"64","000","00","005","0552","1029","698","494","204","53","751","1230","0","61.06","40.16"
"64","000","00","005","0553","0000","1273","940","333","123","1396","2154","0","64.81","43.64"
"64","000","00","005","0553","1030","620","458","162","63","683","1024","0","66.7","44.73"
"64","000","00","005","0553","1031","653","482","171","60","713","1130","0","63.1","42.65"
"64","000","00","005","0554","0000","931","700","231","34","965","1889","0","51.09","37.06"
"64","000","00","005","0554","1032","931","700","231","34","965","1889","0","51.09","37.06"
"64","000","00","005","0555","0000","786","595","191","33","819","1427","0","57.39","41.7"
"64","000","00","005","0555","1033","786","595","191","33","819","1427","0","57.39","41.7"
"64","000","00","005","0556","0000","448","352","96","23","471","791","0","59.54","44.5"
"64","000","00","005","0556","1034","448","352","96","23","471","791","0","59.54","44.5"
"64","000","00","005","0557","0000","671","503","168","87","758","1079","0","70.25","46.62"
"64","000","00","005","0557","1035","671","503","168","87","758","1079","0","70.25","46.62"
"64","000","00","005","0558","0000","806","594","212","87","893","1492","0","59.85","39.81"
"64","000","00","005","0558","1036","806","594","212","87","893","1492","0","59.85","39.81"
"64","000","00","005","0559","0000","1166","831","335","67","1233","2021","0","61.01","41.12"
"64","000","00","005","0559","1037","608","436","172","51","659","1020","0","64.61","42.75"
"64","000","00","005","0559","1038","558","395","163","16","574","1001","0","57.34","39.46"
"64","000","00","005","0560","0000","1639","1256","383","105","1744","3052","0","57.14","41.15"
"64","000","00","005","0560","1039","858","684","174","55","913","1581","0","57.75","43.26"
"64","000","00","005","0560","1040","781","572","209","50","831","1471","0","56.49","38.89"
"64","000","00","005","0561","0000","2117","1517","600","154","2271","3760","0","60.4","40.35"
"64","000","00","005","0561","1041","629","400","229","29","658","1151","0","57.17","34.75"
"64","000","00","005","0561","1042","767","566","201","73","840","1334","0","62.97","42.43"
"64","000","00","005","0561","1043","721","551","170","52","773","1275","0","60.63","43.22"
"64","000","00","005","0562","0000","2070","1515","555","116","2186","4051","0","53.96","37.4"
"64","000","00","005","0562","1044","719","513","206","45","764","1688","0","45.26","30.39"
"64","000","00","005","0562","1045","657","473","184","39","696","1214","0","57.33","38.96"
"64","000","00","005","0562","1046","694","529","165","32","726","1149","0","63.19","46.04"
"64","000","00","005","0563","0000","908","675","233","96","1004","1667","0","60.23","40.49"
"64","000","00","005","0563","1047","908","675","233","96","1004","1667","0","60.23","40.49"
"64","000","00","005","0564","0000","873","641","232","40","913","1786","0","51.12","35.89"
"64","000","00","005","0564","1048","873","641","232","40","913","1786","0","51.12","35.89"
"64","000","00","005","0565","0000","1037","793","244","82","1119","1821","0","61.45","43.55"
"64","000","00","005","0565","1049","521","383","138","18","539","896","0","60.16","42.75"
"64","000","00","005","0565","1050","516","410","106","64","580","925","0","62.7","44.32"
"64","000","00","005","0566","0000","412","303","109","52","464","684","0","67.84","44.3"
"64","000","00","005","0566","1051","412","303","109","52","464","684","0","67.84","44.3"
"64","000","00","005","0567","0000","587","426","161","69","656","981","0","66.87","43.43"
"64","000","00","005","0567","1052","587","426","161","69","656","981","0","66.87","43.43"
"64","000","00","005","0568","0000","667","487","180","88","755","1383","0","54.59","35.21"
"64","000","00","005","0568","1053","667","487","180","88","755","1383","0","54.59","35.21"
"64","000","00","005","0569","0000","752","556","196","49","801","1382","0","57.96","40.23"
"64","000","00","005","0569","1054","752","556","196","49","801","1382","0","57.96","40.23"
"64","000","00","005","0570","0000","425","321","104","27","452","808","0","55.94","39.73"
"64","000","00","005","0570","1055","425","321","104","27","452","808","0","55.94","39.73"
"64","000","00","005","0572","0000","732","542","190","23","755","1197","0","63.07","45.28"
"64","000","00","005","0572","1056","732","542","190","23","755","1197","0","63.07","45.28"
"64","000","00","005","0573","0000","2227","1656","571","132","2359","4047","0","58.29","40.92"
"64","000","00","005","0573","1057","697","520","177","57","754","1344","0","56.1","38.69"
"64","000","00","005","0573","1058","759","550","209","55","814","1344","0","60.57","40.92"
"64","000","00","005","0573","1059","771","586","185","20","791","1359","0","58.2","43.12"
"64","000","00","005","0574","0000","628","467","161","53","681","1073","0","63.47","43.52"
"64","000","00","005","0574","1060","628","467","161","53","681","1073","0","63.47","43.52"
"64","000","00","005","0575","0000","614","449","165","55","669","1186","0","56.41","37.86"
"64","000","00","005","0575","1061","614","449","165","55","669","1186","0","56.41","37.86"
"64","000","00","005","0576","0000","925","705","220","87","1012","1749","0","57.86","40.31"
"64","000","00","005","0576","1062","925","705","220","87","1012","1749","0","57.86","40.31"
"64","000","00","005","0577","0000","422","336","86","24","446","877","0","50.86","38.31"
"64","000","00","005","0577","1063","422","336","86","24","446","877","0","50.86","38.31"
"64","000","00","005","0578","0000","800","599","201","112","912","1402","0","65.05","42.72"
"64","000","00","005","0578","1064","800","599","201","112","912","1402","0","65.05","42.72"
"64","000","00","005","0579","0000","467","350","117","20","487","769","0","63.33","45.51"
"64","000","00","005","0579","1065","467","350","117","20","487","769","0","63.33","45.51"
"64","000","00","005","0581","0000","1289","956","333","110","1399","2477","0","56.48","38.6"
"64","000","00","005","0581","1066","688","518","170","60","748","1207","0","61.97","42.92"
"64","000","00","005","0581","1067","601","438","163","50","651","1270","0","51.26","34.49"
"64","000","00","005","0582","0000","667","392","275","52","719","1248","0","57.61","31.41"
"64","000","00","005","0582","1068","667","392","275","52","719","1248","0","57.61","31.41"
"64","000","00","005","0583","0000","696","534","162","88","784","1263","0","62.07","42.28"
"64","000","00","005","0583","1069","696","534","162","88","784","1263","0","62.07","42.28"
"64","000","00","005","0584","0000","603","449","154","42","645","1101","0","58.58","40.78"
"64","000","00","005","0584","1070","603","449","154","42","645","1101","0","58.58","40.78"
"64","000","00","005","0585","0000","634","475","159","21","655","1116","0","58.69","42.56"
"64","000","00","005","0585","1071","634","475","159","21","655","1116","0","58.69","42.56"
"64","000","00","005","0586","0000","628","479","149","42","670","1152","0","58.16","41.58"
"64","000","00","005","0586","1072","628","479","149","42","670","1152","0","58.16","41.58"
"64","000","00","005","0587","0000","586","442","144","75","661","1057","0","62.54","41.82"
"64","000","00","005","0587","1073","586","442","144","75","661","1057","0","62.54","41.82"
"64","000","00","005","0588","0000","1031","750","281","74","1105","2033","0","54.35","36.89"
"64","000","00","005","0588","1074","467","342","125","56","523","971","0","53.86","35.22"
"64","000","00","005","0588","1075","564","408","156","18","582","1062","0","54.8","38.42"
"64","000","00","006","0000","0000","24892","18404","6488","1616","26508","44355","50942","59.76","41.49"
"64","000","00","006","0601","0000","1037","752","285","89","1126","1791","0","62.87","41.99"
"64","000","00","006","0601","1098","458","333","125","32","490","828","0","59.18","40.22"
"64","000","00","006","0601","1099","579","419","160","57","636","963","0","66.04","43.51"
"64","000","00","006","0602","0000","554","422","132","27","581","1075","0","54.05","39.26"
"64","000","00","006","0602","1100","554","422","132","27","581","1075","0","54.05","39.26"
"64","000","00","006","0603","0000","1644","1263","381","60","1704","2926","0","58.24","43.16"
"64","000","00","006","0603","1101","832","632","200","30","862","1488","0","57.93","42.47"
"64","000","00","006","0603","1102","812","631","181","30","842","1438","0","58.55","43.88"
"64","000","00","006","0604","0000","610","461","149","27","637","1049","0","60.72","43.95"
"64","000","00","006","0604","1103","610","461","149","27","637","1049","0","60.72","43.95"
"64","000","00","006","0605","0000","837","579","258","85","922","1378","0","66.91","42.02"
"64","000","00","006","0605","1104","837","579","258","85","922","1378","0","66.91","42.02"
"64","000","00","006","0606","0000","400","314","86","36","436","666","0","65.47","47.15"
"64","000","00","006","0606","1105","400","314","86","36","436","666","0","65.47","47.15"
"64","000","00","006","0607","0000","548","375","173","28","576","981","0","58.72","38.23"
"64","000","00","006","0607","1106","548","375","173","28","576","981","0","58.72","38.23"
"64","000","00","006","0608","0000","1108","842","266","66","1174","1920","0","61.15","43.85"
"64","000","00","006","0608","1107","567","417","150","38","605","933","0","64.84","44.69"
"64","000","00","006","0608","1108","541","425","116","28","569","987","0","57.65","43.06"
"64","000","00","006","0609","0000","576","459","117","46","622","988","0","62.96","46.46"
"64","000","00","006","0609","1109","576","459","117","46","622","988","0","62.96","46.46"
"64","000","00","006","0610","0000","450","332","118","33","483","735","0","65.71","45.17"
"64","000","00","006","0610","1110","450","332","118","33","483","735","0","65.71","45.17"
"64","000","00","006","0611","0000","750","548","202","34","784","1317","0","59.53","41.61"
"64","000","00","006","0611","1111","750","548","202","34","784","1317","0","59.53","41.61"
"64","000","00","006","0612","0000","399","288","111","10","409","800","0","51.13","36.0"
"64","000","00","006","0612","1112","399","288","111","10","409","800","0","51.13","36.0"
"64","000","00","006","0613","0000","1090","822","268","66","1156","1881","0","61.46","43.7"
"64","000","00","006","0613","1113","562","417","145","37","599","968","0","61.88","43.08"
"64","000","00","006","0613","1114","528","405","123","29","557","913","0","61.01","44.36"
"64","000","00","006","0614","0000","1587","1148","439","79","1666","2617","0","63.66","43.87"
"64","000","00","006","0614","1115","814","583","231","26","840","1389","0","60.48","41.97"
"64","000","00","006","0614","1116","773","565","208","53","826","1228","0","67.26","46.01"
"64","000","00","006","0615","0000","1319","1037","282","96","1415","2312","0","61.2","44.85"
"64","000","00","006","0615","1117","689","532","157","75","764","1211","0","63.09","43.93"
"64","000","00","006","0615","1118","630","505","125","21","651","1101","0","59.13","45.87"
"64","000","00","006","0616","0000","1032","782","250","53","1085","1625","0","66.77","48.12"
"64","000","00","006","0616","1119","457","361","96","12","469","752","0","62.37","48.01"
"64","000","00","006","0616","1120","575","421","154","41","616","873","0","70.56","48.22"
"64","000","00","006","0617","0000","1963","1432","531","102","2065","3345","0","61.73","42.81"
"64","000","00","006","0617","1121","939","686","253","38","977","1609","0","60.72","42.64"
"64","000","00","006","0617","1122","1024","746","278","64","1088","1736","0","62.67","42.97"
"64","000","00","006","0618","0000","682","528","154","27","709","1258","0","56.36","41.97"
"64","000","00","006","0618","1123","682","528","154","27","709","1258","0","56.36","41.97"
"64","000","00","006","0619","0000","629","455","174","59","688","1105","0","62.26","41.18"
"64","000","00","006","0619","1124","629","455","174","59","688","1105","0","62.26","41.18"
"64","000","00","006","0620","0000","486","317","169","47","533","851","0","62.63","37.25"
"64","000","00","006","0620","1125","486","317","169","47","533","851","0","62.63","37.25"
"64","000","00","006","0621","0000","594","432","162","42","636","1011","0","62.91","42.73"
"64","000","00","006","0621","1126","594","432","162","42","636","1011","0","62.91","42.73"
"64","000","00","006","0622","0000","1088","800","288","97","1185","1893","0","62.6","42.26"
"64","000","00","006","0622","1127","546","380","166","68","614","888","0","69.14","42.79"
"64","000","00","006","0622","1128","542","420","122","29","571","1005","0","56.82","41.79"
"64","000","00","006","0623","0000","1373","976","397","79","1452","2763","0","52.55","35.32"
"64","000","00","006","0623","1129","585","442","143","14","599","1375","0","43.56","32.15"
"64","000","00","006","0623","1130","788","534","254","65","853","1388","0","61.46","38.47"
"64","000","00","006","0624","0000","379","274","105","50","429","719","0","59.67","38.11"
"64","000","00","006","0624","1131","379","274","105","50","429","719","0","59.67","38.11"
"64","000","00","006","0625","0000","573","404","169","76","649","1077","0","60.26","37.51"
"64","000","00","006","0625","1132","573","404","169","76","649","1077","0","60.26","37.51"
"64","000","00","006","0626","0000","409","311","98","19","428","875","0","48.91","35.54"
"64","000","00","006","0626","1133","409","311","98","19","428","875","0","48.91","35.54"
"64","000","00","006","0627","0000","477","369","108","27","504","936","0","53.85","39.42"
"64","000","00","006","0627","1134","477","369","108","27","504","936","0","53.85","39.42"
"64","000","00","006","0628","0000","492","368","124","62","554","944","0","58.69","38.98"
"64","000","00","006","0628","1135","492","368","124","62","554","944","0","58.69","38.98"
"64","000","00","006","0629","0000","403","294","109","36","439","833","0","52.7","35.29"
"64","000","00","006","0629","1136","403","294","109","36","439","833","0","52.7","35.29"
"64","000","00","006","0630","0000","392","285","107","13","405","708","0","57.2","40.25"
"64","000","00","006","0630","1137","392","285","107","13","405","708","0","57.2","40.25"
"64","000","00","006","0631","0000","407","315","92","16","423","741","0","57.09","42.51"
"64","000","00","006","0631","1138","407","315","92","16","423","741","0","57.09","42.51"
"64","000","00","006","0632","0000","604","420","184","29","633","1235","0","51.26","34.01"
"64","000","00","006","0632","1139","604","420","184","29","633","1235","0","51.26","34.01"
"64","000","00","007","0000","0000","13216","9799","3417","904","14120","23928","26732","59.01","40.95"
"64","000","00","007","0701","0000","337","251","86","19","356","673","0","52.9","37.3"
"64","000","00","007","0701","1076","337","251","86","19","356","673","0","52.9","37.3"
"64","000","00","007","0702","0000","585","460","125","33","618","1022","0","60.47","45.01"
"64","000","00","007","0702","1077","585","460","125","33","618","1022","0","60.47","45.01"
"64","000","00","007","0703","0000","672","521","151","38","710","1324","0","53.63","39.35"
"64","000","00","007","0703","1078","672","521","151","38","710","1324","0","53.63","39.35"
"64","000","00","007","0704","0000","452","335","117","55","507","839","0","60.43","39.93"
"64","000","00","007","0704","1079","452","335","117","55","507","839","0","60.43","39.93"
"64","000","00","007","0705","0000","507","359","148","77","584","975","0","59.9","36.82"
"64","000","00","007","0705","1080","507","359","148","77","584","975","0","59.9","36.82"
"64","000","00","007","0706","0000","1974","1501","473","111","2085","3587","0","58.13","41.85"
"64","000","00","007","0706","1081","993","770","223","70","1063","1806","0","58.86","42.64"
"64","000","00","007","0706","1082","981","731","250","41","1022","1781","0","57.38","41.04"
"64","000","00","007","0707","0000","410","291","119","41","451","717","0","62.9","40.59"
"64","000","00","007","0707","1083","410","291","119","41","451","717","0","62.9","40.59"
"64","000","00","007","0708","0000","603","451","152","14","617","1097","0","56.24","41.11"
"64","000","00","007","0708","1084","603","451","152","14","617","1097","0","56.24","41.11"
"64","000","00","007","0709","0000","887","639","248","32","919","1633","0","56.28","39.13"
"64","000","00","007","0709","1085","887","639","248","32","919","1633","0","56.28","39.13"
"64","000","00","007","0710","0000","477","361","116","36","513","759","0","67.59","47.56"
"64","000","00","007","0710","1086","477","361","116","36","513","759","0","67.59","47.56"
"64","000","00","007","0711","0000","568","395","173","54","622","948","0","65.61","41.67"
"64","000","00","007","0711","1087","568","395","173","54","622","948","0","65.61","41.67"
"64","000","00","007","0712","0000","494","339","155","67","561","1009","0","55.6","33.6"
"64","000","00","007","0712","1088","494","339","155","67","561","1009","0","55.6","33.6"
"64","000","00","007","0713","0000","531","388","143","37","568","945","0","60.11","41.06"
"64","000","00","007","0713","1089","531","388","143","37","568","945","0","60.11","41.06"
"64","000","00","007","0714","0000","904","667","237","57","961","1529","0","62.85","43.62"
"64","000","00","007","0714","1090","446","340","106","26","472","772","0","61.14","44.04"
"64","000","00","007","0714","1091","458","327","131","31","489","757","0","64.6","43.2"
"64","000","00","007","0715","0000","607","455","152","40","647","1047","0","61.8","43.46"
"64","000","00","007","0715","1092","607","455","152","40","647","1047","0","61.8","43.46"
"64","000","00","007","0716","0000","585","424","161","41","626","985","0","63.55","43.05"
"64","000","00","007","0716","1093","585","424","161","41","626","985","0","63.55","43.05"
"64","000","00","007","0717","0000","870","649","221","30","900","1674","0","53.76","38.77"
"64","000","00","007","0717","1094","870","649","221","30","900","1674","0","53.76","38.77"
"64","000","00","007","0718","0000","586","443","143","31","617","1088","0","56.71","40.72"
"64","000","00","007","0718","1095","586","443","143","31","617","1088","0","56.71","40.72"
"64","000","00","007","0719","0000","548","412","136","52","600","893","0","67.19","46.14"
"64","000","00","007","0719","1096","548","412","136","52","600","893","0","67.19","46.14"
"64","000","00","007","0720","0000","619","458","161","39","658","1184","0","55.57","38.68"
"64","000","00","007","0720","1097","619","458","161","39","658","1184","0","55.57","38.68"
"64","000","00","008","0000","0000","81800","62255","19545","5685","87485","146786","169840","59.6","42.41"
"64","000","00","008","0801","0000","423","322","101","24","447","718","0","62.26","44.85"
"64","000","00","008","0801","1140","423","322","101","24","447","718","0","62.26","44.85"
"64","000","00","008","0802","0000","809","659","150","44","853","1492","0","57.17","44.17"
"64","000","00","008","0802","1141","809","659","150","44","853","1492","0","57.17","44.17"
"64","000","00","008","0803","0000","675","513","162","54","729","1210","0","60.25","42.4"
"64","000","00","008","0803","1142","675","513","162","54","729","1210","0","60.25","42.4"
"64","000","00","008","0804","0000","765","606","159","33","798","1617","0","49.35","37.48"
"64","000","00","008","0804","1143","765","606","159","33","798","1617","0","49.35","37.48"
"64","000","00","008","0805","0000","787","613","174","93","880","1428","0","61.62","42.93"
"64","000","00","008","0805","1144","787","613","174","93","880","1428","0","61.62","42.93"
"64","000","00","008","0806","0000","684","503","181","55","739","1444","0","51.18","34.83"
"64","000","00","008","0806","1145","684","503","181","55","739","1444","0","51.18","34.83"
"64","000","00","008","0807","0000","782","580","202","80","862","1452","0","59.37","39.94"
"64","000","00","008","0807","1146","782","580","202","80","862","1452","0","59.37","39.94"
"64","000","00","008","0808","0000","317","228","89","38","355","554","0","64.08","41.16"
"64","000","00","008","0808","1147","317","228","89","38","355","554","0","64.08","41.16"
"64","000","00","008","0809","0000","1006","724","282","34","1040","1928","0","53.94","37.55"
"64","000","00","008","0809","1148","504","361","143","19","523","950","0","55.05","38.0"
"64","000","00","008","0809","1149","502","363","139","15","517","978","0","52.86","37.12"
"64","000","00","008","0810","0000","1799","1362","437","107","1906","3718","0","51.26","36.63"
"64","000","00","008","0810","1150","809","624","185","35","844","1673","0","50.45","37.3"
"64","000","00","008","0810","1151","990","738","252","72","1062","2045","0","51.93","36.09"
"64","000","00","008","0811","0000","511","391","120","79","590","939","0","62.83","41.64"
"64","000","00","008","0811","1152","511","391","120","79","590","939","0","62.83","41.64"
"64","000","00","008","0812","0000","654","499","155","38","692","1284","0","53.89","38.86"
"64","000","00","008","0812","1153","654","499","155","38","692","1284","0","53.89","38.86"
"64","000","00","008","0813","0000","958","733","225","50","1008","1746","0","57.73","41.98"
"64","000","00","008","0813","1154","515","397","118","31","546","908","0","60.13","43.72"
"64","000","00","008","0813","1155","443","336","107","19","462","838","0","55.13","40.1"
"64","000","00","008","0814","0000","710","525","185","44","754","1267","0","59.51","41.44"
"64","000","00","008","0814","1156","710","525","185","44","754","1267","0","59.51","41.44"
"64","000","00","008","0815","0000","965","684","281","91","1056","1768","0","59.73","38.69"
"64","000","00","008","0815","1157","584","420","164","64","648","994","0","65.19","42.25"
"64","000","00","008","0815","1158","381","264","117","27","408","774","0","52.71","34.11"
"64","000","00","008","0816","0000","630","480","150","28","658","1121","0","58.7","42.82"
"64","000","00","008","0816","1159","630","480","150","28","658","1121","0","58.7","42.82"
"64","000","00","008","0817","0000","1667","1240","427","134","1801","2999","0","60.05","41.35"
"64","000","00","008","0817","1160","801","586","215","63","864","1474","0","58.62","39.76"
"64","000","00","008","0817","1161","866","654","212","71","937","1525","0","61.44","42.89"
"64","000","00","008","0818","0000","1221","914","307","78","1299","2161","0","60.11","42.3"
"64","000","00","008","0818","1162","613","470","143","36","649","1147","0","56.58","40.98"
"64","000","00","008","0818","1163","608","444","164","42","650","1014","0","64.1","43.79"
"64","000","00","008","0819","0000","1727","1253","474","122","1849","2995","0","61.74","41.84"
"64","000","00","008","0819","1164","848","602","246","60","908","1496","0","60.7","40.24"
"64","000","00","008","0819","1165","879","651","228","62","941","1499","0","62.78","43.43"
"64","000","00","008","0820","0000","1195","913","282","77","1272","1977","0","64.34","46.18"
"64","000","00","008","0820","1166","664","521","143","30","694","1138","0","60.98","45.78"
"64","000","00","008","0820","1167","531","392","139","47","578","839","0","68.89","46.72"
"64","000","00","008","0821","0000","661","506","155","52","713","2088","0","34.15","24.23"
"64","000","00","008","0821","1168","661","506","155","52","713","2088","0","34.15","24.23"
"64","000","00","008","0822","0000","1804","1393","411","116","1920","3271","0","58.7","42.59"
"64","000","00","008","0822","1169","926","710","216","43","969","1648","0","58.8","43.08"
"64","000","00","008","0822","1170","878","683","195","73","951","1623","0","58.6","42.08"
"64","000","00","008","0823","0000","1172","894","278","62","1234","1932","0","63.87","46.27"
"64","000","00","008","0823","1171","1172","894","278","62","1234","1932","0","63.87","46.27"
"64","000","00","008","0824","0000","1472","1152","320","54","1526","2283","0","66.84","50.46"
"64","000","00","008","0824","1172","738","576","162","28","766","1127","0","67.97","51.11"
"64","000","00","008","0824","1173","734","576","158","26","760","1156","0","65.74","49.83"
"64","000","00","008","0825","0000","866","648","218","39","905","1465","0","61.77","44.23"
"64","000","00","008","0825","1174","866","648","218","39","905","1465","0","61.77","44.23"
"64","000","00","008","0826","0000","338","255","83","25","363","690","0","52.61","36.96"
"64","000","00","008","0826","1175","338","255","83","25","363","690","0","52.61","36.96"
"64","000","00","008","0827","0000","643","478","165","96","739","1283","0","57.6","37.26"
"64","000","00","008","0827","1176","643","478","165","96","739","1283","0","57.6","37.26"
"64","000","00","008","0828","0000","1521","1095","426","114","1635","2745","0","59.56","39.89"
"64","000","00","008","0828","1177","783","582","201","78","861","1432","0","60.13","40.64"
"64","000","00","008","0828","1178","738","513","225","36","774","1313","0","58.95","39.07"
"64","000","00","008","0829","0000","811","598","213","34","845","1579","0","53.51","37.87"
"64","000","00","008","0829","1179","811","598","213","34","845","1579","0","53.51","37.87"
"64","000","00","008","0830","0000","1613","1232","381","131","1744","2834","0","61.54","43.47"
"64","000","00","008","0830","1180","774","572","202","69","843","1385","0","60.87","41.3"
"64","000","00","008","0830","1181","839","660","179","62","901","1449","0","62.18","45.55"
"64","000","00","008","0831","0000","1094","836","258","53","1147","1834","0","62.54","45.58"
"64","000","00","008","0831","1182","1094","836","258","53","1147","1834","0","62.54","45.58"
"64","000","00","008","0832","0000","1692","1261","431","116","1808","2867","0","63.06","43.98"
"64","000","00","008","0832","1183","827","612","215","65","892","1436","0","62.12","42.62"
"64","000","00","008","0832","1184","865","649","216","51","916","1431","0","64.01","45.35"
"64","000","00","008","0833","0000","1660","1266","394","64","1724","2718","0","63.43","46.58"
"64","000","00","008","0833","1185","769","582","187","22","791","1248","0","63.38","46.63"
"64","000","00","008","0833","1186","891","684","207","42","933","1470","0","63.47","46.53"
"64","000","00","008","0834","0000","940","748","192","79","1019","1540","0","66.17","48.57"
"64","000","00","008","0834","1187","940","748","192","79","1019","1540","0","66.17","48.57"
"64","000","00","008","0835","0000","1352","1042","310","59","1411","2213","0","63.76","47.09"
"64","000","00","008","0835","1188","830","645","185","28","858","1374","0","62.45","46.94"
"64","000","00","008","0835","1189","522","397","125","31","553","839","0","65.91","47.32"
"64","000","00","008","0836","0000","1298","1017","281","62","1360","2084","0","65.26","48.8"
"64","000","00","008","0836","1190","654","511","143","37","691","1022","0","67.61","50.0"
"64","000","00","008","0836","1191","644","506","138","25","669","1062","0","62.99","47.65"
"64","000","00","008","0837","0000","1304","971","333","55","1359","2195","0","61.91","44.24"
"64","000","00","008","0837","1192","628","474","154","22","650","1078","0","60.3","43.97"
"64","000","00","008","0837","1193","676","497","179","33","709","1117","0","63.47","44.49"
"64","000","00","008","0838","0000","876","687","189","60","936","1516","0","61.74","45.32"
"64","000","00","008","0838","1194","876","687","189","60","936","1516","0","61.74","45.32"
"64","000","00","008","0839","0000","779","542","237","122","901","1440","0","62.57","37.64"
"64","000","00","008","0839","1195","779","542","237","122","901","1440","0","62.57","37.64"
"64","000","00","008","0840","0000","929","721","208","72","1001","1727","0","57.96","41.75"
"64","000","00","008","0840","1196","471","353","118","40","511","839","0","60.91","42.07"
"64","000","00","008","0840","1197","458","368","90","32","490","888","0","55.18","41.44"
"64","000","00","008","0841","0000","1300","980","320","105","1405","2105","0","66.75","46.56"
"64","000","00","008","0841","1198","651","491","160","42","693","1101","0","62.94","44.6"
"64","000","00","008","0841","1199","649","489","160","63","712","1004","0","70.92","48.71"
"64","000","00","008","0842","0000","2194","1652","542","161","2355","3779","0","62.32","43.72"
"64","000","00","008","0842","1200","801","605","196","68","869","1427","0","60.9","42.4"
"64","000","00","008","0842","1201","657","508","149","32","689","1168","0","58.99","43.49"
"64","000","00","008","0842","1202","736","539","197","61","797","1184","0","67.31","45.52"
"64","000","00","008","0843","0000","1010","765","245","49","1059","1823","0","58.09","41.96"
"64","000","00","008","0843","1203","584","440","144","35","619","974","0","63.55","45.17"
"64","000","00","008","0843","1204","426","325","101","14","440","849","0","51.83","38.28"
"64","000","00","008","0844","0000","1044","833","211","48","1092","1821","0","59.97","45.74"
"64","000","00","008","0844","1205","1044","833","211","48","1092","1821","0","59.97","45.74"
"64","000","00","008","0845","0000","2159","1681","478","145","2304","3906","0","58.99","43.04"
"64","000","00","008","0845","1206","778","576","202","57","835","1306","0","63.94","44.1"
"64","000","00","008","0845","1207","597","523","74","29","626","1185","0","52.83","44.14"
"64","000","00","008","0845","1208","784","582","202","59","843","1415","0","59.58","41.13"
"64","000","00","008","0846","0000","1120","850","270","104","1224","1926","0","63.55","44.13"
"64","000","00","008","0846","1209","586","450","136","46","632","962","0","65.7","46.78"
"64","000","00","008","0846","1210","534","400","134","58","592","964","0","61.41","41.49"
"64","000","00","008","0847","0000","859","673","186","47","906","1524","0","59.45","44.16"
"64","000","00","008","0847","1211","859","673","186","47","906","1524","0","59.45","44.16"
"64","000","00","008","0848","0000","827","631","196","39","866","1455","0","59.52","43.37"
"64","000","00","008","0848","1212","827","631","196","39","866","1455","0","59.52","43.37"
"64","000","00","008","0849","0000","1271","947","324","77","1348","2528","0","53.32","37.46"
"64","000","00","008","0849","1213","626","463","163","42","668","1272","0","52.52","36.4"
"64","000","00","008","0849","1214","645","484","161","35","680","1256","0","54.14","38.54"
"64","000","00","008","0850","0000","642","504","138","34","676","1203","0","56.19","41.9"
"64","000","00","008","0850","1215","642","504","138","34","676","1203","0","56.19","41.9"
"64","000","00","008","0851","0000","612","487","125","32","644","1062","0","60.64","45.86"
"64","000","00","008","0851","1216","612","487","125","32","644","1062","0","60.64","45.86"
"64","000","00","008","0852","0000","1092","821","271","158","1250","1860","0","67.2","44.14"
"64","000","00","008","0852","1217","502","379","123","66","568","850","0","66.82","44.59"
"64","000","00","008","0852","1218","590","442","148","92","682","1010","0","67.52","43.76"
"64","000","00","008","0853","0000","1149","872","277","87","1236","2055","0","60.15","42.43"
"64","000","00","008","0853","1219","603","461","142","30","633","1118","0","56.62","41.23"
"64","000","00","008","0853","1220","546","411","135","57","603","937","0","64.35","43.86"
"64","000","00","008","0854","0000","1386","1076","310","73","1459","2676","0","54.52","40.21"
"64","000","00","008","0854","1221","704","542","162","36","740","1493","0","49.56","36.3"
"64","000","00","008","0854","1222","682","534","148","37","719","1183","0","60.78","45.14"
"64","000","00","008","0855","0000","1359","1046","313","99","1458","2680","0","54.4","39.03"
"64","000","00","008","0855","1223","618","489","129","45","663","1318","0","50.3","37.1"
"64","000","00","008","0855","1224","741","557","184","54","795","1362","0","58.37","40.9"
"64","000","00","008","0856","0000","1406","1151","255","139","1545","2583","0","59.81","44.56"
"64","000","00","008","0856","1225","595","418","177","76","671","1102","0","60.89","37.93"
"64","000","00","008","0856","1226","811","733","78","63","874","1481","0","59.01","49.49"
"64","000","00","008","0857","0000","940","712","228","108","1048","1786","0","58.68","39.87"
"64","000","00","008","0857","1227","513","394","119","66","579","878","0","65.95","44.87"
"64","000","00","008","0857","1228","427","318","109","42","469","908","0","51.65","35.02"
"64","000","00","008","0858","0000","1189","927","262","95","1284","2147","0","59.8","43.18"
"64","000","00","008","0858","1229","639","507","132","53","692","1056","0","65.53","48.01"
"64","000","00","008","0858","1230","550","420","130","42","592","1091","0","54.26","38.5"
"64","000","00","008","0859","0000","1235","889","346","82","1317","2039","0","64.59","43.6"
"64","000","00","008","0859","1231","582","419","163","32","614","976","0","62.91","42.93"
"64","000","00","008","0859","1232","653","470","183","50","703","1063","0","66.13","44.21"
"64","000","00","008","0860","0000","1606","1187","419","110","1716","2774","0","61.86","42.79"
"64","000","00","008","0860","1233","864","672","192","73","937","1484","0","63.14","45.28"
"64","000","00","008","0860","1234","742","515","227","37","779","1290","0","60.39","39.92"
"64","000","00","008","0861","0000","2771","2134","637","160","2931","4982","0","58.83","42.83"
"64","000","00","008","0861","1235","994","778","216","70","1064","1740","0","61.15","44.71"
"64","000","00","008","0861","1236","885","670","215","59","944","1594","0","59.22","42.03"
"64","000","00","008","0861","1237","892","686","206","31","923","1648","0","56.01","41.63"
"64","000","00","008","0862","0000","2137","1638","499","145","2282","3730","0","61.18","43.91"
"64","000","00","008","0862","1238","740","576","164","61","801","1236","0","64.81","46.6"
"64","000","00","008","0862","1239","689","511","178","54","743","1211","0","61.35","42.2"
"64","000","00","008","0862","1240","708","551","157","30","738","1283","0","57.52","42.95"
"64","000","00","008","0863","0000","2027","1532","495","168","2195","3522","0","62.32","43.5"
"64","000","00","008","0863","1241","1042","795","247","89","1131","1804","0","62.69","44.07"
"64","000","00","008","0863","1242","985","737","248","79","1064","1718","0","61.93","42.9"
"64","000","00","008","0864","0000","2292","1748","544","207","2499","4053","0","61.66","43.13"
"64","000","00","008","0864","1243","748","577","171","65","813","1297","0","62.68","44.49"
"64","000","00","008","0864","1244","804","596","208","87","891","1449","0","61.49","41.13"
"64","000","00","008","0864","1245","740","575","165","55","795","1307","0","60.83","43.99"
"64","000","00","008","0865","0000","1458","1097","361","134","1592","2434","0","65.41","45.07"
"64","000","00","008","0865","1246","694","528","166","58","752","1184","0","63.51","44.59"
"64","000","00","008","0865","1247","764","569","195","76","840","1250","0","67.2","45.52"
"64","000","00","008","0866","0000","1400","1102","298","69","1469","2531","0","58.04","43.54"
"64","000","00","008","0866","1248","675","526","149","36","711","1248","0","56.97","42.15"
"64","000","00","008","0866","1249","725","576","149","33","758","1283","0","59.08","44.89"
"64","000","00","008","0867","0000","2064","1609","455","106","2170","3718","0","58.36","43.28"
"64","000","00","008","0867","1250","630","507","123","34","664","1121","0","59.23","45.23"
"64","000","00","008","0867","1251","703","541","162","33","736","1258","0","58.51","43.0"
"64","000","00","008","0867","1252","731","561","170","39","770","1339","0","57.51","41.9"
"64","000","00","008","0868","0000","1029","758","271","80","1109","1986","0","55.84","38.17"
"64","000","00","008","0868","1253","1029","758","271","80","1109","1986","0","55.84","38.17"
"64","000","00","008","0869","0000","1112","869","243","56","1168","1976","0","59.11","43.98"
"64","000","00","008","0869","1254","565","447","118","34","599","1028","0","58.27","43.48"
"64","000","00","008","0869","1255","547","422","125","22","569","948","0","60.02","44.51"
"64","000","00","009","0000","0000","85525","65326","20199","7215","92740","161797","188516","57.32","40.38"
"64","000","00","009","0901","0000","4290","3220","1070","461","4751","9323","0","50.96","34.54"
"64","000","00","009","0901","1484","862","630","232","140","1002","1809","0","55.39","34.83"
"64","000","00","009","0901","1485","896","667","229","95","991","1835","0","54.01","36.35"
"64","000","00","009","0901","1486","755","580","175","81","836","1890","0","44.23","30.69"
"64","000","00","009","0901","1487","907","672","235","70","977","2013","0","48.53","33.38"
"64","000","00","009","0901","1488","870","671","199","75","945","1776","0","53.21","37.78"
"64","000","00","009","0902","0000","1094","831","263","166","1260","2377","0","53.01","34.96"
"64","000","00","009","0902","1489","741","559","182","97","838","1705","0","49.15","32.79"
"64","000","00","009","0902","1490","353","272","81","69","422","672","0","62.8","40.48"
"64","000","00","009","0903","0000","2495","1866","629","243","2738","5013","0","54.62","37.22"
"64","000","00","009","0903","1491","745","553","192","104","849","1726","0","49.19","32.04"
"64","000","00","009","0903","1492","838","651","187","48","886","1597","0","55.48","40.76"
"64","000","00","009","0903","1493","912","662","250","91","1003","1690","0","59.35","39.17"
"64","000","00","009","0904","0000","1310","987","323","150","1460","2239","0","65.21","44.08"
"64","000","00","009","0904","1494","617","475","142","78","695","1080","0","64.35","43.98"
"64","000","00","009","0904","1495","693","512","181","72","765","1159","0","66.01","44.18"
"64","000","00","009","0905","0000","636","478","158","77","713","1314","0","54.26","36.38"
"64","000","00","009","0905","1496","636","478","158","77","713","1314","0","54.26","36.38"
"64","000","00","009","0906","0000","1045","804","241","104","1149","1898","0","60.54","42.36"
"64","000","00","009","0906","1497","491","387","104","65","556","896","0","62.05","43.19"
"64","000","00","009","0906","1498","554","417","137","39","593","1002","0","59.18","41.62"
"64","000","00","009","0907","0000","956","714","242","110","1066","2765","0","38.55","25.82"
"64","000","00","009","0907","1499","956","714","242","110","1066","2765","0","38.55","25.82"
"64","000","00","009","0908","0000","312","230","82","65","377","600","0","62.83","38.33"
"64","000","00","009","0908","1500","312","230","82","65","377","600","0","62.83","38.33"
"64","000","00","009","0909","0000","475","344","131","42","517","1466","0","35.27","23.47"
"64","000","00","009","0909","1501","475","344","131","42","517","1466","0","35.27","23.47"
"64","000","00","009","0910","0000","704","544","160","57","761","1449","0","52.52","37.54"
"64","000","00","009","0910","1502","704","544","160","57","761","1449","0","52.52","37.54"
"64","000","00","009","0911","0000","1155","888","267","149","1304","2239","0","58.24","39.66"
"64","000","00","009","0911","1503","490","374","116","58","548","991","0","55.3","37.74"
"64","000","00","009","0911","1504","665","514","151","91","756","1248","0","60.58","41.19"
"64","000","00","009","0912","0000","585","443","142","92","677","1066","0","63.51","41.56"
"64","000","00","009","0912","1505","585","443","142","92","677","1066","0","63.51","41.56"
"64","000","00","009","0913","0000","288","215","73","43","331","706","0","46.88","30.45"
"64","000","00","009","0913","1506","288","215","73","43","331","706","0","46.88","30.45"
"64","000","00","009","0914","0000","334","241","93","39","373","713","0","52.31","33.8"
"64","000","00","009","0914","1507","334","241","93","39","373","713","0","52.31","33.8"
"64","000","00","009","0915","0000","629","468","161","50","679","1344","0","50.52","34.82"
"64","000","00","009","0915","1508","629","468","161","50","679","1344","0","50.52","34.82"
"64","000","00","009","0916","0000","864","630","234","98","962","1729","0","55.64","36.44"
"64","000","00","009","0916","1509","464","348","116","54","518","856","0","60.51","40.65"
"64","000","00","009","0916","1510","400","282","118","44","444","873","0","50.86","32.3"
"64","000","00","009","0917","0000","1000","736","264","74","1074","2226","0","48.25","33.06"
"64","000","00","009","0917","1511","512","380","132","55","567","1114","0","50.9","34.11"
"64","000","00","009","0917","1512","488","356","132","19","507","1112","0","45.59","32.01"
"64","000","00","009","0918","0000","985","742","243","118","1103","1984","0","55.59","37.4"
"64","000","00","009","0918","1513","525","402","123","64","589","1044","0","56.42","38.51"
"64","000","00","009","0918","1514","460","340","120","54","514","940","0","54.68","36.17"
"64","000","00","009","0919","0000","2273","1743","530","167","2440","4064","0","60.04","42.89"
"64","000","00","009","0919","1515","632","485","147","73","705","1342","0","52.53","36.14"
"64","000","00","009","0919","1516","864","654","210","55","919","1402","0","65.55","46.65"
"64","000","00","009","0919","1517","777","604","173","39","816","1320","0","61.82","45.76"
"64","000","00","009","0920","0000","511","376","135","61","572","958","0","59.71","39.25"
"64","000","00","009","0920","1518","511","376","135","61","572","958","0","59.71","39.25"
"64","000","00","009","0921","0000","1650","1317","333","129","1779","2735","0","65.05","48.15"
"64","000","00","009","0921","1519","825","652","173","44","869","1276","0","68.1","51.1"
"64","000","00","009","0921","1520","825","665","160","85","910","1459","0","62.37","45.58"
"64","000","00","009","0922","0000","339","229","110","21","360","761","0","47.31","30.09"
"64","000","00","009","0922","1521","339","229","110","21","360","761","0","47.31","30.09"
"64","000","00","009","0923","0000","530","383","147","27","557","1093","0","50.96","35.04"
"64","000","00","009","0923","1522","530","383","147","27","557","1093","0","50.96","35.04"
"64","000","00","009","0924","0000","2706","2252","454","128","2834","4899","0","57.85","45.97"
"64","000","00","009","0924","1523","915","782","133","46","961","1521","0","63.18","51.41"
"64","000","00","009","0924","1524","913","759","154","47","960","1557","0","61.66","48.75"
"64","000","00","009","0924","1525","878","711","167","35","913","1821","0","50.14","39.04"
"64","000","00","009","0925","0000","1354","1159","195","64","1418","2112","0","67.14","54.88"
"64","000","00","009","0925","1526","693","587","106","44","737","1066","0","69.14","55.07"
"64","000","00","009","0925","1527","661","572","89","20","681","1046","0","65.11","54.68"
"64","000","00","009","0928","0000","1898","1414","484","158","2056","3432","0","59.91","41.2"
"64","000","00","009","0928","1528","924","671","253","68","992","1709","0","58.05","39.26"
"64","000","00","009","0928","1529","974","743","231","90","1064","1723","0","61.75","43.12"
"64","000","00","009","0929","0000","2457","1886","571","140","2597","3994","0","65.02","47.22"
"64","000","00","009","0929","1530","734","567","167","54","788","1202","0","65.56","47.17"
"64","000","00","009","0929","1531","798","590","208","38","836","1279","0","65.36","46.13"
"64","000","00","009","0929","1532","925","729","196","48","973","1513","0","64.31","48.18"
"64","000","00","009","0930","0000","687","516","171","23","710","1260","0","56.35","40.95"
"64","000","00","009","0930","1533","687","516","171","23","710","1260","0","56.35","40.95"
"64","000","00","009","0931","0000","1376","1041","335","133","1509","2279","0","66.21","45.68"
"64","000","00","009","0931","1534","661","488","173","88","749","1139","0","65.76","42.84"
"64","000","00","009","0931","1535","715","553","162","45","760","1140","0","66.67","48.51"
"64","000","00","009","0932","0000","1616","1171","445","137","1753","2821","0","62.14","41.51"
"64","000","00","009","0932","1536","816","561","255","92","908","1462","0","62.11","38.37"
"64","000","00","009","0932","1537","800","610","190","45","845","1359","0","62.18","44.89"
"64","000","00","009","0933","0000","971","703","268","91","1062","2037","0","52.14","34.51"
"64","000","00","009","0933","1538","971","703","268","91","1062","2037","0","52.14","34.51"
"64","000","00","009","0934","0000","1449","1106","343","51","1500","2717","0","55.21","40.71"
"64","000","00","009","0934","1539","743","586","157","27","770","1410","0","54.61","41.56"
"64","000","00","009","0934","1540","706","520","186","24","730","1307","0","55.85","39.79"
"64","000","00","009","0935","0000","1625","1196","429","177","1802","3003","0","60.01","39.83"
"64","000","00","009","0935","1541","794","580","214","92","886","1512","0","58.6","38.36"
"64","000","00","009","0935","1542","831","616","215","85","916","1491","0","61.44","41.31"
"64","000","00","009","0936","0000","1592","1216","376","167","1759","3143","0","55.97","38.69"
"64","000","00","009","0936","1543","860","656","204","90","950","1621","0","58.61","40.47"
"64","000","00","009","0936","1544","732","560","172","77","809","1522","0","53.15","36.79"
"64","000","00","009","0937","0000","3017","2283","734","246","3263","5348","0","61.01","42.69"
"64","000","00","009","0937","1545","889","658","231","60","949","1593","0","59.57","41.31"
"64","000","00","009","0937","1546","1060","807","253","89","1149","1885","0","60.95","42.81"
"64","000","00","009","0937","1547","1068","818","250","97","1165","1870","0","62.3","43.74"
"64","000","00","009","0938","0000","1524","1159","365","95","1619","2736","0","59.17","42.36"
"64","000","00","009","0938","1548","781","596","185","26","807","1388","0","58.14","42.94"
"64","000","00","009","0938","1549","743","563","180","69","812","1348","0","60.24","41.77"
"64","000","00","009","0939","0000","1480","1153","327","160","1640","2705","0","60.63","42.62"
"64","000","00","009","0939","1550","667","519","148","106","773","1341","0","57.64","38.7"
"64","000","00","009","0939","1551","813","634","179","54","867","1364","0","63.56","46.48"
"64","000","00","009","0940","0000","1444","1068","376","158","1602","2693","0","59.49","39.66"
"64","000","00","009","0940","1552","752","552","200","76","828","1367","0","60.57","40.38"
"64","000","00","009","0940","1553","692","516","176","82","774","1326","0","58.37","38.91"
"64","000","00","009","0941","0000","1219","954","265","64","1283","2178","0","58.91","43.8"
"64","000","00","009","0941","1554","570","434","136","44","614","1059","0","57.98","40.98"
"64","000","00","009","0941","1555","649","520","129","20","669","1119","0","59.79","46.47"
"64","000","00","009","0942","0000","3705","2880","825","194","3899","6642","0","58.7","43.36"
"64","000","00","009","0942","1556","786","612","174","47","833","1565","0","53.23","39.11"
"64","000","00","009","0942","1557","835","637","198","68","903","1549","0","58.3","41.12"
"64","000","00","009","0942","1558","1021","800","221","41","1062","1691","0","62.8","47.31"
"64","000","00","009","0942","1559","1063","831","232","38","1101","1837","0","59.93","45.24"
"64","000","00","009","0943","0000","1282","958","324","91","1373","2218","0","61.9","43.19"
"64","000","00","009","0943","1560","637","480","157","28","665","1092","0","60.9","43.96"
"64","000","00","009","0943","1561","645","478","167","63","708","1126","0","62.88","42.45"
"64","000","00","009","0944","0000","2358","1841","517","150","2508","4106","0","61.08","44.84"
"64","000","00","009","0944","1562","617","472","145","89","706","1215","0","58.11","38.85"
"64","000","00","009","0944","1563","818","660","158","37","855","1443","0","59.25","45.74"
"64","000","00","009","0944","1564","923","709","214","24","947","1448","0","65.4","48.96"
"64","000","00","009","0945","0000","1737","1302","435","170","1907","3251","0","58.66","40.05"
"64","000","00","009","0945","1565","929","709","220","85","1014","1648","0","61.53","43.02"
"64","000","00","009","0945","1566","808","593","215","85","893","1603","0","55.71","36.99"
"64","000","00","009","0946","0000","745","580","165","33","778","1596","0","48.75","36.34"
"64","000","00","009","0946","1567","745","580","165","33","778","1596","0","48.75","36.34"
"64","000","00","009","0947","0000","2360","1829","531","225","2585","4607","0","56.11","39.7"
"64","000","00","009","0947","1568","673","521","152","37","710","1450","0","48.97","35.93"
"64","000","00","009","0947","1569","752","597","155","88","840","1510","0","55.63","39.54"
"64","000","00","009","0947","1570","935","711","224","100","1035","1647","0","62.84","43.17"
"64","000","00","009","0948","0000","1390","1081","309","125","1515","2726","0","55.58","39.66"
"64","000","00","009","0948","1571","705","557","148","69","774","1342","0","57.68","41.51"
"64","000","00","009","0948","1572","685","524","161","56","741","1384","0","53.54","37.86"
"64","000","00","009","0949","0000","2463","1865","598","183","2646","4620","0","57.27","40.37"
"64","000","00","009","0949","1573","741","563","178","75","816","1479","0","55.17","38.07"
"64","000","00","009","0949","1574","831","667","164","44","875","1546","0","56.6","43.14"
"64","000","00","009","0949","1575","891","635","256","64","955","1595","0","59.87","39.81"
"64","000","00","009","0950","0000","1218","945","273","96","1314","2283","0","57.56","41.39"
"64","000","00","009","0950","1576","671","533","138","70","741","1201","0","61.7","44.38"
"64","000","00","009","0950","1577","547","412","135","26","573","1082","0","52.96","38.08"
"64","000","00","009","0951","0000","980","755","225","132","1112","1928","0","57.68","39.16"
"64","000","00","009","0951","1578","490","379","111","46","536","996","0","53.82","38.05"
"64","000","00","009","0951","1579","490","376","114","86","576","932","0","61.8","40.34"
"64","000","00","009","0952","0000","2055","1591","464","108","2163","3574","0","60.52","44.52"
"64","000","00","009","0952","1580","635","451","184","52","687","1146","0","59.95","39.35"
"64","000","00","009","0952","1581","620","497","123","37","657","1096","0","59.95","45.35"
"64","000","00","009","0952","1582","800","643","157","19","819","1332","0","61.49","48.27"
"64","000","00","009","0953","0000","1916","1476","440","181","2097","3477","0","60.31","42.45"
"64","000","00","009","0953","1583","632","503","129","41","673","1175","0","57.28","42.81"
"64","000","00","009","0953","1584","532","407","125","67","599","986","0","60.75","41.28"
"64","000","00","009","0953","1585","752","566","186","73","825","1316","0","62.69","43.01"
"64","000","00","009","0954","0000","1640","1278","362","155","1795","3181","0","56.43","40.18"
"64","000","00","009","0954","1586","737","574","163","71","808","1559","0","51.83","36.82"
"64","000","00","009","0954","1587","903","704","199","84","987","1622","0","60.85","43.4"
"64","000","00","009","0955","0000","1378","1021","357","138","1516","2609","0","58.11","39.13"
"64","000","00","009","0955","1588","684","509","175","37","721","1310","0","55.04","38.85"
"64","000","00","009","0955","1589","694","512","182","101","795","1299","0","61.2","39.41"
"64","000","00","009","0956","0000","1409","1131","278","102","1511","2566","0","58.89","44.08"
"64","000","00","009","0956","1590","723","567","156","70","793","1191","0","66.58","47.61"
"64","000","00","009","0956","1591","686","564","122","32","718","1375","0","52.22","41.02"
"64","000","00","009","0957","0000","1330","1000","330","63","1393","2513","0","55.43","39.79"
"64","000","00","009","0957","1592","735","565","170","25","760","1338","0","56.8","42.23"
"64","000","00","009","0957","1593","595","435","160","38","633","1175","0","53.87","37.02"
"64","000","00","009","0958","0000","1415","1080","335","97","1512","2544","0","59.43","42.45"
"64","000","00","009","0958","1594","704","546","158","35","739","1357","0","54.46","40.24"
"64","000","00","009","0958","1595","711","534","177","62","773","1187","0","65.12","44.99"
"64","000","00","009","0959","0000","1318","1001","317","111","1429","2383","0","59.97","42.01"
"64","000","00","009","0959","1596","613","460","153","50","663","1164","0","56.96","39.52"
"64","000","00","009","0959","1597","705","541","164","61","766","1219","0","62.84","44.38"
"64","000","00","009","0960","0000","2359","1770","589","166","2525","4454","0","56.69","39.74"
"64","000","00","009","0960","1598","739","552","187","25","764","1428","0","53.5","38.66"
"64","000","00","009","0960","1599","777","575","202","104","881","1495","0","58.93","38.46"
"64","000","00","009","0960","1600","843","643","200","37","880","1531","0","57.48","42.0"
"64","000","00","009","0961","0000","1592","1236","356","160","1752","3100","0","56.52","39.87"
"64","000","00","009","0961","1601","771","613","158","83","854","1509","0","56.59","40.62"
"64","000","00","009","0961","1602","821","623","198","77","898","1591","0","56.44","39.16"
"64","000","00","010","0000","0000","11042","8132","2910","1324","12366","24860","28533","49.74","32.71"
"64","000","00","010","1001","0000","624","437","187","122","746","1177","0","63.38","37.13"
"64","000","00","010","1001","0869","624","437","187","122","746","1177","0","63.38","37.13"
"64","000","00","010","1002","0000","500","367","133","58","558","1109","0","50.32","33.09"
"64","000","00","010","1002","0870","500","367","133","58","558","1109","0","50.32","33.09"
"64","000","00","010","1003","0000","676","485","191","31","707","1642","0","43.06","29.54"
"64","000","00","010","1003","0871","676","485","191","31","707","1642","0","43.06","29.54"
"64","000","00","010","1004","0000","1013","791","222","168","1181","2321","0","50.88","34.08"
"64","000","00","010","1004","0872","548","429","119","111","659","1209","0","54.51","35.48"
"64","000","00","010","1004","0873","465","362","103","57","522","1112","0","46.94","32.55"
"64","000","00","010","1005","0000","1343","1018","325","128","1471","2943","0","49.98","34.59"
"64","000","00","010","1005","0874","753","553","200","94","847","1483","0","57.11","37.29"
"64","000","00","010","1005","0875","590","465","125","34","624","1460","0","42.74","31.85"
"64","000","00","010","1006","0000","825","588","237","172","997","1572","0","63.42","37.4"
"64","000","00","010","1006","0876","825","588","237","172","997","1572","0","63.42","37.4"
"64","000","00","010","1007","0000","586","490","96","32","618","1384","0","44.65","35.4"
"64","000","00","010","1007","0877","586","490","96","32","618","1384","0","44.65","35.4"
"64","000","00","010","1008","0000","1122","834","288","111","1233","2629","0","46.9","31.72"
"64","000","00","010","1008","0878","591","436","155","44","635","1390","0","45.68","31.37"
"64","000","00","010","1008","0879","531","398","133","67","598","1239","0","48.26","32.12"
"64","000","00","010","1009","0000","901","617","284","139","1040","2045","0","50.86","30.17"
"64","000","00","010","1009","0880","901","617","284","139","1040","2045","0","50.86","30.17"
"64","000","00","010","1010","0000","1231","886","345","159","1390","2759","0","50.38","32.11"
"64","000","00","010","1010","0881","399","292","107","23","422","893","0","47.26","32.7"
"64","000","00","010","1010","0882","832","594","238","136","968","1866","0","51.88","31.83"
"64","000","00","010","1011","0000","686","516","170","45","731","1874","0","39.01","27.53"
"64","000","00","010","1011","0883","686","516","170","45","731","1874","0","39.01","27.53"
"64","000","00","010","1012","0000","390","277","113","68","458","893","0","51.29","31.02"
"64","000","00","010","1012","0884","390","277","113","68","458","893","0","51.29","31.02"
"64","000","00","010","1013","0000","1145","826","319","91","1236","2512","0","49.2","32.88"
"64","000","00","010","1013","0885","588","402","186","44","632","1215","0","52.02","33.09"
"64","000","00","010","1013","0886","557","424","133","47","604","1297","0","46.57","32.69"
"64","000","00","011","0000","0000","70977","55215","15762","5177","76154","132733","157685","57.37","41.6"
"64","000","00","011","1101","0000","1313","1017","296","111","1424","2279","0","62.48","44.62"
"64","000","00","011","1101","1603","649","508","141","45","694","1108","0","62.64","45.85"
"64","000","00","011","1101","1604","664","509","155","66","730","1171","0","62.34","43.47"
"64","000","00","011","1102","0000","1781","1368","413","44","1825","3225","0","56.59","42.42"
"64","000","00","011","1102","1605","937","701","236","23","960","1557","0","61.66","45.02"
"64","000","00","011","1102","1606","844","667","177","21","865","1668","0","51.86","39.99"
"64","000","00","011","1103","0000","1442","1160","282","61","1503","2555","0","58.83","45.4"
"64","000","00","011","1103","1607","689","553","136","30","719","1183","0","60.78","46.75"
"64","000","00","011","1103","1608","753","607","146","31","784","1372","0","57.14","44.24"
"64","000","00","011","1104","0000","971","765","206","72","1043","1737","0","60.05","44.04"
"64","000","00","011","1104","1609","971","765","206","72","1043","1737","0","60.05","44.04"
"64","000","00","011","1105","0000","1591","1211","380","178","1769","3144","0","56.27","38.52"
"64","000","00","011","1105","1610","832","616","216","104","936","1586","0","59.02","38.84"
"64","000","00","011","1105","1611","759","595","164","74","833","1558","0","53.47","38.19"
"64","000","00","011","1106","0000","1484","1115","369","136","1620","2533","0","63.96","44.02"
"64","000","00","011","1106","1612","775","563","212","76","851","1284","0","66.28","43.85"
"64","000","00","011","1106","1613","709","552","157","60","769","1249","0","61.57","44.2"
"64","000","00","011","1107","0000","1015","800","215","109","1124","2400","0","46.83","33.33"
"64","000","00","011","1107","1614","1015","800","215","109","1124","2400","0","46.83","33.33"
"64","000","00","011","1108","0000","1237","948","289","77","1314","2260","0","58.14","41.95"
"64","000","00","011","1108","1615","668","500","168","41","709","1181","0","60.03","42.34"
"64","000","00","011","1108","1616","569","448","121","36","605","1079","0","56.07","41.52"
"64","000","00","011","1109","0000","1436","1135","301","113","1549","2576","0","60.13","44.06"
"64","000","00","011","1109","1617","735","567","168","48","783","1335","0","58.65","42.47"
"64","000","00","011","1109","1618","701","568","133","65","766","1241","0","61.72","45.77"
"64","000","00","011","1110","0000","3141","2443","698","227","3368","5796","0","58.11","42.15"
"64","000","00","011","1110","1619","802","630","172","71","873","1513","0","57.7","41.64"
"64","000","00","011","1110","1620","764","594","170","71","835","1349","0","61.9","44.03"
"64","000","00","011","1110","1621","774","585","189","54","828","1483","0","55.83","39.45"
"64","000","00","011","1110","1622","801","634","167","31","832","1451","0","57.34","43.69"
"64","000","00","011","1111","0000","1400","1086","314","102","1502","2503","0","60.01","43.39"
"64","000","00","011","1111","1623","626","505","121","31","657","1241","0","52.94","40.69"
"64","000","00","011","1111","1624","774","581","193","71","845","1262","0","66.96","46.04"
"64","000","00","011","1112","0000","1876","1503","373","136","2012","3690","0","54.53","40.73"
"64","000","00","011","1112","1625","1005","797","208","93","1098","1813","0","60.56","43.96"
"64","000","00","011","1112","1626","871","706","165","43","914","1877","0","48.69","37.61"
"64","000","00","011","1113","0000","1583","1215","368","52","1635","2844","0","57.49","42.72"
"64","000","00","011","1113","1627","755","585","170","21","776","1391","0","55.79","42.06"
"64","000","00","011","1113","1628","828","630","198","31","859","1453","0","59.12","43.36"
"64","000","00","011","1114","0000","2257","1738","519","180","2437","4056","0","60.08","42.85"
"64","000","00","011","1114","1629","762","571","191","49","811","1374","0","59.02","41.56"
"64","000","00","011","1114","1630","728","561","167","61","789","1348","0","58.53","41.62"
"64","000","00","011","1114","1631","767","606","161","70","837","1334","0","62.74","45.43"
"64","000","00","011","1115","0000","2361","1794","567","114","2475","4369","0","56.65","41.06"
"64","000","00","011","1115","1632","763","569","194","32","795","1433","0","55.48","39.71"
"64","000","00","011","1115","1633","711","541","170","18","729","1448","0","50.35","37.36"
"64","000","00","011","1115","1634","887","684","203","64","951","1488","0","63.91","45.97"
"64","000","00","011","1116","0000","1568","1242","326","107","1675","2584","0","64.82","48.07"
"64","000","00","011","1116","1635","720","574","146","61","781","1278","0","61.11","44.91"
"64","000","00","011","1116","1636","848","668","180","46","894","1306","0","68.45","51.15"
"64","000","00","011","1117","0000","1749","1404","345","177","1926","3265","0","58.99","43.0"
"64","000","00","011","1117","1637","792","680","112","89","881","1625","0","54.22","41.85"
"64","000","00","011","1117","1638","957","724","233","88","1045","1640","0","63.72","44.15"
"64","000","00","011","1118","0000","1548","1233","315","122","1670","2944","0","56.73","41.88"
"64","000","00","011","1118","1639","819","651","168","53","872","1506","0","57.9","43.23"
"64","000","00","011","1118","1640","729","582","147","69","798","1438","0","55.49","40.47"
"64","000","00","011","1119","0000","1327","1071","256","57","1384","2272","0","60.92","47.14"
"64","000","00","011","1119","1641","699","554","145","40","739","1105","0","66.88","50.14"
"64","000","00","011","1119","1642","628","517","111","17","645","1167","0","55.27","44.3"
"64","000","00","011","1120","0000","2336","1885","451","132","2468","4039","0","61.1","46.67"
"64","000","00","011","1120","1643","819","662","157","33","852","1420","0","60.0","46.62"
"64","000","00","011","1120","1644","845","678","167","67","912","1380","0","66.09","49.13"
"64","000","00","011","1120","1645","672","545","127","32","704","1239","0","56.82","43.99"
"64","000","00","011","1121","0000","1857","1516","341","81","1938","3207","0","60.43","47.27"
"64","000","00","011","1121","1646","901","743","158","59","960","1563","0","61.42","47.54"
"64","000","00","011","1121","1647","956","773","183","22","978","1644","0","59.49","47.02"
"64","000","00","011","1122","0000","5822","4565","1257","460","6282","11107","0","56.56","41.1"
"64","000","00","011","1122","1648","997","884","113","89","1086","1895","0","57.31","46.65"
"64","000","00","011","1122","1649","908","692","216","96","1004","1748","0","57.44","39.59"
"64","000","00","011","1122","1650","882","619","263","94","976","1579","0","61.81","39.2"
"64","000","00","011","1122","1651","1102","871","231","51","1153","2135","0","54.0","40.8"
"64","000","00","011","1122","1652","922","708","214","84","1006","1728","0","58.22","40.97"
"64","000","00","011","1122","1653","1011","791","220","46","1057","2022","0","52.27","39.12"
"64","000","00","011","1123","0000","1954","1511","443","163","2117","3916","0","54.06","38.59"
"64","000","00","011","1123","1654","580","465","115","30","610","1329","0","45.9","34.99"
"64","000","00","011","1123","1655","685","495","190","47","732","1320","0","55.45","37.5"
"64","000","00","011","1123","1656","689","551","138","86","775","1267","0","61.17","43.49"
"64","000","00","011","1124","0000","1491","1123","368","114","1605","2587","0","62.04","43.41"
"64","000","00","011","1124","1657","746","555","191","78","824","1298","0","63.48","42.76"
"64","000","00","011","1124","1658","745","568","177","36","781","1289","0","60.59","44.07"
"64","000","00","011","1125","0000","1677","1290","387","108","1785","3028","0","58.95","42.6"
"64","000","00","011","1125","1659","850","653","197","56","906","1534","0","59.06","42.57"
"64","000","00","011","1125","1660","827","637","190","52","879","1494","0","58.84","42.64"
"64","000","00","011","1126","0000","1537","1205","332","163","1700","2721","0","62.48","44.29"
"64","000","00","011","1126","1661","750","566","184","79","829","1377","0","60.2","41.1"
"64","000","00","011","1126","1662","787","639","148","84","871","1344","0","64.81","47.54"
"64","000","00","011","1127","0000","3140","2473","667","196","3336","5757","0","57.95","42.96"
"64","000","00","011","1127","1663","803","648","155","69","872","1508","0","57.82","42.97"
"64","000","00","011","1127","1664","759","572","187","36","795","1400","0","56.79","40.86"
"64","000","00","011","1127","1665","835","673","162","61","896","1457","0","61.5","46.19"
"64","000","00","011","1127","1666","743","580","163","30","773","1392","0","55.53","41.67"
"64","000","00","011","1128","0000","2345","1851","494","149","2494","4487","0","55.58","41.25"
"64","000","00","011","1128","1667","1014","805","209","70","1084","1983","0","54.66","40.6"
"64","000","00","011","1128","1668","622","508","114","34","656","1204","0","54.49","42.19"
"64","000","00","011","1128","1669","709","538","171","45","754","1300","0","58.0","41.38"
"64","000","00","011","1129","0000","1902","1449","453","130","2032","3423","0","59.36","42.33"
"64","000","00","011","1129","1670","1061","785","276","88","1149","1857","0","61.87","42.27"
"64","000","00","011","1129","1671","841","664","177","42","883","1566","0","56.39","42.4"
"64","000","00","011","1130","0000","1525","1171","354","160","1685","2579","0","65.34","45.41"
"64","000","00","011","1130","1672","809","634","175","83","892","1343","0","66.42","47.21"
"64","000","00","011","1130","1673","716","537","179","77","793","1236","0","64.16","43.45"
"64","000","00","011","1131","0000","4177","3233","944","277","4454","7715","0","57.73","41.91"
"64","000","00","011","1131","1674","877","675","202","102","979","1564","0","62.6","43.16"
"64","000","00","011","1131","1675","774","592","182","39","813","1484","0","54.78","39.89"
"64","000","00","011","1131","1676","795","638","157","38","833","1477","0","56.4","43.2"
"64","000","00","011","1131","1677","871","653","218","49","920","1482","0","62.08","44.06"
"64","000","00","011","1131","1678","860","675","185","49","909","1708","0","53.22","39.52"
"64","000","00","011","1132","0000","1809","1351","458","100","1909","3576","0","53.38","37.78"
"64","000","00","011","1132","1679","1000","721","279","68","1068","1867","0","57.2","38.62"
"64","000","00","011","1132","1680","809","630","179","32","841","1709","0","49.21","36.86"
"64","000","00","011","1133","0000","1453","1132","321","134","1587","3121","0","50.85","36.27"
"64","000","00","011","1133","1681","704","545","159","82","786","1425","0","55.16","38.25"
"64","000","00","011","1133","1682","749","587","162","52","801","1696","0","47.23","34.61"
"64","000","00","011","1134","0000","1479","1101","378","148","1627","3053","0","53.29","36.06"
"64","000","00","011","1134","1683","678","505","173","45","723","1522","0","47.5","33.18"
"64","000","00","011","1134","1684","801","596","205","103","904","1531","0","59.05","38.93"
"64","000","00","011","1135","0000","1080","818","262","127","1207","2215","0","54.49","36.93"
"64","000","00","011","1135","1685","1080","818","262","127","1207","2215","0","54.49","36.93"
"64","000","00","011","1136","0000","1444","1104","340","74","1518","3050","0","49.77","36.2"
"64","000","00","011","1136","1686","741","565","176","41","782","1515","0","51.62","37.29"
"64","000","00","011","1136","1687","703","539","164","33","736","1535","0","47.95","35.11"
"64","000","00","011","1137","0000","1213","940","273","74","1287","2493","0","51.62","37.71"
"64","000","00","011","1137","1688","653","508","145","34","687","1276","0","53.84","39.81"
"64","000","00","011","1137","1689","560","432","128","40","600","1217","0","49.3","35.5"
"64","000","00","011","1138","0000","1656","1249","407","212","1868","3627","0","51.5","34.44"
"64","000","00","011","1138","1690","760","585","175","85","845","1707","0","49.5","34.27"
"64","000","00","011","1138","1691","896","664","232","127","1023","1920","0","53.28","34.58"
"64","000","00","012","0000","0000","164376","129085","35291","11320","175696","300510","359100","58.47","42.96"
"64","000","00","012","1201","0000","234","179","55","16","250","423","0","59.1","42.32"
"64","000","00","012","1201","1306","234","179","55","16","250","423","0","59.1","42.32"
"64","000","00","012","1202","0000","336","254","82","25","361","618","0","58.41","41.1"
"64","000","00","012","1202","1305","336","254","82","25","361","618","0","58.41","41.1"
"64","000","00","012","1203","0000","696","517","179","63","759","1312","0","57.85","39.41"
"64","000","00","012","1203","1307","696","517","179","63","759","1312","0","57.85","39.41"
"64","000","00","012","1204","0000","574","445","129","49","623","875","0","71.2","50.86"
"64","000","00","012","1204","1321","574","445","129","49","623","875","0","71.2","50.86"
"64","000","00","012","1205","0000","486","356","130","34","520","882","0","58.96","40.36"
"64","000","00","012","1205","1314","486","356","130","34","520","882","0","58.96","40.36"
"64","000","00","012","1206","0000","1171","959","212","58","1229","1982","0","62.01","48.39"
"64","000","00","012","1206","1308","425","323","102","31","456","769","0","59.3","42.0"
"64","000","00","012","1206","1309","746","636","110","27","773","1213","0","63.73","52.43"
"64","000","00","012","1207","0000","651","507","144","59","710","1080","0","65.74","46.94"
"64","000","00","012","1207","1256","651","507","144","59","710","1080","0","65.74","46.94"
"64","000","00","012","1208","0000","2034","1567","467","173","2207","3395","0","65.01","46.16"
"64","000","00","012","1208","1334","673","521","152","64","737","1159","0","63.59","44.95"
"64","000","00","012","1208","1335","613","481","132","61","674","1127","0","59.8","42.68"
"64","000","00","012","1208","1336","748","565","183","48","796","1109","0","71.78","50.95"
"64","000","00","012","1209","0000","4377","3460","917","263","4640","8473","0","54.76","40.84"
"64","000","00","012","1209","1268","808","623","185","79","887","1496","0","59.29","41.64"
"64","000","00","012","1209","1269","987","784","203","59","1046","2094","0","49.95","37.44"
"64","000","00","012","1209","1270","867","693","174","29","896","1672","0","53.59","41.45"
"64","000","00","012","1209","1271","929","755","174","22","951","1761","0","54.0","42.87"
"64","000","00","012","1209","1272","786","605","181","74","860","1450","0","59.31","41.72"
"64","000","00","012","1210","0000","480","369","111","34","514","819","0","62.76","45.05"
"64","000","00","012","1210","1257","480","369","111","34","514","819","0","62.76","45.05"
"64","000","00","012","1211","0000","2008","1554","454","138","2146","3533","0","60.74","43.99"
"64","000","00","012","1211","1277","708","561","147","64","772","1247","0","61.91","44.99"
"64","000","00","012","1211","1278","611","466","145","47","658","1087","0","60.53","42.87"
"64","000","00","012","1211","1279","689","527","162","27","716","1199","0","59.72","43.95"
"64","000","00","012","1212","0000","2684","2089","595","159","2843","4957","0","57.35","42.14"
"64","000","00","012","1212","1260","713","562","151","40","753","1223","0","61.57","45.95"
"64","000","00","012","1212","1261","706","545","161","38","744","1207","0","61.64","45.15"
"64","000","00","012","1212","1262","691","519","172","42","733","1339","0","54.74","38.76"
"64","000","00","012","1212","1263","574","463","111","39","613","1188","0","51.6","38.97"
"64","000","00","012","1213","0000","1276","1040","236","76","1352","2465","0","54.85","42.19"
"64","000","00","012","1213","1340","762","619","143","56","818","1432","0","57.12","43.23"
"64","000","00","012","1213","1341","514","421","93","20","534","1033","0","51.69","40.76"
"64","000","00","012","1214","0000","3129","2502","627","180","3309","5972","0","55.41","41.9"
"64","000","00","012","1214","1362","796","623","173","54","850","1521","0","55.88","40.96"
"64","000","00","012","1214","1363","696","555","141","39","735","1407","0","52.24","39.45"
"64","000","00","012","1214","1364","875","710","165","63","938","1542","0","60.83","46.04"
"64","000","00","012","1214","1365","762","614","148","24","786","1502","0","52.33","40.88"
"64","000","00","012","1215","0000","2352","2017","335","124","2476","4111","0","60.23","49.06"
"64","000","00","012","1215","1366","777","626","151","45","822","1320","0","62.27","47.42"
"64","000","00","012","1215","1367","796","701","95","38","834","1507","0","55.34","46.52"
"64","000","00","012","1215","1368","779","690","89","41","820","1284","0","63.86","53.74"
"64","000","00","012","1216","0000","2588","2002","586","163","2751","4722","0","58.26","42.4"
"64","000","00","012","1216","1445","585","462","123","62","647","1058","0","61.15","43.67"
"64","000","00","012","1216","1446","578","467","111","56","634","976","0","64.96","47.85"
"64","000","00","012","1216","1447","758","593","165","39","797","1545","0","51.59","38.38"
"64","000","00","012","1216","1448","667","480","187","6","673","1143","0","58.88","41.99"
"64","000","00","012","1217","0000","3394","2616","778","275","3669","6769","0","54.2","38.65"
"64","000","00","012","1217","1407","636","488","148","46","682","1314","0","51.9","37.14"
"64","000","00","012","1217","1408","785","628","157","28","813","1649","0","49.3","38.08"
"64","000","00","012","1217","1409","792","595","197","100","892","1601","0","55.72","37.16"
"64","000","00","012","1217","1410","608","472","136","29","637","1155","0","55.15","40.87"
"64","000","00","012","1217","1411","573","433","140","72","645","1050","0","61.43","41.24"
"64","000","00","012","1218","0000","2793","2161","632","212","3005","4988","0","60.24","43.32"
"64","000","00","012","1218","1342","709","530","179","89","798","1253","0","63.69","42.3"
"64","000","00","012","1218","1343","671","516","155","34","705","1217","0","57.93","42.4"
"64","000","00","012","1218","1344","765","613","152","49","814","1267","0","64.25","48.38"
"64","000","00","012","1218","1345","648","502","146","40","688","1251","0","55.0","40.13"
"64","000","00","012","1219","0000","2721","2116","605","153","2874","4562","0","63.0","46.38"
"64","000","00","012","1219","1325","630","494","136","36","666","974","0","68.38","50.72"
"64","000","00","012","1219","1326","556","446","110","42","598","987","0","60.59","45.19"
"64","000","00","012","1219","1327","758","589","169","18","776","1210","0","64.13","48.68"
"64","000","00","012","1219","1328","777","587","190","57","834","1391","0","59.96","42.2"
"64","000","00","012","1220","0000","2290","1874","416","97","2387","3682","0","64.83","50.9"
"64","000","00","012","1220","1337","1132","930","202","60","1192","1879","0","63.44","49.49"
"64","000","00","012","1220","1338","1158","944","214","37","1195","1803","0","66.28","52.36"
"64","000","00","012","1221","0000","888","659","229","119","1007","2513","0","40.07","26.22"
"64","000","00","012","1221","1316","474","360","114","61","535","853","0","62.72","42.2"
"64","000","00","012","1221","1317","414","299","115","58","472","1660","0","28.43","18.01"
"64","000","00","012","1222","0000","1585","1293","292","123","1708","2926","0","58.37","44.19"
"64","000","00","012","1222","1369","753","604","149","40","793","1441","0","55.03","41.92"
"64","000","00","012","1222","1370","832","689","143","83","915","1485","0","61.62","46.4"
"64","000","00","012","1224","0000","1733","1453","280","117","1850","3411","0","54.24","42.6"
"64","000","00","012","1224","1275","892","776","116","80","972","1713","0","56.74","45.3"
"64","000","00","012","1224","1276","841","677","164","37","878","1698","0","51.71","39.87"
"64","000","00","012","1225","0000","1530","1271","259","54","1584","2870","0","55.19","44.29"
"64","000","00","012","1225","1387","798","736","62","18","816","1525","0","53.51","48.26"
"64","000","00","012","1225","1388","732","535","197","36","768","1345","0","57.1","39.78"
"64","000","00","012","1226","0000","2681","2150","531","159","2840","4708","0","60.32","45.67"
"64","000","00","012","1226","1383","507","393","114","43","550","942","0","58.39","41.72"
"64","000","00","012","1226","1384","635","491","144","24","659","1206","0","54.64","40.71"
"64","000","00","012","1226","1385","702","534","168","43","745","1159","0","64.28","46.07"
"64","000","00","012","1226","1386","837","732","105","49","886","1401","0","63.24","52.25"
"64","000","00","012","1227","0000","3479","2586","893","351","3830","6189","0","61.88","41.78"
"64","000","00","012","1227","1429","802","615","187","65","867","1405","0","61.71","43.77"
"64","000","00","012","1227","1430","636","482","154","79","715","1097","0","65.18","43.94"
"64","000","00","012","1227","1431","719","504","215","98","817","1248","0","65.46","40.38"
"64","000","00","012","1227","1432","692","516","176","70","762","1225","0","62.2","42.12"
"64","000","00","012","1227","1433","630","469","161","39","669","1214","0","55.11","38.63"
"64","000","00","012","1228","0000","1716","1307","409","195","1911","3269","0","58.46","39.98"
"64","000","00","012","1228","1437","514","387","127","54","568","968","0","58.68","39.98"
"64","000","00","012","1228","1438","604","465","139","69","673","1200","0","56.08","38.75"
"64","000","00","012","1228","1439","598","455","143","72","670","1101","0","60.85","41.33"
"64","000","00","012","1229","0000","2988","2302","686","277","3265","5759","0","56.69","39.97"
"64","000","00","012","1229","1474","535","419","116","69","604","1042","0","57.97","40.21"
"64","000","00","012","1229","1475","593","459","134","68","661","1098","0","60.2","41.8"
"64","000","00","012","1229","1476","624","468","156","23","647","1284","0","50.39","36.45"
"64","000","00","012","1229","1477","625","479","146","40","665","1242","0","53.54","38.57"
"64","000","00","012","1229","1478","611","477","134","77","688","1093","0","62.95","43.64"
"64","000","00","012","1230","0000","2934","2347","587","268","3202","5398","0","59.32","43.48"
"64","000","00","012","1230","1349","803","638","165","47","850","1588","0","53.53","40.18"
"64","000","00","012","1230","1350","731","623","108","66","797","1255","0","63.51","49.64"
"64","000","00","012","1230","1351","697","533","164","69","766","1264","0","60.6","42.17"
"64","000","00","012","1230","1352","703","553","150","86","789","1291","0","61.12","42.84"
"64","000","00","012","1231","0000","2733","2157","576","203","2936","4819","0","60.93","44.76"
"64","000","00","012","1231","1346","861","696","165","85","946","1563","0","60.52","44.53"
"64","000","00","012","1231","1347","1097","882","215","58","1155","1888","0","61.18","46.72"
"64","000","00","012","1231","1348","775","579","196","60","835","1368","0","61.04","42.32"
"64","000","00","012","1232","0000","1789","1403","386","122","1911","3455","0","55.31","40.61"
"64","000","00","012","1232","1465","605","458","147","49","654","1154","0","56.67","39.69"
"64","000","00","012","1232","1466","643","510","133","54","697","1153","0","60.45","44.23"
"64","000","00","012","1232","1467","541","435","106","19","560","1148","0","48.78","37.89"
"64","000","00","012","1233","0000","2983","2295","688","157","3140","5211","0","60.26","44.04"
"64","000","00","012","1233","1397","694","532","162","33","727","1388","0","52.38","38.33"
"64","000","00","012","1233","1398","691","534","157","78","769","1241","0","61.97","43.03"
"64","000","00","012","1233","1399","854","640","214","17","871","1394","0","62.48","45.91"
"64","000","00","012","1233","1400","744","589","155","29","773","1188","0","65.07","49.58"
"64","000","00","012","1234","0000","2061","1551","510","149","2210","3815","0","57.93","40.66"
"64","000","00","012","1234","1371","640","471","169","61","701","1205","0","58.17","39.09"
"64","000","00","012","1234","1372","658","507","151","26","684","1284","0","53.27","39.49"
"64","000","00","012","1234","1373","763","573","190","62","825","1326","0","62.22","43.21"
"64","000","00","012","1235","0000","3266","2623","643","200","3466","5984","0","57.92","43.83"
"64","000","00","012","1235","1359","1143","907","236","86","1229","2173","0","56.56","41.74"
"64","000","00","012","1235","1360","1237","1002","235","74","1311","2255","0","58.14","44.43"
"64","000","00","012","1235","1361","886","714","172","40","926","1556","0","59.51","45.89"
"64","000","00","012","1236","0000","2011","1638","373","95","2106","3999","0","52.66","40.96"
"64","000","00","012","1236","1404","613","476","137","34","647","1216","0","53.21","39.14"
"64","000","00","012","1236","1405","616","462","154","36","652","1318","0","49.47","35.05"
"64","000","00","012","1236","1406","782","700","82","25","807","1465","0","55.09","47.78"
"64","000","00","012","1237","0000","1928","1427","501","165","2093","3295","0","63.52","43.31"
"64","000","00","012","1237","1374","615","466","149","27","642","1096","0","58.58","42.52"
"64","000","00","012","1237","1375","676","485","191","82","758","1182","0","64.13","41.03"
"64","000","00","012","1237","1376","637","476","161","56","693","1017","0","68.14","46.8"
"64","000","00","012","1238","0000","1235","903","332","126","1361","2479","0","54.9","36.43"
"64","000","00","012","1238","1377","616","441","175","92","708","1198","0","59.1","36.81"
"64","000","00","012","1238","1378","619","462","157","34","653","1281","0","50.98","36.07"
"64","000","00","012","1239","0000","4824","3801","1023","240","5064","8716","0","58.1","43.61"
"64","000","00","012","1239","1291","1014","811","203","45","1059","1751","0","60.48","46.32"
"64","000","00","012","1239","1292","999","780","219","45","1044","1758","0","59.39","44.37"
"64","000","00","012","1239","1293","953","729","224","82","1035","1749","0","59.18","41.68"
"64","000","00","012","1239","1294","940","741","199","22","962","1746","0","55.1","42.44"
"64","000","00","012","1239","1295","918","740","178","46","964","1712","0","56.31","43.22"
"64","000","00","012","1240","0000","7097","5666","1431","323","7420","12977","0","57.18","43.66"
"64","000","00","012","1240","1421","825","642","183","50","875","1688","0","51.84","38.03"
"64","000","00","012","1240","1422","901","733","168","58","959","1657","0","57.88","44.24"
"64","000","00","012","1240","1423","874","678","196","36","910","1729","0","52.63","39.21"
"64","000","00","012","1240","1424","929","744","185","56","985","1628","0","60.5","45.7"
"64","000","00","012","1240","1425","909","733","176","19","928","1891","0","49.07","38.76"
"64","000","00","012","1240","1426","933","751","182","44","977","1594","0","61.29","47.11"
"64","000","00","012","1240","1427","819","662","157","20","839","1342","0","62.52","49.33"
"64","000","00","012","1240","1428","907","723","184","40","947","1448","0","65.4","49.93"
"64","000","00","012","1241","0000","1095","849","246","109","1204","1926","0","62.51","44.08"
"64","000","00","012","1241","1258","462","357","105","69","531","851","0","62.4","41.95"
"64","000","00","012","1241","1259","633","492","141","40","673","1075","0","62.6","45.77"
"64","000","00","012","1242","0000","1896","1477","419","137","2033","3418","0","59.48","43.21"
"64","000","00","012","1242","1318","659","517","142","31","690","1124","0","61.39","46.0"
"64","000","00","012","1242","1319","628","469","159","63","691","1112","0","62.14","42.18"
"64","000","00","012","1242","1320","609","491","118","43","652","1182","0","55.16","41.54"
"64","000","00","012","1243","0000","1706","1407","299","213","1919","2966","0","64.7","47.44"
"64","000","00","012","1243","1471","578","451","127","51","629","1026","0","61.31","43.96"
"64","000","00","012","1243","1472","581","529","52","93","674","993","0","67.88","53.27"
"64","000","00","012","1243","1473","547","427","120","69","616","947","0","65.05","45.09"
"64","000","00","012","1244","0000","3154","2500","654","221","3375","5672","0","59.5","44.08"
"64","000","00","012","1244","1329","592","448","144","25","617","1241","0","49.72","36.1"
"64","000","00","012","1244","1330","596","494","102","48","644","1000","0","64.4","49.4"
"64","000","00","012","1244","1331","619","490","129","44","663","1092","0","60.71","44.87"
"64","000","00","012","1244","1332","759","603","156","46","805","1308","0","61.54","46.1"
"64","000","00","012","1244","1333","588","465","123","58","646","1031","0","62.66","45.1"
"64","000","00","012","1245","0000","1018","823","195","85","1103","2045","0","53.94","40.24"
"64","000","00","012","1245","1339","1018","823","195","85","1103","2045","0","53.94","40.24"
"64","000","00","012","1246","0000","2771","2136","635","170","2941","4742","0","62.02","45.04"
"64","000","00","012","1246","1310","672","539","133","49","721","1107","0","65.13","48.69"
"64","000","00","012","1246","1311","675","503","172","31","706","1188","0","59.43","42.34"
"64","000","00","012","1246","1312","695","539","156","40","735","1183","0","62.13","45.56"
"64","000","00","012","1246","1313","729","555","174","50","779","1264","0","61.63","43.91"
"64","000","00","012","1247","0000","1960","1514","446","150","2110","3351","0","62.97","45.18"
"64","000","00","012","1247","1322","580","423","157","58","638","1040","0","61.35","40.67"
"64","000","00","012","1247","1323","667","523","144","30","697","1094","0","63.71","47.81"
"64","000","00","012","1247","1324","713","568","145","62","775","1217","0","63.68","46.67"
"64","000","00","012","1248","0000","3222","2576","646","237","3459","6178","0","55.99","41.7"
"64","000","00","012","1248","1286","615","502","113","37","652","1247","0","52.29","40.26"
"64","000","00","012","1248","1287","770","604","166","72","842","1538","0","54.75","39.27"
"64","000","00","012","1248","1288","575","441","134","39","614","1097","0","55.97","40.2"
"64","000","00","012","1248","1289","594","500","94","29","623","1221","0","51.02","40.95"
"64","000","00","012","1248","1290","668","529","139","60","728","1075","0","67.72","49.21"
"64","000","00","012","1249","0000","2345","1795","550","233","2578","4308","0","59.84","41.67"
"64","000","00","012","1249","1481","726","556","170","75","801","1309","0","61.19","42.48"
"64","000","00","012","1249","1482","880","679","201","64","944","1627","0","58.02","41.73"
"64","000","00","012","1249","1483","739","560","179","94","833","1372","0","60.71","40.82"
"64","000","00","012","1250","0000","1386","1141","245","66","1452","2520","0","57.62","45.28"
"64","000","00","012","1250","1353","658","542","116","35","693","1224","0","56.62","44.28"
"64","000","00","012","1250","1354","728","599","129","31","759","1296","0","58.56","46.22"
"64","000","00","012","1251","0000","642","500","142","60","702","1007","0","69.71","49.65"
"64","000","00","012","1251","1315","642","500","142","60","702","1007","0","69.71","49.65"
"64","000","00","012","1253","0000","2224","1755","469","213","2437","4102","0","59.41","42.78"
"64","000","00","012","1253","1264","576","448","128","62","638","1055","0","60.47","42.46"
"64","000","00","012","1253","1265","566","455","111","69","635","1109","0","57.26","41.03"
"64","000","00","012","1253","1266","475","366","109","44","519","756","0","68.65","48.41"
"64","000","00","012","1253","1267","607","486","121","38","645","1182","0","54.57","41.12"
"64","000","00","012","1254","0000","870","668","202","56","926","2551","0","36.3","26.19"
"64","000","00","012","1254","1449","314","241","73","24","338","1301","0","25.98","18.52"
"64","000","00","012","1254","1450","556","427","129","32","588","1250","0","47.04","34.16"
"64","000","00","012","1255","0000","4414","3427","987","322","4736","7753","0","61.09","44.2"
"64","000","00","012","1255","1459","746","594","152","29","775","1291","0","60.03","46.01"
"64","000","00","012","1255","1460","526","414","112","68","594","938","0","63.33","44.14"
"64","000","00","012","1255","1461","997","767","230","42","1039","1783","0","58.27","43.02"
"64","000","00","012","1255","1462","622","489","133","42","664","1105","0","60.09","44.25"
"64","000","00","012","1255","1463","741","550","191","93","834","1392","0","59.91","39.51"
"64","000","00","012","1255","1464","782","613","169","48","830","1244","0","66.72","49.28"
"64","000","00","012","1256","0000","4616","3710","906","198","4814","8179","0","58.86","45.36"
"64","000","00","012","1256","1280","847","731","116","52","899","1559","0","57.67","46.89"
"64","000","00","012","1256","1281","682","537","145","43","725","1233","0","58.8","43.55"
"64","000","00","012","1256","1282","706","549","157","50","756","1277","0","59.2","42.99"
"64","000","00","012","1256","1283","781","645","136","20","801","1481","0","54.09","43.55"
"64","000","00","012","1256","1284","723","574","149","13","736","1154","0","63.78","49.74"
"64","000","00","012","1256","1285","877","674","203","20","897","1475","0","60.81","45.69"
"64","000","00","012","1257","0000","2055","1569","486","170","2225","4340","0","51.27","36.15"
"64","000","00","012","1257","1468","711","526","185","115","826","1432","0","57.68","36.73"
"64","000","00","012","1257","1469","570","420","150","20","590","1429","0","41.29","29.39"
"64","000","00","012","1257","1470","774","623","151","35","809","1479","0","54.7","42.12"
"64","000","00","012","1258","0000","1393","1109","284","90","1483","2689","0","55.15","41.24"
"64","000","00","012","1258","1273","717","558","159","33","750","1455","0","51.55","38.35"
"64","000","00","012","1258","1274","676","551","125","57","733","1234","0","59.4","44.65"
"64","000","00","012","1259","0000","2268","1717","551","147","2415","4003","0","60.33","42.89"
"64","000","00","012","1259","1296","711","552","159","33","744","1247","0","59.66","44.27"
"64","000","00","012","1259","1297","803","604","199","54","857","1409","0","60.82","42.87"
"64","000","00","012","1259","1298","754","561","193","60","814","1347","0","60.43","41.65"
"64","000","00","012","1260","0000","5150","4114","1036","203","5353","9265","0","57.78","44.4"
"64","000","00","012","1260","1299","961","766","195","26","987","1771","0","55.73","43.25"
"64","000","00","012","1260","1300","847","665","182","17","864","1537","0","56.21","43.27"
"64","000","00","012","1260","1301","919","740","179","28","947","1605","0","59.0","46.11"
"64","000","00","012","1260","1302","779","626","153","46","825","1375","0","60.0","45.53"
"64","000","00","012","1260","1303","819","642","177","53","872","1393","0","62.6","46.09"
"64","000","00","012","1260","1304","825","675","150","33","858","1584","0","54.17","42.61"
"64","000","00","012","1261","0000","1202","979","223","100","1302","2055","0","63.36","47.64"
"64","000","00","012","1261","1355","502","395","107","54","556","826","0","67.31","47.82"
"64","000","00","012","1261","1356","700","584","116","46","746","1229","0","60.7","47.52"
"64","000","00","012","1262","0000","1543","1232","311","105","1648","2685","0","61.38","45.88"
"64","000","00","012","1262","1357","858","702","156","43","901","1467","0","61.42","47.85"
"64","000","00","012","1262","1358","685","530","155","62","747","1218","0","61.33","43.51"
"64","000","00","012","1263","0000","1578","1209","369","92","1670","2584","0","64.63","46.79"
"64","000","00","012","1263","1379","817","617","200","44","861","1358","0","63.4","45.43"
"64","000","00","012","1263","1380","761","592","169","48","809","1226","0","65.99","48.29"
"64","000","00","012","1264","0000","1326","1015","311","107","1433","2298","0","62.36","44.17"
"64","000","00","012","1264","1381","644","491","153","66","710","1098","0","64.66","44.72"
"64","000","00","012","1264","1382","682","524","158","41","723","1200","0","60.25","43.67"
"64","000","00","012","1265","0000","2170","1662","508","140","2310","3785","0","61.03","43.91"
"64","000","00","012","1265","1401","624","477","147","39","663","1112","0","59.62","42.9"
"64","000","00","012","1265","1402","735","559","176","53","788","1198","0","65.78","46.66"
"64","000","00","012","1265","1403","811","626","185","48","859","1475","0","58.24","42.44"
"64","000","00","012","1266","0000","1246","930","316","65","1311","2286","0","57.35","40.68"
"64","000","00","012","1266","1389","690","513","177","41","731","1180","0","61.95","43.47"
"64","000","00","012","1266","1390","556","417","139","24","580","1106","0","52.44","37.7"
"64","000","00","012","1267","0000","2508","1957","551","159","2667","4313","0","61.84","45.37"
"64","000","00","012","1267","1394","754","615","139","25","779","1361","0","57.24","45.19"
"64","000","00","012","1267","1395","818","626","192","64","882","1416","0","62.29","44.21"
"64","000","00","012","1267","1396","936","716","220","70","1006","1536","0","65.49","46.61"
"64","000","00","012","1268","0000","2345","1818","527","149","2494","4061","0","61.41","44.77"
"64","000","00","012","1268","1391","850","663","187","63","913","1442","0","63.31","45.98"
"64","000","00","012","1268","1392","801","621","180","54","855","1376","0","62.14","45.13"
"64","000","00","012","1268","1393","694","534","160","32","726","1243","0","58.41","42.96"
"64","000","00","012","1269","0000","1339","1060","279","73","1412","2515","0","56.14","42.15"
"64","000","00","012","1269","1415","657","520","137","49","706","1190","0","59.33","43.7"
"64","000","00","012","1269","1416","682","540","142","24","706","1325","0","53.28","40.75"
"64","000","00","012","1270","0000","2440","1878","562","173","2613","4481","0","58.31","41.91"
"64","000","00","012","1270","1417","596","464","132","58","654","1049","0","62.35","44.23"
"64","000","00","012","1270","1418","565","443","122","33","598","1026","0","58.28","43.18"
"64","000","00","012","1270","1419","657","492","165","63","720","1152","0","62.5","42.71"
"64","000","00","012","1270","1420","622","479","143","19","641","1254","0","51.12","38.2"
"64","000","00","012","1271","0000","2364","1871","493","156","2520","4456","0","56.55","41.99"
"64","000","00","012","1271","1412","687","543","144","28","715","1417","0","50.46","38.32"
"64","000","00","012","1271","1413","816","629","187","65","881","1525","0","57.77","41.25"
"64","000","00","012","1271","1414","861","699","162","63","924","1514","0","61.03","46.17"
"64","000","00","012","1272","0000","2422","2012","410","172","2594","4447","0","58.33","45.24"
"64","000","00","012","1272","1440","697","539","158","42","739","1369","0","53.98","39.37"
"64","000","00","012","1272","1441","837","769","68","67","904","1542","0","58.63","49.87"
"64","000","00","012","1272","1442","888","704","184","63","951","1536","0","61.91","45.83"
"64","000","00","012","1273","0000","1483","1101","382","132","1615","2834","0","56.99","38.85"
"64","000","00","012","1273","1443","685","502","183","33","718","1382","0","51.95","36.32"
"64","000","00","012","1273","1444","798","599","199","99","897","1452","0","61.78","41.25"
"64","000","00","012","1274","0000","1399","1084","315","86","1485","2432","0","61.06","44.57"
"64","000","00","012","1274","1455","653","506","147","59","712","1125","0","63.29","44.98"
"64","000","00","012","1274","1456","746","578","168","27","773","1307","0","59.14","44.22"
"64","000","00","012","1275","0000","2869","2192","677","286","3155","5431","0","58.09","40.36"
"64","000","00","012","1275","1451","649","512","137","58","707","1208","0","58.53","42.38"
"64","000","00","012","1275","1452","651","502","149","86","737","1202","0","61.31","41.76"
"64","000","00","012","1275","1453","770","587","183","87","857","1499","0","57.17","39.16"
"64","000","00","012","1275","1454","799","591","208","55","854","1522","0","56.11","38.83"
"64","000","00","012","1276","0000","1448","1108","340","131","1579","2657","0","59.43","41.7"
"64","000","00","012","1276","1457","760","562","198","67","827","1405","0","58.86","40.0"
"64","000","00","012","1276","1458","688","546","142","64","752","1252","0","60.06","43.61"
"64","000","00","012","1277","0000","1367","1059","308","86","1453","2706","0","53.7","39.14"
"64","000","00","012","1277","1479","700","533","167","53","753","1353","0","55.65","39.39"
"64","000","00","012","1277","1480","667","526","141","33","700","1353","0","51.74","38.88"
"64","000","00","012","1278","0000","3407","2715","692","234","3641","6056","0","60.12","44.83"
"64","000","00","012","1278","1434","1132","894","238","104","1236","2032","0","60.83","44.0"
"64","000","00","012","1278","1435","1069","855","214","72","1141","1927","0","59.21","44.37"
"64","000","00","012","1278","1436","1206","966","240","58","1264","2097","0","60.28","46.07"
"64","000","00","013","0000","0000","29464","22575","6889","2778","32242","59129","69829","54.53","38.18"
"64","000","00","013","1301","0000","1409","1076","333","172","1581","2824","0","55.98","38.1"
"64","000","00","013","1301","1773","670","514","156","91","761","1262","0","60.3","40.73"
"64","000","00","013","1301","1774","739","562","177","81","820","1562","0","52.5","35.98"
"64","000","00","013","1302","0000","1749","1372","377","145","1894","3252","0","58.24","42.19"
"64","000","00","013","1302","1775","573","460","113","31","604","1078","0","56.03","42.67"
"64","000","00","013","1302","1776","563","428","135","61","624","979","0","63.74","43.72"
"64","000","00","013","1302","1777","613","484","129","53","666","1195","0","55.73","40.5"
"64","000","00","013","1303","0000","1954","1443","511","195","2149","3929","0","54.7","36.73"
"64","000","00","013","1303","1778","675","512","163","78","753","1380","0","54.57","37.1"
"64","000","00","013","1303","1779","643","470","173","83","726","1280","0","56.72","36.72"
"64","000","00","013","1303","1780","636","461","175","34","670","1269","0","52.8","36.33"
"64","000","00","013","1304","0000","1341","974","367","91","1432","2794","0","51.25","34.86"
"64","000","00","013","1304","1781","668","486","182","26","694","1568","0","44.26","30.99"
"64","000","00","013","1304","1782","673","488","185","65","738","1226","0","60.2","39.8"
"64","000","00","013","1305","0000","1526","1209","317","138","1664","2939","0","56.62","41.14"
"64","000","00","013","1305","1783","738","580","158","68","806","1480","0","54.46","39.19"
"64","000","00","013","1305","1784","788","629","159","70","858","1459","0","58.81","43.11"
"64","000","00","013","1306","0000","1201","891","310","148","1349","2488","0","54.22","35.81"
"64","000","00","013","1306","1785","753","570","183","59","812","1593","0","50.97","35.78"
"64","000","00","013","1306","1786","448","321","127","89","537","895","0","60.0","35.87"
"64","000","00","013","1307","0000","2303","1752","551","245","2548","4455","0","57.19","39.33"
"64","000","00","013","1307","1787","532","402","130","42","574","1110","0","51.71","36.22"
"64","000","00","013","1307","1788","662","514","148","69","731","1348","0","54.23","38.13"
"64","000","00","013","1307","1789","478","347","131","64","542","912","0","59.43","38.05"
"64","000","00","013","1307","1790","631","489","142","70","701","1085","0","64.61","45.07"
"64","000","00","013","1308","0000","962","739","223","89","1051","1834","0","57.31","40.29"
"64","000","00","013","1308","1791","474","373","101","35","509","955","0","53.3","39.06"
"64","000","00","013","1308","1792","488","366","122","54","542","879","0","61.66","41.64"
"64","000","00","013","1309","0000","1731","1367","364","171","1902","3449","0","55.15","39.63"
"64","000","00","013","1309","1793","566","448","118","75","641","1103","0","58.11","40.62"
"64","000","00","013","1309","1794","591","464","127","77","668","1054","0","63.38","44.02"
"64","000","00","013","1309","1795","574","455","119","19","593","1292","0","45.9","35.22"
"64","000","00","013","1310","0000","722","565","157","36","758","1683","0","45.04","33.57"
"64","000","00","013","1310","1796","722","565","157","36","758","1683","0","45.04","33.57"
"64","000","00","013","1311","0000","823","637","186","120","943","1619","0","58.25","39.35"
"64","000","00","013","1311","1797","312","247","65","39","351","607","0","57.83","40.69"
"64","000","00","013","1311","1798","511","390","121","81","592","1012","0","58.5","38.54"
"64","000","00","013","1312","0000","933","732","201","102","1035","1960","0","52.81","37.35"
"64","000","00","013","1312","1799","540","421","119","76","616","1046","0","58.89","40.25"
"64","000","00","013","1312","1800","393","311","82","26","419","914","0","45.84","34.03"
"64","000","00","013","1313","0000","2053","1609","444","181","2234","3874","0","57.67","41.53"
"64","000","00","013","1313","1801","747","584","163","72","819","1405","0","58.29","41.57"
"64","000","00","013","1313","1802","718","542","176","74","792","1299","0","60.97","41.72"
"64","000","00","013","1313","1803","588","483","105","35","623","1170","0","53.25","41.28"
"64","000","00","013","1314","0000","546","406","140","44","590","1299","0","45.42","31.25"
"64","000","00","013","1314","1804","546","406","140","44","590","1299","0","45.42","31.25"
"64","000","00","013","1315","0000","957","715","242","59","1016","1880","0","54.04","38.03"
"64","000","00","013","1315","1805","550","400","150","34","584","1031","0","56.64","38.8"
"64","000","00","013","1315","1806","407","315","92","25","432","849","0","50.88","37.1"
"64","000","00","013","1316","0000","883","661","222","91","974","1776","0","54.84","37.22"
"64","000","00","013","1316","1807","395","276","119","56","451","838","0","53.82","32.94"
"64","000","00","013","1316","1808","488","385","103","35","523","938","0","55.76","41.04"
"64","000","00","013","1317","0000","879","672","207","105","984","1837","0","53.57","36.58"
"64","000","00","013","1317","1809","460","358","102","47","507","1051","0","48.24","34.06"
"64","000","00","013","1317","1810","419","314","105","58","477","786","0","60.69","39.95"
"64","000","00","013","1318","0000","473","366","107","80","553","894","0","61.86","40.94"
"64","000","00","013","1318","1811","473","366","107","80","553","894","0","61.86","40.94"
"64","000","00","013","1319","0000","256","198","58","22","278","749","0","37.12","26.44"
"64","000","00","013","1319","1812","256","198","58","22","278","749","0","37.12","26.44"
"64","000","00","013","1320","0000","1609","1255","354","149","1758","2963","0","59.33","42.36"
"64","000","00","013","1320","1813","820","653","167","44","864","1485","0","58.18","43.97"
"64","000","00","013","1320","1814","789","602","187","105","894","1478","0","60.49","40.73"
"64","000","00","013","1321","0000","1275","903","372","146","1421","2383","0","59.63","37.89"
"64","000","00","013","1321","1815","764","559","205","84","848","1345","0","63.05","41.56"
"64","000","00","013","1321","1816","511","344","167","62","573","1038","0","55.2","33.14"
"64","000","00","013","1322","0000","1734","1373","361","84","1818","3366","0","54.01","40.79"
"64","000","00","013","1322","1817","665","521","144","29","694","1203","0","57.69","43.31"
"64","000","00","013","1322","1818","584","455","129","37","621","1138","0","54.57","39.98"
"64","000","00","013","1322","1819","485","397","88","18","503","1025","0","49.07","38.73"
"64","000","00","013","1323","0000","1226","947","279","111","1337","2559","0","52.25","37.01"
"64","000","00","013","1323","1820","702","543","159","87","789","1341","0","58.84","40.49"
"64","000","00","013","1323","1821","524","404","120","24","548","1218","0","44.99","33.17"
"64","000","00","013","1324","0000","919","713","206","54","973","2323","0","41.89","30.69"
"64","000","00","013","1324","1822","450","360","90","32","482","1147","0","42.02","31.39"
"64","000","00","013","1324","1823","469","353","116","22","491","1176","0","41.75","30.02"
"64","000","00","014","0000","0000","50355","38925","11430","4150","54505","97309","112334","56.01","40.0"
"64","000","00","014","1401","0000","648","476","172","44","692","1445","0","47.89","32.94"
"64","000","00","014","1401","1692","330","243","87","25","355","727","0","48.83","33.43"
"64","000","00","014","1401","1693","318","233","85","19","337","718","0","46.94","32.45"
"64","000","00","014","1402","0000","2529","1954","575","177","2706","5733","0","47.2","34.08"
"64","000","00","014","1402","1694","608","468","140","46","654","1340","0","48.81","34.93"
"64","000","00","014","1402","1695","691","528","163","47","738","1575","0","46.86","33.52"
"64","000","00","014","1402","1696","232","166","66","29","261","444","0","58.78","37.39"
"64","000","00","014","1402","1697","998","792","206","55","1053","2374","0","44.36","33.36"
"64","000","00","014","1403","0000","3324","2548","776","322","3646","6681","0","54.57","38.14"
"64","000","00","014","1403","1698","643","503","140","78","721","1291","0","55.85","38.96"
"64","000","00","014","1403","1699","716","544","172","81","797","1400","0","56.93","38.86"
"64","000","00","014","1403","1700","701","539","162","37","738","1390","0","53.09","38.78"
"64","000","00","014","1403","1701","693","515","178","88","781","1401","0","55.75","36.76"
"64","000","00","014","1403","1702","571","447","124","38","609","1199","0","50.79","37.28"
"64","000","00","014","1404","0000","1165","880","285","81","1246","2405","0","51.81","36.59"
"64","000","00","014","1404","1703","549","420","129","34","583","1210","0","48.18","34.71"
"64","000","00","014","1404","1704","616","460","156","47","663","1195","0","55.48","38.49"
"64","000","00","014","1405","0000","2235","1716","519","186","2421","4595","0","52.69","37.34"
"64","000","00","014","1405","1705","548","431","117","36","584","1166","0","50.09","36.96"
"64","000","00","014","1405","1706","694","527","167","45","739","1353","0","54.62","38.95"
"64","000","00","014","1405","1707","568","428","140","73","641","1052","0","60.93","40.68"
"64","000","00","014","1405","1708","425","330","95","32","457","1024","0","44.63","32.23"
"64","000","00","014","1406","0000","2250","1729","521","197","2447","4334","0","56.46","39.89"
"64","000","00","014","1406","1709","633","484","149","26","659","1189","0","55.42","40.71"
"64","000","00","014","1406","1710","824","633","191","91","915","1512","0","60.52","41.87"
"64","000","00","014","1406","1711","793","612","181","80","873","1633","0","53.46","37.48"
"64","000","00","014","1407","0000","2099","1576","523","174","2273","3795","0","59.89","41.53"
"64","000","00","014","1407","1712","666","506","160","53","719","1214","0","59.23","41.68"
"64","000","00","014","1407","1713","725","545","180","79","804","1258","0","63.91","43.32"
"64","000","00","014","1407","1714","708","525","183","42","750","1323","0","56.69","39.68"
"64","000","00","014","1408","0000","1276","906","370","132","1408","2288","0","61.54","39.6"
"64","000","00","014","1408","1715","697","556","141","57","754","1253","0","60.18","44.37"
"64","000","00","014","1408","1716","579","350","229","75","654","1035","0","63.19","33.82"
"64","000","00","014","1409","0000","5751","4441","1310","429","6180","10761","0","57.43","41.27"
"64","000","00","014","1409","1717","578","458","120","28","606","1106","0","54.79","41.41"
"64","000","00","014","1409","1718","638","494","144","46","684","1195","0","57.24","41.34"
"64","000","00","014","1409","1719","585","436","149","21","606","1051","0","57.66","41.48"
"64","000","00","014","1409","1720","765","581","184","86","851","1425","0","59.72","40.77"
"64","000","00","014","1409","1721","844","648","196","65","909","1635","0","55.6","39.63"
"64","000","00","014","1409","1722","738","542","196","68","806","1359","0","59.31","39.88"
"64","000","00","014","1409","1723","741","601","140","64","805","1361","0","59.15","44.16"
"64","000","00","014","1409","1724","862","681","181","51","913","1629","0","56.05","41.8"
"64","000","00","014","1410","0000","3967","3124","843","243","4210","7606","0","55.35","41.07"
"64","000","00","014","1410","1725","831","670","161","55","886","1518","0","58.37","44.14"
"64","000","00","014","1410","1726","849","645","204","71","920","1620","0","56.79","39.81"
"64","000","00","014","1410","1727","837","645","192","29","866","1648","0","52.55","39.14"
"64","000","00","014","1410","1728","738","592","146","52","790","1385","0","57.04","42.74"
"64","000","00","014","1410","1729","712","572","140","36","748","1435","0","52.13","39.86"
"64","000","00","014","1411","0000","918","698","220","65","983","1835","0","53.57","38.04"
"64","000","00","014","1411","1730","538","426","112","28","566","1046","0","54.11","40.73"
"64","000","00","014","1411","1731","380","272","108","37","417","789","0","52.85","34.47"
"64","000","00","014","1412","0000","844","617","227","81","925","1642","0","56.33","37.58"
"64","000","00","014","1412","1732","454","333","121","38","492","909","0","54.13","36.63"
"64","000","00","014","1412","1733","390","284","106","43","433","733","0","59.07","38.74"
"64","000","00","014","1413","0000","1238","1051","187","102","1340","2475","0","54.14","42.46"
"64","000","00","014","1413","1734","770","693","77","71","841","1553","0","54.15","44.62"
"64","000","00","014","1413","1735","468","358","110","31","499","922","0","54.12","38.83"
"64","000","00","014","1414","0000","1493","1077","416","183","1676","3001","0","55.85","35.89"
"64","000","00","014","1414","1736","515","385","130","71","586","1012","0","57.91","38.04"
"64","000","00","014","1414","1737","462","330","132","74","536","968","0","55.37","34.09"
"64","000","00","014","1414","1738","516","362","154","38","554","1021","0","54.26","35.46"
"64","000","00","014","1415","0000","674","517","157","79","753","1554","0","48.46","33.27"
"64","000","00","014","1415","1739","674","517","157","79","753","1554","0","48.46","33.27"
"64","000","00","014","1416","0000","3060","2389","671","238","3298","6101","0","54.06","39.16"
"64","000","00","014","1416","1740","610","474","136","75","685","1120","0","61.16","42.32"
"64","000","00","014","1416","1741","706","572","134","56","762","1225","0","62.2","46.69"
"64","000","00","014","1416","1742","486","383","103","25","511","1320","0","38.71","29.02"
"64","000","00","014","1416","1743","682","514","168","61","743","1317","0","56.42","39.03"
"64","000","00","014","1416","1744","576","446","130","21","597","1119","0","53.35","39.86"
"64","000","00","014","1417","0000","4240","3428","812","294","4534","7467","0","60.72","45.91"
"64","000","00","014","1417","1745","662","582","80","59","721","1190","0","60.59","48.91"
"64","000","00","014","1417","1746","703","566","137","54","757","1229","0","61.59","46.05"
"64","000","00","014","1417","1747","704","557","147","51","755","1178","0","64.09","47.28"
"64","000","00","014","1417","1748","757","587","170","35","792","1272","0","62.26","46.15"
"64","000","00","014","1417","1749","741","601","140","29","770","1413","0","54.49","42.53"
"64","000","00","014","1417","1750","673","535","138","66","739","1185","0","62.36","45.15"
"64","000","00","014","1418","0000","299","237","62","5","304","553","0","54.97","42.86"
"64","000","00","014","1418","1751","299","237","62","5","304","553","0","54.97","42.86"
"64","000","00","014","1419","0000","3661","2886","775","263","3924","6837","0","57.39","42.21"
"64","000","00","014","1419","1752","555","436","119","72","627","1121","0","55.93","38.89"
"64","000","00","014","1419","1753","631","487","144","46","677","1227","0","55.18","39.69"
"64","000","00","014","1419","1754","653","520","133","63","716","1058","0","67.67","49.15"
"64","000","00","014","1419","1755","661","520","141","34","695","1209","0","57.49","43.01"
"64","000","00","014","1419","1756","602","481","121","23","625","1100","0","56.82","43.73"
"64","000","00","014","1419","1757","559","442","117","25","584","1122","0","52.05","39.39"
"64","000","00","014","1420","0000","1131","854","277","108","1239","2175","0","56.97","39.26"
"64","000","00","014","1420","1758","564","424","140","76","640","983","0","65.11","43.13"
"64","000","00","014","1420","1759","567","430","137","32","599","1192","0","50.25","36.07"
"64","000","00","014","1421","0000","804","577","227","70","874","1548","0","56.46","37.27"
"64","000","00","014","1421","1760","352","249","103","37","389","719","0","54.1","34.63"
"64","000","00","014","1421","1761","452","328","124","33","485","829","0","58.5","39.57"
"64","000","00","014","1422","0000","1050","760","290","161","1211","1846","0","65.6","41.17"
"64","000","00","014","1422","1762","462","346","116","71","533","771","0","69.13","44.88"
"64","000","00","014","1422","1763","588","414","174","90","678","1075","0","63.07","38.51"
"64","000","00","014","1423","0000","1872","1413","459","230","2102","3669","0","57.29","38.51"
"64","000","00","014","1423","1764","691","528","163","88","779","1280","0","60.86","41.25"
"64","000","00","014","1423","1765","583","423","160","106","689","1179","0","58.44","35.88"
"64","000","00","014","1423","1766","598","462","136","36","634","1210","0","52.4","38.18"
"64","000","00","014","1424","0000","109","88","21","7","116","189","0","61.38","46.56"
"64","000","00","014","1424","1767","109","88","21","7","116","189","0","61.38","46.56"
"64","000","00","014","1425","0000","3718","2983","735","279","3997","6774","0","59.01","44.04"
"64","000","00","014","1425","1768","682","530","152","68","750","1228","0","61.07","43.16"
"64","000","00","014","1425","1769","620","490","130","50","670","1170","0","57.26","41.88"
"64","000","00","014","1425","1770","814","669","145","60","874","1416","0","61.72","47.25"
"64","000","00","014","1425","1771","849","677","172","33","882","1482","0","59.51","45.68"
"64","000","00","014","1425","1772","753","617","136","68","821","1478","0","55.55","41.75"
"64","000","00","015","0000","0000","18296","13972","4324","1704","20000","36772","42431","54.39","38.0"
"64","000","00","015","1501","0000","1535","1206","329","48","1583","2701","0","58.61","44.65"
"64","000","00","015","1501","0736","725","559","166","23","748","1386","0","53.97","40.33"
"64","000","00","015","1501","0737","810","647","163","25","835","1315","0","63.5","49.2"
"64","000","00","015","1502","0000","2521","2002","519","182","2703","5000","0","54.06","40.04"
"64","000","00","015","1502","0738","1248","985","263","69","1317","2461","0","53.51","40.02"
"64","000","00","015","1502","0739","637","510","127","35","672","1274","0","52.75","40.03"
"64","000","00","015","1502","0740","636","507","129","78","714","1265","0","56.44","40.08"
"64","000","00","015","1503","0000","2052","1537","515","173","2225","4126","0","53.93","37.25"
"64","000","00","015","1503","0741","777","576","201","78","855","1504","0","56.85","38.3"
"64","000","00","015","1503","0742","491","372","119","30","521","1049","0","49.67","35.46"
"64","000","00","015","1503","0743","784","589","195","65","849","1573","0","53.97","37.44"
"64","000","00","015","1504","0000","1126","876","250","101","1227","2328","0","52.71","37.63"
"64","000","00","015","1504","0744","483","376","107","41","524","1121","0","46.74","33.54"
"64","000","00","015","1504","0745","643","500","143","60","703","1207","0","58.24","41.43"
"64","000","00","015","1505","0000","1152","846","306","94","1246","2258","0","55.18","37.47"
"64","000","00","015","1505","0746","556","417","139","38","594","1134","0","52.38","36.77"
"64","000","00","015","1505","0747","596","429","167","56","652","1124","0","58.01","38.17"
"64","000","00","015","1506","0000","1825","1381","444","235","2060","3492","0","58.99","39.55"
"64","000","00","015","1506","0748","615","463","152","102","717","1259","0","56.95","36.78"
"64","000","00","015","1506","0749","627","478","149","65","692","1105","0","62.62","43.26"
"64","000","00","015","1506","0750","583","440","143","68","651","1128","0","57.71","39.01"
"64","000","00","015","1507","0000","488","360","128","99","587","1079","0","54.4","33.36"
"64","000","00","015","1507","0751","488","360","128","99","587","1079","0","54.4","33.36"
"64","000","00","015","1508","0000","452","339","113","52","504","1025","0","49.17","33.07"
"64","000","00","015","1508","0752","452","339","113","52","504","1025","0","49.17","33.07"
"64","000","00","015","1509","0000","464","342","122","65","529","950","0","55.68","36.0"
"64","000","00","015","1509","0753","464","342","122","65","529","950","0","55.68","36.0"
"64","000","00","015","1510","0000","714","525","189","99","813","1433","0","56.73","36.64"
"64","000","00","015","1510","0754","714","525","189","99","813","1433","0","56.73","36.64"
"64","000","00","015","1511","0000","630","471","159","39","669","1575","0","42.48","29.9"
"64","000","00","015","1511","0755","353","263","90","22","375","794","0","47.23","33.12"
"64","000","00","015","1511","0756","277","208","69","17","294","781","0","37.64","26.63"
"64","000","00","015","1512","0000","566","421","145","24","590","1318","0","44.76","31.94"
"64","000","00","015","1512","0757","566","421","145","24","590","1318","0","44.76","31.94"
"64","000","00","015","1513","0000","797","608","189","87","884","1783","0","49.58","34.1"
"64","000","00","015","1513","0758","354","266","88","51","405","736","0","55.03","36.14"
"64","000","00","015","1513","0759","443","342","101","36","479","1047","0","45.75","32.66"
"64","000","00","015","1514","0000","1183","843","340","119","1302","2457","0","52.99","34.31"
"64","000","00","015","1514","0760","671","478","193","75","746","1271","0","58.69","37.61"
"64","000","00","015","1514","0761","512","365","147","44","556","1186","0","46.88","30.78"
"64","000","00","015","1515","0000","525","392","133","56","581","1007","0","57.7","38.93"
"64","000","00","015","1515","0762","525","392","133","56","581","1007","0","57.7","38.93"
"64","000","00","015","1516","0000","771","589","182","78","849","1594","0","53.26","36.95"
"64","000","00","015","1516","0763","458","336","122","60","518","859","0","60.3","39.12"
"64","000","00","015","1516","0764","313","253","60","18","331","735","0","45.03","34.42"
"64","000","00","015","1517","0000","1158","963","195","131","1289","1926","0","66.93","50.0"
"64","000","00","015","1517","0765","556","421","135","82","638","1046","0","60.99","40.25"
"64","000","00","015","1517","0766","602","542","60","49","651","880","0","73.98","61.59"
"64","000","00","015","1518","0000","337","271","66","22","359","720","0","49.86","37.64"
"64","000","00","015","1518","0767","337","271","66","22","359","720","0","49.86","37.64"
"64","000","00","016","0000","0000","15652","11744","3908","1396","17048","30046","34591","56.74","39.09"
"64","000","00","016","1601","0000","455","341","114","80","535","950","0","56.32","35.89"
"64","000","00","016","1601","0637","455","341","114","80","535","950","0","56.32","35.89"
"64","000","00","016","1602","0000","1404","1138","266","82","1486","3162","0","47.0","35.99"
"64","000","00","016","1602","0638","616","482","134","45","661","1306","0","50.61","36.91"
"64","000","00","016","1602","0639","788","656","132","37","825","1856","0","44.45","35.34"
"64","000","00","016","1603","0000","2681","2006","675","258","2939","4968","0","59.16","40.38"
"64","000","00","016","1603","0640","571","423","148","63","634","986","0","64.3","42.9"
"64","000","00","016","1603","0641","514","381","133","59","573","1116","0","51.34","34.14"
"64","000","00","016","1603","0642","719","518","201","87","806","1253","0","64.33","41.34"
"64","000","00","016","1603","0643","877","684","193","49","926","1613","0","57.41","42.41"
"64","000","00","016","1604","0000","818","595","223","52","870","1679","0","51.82","35.44"
"64","000","00","016","1604","0659","316","219","97","16","332","745","0","44.56","29.4"
"64","000","00","016","1604","0660","502","376","126","36","538","934","0","57.6","40.26"
"64","000","00","016","1605","0000","1383","1053","330","126","1509","2661","0","56.71","39.57"
"64","000","00","016","1605","0646","544","430","114","64","608","1004","0","60.56","42.83"
"64","000","00","016","1605","0647","458","349","109","42","500","879","0","56.88","39.7"
"64","000","00","016","1605","0648","381","274","107","20","401","778","0","51.54","35.22"
"64","000","00","016","1606","0000","3028","2161","867","276","3304","5391","0","61.29","40.09"
"64","000","00","016","1606","0649","618","438","180","58","676","1110","0","60.9","39.46"
"64","000","00","016","1606","0650","742","548","194","66","808","1432","0","56.42","38.27"
"64","000","00","016","1606","0651","797","606","191","52","849","1466","0","57.91","41.34"
"64","000","00","016","1606","0652","871","569","302","100","971","1383","0","70.21","41.14"
"64","000","00","016","1607","0000","2541","1940","601","230","2771","4950","0","55.98","39.19"
"64","000","00","016","1607","0653","892","680","212","85","977","1645","0","59.39","41.34"
"64","000","00","016","1607","0654","720","549","171","66","786","1555","0","50.55","35.31"
"64","000","00","016","1607","0655","929","711","218","79","1008","1750","0","57.6","40.63"
"64","000","00","016","1608","0000","1689","1276","413","191","1880","3156","0","59.57","40.43"
"64","000","00","016","1608","0656","583","441","142","68","651","1111","0","58.6","39.69"
"64","000","00","016","1608","0657","618","460","158","75","693","1133","0","61.17","40.6"
"64","000","00","016","1608","0658","488","375","113","48","536","912","0","58.77","41.12"
"64","000","00","016","1609","0000","1653","1234","419","101","1754","3129","0","56.06","39.44"
"64","000","00","016","1609","0644","719","546","173","53","772","1455","0","53.06","37.53"
"64","000","00","016","1609","0645","934","688","246","48","982","1674","0","58.66","41.1"
"64","000","00","017","0000","0000","39654","30858","8796","2570","42224","73611","87415","57.36","41.92"
"64","000","00","017","1701","0000","2350","1924","426","146","2496","4050","0","61.63","47.51"
"64","000","00","017","1701","0661","1051","822","229","57","1108","1777","0","62.35","46.26"
"64","000","00","017","1701","0662","1299","1102","197","89","1388","2273","0","61.06","48.48"
"64","000","00","017","1702","0000","4363","3395","968","260","4623","7511","0","61.55","45.2"
"64","000","00","017","1702","0663","835","634","201","75","910","1384","0","65.75","45.81"
"64","000","00","017","1702","0664","628","477","151","60","688","1170","0","58.8","40.77"
"64","000","00","017","1702","0665","747","558","189","67","814","1216","0","66.94","45.89"
"64","000","00","017","1702","0666","867","674","193","21","888","1598","0","55.57","42.18"
"64","000","00","017","1702","0667","1286","1052","234","37","1323","2143","0","61.74","49.09"
"64","000","00","017","1703","0000","1421","1079","342","138","1559","2638","0","59.1","40.9"
"64","000","00","017","1703","0668","686","528","158","60","746","1300","0","57.38","40.62"
"64","000","00","017","1703","0669","735","551","184","78","813","1338","0","60.76","41.18"
"64","000","00","017","1704","0000","1837","1409","428","138","1975","3823","0","51.66","36.86"
"64","000","00","017","1704","0670","613","455","158","27","640","1217","0","52.59","37.39"
"64","000","00","017","1704","0671","550","423","127","65","615","1202","0","51.16","35.19"
"64","000","00","017","1704","0672","674","531","143","46","720","1404","0","51.28","37.82"
"64","000","00","017","1705","0000","426","324","102","54","480","830","0","57.83","39.04"
"64","000","00","017","1705","0673","426","324","102","54","480","830","0","57.83","39.04"
"64","000","00","017","1706","0000","2443","1863","580","161","2604","5417","0","48.07","34.39"
"64","000","00","017","1706","0674","733","567","166","41","774","1802","0","42.95","31.47"
"64","000","00","017","1706","0675","930","718","212","72","1002","1877","0","53.38","38.25"
"64","000","00","017","1706","0676","780","578","202","48","828","1738","0","47.64","33.26"
"64","000","00","017","1707","0000","4624","3608","1016","290","4914","8679","0","56.62","41.57"
"64","000","00","017","1707","0677","795","605","190","53","848","1549","0","54.74","39.06"
"64","000","00","017","1707","0678","851","674","177","77","928","1579","0","58.77","42.69"
"64","000","00","017","1707","0679","695","550","145","51","746","1406","0","53.06","39.12"
"64","000","00","017","1707","0680","790","658","132","35","825","1461","0","56.47","45.04"
"64","000","00","017","1707","0681","773","568","205","47","820","1311","0","62.55","43.33"
"64","000","00","017","1707","0682","720","553","167","27","747","1373","0","54.41","40.28"
"64","000","00","017","1708","0000","1054","730","324","69","1123","2216","0","50.68","32.94"
"64","000","00","017","1708","0683","470","325","145","22","492","1035","0","47.54","31.4"
"64","000","00","017","1708","0684","584","405","179","47","631","1181","0","53.43","34.29"
"64","000","00","017","1709","0000","9003","7136","1867","484","9487","15899","0","59.67","44.88"
"64","000","00","017","1709","0685","843","658","185","53","896","1670","0","53.65","39.4"
"64","000","00","017","1709","0686","808","624","184","42","850","1576","0","53.93","39.59"
"64","000","00","017","1709","0687","904","714","190","74","978","1576","0","62.06","45.3"
"64","000","00","017","1709","0688","1127","882","245","45","1172","1915","0","61.2","46.06"
"64","000","00","017","1709","0689","910","739","171","33","943","1758","0","53.64","42.04"
"64","000","00","017","1709","0690","1145","936","209","48","1193","1892","0","63.05","49.47"
"64","000","00","017","1709","0691","1145","895","250","76","1221","2025","0","60.3","44.2"
"64","000","00","017","1709","0692","1176","939","237","64","1240","2014","0","61.57","46.62"
"64","000","00","017","1709","0693","945","749","196","49","994","1473","0","67.48","50.85"
"64","000","00","017","1710","0000","974","760","214","66","1040","1923","0","54.08","39.52"
"64","000","00","017","1710","0694","472","366","106","39","511","979","0","52.2","37.39"
"64","000","00","017","1710","0695","502","394","108","27","529","944","0","56.04","41.74"
"64","000","00","017","1711","0000","1275","1003","272","140","1415","2481","0","57.03","40.43"
"64","000","00","017","1711","0696","609","476","133","98","707","1153","0","61.32","41.28"
"64","000","00","017","1711","0697","666","527","139","42","708","1328","0","53.31","39.68"
"64","000","00","017","1712","0000","909","699","210","85","994","1657","0","59.99","42.18"
"64","000","00","017","1712","0698","909","699","210","85","994","1657","0","59.99","42.18"
"64","000","00","017","1713","0000","2504","1904","600","203","2707","4564","0","59.31","41.72"
"64","000","00","017","1713","0699","742","570","172","76","818","1545","0","52.94","36.89"
"64","000","00","017","1713","0700","794","583","211","68","862","1417","0","60.83","41.14"
"64","000","00","017","1713","0701","968","751","217","59","1027","1602","0","64.11","46.88"
"64","000","00","017","1714","0000","2115","1607","508","121","2236","3737","0","59.83","43.0"
"64","000","00","017","1714","0702","1092","844","248","76","1168","1823","0","64.07","46.3"
"64","000","00","017","1714","0703","1023","763","260","45","1068","1914","0","55.8","39.86"
"64","000","00","017","1715","0000","3256","2567","689","159","3415","6019","0","56.74","42.65"
"64","000","00","017","1715","0704","1085","856","229","60","1145","1992","0","57.48","42.97"
"64","000","00","017","1715","0705","1022","806","216","45","1067","2045","0","52.18","39.41"
"64","000","00","017","1715","0706","1149","905","244","54","1203","1982","0","60.7","45.66"
"64","000","00","017","1716","0000","1100","850","250","56","1156","2167","0","53.35","39.22"
"64","000","00","017","1716","0707","1100","850","250","56","1156","2167","0","53.35","39.22"
"64","000","00","018","0000","0000","21902","16620","5282","1550","23452","39191","44387","59.84","42.41"
"64","000","00","018","1801","0000","5424","4081","1343","377","5801","10030","0","57.84","40.69"
"64","000","00","018","1801","0708","920","692","228","62","982","1678","0","58.52","41.24"
"64","000","00","018","1801","0709","838","648","190","75","913","1682","0","54.28","38.53"
"64","000","00","018","1801","0710","689","530","159","58","747","1225","0","60.98","43.27"
"64","000","00","018","1801","0711","669","501","168","62","731","1322","0","55.3","37.9"
"64","000","00","018","1801","0712","686","528","158","47","733","1215","0","60.33","43.46"
"64","000","00","018","1801","0713","913","679","234","50","963","1779","0","54.13","38.17"
"64","000","00","018","1801","0714","709","503","206","23","732","1129","0","64.84","44.55"
"64","000","00","018","1802","0000","2679","2012","667","161","2840","4682","0","60.66","42.97"
"64","000","00","018","1802","0715","791","625","166","64","855","1374","0","62.23","45.49"
"64","000","00","018","1802","0716","591","424","167","35","626","1089","0","57.48","38.93"
"64","000","00","018","1802","0717","1297","963","334","62","1359","2219","0","61.24","43.4"
"64","000","00","018","1803","0000","5755","4364","1391","313","6068","9817","0","61.81","44.45"
"64","000","00","018","1803","0718","889","662","227","35","924","1634","0","56.55","40.51"
"64","000","00","018","1803","0719","917","713","204","69","986","1553","0","63.49","45.91"
"64","000","00","018","1803","0720","941","729","212","53","994","1572","0","63.23","46.37"
"64","000","00","018","1803","0721","1009","752","257","52","1061","1688","0","62.86","44.55"
"64","000","00","018","1803","0722","944","690","254","38","982","1626","0","60.39","42.44"
"64","000","00","018","1803","0723","1055","818","237","66","1121","1744","0","64.28","46.9"
"64","000","00","018","1804","0000","1968","1513","455","201","2169","3548","0","61.13","42.64"
"64","000","00","018","1804","0724","618","471","147","61","679","1230","0","55.2","38.29"
"64","000","00","018","1804","0725","680","525","155","94","774","1201","0","64.45","43.71"
"64","000","00","018","1804","0726","670","517","153","46","716","1117","0","64.1","46.28"
"64","000","00","018","1805","0000","3360","2561","799","296","3656","6462","0","56.58","39.63"
"64","000","00","018","1805","0727","639","484","155","77","716","1255","0","57.05","38.57"
"64","000","00","018","1805","0728","684","527","157","49","733","1432","0","51.19","36.8"
"64","000","00","018","1805","0729","665","504","161","38","703","1370","0","51.31","36.79"
"64","000","00","018","1805","0730","774","601","173","76","850","1364","0","62.32","44.06"
"64","000","00","018","1805","0731","598","445","153","56","654","1041","0","62.82","42.75"
"64","000","00","018","1806","0000","471","360","111","40","511","702","0","72.79","51.28"
"64","000","00","018","1806","0732","471","360","111","40","511","702","0","72.79","51.28"
"64","000","00","018","1807","0000","2245","1729","516","162","2407","3950","0","60.94","43.77"
"64","000","00","018","1807","0733","664","469","195","67","731","1212","0","60.31","38.7"
"64","000","00","018","1807","0734","688","563","125","63","751","1289","0","58.26","43.68"
"64","000","00","018","1807","0735","893","697","196","32","925","1449","0","63.84","48.1"
"64","000","00","019","0000","0000","45717","35934","9783","3433","49150","81244","97072","60.5","44.23"
"64","000","00","019","1901","0000","693","515","178","74","767","1159","0","66.18","44.43"
"64","000","00","019","1901","0268","693","515","178","74","767","1159","0","66.18","44.43"
"64","000","00","019","1902","0000","2364","1855","509","157","2521","4358","0","57.85","42.57"
"64","000","00","019","1902","0261","808","646","162","64","872","1345","0","64.83","48.03"
"64","000","00","019","1902","0262","440","327","113","27","467","1045","0","44.69","31.29"
"64","000","00","019","1902","0263","592","473","119","46","638","1051","0","60.7","45.0"
"64","000","00","019","1902","0264","524","409","115","20","544","917","0","59.32","44.6"
"64","000","00","019","1903","0000","1957","1567","390","135","2092","3239","0","64.59","48.38"
"64","000","00","019","1903","0265","567","446","121","35","602","934","0","64.45","47.75"
"64","000","00","019","1903","0266","634","511","123","54","688","1097","0","62.72","46.58"
"64","000","00","019","1903","0267","756","610","146","46","802","1208","0","66.39","50.5"
"64","000","00","019","1904","0000","554","416","138","69","623","1018","0","61.2","40.86"
"64","000","00","019","1904","0269","554","416","138","69","623","1018","0","61.2","40.86"
"64","000","00","019","1905","0000","2235","1799","436","97","2332","4091","0","57.0","43.97"
"64","000","00","019","1905","0274","668","533","135","39","707","1328","0","53.24","40.14"
"64","000","00","019","1905","0275","775","614","161","25","800","1382","0","57.89","44.43"
"64","000","00","019","1905","0276","792","652","140","33","825","1381","0","59.74","47.21"
"64","000","00","019","1906","0000","606","471","135","44","650","1316","0","49.39","35.79"
"64","000","00","019","1906","0270","606","471","135","44","650","1316","0","49.39","35.79"
"64","000","00","019","1907","0000","1764","1504","260","75","1839","2895","0","63.52","51.95"
"64","000","00","019","1907","0325","779","663","116","40","819","1336","0","61.3","49.63"
"64","000","00","019","1907","0326","740","663","77","21","761","1218","0","62.48","54.43"
"64","000","00","019","1907","0327","245","178","67","14","259","341","0","75.95","52.2"
"64","000","00","019","1908","0000","226","176","50","14","240","318","0","75.47","55.35"
"64","000","00","019","1908","0332","226","176","50","14","240","318","0","75.47","55.35"
"64","000","00","019","1909","0000","1505","1191","314","98","1603","2795","0","57.35","42.61"
"64","000","00","019","1909","0293","721","566","155","55","776","1283","0","60.48","44.12"
"64","000","00","019","1909","0294","784","625","159","43","827","1512","0","54.7","41.34"
"64","000","00","019","1910","0000","682","505","177","24","706","1413","0","49.96","35.74"
"64","000","00","019","1910","0309","682","505","177","24","706","1413","0","49.96","35.74"
"64","000","00","019","1911","0000","2061","1594","467","190","2251","3607","0","62.41","44.19"
"64","000","00","019","1911","0304","728","584","144","51","779","1272","0","61.24","45.91"
"64","000","00","019","1911","0305","636","491","145","56","692","1080","0","64.07","45.46"
"64","000","00","019","1911","0306","697","519","178","83","780","1255","0","62.15","41.35"
"64","000","00","019","1912","0000","3168","2469","699","246","3414","5535","0","61.68","44.61"
"64","000","00","019","1912","0300","776","592","184","59","835","1360","0","61.4","43.53"
"64","000","00","019","1912","0301","787","605","182","47","834","1363","0","61.19","44.39"
"64","000","00","019","1912","0302","809","637","172","67","876","1352","0","64.79","47.12"
"64","000","00","019","1912","0303","796","635","161","73","869","1460","0","59.52","43.49"
"64","000","00","019","1913","0000","1047","865","182","63","1110","1613","0","68.82","53.63"
"64","000","00","019","1913","0330","530","425","105","45","575","851","0","67.57","49.94"
"64","000","00","019","1913","0331","517","440","77","18","535","762","0","70.21","57.74"
"64","000","00","019","1914","0000","430","310","120","82","512","756","0","67.72","41.01"
"64","000","00","019","1914","0320","430","310","120","82","512","756","0","67.72","41.01"
"64","000","00","019","1915","0000","356","277","79","22","378","866","0","43.65","31.99"
"64","000","00","019","1915","0323","356","277","79","22","378","866","0","43.65","31.99"
"64","000","00","019","1916","0000","1841","1448","393","150","1991","3350","0","59.43","43.22"
"64","000","00","019","1916","0297","614","464","150","65","679","1096","0","61.95","42.34"
"64","000","00","019","1916","0298","599","471","128","49","648","1066","0","60.79","44.18"
"64","000","00","019","1916","0299","628","513","115","36","664","1188","0","55.89","43.18"
"64","000","00","019","1917","0000","2098","1650","448","155","2253","3849","0","58.53","42.87"
"64","000","00","019","1917","0277","697","552","145","72","769","1282","0","59.98","43.06"
"64","000","00","019","1917","0278","672","508","164","18","690","1240","0","55.65","40.97"
"64","000","00","019","1917","0279","729","590","139","65","794","1327","0","59.83","44.46"
"64","000","00","019","1918","0000","2277","1831","446","137","2414","4065","0","59.38","45.04"
"64","000","00","019","1918","0271","736","613","123","35","771","1345","0","57.32","45.58"
"64","000","00","019","1918","0272","750","597","153","53","803","1295","0","62.01","46.1"
"64","000","00","019","1918","0273","791","621","170","49","840","1425","0","58.95","43.58"
"64","000","00","019","1919","0000","3462","2721","741","269","3731","6674","0","55.9","40.77"
"64","000","00","019","1919","0280","883","701","182","68","951","1736","0","54.78","40.38"
"64","000","00","019","1919","0281","878","670","208","68","946","1566","0","60.41","42.78"
"64","000","00","019","1919","0282","817","648","169","50","867","1779","0","48.74","36.42"
"64","000","00","019","1919","0283","884","702","182","83","967","1593","0","60.7","44.07"
"64","000","00","019","1920","0000","3154","2454","700","227","3381","5402","0","62.59","45.43"
"64","000","00","019","1920","0284","846","660","186","72","918","1480","0","62.03","44.59"
"64","000","00","019","1920","0285","777","610","167","36","813","1364","0","59.6","44.72"
"64","000","00","019","1920","0286","804","620","184","58","862","1410","0","61.13","43.97"
"64","000","00","019","1920","0287","727","564","163","61","788","1148","0","68.64","49.13"
"64","000","00","019","1921","0000","1062","804","258","67","1129","1830","0","61.69","43.93"
"64","000","00","019","1921","0289","553","425","128","44","597","969","0","61.61","43.86"
"64","000","00","019","1921","0290","509","379","130","23","532","861","0","61.79","44.02"
"64","000","00","019","1922","0000","1062","814","248","50","1112","1808","0","61.5","45.02"
"64","000","00","019","1922","0310","419","317","102","15","434","765","0","56.73","41.44"
"64","000","00","019","1922","0311","643","497","146","35","678","1043","0","65.0","47.65"
"64","000","00","019","1923","0000","1083","846","237","83","1166","1837","0","63.47","46.05"
"64","000","00","019","1923","0312","396","327","69","40","436","844","0","51.66","38.74"
"64","000","00","019","1923","0313","687","519","168","43","730","993","0","73.51","52.27"
"64","000","00","019","1924","0000","599","460","139","71","670","1038","0","64.55","44.32"
"64","000","00","019","1924","0314","599","460","139","71","670","1038","0","64.55","44.32"
"64","000","00","019","1925","0000","940","718","222","87","1027","1712","0","59.99","41.94"
"64","000","00","019","1925","0291","414","321","93","19","433","823","0","52.61","39.0"
"64","000","00","019","1925","0292","526","397","129","68","594","889","0","66.82","44.66"
"64","000","00","019","1926","0000","1919","1439","480","189","2108","3442","0","61.24","41.81"
"64","000","00","019","1926","0315","580","435","145","78","658","1070","0","61.5","40.65"
"64","000","00","019","1926","0316","604","445","159","80","684","1023","0","66.86","43.5"
"64","000","00","019","1926","0317","735","559","176","31","766","1349","0","56.78","41.44"
"64","000","00","019","1927","0000","916","695","221","64","980","1753","0","55.9","39.65"
"64","000","00","019","1927","0318","729","568","161","48","777","1452","0","53.51","39.12"
"64","000","00","019","1927","0319","187","127","60","16","203","301","0","67.44","42.19"
"64","000","00","019","1928","0000","849","634","215","118","967","1587","0","60.93","39.95"
"64","000","00","019","1928","0321","335","249","86","20","355","733","0","48.43","33.97"
"64","000","00","019","1928","0322","514","385","129","98","612","854","0","71.66","45.08"
"64","000","00","019","1929","0000","510","398","112","58","568","978","0","58.08","40.7"
"64","000","00","019","1929","0324","510","398","112","58","568","978","0","58.08","40.7"
"64","000","00","019","1930","0000","1295","1018","277","125","1420","2175","0","65.29","46.8"
"64","000","00","019","1930","0307","565","446","119","63","628","938","0","66.95","47.55"
"64","000","00","019","1930","0308","730","572","158","62","792","1237","0","64.03","46.24"
"64","000","00","019","1931","0000","360","264","96","46","406","625","0","64.96","42.24"
"64","000","00","019","1931","0288","360","264","96","46","406","625","0","64.96","42.24"
"64","000","00","019","1932","0000","1321","1033","288","104","1425","2245","0","63.47","46.01"
"64","000","00","019","1932","0295","610","462","148","62","672","983","0","68.36","47.0"
"64","000","00","019","1932","0296","711","571","140","42","753","1262","0","59.67","45.25"
"64","000","00","019","1933","0000","1321","1193","128","43","1364","1895","0","71.98","62.96"
"64","000","00","019","1933","0328","682","617","65","32","714","955","0","74.76","64.61"
"64","000","00","019","1933","0329","639","576","63","11","650","940","0","69.15","61.28"
"64","000","00","020","0000","0000","17973","13650","4323","1929","19902","32565","37647","61.11","41.92"
"64","000","00","020","2001","0000","1208","914","294","127","1335","2078","0","64.24","43.98"
"64","000","00","020","2001","0404","576","431","145","79","655","1005","0","65.17","42.89"
"64","000","00","020","2001","0405","632","483","149","48","680","1073","0","63.37","45.01"
"64","000","00","020","2002","0000","598","427","171","50","648","1129","0","57.4","37.82"
"64","000","00","020","2002","0406","598","427","171","50","648","1129","0","57.4","37.82"
"64","000","00","020","2003","0000","1271","993","278","129","1400","2335","0","59.96","42.53"
"64","000","00","020","2003","0407","700","552","148","81","781","1244","0","62.78","44.37"
"64","000","00","020","2003","0408","571","441","130","48","619","1091","0","56.74","40.42"
"64","000","00","020","2004","0000","1461","1116","345","103","1564","2469","0","63.35","45.2"
"64","000","00","020","2004","0409","806","634","172","52","858","1329","0","64.56","47.71"
"64","000","00","020","2004","0410","655","482","173","51","706","1140","0","61.93","42.28"
"64","000","00","020","2005","0000","664","476","188","86","750","1220","0","61.48","39.02"
"64","000","00","020","2005","0411","664","476","188","86","750","1220","0","61.48","39.02"
"64","000","00","020","2006","0000","1316","988","328","182","1498","2362","0","63.42","41.83"
"64","000","00","020","2006","0412","639","477","162","72","711","1047","0","67.91","45.56"
"64","000","00","020","2006","0413","677","511","166","110","787","1315","0","59.85","38.86"
"64","000","00","020","2007","0000","761","577","184","106","867","1411","0","61.45","40.89"
"64","000","00","020","2007","0414","352","263","89","37","389","691","0","56.3","38.06"
"64","000","00","020","2007","0415","409","314","95","69","478","720","0","66.39","43.61"
"64","000","00","020","2008","0000","1807","1358","449","264","2071","3271","0","63.31","41.52"
"64","000","00","020","2008","0416","643","471","172","98","741","1192","0","62.16","39.51"
"64","000","00","020","2008","0417","735","556","179","104","839","1318","0","63.66","42.19"
"64","000","00","020","2008","0418","429","331","98","62","491","761","0","64.52","43.5"
"64","000","00","020","2009","0000","849","644","205","69","918","1560","0","58.85","41.28"
"64","000","00","020","2009","0419","520","396","124","35","555","973","0","57.04","40.7"
"64","000","00","020","2009","0420","329","248","81","34","363","587","0","61.84","42.25"
"64","000","00","020","2010","0000","1461","1112","349","94","1555","2421","0","64.23","45.93"
"64","000","00","020","2010","0421","472","346","126","55","527","812","0","64.9","42.61"
"64","000","00","020","2010","0422","204","139","65","9","213","343","0","62.1","40.52"
"64","000","00","020","2010","0423","785","627","158","30","815","1266","0","64.38","49.53"
"64","000","00","020","2011","0000","1148","867","281","156","1304","2012","0","64.81","43.09"
"64","000","00","020","2011","0424","647","496","151","93","740","1128","0","65.6","43.97"
"64","000","00","020","2011","0425","501","371","130","63","564","884","0","63.8","41.97"
"64","000","00","020","2012","0000","1288","998","290","177","1465","2446","0","59.89","40.8"
"64","000","00","020","2012","0426","599","474","125","91","690","1187","0","58.13","39.93"
"64","000","00","020","2012","0427","689","524","165","86","775","1259","0","61.56","41.62"
"64","000","00","020","2013","0000","671","515","156","80","751","1361","0","55.18","37.84"
"64","000","00","020","2013","0428","671","515","156","80","751","1361","0","55.18","37.84"
"64","000","00","020","2014","0000","320","256","64","37","357","671","0","53.2","38.15"
"64","000","00","020","2014","0429","320","256","64","37","357","671","0","53.2","38.15"
"64","000","00","020","2015","0000","2147","1652","495","224","2371","3689","0","64.27","44.78"
"64","000","00","020","2015","0430","718","548","170","61","779","1215","0","64.12","45.1"
"64","000","00","020","2015","0431","701","530","171","93","794","1255","0","63.27","42.23"
"64","000","00","020","2015","0432","728","574","154","70","798","1219","0","65.46","47.09"
"64","000","00","020","2016","0000","713","547","166","34","747","1372","0","54.45","39.87"
"64","000","00","020","2016","0433","713","547","166","34","747","1372","0","54.45","39.87"
"64","000","00","020","2017","0000","290","210","80","11","301","758","0","39.71","27.7"
"64","000","00","020","2017","0434","290","210","80","11","301","758","0","39.71","27.7"
"64","000","00","021","0000","0000","13182","10042","3140","1444","14626","26012","29809","56.23","38.61"
"64","000","00","021","2101","0000","573","443","130","93","666","1152","0","57.81","38.45"
"64","000","00","021","2101","0333","573","443","130","93","666","1152","0","57.81","38.45"
"64","000","00","021","2102","0000","1181","912","269","94","1275","2094","0","60.89","43.55"
"64","000","00","021","2102","0334","604","465","139","30","634","1120","0","56.61","41.52"
"64","000","00","021","2102","0335","577","447","130","64","641","974","0","65.81","45.89"
"64","000","00","021","2103","0000","1463","1112","351","142","1605","3353","0","47.87","33.16"
"64","000","00","021","2103","0336","514","396","118","23","537","1019","0","52.7","38.86"
"64","000","00","021","2103","0337","515","391","124","82","597","1058","0","56.43","36.96"
"64","000","00","021","2103","0338","397","295","102","33","430","1017","0","42.28","29.01"
"64","000","00","021","2103","0339","37","30","7","4","41","259","0","15.83","11.58"
"64","000","00","021","2104","0000","1483","1120","363","153","1636","2652","0","61.69","42.23"
"64","000","00","021","2104","0340","547","421","126","66","613","926","0","66.2","45.46"
"64","000","00","021","2104","0341","287","207","80","19","306","624","0","49.04","33.17"
"64","000","00","021","2104","0342","649","492","157","68","717","1102","0","65.06","44.65"
"64","000","00","021","2105","0000","1234","925","309","114","1348","2433","0","55.4","38.02"
"64","000","00","021","2105","0343","529","413","116","48","577","1072","0","53.82","38.53"
"64","000","00","021","2105","0344","705","512","193","66","771","1361","0","56.65","37.62"
"64","000","00","021","2106","0000","255","193","62","31","286","472","0","60.59","40.89"
"64","000","00","021","2106","0345","255","193","62","31","286","472","0","60.59","40.89"
"64","000","00","021","2107","0000","1216","915","301","160","1376","2331","0","59.03","39.25"
"64","000","00","021","2107","0346","578","444","134","63","641","1197","0","53.55","37.09"
"64","000","00","021","2107","0347","638","471","167","97","735","1134","0","64.81","41.53"
"64","000","00","021","2108","0000","1954","1513","441","180","2134","3757","0","56.8","40.27"
"64","000","00","021","2108","0348","557","423","134","48","605","1148","0","52.7","36.85"
"64","000","00","021","2108","0349","577","463","114","77","654","1207","0","54.18","38.36"
"64","000","00","021","2108","0350","820","627","193","55","875","1402","0","62.41","44.72"
"64","000","00","021","2109","0000","1804","1366","438","226","2030","3401","0","59.69","40.16"
"64","000","00","021","2109","0351","533","397","136","73","606","1000","0","60.6","39.7"
"64","000","00","021","2109","0352","601","458","143","78","679","1110","0","61.17","41.26"
"64","000","00","021","2109","0353","670","511","159","75","745","1291","0","57.71","39.58"
"64","000","00","021","2110","0000","897","666","231","155","1052","1895","0","55.51","35.15"
"64","000","00","021","2110","0354","405","288","117","80","485","797","0","60.85","36.14"
"64","000","00","021","2110","0355","492","378","114","75","567","1098","0","51.64","34.43"
"64","000","00","021","2111","0000","1122","877","245","96","1218","2472","0","49.27","35.48"
"64","000","00","021","2111","0356","679","524","155","73","752","1393","0","53.98","37.62"
"64","000","00","021","2111","0357","443","353","90","23","466","1079","0","43.19","32.72"
"64","000","00","022","0000","0000","2727","2021","706","358","3085","6671","7196","46.24","30.3"
"64","000","00","022","2201","0000","136","100","36","6","142","369","0","38.48","27.1"
"64","000","00","022","2201","0237","136","100","36","6","142","369","0","38.48","27.1"
"64","000","00","022","2202","0000","348","270","78","37","385","1062","0","36.25","25.42"
"64","000","00","022","2202","0238","241","196","45","28","269","656","0","41.01","29.88"
"64","000","00","022","2202","0239","107","74","33","9","116","406","0","28.57","18.23"
"64","000","00","022","2203","0000","168","117","51","20","188","380","0","49.47","30.79"
"64","000","00","022","2203","0240","168","117","51","20","188","380","0","49.47","30.79"
"64","000","00","022","2204","0000","178","137","41","13","191","379","0","50.4","36.15"
"64","000","00","022","2204","0241","178","137","41","13","191","379","0","50.4","36.15"
"64","000","00","022","2205","0000","298","207","91","58","356","625","0","56.96","33.12"
"64","000","00","022","2205","0242","298","207","91","58","356","625","0","56.96","33.12"
"64","000","00","022","2206","0000","405","323","82","29","434","946","0","45.88","34.14"
"64","000","00","022","2206","0243","405","323","82","29","434","946","0","45.88","34.14"
"64","000","00","022","2207","0000","326","241","85","49","375","794","0","47.23","30.35"
"64","000","00","022","2207","0244","326","241","85","49","375","794","0","47.23","30.35"
"64","000","00","022","2208","0000","149","110","39","19","168","382","0","43.98","28.8"
"64","000","00","022","2208","0245","149","110","39","19","168","382","0","43.98","28.8"
"64","000","00","022","2209","0000","147","105","42","51","198","513","0","38.6","20.47"
"64","000","00","022","2209","0246","147","105","42","51","198","513","0","38.6","20.47"
"64","000","00","022","2210","0000","572","411","161","76","648","1221","0","53.07","33.66"
"64","000","00","022","2210","0247","269","197","72","22","291","601","0","48.42","32.78"
"64","000","00","022","2210","0248","303","214","89","54","357","620","0","57.58","34.52"
"64","000","00","023","0000","0000","11981","9103","2878","954","12935","24534","28676","52.72","37.1"
"64","000","00","023","2301","0000","563","413","150","35","598","1299","0","46.04","31.79"
"64","000","00","023","2301","0216","563","413","150","35","598","1299","0","46.04","31.79"
"64","000","00","023","2302","0000","947","708","239","60","1007","2005","0","50.22","35.31"
"64","000","00","023","2302","0217","542","415","127","30","572","1107","0","51.67","37.49"
"64","000","00","023","2302","0218","405","293","112","30","435","898","0","48.44","32.63"
"64","000","00","023","2303","0000","588","425","163","86","674","1259","0","53.53","33.76"
"64","000","00","023","2303","0219","588","425","163","86","674","1259","0","53.53","33.76"
"64","000","00","023","2304","0000","1064","836","228","63","1127","2143","0","52.59","39.01"
"64","000","00","023","2304","0220","759","601","158","52","811","1579","0","51.36","38.06"
"64","000","00","023","2304","0221","305","235","70","11","316","564","0","56.03","41.67"
"64","000","00","023","2305","0000","444","334","110","52","496","768","0","64.58","43.49"
"64","000","00","023","2305","0222","444","334","110","52","496","768","0","64.58","43.49"
"64","000","00","023","2306","0000","2477","1902","575","181","2658","4886","0","54.4","38.93"
"64","000","00","023","2306","0223","576","446","130","61","637","1092","0","58.33","40.84"
"64","000","00","023","2306","0224","564","409","155","61","625","1099","0","56.87","37.22"
"64","000","00","023","2306","0225","594","492","102","28","622","1134","0","54.85","43.39"
"64","000","00","023","2306","0226","743","555","188","31","774","1561","0","49.58","35.55"
"64","000","00","023","2307","0000","1308","948","360","143","1451","2649","0","54.78","35.79"
"64","000","00","023","2307","0227","797","571","226","103","900","1533","0","58.71","37.25"
"64","000","00","023","2307","0228","511","377","134","40","551","1116","0","49.37","33.78"
"64","000","00","023","2308","0000","1134","865","269","101","1235","2314","0","53.37","37.38"
"64","000","00","023","2308","0229","512","389","123","41","553","1054","0","52.47","36.91"
"64","000","00","023","2308","0230","622","476","146","60","682","1260","0","54.13","37.78"
"64","000","00","023","2309","0000","713","557","156","79","792","1504","0","52.66","37.03"
"64","000","00","023","2309","0231","713","557","156","79","792","1504","0","52.66","37.03"
"64","000","00","023","2310","0000","781","621","160","39","820","1671","0","49.07","37.16"
"64","000","00","023","2310","0232","379","292","87","19","398","848","0","46.93","34.43"
"64","000","00","023","2310","0233","402","329","73","20","422","823","0","51.28","39.98"
"64","000","00","023","2311","0000","529","422","107","28","557","1021","0","54.55","41.33"
"64","000","00","023","2311","0234","529","422","107","28","557","1021","0","54.55","41.33"
"64","000","00","023","2312","0000","1433","1072","361","87","1520","3015","0","50.41","35.56"
"64","000","00","023","2312","0235","805","600","205","33","838","1715","0","48.86","34.99"
"64","000","00","023","2312","0236","628","472","156","54","682","1300","0","52.46","36.31"
"64","000","00","024","0000","0000","23248","17739","5509","2307","25555","43850","52578","58.28","40.45"
"64","000","00","024","2401","0000","1658","1246","412","176","1834","3222","0","56.92","38.67"
"64","000","00","024","2401","0175","491","373","118","29","520","1026","0","50.68","36.35"
"64","000","00","024","2401","0176","548","418","130","77","625","1069","0","58.47","39.1"
"64","000","00","024","2401","0177","619","455","164","70","689","1127","0","61.14","40.37"
"64","000","00","024","2402","0000","583","454","129","81","664","1179","0","56.32","38.51"
"64","000","00","024","2402","0178","583","454","129","81","664","1179","0","56.32","38.51"
"64","000","00","024","2403","0000","597","452","145","105","702","1237","0","56.75","36.54"
"64","000","00","024","2403","0179","597","452","145","105","702","1237","0","56.75","36.54"
"64","000","00","024","2404","0000","589","451","138","67","656","1096","0","59.85","41.15"
"64","000","00","024","2404","0180","589","451","138","67","656","1096","0","59.85","41.15"
"64","000","00","024","2405","0000","719","557","162","82","801","1272","0","62.97","43.79"
"64","000","00","024","2405","0181","719","557","162","82","801","1272","0","62.97","43.79"
"64","000","00","024","2406","0000","1224","954","270","118","1342","2309","0","58.12","41.32"
"64","000","00","024","2406","0182","621","500","121","70","691","1182","0","58.46","42.3"
"64","000","00","024","2406","0183","603","454","149","48","651","1127","0","57.76","40.28"
"64","000","00","024","2407","0000","1113","856","257","120","1233","2088","0","59.05","41.0"
"64","000","00","024","2407","0184","510","415","95","61","571","956","0","59.73","43.41"
"64","000","00","024","2407","0185","603","441","162","59","662","1132","0","58.48","38.96"
"64","000","00","024","2408","0000","1679","1267","412","196","1875","3333","0","56.26","38.01"
"64","000","00","024","2408","0186","564","420","144","91","655","1025","0","63.9","40.98"
"64","000","00","024","2408","0187","491","362","129","31","522","1007","0","51.84","35.95"
"64","000","00","024","2408","0188","624","485","139","74","698","1301","0","53.65","37.28"
"64","000","00","024","2409","0000","1325","979","346","138","1463","2652","0","55.17","36.92"
"64","000","00","024","2409","0189","465","354","111","42","507","885","0","57.29","40.0"
"64","000","00","024","2409","0190","361","257","104","31","392","837","0","46.83","30.7"
"64","000","00","024","2409","0191","499","368","131","65","564","930","0","60.65","39.57"
"64","000","00","024","2410","0000","885","636","249","128","1013","1804","0","56.15","35.25"
"64","000","00","024","2410","0192","342","249","93","62","404","781","0","51.73","31.88"
"64","000","00","024","2410","0193","543","387","156","66","609","1023","0","59.53","37.83"
"64","000","00","024","2411","0000","1788","1376","412","154","1942","3400","0","57.12","40.47"
"64","000","00","024","2411","0194","952","758","194","85","1037","1763","0","58.82","42.99"
"64","000","00","024","2411","0195","836","618","218","69","905","1637","0","55.28","37.75"
"64","000","00","024","2412","0000","1159","900","259","134","1293","2247","0","57.54","40.05"
"64","000","00","024","2412","0196","533","407","126","52","585","1070","0","54.67","38.04"
"64","000","00","024","2412","0197","626","493","133","82","708","1177","0","60.15","41.89"
"64","000","00","024","2413","0000","1634","1248","386","138","1772","3050","0","58.1","40.92"
"64","000","00","024","2413","0198","541","413","128","51","592","1007","0","58.79","41.01"
"64","000","00","024","2413","0199","549","415","134","38","587","1026","0","57.21","40.45"
"64","000","00","024","2413","0200","544","420","124","49","593","1017","0","58.31","41.3"
"64","000","00","024","2414","0000","1278","992","286","113","1391","2353","0","59.12","42.16"
"64","000","00","024","2414","0201","677","528","149","55","732","1264","0","57.91","41.77"
"64","000","00","024","2414","0202","601","464","137","58","659","1089","0","60.51","42.61"
"64","000","00","024","2415","0000","454","338","116","39","493","851","0","57.93","39.72"
"64","000","00","024","2415","0203","454","338","116","39","493","851","0","57.93","39.72"
"64","000","00","024","2416","0000","1104","843","261","123","1227","1948","0","62.99","43.28"
"64","000","00","024","2416","0204","544","422","122","79","623","1011","0","61.62","41.74"
"64","000","00","024","2416","0205","560","421","139","44","604","937","0","64.46","44.93"
"64","000","00","024","2417","0000","910","662","248","50","960","1730","0","55.49","38.27"
"64","000","00","024","2417","0206","361","262","99","16","377","820","0","45.98","31.95"
"64","000","00","024","2417","0207","549","400","149","34","583","910","0","64.07","43.96"
"64","000","00","024","2418","0000","436","329","107","57","493","867","0","56.86","37.95"
"64","000","00","024","2418","0208","436","329","107","57","493","867","0","56.86","37.95"
"64","000","00","024","2419","0000","1479","1140","339","112","1591","2737","0","58.13","41.65"
"64","000","00","024","2419","0209","494","374","120","35","529","937","0","56.46","39.91"
"64","000","00","024","2419","0210","489","375","114","21","510","900","0","56.67","41.67"
"64","000","00","024","2419","0211","496","391","105","56","552","900","0","61.33","43.44"
"64","000","00","024","2420","0000","2634","2059","575","176","2810","4475","0","62.79","46.01"
"64","000","00","024","2420","0212","504","399","105","42","546","918","0","59.48","43.46"
"64","000","00","024","2420","0213","521","400","121","37","558","870","0","64.14","45.98"
"64","000","00","024","2420","0214","676","511","165","45","721","1150","0","62.7","44.43"
"64","000","00","024","2420","0215","933","749","184","52","985","1537","0","64.09","48.73"
"64","000","00","025","0000","0000","12853","9497","3356","1079","13932","25729","29812","54.15","36.91"
"64","000","00","025","2501","0000","510","373","137","41","551","1112","0","49.55","33.54"
"64","000","00","025","2501","0151","510","373","137","41","551","1112","0","49.55","33.54"
"64","000","00","025","2502","0000","483","355","128","94","577","1017","0","56.74","34.91"
"64","000","00","025","2502","0152","483","355","128","94","577","1017","0","56.74","34.91"
"64","000","00","025","2503","0000","365","266","99","30","395","796","0","49.62","33.42"
"64","000","00","025","2503","0153","365","266","99","30","395","796","0","49.62","33.42"
"64","000","00","025","2504","0000","1164","546","618","74","1238","2194","0","56.43","24.89"
"64","000","00","025","2504","0154","607","138","469","37","644","1079","0","59.68","12.79"
"64","000","00","025","2504","0155","557","408","149","37","594","1115","0","53.27","36.59"
"64","000","00","025","2505","0000","1271","996","275","85","1356","2630","0","51.56","37.87"
"64","000","00","025","2505","0156","638","484","154","42","680","1311","0","51.87","36.92"
"64","000","00","025","2505","0157","633","512","121","43","676","1319","0","51.25","38.82"
"64","000","00","025","2506","0000","2063","1649","414","201","2264","3634","0","62.3","45.38"
"64","000","00","025","2506","0158","713","559","154","71","784","1244","0","63.02","44.94"
"64","000","00","025","2506","0159","711","573","138","54","765","1227","0","62.35","46.7"
"64","000","00","025","2506","0160","639","517","122","76","715","1163","0","61.48","44.45"
"64","000","00","025","2507","0000","549","416","133","40","589","981","0","60.04","42.41"
"64","000","00","025","2507","0161","549","416","133","40","589","981","0","60.04","42.41"
"64","000","00","025","2508","0000","1963","1520","443","135","2098","3680","0","57.01","41.3"
"64","000","00","025","2508","0162","376","288","88","20","396","780","0","50.77","36.92"
"64","000","00","025","2508","0163","423","318","105","51","474","832","0","56.97","38.22"
"64","000","00","025","2508","0164","595","462","133","43","638","1017","0","62.73","45.43"
"64","000","00","025","2508","0165","569","452","117","21","590","1051","0","56.14","43.01"
"64","000","00","025","2509","0000","869","663","206","92","961","1804","0","53.27","36.75"
"64","000","00","025","2509","0166","448","337","111","37","485","941","0","51.54","35.81"
"64","000","00","025","2509","0167","421","326","95","55","476","863","0","55.16","37.78"
"64","000","00","025","2510","0000","575","428","147","55","630","1160","0","54.31","36.9"
"64","000","00","025","2510","0168","575","428","147","55","630","1160","0","54.31","36.9"
"64","000","00","025","2511","0000","1012","759","253","87","1099","2212","0","49.68","34.31"
"64","000","00","025","2511","0169","428","323","105","27","455","1090","0","41.74","29.63"
"64","000","00","025","2511","0170","584","436","148","60","644","1122","0","57.4","38.86"
"64","000","00","025","2512","0000","464","347","117","37","501","1123","0","44.61","30.9"
"64","000","00","025","2512","0171","464","347","117","37","501","1123","0","44.61","30.9"
"64","000","00","025","2513","0000","327","230","97","30","357","684","0","52.19","33.63"
"64","000","00","025","2513","0172","327","230","97","30","357","684","0","52.19","33.63"
"64","000","00","025","2514","0000","1238","949","289","78","1316","2702","0","48.7","35.12"
"64","000","00","025","2514","0173","576","430","146","25","601","1249","0","48.12","34.43"
"64","000","00","025","2514","0174","662","519","143","53","715","1453","0","49.21","35.72"
"64","000","00","026","0000","0000","12225","9093","3132","1502","13727","26212","30055","52.37","34.69"
"64","000","00","026","2601","0000","412","302","110","16","428","976","0","43.85","30.94"
"64","000","00","026","2601","0130","412","302","110","16","428","976","0","43.85","30.94"
"64","000","00","026","2602","0000","420","287","133","64","484","887","0","54.57","32.36"
"64","000","00","026","2602","0131","420","287","133","64","484","887","0","54.57","32.36"
"64","000","00","026","2603","0000","807","639","168","43","850","1710","0","49.71","37.37"
"64","000","00","026","2603","0132","807","639","168","43","850","1710","0","49.71","37.37"
"64","000","00","026","2604","0000","1831","1366","465","122","1953","3751","0","52.07","36.42"
"64","000","00","026","2604","0133","510","392","118","51","561","1280","0","43.83","30.63"
"64","000","00","026","2604","0134","678","495","183","38","716","1314","0","54.49","37.67"
"64","000","00","026","2604","0135","643","479","164","33","676","1157","0","58.43","41.4"
"64","000","00","026","2605","0000","860","652","208","124","984","1785","0","55.13","36.53"
"64","000","00","026","2605","0136","860","652","208","124","984","1785","0","55.13","36.53"
"64","000","00","026","2606","0000","532","360","172","75","607","1139","0","53.29","31.61"
"64","000","00","026","2606","0142","532","360","172","75","607","1139","0","53.29","31.61"
"64","000","00","026","2607","0000","1393","1053","340","290","1683","2961","0","56.84","35.56"
"64","000","00","026","2607","0143","639","496","143","119","758","1363","0","55.61","36.39"
"64","000","00","026","2607","0144","754","557","197","171","925","1598","0","57.88","34.86"
"64","000","00","026","2608","0000","366","273","93","50","416","925","0","44.97","29.51"
"64","000","00","026","2608","0146","366","273","93","50","416","925","0","44.97","29.51"
"64","000","00","026","2609","0000","528","382","146","66","594","1111","0","53.47","34.38"
"64","000","00","026","2609","0145","528","382","146","66","594","1111","0","53.47","34.38"
"64","000","00","026","2610","0000","546","418","128","68","614","1148","0","53.48","36.41"
"64","000","00","026","2610","0147","546","418","128","68","614","1148","0","53.48","36.41"
"64","000","00","026","2611","0000","1089","801","288","189","1278","2087","0","61.24","38.38"
"64","000","00","026","2611","0137","393","274","119","93","486","838","0","58.0","32.7"
"64","000","00","026","2611","0138","696","527","169","96","792","1249","0","63.41","42.19"
"64","000","00","026","2612","0000","504","380","124","103","607","1116","0","54.39","34.05"
"64","000","00","026","2612","0139","504","380","124","103","607","1116","0","54.39","34.05"
"64","000","00","026","2613","0000","415","302","113","56","471","978","0","48.16","30.88"
"64","000","00","026","2613","0140","415","302","113","56","471","978","0","48.16","30.88"
"64","000","00","026","2614","0000","443","323","120","51","494","1125","0","43.91","28.71"
"64","000","00","026","2614","0141","443","323","120","51","494","1125","0","43.91","28.71"
"64","000","00","026","2615","0000","2079","1555","524","185","2264","4513","0","50.17","34.46"
"64","000","00","026","2615","0148","619","469","150","40","659","1353","0","48.71","34.66"
"64","000","00","026","2615","0149","651","491","160","69","720","1331","0","54.09","36.89"
"64","000","00","026","2615","0150","809","595","214","76","885","1829","0","48.39","32.53"
"64","000","00","027","0000","0000","6800","5146","1654","682","7482","12001","13888","62.34","42.88"
"64","000","00","027","2701","0000","890","655","235","120","1010","1574","0","64.17","41.61"
"64","000","00","027","2701","0249","451","350","101","47","498","756","0","65.87","46.3"
"64","000","00","027","2701","0250","439","305","134","73","512","818","0","62.59","37.29"
"64","000","00","027","2702","0000","1097","833","264","110","1207","1817","0","66.43","45.84"
"64","000","00","027","2702","0251","548","432","116","47","595","866","0","68.71","49.88"
"64","000","00","027","2702","0252","549","401","148","63","612","951","0","64.35","42.17"
"64","000","00","027","2703","0000","1193","886","307","118","1311","2339","0","56.05","37.88"
"64","000","00","027","2703","0253","553","422","131","69","622","992","0","62.7","42.54"
"64","000","00","027","2703","0254","285","196","89","24","309","682","0","45.31","28.74"
"64","000","00","027","2703","0255","355","268","87","25","380","665","0","57.14","40.3"
"64","000","00","027","2704","0000","188","145","43","16","204","371","0","54.99","39.08"
"64","000","00","027","2704","0256","188","145","43","16","204","371","0","54.99","39.08"
"64","000","00","027","2705","0000","1476","1095","381","129","1605","2532","0","63.39","43.25"
"64","000","00","027","2705","0257","642","461","181","87","729","1114","0","65.44","41.38"
"64","000","00","027","2705","0258","834","634","200","42","876","1418","0","61.78","44.71"
"64","000","00","027","2706","0000","1956","1532","424","189","2145","3368","0","63.69","45.49"
"64","000","00","027","2706","0259","871","680","191","86","957","1477","0","64.79","46.04"
"64","000","00","027","2706","0260","1085","852","233","103","1188","1891","0","62.82","45.06"
"64","000","00","028","0000","0000","8988","6401","2587","1082","10070","16487","19266","61.08","38.82"
"64","000","00","028","2801","0000","679","494","185","70","749","1246","0","60.11","39.65"
"64","000","00","028","2801","0358","679","494","185","70","749","1246","0","60.11","39.65"
"64","000","00","028","2802","0000","1061","790","271","134","1195","1840","0","64.95","42.93"
"64","000","00","028","2802","0359","490","365","125","58","548","885","0","61.92","41.24"
"64","000","00","028","2802","0360","571","425","146","76","647","955","0","67.75","44.5"
"64","000","00","028","2803","0000","267","188","79","48","315","534","0","58.99","35.21"
"64","000","00","028","2803","0361","267","188","79","48","315","534","0","58.99","35.21"
"64","000","00","028","2804","0000","415","317","98","30","445","738","0","60.3","42.95"
"64","000","00","028","2804","0362","415","317","98","30","445","738","0","60.3","42.95"
"64","000","00","028","2805","0000","1022","443","579","108","1130","1732","0","65.24","25.58"
"64","000","00","028","2805","0363","524","413","111","51","575","855","0","67.25","48.3"
"64","000","00","028","2805","0364","498","30","468","57","555","877","0","63.28","3.42"
"64","000","00","028","2806","0000","871","641","230","97","968","1589","0","60.92","40.34"
"64","000","00","028","2806","0365","442","324","118","61","503","781","0","64.4","41.49"
"64","000","00","028","2806","0366","429","317","112","36","465","808","0","57.55","39.23"
"64","000","00","028","2807","0000","857","653","204","96","953","1729","0","55.12","37.77"
"64","000","00","028","2807","0367","420","328","92","34","454","904","0","50.22","36.28"
"64","000","00","028","2807","0368","437","325","112","62","499","825","0","60.48","39.39"
"64","000","00","028","2808","0000","1100","818","282","114","1214","2037","0","59.6","40.16"
"64","000","00","028","2808","0370","530","393","137","40","570","1013","0","56.27","38.8"
"64","000","00","028","2808","0371","570","425","145","74","644","1024","0","62.89","41.5"
"64","000","00","028","2809","0000","438","325","113","81","519","941","0","55.15","34.54"
"64","000","00","028","2809","0369","438","325","113","81","519","941","0","55.15","34.54"
"64","000","00","028","2810","0000","420","320","100","26","446","861","0","51.8","37.17"
"64","000","00","028","2810","0372","420","320","100","26","446","861","0","51.8","37.17"
"64","000","00","028","2811","0000","646","490","156","79","725","1163","0","62.34","42.13"
"64","000","00","028","2811","0373","646","490","156","79","725","1163","0","62.34","42.13"
"64","000","00","028","2812","0000","1212","922","290","199","1411","2077","0","67.93","44.39"
"64","000","00","028","2812","0374","685","526","159","104","789","1216","0","64.88","43.26"
"64","000","00","028","2812","0375","527","396","131","95","622","861","0","72.24","45.99"
"64","000","00","029","0000","0000","16093","12179","3914","1582","17675","31025","35896","56.97","39.26"
"64","000","00","029","2901","0000","1148","851","297","142","1290","2124","0","60.73","40.07"
"64","000","00","029","2901","0376","598","440","158","64","662","1061","0","62.39","41.47"
"64","000","00","029","2901","0377","550","411","139","78","628","1063","0","59.08","38.66"
"64","000","00","029","2902","0000","1017","743","274","74","1091","2047","0","53.3","36.3"
"64","000","00","029","2902","0378","507","367","140","40","547","969","0","56.45","37.87"
"64","000","00","029","2902","0379","510","376","134","34","544","1078","0","50.46","34.88"
"64","000","00","029","2903","0000","1213","885","328","126","1339","2231","0","60.02","39.67"
"64","000","00","029","2903","0380","463","328","135","57","520","838","0","62.05","39.14"
"64","000","00","029","2903","0381","348","257","91","32","380","611","0","62.19","42.06"
"64","000","00","029","2903","0382","402","300","102","37","439","782","0","56.14","38.36"
"64","000","00","029","2904","0000","871","663","208","84","955","1451","0","65.82","45.69"
"64","000","00","029","2904","0383","871","663","208","84","955","1451","0","65.82","45.69"
"64","000","00","029","2905","0000","574","433","141","33","607","1144","0","53.06","37.85"
"64","000","00","029","2905","0384","574","433","141","33","607","1144","0","53.06","37.85"
"64","000","00","029","2906","0000","865","669","196","88","953","1827","0","52.16","36.62"
"64","000","00","029","2906","0389","509","410","99","43","552","1112","0","49.64","36.87"
"64","000","00","029","2906","0390","356","259","97","45","401","715","0","56.08","36.22"
"64","000","00","029","2907","0000","1125","830","295","214","1339","2072","0","64.62","40.06"
"64","000","00","029","2907","0394","590","430","160","104","694","1052","0","65.97","40.87"
"64","000","00","029","2907","0395","535","400","135","110","645","1020","0","63.24","39.22"
"64","000","00","029","2908","0000","1387","1031","356","109","1496","2855","0","52.4","36.11"
"64","000","00","029","2908","0396","595","423","172","51","646","1260","0","51.27","33.57"
"64","000","00","029","2908","0397","792","608","184","58","850","1595","0","53.29","38.12"
"64","000","00","029","2909","0000","1207","949","258","82","1289","2361","0","54.6","40.19"
"64","000","00","029","2909","0398","453","356","97","45","498","829","0","60.07","42.94"
"64","000","00","029","2909","0399","754","593","161","37","791","1532","0","51.63","38.71"
"64","000","00","029","2910","0000","452","347","105","22","474","975","0","48.62","35.59"
"64","000","00","029","2910","0385","452","347","105","22","474","975","0","48.62","35.59"
"64","000","00","029","2911","0000","1917","1467","450","189","2106","3608","0","58.37","40.66"
"64","000","00","029","2911","0386","684","527","157","51","735","1317","0","55.81","40.02"
"64","000","00","029","2911","0387","664","494","170","89","753","1218","0","61.82","40.56"
"64","000","00","029","2911","0388","569","446","123","49","618","1073","0","57.6","41.57"
"64","000","00","029","2912","0000","1103","827","276","103","1206","2250","0","53.6","36.76"
"64","000","00","029","2912","0391","633","488","145","62","695","1311","0","53.01","37.22"
"64","000","00","029","2912","0392","470","339","131","41","511","939","0","54.42","36.1"
"64","000","00","029","2913","0000","476","368","108","37","513","824","0","62.26","44.66"
"64","000","00","029","2913","0393","476","368","108","37","513","824","0","62.26","44.66"
"64","000","00","029","2914","0000","1308","978","330","156","1464","2338","0","62.62","41.83"
"64","000","00","029","2914","0400","687","507","180","76","763","1195","0","63.85","42.43"
"64","000","00","029","2914","0401","621","471","150","80","701","1143","0","61.33","41.21"
"64","000","00","029","2915","0000","1430","1138","292","123","1553","2918","0","53.22","39.0"
"64","000","00","029","2915","0402","660","517","143","77","737","1186","0","62.14","43.59"
"64","000","00","029","2915","0403","770","621","149","46","816","1732","0","47.11","35.85"
"64","000","00","030","0000","0000","15982","12146","3836","1525","17507","31996","36695","54.72","37.96"
"64","000","00","030","3001","0000","1124","892","232","96","1220","2185","0","55.84","40.82"
"64","000","00","030","3001","0060","575","459","116","55","630","1060","0","59.43","43.3"
"64","000","00","030","3001","0061","549","433","116","41","590","1125","0","52.44","38.49"
"64","000","00","030","3002","0000","1303","1020","283","56","1359","2338","0","58.13","43.63"
"64","000","00","030","3002","0062","616","485","131","30","646","1100","0","58.73","44.09"
"64","000","00","030","3002","0063","687","535","152","26","713","1238","0","57.59","43.21"
"64","000","00","030","3003","0000","826","655","171","40","866","1660","0","52.17","39.46"
"64","000","00","030","3003","0064","503","404","99","19","522","933","0","55.95","43.3"
"64","000","00","030","3003","0065","323","251","72","21","344","727","0","47.32","34.53"
"64","000","00","030","3004","0000","890","667","223","88","978","1815","0","53.88","36.75"
"64","000","00","030","3004","0066","537","406","131","59","596","1071","0","55.65","37.91"
"64","000","00","030","3004","0067","353","261","92","29","382","744","0","51.34","35.08"
"64","000","00","030","3005","0000","650","494","156","56","706","1469","0","48.06","33.63"
"64","000","00","030","3005","0068","472","354","118","41","513","1100","0","46.64","32.18"
"64","000","00","030","3005","0069","178","140","38","15","193","369","0","52.3","37.94"
"64","000","00","030","3006","0000","554","396","158","24","578","1398","0","41.34","28.33"
"64","000","00","030","3006","0070","359","255","104","14","373","888","0","42.0","28.72"
"64","000","00","030","3006","0071","195","141","54","10","205","510","0","40.2","27.65"
"64","000","00","030","3007","0000","559","399","160","88","647","1042","0","62.09","38.29"
"64","000","00","030","3007","0072","559","399","160","88","647","1042","0","62.09","38.29"
"64","000","00","030","3008","0000","381","282","99","50","431","791","0","54.49","35.65"
"64","000","00","030","3008","0073","381","282","99","50","431","791","0","54.49","35.65"
"64","000","00","030","3009","0000","1040","783","257","118","1158","2157","0","53.69","36.3"
"64","000","00","030","3009","0074","488","364","124","78","566","939","0","60.28","38.76"
"64","000","00","030","3009","0075","552","419","133","40","592","1218","0","48.6","34.4"
"64","000","00","030","3010","0000","76","54","22","20","96","178","0","53.93","30.34"
"64","000","00","030","3010","0076","76","54","22","20","96","178","0","53.93","30.34"
"64","000","00","030","3011","0000","1019","763","256","106","1125","1971","0","57.08","38.71"
"64","000","00","030","3011","0077","520","402","118","66","586","946","0","61.95","42.49"
"64","000","00","030","3011","0078","499","361","138","40","539","1025","0","52.59","35.22"
"64","000","00","030","3012","0000","546","431","115","82","628","1040","0","60.38","41.44"
"64","000","00","030","3012","0079","546","431","115","82","628","1040","0","60.38","41.44"
"64","000","00","030","3013","0000","822","625","197","82","904","1563","0","57.84","39.99"
"64","000","00","030","3013","0080","525","392","133","49","574","900","0","63.78","43.56"
"64","000","00","030","3013","0081","297","233","64","33","330","663","0","49.77","35.14"
"64","000","00","030","3014","0000","980","771","209","98","1078","2014","0","53.53","38.28"
"64","000","00","030","3014","0082","468","370","98","62","530","954","0","55.56","38.78"
"64","000","00","030","3014","0083","512","401","111","36","548","1060","0","51.7","37.83"
"64","000","00","030","3015","0000","1757","1353","404","153","1910","3323","0","57.48","40.72"
"64","000","00","030","3015","0084","602","456","146","60","662","1110","0","59.64","41.08"
"64","000","00","030","3015","0085","573","436","137","56","629","1062","0","59.23","41.05"
"64","000","00","030","3015","0086","582","461","121","37","619","1151","0","53.78","40.05"
"64","000","00","030","3016","0000","1076","816","260","98","1174","2206","0","53.22","36.99"
"64","000","00","030","3016","0087","139","108","31","25","164","266","0","61.65","40.6"
"64","000","00","030","3016","0088","346","272","74","40","386","633","0","60.98","42.97"
"64","000","00","030","3016","0089","591","436","155","33","624","1307","0","47.74","33.36"
"64","000","00","030","3017","0000","364","251","113","61","425","754","0","56.37","33.29"
"64","000","00","030","3017","0090","364","251","113","61","425","754","0","56.37","33.29"
"64","000","00","030","3018","0000","639","456","183","100","739","1296","0","57.02","35.19"
"64","000","00","030","3018","0091","639","456","183","100","739","1296","0","57.02","35.19"
"64","000","00","030","3019","0000","343","252","91","23","366","839","0","43.62","30.04"
"64","000","00","030","3019","0092","343","252","91","23","366","839","0","43.62","30.04"
"64","000","00","030","3020","0000","696","541","155","53","749","1329","0","56.36","40.71"
"64","000","00","030","3020","0093","696","541","155","53","749","1329","0","56.36","40.71"
"64","000","00","030","3021","0000","337","245","92","33","370","628","0","58.92","39.01"
"64","000","00","030","3021","0094","337","245","92","33","370","628","0","58.92","39.01"
"64","000","00","031","0000","0000","17132","13318","3814","1879","19011","35311","39630","53.84","37.72"
"64","000","00","031","3101","0000","1262","975","287","117","1379","2613","0","52.77","37.31"
"64","000","00","031","3101","0095","601","460","141","88","689","1175","0","58.64","39.15"
"64","000","00","031","3101","0096","661","515","146","29","690","1438","0","47.98","35.81"
"64","000","00","031","3102","0000","1093","930","163","123","1216","2416","0","50.33","38.49"
"64","000","00","031","3102","0097","453","362","91","44","497","989","0","50.25","36.6"
"64","000","00","031","3102","0098","640","568","72","79","719","1427","0","50.39","39.8"
"64","000","00","031","3103","0000","1348","1033","315","152","1500","2572","0","58.32","40.16"
"64","000","00","031","3103","0099","673","513","160","63","736","1309","0","56.23","39.19"
"64","000","00","031","3103","0100","675","520","155","89","764","1263","0","60.49","41.17"
"64","000","00","031","3104","0000","1097","840","257","116","1213","2061","0","58.85","40.76"
"64","000","00","031","3104","0101","538","418","120","60","598","997","0","59.98","41.93"
"64","000","00","031","3104","0102","559","422","137","56","615","1064","0","57.8","39.66"
"64","000","00","031","3105","0000","728","583","145","91","819","1498","0","54.67","38.92"
"64","000","00","031","3105","0103","728","583","145","91","819","1498","0","54.67","38.92"
"64","000","00","031","3106","0000","1119","878","241","137","1256","2150","0","58.42","40.84"
"64","000","00","031","3106","0104","581","451","130","75","656","1119","0","58.62","40.3"
"64","000","00","031","3106","0105","538","427","111","62","600","1031","0","58.2","41.42"
"64","000","00","031","3107","0000","1216","930","286","153","1369","2508","0","54.59","37.08"
"64","000","00","031","3107","0106","668","511","157","94","762","1437","0","53.03","35.56"
"64","000","00","031","3107","0107","548","419","129","59","607","1071","0","56.68","39.12"
"64","000","00","031","3108","0000","627","533","94","63","690","1462","0","47.2","36.46"
"64","000","00","031","3108","0108","338","311","27","39","377","687","0","54.88","45.27"
"64","000","00","031","3108","0109","289","222","67","24","313","775","0","40.39","28.65"
"64","000","00","031","3109","0000","617","467","150","77","694","1353","0","51.29","34.52"
"64","000","00","031","3109","0110","617","467","150","77","694","1353","0","51.29","34.52"
"64","000","00","031","3110","0000","541","413","128","43","584","1191","0","49.03","34.68"
"64","000","00","031","3110","0111","541","413","128","43","584","1191","0","49.03","34.68"
"64","000","00","031","3111","0000","1038","834","204","82","1120","2084","0","53.74","40.02"
"64","000","00","031","3111","0112","395","315","80","34","429","906","0","47.35","34.77"
"64","000","00","031","3111","0113","643","519","124","48","691","1178","0","58.66","44.06"
"64","000","00","031","3112","0000","540","424","116","44","584","1252","0","46.65","33.87"
"64","000","00","031","3112","0114","540","424","116","44","584","1252","0","46.65","33.87"
"64","000","00","031","3113","0000","799","622","177","61","860","1549","0","55.52","40.15"
"64","000","00","031","3113","0115","799","622","177","61","860","1549","0","55.52","40.15"
"64","000","00","031","3114","0000","1074","831","243","113","1187","2204","0","53.86","37.7"
"64","000","00","031","3114","0116","493","386","107","59","552","1088","0","50.74","35.48"
"64","000","00","031","3114","0117","581","445","136","54","635","1116","0","56.9","39.87"
"64","000","00","031","3115","0000","928","682","246","101","1029","1793","0","57.39","38.04"
"64","000","00","031","3115","0118","487","361","126","31","518","977","0","53.02","36.95"
"64","000","00","031","3115","0119","441","321","120","70","511","816","0","62.62","39.34"
"64","000","00","031","3116","0000","864","668","196","108","972","1898","0","51.21","35.19"
"64","000","00","031","3116","0120","391","318","73","32","423","955","0","44.29","33.3"
"64","000","00","031","3116","0121","473","350","123","76","549","943","0","58.22","37.12"
"64","000","00","031","3117","0000","631","504","127","58","689","1371","0","50.26","36.76"
"64","000","00","031","3117","0122","631","504","127","58","689","1371","0","50.26","36.76"
"64","000","00","031","3118","0000","954","709","245","122","1076","1834","0","58.67","38.66"
"64","000","00","031","3118","0123","450","329","121","64","514","919","0","55.93","35.8"
"64","000","00","031","3118","0124","504","380","124","58","562","915","0","61.42","41.53"
"64","000","00","031","3119","0000","656","462","194","118","774","1502","0","51.53","30.76"
"64","000","00","031","3119","0125","393","275","118","64","457","828","0","55.19","33.21"
"64","000","00","031","3119","0126","263","187","76","54","317","674","0","47.03","27.74"
"64","000","00","032","0000","0000","4722","3496","1226","698","5420","11501","12984","47.13","30.4"
"64","000","00","032","3201","0000","346","245","101","36","382","760","0","50.26","32.24"
"64","000","00","032","3201","0020","346","245","101","36","382","760","0","50.26","32.24"
"64","000","00","032","3202","0000","272","205","67","35","307","666","0","46.1","30.78"
"64","000","00","032","3202","0021","272","205","67","35","307","666","0","46.1","30.78"
"64","000","00","032","3203","0000","350","268","82","50","400","704","0","56.82","38.07"
"64","000","00","032","3203","0022","350","268","82","50","400","704","0","56.82","38.07"
"64","000","00","032","3204","0000","456","325","131","56","512","1003","0","51.05","32.4"
"64","000","00","032","3204","0023","456","325","131","56","512","1003","0","51.05","32.4"
"64","000","00","032","3205","0000","543","414","129","110","653","1382","0","47.25","29.96"
"64","000","00","032","3205","0024","543","414","129","110","653","1382","0","47.25","29.96"
"64","000","00","032","3206","0000","336","240","96","74","410","986","0","41.58","24.34"
"64","000","00","032","3206","0025","336","240","96","74","410","986","0","41.58","24.34"
"64","000","00","032","3207","0000","485","353","132","38","523","1046","0","50.0","33.75"
"64","000","00","032","3207","0026","485","353","132","38","523","1046","0","50.0","33.75"
"64","000","00","032","3208","0000","320","222","98","62","382","812","0","47.04","27.34"
"64","000","00","032","3208","0027","320","222","98","62","382","812","0","47.04","27.34"
"64","000","00","032","3209","0000","582","439","143","81","663","1431","0","46.33","30.68"
"64","000","00","032","3209","0028","582","439","143","81","663","1431","0","46.33","30.68"
"64","000","00","032","3210","0000","400","320","80","79","479","912","0","52.52","35.09"
"64","000","00","032","3210","0029","400","320","80","79","479","912","0","52.52","35.09"
"64","000","00","032","3211","0000","517","381","136","49","566","1472","0","38.45","25.88"
"64","000","00","032","3211","0030","517","381","136","49","566","1472","0","38.45","25.88"
"64","000","00","032","3212","0000","115","84","31","28","143","327","0","43.73","25.69"
"64","000","00","032","3212","0031","115","84","31","28","143","327","0","43.73","25.69"
"64","000","00","033","0000","0000","2285","1767","518","314","2599","5417","6051","47.98","32.62"
"64","000","00","033","3301","0000","149","124","25","11","160","472","0","33.9","26.27"
"64","000","00","033","3301","0013","149","124","25","11","160","472","0","33.9","26.27"
"64","000","00","033","3302","0000","492","386","106","62","554","882","0","62.81","43.76"
"64","000","00","033","3302","0014","492","386","106","62","554","882","0","62.81","43.76"
"64","000","00","033","3303","0000","311","239","72","43","354","668","0","52.99","35.78"
"64","000","00","033","3303","0015","311","239","72","43","354","668","0","52.99","35.78"
"64","000","00","033","3304","0000","661","505","156","134","795","1581","0","50.28","31.94"
"64","000","00","033","3304","0016","661","505","156","134","795","1581","0","50.28","31.94"
"64","000","00","033","3305","0000","203","150","53","12","215","673","0","31.95","22.29"
"64","000","00","033","3305","0017","203","150","53","12","215","673","0","31.95","22.29"
"64","000","00","033","3306","0000","242","188","54","36","278","607","0","45.8","30.97"
"64","000","00","033","3306","0018","242","188","54","36","278","607","0","45.8","30.97"
"64","000","00","033","3307","0000","227","175","52","16","243","534","0","45.51","32.77"
"64","000","00","033","3307","0019","227","175","52","16","243","534","0","45.51","32.77"
"64","000","00","034","0000","0000","4225","3088","1137","507","4732","10607","11828","44.61","29.11"
"64","000","00","034","3401","0000","263","190","73","52","315","640","0","49.22","29.69"
"64","000","00","034","3401","0032","263","190","73","52","315","640","0","49.22","29.69"
"64","000","00","034","3402","0000","261","197","64","34","295","696","0","42.39","28.3"
"64","000","00","034","3402","0033","261","197","64","34","295","696","0","42.39","28.3"
"64","000","00","034","3403","0000","403","275","128","45","448","1284","0","34.89","21.42"
"64","000","00","034","3403","0034","403","275","128","45","448","1284","0","34.89","21.42"
"64","000","00","034","3404","0000","591","423","168","75","666","1509","0","44.14","28.03"
"64","000","00","034","3404","0035","389","269","120","49","438","1027","0","42.65","26.19"
"64","000","00","034","3404","0036","202","154","48","26","228","482","0","47.3","31.95"
"64","000","00","034","3405","0000","781","573","208","119","900","1627","0","55.32","35.22"
"64","000","00","034","3405","0037","781","573","208","119","900","1627","0","55.32","35.22"
"64","000","00","034","3406","0000","672","509","163","40","712","1630","0","43.68","31.23"
"64","000","00","034","3406","0038","672","509","163","40","712","1630","0","43.68","31.23"
"64","000","00","034","3407","0000","579","430","149","83","662","1261","0","52.5","34.1"
"64","000","00","034","3407","0041","579","430","149","83","662","1261","0","52.5","34.1"
"64","000","00","034","3408","0000","675","491","184","59","734","1960","0","37.45","25.05"
"64","000","00","034","3408","0039","324","231","93","25","349","973","0","35.87","23.74"
"64","000","00","034","3408","0040","351","260","91","34","385","987","0","39.01","26.34"
"64","000","00","035","0000","0000","5357","3998","1359","762","6119","13002","14465","47.06","30.75"
"64","000","00","035","3501","0000","374","280","94","64","438","969","0","45.2","28.9"
"64","000","00","035","3501","0042","374","280","94","64","438","969","0","45.2","28.9"
"64","000","00","035","3502","0000","227","165","62","22","249","652","0","38.19","25.31"
"64","000","00","035","3502","0043","227","165","62","22","249","652","0","38.19","25.31"
"64","000","00","035","3503","0000","424","302","122","88","512","961","0","53.28","31.43"
"64","000","00","035","3503","0044","424","302","122","88","512","961","0","53.28","31.43"
"64","000","00","035","3504","0000","161","133","28","7","168","426","0","39.44","31.22"
"64","000","00","035","3504","0045","161","133","28","7","168","426","0","39.44","31.22"
"64","000","00","035","3505","0000","163","123","40","19","182","398","0","45.73","30.9"
"64","000","00","035","3505","0046","163","123","40","19","182","398","0","45.73","30.9"
"64","000","00","035","3506","0000","200","162","38","19","219","508","0","43.11","31.89"
"64","000","00","035","3506","0047","200","162","38","19","219","508","0","43.11","31.89"
"64","000","00","035","3507","0000","490","367","123","81","571","980","0","58.27","37.45"
"64","000","00","035","3507","0048","490","367","123","81","571","980","0","58.27","37.45"
"64","000","00","035","3508","0000","489","368","121","46","535","1225","0","43.67","30.04"
"64","000","00","035","3508","0049","489","368","121","46","535","1225","0","43.67","30.04"
"64","000","00","035","3509","0000","790","599","191","156","946","1722","0","54.94","34.79"
"64","000","00","035","3509","0050","790","599","191","156","946","1722","0","54.94","34.79"
"64","000","00","035","3510","0000","246","172","74","29","275","560","0","49.11","30.71"
"64","000","00","035","3510","0051","246","172","74","29","275","560","0","49.11","30.71"
"64","000","00","035","3511","0000","288","210","78","22","310","801","0","38.7","26.22"
"64","000","00","035","3511","0052","288","210","78","22","310","801","0","38.7","26.22"
"64","000","00","035","3512","0000","196","138","58","19","215","423","0","50.83","32.62"
"64","000","00","035","3512","0053","196","138","58","19","215","423","0","50.83","32.62"
"64","000","00","035","3513","0000","202","153","49","33","235","497","0","47.28","30.78"
"64","000","00","035","3513","0054","202","153","49","33","235","497","0","47.28","30.78"
"64","000","00","035","3514","0000","282","200","82","34","316","677","0","46.68","29.54"
"64","000","00","035","3514","0055","282","200","82","34","316","677","0","46.68","29.54"
"64","000","00","035","3515","0000","180","137","43","12","192","593","0","32.38","23.1"
"64","000","00","035","3515","0056","180","137","43","12","192","593","0","32.38","23.1"
"64","000","00","035","3516","0000","196","144","52","54","250","597","0","41.88","24.12"
"64","000","00","035","3516","0057","196","144","52","54","250","597","0","41.88","24.12"
"64","000","00","035","3517","0000","132","101","31","9","141","343","0","41.11","29.45"
"64","000","00","035","3517","0058","132","101","31","9","141","343","0","41.11","29.45"
"64","000","00","035","3518","0000","317","244","73","48","365","670","0","54.48","36.42"
"64","000","00","035","3518","0059","317","244","73","48","365","670","0","54.48","36.42"
"64","000","00","036","0000","0000","971","758","213","90","1061","1615","1999","65.7","46.93"
"64","000","00","036","3601","0000","413","326","87","30","443","726","0","61.02","44.9"
"64","000","00","036","3601","0129","413","326","87","30","443","726","0","61.02","44.9"
"64","000","00","036","3602","0000","239","190","49","23","262","382","0","68.59","49.74"
"64","000","00","036","3602","0128","239","190","49","23","262","382","0","68.59","49.74"
"64","000","00","036","3603","0000","319","242","77","37","356","507","0","70.22","47.73"
"64","000","00","036","3603","0127","319","242","77","37","356","507","0","70.22","47.73"
"64","000","00","037","0000","0000","1634","1239","395","109","1743","3498","4310","49.83","35.42"
"64","000","00","037","3701","0000","300","221","79","11","311","783","0","39.72","28.22"
"64","000","00","037","3701","0005","300","221","79","11","311","783","0","39.72","28.22"
"64","000","00","037","3702","0000","221","171","50","27","248","472","0","52.54","36.23"
"64","000","00","037","3702","0008","221","171","50","27","248","472","0","52.54","36.23"
"64","000","00","037","3703","0000","384","291","93","31","415","612","0","67.81","47.55"
"64","000","00","037","3703","0007","384","291","93","31","415","612","0","67.81","47.55"
"64","000","00","037","3704","0000","233","185","48","7","240","632","0","37.97","29.27"
"64","000","00","037","3704","0006","233","185","48","7","240","632","0","37.97","29.27"
"64","000","00","037","3705","0000","104","65","39","4","108","223","0","48.43","29.15"
"64","000","00","037","3705","0004","104","65","39","4","108","223","0","48.43","29.15"
"64","000","00","037","3706","0000","166","138","28","8","174","279","0","62.37","49.46"
"64","000","00","037","3706","0003","166","138","28","8","174","279","0","62.37","49.46"
"64","000","00","037","3707","0000","151","112","39","20","171","233","0","73.39","48.07"
"64","000","00","037","3707","0002","151","112","39","20","171","233","0","73.39","48.07"
"64","000","00","037","3708","0000","75","56","19","1","76","264","0","28.79","21.21"
"64","000","00","037","3708","0001","75","56","19","1","76","264","0","28.79","21.21"
"64","000","00","038","0000","0000","1220","917","303","165","1385","2424","3143","57.14","37.83"
"64","000","00","038","3801","0000","646","472","174","97","743","1326","0","56.03","35.6"
"64","000","00","038","3801","0009","297","222","75","29","326","741","0","43.99","29.96"
"64","000","00","038","3801","0010","349","250","99","68","417","585","0","71.28","42.74"
"64","000","00","038","3802","0000","404","316","88","62","466","609","0","76.52","51.89"
"64","000","00","038","3802","0011","404","316","88","62","466","609","0","76.52","51.89"
"64","000","00","038","3803","0000","170","129","41","6","176","489","0","35.99","26.38"
"64","000","00","038","3803","0012","170","129","41","6","176","489","0","35.99","26.38"
"10","004","00","000","0000","0000","235409","187845","47564","14059","249468","445051","556307","56.05","42.21"
"10","004","00","001","0000","0000","75796","60847","14949","3703","79499","137129","186411","57.97","44.37"
"10","004","00","001","0101","0000","3426","2797","629","130","3556","5988","0","59.39","46.71"
"10","004","00","001","0101","0041","733","591","142","23","756","1301","0","58.11","45.43"
"10","004","00","001","0101","0042","1002","813","189","47","1049","1798","0","58.34","45.22"
"10","004","00","001","0101","0043","823","660","163","26","849","1427","0","59.5","46.25"
"10","004","00","001","0101","0044","868","733","135","34","902","1462","0","61.7","50.14"
"10","004","00","001","0102","0000","5501","4473","1028","158","5659","9417","0","60.09","47.5"
"10","004","00","001","0102","0001","821","671","150","30","851","1319","0","64.52","50.87"
"10","004","00","001","0102","0002","777","634","143","25","802","1321","0","60.71","47.99"
"10","004","00","001","0102","0003","758","607","151","40","798","1272","0","62.74","47.72"
"10","004","00","001","0102","0004","810","660","150","30","840","1467","0","57.26","44.99"
"10","004","00","001","0102","0005","679","528","151","14","693","1226","0","56.53","43.07"
"10","004","00","001","0102","0006","787","654","133","13","800","1412","0","56.66","46.32"
"10","004","00","001","0102","0007","869","719","150","6","875","1400","0","62.5","51.36"
"10","004","00","001","0103","0000","5729","4511","1218","165","5894","10185","0","57.87","44.29"
"10","004","00","001","0103","0008","856","697","159","22","878","1415","0","62.05","49.26"
"10","004","00","001","0103","0009","772","618","154","20","792","1361","0","58.19","45.41"
"10","004","00","001","0103","0010","814","643","171","21","835","1515","0","55.12","42.44"
"10","004","00","001","0103","0011","864","676","188","23","887","1495","0","59.33","45.22"
"10","004","00","001","0103","0012","809","639","170","28","837","1417","0","59.07","45.1"
"10","004","00","001","0103","0013","855","654","201","28","883","1548","0","57.04","42.25"
"10","004","00","001","0103","0014","759","584","175","23","782","1434","0","54.53","40.73"
"10","004","00","001","0104","0000","3771","3089","682","158","3929","6515","0","60.31","47.41"
"10","004","00","001","0104","0015","780","651","129","34","814","1385","0","58.77","47.0"
"10","004","00","001","0104","0016","758","636","122","34","792","1247","0","63.51","51.0"
"10","004","00","001","0104","0017","768","608","160","27","795","1373","0","57.9","44.28"
"10","004","00","001","0104","0018","832","667","165","27","859","1345","0","63.87","49.59"
"10","004","00","001","0104","0019","633","527","106","36","669","1165","0","57.42","45.24"
"10","004","00","001","0105","0000","1437","1112","325","66","1503","2376","0","63.26","46.8"
"10","004","00","001","0105","0020","714","552","162","35","749","1164","0","64.35","47.42"
"10","004","00","001","0105","0021","723","560","163","31","754","1212","0","62.21","46.2"
"10","004","00","001","0106","0000","1503","1239","264","66","1569","3083","0","50.89","40.19"
"10","004","00","001","0106","0022","736","600","136","23","759","1507","0","50.36","39.81"
"10","004","00","001","0106","0023","767","639","128","43","810","1576","0","51.4","40.55"
"10","004","00","001","0107","0000","3277","2649","628","194","3471","6111","0","56.8","43.35"
"10","004","00","001","0107","0056","753","623","130","32","785","1477","0","53.15","42.18"
"10","004","00","001","0107","0057","931","716","215","52","983","1611","0","61.02","44.44"
"10","004","00","001","0107","0058","836","691","145","68","904","1555","0","58.14","44.44"
"10","004","00","001","0107","0059","757","619","138","42","799","1468","0","54.43","42.17"
"10","004","00","001","0108","0000","4891","3926","965","314","5205","8856","0","58.77","44.33"
"10","004","00","001","0108","0060","844","667","177","50","894","1509","0","59.24","44.2"
"10","004","00","001","0108","0061","844","688","156","45","889","1602","0","55.49","42.95"
"10","004","00","001","0108","0062","811","642","169","53","864","1448","0","59.67","44.34"
"10","004","00","001","0108","0063","736","599","137","59","795","1318","0","60.32","45.45"
"10","004","00","001","0108","0064","945","764","181","49","994","1634","0","60.83","46.76"
"10","004","00","001","0108","0065","711","566","145","58","769","1345","0","57.17","42.08"
"10","004","00","001","0109","0000","2872","2332","540","111","2983","5746","0","51.91","40.58"
"10","004","00","001","0109","0069","828","674","154","26","854","1483","0","57.59","45.45"
"10","004","00","001","0109","0070","713","568","145","35","748","1332","0","56.16","42.64"
"10","004","00","001","0109","0071","736","621","115","26","762","1482","0","51.42","41.9"
"10","004","00","001","0109","0072","595","469","126","24","619","1449","0","42.72","32.37"
"10","004","00","001","0110","0000","2940","2368","572","143","3083","5703","0","54.06","41.52"
"10","004","00","001","0110","0073","694","582","112","24","718","1319","0","54.44","44.12"
"10","004","00","001","0110","0074","687","550","137","40","727","1332","0","54.58","41.29"
"10","004","00","001","0110","0075","716","547","169","34","750","1412","0","53.12","38.74"
"10","004","00","001","0110","0076","843","689","154","45","888","1640","0","54.15","42.01"
"10","004","00","001","0111","0000","3649","2930","719","227","3876","6849","0","56.59","42.78"
"10","004","00","001","0111","0077","721","556","165","41","762","1323","0","57.6","42.03"
"10","004","00","001","0111","0078","796","627","169","54","850","1428","0","59.52","43.91"
"10","004","00","001","0111","0079","837","694","143","58","895","1533","0","58.38","45.27"
"10","004","00","001","0111","0080","673","544","129","27","700","1346","0","52.01","40.42"
"10","004","00","001","0111","0081","622","509","113","47","669","1219","0","54.88","41.76"
"10","004","00","001","0112","0000","2393","1815","578","115","2508","4458","0","56.26","40.71"
"10","004","00","001","0112","0086","777","635","142","52","829","1383","0","59.94","45.91"
"10","004","00","001","0112","0087","853","548","305","42","895","1569","0","57.04","34.93"
"10","004","00","001","0112","0088","763","632","131","21","784","1506","0","52.06","41.97"
"10","004","00","001","0113","0000","1044","832","212","88","1132","1951","0","58.02","42.64"
"10","004","00","001","0113","0089","465","386","79","41","506","877","0","57.7","44.01"
"10","004","00","001","0113","0090","579","446","133","47","626","1074","0","58.29","41.53"
"10","004","00","001","0114","0000","1405","1119","286","90","1495","2425","0","61.65","46.14"
"10","004","00","001","0114","0091","665","531","134","37","702","1089","0","64.46","48.76"
"10","004","00","001","0114","0092","740","588","152","53","793","1336","0","59.36","44.01"
"10","004","00","001","0115","0000","1217","946","271","100","1317","2143","0","61.46","44.14"
"10","004","00","001","0115","0094","566","441","125","59","625","937","0","66.7","47.07"
"10","004","00","001","0115","0095","651","505","146","41","692","1206","0","57.38","41.87"
"10","004","00","001","0116","0000","629","481","148","52","681","1205","0","56.51","39.92"
"10","004","00","001","0116","0096","629","481","148","52","681","1205","0","56.51","39.92"
"10","004","00","001","0117","0000","847","651","196","81","928","1585","0","58.55","41.07"
"10","004","00","001","0117","0098","473","358","115","51","524","917","0","57.14","39.04"
"10","004","00","001","0117","0099","374","293","81","30","404","668","0","60.48","43.86"
"10","004","00","001","0118","0000","945","729","216","98","1043","1914","0","54.49","38.09"
"10","004","00","001","0118","0102","522","401","121","76","598","977","0","61.21","41.04"
"10","004","00","001","0118","0103","423","328","95","22","445","937","0","47.49","35.01"
"10","004","00","001","0119","0000","954","749","205","74","1028","1718","0","59.84","43.6"
"10","004","00","001","0119","0097","954","749","205","74","1028","1718","0","59.84","43.6"
"10","004","00","001","0120","0000","816","646","170","103","919","1606","0","57.22","40.22"
"10","004","00","001","0120","0100","421","334","87","34","455","824","0","55.22","40.53"
"10","004","00","001","0120","0101","395","312","83","69","464","782","0","59.34","39.9"
"10","004","00","001","0121","0000","3553","2853","700","99","3652","6176","0","59.13","46.19"
"10","004","00","001","0121","0030","704","549","155","29","733","1196","0","61.29","45.9"
"10","004","00","001","0121","0031","722","588","134","19","741","1235","0","60.0","47.61"
"10","004","00","001","0121","0032","667","552","115","17","684","1204","0","56.81","45.85"
"10","004","00","001","0121","0033","776","628","148","18","794","1308","0","60.7","48.01"
"10","004","00","001","0121","0034","684","536","148","16","700","1233","0","56.77","43.47"
"10","004","00","001","0122","0000","2967","2418","549","186","3153","5664","0","55.67","42.69"
"10","004","00","001","0122","0082","837","674","163","56","893","1466","0","60.91","45.98"
"10","004","00","001","0122","0083","596","468","128","36","632","1147","0","55.1","40.8"
"10","004","00","001","0122","0084","708","597","111","43","751","1529","0","49.12","39.05"
"10","004","00","001","0122","0085","826","679","147","51","877","1522","0","57.62","44.61"
"10","004","00","001","0123","0000","546","431","115","57","603","1058","0","56.99","40.74"
"10","004","00","001","0123","0093","546","431","115","57","603","1058","0","56.99","40.74"
"10","004","00","001","0124","0000","2269","1846","423","92","2361","3738","0","63.16","49.38"
"10","004","00","001","0124","0049","691","554","137","34","725","1181","0","61.39","46.91"
"10","004","00","001","0124","0050","825","675","150","33","858","1329","0","64.56","50.79"
"10","004","00","001","0124","0051","753","617","136","25","778","1228","0","63.36","50.24"
"10","004","00","001","0125","0000","3232","2545","687","141","3373","5989","0","56.32","42.49"
"10","004","00","001","0125","0052","836","659","177","40","876","1552","0","56.44","42.46"
"10","004","00","001","0125","0053","861","685","176","30","891","1480","0","60.2","46.28"
"10","004","00","001","0125","0054","771","606","165","31","802","1487","0","53.93","40.75"
"10","004","00","001","0125","0055","764","595","169","40","804","1470","0","54.69","40.48"
"10","004","00","001","0126","0000","1865","1515","350","133","1998","3204","0","62.36","47.28"
"10","004","00","001","0126","0066","601","485","116","27","628","958","0","65.55","50.63"
"10","004","00","001","0126","0067","661","555","106","40","701","1112","0","63.04","49.91"
"10","004","00","001","0126","0068","603","475","128","66","669","1134","0","58.99","41.89"
"10","004","00","001","0127","0000","3087","2498","589","125","3212","5749","0","55.87","43.45"
"10","004","00","001","0127","0024","797","661","136","31","828","1464","0","56.56","45.15"
"10","004","00","001","0127","0025","793","640","153","23","816","1428","0","57.14","44.82"
"10","004","00","001","0127","0026","710","557","153","17","727","1442","0","50.42","38.63"
"10","004","00","001","0127","0027","787","640","147","54","841","1415","0","59.43","45.23"
"10","004","00","001","0128","0000","1724","1355","369","61","1785","3417","0","52.24","39.65"
"10","004","00","001","0128","0028","817","655","162","29","846","1666","0","50.78","39.32"
"10","004","00","001","0128","0029","907","700","207","32","939","1751","0","53.63","39.98"
"10","004","00","001","0129","0000","1956","1596","360","88","2044","3312","0","61.71","48.19"
"10","004","00","001","0129","0035","648","515","133","25","673","1129","0","59.61","45.62"
"10","004","00","001","0129","0036","637","527","110","22","659","1069","0","61.65","49.3"
"10","004","00","001","0129","0037","671","554","117","41","712","1114","0","63.91","49.73"
"10","004","00","001","0130","0000","1996","1617","379","74","2070","3265","0","63.4","49.53"
"10","004","00","001","0130","0038","649","530","119","20","669","1103","0","60.65","48.05"
"10","004","00","001","0130","0039","640","512","128","30","670","1029","0","65.11","49.76"
"10","004","00","001","0130","0040","707","575","132","24","731","1133","0","64.52","50.75"
"10","004","00","001","0131","0000","3355","2779","576","114","3469","5723","0","60.62","48.56"
"10","004","00","001","0131","0045","815","678","137","35","850","1342","0","63.34","50.52"
"10","004","00","001","0131","0046","861","715","146","28","889","1480","0","60.07","48.31"
"10","004","00","001","0131","0047","896","734","162","31","927","1645","0","56.35","44.62"
"10","004","00","001","0131","0048","783","652","131","20","803","1256","0","63.93","51.91"
"10","004","00","002","0000","0000","39848","31963","7885","2370","42218","78794","96358","53.58","40.57"
"10","004","00","002","0201","0000","142","117","25","10","152","309","0","49.19","37.86"
"10","004","00","002","0201","0104","142","117","25","10","152","309","0","49.19","37.86"
"10","004","00","002","0202","0000","186","140","46","29","215","416","0","51.68","33.65"
"10","004","00","002","0202","0105","186","140","46","29","215","416","0","51.68","33.65"
"10","004","00","002","0203","0000","182","142","40","10","192","386","0","49.74","36.79"
"10","004","00","002","0203","0106","182","142","40","10","192","386","0","49.74","36.79"
"10","004","00","002","0204","0000","1093","907","186","38","1131","2225","0","50.83","40.76"
"10","004","00","002","0204","0107","451","371","80","22","473","950","0","49.79","39.05"
"10","004","00","002","0204","0108","642","536","106","16","658","1275","0","51.61","42.04"
"10","004","00","002","0205","0000","1700","1399","301","101","1801","3283","0","54.86","42.61"
"10","004","00","002","0205","0116","680","559","121","44","724","1292","0","56.04","43.27"
"10","004","00","002","0205","0117","540","455","85","14","554","1111","0","49.86","40.95"
"10","004","00","002","0205","0118","480","385","95","43","523","880","0","59.43","43.75"
"10","004","00","002","0206","0000","4571","3670","901","285","4856","9177","0","52.91","39.99"
"10","004","00","002","0206","0109","613","480","133","44","657","1213","0","54.16","39.57"
"10","004","00","002","0206","0110","825","672","153","38","863","1548","0","55.75","43.41"
"10","004","00","002","0206","0111","591","478","113","33","624","1246","0","50.08","38.36"
"10","004","00","002","0206","0112","533","429","104","42","575","1252","0","45.93","34.27"
"10","004","00","002","0206","0113","671","555","116","47","718","1359","0","52.83","40.84"
"10","004","00","002","0206","0114","626","490","136","43","669","1255","0","53.31","39.04"
"10","004","00","002","0206","0115","712","566","146","38","750","1304","0","57.52","43.4"
"10","004","00","002","0207","0000","2387","1924","463","161","2548","4569","0","55.77","42.11"
"10","004","00","002","0207","0121","554","436","118","54","608","1126","0","54.0","38.72"
"10","004","00","002","0207","0122","545","442","103","40","585","1073","0","54.52","41.19"
"10","004","00","002","0207","0123","651","520","131","45","696","1215","0","57.28","42.8"
"10","004","00","002","0207","0124","637","526","111","22","659","1155","0","57.06","45.54"
"10","004","00","002","0208","0000","354","287","67","26","380","704","0","53.98","40.77"
"10","004","00","002","0208","0128","354","287","67","26","380","704","0","53.98","40.77"
"10","004","00","002","0209","0000","1348","1083","265","66","1414","3048","0","46.39","35.53"
"10","004","00","002","0209","0129","348","273","75","34","382","951","0","40.17","28.71"
"10","004","00","002","0209","0130","538","436","102","19","557","984","0","56.61","44.31"
"10","004","00","002","0209","0131","462","374","88","13","475","1113","0","42.68","33.6"
"10","004","00","002","0210","0000","750","575","175","72","822","1357","0","60.57","42.37"
"10","004","00","002","0210","0132","336","255","81","20","356","595","0","59.83","42.86"
"10","004","00","002","0210","0133","414","320","94","52","466","762","0","61.15","41.99"
"10","004","00","002","0211","0000","775","605","170","49","824","1400","0","58.86","43.21"
"10","004","00","002","0211","0142","404","309","95","35","439","715","0","61.4","43.22"
"10","004","00","002","0211","0143","371","296","75","14","385","685","0","56.2","43.21"
"10","004","00","002","0212","0000","1861","1498","363","96","1957","3875","0","50.5","38.66"
"10","004","00","002","0212","0136","590","465","125","29","619","1310","0","47.25","35.5"
"10","004","00","002","0212","0137","666","547","119","38","704","1434","0","49.09","38.15"
"10","004","00","002","0212","0138","605","486","119","29","634","1131","0","56.06","42.97"
"10","004","00","002","0213","0000","1703","1344","359","93","1796","3317","0","54.15","40.52"
"10","004","00","002","0213","0139","510","408","102","19","529","967","0","54.71","42.19"
"10","004","00","002","0213","0140","574","441","133","38","612","1196","0","51.17","36.87"
"10","004","00","002","0213","0141","619","495","124","36","655","1154","0","56.76","42.89"
"10","004","00","002","0214","0000","3598","2921","677","181","3779","7555","0","50.02","38.66"
"10","004","00","002","0214","0149","606","503","103","22","628","1248","0","50.32","40.3"
"10","004","00","002","0214","0150","539","434","105","27","566","1263","0","44.81","34.36"
"10","004","00","002","0214","0151","563","450","113","27","590","1232","0","47.89","36.53"
"10","004","00","002","0214","0152","510","407","103","31","541","1143","0","47.33","35.61"
"10","004","00","002","0214","0153","800","652","148","29","829","1529","0","54.22","42.64"
"10","004","00","002","0214","0154","580","475","105","45","625","1140","0","54.82","41.67"
"10","004","00","002","0215","0000","3108","2511","597","224","3332","6204","0","53.71","40.47"
"10","004","00","002","0215","0156","629","515","114","25","654","1345","0","48.62","38.29"
"10","004","00","002","0215","0157","676","529","147","56","732","1381","0","53.01","38.31"
"10","004","00","002","0215","0158","709","568","141","55","764","1379","0","55.4","41.19"
"10","004","00","002","0215","0159","547","437","110","53","600","1033","0","58.08","42.3"
"10","004","00","002","0215","0160","547","462","85","35","582","1066","0","54.6","43.34"
"10","004","00","002","0216","0000","2324","1814","510","110","2434","4350","0","55.95","41.7"
"10","004","00","002","0216","0169","586","451","135","36","622","1083","0","57.43","41.64"
"10","004","00","002","0216","0170","577","445","132","29","606","1102","0","54.99","40.38"
"10","004","00","002","0216","0171","560","466","94","20","580","1068","0","54.31","43.63"
"10","004","00","002","0216","0172","601","452","149","25","626","1097","0","57.06","41.2"
"10","004","00","002","0217","0000","947","764","183","48","995","1871","0","53.18","40.83"
"10","004","00","002","0217","0173","459","391","68","22","481","962","0","50.0","40.64"
"10","004","00","002","0217","0174","488","373","115","26","514","909","0","56.55","41.03"
"10","004","00","002","0218","0000","272","219","53","30","302","603","0","50.08","36.32"
"10","004","00","002","0218","0175","272","219","53","30","302","603","0","50.08","36.32"
"10","004","00","002","0219","0000","5224","4184","1040","286","5510","10396","0","53.0","40.25"
"10","004","00","002","0219","0161","516","412","104","38","554","938","0","59.06","43.92"
"10","004","00","002","0219","0162","546","444","102","40","586","952","0","61.55","46.64"
"10","004","00","002","0219","0163","828","677","151","43","871","1468","0","59.33","46.12"
"10","004","00","002","0219","0164","942","744","198","34","976","1915","0","50.97","38.85"
"10","004","00","002","0219","0165","585","464","121","43","628","1220","0","51.48","38.03"
"10","004","00","002","0219","0166","511","419","92","20","531","1166","0","45.54","35.93"
"10","004","00","002","0219","0167","683","551","132","30","713","1492","0","47.79","36.93"
"10","004","00","002","0219","0168","613","473","140","38","651","1245","0","52.29","37.99"
"10","004","00","002","0220","0000","938","703","235","72","1010","1727","0","58.48","40.71"
"10","004","00","002","0220","0125","441","338","103","43","484","852","0","56.81","39.67"
"10","004","00","002","0220","0126","497","365","132","29","526","875","0","60.11","41.71"
"10","004","00","002","0221","0000","1049","850","199","69","1118","1914","0","58.41","44.41"
"10","004","00","002","0221","0119","369","293","76","24","393","670","0","58.66","43.73"
"10","004","00","002","0221","0120","680","557","123","45","725","1244","0","58.28","44.77"
"10","004","00","002","0222","0000","622","504","118","32","654","1070","0","61.12","47.1"
"10","004","00","002","0222","0127","622","504","118","32","654","1070","0","61.12","47.1"
"10","004","00","002","0223","0000","3565","2916","649","227","3792","6892","0","55.02","42.31"
"10","004","00","002","0223","0144","668","532","136","50","718","1352","0","53.11","39.35"
"10","004","00","002","0223","0145","750","611","139","56","806","1407","0","57.29","43.43"
"10","004","00","002","0223","0146","700","595","105","29","729","1362","0","53.52","43.69"
"10","004","00","002","0223","0147","719","593","126","32","751","1330","0","56.47","44.59"
"10","004","00","002","0223","0148","728","585","143","60","788","1441","0","54.68","40.6"
"10","004","00","002","0224","0000","803","631","172","37","840","1576","0","53.3","40.04"
"10","004","00","002","0224","0134","400","311","89","21","421","763","0","55.18","40.76"
"10","004","00","002","0224","0135","403","320","83","16","419","813","0","51.54","39.36"
"10","004","00","002","0225","0000","346","255","91","18","364","570","0","63.86","44.74"
"10","004","00","002","0225","0155","346","255","91","18","364","570","0","63.86","44.74"
"10","004","00","003","0000","0000","15101","12046","3055","1093","16194","28894","33106","56.05","41.69"
"10","004","00","003","0301","0000","616","482","134","40","656","1139","0","57.59","42.32"
"10","004","00","003","0301","0194","616","482","134","40","656","1139","0","57.59","42.32"
"10","004","00","003","0302","0000","461","380","81","20","481","861","0","55.87","44.13"
"10","004","00","003","0302","0195","461","380","81","20","481","861","0","55.87","44.13"
"10","004","00","003","0303","0000","2046","1618","428","150","2196","4271","0","51.42","37.88"
"10","004","00","003","0303","0196","525","417","108","34","559","1093","0","51.14","38.15"
"10","004","00","003","0303","0197","468","366","102","40","508","978","0","51.94","37.42"
"10","004","00","003","0303","0198","469","366","103","38","507","1040","0","48.75","35.19"
"10","004","00","003","0303","0199","584","469","115","38","622","1160","0","53.62","40.43"
"10","004","00","003","0304","0000","1042","847","195","90","1132","1965","0","57.61","43.1"
"10","004","00","003","0304","0184","500","407","93","38","538","948","0","56.75","42.93"
"10","004","00","003","0304","0185","542","440","102","52","594","1017","0","58.41","43.26"
"10","004","00","003","0305","0000","1757","1389","368","114","1871","3320","0","56.36","41.84"
"10","004","00","003","0305","0186","677","550","127","41","718","1176","0","61.05","46.77"
"10","004","00","003","0305","0187","642","499","143","56","698","1122","0","62.21","44.47"
"10","004","00","003","0305","0188","438","340","98","17","455","1022","0","44.52","33.27"
"10","004","00","003","0306","0000","900","748","152","65","965","1829","0","52.76","40.9"
"10","004","00","003","0306","0182","481","395","86","37","518","924","0","56.06","42.75"
"10","004","00","003","0306","0183","419","353","66","28","447","905","0","49.39","39.01"
"10","004","00","003","0307","0000","1420","1149","271","91","1511","2526","0","59.82","45.49"
"10","004","00","003","0307","0179","489","406","83","38","527","935","0","56.36","43.42"
"10","004","00","003","0307","0180","405","316","89","27","432","753","0","57.37","41.97"
"10","004","00","003","0307","0181","526","427","99","26","552","838","0","65.87","50.95"
"10","004","00","003","0308","0000","537","440","97","49","586","983","0","59.61","44.76"
"10","004","00","003","0308","0176","537","440","97","49","586","983","0","59.61","44.76"
"10","004","00","003","0309","0000","343","262","81","26","369","597","0","61.81","43.89"
"10","004","00","003","0309","0177","343","262","81","26","369","597","0","61.81","43.89"
"10","004","00","003","0310","0000","556","464","92","27","583","1070","0","54.49","43.36"
"10","004","00","003","0310","0178","556","464","92","27","583","1070","0","54.49","43.36"
"10","004","00","003","0311","0000","1015","802","213","57","1072","1832","0","58.52","43.78"
"10","004","00","003","0311","0200","550","430","120","25","575","950","0","60.53","45.26"
"10","004","00","003","0311","0201","465","372","93","32","497","882","0","56.35","42.18"
"10","004","00","003","0312","0000","1297","1033","264","93","1390","2493","0","55.76","41.44"
"10","004","00","003","0312","0202","685","549","136","54","739","1281","0","57.69","42.86"
"10","004","00","003","0312","0203","612","484","128","39","651","1212","0","53.71","39.93"
"10","004","00","003","0313","0000","446","376","70","38","484","1013","0","47.78","37.12"
"10","004","00","003","0313","0204","446","376","70","38","484","1013","0","47.78","37.12"
"10","004","00","003","0314","0000","375","283","92","28","403","630","0","63.97","44.92"
"10","004","00","003","0314","0205","375","283","92","28","403","630","0","63.97","44.92"
"10","004","00","003","0315","0000","626","487","139","52","678","1144","0","59.27","42.57"
"10","004","00","003","0315","0193","626","487","139","52","678","1144","0","59.27","42.57"
"10","004","00","003","0316","0000","661","521","140","49","710","1429","0","49.69","36.46"
"10","004","00","003","0316","0189","661","521","140","49","710","1429","0","49.69","36.46"
"10","004","00","003","0317","0000","264","209","55","41","305","451","0","67.63","46.34"
"10","004","00","003","0317","0190","264","209","55","41","305","451","0","67.63","46.34"
"10","004","00","003","0318","0000","386","283","103","24","410","724","0","56.63","39.09"
"10","004","00","003","0318","0191","386","283","103","24","410","724","0","56.63","39.09"
"10","004","00","003","0319","0000","353","273","80","39","392","617","0","63.53","44.25"
"10","004","00","003","0319","0192","353","273","80","39","392","617","0","63.53","44.25"
"10","004","00","004","0000","0000","12983","10235","2748","974","13957","24712","28659","56.48","41.42"
"10","004","00","004","0401","0000","278","222","56","29","307","480","0","63.96","46.25"
"10","004","00","004","0401","0206","278","222","56","29","307","480","0","63.96","46.25"
"10","004","00","004","0402","0000","1061","834","227","76","1137","1923","0","59.13","43.37"
"10","004","00","004","0402","0207","505","401","104","38","543","903","0","60.13","44.41"
"10","004","00","004","0402","0208","556","433","123","38","594","1020","0","58.24","42.45"
"10","004","00","004","0403","0000","352","268","84","25","377","705","0","53.48","38.01"
"10","004","00","004","0403","0209","352","268","84","25","377","705","0","53.48","38.01"
"10","004","00","004","0404","0000","1903","1491","412","129","2032","3618","0","56.16","41.21"
"10","004","00","004","0404","0210","545","432","113","34","579","1056","0","54.83","40.91"
"10","004","00","004","0404","0211","653","488","165","46","699","1275","0","54.82","38.27"
"10","004","00","004","0404","0212","705","571","134","49","754","1287","0","58.59","44.37"
"10","004","00","004","0405","0000","526","411","115","43","569","1046","0","54.4","39.29"
"10","004","00","004","0405","0214","526","411","115","43","569","1046","0","54.4","39.29"
"10","004","00","004","0406","0000","437","330","107","29","466","771","0","60.44","42.8"
"10","004","00","004","0406","0213","437","330","107","29","466","771","0","60.44","42.8"
"10","004","00","004","0407","0000","553","427","126","49","602","1030","0","58.45","41.46"
"10","004","00","004","0407","0215","553","427","126","49","602","1030","0","58.45","41.46"
"10","004","00","004","0408","0000","1797","1452","345","127","1924","3653","0","52.67","39.75"
"10","004","00","004","0408","0216","645","530","115","40","685","1208","0","56.71","43.87"
"10","004","00","004","0408","0217","502","417","85","26","528","1095","0","48.22","38.08"
"10","004","00","004","0408","0218","650","505","145","61","711","1350","0","52.67","37.41"
"10","004","00","004","0409","0000","669","524","145","74","743","1362","0","54.55","38.47"
"10","004","00","004","0409","0220","669","524","145","74","743","1362","0","54.55","38.47"
"10","004","00","004","0410","0000","244","185","59","21","265","551","0","48.09","33.58"
"10","004","00","004","0410","0222","244","185","59","21","265","551","0","48.09","33.58"
"10","004","00","004","0411","0000","285","232","53","34","319","572","0","55.77","40.56"
"10","004","00","004","0411","0224","285","232","53","34","319","572","0","55.77","40.56"
"10","004","00","004","0412","0000","474","359","115","32","506","943","0","53.66","38.07"
"10","004","00","004","0412","0225","474","359","115","32","506","943","0","53.66","38.07"
"10","004","00","004","0413","0000","176","128","48","15","191","461","0","41.43","27.77"
"10","004","00","004","0413","0223","176","128","48","15","191","461","0","41.43","27.77"
"10","004","00","004","0414","0000","426","305","121","42","468","808","0","57.92","37.75"
"10","004","00","004","0414","0226","426","305","121","42","468","808","0","57.92","37.75"
"10","004","00","004","0415","0000","1058","869","189","60","1118","1826","0","61.23","47.59"
"10","004","00","004","0415","0227","559","463","96","24","583","923","0","63.16","50.16"
"10","004","00","004","0415","0228","499","406","93","36","535","903","0","59.25","44.96"
"10","004","00","004","0416","0000","464","357","107","40","504","824","0","61.17","43.33"
"10","004","00","004","0416","0230","464","357","107","40","504","824","0","61.17","43.33"
"10","004","00","004","0417","0000","326","272","54","16","342","559","0","61.18","48.66"
"10","004","00","004","0417","0231","326","272","54","16","342","559","0","61.18","48.66"
"10","004","00","004","0418","0000","504","424","80","30","534","854","0","62.53","49.65"
"10","004","00","004","0418","0232","504","424","80","30","534","854","0","62.53","49.65"
"10","004","00","004","0419","0000","509","401","108","26","535","846","0","63.24","47.4"
"10","004","00","004","0419","0219","509","401","108","26","535","846","0","63.24","47.4"
"10","004","00","004","0420","0000","411","309","102","34","445","903","0","49.28","34.22"
"10","004","00","004","0420","0221","411","309","102","34","445","903","0","49.28","34.22"
"10","004","00","004","0421","0000","530","435","95","43","573","977","0","58.65","44.52"
"10","004","00","004","0421","0229","530","435","95","43","573","977","0","58.65","44.52"
"10","004","00","005","0000","0000","33398","26766","6632","1932","35330","63511","77604","55.63","42.14"
"10","004","00","005","0501","0000","697","554","143","58","755","1272","0","59.36","43.55"
"10","004","00","005","0501","0245","697","554","143","58","755","1272","0","59.36","43.55"
"10","004","00","005","0502","0000","474","380","94","41","515","851","0","60.52","44.65"
"10","004","00","005","0502","0244","474","380","94","41","515","851","0","60.52","44.65"
"10","004","00","005","0503","0000","2228","1779","449","130","2358","3993","0","59.05","44.55"
"10","004","00","005","0503","0241","766","595","171","52","818","1444","0","56.65","41.2"
"10","004","00","005","0503","0242","776","625","151","61","837","1347","0","62.14","46.4"
"10","004","00","005","0503","0243","686","559","127","17","703","1202","0","58.49","46.51"
"10","004","00","005","0504","0000","2855","2218","637","179","3034","5202","0","58.32","42.64"
"10","004","00","005","0504","0250","714","554","160","39","753","1402","0","53.71","39.51"
"10","004","00","005","0504","0251","651","507","144","52","703","1183","0","59.43","42.86"
"10","004","00","005","0504","0252","730","578","152","50","780","1282","0","60.84","45.09"
"10","004","00","005","0504","0253","760","579","181","38","798","1335","0","59.78","43.37"
"10","004","00","005","0505","0000","1587","1276","311","52","1639","2835","0","57.81","45.01"
"10","004","00","005","0505","0246","683","548","135","40","723","1275","0","56.71","42.98"
"10","004","00","005","0505","0247","904","728","176","12","916","1560","0","58.72","46.67"
"10","004","00","005","0506","0000","2507","2005","502","148","2655","4714","0","56.32","42.53"
"10","004","00","005","0506","0238","939","757","182","59","998","1719","0","58.06","44.04"
"10","004","00","005","0506","0239","674","535","139","45","719","1162","0","61.88","46.04"
"10","004","00","005","0506","0240","894","713","181","44","938","1833","0","51.17","38.9"
"10","004","00","005","0507","0000","1377","1145","232","99","1476","2898","0","50.93","39.51"
"10","004","00","005","0507","0233","554","496","58","50","604","1393","0","43.36","35.61"
"10","004","00","005","0507","0234","823","649","174","49","872","1505","0","57.94","43.12"
"10","004","00","005","0508","0000","1528","1226","302","76","1604","3140","0","51.08","39.04"
"10","004","00","005","0508","0258","568","437","131","32","600","1193","0","50.29","36.63"
"10","004","00","005","0508","0259","960","789","171","44","1004","1947","0","51.57","40.52"
"10","004","00","005","0509","0000","623","445","178","49","672","1125","0","59.73","39.56"
"10","004","00","005","0509","0260","623","445","178","49","672","1125","0","59.73","39.56"
"10","004","00","005","0510","0000","1521","1222","299","90","1611","2783","0","57.89","43.91"
"10","004","00","005","0510","0261","570","469","101","41","611","1050","0","58.19","44.67"
"10","004","00","005","0510","0262","951","753","198","49","1000","1733","0","57.7","43.45"
"10","004","00","005","0511","0000","1316","1060","256","77","1393","2346","0","59.38","45.18"
"10","004","00","005","0511","0263","715","571","144","45","760","1284","0","59.19","44.47"
"10","004","00","005","0511","0264","601","489","112","32","633","1062","0","59.6","46.05"
"10","004","00","005","0512","0000","821","687","134","69","890","1547","0","57.53","44.41"
"10","004","00","005","0512","0265","821","687","134","69","890","1547","0","57.53","44.41"
"10","004","00","005","0513","0000","1249","972","277","105","1354","2197","0","61.63","44.24"
"10","004","00","005","0513","0256","625","511","114","43","668","1082","0","61.74","47.23"
"10","004","00","005","0513","0257","624","461","163","62","686","1115","0","61.52","41.35"
"10","004","00","005","0514","0000","2460","1954","506","152","2612","5072","0","51.5","38.53"
"10","004","00","005","0514","0270","565","459","106","36","601","1058","0","56.81","43.38"
"10","004","00","005","0514","0271","472","369","103","25","497","1220","0","40.74","30.25"
"10","004","00","005","0514","0272","712","552","160","36","748","1333","0","56.11","41.41"
"10","004","00","005","0514","0273","711","574","137","55","766","1461","0","52.43","39.29"
"10","004","00","005","0515","0000","1635","1311","324","86","1721","3233","0","53.23","40.55"
"10","004","00","005","0515","0277","701","550","151","40","741","1495","0","49.57","36.79"
"10","004","00","005","0515","0278","406","328","78","28","434","752","0","57.71","43.62"
"10","004","00","005","0515","0279","528","433","95","18","546","986","0","55.38","43.91"
"10","004","00","005","0516","0000","2772","2252","520","113","2885","5896","0","48.93","38.2"
"10","004","00","005","0516","0266","697","561","136","41","738","1494","0","49.4","37.55"
"10","004","00","005","0516","0267","751","600","151","34","785","1634","0","48.04","36.72"
"10","004","00","005","0516","0268","655","545","110","13","668","1444","0","46.26","37.74"
"10","004","00","005","0516","0269","669","546","123","25","694","1324","0","52.42","41.24"
"10","004","00","005","0517","0000","1865","1544","321","61","1926","3370","0","57.15","45.82"
"10","004","00","005","0517","0254","884","719","165","43","927","1493","0","62.09","48.16"
"10","004","00","005","0517","0255","981","825","156","18","999","1877","0","53.22","43.95"
"10","004","00","005","0518","0000","1574","1270","304","128","1702","2876","0","59.18","44.16"
"10","004","00","005","0518","0248","657","518","139","77","734","1147","0","63.99","45.16"
"10","004","00","005","0518","0249","917","752","165","51","968","1729","0","55.99","43.49"
"10","004","00","005","0519","0000","2297","1827","470","120","2417","4123","0","58.62","44.31"
"10","004","00","005","0519","0235","712","545","167","44","756","1188","0","63.64","45.88"
"10","004","00","005","0519","0236","682","541","141","45","727","1267","0","57.38","42.7"
"10","004","00","005","0519","0237","903","741","162","31","934","1668","0","56.0","44.42"
"10","004","00","005","0520","0000","2012","1639","373","99","2111","4038","0","52.28","40.59"
"10","004","00","005","0520","0274","713","568","145","32","745","1429","0","52.13","39.75"
"10","004","00","005","0520","0275","677","560","117","23","700","1506","0","46.48","37.18"
"10","004","00","005","0520","0276","622","511","111","44","666","1103","0","60.38","46.33"
"10","004","00","006","0000","0000","24023","19113","4910","1488","25511","45790","56957","55.71","41.74"
"10","004","00","006","0601","0000","520","403","117","57","577","1080","0","53.43","37.31"
"10","004","00","006","0601","0280","520","403","117","57","577","1080","0","53.43","37.31"
"10","004","00","006","0602","0000","891","706","185","57","948","1799","0","52.7","39.24"
"10","004","00","006","0602","0288","425","326","99","33","458","824","0","55.58","39.56"
"10","004","00","006","0602","0289","466","380","86","24","490","975","0","50.26","38.97"
"10","004","00","006","0603","0000","940","714","226","62","1002","1841","0","54.43","38.78"
"10","004","00","006","0603","0281","439","335","104","27","466","887","0","52.54","37.77"
"10","004","00","006","0603","0282","501","379","122","35","536","954","0","56.18","39.73"
"10","004","00","006","0604","0000","1357","1023","334","139","1496","2743","0","54.54","37.29"
"10","004","00","006","0604","0291","749","598","151","82","831","1477","0","56.26","40.49"
"10","004","00","006","0604","0292","608","425","183","57","665","1266","0","52.53","33.57"
"10","004","00","006","0605","0000","893","693","200","75","968","1765","0","54.84","39.26"
"10","004","00","006","0605","0286","485","370","115","43","528","891","0","59.26","41.53"
"10","004","00","006","0605","0287","408","323","85","32","440","874","0","50.34","36.96"
"10","004","00","006","0606","0000","427","321","106","49","476","847","0","56.2","37.9"
"10","004","00","006","0606","0290","427","321","106","49","476","847","0","56.2","37.9"
"10","004","00","006","0607","0000","1712","1355","357","100","1812","3232","0","56.06","41.92"
"10","004","00","006","0607","0283","518","412","106","32","550","1003","0","54.84","41.08"
"10","004","00","006","0607","0284","565","448","117","39","604","1106","0","54.61","40.51"
"10","004","00","006","0607","0285","629","495","134","29","658","1123","0","58.59","44.08"
"10","004","00","006","0608","0000","2697","2142","555","204","2901","5237","0","55.39","40.9"
"10","004","00","006","0608","0305","730","604","126","56","786","1302","0","60.37","46.39"
"10","004","00","006","0608","0306","726","555","171","63","789","1410","0","55.96","39.36"
"10","004","00","006","0608","0307","655","514","141","40","695","1267","0","54.85","40.57"
"10","004","00","006","0608","0308","586","469","117","45","631","1258","0","50.16","37.28"
"10","004","00","006","0609","0000","1016","744","272","115","1131","2092","0","54.06","35.56"
"10","004","00","006","0609","0293","497","375","122","63","560","1029","0","54.42","36.44"
"10","004","00","006","0609","0294","519","369","150","52","571","1063","0","53.72","34.71"
"10","004","00","006","0610","0000","1333","1105","228","51","1384","2500","0","55.36","44.2"
"10","004","00","006","0610","0295","558","467","91","23","581","1055","0","55.07","44.27"
"10","004","00","006","0610","0296","775","638","137","28","803","1445","0","55.57","44.15"
"10","004","00","006","0611","0000","2422","1988","434","85","2507","4382","0","57.21","45.37"
"10","004","00","006","0611","0311","644","516","128","35","679","1157","0","58.69","44.6"
"10","004","00","006","0611","0312","546","438","108","26","572","1089","0","52.53","40.22"
"10","004","00","006","0611","0313","640","532","108","9","649","1160","0","55.95","45.86"
"10","004","00","006","0611","0314","592","502","90","15","607","976","0","62.19","51.43"
"10","004","00","006","0612","0000","724","550","174","31","755","1486","0","50.81","37.01"
"10","004","00","006","0612","0303","724","550","174","31","755","1486","0","50.81","37.01"
"10","004","00","006","0613","0000","605","459","146","62","667","1067","0","62.51","43.02"
"10","004","00","006","0613","0304","605","459","146","62","667","1067","0","62.51","43.02"
"10","004","00","006","0614","0000","2088","1713","375","93","2181","3519","0","61.98","48.68"
"10","004","00","006","0614","0297","832","698","134","34","866","1413","0","61.29","49.4"
"10","004","00","006","0614","0298","604","489","115","31","635","971","0","65.4","50.36"
"10","004","00","006","0614","0299","652","526","126","28","680","1135","0","59.91","46.34"
"10","004","00","006","0615","0000","2235","1791","444","122","2357","4188","0","56.28","42.77"
"10","004","00","006","0615","0300","642","509","133","38","680","1269","0","53.59","40.11"
"10","004","00","006","0615","0301","674","533","141","37","711","1257","0","56.56","42.4"
"10","004","00","006","0615","0302","919","749","170","47","966","1662","0","58.12","45.07"
"10","004","00","006","0616","0000","2821","2311","510","140","2961","5339","0","55.46","43.29"
"10","004","00","006","0616","0315","767","606","161","39","806","1443","0","55.86","42.0"
"10","004","00","006","0616","0316","604","489","115","24","628","1247","0","50.36","39.21"
"10","004","00","006","0616","0317","764","645","119","27","791","1411","0","56.06","45.71"
"10","004","00","006","0616","0318","686","571","115","50","736","1238","0","59.45","46.12"
"10","004","00","006","0617","0000","1342","1095","247","46","1388","2673","0","51.93","40.97"
"10","004","00","006","0617","0309","570","470","100","17","587","1217","0","48.23","38.62"
"10","004","00","006","0617","0310","772","625","147","29","801","1456","0","55.01","42.93"
"10","004","00","007","0000","0000","9444","7422","2022","673","10117","17293","20043","58.5","42.92"
"10","004","00","007","0701","0000","345","260","85","29","374","534","0","70.04","48.69"
"10","004","00","007","0701","0320","345","260","85","29","374","534","0","70.04","48.69"
"10","004","00","007","0702","0000","234","173","61","9","243","417","0","58.27","41.49"
"10","004","00","007","0702","0319","234","173","61","9","243","417","0","58.27","41.49"
"10","004","00","007","0703","0000","526","436","90","39","565","963","0","58.67","45.28"
"10","004","00","007","0703","0321","526","436","90","39","565","963","0","58.67","45.28"
"10","004","00","007","0704","0000","252","203","49","20","272","418","0","65.07","48.56"
"10","004","00","007","0704","0322","252","203","49","20","272","418","0","65.07","48.56"
"10","004","00","007","0705","0000","1318","1018","300","83","1401","2666","0","52.55","38.18"
"10","004","00","007","0705","0323","673","531","142","48","721","1312","0","54.95","40.47"
"10","004","00","007","0705","0324","645","487","158","35","680","1354","0","50.22","35.97"
"10","004","00","007","0706","0000","851","662","189","108","959","1582","0","60.62","41.85"
"10","004","00","007","0706","0325","430","324","106","40","470","785","0","59.87","41.27"
"10","004","00","007","0706","0326","421","338","83","68","489","797","0","61.36","42.41"
"10","004","00","007","0707","0000","355","280","75","19","374","623","0","60.03","44.94"
"10","004","00","007","0707","0327","355","280","75","19","374","623","0","60.03","44.94"
"10","004","00","007","0708","0000","405","310","95","31","436","759","0","57.44","40.84"
"10","004","00","007","0708","0328","405","310","95","31","436","759","0","57.44","40.84"
"10","004","00","007","0709","0000","1239","1003","236","76","1315","2401","0","54.77","41.77"
"10","004","00","007","0709","0329","604","478","126","41","645","1272","0","50.71","37.58"
"10","004","00","007","0709","0330","635","525","110","35","670","1129","0","59.34","46.5"
"10","004","00","007","0710","0000","899","694","205","65","964","1552","0","62.11","44.72"
"10","004","00","007","0710","0331","418","319","99","25","443","713","0","62.13","44.74"
"10","004","00","007","0710","0332","481","375","106","40","521","839","0","62.1","44.7"
"10","004","00","007","0711","0000","2427","1925","502","137","2564","4276","0","59.96","45.02"
"10","004","00","007","0711","0333","701","556","145","34","735","1123","0","65.45","49.51"
"10","004","00","007","0711","0334","552","453","99","25","577","981","0","58.82","46.18"
"10","004","00","007","0711","0335","615","467","148","42","657","1078","0","60.95","43.32"
"10","004","00","007","0711","0336","559","449","110","36","595","1094","0","54.39","41.04"
"10","004","00","007","0712","0000","593","458","135","57","650","1102","0","58.98","41.56"
"10","004","00","007","0712","0337","593","458","135","57","650","1102","0","58.98","41.56"
"10","004","00","008","0000","0000","6159","4871","1288","516","6675","11346","13013","58.83","42.93"
"10","004","00","008","0801","0000","1925","1520","405","141","2066","3404","0","60.69","44.65"
"10","004","00","008","0801","0338","705","556","149","46","751","1231","0","61.01","45.17"
"10","004","00","008","0801","0339","576","458","118","53","629","1041","0","60.42","44.0"
"10","004","00","008","0801","0340","644","506","138","42","686","1132","0","60.6","44.7"
"10","004","00","008","0802","0000","475","372","103","33","508","859","0","59.14","43.31"
"10","004","00","008","0802","0341","475","372","103","33","508","859","0","59.14","43.31"
"10","004","00","008","0803","0000","105","80","25","13","118","204","0","57.84","39.22"
"10","004","00","008","0803","0342","105","80","25","13","118","204","0","57.84","39.22"
"10","004","00","008","0804","0000","89","65","24","11","100","222","0","45.05","29.28"
"10","004","00","008","0804","0343","89","65","24","11","100","222","0","45.05","29.28"
"10","004","00","008","0805","0000","178","131","47","40","218","338","0","64.5","38.76"
"10","004","00","008","0805","0344","178","131","47","40","218","338","0","64.5","38.76"
"10","004","00","008","0806","0000","458","367","91","34","492","916","0","53.71","40.07"
"10","004","00","008","0806","0345","458","367","91","34","492","916","0","53.71","40.07"
"10","004","00","008","0807","0000","202","157","45","24","226","463","0","48.81","33.91"
"10","004","00","008","0807","0348","202","157","45","24","226","463","0","48.81","33.91"
"10","004","00","008","0808","0000","527","426","101","53","580","978","0","59.3","43.56"
"10","004","00","008","0808","0349","400","333","67","39","439","690","0","63.62","48.26"
"10","004","00","008","0808","0350","127","93","34","14","141","288","0","48.96","32.29"
"10","004","00","008","0809","0000","912","730","182","67","979","1553","0","63.04","47.01"
"10","004","00","008","0809","0351","412","329","83","30","442","685","0","64.53","48.03"
"10","004","00","008","0809","0352","500","401","99","37","537","868","0","61.87","46.2"
"10","004","00","008","0810","0000","891","713","178","71","962","1561","0","61.63","45.68"
"10","004","00","008","0810","0353","891","713","178","71","962","1561","0","61.63","45.68"
"10","004","00","008","0811","0000","397","310","87","29","426","848","0","50.24","36.56"
"10","004","00","008","0811","0346","221","177","44","17","238","573","0","41.54","30.89"
"10","004","00","008","0811","0347","176","133","43","12","188","275","0","68.36","48.36"
"10","004","00","009","0000","0000","4261","3408","853","284","4545","8180","9352","55.56","41.66"
"10","004","00","009","0901","0000","546","422","124","19","565","1158","0","48.79","36.44"
"10","004","00","009","0901","0354","546","422","124","19","565","1158","0","48.79","36.44"
"10","004","00","009","0902","0000","675","519","156","57","732","1238","0","59.13","41.92"
"10","004","00","009","0902","0355","675","519","156","57","732","1238","0","59.13","41.92"
"10","004","00","009","0903","0000","1366","1113","253","99","1465","2584","0","56.7","43.07"
"10","004","00","009","0903","0357","507","412","95","31","538","931","0","57.79","44.25"
"10","004","00","009","0903","0358","859","701","158","68","927","1653","0","56.08","42.41"
"10","004","00","009","0904","0000","446","349","97","38","484","845","0","57.28","41.3"
"10","004","00","009","0904","0359","446","349","97","38","484","845","0","57.28","41.3"
"10","004","00","009","0905","0000","200","164","36","10","210","384","0","54.69","42.71"
"10","004","00","009","0905","0360","200","164","36","10","210","384","0","54.69","42.71"
"10","004","00","009","0906","0000","402","333","69","18","420","763","0","55.05","43.64"
"10","004","00","009","0906","0361","402","333","69","18","420","763","0","55.05","43.64"
"10","004","00","009","0907","0000","315","256","59","22","337","580","0","58.1","44.14"
"10","004","00","009","0907","0356","315","256","59","22","337","580","0","58.1","44.14"
"10","004","00","009","0908","0000","169","131","38","14","183","333","0","54.95","39.34"
"10","004","00","009","0908","0362","169","131","38","14","183","333","0","54.95","39.34"
"10","004","00","009","0909","0000","142","121","21","7","149","295","0","50.51","41.02"
"10","004","00","009","0909","0363","142","121","21","7","149","295","0","50.51","41.02"
"10","004","00","010","0000","0000","7153","5620","1533","431","7584","12973","14681","58.46","43.32"
"10","004","00","010","1001","0000","1406","1118","288","80","1486","2595","0","57.26","43.08"
"10","004","00","010","1001","0364","606","477","129","56","662","1158","0","57.17","41.19"
"10","004","00","010","1001","0365","800","641","159","24","824","1437","0","57.34","44.61"
"10","004","00","010","1002","0000","1053","845","208","47","1100","1900","0","57.89","44.47"
"10","004","00","010","1002","0368","1053","845","208","47","1100","1900","0","57.89","44.47"
"10","004","00","010","1003","0000","513","414","99","24","537","1056","0","50.85","39.2"
"10","004","00","010","1003","0369","513","414","99","24","537","1056","0","50.85","39.2"
"10","004","00","010","1004","0000","696","546","150","60","756","1205","0","62.74","45.31"
"10","004","00","010","1004","0370","696","546","150","60","756","1205","0","62.74","45.31"
"10","004","00","010","1005","0000","485","392","93","34","519","846","0","61.35","46.34"
"10","004","00","010","1005","0372","485","392","93","34","519","846","0","61.35","46.34"
"10","004","00","010","1006","0000","407","318","89","32","439","766","0","57.31","41.51"
"10","004","00","010","1006","0371","407","318","89","32","439","766","0","57.31","41.51"
"10","004","00","010","1007","0000","339","255","84","11","350","554","0","63.18","46.03"
"10","004","00","010","1007","0375","339","255","84","11","350","554","0","63.18","46.03"
"10","004","00","010","1008","0000","452","352","100","36","488","804","0","60.7","43.78"
"10","004","00","010","1008","0373","452","352","100","36","488","804","0","60.7","43.78"
"10","004","00","010","1009","0000","346","269","77","14","360","607","0","59.31","44.32"
"10","004","00","010","1009","0374","346","269","77","14","360","607","0","59.31","44.32"
"10","004","00","010","1010","0000","1456","1111","345","93","1549","2640","0","58.67","42.08"
"10","004","00","010","1010","0366","789","594","195","52","841","1470","0","57.21","40.41"
"10","004","00","010","1010","0367","667","517","150","41","708","1170","0","60.51","44.19"
"10","004","00","011","0000","0000","2770","2175","595","279","3049","5068","5638","60.16","42.92"
"10","004","00","011","1101","0000","523","409","114","47","570","879","0","64.85","46.53"
"10","004","00","011","1101","0376","523","409","114","47","570","879","0","64.85","46.53"
"10","004","00","011","1102","0000","380","295","85","50","430","683","0","62.96","43.19"
"10","004","00","011","1102","0377","380","295","85","50","430","683","0","62.96","43.19"
"10","004","00","011","1103","0000","339","257","82","26","365","604","0","60.43","42.55"
"10","004","00","011","1103","0378","339","257","82","26","365","604","0","60.43","42.55"
"10","004","00","011","1104","0000","773","628","145","84","857","1406","0","60.95","44.67"
"10","004","00","011","1104","0381","773","628","145","84","857","1406","0","60.95","44.67"
"10","004","00","011","1105","0000","285","215","70","28","313","615","0","50.89","34.96"
"10","004","00","011","1105","0379","178","139","39","21","199","339","0","58.7","41.0"
"10","004","00","011","1105","0380","107","76","31","7","114","276","0","41.3","27.54"
"10","004","00","011","1106","0000","470","371","99","44","514","881","0","58.34","42.11"
"10","004","00","011","1106","0382","265","220","45","24","289","462","0","62.55","47.62"
"10","004","00","011","1106","0383","205","151","54","20","225","419","0","53.7","36.04"
"10","004","00","012","0000","0000","2925","2212","713","213","3138","7364","9683","42.61","30.04"
"10","004","00","012","1201","0000","256","207","49","22","278","599","0","46.41","34.56"
"10","004","00","012","1201","0386","94","73","21","16","110","225","0","48.89","32.44"
"10","004","00","012","1201","0387","162","134","28","6","168","374","0","44.92","35.83"
"10","004","00","012","1202","0000","333","263","70","20","353","831","0","42.48","31.65"
"10","004","00","012","1202","0384","174","136","38","11","185","474","0","39.03","28.69"
"10","004","00","012","1202","0385","159","127","32","9","168","357","0","47.06","35.57"
"10","004","00","012","1203","0000","493","385","108","27","520","1263","0","41.17","30.48"
"10","004","00","012","1203","0388","299","234","65","10","309","773","0","39.97","30.27"
"10","004","00","012","1203","0389","194","151","43","17","211","490","0","43.06","30.82"
"10","004","00","012","1204","0000","338","236","102","62","400","613","0","65.25","38.5"
"10","004","00","012","1204","0392","338","236","102","62","400","613","0","65.25","38.5"
"10","004","00","012","1205","0000","434","344","90","14","448","1191","0","37.62","28.88"
"10","004","00","012","1205","0390","177","138","39","4","181","531","0","34.09","25.99"
"10","004","00","012","1205","0391","257","206","51","10","267","660","0","40.45","31.21"
"10","004","00","012","1206","0000","567","418","149","28","595","1294","0","45.98","32.3"
"10","004","00","012","1206","0393","251","179","72","2","253","593","0","42.66","30.19"
"10","004","00","012","1206","0394","240","176","64","18","258","575","0","44.87","30.61"
"10","004","00","012","1206","0395","76","63","13","8","84","126","0","66.67","50.0"
"10","004","00","012","1207","0000","504","359","145","40","544","1573","0","34.58","22.82"
"10","004","00","012","1207","0396","157","128","29","5","162","499","0","32.46","25.65"
"10","004","00","012","1207","0397","200","141","59","19","219","785","0","27.9","17.96"
"10","004","00","012","1207","0398","147","90","57","16","163","289","0","56.4","31.14"
"10","004","00","013","0000","0000","1548","1167","381","103","1651","3997","4802","41.31","29.2"
"10","004","00","013","1301","0000","611","467","144","48","659","1385","0","47.58","33.72"
"10","004","00","013","1301","0399","323","247","76","33","356","672","0","52.98","36.76"
"10","004","00","013","1301","0400","288","220","68","15","303","713","0","42.5","30.86"
"10","004","00","013","1302","0000","276","199","77","5","281","727","0","38.65","27.37"
"10","004","00","013","1302","0403","276","199","77","5","281","727","0","38.65","27.37"
"10","004","00","013","1303","0000","137","97","40","10","147","395","0","37.22","24.56"
"10","004","00","013","1303","0404","137","97","40","10","147","395","0","37.22","24.56"
"10","004","00","013","1304","0000","524","404","120","40","564","1490","0","37.85","27.11"
"10","004","00","013","1304","0401","190","149","41","7","197","594","0","33.16","25.08"
"10","004","00","013","1304","0402","334","255","79","33","367","896","0","40.96","28.46"
"10","005","00","000","0000","0000","242512","190918","51594","18483","260995","461580","549798","56.54","41.36"
"10","005","00","001","0000","0000","40490","33058","7432","2312","42802","74249","88300","57.65","44.52"
"10","005","00","001","0101","0000","592","502","90","32","624","1087","0","57.41","46.18"
"10","005","00","001","0101","0001","592","502","90","32","624","1087","0","57.41","46.18"
"10","005","00","001","0102","0000","2320","1915","405","115","2435","4075","0","59.75","46.99"
"10","005","00","001","0102","0049","617","498","119","26","643","1003","0","64.11","49.65"
"10","005","00","001","0102","0050","564","451","113","16","580","1000","0","58.0","45.1"
"10","005","00","001","0102","0051","550","467","83","37","587","1047","0","56.06","44.6"
"10","005","00","001","0102","0052","589","499","90","36","625","1025","0","60.98","48.68"
"10","005","00","001","0103","0000","539","450","89","32","571","1018","0","56.09","44.2"
"10","005","00","001","0103","0002","539","450","89","32","571","1018","0","56.09","44.2"
"10","005","00","001","0104","0000","1270","1042","228","77","1347","2234","0","60.3","46.64"
"10","005","00","001","0104","0009","630","516","114","30","660","1115","0","59.19","46.28"
"10","005","00","001","0104","0010","640","526","114","47","687","1119","0","61.39","47.01"
"10","005","00","001","0105","0000","2092","1699","393","102","2194","3685","0","59.54","46.11"
"10","005","00","001","0105","0011","664","525","139","32","696","1132","0","61.48","46.38"
"10","005","00","001","0105","0012","706","584","122","34","740","1289","0","57.41","45.31"
"10","005","00","001","0105","0013","722","590","132","36","758","1264","0","59.97","46.68"
"10","005","00","001","0106","0000","2082","1677","405","127","2209","3702","0","59.67","45.3"
"10","005","00","001","0106","0006","681","561","120","40","721","1203","0","59.93","46.63"
"10","005","00","001","0106","0007","724","586","138","49","773","1306","0","59.19","44.87"
"10","005","00","001","0106","0008","677","530","147","38","715","1193","0","59.93","44.43"
"10","005","00","001","0107","0000","1785","1471","314","101","1886","3358","0","56.16","43.81"
"10","005","00","001","0107","0003","609","506","103","25","634","1156","0","54.84","43.77"
"10","005","00","001","0107","0004","579","477","102","35","614","1118","0","54.92","42.67"
"10","005","00","001","0107","0005","597","488","109","41","638","1084","0","58.86","45.02"
"10","005","00","001","0108","0000","466","382","84","26","492","870","0","56.55","43.91"
"10","005","00","001","0108","0014","466","382","84","26","492","870","0","56.55","43.91"
"10","005","00","001","0109","0000","1632","1333","299","92","1724","3163","0","54.51","42.14"
"10","005","00","001","0109","0015","477","397","80","34","511","1008","0","50.69","39.38"
"10","005","00","001","0109","0016","536","429","107","32","568","1078","0","52.69","39.8"
"10","005","00","001","0109","0017","619","507","112","26","645","1077","0","59.89","47.08"
"10","005","00","001","0110","0000","455","364","91","48","503","894","0","56.26","40.72"
"10","005","00","001","0110","0019","455","364","91","48","503","894","0","56.26","40.72"
"10","005","00","001","0111","0000","278","221","57","25","303","522","0","58.05","42.34"
"10","005","00","001","0111","0020","278","221","57","25","303","522","0","58.05","42.34"
"10","005","00","001","0112","0000","476","382","94","33","509","880","0","57.84","43.41"
"10","005","00","001","0112","0018","476","382","94","33","509","880","0","57.84","43.41"
"10","005","00","001","0113","0000","2263","1842","421","140","2403","3964","0","60.62","46.47"
"10","005","00","001","0113","0024","660","532","128","49","709","1272","0","55.74","41.82"
"10","005","00","001","0113","0025","672","549","123","41","713","1112","0","64.12","49.37"
"10","005","00","001","0113","0026","519","432","87","25","544","813","0","66.91","53.14"
"10","005","00","001","0113","0027","412","329","83","25","437","767","0","56.98","42.89"
"10","005","00","001","0114","0000","814","655","159","58","872","1376","0","63.37","47.6"
"10","005","00","001","0114","0021","814","655","159","58","872","1376","0","63.37","47.6"
"10","005","00","001","0115","0000","939","774","165","37","976","1597","0","61.11","48.47"
"10","005","00","001","0115","0031","352","299","53","12","364","607","0","59.97","49.26"
"10","005","00","001","0115","0032","587","475","112","25","612","990","0","61.82","47.98"
"10","005","00","001","0116","0000","2672","2185","487","221","2893","5087","0","56.87","42.95"
"10","005","00","001","0116","0033","579","475","104","89","668","1230","0","54.31","38.62"
"10","005","00","001","0116","0034","747","613","134","44","791","1372","0","57.65","44.68"
"10","005","00","001","0116","0035","663","537","126","47","710","1213","0","58.53","44.27"
"10","005","00","001","0116","0036","683","560","123","41","724","1272","0","56.92","44.03"
"10","005","00","001","0117","0000","1718","1433","285","65","1783","3157","0","56.48","45.39"
"10","005","00","001","0117","0028","546","450","96","18","564","1010","0","55.84","44.55"
"10","005","00","001","0117","0029","635","532","103","32","667","1182","0","56.43","45.01"
"10","005","00","001","0117","0030","537","451","86","15","552","965","0","57.2","46.74"
"10","005","00","001","0118","0000","1901","1540","361","100","2001","3496","0","57.24","44.05"
"10","005","00","001","0118","0037","706","571","135","43","749","1221","0","61.34","46.76"
"10","005","00","001","0118","0038","601","495","106","45","646","1104","0","58.51","44.84"
"10","005","00","001","0118","0039","594","474","120","12","606","1171","0","51.75","40.48"
"10","005","00","001","0119","0000","2258","1803","455","133","2391","4135","0","57.82","43.6"
"10","005","00","001","0119","0040","735","600","135","50","785","1392","0","56.39","43.1"
"10","005","00","001","0119","0041","761","599","162","35","796","1356","0","58.7","44.17"
"10","005","00","001","0119","0042","762","604","158","48","810","1387","0","58.4","43.55"
"10","005","00","001","0120","0000","609","493","116","38","647","1180","0","54.83","41.78"
"10","005","00","001","0120","0063","609","493","116","38","647","1180","0","54.83","41.78"
"10","005","00","001","0121","0000","2043","1658","385","109","2152","3644","0","59.06","45.5"
"10","005","00","001","0121","0057","661","533","128","29","690","1125","0","61.33","47.38"
"10","005","00","001","0121","0058","660","530","130","35","695","1241","0","56.0","42.71"
"10","005","00","001","0121","0059","722","595","127","45","767","1278","0","60.02","46.56"
"10","005","00","001","0122","0000","2661","2181","480","129","2790","5200","0","53.65","41.94"
"10","005","00","001","0122","0053","594","485","109","16","610","1130","0","53.98","42.92"
"10","005","00","001","0122","0054","626","526","100","28","654","1146","0","57.07","45.9"
"10","005","00","001","0122","0055","787","627","160","45","832","1432","0","58.1","43.78"
"10","005","00","001","0122","0056","654","543","111","40","694","1492","0","46.51","36.39"
"10","005","00","001","0123","0000","1313","1068","245","86","1399","2472","0","56.59","43.2"
"10","005","00","001","0123","0022","717","589","128","34","751","1391","0","53.99","42.34"
"10","005","00","001","0123","0023","596","479","117","52","648","1081","0","59.94","44.31"
"10","005","00","001","0124","0000","801","637","164","55","856","1665","0","51.41","38.26"
"10","005","00","001","0124","0066","395","314","81","31","426","796","0","53.52","39.45"
"10","005","00","001","0124","0067","406","323","83","24","430","869","0","49.48","37.17"
"10","005","00","001","0125","0000","1882","1510","372","106","1988","3412","0","58.26","44.26"
"10","005","00","001","0125","0043","637","524","113","39","676","1206","0","56.05","43.45"
"10","005","00","001","0125","0044","601","471","130","36","637","1004","0","63.45","46.91"
"10","005","00","001","0125","0045","644","515","129","31","675","1202","0","56.16","42.85"
"10","005","00","001","0126","0000","1749","1445","304","87","1836","2900","0","63.31","49.83"
"10","005","00","001","0126","0046","612","499","113","30","642","1052","0","61.03","47.43"
"10","005","00","001","0126","0047","514","418","96","27","541","873","0","61.97","47.88"
"10","005","00","001","0126","0048","623","528","95","30","653","975","0","66.97","54.15"
"10","005","00","001","0127","0000","1064","893","171","55","1119","1984","0","56.4","45.01"
"10","005","00","001","0127","0064","610","501","109","26","636","1072","0","59.33","46.74"
"10","005","00","001","0127","0065","454","392","62","29","483","912","0","52.96","42.98"
"10","005","00","001","0128","0000","1816","1503","313","83","1899","3492","0","54.38","43.04"
"10","005","00","001","0128","0060","692","588","104","22","714","1293","0","55.22","45.48"
"10","005","00","001","0128","0061","677","554","123","32","709","1342","0","52.83","41.28"
"10","005","00","001","0128","0062","447","361","86","29","476","857","0","55.54","42.12"
"10","005","00","002","0000","0000","20314","15629","4685","1797","22111","38890","45367","56.86","40.19"
"10","005","00","002","0201","0000","1206","945","261","105","1311","2219","0","59.08","42.59"
"10","005","00","002","0201","0183","467","351","116","56","523","873","0","59.91","40.21"
"10","005","00","002","0201","0184","739","594","145","49","788","1346","0","58.54","44.13"
"10","005","00","002","0202","0000","878","682","196","74","952","1566","0","60.79","43.55"
"10","005","00","002","0202","0185","575","447","128","56","631","951","0","66.35","47.0"
"10","005","00","002","0202","0186","303","235","68","18","321","615","0","52.2","38.21"
"10","005","00","002","0203","0000","493","415","78","53","546","878","0","62.19","47.27"
"10","005","00","002","0203","0187","493","415","78","53","546","878","0","62.19","47.27"
"10","005","00","002","0204","0000","831","623","208","70","901","1543","0","58.39","40.38"
"10","005","00","002","0204","0188","441","335","106","26","467","767","0","60.89","43.68"
"10","005","00","002","0204","0189","390","288","102","44","434","776","0","55.93","37.11"
"10","005","00","002","0205","0000","581","453","128","56","637","1231","0","51.75","36.8"
"10","005","00","002","0205","0190","581","453","128","56","637","1231","0","51.75","36.8"
"10","005","00","002","0206","0000","1066","809","257","77","1143","1995","0","57.29","40.55"
"10","005","00","002","0206","0191","633","480","153","39","672","1145","0","58.69","41.92"
"10","005","00","002","0206","0192","433","329","104","38","471","850","0","55.41","38.71"
"10","005","00","002","0207","0000","516","379","137","62","578","1052","0","54.94","36.03"
"10","005","00","002","0207","0193","516","379","137","62","578","1052","0","54.94","36.03"
"10","005","00","002","0208","0000","1211","915","296","100","1311","2250","0","58.27","40.67"
"10","005","00","002","0208","0194","597","469","128","42","639","1114","0","57.36","42.1"
"10","005","00","002","0208","0195","614","446","168","58","672","1136","0","59.15","39.26"
"10","005","00","002","0209","0000","2129","1647","482","152","2281","3922","0","58.16","41.99"
"10","005","00","002","0209","0196","624","479","145","44","668","1194","0","55.95","40.12"
"10","005","00","002","0209","0197","849","677","172","51","900","1579","0","57.0","42.88"
"10","005","00","002","0209","0198","656","491","165","57","713","1149","0","62.05","42.73"
"10","005","00","002","0210","0000","1089","842","247","90","1179","2158","0","54.63","39.02"
"10","005","00","002","0210","0199","574","425","149","66","640","1057","0","60.55","40.21"
"10","005","00","002","0210","0200","515","417","98","24","539","1101","0","48.96","37.87"
"10","005","00","002","0211","0000","383","284","99","43","426","912","0","46.71","31.14"
"10","005","00","002","0211","0201","383","284","99","43","426","912","0","46.71","31.14"
"10","005","00","002","0212","0000","326","238","88","38","364","652","0","55.83","36.5"
"10","005","00","002","0212","0202","326","238","88","38","364","652","0","55.83","36.5"
"10","005","00","002","0213","0000","714","558","156","71","785","1348","0","58.23","41.39"
"10","005","00","002","0213","0203","714","558","156","71","785","1348","0","58.23","41.39"
"10","005","00","002","0214","0000","641","500","141","33","674","1395","0","48.32","35.84"
"10","005","00","002","0214","0204","329","240","89","18","347","733","0","47.34","32.74"
"10","005","00","002","0214","0205","312","260","52","15","327","662","0","49.4","39.27"
"10","005","00","002","0215","0000","971","767","204","90","1061","1803","0","58.85","42.54"
"10","005","00","002","0215","0206","472","370","102","44","516","893","0","57.78","41.43"
"10","005","00","002","0215","0207","499","397","102","46","545","910","0","59.89","43.63"
"10","005","00","002","0216","0000","634","469","165","62","696","1270","0","54.8","36.93"
"10","005","00","002","0216","0208","634","469","165","62","696","1270","0","54.8","36.93"
"10","005","00","002","0217","0000","263","203","60","29","292","545","0","53.58","37.25"
"10","005","00","002","0217","0209","263","203","60","29","292","545","0","53.58","37.25"
"10","005","00","002","0218","0000","439","349","90","62","501","792","0","63.26","44.07"
"10","005","00","002","0218","0210","439","349","90","62","501","792","0","63.26","44.07"
"10","005","00","002","0219","0000","1286","978","308","96","1382","2316","0","59.67","42.23"
"10","005","00","002","0219","0218","600","458","142","33","633","1082","0","58.5","42.33"
"10","005","00","002","0219","0219","686","520","166","63","749","1234","0","60.7","42.14"
"10","005","00","002","0220","0000","728","560","168","80","808","1609","0","50.22","34.8"
"10","005","00","002","0220","0212","324","254","70","20","344","827","0","41.6","30.71"
"10","005","00","002","0220","0213","404","306","98","60","464","782","0","59.34","39.13"
"10","005","00","002","0221","0000","820","618","202","76","896","1634","0","54.83","37.82"
"10","005","00","002","0221","0214","399","301","98","35","434","788","0","55.08","38.2"
"10","005","00","002","0221","0215","421","317","104","41","462","846","0","54.61","37.47"
"10","005","00","002","0222","0000","953","717","236","101","1054","1771","0","59.51","40.49"
"10","005","00","002","0222","0216","451","340","111","53","504","828","0","60.87","41.06"
"10","005","00","002","0222","0217","502","377","125","48","550","943","0","58.32","39.98"
"10","005","00","002","0223","0000","382","288","94","36","418","726","0","57.58","39.67"
"10","005","00","002","0223","0211","382","288","94","36","418","726","0","57.58","39.67"
"10","005","00","002","0224","0000","730","582","148","53","783","1434","0","54.6","40.59"
"10","005","00","002","0224","0220","730","582","148","53","783","1434","0","54.6","40.59"
"10","005","00","002","0225","0000","1044","808","236","88","1132","1869","0","60.57","43.23"
"10","005","00","002","0225","0221","531","423","108","39","570","987","0","57.75","42.86"
"10","005","00","002","0225","0222","513","385","128","49","562","882","0","63.72","43.65"
"10","005","00","003","0000","0000","14345","10767","3578","1550","15895","29709","34122","53.5","36.24"
"10","005","00","003","0301","0000","580","417","163","71","651","1142","0","57.01","36.51"
"10","005","00","003","0301","0149","580","417","163","71","651","1142","0","57.01","36.51"
"10","005","00","003","0302","0000","1040","764","276","128","1168","1952","0","59.84","39.14"
"10","005","00","003","0302","0150","511","370","141","59","570","884","0","64.48","41.86"
"10","005","00","003","0302","0151","529","394","135","69","598","1068","0","55.99","36.89"
"10","005","00","003","0303","0000","1036","795","241","92","1128","1868","0","60.39","42.56"
"10","005","00","003","0303","0152","526","408","118","42","568","1009","0","56.29","40.44"
"10","005","00","003","0303","0153","510","387","123","50","560","859","0","65.19","45.05"
"10","005","00","003","0304","0000","812","632","180","89","901","1551","0","58.09","40.75"
"10","005","00","003","0304","0157","449","352","97","55","504","761","0","66.23","46.25"
"10","005","00","003","0304","0158","363","280","83","34","397","790","0","50.25","35.44"
"10","005","00","003","0305","0000","352","262","90","56","408","686","0","59.48","38.19"
"10","005","00","003","0305","0156","352","262","90","56","408","686","0","59.48","38.19"
"10","005","00","003","0306","0000","1294","972","322","169","1463","2709","0","54.01","35.88"
"10","005","00","003","0306","0159","482","367","115","48","530","966","0","54.87","37.99"
"10","005","00","003","0306","0160","431","314","117","72","503","972","0","51.75","32.3"
"10","005","00","003","0306","0161","381","291","90","49","430","771","0","55.77","37.74"
"10","005","00","003","0307","0000","319","233","86","28","347","684","0","50.73","34.06"
"10","005","00","003","0307","0168","319","233","86","28","347","684","0","50.73","34.06"
"10","005","00","003","0308","0000","399","321","78","41","440","943","0","46.66","34.04"
"10","005","00","003","0308","0169","399","321","78","41","440","943","0","46.66","34.04"
"10","005","00","003","0309","0000","419","309","110","60","479","790","0","60.63","39.11"
"10","005","00","003","0309","0170","419","309","110","60","479","790","0","60.63","39.11"
"10","005","00","003","0310","0000","265","210","55","12","277","673","0","41.16","31.2"
"10","005","00","003","0310","0171","265","210","55","12","277","673","0","41.16","31.2"
"10","005","00","003","0311","0000","583","460","123","65","648","1232","0","52.6","37.34"
"10","005","00","003","0311","0172","583","460","123","65","648","1232","0","52.6","37.34"
"10","005","00","003","0312","0000","669","526","143","84","753","1286","0","58.55","40.9"
"10","005","00","003","0312","0173","669","526","143","84","753","1286","0","58.55","40.9"
"10","005","00","003","0313","0000","695","516","179","78","773","1418","0","54.51","36.39"
"10","005","00","003","0313","0174","341","249","92","46","387","649","0","59.63","38.37"
"10","005","00","003","0313","0175","354","267","87","32","386","769","0","50.2","34.72"
"10","005","00","003","0314","0000","834","620","214","77","911","1836","0","49.62","33.77"
"10","005","00","003","0314","0162","295","219","76","34","329","758","0","43.4","28.89"
"10","005","00","003","0314","0163","539","401","138","43","582","1078","0","53.99","37.2"
"10","005","00","003","0315","0000","172","126","46","27","199","459","0","43.36","27.45"
"10","005","00","003","0315","0164","172","126","46","27","199","459","0","43.36","27.45"
"10","005","00","003","0316","0000","403","317","86","46","449","894","0","50.22","35.46"
"10","005","00","003","0316","0165","403","317","86","46","449","894","0","50.22","35.46"
"10","005","00","003","0317","0000","148","106","42","11","159","402","0","39.55","26.37"
"10","005","00","003","0317","0166","148","106","42","11","159","402","0","39.55","26.37"
"10","005","00","003","0318","0000","399","292","107","35","434","802","0","54.11","36.41"
"10","005","00","003","0318","0167","399","292","107","35","434","802","0","54.11","36.41"
"10","005","00","003","0319","0000","1047","752","295","161","1208","2286","0","52.84","32.9"
"10","005","00","003","0319","0176","557","395","162","76","633","1148","0","55.14","34.41"
"10","005","00","003","0319","0177","490","357","133","85","575","1138","0","50.53","31.37"
"10","005","00","003","0320","0000","487","370","117","57","544","1121","0","48.53","33.01"
"10","005","00","003","0320","0178","487","370","117","57","544","1121","0","48.53","33.01"
"10","005","00","003","0321","0000","403","321","82","24","427","769","0","55.53","41.74"
"10","005","00","003","0321","0179","403","321","82","24","427","769","0","55.53","41.74"
"10","005","00","003","0322","0000","686","446","240","44","730","1415","0","51.59","31.52"
"10","005","00","003","0322","0180","286","188","98","8","294","616","0","47.73","30.52"
"10","005","00","003","0322","0181","400","258","142","36","436","799","0","54.57","32.29"
"10","005","00","003","0323","0000","337","257","80","35","372","743","0","50.07","34.59"
"10","005","00","003","0323","0182","337","257","80","35","372","743","0","50.07","34.59"
"10","005","00","003","0324","0000","966","743","223","60","1026","2048","0","50.1","36.28"
"10","005","00","003","0324","0154","561","420","141","41","602","1040","0","57.88","40.38"
"10","005","00","003","0324","0155","405","323","82","19","424","1008","0","42.06","32.04"
"10","005","00","004","0000","0000","36008","28434","7574","2346","38354","68528","86056","55.97","41.49"
"10","005","00","004","0401","0000","1068","823","245","67","1135","1912","0","59.36","43.04"
"10","005","00","004","0401","0270","615","460","155","35","650","1086","0","59.85","42.36"
"10","005","00","004","0401","0271","453","363","90","32","485","826","0","58.72","43.95"
"10","005","00","004","0402","0000","1749","1404","345","148","1897","3302","0","57.45","42.52"
"10","005","00","004","0402","0272","501","391","110","51","552","1051","0","52.52","37.2"
"10","005","00","004","0402","0273","691","576","115","39","730","1235","0","59.11","46.64"
"10","005","00","004","0402","0274","557","437","120","58","615","1016","0","60.53","43.01"
"10","005","00","004","0403","0000","1341","1029","312","96","1437","2773","0","51.82","37.11"
"10","005","00","004","0403","0275","734","543","191","64","798","1472","0","54.21","36.89"
"10","005","00","004","0403","0276","607","486","121","32","639","1301","0","49.12","37.36"
"10","005","00","004","0404","0000","2254","1815","439","129","2383","4519","0","52.73","40.16"
"10","005","00","004","0404","0277","737","589","148","42","779","1544","0","50.45","38.15"
"10","005","00","004","0404","0278","792","637","155","38","830","1512","0","54.89","42.13"
"10","005","00","004","0404","0279","725","589","136","49","774","1463","0","52.9","40.26"
"10","005","00","004","0405","0000","2932","2380","552","139","3071","5258","0","58.41","45.26"
"10","005","00","004","0405","0280","573","453","120","27","600","1073","0","55.92","42.22"
"10","005","00","004","0405","0281","795","643","152","33","828","1453","0","56.99","44.25"
"10","005","00","004","0405","0282","714","592","122","40","754","1245","0","60.56","47.55"
"10","005","00","004","0405","0283","850","692","158","39","889","1487","0","59.78","46.54"
"10","005","00","004","0406","0000","1850","1416","434","105","1955","3445","0","56.75","41.1"
"10","005","00","004","0406","0284","562","412","150","36","598","1018","0","58.74","40.47"
"10","005","00","004","0406","0285","631","486","145","25","656","1105","0","59.37","43.98"
"10","005","00","004","0406","0286","657","518","139","44","701","1322","0","53.03","39.18"
"10","005","00","004","0407","0000","1921","1552","369","111","2032","3343","0","60.78","46.43"
"10","005","00","004","0407","0287","634","530","104","27","661","1140","0","57.98","46.49"
"10","005","00","004","0407","0288","618","504","114","36","654","1067","0","61.29","47.24"
"10","005","00","004","0407","0289","669","518","151","48","717","1136","0","63.12","45.6"
"10","005","00","004","0408","0000","1583","1245","338","139","1722","3237","0","53.2","38.46"
"10","005","00","004","0408","0290","607","496","111","46","653","1253","0","52.11","39.58"
"10","005","00","004","0408","0291","467","363","104","46","513","963","0","53.27","37.69"
"10","005","00","004","0408","0292","509","386","123","47","556","1021","0","54.46","37.81"
"10","005","00","004","0409","0000","1153","951","202","87","1240","2111","0","58.74","45.05"
"10","005","00","004","0409","0297","514","410","104","48","562","989","0","56.83","41.46"
"10","005","00","004","0409","0298","639","541","98","39","678","1122","0","60.43","48.22"
"10","005","00","004","0410","0000","2257","1813","444","140","2397","4607","0","52.03","39.35"
"10","005","00","004","0410","0299","493","393","100","30","523","1111","0","47.07","35.37"
"10","005","00","004","0410","0300","562","442","120","53","615","1036","0","59.36","42.66"
"10","005","00","004","0410","0301","532","433","99","28","560","1112","0","50.36","38.94"
"10","005","00","004","0410","0302","670","545","125","29","699","1348","0","51.85","40.43"
"10","005","00","004","0411","0000","607","478","129","44","651","1059","0","61.47","45.14"
"10","005","00","004","0411","0306","607","478","129","44","651","1059","0","61.47","45.14"
"10","005","00","004","0412","0000","1573","1210","363","104","1677","2834","0","59.17","42.7"
"10","005","00","004","0412","0307","488","356","132","34","522","869","0","60.07","40.97"
"10","005","00","004","0412","0308","414","309","105","29","443","800","0","55.38","38.63"
"10","005","00","004","0412","0309","671","545","126","41","712","1165","0","61.12","46.78"
"10","005","00","004","0413","0000","761","585","176","68","829","1468","0","56.47","39.85"
"10","005","00","004","0413","0310","415","328","87","41","456","791","0","57.65","41.47"
"10","005","00","004","0413","0311","346","257","89","27","373","677","0","55.1","37.96"
"10","005","00","004","0414","0000","1084","869","215","82","1166","1988","0","58.65","43.71"
"10","005","00","004","0414","0312","469","361","108","49","518","797","0","64.99","45.29"
"10","005","00","004","0414","0313","615","508","107","33","648","1191","0","54.41","42.65"
"10","005","00","004","0415","0000","512","390","122","22","534","1027","0","52.0","37.97"
"10","005","00","004","0415","0314","512","390","122","22","534","1027","0","52.0","37.97"
"10","005","00","004","0416","0000","2050","1617","433","124","2174","3935","0","55.25","41.09"
"10","005","00","004","0416","0315","745","599","146","46","791","1341","0","58.99","44.67"
"10","005","00","004","0416","0316","651","504","147","52","703","1378","0","51.02","36.57"
"10","005","00","004","0416","0317","654","514","140","26","680","1216","0","55.92","42.27"
"10","005","00","004","0417","0000","1092","861","231","62","1154","2108","0","54.74","40.84"
"10","005","00","004","0417","0318","791","643","148","34","825","1570","0","52.55","40.96"
"10","005","00","004","0417","0319","301","218","83","28","329","538","0","61.15","40.52"
"10","005","00","004","0418","0000","520","423","97","24","544","1166","0","46.66","36.28"
"10","005","00","004","0418","0320","520","423","97","24","544","1166","0","46.66","36.28"
"10","005","00","004","0419","0000","2024","1577","447","131","2155","4119","0","52.32","38.29"
"10","005","00","004","0419","0321","747","575","172","28","775","1488","0","52.08","38.64"
"10","005","00","004","0419","0322","691","553","138","28","719","1449","0","49.62","38.16"
"10","005","00","004","0419","0323","586","449","137","75","661","1182","0","55.92","37.99"
"10","005","00","004","0420","0000","1106","840","266","121","1227","2158","0","56.86","38.92"
"10","005","00","004","0420","0324","595","439","156","75","670","1175","0","57.02","37.36"
"10","005","00","004","0420","0325","511","401","110","46","557","983","0","56.66","40.79"
"10","005","00","004","0421","0000","1951","1518","433","132","2083","3715","0","56.07","40.86"
"10","005","00","004","0421","0326","289","225","64","20","309","492","0","62.8","45.73"
"10","005","00","004","0421","0327","580","435","145","42","622","1074","0","57.91","40.5"
"10","005","00","004","0421","0328","427","314","113","41","468","852","0","54.93","36.85"
"10","005","00","004","0421","0329","655","544","111","29","684","1297","0","52.74","41.94"
"10","005","00","004","0422","0000","509","384","125","49","558","1028","0","54.28","37.35"
"10","005","00","004","0422","0330","509","384","125","49","558","1028","0","54.28","37.35"
"10","005","00","004","0423","0000","1723","1355","368","99","1822","3111","0","58.57","43.56"
"10","005","00","004","0423","0303","627","484","143","26","653","1114","0","58.62","43.45"
"10","005","00","004","0423","0304","626","484","142","44","670","1119","0","59.87","43.25"
"10","005","00","004","0423","0305","470","387","83","29","499","878","0","56.83","44.08"
"10","005","00","004","0424","0000","1171","931","240","52","1223","2109","0","57.99","44.14"
"10","005","00","004","0424","0295","709","567","142","34","743","1293","0","57.46","43.85"
"10","005","00","004","0424","0296","462","364","98","18","480","816","0","58.82","44.61"
"10","005","00","004","0425","0000","1217","968","249","71","1288","2196","0","58.65","44.08"
"10","005","00","004","0425","0293","651","519","132","41","692","1154","0","59.97","44.97"
"10","005","00","004","0425","0294","566","449","117","30","596","1042","0","57.2","43.09"
"10","005","00","005","0000","0000","44209","35262","8947","2801","47010","83617","103007","56.22","42.17"
"10","005","00","005","0501","0000","1096","830","266","136","1232","2207","0","55.82","37.61"
"10","005","00","005","0501","0331","422","321","101","75","497","915","0","54.32","35.08"
"10","005","00","005","0501","0332","674","509","165","61","735","1292","0","56.89","39.4"
"10","005","00","005","0502","0000","919","706","213","40","959","1763","0","54.4","40.05"
"10","005","00","005","0502","0333","527","394","133","25","552","928","0","59.48","42.46"
"10","005","00","005","0502","0334","392","312","80","15","407","835","0","48.74","37.37"
"10","005","00","005","0503","0000","1470","1153","317","85","1555","2988","0","52.04","38.59"
"10","005","00","005","0503","0335","557","444","113","30","587","1070","0","54.86","41.5"
"10","005","00","005","0503","0336","417","339","78","12","429","879","0","48.81","38.57"
"10","005","00","005","0503","0337","496","370","126","43","539","1039","0","51.88","35.61"
"10","005","00","005","0504","0000","1858","1498","360","160","2018","3716","0","54.31","40.31"
"10","005","00","005","0504","0338","604","500","104","52","656","1129","0","58.1","44.29"
"10","005","00","005","0504","0339","538","441","97","34","572","1041","0","54.95","42.36"
"10","005","00","005","0504","0340","716","557","159","74","790","1546","0","51.1","36.03"
"10","005","00","005","0505","0000","2219","1704","515","147","2366","4361","0","54.25","39.07"
"10","005","00","005","0505","0341","550","423","127","35","585","935","0","62.57","45.24"
"10","005","00","005","0505","0342","571","429","142","46","617","1180","0","52.29","36.36"
"10","005","00","005","0505","0343","710","547","163","50","760","1499","0","50.7","36.49"
"10","005","00","005","0505","0344","388","305","83","16","404","747","0","54.08","40.83"
"10","005","00","005","0506","0000","1335","1072","263","84","1419","2599","0","54.6","41.25"
"10","005","00","005","0506","0345","718","574","144","30","748","1406","0","53.2","40.83"
"10","005","00","005","0506","0346","617","498","119","54","671","1193","0","56.24","41.74"
"10","005","00","005","0507","0000","507","387","120","45","552","948","0","58.23","40.82"
"10","005","00","005","0507","0347","507","387","120","45","552","948","0","58.23","40.82"
"10","005","00","005","0508","0000","1740","1393","347","89","1829","3297","0","55.47","42.25"
"10","005","00","005","0508","0348","440","370","70","25","465","869","0","53.51","42.58"
"10","005","00","005","0508","0349","635","487","148","33","668","1142","0","58.49","42.64"
"10","005","00","005","0508","0350","665","536","129","31","696","1286","0","54.12","41.68"
"10","005","00","005","0509","0000","1763","1426","337","96","1859","3105","0","59.87","45.93"
"10","005","00","005","0509","0351","503","395","108","33","536","903","0","59.36","43.74"
"10","005","00","005","0509","0352","691","564","127","44","735","1186","0","61.97","47.55"
"10","005","00","005","0509","0353","569","467","102","19","588","1016","0","57.87","45.96"
"10","005","00","005","0510","0000","859","688","171","65","924","1536","0","60.16","44.79"
"10","005","00","005","0510","0357","486","404","82","32","518","890","0","58.2","45.39"
"10","005","00","005","0510","0358","373","284","89","33","406","646","0","62.85","43.96"
"10","005","00","005","0511","0000","430","338","92","34","464","947","0","49.0","35.69"
"10","005","00","005","0511","0356","430","338","92","34","464","947","0","49.0","35.69"
"10","005","00","005","0512","0000","624","514","110","47","671","1030","0","65.15","49.9"
"10","005","00","005","0512","0363","624","514","110","47","671","1030","0","65.15","49.9"
"10","005","00","005","0513","0000","1010","796","214","59","1069","1968","0","54.32","40.45"
"10","005","00","005","0513","0384","552","447","105","31","583","1121","0","52.01","39.88"
"10","005","00","005","0513","0385","458","349","109","28","486","847","0","57.38","41.2"
"10","005","00","005","0514","0000","1676","1358","318","140","1816","3454","0","52.58","39.32"
"10","005","00","005","0514","0388","768","624","144","59","827","1655","0","49.97","37.7"
"10","005","00","005","0514","0389","908","734","174","81","989","1799","0","54.97","40.8"
"10","005","00","005","0515","0000","2195","1799","396","119","2314","3884","0","59.58","46.32"
"10","005","00","005","0515","0367","749","601","148","49","798","1326","0","60.18","45.32"
"10","005","00","005","0515","0368","769","641","128","34","803","1270","0","63.23","50.47"
"10","005","00","005","0515","0369","677","557","120","36","713","1288","0","55.36","43.25"
"10","005","00","005","0516","0000","2059","1661","398","94","2153","3830","0","56.21","43.37"
"10","005","00","005","0516","0364","737","580","157","36","773","1338","0","57.77","43.35"
"10","005","00","005","0516","0365","740","604","136","35","775","1450","0","53.45","41.66"
"10","005","00","005","0516","0366","582","477","105","23","605","1042","0","58.06","45.78"
"10","005","00","005","0517","0000","1630","1342","288","70","1700","3125","0","54.4","42.94"
"10","005","00","005","0517","0376","853","711","142","34","887","1551","0","57.19","45.84"
"10","005","00","005","0517","0377","777","631","146","36","813","1574","0","51.65","40.09"
"10","005","00","005","0518","0000","1992","1588","404","101","2093","3984","0","52.54","39.86"
"10","005","00","005","0518","0390","624","485","139","38","662","1141","0","58.02","42.51"
"10","005","00","005","0518","0391","744","605","139","37","781","1431","0","54.58","42.28"
"10","005","00","005","0518","0392","624","498","126","26","650","1412","0","46.03","35.27"
"10","005","00","005","0519","0000","750","564","186","51","801","1344","0","59.6","41.96"
"10","005","00","005","0519","0395","750","564","186","51","801","1344","0","59.6","41.96"
"10","005","00","005","0520","0000","905","681","224","64","969","1990","0","48.69","34.22"
"10","005","00","005","0520","0359","528","399","129","49","577","975","0","59.18","40.92"
"10","005","00","005","0520","0360","377","282","95","15","392","1015","0","38.62","27.78"
"10","005","00","005","0521","0000","1431","1136","295","103","1534","2542","0","60.35","44.69"
"10","005","00","005","0521","0361","791","636","155","57","848","1399","0","60.61","45.46"
"10","005","00","005","0521","0362","640","500","140","46","686","1143","0","60.02","43.74"
"10","005","00","005","0522","0000","784","611","173","58","842","1363","0","61.78","44.83"
"10","005","00","005","0522","0396","784","611","173","58","842","1363","0","61.78","44.83"
"10","005","00","005","0523","0000","1363","1084","279","117","1480","2595","0","57.03","41.77"
"10","005","00","005","0523","0398","633","502","131","76","709","1182","0","59.98","42.47"
"10","005","00","005","0523","0399","730","582","148","41","771","1413","0","54.56","41.19"
"10","005","00","005","0524","0000","522","420","102","41","563","898","0","62.69","46.77"
"10","005","00","005","0524","0397","522","420","102","41","563","898","0","62.69","46.77"
"10","005","00","005","0525","0000","1240","975","265","72","1312","2171","0","60.43","44.91"
"10","005","00","005","0525","0400","586","460","126","30","616","991","0","62.16","46.42"
"10","005","00","005","0525","0401","654","515","139","42","696","1180","0","58.98","43.64"
"10","005","00","005","0526","0000","1003","839","164","66","1069","2048","0","52.2","40.97"
"10","005","00","005","0526","0386","565","430","135","33","598","993","0","60.22","43.3"
"10","005","00","005","0526","0387","438","409","29","33","471","1055","0","44.64","38.77"
"10","005","00","005","0527","0000","1229","999","230","78","1307","2319","0","56.36","43.08"
"10","005","00","005","0527","0393","532","431","101","32","564","1074","0","52.51","40.13"
"10","005","00","005","0527","0394","697","568","129","46","743","1245","0","59.68","45.62"
"10","005","00","005","0528","0000","2007","1587","420","109","2116","3507","0","60.34","45.25"
"10","005","00","005","0528","0378","697","543","154","37","734","1262","0","58.16","43.03"
"10","005","00","005","0528","0379","647","518","129","39","686","1171","0","58.58","44.24"
"10","005","00","005","0528","0380","663","526","137","33","696","1074","0","64.8","48.98"
"10","005","00","005","0529","0000","1972","1573","399","103","2075","3586","0","57.86","43.87"
"10","005","00","005","0529","0381","664","540","124","26","690","1141","0","60.47","47.33"
"10","005","00","005","0529","0382","694","545","149","36","730","1259","0","57.98","43.29"
"10","005","00","005","0529","0383","614","488","126","41","655","1186","0","55.23","41.15"
"10","005","00","005","0530","0000","1063","850","213","58","1121","2022","0","55.44","42.04"
"10","005","00","005","0530","0354","529","422","107","30","559","985","0","56.75","42.84"
"10","005","00","005","0530","0355","534","428","106","28","562","1037","0","54.19","41.27"
"10","005","00","005","0531","0000","1408","1156","252","62","1470","2523","0","58.26","45.82"
"10","005","00","005","0531","0370","687","568","119","32","719","1243","0","57.84","45.7"
"10","005","00","005","0531","0371","721","588","133","30","751","1280","0","58.67","45.94"
"10","005","00","005","0532","0000","1717","1357","360","128","1845","3377","0","54.63","40.18"
"10","005","00","005","0532","0372","829","642","187","79","908","1618","0","56.12","39.68"
"10","005","00","005","0532","0373","888","715","173","49","937","1759","0","53.27","40.65"
"10","005","00","005","0533","0000","1433","1177","256","80","1513","2590","0","58.42","45.44"
"10","005","00","005","0533","0374","708","584","124","41","749","1264","0","59.26","46.2"
"10","005","00","005","0533","0375","725","593","132","39","764","1326","0","57.62","44.72"
"10","005","00","006","0000","0000","15308","11663","3645","1670","16978","30948","36332","54.86","37.69"
"10","005","00","006","0601","0000","808","595","213","85","893","1473","0","60.62","40.39"
"10","005","00","006","0601","0223","299","216","83","36","335","590","0","56.78","36.61"
"10","005","00","006","0601","0224","509","379","130","49","558","883","0","63.19","42.92"
"10","005","00","006","0602","0000","437","340","97","57","494","793","0","62.3","42.88"
"10","005","00","006","0602","0225","437","340","97","57","494","793","0","62.3","42.88"
"10","005","00","006","0603","0000","731","536","195","68","799","1324","0","60.35","40.48"
"10","005","00","006","0603","0226","406","298","108","33","439","732","0","59.97","40.71"
"10","005","00","006","0603","0227","325","238","87","35","360","592","0","60.81","40.2"
"10","005","00","006","0604","0000","2197","1655","542","196","2393","4218","0","56.73","39.24"
"10","005","00","006","0604","0228","602","450","152","61","663","1113","0","59.57","40.43"
"10","005","00","006","0604","0229","618","486","132","59","677","1195","0","56.65","40.67"
"10","005","00","006","0604","0230","567","437","130","48","615","997","0","61.69","43.83"
"10","005","00","006","0604","0231","410","282","128","28","438","913","0","47.97","30.89"
"10","005","00","006","0605","0000","1167","892","275","111","1278","2304","0","55.47","38.72"
"10","005","00","006","0605","0246","575","438","137","50","625","1107","0","56.46","39.57"
"10","005","00","006","0605","0247","592","454","138","61","653","1197","0","54.55","37.93"
"10","005","00","006","0606","0000","776","624","152","76","852","1216","0","70.07","51.32"
"10","005","00","006","0606","0236","776","624","152","76","852","1216","0","70.07","51.32"
"10","005","00","006","0607","0000","492","400","92","39","531","977","0","54.35","40.94"
"10","005","00","006","0607","0237","492","400","92","39","531","977","0","54.35","40.94"
"10","005","00","006","0608","0000","1303","989","314","167","1470","2704","0","54.36","36.58"
"10","005","00","006","0608","0238","424","312","112","51","475","943","0","50.37","33.09"
"10","005","00","006","0608","0239","452","333","119","69","521","910","0","57.25","36.59"
"10","005","00","006","0608","0240","427","344","83","47","474","851","0","55.7","40.42"
"10","005","00","006","0609","0000","757","555","202","78","835","1375","0","60.73","40.36"
"10","005","00","006","0609","0241","414","295","119","33","447","725","0","61.66","40.69"
"10","005","00","006","0609","0242","343","260","83","45","388","650","0","59.69","40.0"
"10","005","00","006","0610","0000","319","226","93","49","368","706","0","52.12","32.01"
"10","005","00","006","0610","0243","319","226","93","49","368","706","0","52.12","32.01"
"10","005","00","006","0611","0000","698","534","164","76","774","1489","0","51.98","35.86"
"10","005","00","006","0611","0232","298","221","77","39","337","641","0","52.57","34.48"
"10","005","00","006","0611","0233","400","313","87","37","437","848","0","51.53","36.91"
"10","005","00","006","0612","0000","718","540","178","90","808","1549","0","52.16","34.86"
"10","005","00","006","0612","0244","381","272","109","50","431","748","0","57.62","36.36"
"10","005","00","006","0612","0245","337","268","69","40","377","801","0","47.07","33.46"
"10","005","00","006","0613","0000","611","471","140","91","702","1264","0","55.54","37.26"
"10","005","00","006","0613","0234","611","471","140","91","702","1264","0","55.54","37.26"
"10","005","00","006","0614","0000","447","332","115","42","489","965","0","50.67","34.4"
"10","005","00","006","0614","0235","447","332","115","42","489","965","0","50.67","34.4"
"10","005","00","006","0615","0000","473","363","110","53","526","1036","0","50.77","35.04"
"10","005","00","006","0615","0248","473","363","110","53","526","1036","0","50.77","35.04"
"10","005","00","006","0616","0000","374","274","100","38","412","913","0","45.13","30.01"
"10","005","00","006","0616","0249","374","274","100","38","412","913","0","45.13","30.01"
"10","005","00","006","0617","0000","383","287","96","57","440","719","0","61.2","39.92"
"10","005","00","006","0617","0250","383","287","96","57","440","719","0","61.2","39.92"
"10","005","00","006","0618","0000","507","410","97","92","599","1037","0","57.76","39.54"
"10","005","00","006","0618","0251","507","410","97","92","599","1037","0","57.76","39.54"
"10","005","00","006","0619","0000","286","226","60","20","306","601","0","50.92","37.6"
"10","005","00","006","0619","0252","286","226","60","20","306","601","0","50.92","37.6"
"10","005","00","006","0620","0000","529","405","124","49","578","1269","0","45.55","31.91"
"10","005","00","006","0620","0253","529","405","124","49","578","1269","0","45.55","31.91"
"10","005","00","006","0621","0000","323","254","69","34","357","735","0","48.57","34.56"
"10","005","00","006","0621","0254","323","254","69","34","357","735","0","48.57","34.56"
"10","005","00","006","0622","0000","462","362","100","38","500","1047","0","47.76","34.57"
"10","005","00","006","0622","0255","131","95","36","14","145","422","0","34.36","22.51"
"10","005","00","006","0622","0256","331","267","64","24","355","625","0","56.8","42.72"
"10","005","00","006","0623","0000","510","393","117","64","574","1234","0","46.52","31.85"
"10","005","00","006","0623","0257","510","393","117","64","574","1234","0","46.52","31.85"
"10","005","00","007","0000","0000","7853","6068","1785","698","8551","14772","16818","57.89","41.08"
"10","005","00","007","0701","0000","418","336","82","29","447","745","0","60.0","45.1"
"10","005","00","007","0701","0445","418","336","82","29","447","745","0","60.0","45.1"
"10","005","00","007","0702","0000","721","561","160","66","787","1528","0","51.51","36.71"
"10","005","00","007","0702","0446","382","294","88","48","430","783","0","54.92","37.55"
"10","005","00","007","0702","0447","339","267","72","18","357","745","0","47.92","35.84"
"10","005","00","007","0703","0000","1161","924","237","137","1298","2079","0","62.43","44.44"
"10","005","00","007","0703","0451","477","389","88","57","534","865","0","61.73","44.97"
"10","005","00","007","0703","0452","469","367","102","50","519","828","0","62.68","44.32"
"10","005","00","007","0703","0453","215","168","47","30","245","386","0","63.47","43.52"
"10","005","00","007","0704","0000","456","356","100","28","484","999","0","48.45","35.64"
"10","005","00","007","0704","0448","456","356","100","28","484","999","0","48.45","35.64"
"10","005","00","007","0705","0000","423","340","83","40","463","757","0","61.16","44.91"
"10","005","00","007","0705","0449","380","299","81","38","418","671","0","62.3","44.56"
"10","005","00","007","0705","0459","43","41","2","2","45","86","0","52.33","47.67"
"10","005","00","007","0706","0000","496","400","96","13","509","940","0","54.15","42.55"
"10","005","00","007","0706","0460","496","400","96","13","509","940","0","54.15","42.55"
"10","005","00","007","0707","0000","1066","768","298","93","1159","1978","0","58.59","38.83"
"10","005","00","007","0707","0442","556","369","187","31","587","961","0","61.08","38.4"
"10","005","00","007","0707","0443","510","399","111","62","572","1017","0","56.24","39.23"
"10","005","00","007","0708","0000","627","452","175","75","702","1095","0","64.11","41.28"
"10","005","00","007","0708","0444","627","452","175","75","702","1095","0","64.11","41.28"
"10","005","00","007","0709","0000","1250","973","277","117","1367","2209","0","61.88","44.05"
"10","005","00","007","0709","0454","408","322","86","36","444","688","0","64.53","46.8"
"10","005","00","007","0709","0455","447","348","99","47","494","792","0","62.37","43.94"
"10","005","00","007","0709","0456","395","303","92","34","429","729","0","58.85","41.56"
"10","005","00","007","0710","0000","421","336","85","59","480","734","0","65.4","45.78"
"10","005","00","007","0710","0450","421","336","85","59","480","734","0","65.4","45.78"
"10","005","00","007","0711","0000","814","622","192","41","855","1708","0","50.06","36.42"
"10","005","00","007","0711","0457","483","360","123","28","511","1093","0","46.75","32.94"
"10","005","00","007","0711","0458","331","262","69","13","344","615","0","55.93","42.6"
"10","005","00","008","0000","0000","6166","4826","1340","561","6727","12653","14521","53.17","38.14"
"10","005","00","008","0801","0000","831","653","178","59","890","1625","0","54.77","40.18"
"10","005","00","008","0801","0420","374","277","97","28","402","744","0","54.03","37.23"
"10","005","00","008","0801","0421","457","376","81","31","488","881","0","55.39","42.68"
"10","005","00","008","0802","0000","302","253","49","37","339","596","0","56.88","42.45"
"10","005","00","008","0802","0422","302","253","49","37","339","596","0","56.88","42.45"
"10","005","00","008","0803","0000","884","712","172","81","965","1790","0","53.91","39.78"
"10","005","00","008","0803","0424","421","339","82","34","455","867","0","52.48","39.1"
"10","005","00","008","0803","0425","463","373","90","47","510","923","0","55.25","40.41"
"10","005","00","008","0804","0000","673","504","169","64","737","1395","0","52.83","36.13"
"10","005","00","008","0804","0426","673","504","169","64","737","1395","0","52.83","36.13"
"10","005","00","008","0805","0000","189","142","47","14","203","561","0","36.19","25.31"
"10","005","00","008","0805","0427","189","142","47","14","203","561","0","36.19","25.31"
"10","005","00","008","0806","0000","569","461","108","83","652","1260","0","51.75","36.59"
"10","005","00","008","0806","0423","569","461","108","83","652","1260","0","51.75","36.59"
"10","005","00","008","0807","0000","343","267","76","27","370","638","0","57.99","41.85"
"10","005","00","008","0807","0428","343","267","76","27","370","638","0","57.99","41.85"
"10","005","00","008","0808","0000","709","529","180","59","768","1495","0","51.37","35.38"
"10","005","00","008","0808","0431","322","229","93","38","360","652","0","55.21","35.12"
"10","005","00","008","0808","0432","387","300","87","21","408","843","0","48.4","35.59"
"10","005","00","008","0809","0000","360","274","86","39","399","754","0","52.92","36.34"
"10","005","00","008","0809","0429","360","274","86","39","399","754","0","52.92","36.34"
"10","005","00","008","0810","0000","235","175","60","12","247","501","0","49.3","34.93"
"10","005","00","008","0810","0430","235","175","60","12","247","501","0","49.3","34.93"
"10","005","00","008","0811","0000","534","424","110","44","578","1020","0","56.67","41.57"
"10","005","00","008","0811","0433","534","424","110","44","578","1020","0","56.67","41.57"
"10","005","00","008","0812","0000","537","432","105","42","579","1018","0","56.88","42.44"
"10","005","00","008","0812","0434","537","432","105","42","579","1018","0","56.88","42.44"
"10","005","00","009","0000","0000","15377","12057","3320","1336","16713","28318","33327","59.02","42.58"
"10","005","00","009","0901","0000","965","762","203","77","1042","1581","0","65.91","48.2"
"10","005","00","009","0901","0068","473","365","108","48","521","789","0","66.03","46.26"
"10","005","00","009","0901","0069","492","397","95","29","521","792","0","65.78","50.13"
"10","005","00","009","0902","0000","1346","1047","299","157","1503","2372","0","63.36","44.14"
"10","005","00","009","0902","0070","628","478","150","90","718","1117","0","64.28","42.79"
"10","005","00","009","0902","0071","718","569","149","67","785","1255","0","62.55","45.34"
"10","005","00","009","0903","0000","1940","1512","428","123","2063","3413","0","60.45","44.3"
"10","005","00","009","0903","0072","641","517","124","40","681","1141","0","59.68","45.31"
"10","005","00","009","0903","0073","646","494","152","41","687","1172","0","58.62","42.15"
"10","005","00","009","0903","0074","653","501","152","42","695","1100","0","63.18","45.55"
"10","005","00","009","0904","0000","489","374","115","64","553","964","0","57.37","38.8"
"10","005","00","009","0904","0079","489","374","115","64","553","964","0","57.37","38.8"
"10","005","00","009","0905","0000","1121","897","224","100","1221","2313","0","52.79","38.78"
"10","005","00","009","0905","0075","611","488","123","41","652","1232","0","52.92","39.61"
"10","005","00","009","0905","0076","510","409","101","59","569","1081","0","52.64","37.84"
"10","005","00","009","0906","0000","1328","1072","256","78","1406","2331","0","60.32","45.99"
"10","005","00","009","0906","0077","737","615","122","38","775","1250","0","62.0","49.2"
"10","005","00","009","0906","0078","591","457","134","40","631","1081","0","58.37","42.28"
"10","005","00","009","0907","0000","795","625","170","68","863","1507","0","57.27","41.47"
"10","005","00","009","0907","0084","403","325","78","25","428","719","0","59.53","45.2"
"10","005","00","009","0907","0085","392","300","92","43","435","788","0","55.2","38.07"
"10","005","00","009","0908","0000","566","436","130","66","632","1038","0","60.89","42.0"
"10","005","00","009","0908","0080","566","436","130","66","632","1038","0","60.89","42.0"
"10","005","00","009","0909","0000","1065","834","231","86","1151","2031","0","56.67","41.06"
"10","005","00","009","0909","0082","457","350","107","42","499","865","0","57.69","40.46"
"10","005","00","009","0909","0083","608","484","124","44","652","1166","0","55.92","41.51"
"10","005","00","009","0910","0000","177","135","42","25","202","303","0","66.67","44.55"
"10","005","00","009","0910","0086","177","135","42","25","202","303","0","66.67","44.55"
"10","005","00","009","0911","0000","208","154","54","19","227","360","0","63.06","42.78"
"10","005","00","009","0911","0081","208","154","54","19","227","360","0","63.06","42.78"
"10","005","00","009","0912","0000","1236","969","267","92","1328","2255","0","58.89","42.97"
"10","005","00","009","0912","0087","758","601","157","37","795","1322","0","60.14","45.46"
"10","005","00","009","0912","0088","478","368","110","55","533","933","0","57.13","39.44"
"10","005","00","009","0913","0000","734","576","158","58","792","1455","0","54.43","39.59"
"10","005","00","009","0913","0089","734","576","158","58","792","1455","0","54.43","39.59"
"10","005","00","009","0914","0000","899","677","222","100","999","1615","0","61.86","41.92"
"10","005","00","009","0914","0090","899","677","222","100","999","1615","0","61.86","41.92"
"10","005","00","009","0915","0000","738","588","150","68","806","1451","0","55.55","40.52"
"10","005","00","009","0915","0091","738","588","150","68","806","1451","0","55.55","40.52"
"10","005","00","009","0916","0000","671","522","149","66","737","1317","0","55.96","39.64"
"10","005","00","009","0916","0093","671","522","149","66","737","1317","0","55.96","39.64"
"10","005","00","009","0917","0000","810","641","169","72","882","1462","0","60.33","43.84"
"10","005","00","009","0917","0092","810","641","169","72","882","1462","0","60.33","43.84"
"10","005","00","009","0918","0000","125","107","18","6","131","221","0","59.28","48.42"
"10","005","00","009","0918","0094","125","107","18","6","131","221","0","59.28","48.42"
"10","005","00","009","0919","0000","164","129","35","11","175","329","0","53.19","39.21"
"10","005","00","009","0919","0095","164","129","35","11","175","329","0","53.19","39.21"
"10","005","00","010","0000","0000","8063","6390","1673","577","8640","15424","17922","56.02","41.43"
"10","005","00","010","1001","0000","554","476","78","42","596","1029","0","57.92","46.26"
"10","005","00","010","1001","0114","554","476","78","42","596","1029","0","57.92","46.26"
"10","005","00","010","1002","0000","2522","1941","581","153","2675","4463","0","59.94","43.49"
"10","005","00","010","1002","0108","513","430","83","35","548","887","0","61.78","48.48"
"10","005","00","010","1002","0109","583","465","118","47","630","1052","0","59.89","44.2"
"10","005","00","010","1002","0110","800","646","154","26","826","1347","0","61.32","47.96"
"10","005","00","010","1002","0111","626","400","226","45","671","1177","0","57.01","33.98"
"10","005","00","010","1003","0000","926","753","173","61","987","1655","0","59.64","45.5"
"10","005","00","010","1003","0115","490","411","79","31","521","905","0","57.57","45.41"
"10","005","00","010","1003","0116","436","342","94","30","466","750","0","62.13","45.6"
"10","005","00","010","1004","0000","638","500","138","45","683","1268","0","53.86","39.43"
"10","005","00","010","1004","0112","638","500","138","45","683","1268","0","53.86","39.43"
"10","005","00","010","1005","0000","547","423","124","31","578","1185","0","48.78","35.7"
"10","005","00","010","1005","0113","547","423","124","31","578","1185","0","48.78","35.7"
"10","005","00","010","1006","0000","521","425","96","41","562","1080","0","52.04","39.35"
"10","005","00","010","1006","0117","521","425","96","41","562","1080","0","52.04","39.35"
"10","005","00","010","1007","0000","1582","1263","319","123","1705","3186","0","53.52","39.64"
"10","005","00","010","1007","0118","549","434","115","52","601","1108","0","54.24","39.17"
"10","005","00","010","1007","0119","414","338","76","43","457","862","0","53.02","39.21"
"10","005","00","010","1007","0120","619","491","128","28","647","1216","0","53.21","40.38"
"10","005","00","010","1008","0000","273","222","51","30","303","588","0","51.53","37.76"
"10","005","00","010","1008","0121","273","222","51","30","303","588","0","51.53","37.76"
"10","005","00","010","1009","0000","204","156","48","30","234","429","0","54.55","36.36"
"10","005","00","010","1009","0122","204","156","48","30","234","429","0","54.55","36.36"
"10","005","00","010","1010","0000","296","231","65","21","317","541","0","58.6","42.7"
"10","005","00","010","1010","0123","296","231","65","21","317","541","0","58.6","42.7"
"10","005","00","011","0000","0000","3932","2985","947","376","4308","8784","10130","49.04","33.98"
"10","005","00","011","1101","0000","580","434","146","59","639","1155","0","55.32","37.58"
"10","005","00","011","1101","0411","580","434","146","59","639","1155","0","55.32","37.58"
"10","005","00","011","1102","0000","324","237","87","41","365","650","0","56.15","36.46"
"10","005","00","011","1102","0412","324","237","87","41","365","650","0","56.15","36.46"
"10","005","00","011","1103","0000","638","474","164","62","700","1353","0","51.74","35.03"
"10","005","00","011","1103","0413","638","474","164","62","700","1353","0","51.74","35.03"
"10","005","00","011","1104","0000","315","238","77","40","355","813","0","43.67","29.27"
"10","005","00","011","1104","0414","315","238","77","40","355","813","0","43.67","29.27"
"10","005","00","011","1105","0000","329","262","67","28","357","837","0","42.65","31.3"
"10","005","00","011","1105","0415","329","262","67","28","357","837","0","42.65","31.3"
"10","005","00","011","1106","0000","536","418","118","36","572","1093","0","52.33","38.24"
"10","005","00","011","1106","0416","536","418","118","36","572","1093","0","52.33","38.24"
"10","005","00","011","1107","0000","521","390","131","50","571","1048","0","54.48","37.21"
"10","005","00","011","1107","0417","521","390","131","50","571","1048","0","54.48","37.21"
"10","005","00","011","1108","0000","403","314","89","46","449","872","0","51.49","36.01"
"10","005","00","011","1108","0418","403","314","89","46","449","872","0","51.49","36.01"
"10","005","00","011","1109","0000","286","218","68","14","300","963","0","31.15","22.64"
"10","005","00","011","1109","0419","286","218","68","14","300","963","0","31.15","22.64"
"10","005","00","012","0000","0000","5706","4274","1432","379","6085","9390","10711","64.8","45.52"
"10","005","00","012","1201","0000","1595","1289","306","125","1720","2503","0","68.72","51.5"
"10","005","00","012","1201","0096","833","670","163","60","893","1335","0","66.89","50.19"
"10","005","00","012","1201","0097","762","619","143","65","827","1168","0","70.8","53.0"
"10","005","00","012","1202","0000","1047","837","210","51","1098","1851","0","59.32","45.22"
"10","005","00","012","1202","0103","479","379","100","25","504","844","0","59.72","44.91"
"10","005","00","012","1202","0104","568","458","110","26","594","1007","0","58.99","45.48"
"10","005","00","012","1203","0000","435","364","71","28","463","725","0","63.86","50.21"
"10","005","00","012","1203","0100","435","364","71","28","463","725","0","63.86","50.21"
"10","005","00","012","1204","0000","1106","876","230","68","1174","1710","0","68.65","51.23"
"10","005","00","012","1204","0098","488","397","91","28","516","792","0","65.15","50.13"
"10","005","00","012","1204","0099","618","479","139","40","658","918","0","71.68","52.18"
"10","005","00","012","1205","0000","525","410","115","29","554","899","0","61.62","45.61"
"10","005","00","012","1205","0101","525","410","115","29","554","899","0","61.62","45.61"
"10","005","00","012","1206","0000","167","135","32","14","181","369","0","49.05","36.59"
"10","005","00","012","1206","0102","167","135","32","14","181","369","0","49.05","36.59"
"10","005","00","012","1207","0000","611","197","414","47","658","1005","0","65.47","19.6"
"10","005","00","012","1207","0105","471","80","391","30","501","794","0","63.1","10.08"
"10","005","00","012","1207","0106","140","117","23","17","157","211","0","74.41","55.45"
"10","005","00","012","1208","0000","220","166","54","17","237","328","0","72.26","50.61"
"10","005","00","012","1208","0107","220","166","54","17","237","328","0","72.26","50.61"
"10","005","00","013","0000","0000","7683","6215","1468","453","8136","13889","16277","58.58","44.75"
"10","005","00","013","1301","0000","2301","1876","425","129","2430","4132","0","58.81","45.4"
"10","005","00","013","1301","0124","481","385","96","42","523","853","0","61.31","45.13"
"10","005","00","013","1301","0125","587","483","104","24","611","983","0","62.16","49.14"
"10","005","00","013","1301","0126","611","485","126","37","648","1080","0","60.0","44.91"
"10","005","00","013","1301","0127","622","523","99","26","648","1216","0","53.29","43.01"
"10","005","00","013","1302","0000","962","772","190","41","1003","1825","0","54.96","42.3"
"10","005","00","013","1302","0132","492","391","101","24","516","991","0","52.07","39.46"
"10","005","00","013","1302","0133","470","381","89","17","487","834","0","58.39","45.68"
"10","005","00","013","1303","0000","759","592","167","67","826","1371","0","60.25","43.18"
"10","005","00","013","1303","0134","335","254","81","31","366","622","0","58.84","40.84"
"10","005","00","013","1303","0135","424","338","86","36","460","749","0","61.42","45.13"
"10","005","00","013","1304","0000","1843","1552","291","77","1920","3395","0","56.55","45.71"
"10","005","00","013","1304","0128","574","494","80","29","603","1017","0","59.29","48.57"
"10","005","00","013","1304","0129","605","489","116","28","633","1180","0","53.64","41.44"
"10","005","00","013","1304","0130","664","569","95","20","684","1198","0","57.1","47.5"
"10","005","00","013","1305","0000","928","734","194","67","995","1451","0","68.57","50.59"
"10","005","00","013","1305","0136","432","338","94","28","460","692","0","66.47","48.84"
"10","005","00","013","1305","0137","496","396","100","39","535","759","0","70.49","52.17"
"10","005","00","013","1306","0000","225","179","46","16","241","417","0","57.79","42.93"
"10","005","00","013","1306","0131","225","179","46","16","241","417","0","57.79","42.93"
"10","005","00","013","1307","0000","665","510","155","56","721","1298","0","55.55","39.29"
"10","005","00","013","1307","0138","310","238","72","25","335","629","0","53.26","37.84"
"10","005","00","013","1307","0139","355","272","83","31","386","669","0","57.7","40.66"
"10","005","00","014","0000","0000","3275","2572","703","247","3522","6382","7072","55.19","40.3"
"10","005","00","014","1401","0000","304","238","66","21","325","601","0","54.08","39.6"
"10","005","00","014","1401","0140","304","238","66","21","325","601","0","54.08","39.6"
"10","005","00","014","1402","0000","320","249","71","21","341","566","0","60.25","43.99"
"10","005","00","014","1402","0141","320","249","71","21","341","566","0","60.25","43.99"
"10","005","00","014","1403","0000","458","352","106","32","490","843","0","58.13","41.76"
"10","005","00","014","1403","0142","458","352","106","32","490","843","0","58.13","41.76"
"10","005","00","014","1404","0000","322","257","65","22","344","648","0","53.09","39.66"
"10","005","00","014","1404","0143","322","257","65","22","344","648","0","53.09","39.66"
"10","005","00","014","1405","0000","281","222","59","12","293","515","0","56.89","43.11"
"10","005","00","014","1405","0146","281","222","59","12","293","515","0","56.89","43.11"
"10","005","00","014","1406","0000","230","178","52","16","246","461","0","53.36","38.61"
"10","005","00","014","1406","0145","230","178","52","16","246","461","0","53.36","38.61"
"10","005","00","014","1407","0000","444","349","95","30","474","936","0","50.64","37.29"
"10","005","00","014","1407","0144","444","349","95","30","474","936","0","50.64","37.29"
"10","005","00","014","1408","0000","552","431","121","63","615","1141","0","53.9","37.77"
"10","005","00","014","1408","0147","552","431","121","63","615","1141","0","53.9","37.77"
"10","005","00","014","1409","0000","364","296","68","30","394","671","0","58.72","44.11"
"10","005","00","014","1409","0148","364","296","68","30","394","671","0","58.72","44.11"
"10","005","00","015","0000","0000","5822","4561","1261","591","6413","11027","12728","58.16","41.36"
"10","005","00","015","1501","0000","1194","976","218","98","1292","2060","0","62.72","47.38"
"10","005","00","015","1501","0258","702","571","131","62","764","1171","0","65.24","48.76"
"10","005","00","015","1501","0259","492","405","87","36","528","889","0","59.39","45.56"
"10","005","00","015","1502","0000","213","173","40","24","237","479","0","49.48","36.12"
"10","005","00","015","1502","0260","213","173","40","24","237","479","0","49.48","36.12"
"10","005","00","015","1503","0000","564","441","123","36","600","1024","0","58.59","43.07"
"10","005","00","015","1503","0261","564","441","123","36","600","1024","0","58.59","43.07"
"10","005","00","015","1504","0000","1661","1284","377","165","1826","3442","0","53.05","37.3"
"10","005","00","015","1504","0262","593","465","128","64","657","1214","0","54.12","38.3"
"10","005","00","015","1504","0263","512","380","132","50","562","1071","0","52.47","35.48"
"10","005","00","015","1504","0264","556","439","117","51","607","1157","0","52.46","37.94"
"10","005","00","015","1505","0000","261","208","53","36","297","512","0","58.01","40.63"
"10","005","00","015","1505","0265","261","208","53","36","297","512","0","58.01","40.63"
"10","005","00","015","1506","0000","285","225","60","25","310","491","0","63.14","45.82"
"10","005","00","015","1506","0266","285","225","60","25","310","491","0","63.14","45.82"
"10","005","00","015","1507","0000","701","553","148","65","766","1272","0","60.22","43.47"
"10","005","00","015","1507","0267","701","553","148","65","766","1272","0","60.22","43.47"
"10","005","00","015","1508","0000","410","315","95","42","452","785","0","57.58","40.13"
"10","005","00","015","1508","0268","410","315","95","42","452","785","0","57.58","40.13"
"10","005","00","015","1509","0000","533","386","147","100","633","962","0","65.8","40.12"
"10","005","00","015","1509","0269","533","386","147","100","633","962","0","65.8","40.12"
"10","005","00","016","0000","0000","3055","2313","742","320","3375","5852","6662","57.67","39.52"
"10","005","00","016","1601","0000","1169","919","250","116","1285","2201","0","58.38","41.75"
"10","005","00","016","1601","0402","550","437","113","44","594","996","0","59.64","43.88"
"10","005","00","016","1601","0403","619","482","137","72","691","1205","0","57.34","40.0"
"10","005","00","016","1602","0000","354","253","101","33","387","635","0","60.94","39.84"
"10","005","00","016","1602","0404","354","253","101","33","387","635","0","60.94","39.84"
"10","005","00","016","1603","0000","454","334","120","39","493","862","0","57.19","38.75"
"10","005","00","016","1603","0405","454","334","120","39","493","862","0","57.19","38.75"
"10","005","00","016","1604","0000","106","83","23","12","118","238","0","49.58","34.87"
"10","005","00","016","1604","0406","106","83","23","12","118","238","0","49.58","34.87"
"10","005","00","016","1605","0000","260","196","64","33","293","541","0","54.16","36.23"
"10","005","00","016","1605","0407","260","196","64","33","293","541","0","54.16","36.23"
"10","005","00","016","1606","0000","271","206","65","28","299","578","0","51.73","35.64"
"10","005","00","016","1606","0408","271","206","65","28","299","578","0","51.73","35.64"
"10","005","00","016","1607","0000","244","180","64","34","278","405","0","68.64","44.44"
"10","005","00","016","1607","0409","244","180","64","34","278","405","0","68.64","44.44"
"10","005","00","016","1608","0000","197","142","55","25","222","392","0","56.63","36.22"
"10","005","00","016","1608","0410","197","142","55","25","222","392","0","56.63","36.22"
"10","005","00","017","0000","0000","1824","1450","374","194","2018","3968","4370","50.86","36.54"
"10","005","00","017","1701","0000","119","96","23","8","127","328","0","38.72","29.27"
"10","005","00","017","1701","0435","119","96","23","8","127","328","0","38.72","29.27"
"10","005","00","017","1702","0000","208","147","61","41","249","565","0","44.07","26.02"
"10","005","00","017","1702","0436","208","147","61","41","249","565","0","44.07","26.02"
"10","005","00","017","1703","0000","462","369","93","62","524","911","0","57.52","40.5"
"10","005","00","017","1703","0437","462","369","93","62","524","911","0","57.52","40.5"
"10","005","00","017","1704","0000","240","193","47","26","266","568","0","46.83","33.98"
"10","005","00","017","1704","0438","240","193","47","26","266","568","0","46.83","33.98"
"10","005","00","017","1705","0000","316","250","66","25","341","580","0","58.79","43.1"
"10","005","00","017","1705","0439","316","250","66","25","341","580","0","58.79","43.1"
"10","005","00","017","1706","0000","157","128","29","9","166","333","0","49.85","38.44"
"10","005","00","017","1706","0440","157","128","29","9","166","333","0","49.85","38.44"
"10","005","00","017","1707","0000","322","267","55","23","345","683","0","50.51","39.09"
"10","005","00","017","1707","0441","322","267","55","23","345","683","0","50.51","39.09"
"10","005","00","018","0000","0000","3082","2394","688","275","3357","5180","6076","64.81","46.22"
"10","005","00","018","1801","0000","129","100","29","17","146","325","0","44.92","30.77"
"10","005","00","018","1801","0461","129","100","29","17","146","325","0","44.92","30.77"
"10","005","00","018","1802","0000","700","532","168","71","771","1150","0","67.04","46.26"
"10","005","00","018","1802","0462","263","195","68","23","286","484","0","59.09","40.29"
"10","005","00","018","1802","0463","437","337","100","48","485","666","0","72.82","50.6"
"10","005","00","018","1803","0000","501","408","93","57","558","907","0","61.52","44.98"
"10","005","00","018","1803","0464","345","273","72","44","389","574","0","67.77","47.56"
"10","005","00","018","1803","0465","156","135","21","13","169","333","0","50.75","40.54"
"10","005","00","018","1804","0000","318","253","65","17","335","495","0","67.68","51.11"
"10","005","00","018","1804","0466","318","253","65","17","335","495","0","67.68","51.11"
"10","005","00","018","1805","0000","355","265","90","38","393","544","0","72.24","48.71"
"10","005","00","018","1805","0467","355","265","90","38","393","544","0","72.24","48.71"
"10","005","00","018","1806","0000","212","152","60","23","235","500","0","47.0","30.4"
"10","005","00","018","1806","0468","212","152","60","23","235","500","0","47.0","30.4"
"10","005","00","018","1807","0000","431","325","106","46","477","670","0","71.19","48.51"
"10","005","00","018","1807","0469","431","325","106","46","477","670","0","71.19","48.51"
"10","005","00","018","1808","0000","436","359","77","6","442","589","0","75.04","60.95"
"10","005","00","018","1808","0470","436","359","77","6","442","589","0","75.04","60.95"
"10","007","00","000","0000","0000","559403","435289","124114","49307","608710","1066994","1278437","57.05","40.8"
"10","007","00","001","0000","0000","106931","82918","24013","8048","114979","190995","232709","60.2","43.41"
"10","007","00","001","0101","0000","784","607","177","47","831","1295","0","64.17","46.87"
"10","007","00","001","0101","0117","401","307","94","26","427","662","0","64.5","46.37"
"10","007","00","001","0101","0118","383","300","83","21","404","633","0","63.82","47.39"
"10","007","00","001","0102","0000","2872","2238","634","215","3087","5001","0","61.73","44.75"
"10","007","00","001","0102","0125","698","514","184","72","770","1263","0","60.97","40.7"
"10","007","00","001","0102","0126","744","585","159","54","798","1268","0","62.93","46.14"
"10","007","00","001","0102","0127","718","568","150","58","776","1258","0","61.69","45.15"
"10","007","00","001","0102","0128","712","571","141","31","743","1212","0","61.3","47.11"
"10","007","00","001","0103","0000","938","710","228","66","1004","1656","0","60.63","42.87"
"10","007","00","001","0103","0112","459","338","121","23","482","781","0","61.72","43.28"
"10","007","00","001","0103","0113","479","372","107","43","522","875","0","59.66","42.51"
"10","007","00","001","0104","0000","451","338","113","33","484","816","0","59.31","41.42"
"10","007","00","001","0104","0114","451","338","113","33","484","816","0","59.31","41.42"
"10","007","00","001","0105","0000","826","633","193","86","912","1414","0","64.5","44.77"
"10","007","00","001","0105","0115","400","300","100","38","438","687","0","63.76","43.67"
"10","007","00","001","0105","0116","426","333","93","48","474","727","0","65.2","45.8"
"10","007","00","001","0106","0000","999","781","218","80","1079","1759","0","61.34","44.4"
"10","007","00","001","0106","0119","549","432","117","38","587","906","0","64.79","47.68"
"10","007","00","001","0106","0120","450","349","101","42","492","853","0","57.68","40.91"
"10","007","00","001","0107","0000","2363","1859","504","153","2516","3986","0","63.12","46.64"
"10","007","00","001","0107","0121","603","491","112","41","644","1027","0","62.71","47.81"
"10","007","00","001","0107","0122","606","481","125","40","646","993","0","65.06","48.44"
"10","007","00","001","0107","0123","476","361","115","46","522","848","0","61.56","42.57"
"10","007","00","001","0107","0124","678","526","152","26","704","1118","0","62.97","47.05"
"10","007","00","001","0108","0000","2844","2198","646","147","2991","5156","0","58.01","42.63"
"10","007","00","001","0108","0106","661","495","166","7","668","1156","0","57.79","42.82"
"10","007","00","001","0108","0107","688","516","172","63","751","1235","0","60.81","41.78"
"10","007","00","001","0108","0108","738","588","150","45","783","1376","0","56.9","42.73"
"10","007","00","001","0108","0109","757","599","158","32","789","1389","0","56.8","43.12"
"10","007","00","001","0109","0000","1027","787","240","85","1112","1705","0","65.22","46.16"
"10","007","00","001","0109","0110","507","373","134","52","559","846","0","66.08","44.09"
"10","007","00","001","0109","0111","520","414","106","33","553","859","0","64.38","48.2"
"10","007","00","001","0110","0000","976","772","204","67","1043","1883","0","55.39","41.0"
"10","007","00","001","0110","0104","469","378","91","21","490","975","0","50.26","38.77"
"10","007","00","001","0110","0105","507","394","113","46","553","908","0","60.9","43.39"
"10","007","00","001","0111","0000","465","345","120","36","501","773","0","64.81","44.63"
"10","007","00","001","0111","0103","465","345","120","36","501","773","0","64.81","44.63"
"10","007","00","001","0112","0000","793","595","198","84","877","1420","0","61.76","41.9"
"10","007","00","001","0112","0101","400","293","107","44","444","692","0","64.16","42.34"
"10","007","00","001","0112","0102","393","302","91","40","433","728","0","59.48","41.48"
"10","007","00","001","0113","0000","528","384","144","48","576","893","0","64.5","43.0"
"10","007","00","001","0113","0099","528","384","144","48","576","893","0","64.5","43.0"
"10","007","00","001","0114","0000","416","298","118","48","464","691","0","67.15","43.13"
"10","007","00","001","0114","0098","416","298","118","48","464","691","0","67.15","43.13"
"10","007","00","001","0115","0000","412","300","112","44","456","733","0","62.21","40.93"
"10","007","00","001","0115","0100","412","300","112","44","456","733","0","62.21","40.93"
"10","007","00","001","0116","0000","492","356","136","65","557","910","0","61.21","39.12"
"10","007","00","001","0116","0054","492","356","136","65","557","910","0","61.21","39.12"
"10","007","00","001","0117","0000","447","317","130","48","495","771","0","64.2","41.12"
"10","007","00","001","0117","0051","447","317","130","48","495","771","0","64.2","41.12"
"10","007","00","001","0118","0000","481","344","137","43","524","868","0","60.37","39.63"
"10","007","00","001","0118","0052","481","344","137","43","524","868","0","60.37","39.63"
"10","007","00","001","0119","0000","626","448","178","63","689","1135","0","60.7","39.47"
"10","007","00","001","0119","0053","626","448","178","63","689","1135","0","60.7","39.47"
"10","007","00","001","0120","0000","2018","1602","416","134","2152","3360","0","64.05","47.68"
"10","007","00","001","0120","0056","630","498","132","42","672","1077","0","62.4","46.24"
"10","007","00","001","0120","0057","778","625","153","50","828","1258","0","65.82","49.68"
"10","007","00","001","0120","0058","610","479","131","42","652","1025","0","63.61","46.73"
"10","007","00","001","0121","0000","1969","1538","431","169","2138","3648","0","58.61","42.16"
"10","007","00","001","0121","0059","684","534","150","59","743","1177","0","63.13","45.37"
"10","007","00","001","0121","0060","663","531","132","52","715","1262","0","56.66","42.08"
"10","007","00","001","0121","0061","622","473","149","58","680","1209","0","56.24","39.12"
"10","007","00","001","0122","0000","622","476","146","76","698","1203","0","58.02","39.57"
"10","007","00","001","0122","0065","622","476","146","76","698","1203","0","58.02","39.57"
"10","007","00","001","0123","0000","1786","1406","380","135","1921","3145","0","61.08","44.71"
"10","007","00","001","0123","0062","614","458","156","46","660","1041","0","63.4","44.0"
"10","007","00","001","0123","0063","633","510","123","37","670","1075","0","62.33","47.44"
"10","007","00","001","0123","0064","539","438","101","52","591","1029","0","57.43","42.57"
"10","007","00","001","0124","0000","2159","1687","472","137","2296","4157","0","55.23","40.58"
"10","007","00","001","0124","0066","540","434","106","43","583","1014","0","57.5","42.8"
"10","007","00","001","0124","0067","610","479","131","35","645","1069","0","60.34","44.81"
"10","007","00","001","0124","0068","469","371","98","28","497","969","0","51.29","38.29"
"10","007","00","001","0124","0069","540","403","137","31","571","1105","0","51.67","36.47"
"10","007","00","001","0125","0000","568","406","162","42","610","1004","0","60.76","40.44"
"10","007","00","001","0125","0055","568","406","162","42","610","1004","0","60.76","40.44"
"10","007","00","001","0126","0000","1899","1412","487","187","2086","3496","0","59.67","40.39"
"10","007","00","001","0126","0090","639","492","147","57","696","1201","0","57.95","40.97"
"10","007","00","001","0126","0091","604","435","169","60","664","1057","0","62.82","41.15"
"10","007","00","001","0126","0092","656","485","171","70","726","1238","0","58.64","39.18"
"10","007","00","001","0127","0000","1147","894","253","132","1279","2130","0","60.05","41.97"
"10","007","00","001","0127","0088","597","461","136","80","677","1153","0","58.72","39.98"
"10","007","00","001","0127","0089","550","433","117","52","602","977","0","61.62","44.32"
"10","007","00","001","0128","0000","1001","802","199","85","1086","1799","0","60.37","44.58"
"10","007","00","001","0128","0086","423","347","76","43","466","799","0","58.32","43.43"
"10","007","00","001","0128","0087","578","455","123","42","620","1000","0","62.0","45.5"
"10","007","00","001","0129","0000","1794","1396","398","97","1891","3091","0","61.18","45.16"
"10","007","00","001","0129","0083","506","402","104","43","549","890","0","61.69","45.17"
"10","007","00","001","0129","0084","684","517","167","27","711","1104","0","64.4","46.83"
"10","007","00","001","0129","0085","604","477","127","27","631","1097","0","57.52","43.48"
"10","007","00","001","0130","0000","1967","1523","444","128","2095","3297","0","63.54","46.19"
"10","007","00","001","0130","0093","705","546","159","42","747","1210","0","61.74","45.12"
"10","007","00","001","0130","0094","590","462","128","47","637","1026","0","62.09","45.03"
"10","007","00","001","0130","0095","672","515","157","39","711","1061","0","67.01","48.54"
"10","007","00","001","0131","0000","2446","1863","583","170","2616","4213","0","62.09","44.22"
"10","007","00","001","0131","0070","587","449","138","42","629","981","0","64.12","45.77"
"10","007","00","001","0131","0071","629","462","167","57","686","1095","0","62.65","42.19"
"10","007","00","001","0131","0072","633","493","140","34","667","1087","0","61.36","45.35"
"10","007","00","001","0131","0073","597","459","138","37","634","1050","0","60.38","43.71"
"10","007","00","001","0132","0000","1363","1043","320","129","1492","2545","0","58.62","40.98"
"10","007","00","001","0132","0001","486","378","108","38","524","871","0","60.16","43.4"
"10","007","00","001","0132","0002","321","241","80","40","361","751","0","48.07","32.09"
"10","007","00","001","0132","0003","556","424","132","51","607","923","0","65.76","45.94"
"10","007","00","001","0133","0000","1410","1107","303","85","1495","2477","0","60.36","44.69"
"10","007","00","001","0133","0096","673","527","146","50","723","1213","0","59.6","43.45"
"10","007","00","001","0133","0097","737","580","157","35","772","1264","0","61.08","45.89"
"10","007","00","001","0134","0000","879","646","233","82","961","1558","0","61.68","41.46"
"10","007","00","001","0134","0004","434","312","122","49","483","779","0","62.0","40.05"
"10","007","00","001","0134","0005","445","334","111","33","478","779","0","61.36","42.88"
"10","007","00","001","0135","0000","544","404","140","41","585","1027","0","56.96","39.34"
"10","007","00","001","0135","0010","544","404","140","41","585","1027","0","56.96","39.34"
"10","007","00","001","0136","0000","666","523","143","56","722","1249","0","57.81","41.87"
"10","007","00","001","0136","0011","666","523","143","56","722","1249","0","57.81","41.87"
"10","007","00","001","0137","0000","1048","799","249","105","1153","1814","0","63.56","44.05"
"10","007","00","001","0137","0008","458","362","96","42","500","767","0","65.19","47.2"
"10","007","00","001","0137","0009","590","437","153","63","653","1047","0","62.37","41.74"
"10","007","00","001","0138","0000","791","580","211","78","869","1469","0","59.16","39.48"
"10","007","00","001","0138","0006","386","276","110","38","424","720","0","58.89","38.33"
"10","007","00","001","0138","0007","405","304","101","40","445","749","0","59.41","40.59"
"10","007","00","001","0139","0000","4239","3246","993","286","4525","7563","0","59.83","42.92"
"10","007","00","001","0139","0035","551","439","112","43","594","1045","0","56.84","42.01"
"10","007","00","001","0139","0036","615","471","144","15","630","1097","0","57.43","42.94"
"10","007","00","001","0139","0037","640","488","152","53","693","1190","0","58.24","41.01"
"10","007","00","001","0139","0038","636","476","160","56","692","1106","0","62.57","43.04"
"10","007","00","001","0139","0039","631","500","131","30","661","1097","0","60.26","45.58"
"10","007","00","001","0139","0040","590","427","163","50","640","1048","0","61.07","40.74"
"10","007","00","001","0139","0041","576","445","131","39","615","980","0","62.76","45.41"
"10","007","00","001","0140","0000","862","651","211","68","930","1516","0","61.35","42.94"
"10","007","00","001","0140","0042","412","304","108","27","439","707","0","62.09","43.0"
"10","007","00","001","0140","0043","450","347","103","41","491","809","0","60.69","42.89"
"10","007","00","001","0141","0000","2571","2077","494","204","2775","4896","0","56.68","42.42"
"10","007","00","001","0141","0025","636","476","160","57","693","1207","0","57.42","39.44"
"10","007","00","001","0141","0026","541","523","18","51","592","1161","0","50.99","45.05"
"10","007","00","001","0141","0027","615","446","169","40","655","1166","0","56.17","38.25"
"10","007","00","001","0141","0028","779","632","147","56","835","1362","0","61.31","46.4"
"10","007","00","001","0142","0000","4066","3115","951","245","4311","7131","0","60.45","43.68"
"10","007","00","001","0142","0029","730","540","190","40","770","1236","0","62.3","43.69"
"10","007","00","001","0142","0030","603","480","123","43","646","1065","0","60.66","45.07"
"10","007","00","001","0142","0031","672","514","158","51","723","1199","0","60.3","42.87"
"10","007","00","001","0142","0032","707","537","170","34","741","1233","0","60.1","43.55"
"10","007","00","001","0142","0033","681","551","130","41","722","1245","0","57.99","44.26"
"10","007","00","001","0142","0034","673","493","180","36","709","1153","0","61.49","42.76"
"10","007","00","001","0143","0000","1585","1207","378","129","1714","2928","0","58.54","41.22"
"10","007","00","001","0143","0045","459","341","118","58","517","901","0","57.38","37.85"
"10","007","00","001","0143","0046","519","400","119","29","548","951","0","57.62","42.06"
"10","007","00","001","0143","0047","607","466","141","42","649","1076","0","60.32","43.31"
"10","007","00","001","0144","0000","1570","1221","349","120","1690","2932","0","57.64","41.64"
"10","007","00","001","0144","0048","494","391","103","33","527","1022","0","51.57","38.26"
"10","007","00","001","0144","0049","492","373","119","44","536","894","0","59.96","41.72"
"10","007","00","001","0144","0050","584","457","127","43","627","1016","0","61.71","44.98"
"10","007","00","001","0145","0000","810","617","193","49","859","1409","0","60.97","43.79"
"10","007","00","001","0145","0014","453","340","113","30","483","766","0","63.05","44.39"
"10","007","00","001","0145","0015","357","277","80","19","376","643","0","58.48","43.08"
"10","007","00","001","0146","0000","1145","908","237","104","1249","2552","0","48.94","35.58"
"10","007","00","001","0146","0016","678","557","121","63","741","1251","0","59.23","44.52"
"10","007","00","001","0146","0017","467","351","116","41","508","1301","0","39.05","26.98"
"10","007","00","001","0147","0000","4953","3951","1002","245","5198","8589","0","60.52","46.0"
"10","007","00","001","0147","0018","727","566","161","40","767","1280","0","59.92","44.22"
"10","007","00","001","0147","0019","684","542","142","41","725","1179","0","61.49","45.97"
"10","007","00","001","0147","0020","656","512","144","32","688","1168","0","58.9","43.84"
"10","007","00","001","0147","0021","670","531","139","48","718","1218","0","58.95","43.6"
"10","007","00","001","0147","0022","835","634","201","37","872","1351","0","64.54","46.93"
"10","007","00","001","0147","0023","688","625","63","30","718","1204","0","59.63","51.91"
"10","007","00","001","0147","0024","693","541","152","17","710","1189","0","59.71","45.5"
"10","007","00","001","0148","0000","1291","1003","288","103","1394","2305","0","60.48","43.51"
"10","007","00","001","0148","0012","623","474","149","46","669","1136","0","58.89","41.73"
"10","007","00","001","0148","0013","668","529","139","57","725","1169","0","62.02","45.25"
"10","007","00","001","0149","0000","581","428","153","50","631","1008","0","62.6","42.46"
"10","007","00","001","0149","0044","581","428","153","50","631","1008","0","62.6","42.46"
"10","007","00","001","0150","0000","1765","1405","360","136","1901","3262","0","58.28","43.07"
"10","007","00","001","0150","0177","547","432","115","67","614","1002","0","61.28","43.11"
"10","007","00","001","0150","0178","614","486","128","27","641","1148","0","55.84","42.33"
"10","007","00","001","0150","0179","604","487","117","42","646","1112","0","58.09","43.79"
"10","007","00","001","0151","0000","952","733","219","84","1036","1685","0","61.48","43.5"
"10","007","00","001","0151","0153","475","371","104","31","506","800","0","63.25","46.38"
"10","007","00","001","0151","0154","477","362","115","53","530","885","0","59.89","40.9"
"10","007","00","001","0152","0000","1091","865","226","56","1147","1903","0","60.27","45.45"
"10","007","00","001","0152","0174","521","421","100","24","545","930","0","58.6","45.27"
"10","007","00","001","0152","0175","570","444","126","32","602","973","0","61.87","45.63"
"10","007","00","001","0153","0000","1773","1426","347","102","1875","3282","0","57.13","43.45"
"10","007","00","001","0153","0155","583","477","106","23","606","1000","0","60.6","47.7"
"10","007","00","001","0153","0156","594","471","123","38","632","1159","0","54.53","40.64"
"10","007","00","001","0153","0157","596","478","118","41","637","1123","0","56.72","42.56"
"10","007","00","001","0154","0000","1601","1255","346","192","1793","2908","0","61.66","43.16"
"10","007","00","001","0154","0158","530","410","120","64","594","907","0","65.49","45.2"
"10","007","00","001","0154","0159","498","394","104","63","561","989","0","56.72","39.84"
"10","007","00","001","0154","0160","573","451","122","65","638","1012","0","63.04","44.57"
"10","007","00","001","0155","0000","3662","2784","878","297","3959","6789","0","58.31","41.01"
"10","007","00","001","0155","0168","567","413","154","46","613","1120","0","54.73","36.88"
"10","007","00","001","0155","0169","639","489","150","35","674","1269","0","53.11","38.53"
"10","007","00","001","0155","0170","644","504","140","62","706","1159","0","60.91","43.49"
"10","007","00","001","0155","0171","664","499","165","62","726","1184","0","61.32","42.15"
"10","007","00","001","0155","0172","593","455","138","42","635","1089","0","58.31","41.78"
"10","007","00","001","0155","0173","555","424","131","50","605","968","0","62.5","43.8"
"10","007","00","001","0156","0000","1433","1139","294","124","1557","2485","0","62.66","45.84"
"10","007","00","001","0156","0151","813","660","153","65","878","1372","0","63.99","48.1"
"10","007","00","001","0156","0152","620","479","141","59","679","1113","0","61.01","43.04"
"10","007","00","001","0157","0000","568","431","137","40","608","1184","0","51.35","36.4"
"10","007","00","001","0157","0176","568","431","137","40","608","1184","0","51.35","36.4"
"10","007","00","001","0158","0000","1433","1108","325","128","1561","2445","0","63.84","45.32"
"10","007","00","001","0158","0165","463","368","95","40","503","770","0","65.32","47.79"
"10","007","00","001","0158","0166","517","390","127","40","557","889","0","62.65","43.87"
"10","007","00","001","0158","0167","453","350","103","48","501","786","0","63.74","44.53"
"10","007","00","001","0159","0000","731","567","164","72","803","1249","0","64.29","45.4"
"10","007","00","001","0159","0133","731","567","164","72","803","1249","0","64.29","45.4"
"10","007","00","001","0160","0000","507","404","103","66","573","924","0","62.01","43.72"
"10","007","00","001","0160","0129","507","404","103","66","573","924","0","62.01","43.72"
"10","007","00","001","0161","0000","1727","1342","385","159","1886","2873","0","65.65","46.71"
"10","007","00","001","0161","0130","554","435","119","42","596","939","0","63.47","46.33"
"10","007","00","001","0161","0131","572","434","138","69","641","953","0","67.26","45.54"
"10","007","00","001","0161","0132","601","473","128","48","649","981","0","66.16","48.22"
"10","007","00","001","0162","0000","4608","3646","962","290","4898","8267","0","59.25","44.1"
"10","007","00","001","0162","0137","689","564","125","37","726","1156","0","62.8","48.79"
"10","007","00","001","0162","0138","711","558","153","29","740","1291","0","57.32","43.22"
"10","007","00","001","0162","0139","629","509","120","27","656","1139","0","57.59","44.69"
"10","007","00","001","0162","0140","648","511","137","50","698","1125","0","62.04","45.42"
"10","007","00","001","0162","0141","661","501","160","52","713","1258","0","56.68","39.83"
"10","007","00","001","0162","0142","621","487","134","43","664","1123","0","59.13","43.37"
"10","007","00","001","0162","0143","649","516","133","52","701","1175","0","59.66","43.91"
"10","007","00","001","0163","0000","1306","1009","297","139","1445","2378","0","60.77","42.43"
"10","007","00","001","0163","0134","453","355","98","58","511","817","0","62.55","43.45"
"10","007","00","001","0163","0135","483","366","117","49","532","872","0","61.01","41.97"
"10","007","00","001","0163","0136","370","288","82","32","402","689","0","58.35","41.8"
"10","007","00","001","0164","0000","2284","1791","493","134","2418","4160","0","58.13","43.05"
"10","007","00","001","0164","0147","532","412","120","27","559","1003","0","55.73","41.08"
"10","007","00","001","0164","0148","487","384","103","21","508","915","0","55.52","41.97"
"10","007","00","001","0164","0149","620","485","135","48","668","1158","0","57.69","41.88"
"10","007","00","001","0164","0150","645","510","135","38","683","1084","0","63.01","47.05"
"10","007","00","001","0165","0000","1574","1181","393","103","1677","2631","0","63.74","44.89"
"10","007","00","001","0165","0144","531","384","147","39","570","862","0","66.13","44.55"
"10","007","00","001","0165","0145","490","355","135","38","528","872","0","60.55","40.71"
"10","007","00","001","0165","0146","553","442","111","26","579","897","0","64.55","49.28"
"10","007","00","001","0166","0000","599","479","120","60","659","1161","0","56.76","41.26"
"10","007","00","001","0166","0184","599","479","120","60","659","1161","0","56.76","41.26"
"10","007","00","001","0167","0000","778","645","133","84","862","1276","0","67.55","50.55"
"10","007","00","001","0167","0183","778","645","133","84","862","1276","0","67.55","50.55"
"10","007","00","001","0168","0000","375","292","83","48","423","823","0","51.4","35.48"
"10","007","00","001","0168","0182","375","292","83","48","423","823","0","51.4","35.48"
"10","007","00","001","0169","0000","559","463","96","61","620","907","0","68.36","51.05"
"10","007","00","001","0169","0180","559","463","96","61","620","907","0","68.36","51.05"
"10","007","00","001","0170","0000","606","474","132","72","678","1112","0","60.97","42.63"
"10","007","00","001","0170","0181","606","474","132","72","678","1112","0","60.97","42.63"
"10","007","00","001","0171","0000","2492","1966","526","152","2644","4367","0","60.54","45.02"
"10","007","00","001","0171","0161","512","416","96","29","541","1033","0","52.37","40.27"
"10","007","00","001","0171","0162","689","496","193","42","731","1116","0","65.5","44.44"
"10","007","00","001","0171","0163","678","554","124","34","712","1154","0","61.7","48.01"
"10","007","00","001","0171","0164","613","500","113","47","660","1064","0","62.03","46.99"
"10","007","00","001","0172","0000","3007","2325","682","183","3190","5370","0","59.4","43.3"
"10","007","00","001","0172","0074","716","551","165","51","767","1252","0","61.26","44.01"
"10","007","00","001","0172","0075","581","455","126","32","613","1113","0","55.08","40.88"
"10","007","00","001","0172","0076","600","482","118","35","635","1009","0","62.93","47.77"
"10","007","00","001","0172","0077","537","417","120","40","577","999","0","57.76","41.74"
"10","007","00","001","0172","0078","573","420","153","25","598","997","0","59.98","42.13"
"10","007","00","001","0173","0000","3010","2347","663","137","3147","5178","0","60.78","45.33"
"10","007","00","001","0173","0079","706","557","149","38","744","1145","0","64.98","48.65"
"10","007","00","001","0173","0080","696","537","159","27","723","1227","0","58.92","43.77"
"10","007","00","001","0173","0081","718","541","177","34","752","1208","0","62.25","44.78"
"10","007","00","001","0173","0082","890","712","178","38","928","1598","0","58.07","44.56"
"10","007","00","002","0000","0000","37223","29288","7935","3450","40673","70505","86762","57.69","41.54"
"10","007","00","002","0201","0000","651","475","176","59","710","1140","0","62.28","41.67"
"10","007","00","002","0201","0243","651","475","176","59","710","1140","0","62.28","41.67"
"10","007","00","002","0202","0000","274","199","75","30","304","511","0","59.49","38.94"
"10","007","00","002","0202","0244","274","199","75","30","304","511","0","59.49","38.94"
"10","007","00","002","0203","0000","376","292","84","25","401","857","0","46.79","34.07"
"10","007","00","002","0203","0245","376","292","84","25","401","857","0","46.79","34.07"
"10","007","00","002","0204","0000","550","420","130","61","611","946","0","64.59","44.4"
"10","007","00","002","0204","0246","550","420","130","61","611","946","0","64.59","44.4"
"10","007","00","002","0205","0000","4133","3245","888","329","4462","7584","0","58.83","42.79"
"10","007","00","002","0205","0302","657","503","154","72","729","1299","0","56.12","38.72"
"10","007","00","002","0205","0303","762","620","142","42","804","1298","0","61.94","47.77"
"10","007","00","002","0205","0304","792","626","166","49","841","1458","0","57.68","42.94"
"10","007","00","002","0205","0305","618","470","148","44","662","1138","0","58.17","41.3"
"10","007","00","002","0205","0306","621","469","152","64","685","1170","0","58.55","40.09"
"10","007","00","002","0205","0307","683","557","126","58","741","1221","0","60.69","45.62"
"10","007","00","002","0206","0000","2665","2091","574","227","2892","5161","0","56.04","40.52"
"10","007","00","002","0206","0298","674","538","136","65","739","1227","0","60.23","43.85"
"10","007","00","002","0206","0299","652","510","142","63","715","1187","0","60.24","42.97"
"10","007","00","002","0206","0300","657","529","128","28","685","1296","0","52.85","40.82"
"10","007","00","002","0206","0301","682","514","168","71","753","1451","0","51.9","35.42"
"10","007","00","002","0207","0000","2557","1994","563","231","2788","4946","0","56.37","40.32"
"10","007","00","002","0207","0247","528","404","124","35","563","945","0","59.58","42.75"
"10","007","00","002","0207","0248","596","458","138","48","644","1097","0","58.71","41.75"
"10","007","00","002","0207","0249","671","538","133","45","716","1479","0","48.41","36.38"
"10","007","00","002","0207","0250","762","594","168","103","865","1425","0","60.7","41.68"
"10","007","00","002","0208","0000","2284","1760","524","195","2479","4335","0","57.19","40.6"
"10","007","00","002","0208","0253","578","444","134","73","651","1047","0","62.18","42.41"
"10","007","00","002","0208","0254","547","415","132","23","570","1097","0","51.96","37.83"
"10","007","00","002","0208","0255","539","413","126","54","593","1030","0","57.57","40.1"
"10","007","00","002","0208","0256","620","488","132","45","665","1161","0","57.28","42.03"
"10","007","00","002","0209","0000","291","228","63","51","342","540","0","63.33","42.22"
"10","007","00","002","0209","0257","291","228","63","51","342","540","0","63.33","42.22"
"10","007","00","002","0210","0000","490","362","128","69","559","880","0","63.52","41.14"
"10","007","00","002","0210","0251","490","362","128","69","559","880","0","63.52","41.14"
"10","007","00","002","0211","0000","585","457","128","73","658","1183","0","55.62","38.63"
"10","007","00","002","0211","0252","585","457","128","73","658","1183","0","55.62","38.63"
"10","007","00","002","0212","0000","587","456","131","78","665","1127","0","59.01","40.46"
"10","007","00","002","0212","0262","587","456","131","78","665","1127","0","59.01","40.46"
"10","007","00","002","0213","0000","702","559","143","56","758","1178","0","64.35","47.45"
"10","007","00","002","0213","0263","702","559","143","56","758","1178","0","64.35","47.45"
"10","007","00","002","0214","0000","155","115","40","14","169","284","0","59.51","40.49"
"10","007","00","002","0214","0264","155","115","40","14","169","284","0","59.51","40.49"
"10","007","00","002","0215","0000","400","304","96","33","433","659","0","65.71","46.13"
"10","007","00","002","0215","0266","400","304","96","33","433","659","0","65.71","46.13"
"10","007","00","002","0216","0000","310","247","63","35","345","584","0","59.08","42.29"
"10","007","00","002","0216","0265","310","247","63","35","345","584","0","59.08","42.29"
"10","007","00","002","0217","0000","464","342","122","21","485","915","0","53.01","37.38"
"10","007","00","002","0217","0267","464","342","122","21","485","915","0","53.01","37.38"
"10","007","00","002","0218","0000","1278","988","290","133","1411","2208","0","63.9","44.75"
"10","007","00","002","0218","0268","615","463","152","66","681","1079","0","63.11","42.91"
"10","007","00","002","0218","0269","663","525","138","67","730","1129","0","64.66","46.5"
"10","007","00","002","0219","0000","1966","1574","392","186","2152","3820","0","56.34","41.2"
"10","007","00","002","0219","0286","728","574","154","79","807","1505","0","53.62","38.14"
"10","007","00","002","0219","0287","559","450","109","44","603","1092","0","55.22","41.21"
"10","007","00","002","0219","0288","679","550","129","63","742","1223","0","60.67","44.97"
"10","007","00","002","0220","0000","1261","1011","250","93","1354","2575","0","52.58","39.26"
"10","007","00","002","0220","0289","691","559","132","44","735","1572","0","46.76","35.56"
"10","007","00","002","0220","0290","570","452","118","49","619","1003","0","61.71","45.06"
"10","007","00","002","0221","0000","2240","1820","420","133","2373","4070","0","58.3","44.72"
"10","007","00","002","0221","0295","820","658","162","66","886","1397","0","63.42","47.1"
"10","007","00","002","0221","0296","668","537","131","36","704","1229","0","57.28","43.69"
"10","007","00","002","0221","0297","752","625","127","31","783","1444","0","54.22","43.28"
"10","007","00","002","0222","0000","2228","1776","452","168","2396","4152","0","57.71","42.77"
"10","007","00","002","0222","0291","523","425","98","32","555","933","0","59.49","45.55"
"10","007","00","002","0222","0292","604","485","119","59","663","1093","0","60.66","44.37"
"10","007","00","002","0222","0293","478","382","96","29","507","907","0","55.9","42.12"
"10","007","00","002","0222","0294","623","484","139","48","671","1219","0","55.05","39.7"
"10","007","00","002","0223","0000","1684","1379","305","141","1825","3167","0","57.63","43.54"
"10","007","00","002","0223","0278","506","423","83","31","537","984","0","54.57","42.99"
"10","007","00","002","0223","0279","589","490","99","54","643","1018","0","63.16","48.13"
"10","007","00","002","0223","0280","589","466","123","56","645","1165","0","55.36","40.0"
"10","007","00","002","0224","0000","1062","924","138","105","1167","2181","0","53.51","42.37"
"10","007","00","002","0224","0281","549","425","124","61","610","1161","0","52.54","36.61"
"10","007","00","002","0224","0282","513","499","14","44","557","1020","0","54.61","48.92"
"10","007","00","002","0225","0000","1619","1233","386","197","1816","3066","0","59.23","40.22"
"10","007","00","002","0225","0283","550","409","141","65","615","1068","0","57.58","38.3"
"10","007","00","002","0225","0284","563","429","134","42","605","1024","0","59.08","41.89"
"10","007","00","002","0225","0285","506","395","111","90","596","974","0","61.19","40.55"
"10","007","00","002","0226","0000","1734","1374","360","220","1954","3557","0","54.93","38.63"
"10","007","00","002","0226","0272","526","413","113","104","630","1137","0","55.41","36.32"
"10","007","00","002","0226","0273","609","476","133","53","662","1195","0","55.4","39.83"
"10","007","00","002","0226","0274","599","485","114","63","662","1225","0","54.04","39.59"
"10","007","00","002","0227","0000","968","775","193","106","1074","1979","0","54.27","39.16"
"10","007","00","002","0227","0270","633","512","121","70","703","1273","0","55.22","40.22"
"10","007","00","002","0227","0271","335","263","72","36","371","706","0","52.55","37.25"
"10","007","00","002","0228","0000","1277","995","282","188","1465","2438","0","60.09","40.81"
"10","007","00","002","0228","0275","570","441","129","60","630","957","0","65.83","46.08"
"10","007","00","002","0228","0276","333","268","65","72","405","758","0","53.43","35.36"
"10","007","00","002","0228","0277","374","286","88","56","430","723","0","59.47","39.56"
"10","007","00","002","0229","0000","2432","1893","539","193","2625","4462","0","58.83","42.42"
"10","007","00","002","0229","0258","596","457","139","49","645","1135","0","56.83","40.26"
"10","007","00","002","0229","0259","607","470","137","58","665","1155","0","57.58","40.69"
"10","007","00","002","0229","0260","652","526","126","44","696","1127","0","61.76","46.67"
"10","007","00","002","0229","0261","577","440","137","42","619","1045","0","59.23","42.11"
"10","007","00","003","0000","0000","39829","31150","8679","2760","42589","75286","90786","56.57","41.38"
"10","007","00","003","0301","0000","3018","2312","706","181","3199","6061","0","52.78","38.15"
"10","007","00","003","0301","0373","680","508","172","56","736","1341","0","54.88","37.88"
"10","007","00","003","0301","0374","713","555","158","56","769","1480","0","51.96","37.5"
"10","007","00","003","0301","0375","811","626","185","44","855","1529","0","55.92","40.94"
"10","007","00","003","0301","0376","814","623","191","25","839","1711","0","49.04","36.41"
"10","007","00","003","0302","0000","2406","1863","543","175","2581","4313","0","59.84","43.19"
"10","007","00","003","0302","0377","582","446","136","32","614","1057","0","58.09","42.19"
"10","007","00","003","0302","0378","583","461","122","39","622","1032","0","60.27","44.67"
"10","007","00","003","0302","0379","555","423","132","58","613","1015","0","60.39","41.67"
"10","007","00","003","0302","0380","686","533","153","46","732","1209","0","60.55","44.09"
"10","007","00","003","0303","0000","236","181","55","15","251","430","0","58.37","42.09"
"10","007","00","003","0303","0381","236","181","55","15","251","430","0","58.37","42.09"
"10","007","00","003","0304","0000","1013","806","207","46","1059","1822","0","58.12","44.24"
"10","007","00","003","0304","0382","446","343","103","19","465","856","0","54.32","40.07"
"10","007","00","003","0304","0383","567","463","104","27","594","966","0","61.49","47.93"
"10","007","00","003","0305","0000","1686","1295","391","120","1806","3242","0","55.71","39.94"
"10","007","00","003","0305","0384","544","410","134","36","580","1059","0","54.77","38.72"
"10","007","00","003","0305","0385","601","474","127","34","635","1117","0","56.85","42.44"
"10","007","00","003","0305","0386","541","411","130","50","591","1066","0","55.44","38.56"
"10","007","00","003","0306","0000","1385","1081","304","94","1479","2780","0","53.2","38.88"
"10","007","00","003","0306","0387","625","485","140","49","674","1252","0","53.83","38.74"
"10","007","00","003","0306","0388","760","596","164","45","805","1528","0","52.68","39.01"
"10","007","00","003","0307","0000","912","720","192","64","976","1680","0","58.1","42.86"
"10","007","00","003","0307","0389","460","356","104","35","495","826","0","59.93","43.1"
"10","007","00","003","0307","0390","452","364","88","29","481","854","0","56.32","42.62"
"10","007","00","003","0308","0000","476","374","102","45","521","860","0","60.58","43.49"
"10","007","00","003","0308","0429","476","374","102","45","521","860","0","60.58","43.49"
"10","007","00","003","0309","0000","1140","883","257","76","1216","2152","0","56.51","41.03"
"10","007","00","003","0309","0391","688","531","157","50","738","1387","0","53.21","38.28"
"10","007","00","003","0309","0392","452","352","100","26","478","765","0","62.48","46.01"
"10","007","00","003","0310","0000","1466","1178","288","114","1580","2834","0","55.75","41.57"
"10","007","00","003","0310","0393","702","565","137","48","750","1438","0","52.16","39.29"
"10","007","00","003","0310","0394","764","613","151","66","830","1396","0","59.46","43.91"
"10","007","00","003","0311","0000","840","648","192","54","894","1467","0","60.94","44.17"
"10","007","00","003","0311","0395","354","276","78","25","379","658","0","57.6","41.95"
"10","007","00","003","0311","0396","486","372","114","29","515","809","0","63.66","45.98"
"10","007","00","003","0312","0000","920","721","199","47","967","1820","0","53.13","39.62"
"10","007","00","003","0312","0397","465","362","103","15","480","932","0","51.5","38.84"
"10","007","00","003","0312","0398","455","359","96","32","487","888","0","54.84","40.43"
"10","007","00","003","0313","0000","1218","970","248","89","1307","2221","0","58.85","43.67"
"10","007","00","003","0313","0399","648","500","148","50","698","1144","0","61.01","43.71"
"10","007","00","003","0313","0400","570","470","100","39","609","1077","0","56.55","43.64"
"10","007","00","003","0314","0000","653","498","155","58","711","1349","0","52.71","36.92"
"10","007","00","003","0314","0401","653","498","155","58","711","1349","0","52.71","36.92"
"10","007","00","003","0315","0000","2731","2227","504","163","2894","5134","0","56.37","43.38"
"10","007","00","003","0315","0402","664","500","164","57","721","1155","0","62.42","43.29"
"10","007","00","003","0315","0403","663","546","117","32","695","1253","0","55.47","43.58"
"10","007","00","003","0315","0404","642","519","123","42","684","1252","0","54.63","41.45"
"10","007","00","003","0315","0405","762","662","100","32","794","1474","0","53.87","44.91"
"10","007","00","003","0316","0000","1085","844","241","81","1166","1910","0","61.05","44.19"
"10","007","00","003","0316","0408","585","459","126","35","620","999","0","62.06","45.95"
"10","007","00","003","0316","0409","500","385","115","46","546","911","0","59.93","42.26"
"10","007","00","003","0317","0000","1430","1117","313","75","1505","2632","0","57.18","42.44"
"10","007","00","003","0317","0412","727","553","174","37","764","1308","0","58.41","42.28"
"10","007","00","003","0317","0413","703","564","139","38","741","1324","0","55.97","42.6"
"10","007","00","003","0318","0000","1077","824","253","74","1151","1972","0","58.37","41.78"
"10","007","00","003","0318","0410","560","414","146","30","590","1005","0","58.71","41.19"
"10","007","00","003","0318","0411","517","410","107","44","561","967","0","58.01","42.4"
"10","007","00","003","0319","0000","1814","1387","427","167","1981","3437","0","57.64","40.35"
"10","007","00","003","0319","0414","605","444","161","53","658","1102","0","59.71","40.29"
"10","007","00","003","0319","0415","568","437","131","51","619","1124","0","55.07","38.88"
"10","007","00","003","0319","0416","641","506","135","63","704","1211","0","58.13","41.78"
"10","007","00","003","0320","0000","555","433","122","39","594","884","0","67.19","48.98"
"10","007","00","003","0320","0417","555","433","122","39","594","884","0","67.19","48.98"
"10","007","00","003","0321","0000","1251","966","285","126","1377","2419","0","56.92","39.93"
"10","007","00","003","0321","0418","588","439","149","64","652","1119","0","58.27","39.23"
"10","007","00","003","0321","0419","663","527","136","62","725","1300","0","55.77","40.54"
"10","007","00","003","0322","0000","1293","1022","271","51","1344","2317","0","58.01","44.11"
"10","007","00","003","0322","0420","562","436","126","44","606","1104","0","54.89","39.49"
"10","007","00","003","0322","0421","731","586","145","7","738","1213","0","60.84","48.31"
"10","007","00","003","0323","0000","538","403","135","41","579","1127","0","51.38","35.76"
"10","007","00","003","0323","0422","538","403","135","41","579","1127","0","51.38","35.76"
"10","007","00","003","0324","0000","1608","1262","346","100","1708","2864","0","59.64","44.06"
"10","007","00","003","0324","0423","473","382","91","51","524","919","0","57.02","41.57"
"10","007","00","003","0324","0424","591","472","119","1","592","987","0","59.98","47.82"
"10","007","00","003","0324","0425","544","408","136","48","592","958","0","61.8","42.59"
"10","007","00","003","0325","0000","2281","1818","463","99","2380","4228","0","56.29","43.0"
"10","007","00","003","0325","0426","745","592","153","44","789","1362","0","57.93","43.47"
"10","007","00","003","0325","0427","769","612","157","24","793","1461","0","54.28","41.89"
"10","007","00","003","0325","0428","767","614","153","31","798","1405","0","56.8","43.7"
"10","007","00","003","0326","0000","914","729","185","64","978","1746","0","56.01","41.75"
"10","007","00","003","0326","0430","447","367","80","25","472","875","0","53.94","41.94"
"10","007","00","003","0326","0431","467","362","105","39","506","871","0","58.09","41.56"
"10","007","00","003","0327","0000","501","389","112","49","550","883","0","62.29","44.05"
"10","007","00","003","0327","0432","501","389","112","49","550","883","0","62.29","44.05"
"10","007","00","003","0328","0000","607","469","138","69","676","1224","0","55.23","38.32"
"10","007","00","003","0328","0433","607","469","138","69","676","1224","0","55.23","38.32"
"10","007","00","003","0329","0000","1046","835","211","93","1139","2031","0","56.08","41.11"
"10","007","00","003","0329","0434","549","446","103","49","598","1075","0","55.63","41.49"
"10","007","00","003","0329","0435","497","389","108","44","541","956","0","56.59","40.69"
"10","007","00","003","0330","0000","1581","1239","342","130","1711","3071","0","55.71","40.35"
"10","007","00","003","0330","0436","529","418","111","51","580","1037","0","55.93","40.31"
"10","007","00","003","0330","0437","532","431","101","25","557","1011","0","55.09","42.63"
"10","007","00","003","0330","0438","520","390","130","54","574","1023","0","56.11","38.12"
"10","007","00","003","0331","0000","833","632","201","73","906","1632","0","55.51","38.73"
"10","007","00","003","0331","0439","359","274","85","31","390","719","0","54.24","38.11"
"10","007","00","003","0331","0440","474","358","116","42","516","913","0","56.52","39.21"
"10","007","00","003","0332","0000","1315","1024","291","88","1403","2744","0","51.13","37.32"
"10","007","00","003","0332","0406","661","531","130","35","696","1396","0","49.86","38.04"
"10","007","00","003","0332","0407","654","493","161","53","707","1348","0","52.45","36.57"
"10","007","00","004","0000","0000","7642","5957","1685","722","8364","14065","16872","59.47","42.35"
"10","007","00","004","0401","0000","1216","978","238","79","1295","2237","0","57.89","43.72"
"10","007","00","004","0401","0469","569","466","103","35","604","1071","0","56.4","43.51"
"10","007","00","004","0401","0470","647","512","135","44","691","1166","0","59.26","43.91"
"10","007","00","004","0402","0000","684","552","132","68","752","1269","0","59.26","43.5"
"10","007","00","004","0402","0471","684","552","132","68","752","1269","0","59.26","43.5"
"10","007","00","004","0403","0000","1246","947","299","126","1372","2266","0","60.55","41.79"
"10","007","00","004","0403","0472","601","460","141","50","651","1138","0","57.21","40.42"
"10","007","00","004","0403","0473","645","487","158","76","721","1128","0","63.92","43.17"
"10","007","00","004","0404","0000","677","528","149","86","763","1275","0","59.84","41.41"
"10","007","00","004","0404","0474","677","528","149","86","763","1275","0","59.84","41.41"
"10","007","00","004","0405","0000","652","502","150","55","707","1187","0","59.56","42.29"
"10","007","00","004","0405","0475","652","502","150","55","707","1187","0","59.56","42.29"
"10","007","00","004","0406","0000","1038","784","254","126","1164","1929","0","60.34","40.64"
"10","007","00","004","0406","0476","545","404","141","58","603","991","0","60.85","40.77"
"10","007","00","004","0406","0477","493","380","113","68","561","938","0","59.81","40.51"
"10","007","00","004","0407","0000","1319","1026","293","117","1436","2561","0","56.07","40.06"
"10","007","00","004","0407","0478","620","488","132","60","680","1276","0","53.29","38.24"
"10","007","00","004","0407","0479","699","538","161","57","756","1285","0","58.83","41.87"
"10","007","00","004","0408","0000","810","640","170","65","875","1341","0","65.25","47.73"
"10","007","00","004","0408","0480","810","640","170","65","875","1341","0","65.25","47.73"
"10","007","00","005","0000","0000","15793","12503","3290","1402","17195","30407","37062","56.55","41.12"
"10","007","00","005","0501","0000","811","630","181","85","896","1700","0","52.71","37.06"
"10","007","00","005","0501","0456","417","318","99","53","470","854","0","55.04","37.24"
"10","007","00","005","0501","0457","394","312","82","32","426","846","0","50.35","36.88"
"10","007","00","005","0502","0000","506","387","119","103","609","1143","0","53.28","33.86"
"10","007","00","005","0502","0458","506","387","119","103","609","1143","0","53.28","33.86"
"10","007","00","005","0503","0000","713","547","166","61","774","1317","0","58.77","41.53"
"10","007","00","005","0503","0463","713","547","166","61","774","1317","0","58.77","41.53"
"10","007","00","005","0504","0000","971","771","200","93","1064","1912","0","55.65","40.32"
"10","007","00","005","0504","0447","455","350","105","49","504","904","0","55.75","38.72"
"10","007","00","005","0504","0448","516","421","95","44","560","1008","0","55.56","41.77"
"10","007","00","005","0505","0000","1097","839","258","93","1190","1993","0","59.71","42.1"
"10","007","00","005","0505","0453","589","440","149","58","647","1085","0","59.63","40.55"
"10","007","00","005","0505","0454","508","399","109","35","543","908","0","59.8","43.94"
"10","007","00","005","0506","0000","718","593","125","47","765","1264","0","60.52","46.91"
"10","007","00","005","0506","0455","718","593","125","47","765","1264","0","60.52","46.91"
"10","007","00","005","0507","0000","951","762","189","95","1046","1839","0","56.88","41.44"
"10","007","00","005","0507","0443","509","400","109","51","560","966","0","57.97","41.41"
"10","007","00","005","0507","0444","442","362","80","44","486","873","0","55.67","41.47"
"10","007","00","005","0508","0000","905","734","171","79","984","1687","0","58.33","43.51"
"10","007","00","005","0508","0445","446","365","81","46","492","812","0","60.59","44.95"
"10","007","00","005","0508","0446","459","369","90","33","492","875","0","56.23","42.17"
"10","007","00","005","0509","0000","1333","1096","237","135","1468","2640","0","55.61","41.52"
"10","007","00","005","0509","0449","626","554","72","58","684","1154","0","59.27","48.01"
"10","007","00","005","0509","0450","707","542","165","77","784","1486","0","52.76","36.47"
"10","007","00","005","0510","0000","2668","2096","572","201","2869","5139","0","55.83","40.79"
"10","007","00","005","0510","0459","715","569","146","34","749","1357","0","55.2","41.93"
"10","007","00","005","0510","0460","677","511","166","71","748","1349","0","55.45","37.88"
"10","007","00","005","0510","0461","619","490","129","57","676","1154","0","58.58","42.46"
"10","007","00","005","0510","0462","657","526","131","39","696","1279","0","54.42","41.13"
"10","007","00","005","0511","0000","1086","846","240","80","1166","2182","0","53.44","38.77"
"10","007","00","005","0511","0451","558","436","122","50","608","1095","0","55.53","39.82"
"10","007","00","005","0511","0452","528","410","118","30","558","1087","0","51.33","37.72"
"10","007","00","005","0512","0000","1234","1013","221","80","1314","2348","0","55.96","43.14"
"10","007","00","005","0512","0441","551","453","98","43","594","1182","0","50.25","38.32"
"10","007","00","005","0512","0442","683","560","123","37","720","1166","0","61.75","48.03"
"10","007","00","005","0513","0000","1666","1314","352","120","1786","3020","0","59.14","43.51"
"10","007","00","005","0513","0464","559","435","124","49","608","990","0","61.41","43.94"
"10","007","00","005","0513","0465","467","378","89","36","503","852","0","59.04","44.37"
"10","007","00","005","0513","0466","640","501","139","35","675","1178","0","57.3","42.53"
"10","007","00","005","0514","0000","1134","875","259","130","1264","2223","0","56.86","39.36"
"10","007","00","005","0514","0467","542","410","132","76","618","1088","0","56.8","37.68"
"10","007","00","005","0514","0468","592","465","127","54","646","1135","0","56.92","40.97"
"10","007","00","006","0000","0000","19336","14916","4420","2066","21402","39745","47166","53.85","37.53"
"10","007","00","006","0601","0000","695","537","158","89","784","1492","0","52.55","35.99"
"10","007","00","006","0601","0319","695","537","158","89","784","1492","0","52.55","35.99"
"10","007","00","006","0602","0000","596","457","139","50","646","1458","0","44.31","31.34"
"10","007","00","006","0602","0318","596","457","139","50","646","1458","0","44.31","31.34"
"10","007","00","006","0603","0000","614","486","128","51","665","1251","0","53.16","38.85"
"10","007","00","006","0603","0313","614","486","128","51","665","1251","0","53.16","38.85"
"10","007","00","006","0604","0000","711","500","211","52","763","1464","0","52.12","34.15"
"10","007","00","006","0604","0312","711","500","211","52","763","1464","0","52.12","34.15"
"10","007","00","006","0605","0000","541","404","137","94","635","1166","0","54.46","34.65"
"10","007","00","006","0605","0311","541","404","137","94","635","1166","0","54.46","34.65"
"10","007","00","006","0606","0000","597","486","111","60","657","1256","0","52.31","38.69"
"10","007","00","006","0606","0310","597","486","111","60","657","1256","0","52.31","38.69"
"10","007","00","006","0607","0000","682","487","195","58","740","1363","0","54.29","35.73"
"10","007","00","006","0607","0308","682","487","195","58","740","1363","0","54.29","35.73"
"10","007","00","006","0608","0000","446","351","95","39","485","821","0","59.07","42.75"
"10","007","00","006","0608","0309","446","351","95","39","485","821","0","59.07","42.75"
"10","007","00","006","0609","0000","1154","896","258","90","1244","2425","0","51.3","36.95"
"10","007","00","006","0609","0314","716","562","154","58","774","1465","0","52.83","38.36"
"10","007","00","006","0609","0315","438","334","104","32","470","960","0","48.96","34.79"
"10","007","00","006","0610","0000","1326","1003","323","143","1469","2688","0","54.65","37.31"
"10","007","00","006","0610","0316","637","470","167","79","716","1323","0","54.12","35.53"
"10","007","00","006","0610","0317","689","533","156","64","753","1365","0","55.16","39.05"
"10","007","00","006","0611","0000","1171","904","267","84","1255","2477","0","50.67","36.5"
"10","007","00","006","0611","0324","513","382","131","38","551","1085","0","50.78","35.21"
"10","007","00","006","0611","0325","658","522","136","46","704","1392","0","50.57","37.5"
"10","007","00","006","0612","0000","629","498","131","64","693","1216","0","56.99","40.95"
"10","007","00","006","0612","0331","629","498","131","64","693","1216","0","56.99","40.95"
"10","007","00","006","0613","0000","474","368","106","57","531","1063","0","49.95","34.62"
"10","007","00","006","0613","0332","474","368","106","57","531","1063","0","49.95","34.62"
"10","007","00","006","0614","0000","1106","862","244","172","1278","2229","0","57.34","38.67"
"10","007","00","006","0614","0339","585","447","138","88","673","1079","0","62.37","41.43"
"10","007","00","006","0614","0340","521","415","106","84","605","1150","0","52.61","36.09"
"10","007","00","006","0615","0000","955","726","229","107","1062","1921","0","55.28","37.79"
"10","007","00","006","0615","0337","500","389","111","49","549","926","0","59.29","42.01"
"10","007","00","006","0615","0338","455","337","118","58","513","995","0","51.56","33.87"
"10","007","00","006","0616","0000","1159","928","231","140","1299","2305","0","56.36","40.26"
"10","007","00","006","0616","0335","509","401","108","49","558","994","0","56.14","40.34"
"10","007","00","006","0616","0336","650","527","123","91","741","1311","0","56.52","40.2"
"10","007","00","006","0617","0000","533","412","121","63","596","1287","0","46.31","32.01"
"10","007","00","006","0617","0334","533","412","121","63","596","1287","0","46.31","32.01"
"10","007","00","006","0618","0000","636","501","135","69","705","1306","0","53.98","38.36"
"10","007","00","006","0618","0333","636","501","135","69","705","1306","0","53.98","38.36"
"10","007","00","006","0619","0000","2011","1568","443","186","2197","3672","0","59.83","42.7"
"10","007","00","006","0619","0326","684","536","148","88","772","1316","0","58.66","40.73"
"10","007","00","006","0619","0327","698","523","175","56","754","1255","0","60.08","41.67"
"10","007","00","006","0619","0328","629","509","120","42","671","1101","0","60.94","46.23"
"10","007","00","006","0620","0000","1213","940","273","173","1386","2560","0","54.14","36.72"
"10","007","00","006","0620","0329","566","454","112","87","653","1167","0","55.96","38.9"
"10","007","00","006","0620","0330","647","486","161","86","733","1393","0","52.62","34.89"
"10","007","00","006","0621","0000","1128","875","253","134","1262","2383","0","52.96","36.72"
"10","007","00","006","0621","0322","469","388","81","52","521","1043","0","49.95","37.2"
"10","007","00","006","0621","0323","659","487","172","82","741","1340","0","55.3","36.34"
"10","007","00","006","0622","0000","959","727","232","91","1050","1942","0","54.07","37.44"
"10","007","00","006","0622","0320","396","299","97","29","425","888","0","47.86","33.67"
"10","007","00","006","0622","0321","563","428","135","62","625","1054","0","59.3","40.61"
"10","007","00","007","0000","0000","17752","13713","4039","1407","19159","32394","39300","59.14","42.33"
"10","007","00","007","0701","0000","936","730","206","128","1064","1686","0","63.11","43.3"
"10","007","00","007","0701","0341","585","459","126","82","667","1066","0","62.57","43.06"
"10","007","00","007","0701","0342","351","271","80","46","397","620","0","64.03","43.71"
"10","007","00","007","0702","0000","1113","840","273","64","1177","2072","0","56.81","40.54"
"10","007","00","007","0702","0343","425","333","92","16","441","876","0","50.34","38.01"
"10","007","00","007","0702","0344","688","507","181","48","736","1196","0","61.54","42.39"
"10","007","00","007","0703","0000","1444","1104","340","104","1548","2642","0","58.59","41.79"
"10","007","00","007","0703","0345","744","577","167","47","791","1369","0","57.78","42.15"
"10","007","00","007","0703","0346","700","527","173","57","757","1273","0","59.47","41.4"
"10","007","00","007","0704","0000","1056","844","212","49","1105","1888","0","58.53","44.7"
"10","007","00","007","0704","0348","544","435","109","26","570","967","0","58.95","44.98"
"10","007","00","007","0704","0349","512","409","103","23","535","921","0","58.09","44.41"
"10","007","00","007","0705","0000","751","605","146","55","806","1433","0","56.25","42.22"
"10","007","00","007","0705","0347","751","605","146","55","806","1433","0","56.25","42.22"
"10","007","00","007","0706","0000","2150","1632","518","176","2326","3910","0","59.49","41.74"
"10","007","00","007","0706","0350","394","316","78","40","434","689","0","62.99","45.86"
"10","007","00","007","0706","0351","383","286","97","38","421","688","0","61.19","41.57"
"10","007","00","007","0706","0352","720","530","190","60","780","1252","0","62.3","42.33"
"10","007","00","007","0706","0353","653","500","153","38","691","1281","0","53.94","39.03"
"10","007","00","007","0707","0000","1660","1281","379","102","1762","3211","0","54.87","39.89"
"10","007","00","007","0707","0354","393","294","99","23","416","754","0","55.17","38.99"
"10","007","00","007","0707","0355","531","393","138","51","582","1024","0","56.84","38.38"
"10","007","00","007","0707","0356","736","594","142","28","764","1433","0","53.31","41.45"
"10","007","00","007","0708","0000","1322","999","323","99","1421","2261","0","62.85","44.18"
"10","007","00","007","0708","0357","825","617","208","52","877","1366","0","64.2","45.17"
"10","007","00","007","0708","0358","497","382","115","47","544","895","0","60.78","42.68"
"10","007","00","007","0709","0000","684","543","141","68","752","1386","0","54.26","39.18"
"10","007","00","007","0709","0359","684","543","141","68","752","1386","0","54.26","39.18"
"10","007","00","007","0710","0000","2590","2017","573","212","2802","4454","0","62.91","45.29"
"10","007","00","007","0710","0360","479","357","122","65","544","896","0","60.71","39.84"
"10","007","00","007","0710","0361","493","376","117","35","528","804","0","65.67","46.77"
"10","007","00","007","0710","0362","494","409","85","24","518","827","0","62.64","49.46"
"10","007","00","007","0710","0363","552","432","120","41","593","996","0","59.54","43.37"
"10","007","00","007","0710","0364","572","443","129","47","619","931","0","66.49","47.58"
"10","007","00","007","0711","0000","1077","802","275","93","1170","1944","0","60.19","41.26"
"10","007","00","007","0711","0365","368","270","98","35","403","715","0","56.36","37.76"
"10","007","00","007","0711","0366","709","532","177","58","767","1229","0","62.41","43.29"
"10","007","00","007","0712","0000","891","686","205","75","966","1701","0","56.79","40.33"
"10","007","00","007","0712","0367","427","338","89","30","457","890","0","51.35","37.98"
"10","007","00","007","0712","0368","464","348","116","45","509","811","0","62.76","42.91"
"10","007","00","007","0713","0000","963","748","215","65","1028","1717","0","59.87","43.56"
"10","007","00","007","0713","0369","455","346","109","31","486","786","0","61.83","44.02"
"10","007","00","007","0713","0370","508","402","106","34","542","931","0","58.22","43.18"
"10","007","00","007","0714","0000","1115","882","233","117","1232","2089","0","58.98","42.22"
"10","007","00","007","0714","0371","691","540","151","77","768","1265","0","60.71","42.69"
"10","007","00","007","0714","0372","424","342","82","40","464","824","0","56.31","41.5"
"10","007","00","008","0000","0000","21001","16349","4652","1751","22752","38924","45922","58.45","42.0"
"10","007","00","008","0801","0000","1748","1383","365","105","1853","3257","0","56.89","42.46"
"10","007","00","008","0801","0185","492","388","104","49","541","901","0","60.04","43.06"
"10","007","00","008","0801","0186","595","467","128","36","631","1042","0","60.56","44.82"
"10","007","00","008","0801","0187","661","528","133","20","681","1314","0","51.83","40.18"
"10","007","00","008","0802","0000","968","748","220","99","1067","1827","0","58.4","40.94"
"10","007","00","008","0802","0188","425","332","93","56","481","808","0","59.53","41.09"
"10","007","00","008","0802","0189","543","416","127","43","586","1019","0","57.51","40.82"
"10","007","00","008","0803","0000","1249","972","277","181","1430","2384","0","59.98","40.77"
"10","007","00","008","0803","0190","624","466","158","76","700","1144","0","61.19","40.73"
"10","007","00","008","0803","0191","625","506","119","105","730","1240","0","58.87","40.81"
"10","007","00","008","0804","0000","615","477","138","71","686","1095","0","62.65","43.56"
"10","007","00","008","0804","0193","615","477","138","71","686","1095","0","62.65","43.56"
"10","007","00","008","0805","0000","790","632","158","84","874","1425","0","61.33","44.35"
"10","007","00","008","0805","0192","790","632","158","84","874","1425","0","61.33","44.35"
"10","007","00","008","0806","0000","1058","798","260","74","1132","1892","0","59.83","42.18"
"10","007","00","008","0806","0194","513","391","122","43","556","910","0","61.1","42.97"
"10","007","00","008","0806","0195","545","407","138","31","576","982","0","58.66","41.45"
"10","007","00","008","0807","0000","455","339","116","45","500","764","0","65.45","44.37"
"10","007","00","008","0807","0198","455","339","116","45","500","764","0","65.45","44.37"
"10","007","00","008","0808","0000","907","667","240","39","946","1770","0","53.45","37.68"
"10","007","00","008","0808","0196","552","399","153","21","573","1070","0","53.55","37.29"
"10","007","00","008","0808","0197","355","268","87","18","373","700","0","53.29","38.29"
"10","007","00","008","0809","0000","2717","2174","543","188","2905","4967","0","58.49","43.77"
"10","007","00","008","0809","0207","585","459","126","49","634","1169","0","54.23","39.26"
"10","007","00","008","0809","0208","709","570","139","55","764","1274","0","59.97","44.74"
"10","007","00","008","0809","0209","753","606","147","41","794","1280","0","62.03","47.34"
"10","007","00","008","0809","0210","670","539","131","43","713","1244","0","57.32","43.33"
"10","007","00","008","0810","0000","1655","1281","374","148","1803","3038","0","59.35","42.17"
"10","007","00","008","0810","0199","546","417","129","55","601","953","0","63.06","43.76"
"10","007","00","008","0810","0200","530","423","107","25","555","974","0","56.98","43.43"
"10","007","00","008","0810","0201","579","441","138","68","647","1111","0","58.24","39.69"
"10","007","00","008","0811","0000","2468","1937","531","201","2669","4576","0","58.33","42.33"
"10","007","00","008","0811","0202","607","503","104","66","673","1101","0","61.13","45.69"
"10","007","00","008","0811","0203","567","457","110","44","611","1110","0","55.05","41.17"
"10","007","00","008","0811","0204","678","525","153","59","737","1262","0","58.4","41.6"
"10","007","00","008","0811","0205","616","452","164","32","648","1103","0","58.75","40.98"
"10","007","00","008","0812","0000","629","469","160","68","697","1347","0","51.74","34.82"
"10","007","00","008","0812","0206","629","469","160","68","697","1347","0","51.74","34.82"
"10","007","00","008","0813","0000","1835","1420","415","138","1973","3312","0","59.57","42.87"
"10","007","00","008","0813","0211","621","476","145","59","680","1159","0","58.67","41.07"
"10","007","00","008","0813","0212","621","508","113","35","656","1042","0","62.96","48.75"
"10","007","00","008","0813","0213","593","436","157","44","637","1111","0","57.34","39.24"
"10","007","00","008","0814","0000","518","416","102","49","567","893","0","63.49","46.58"
"10","007","00","008","0814","0214","518","416","102","49","567","893","0","63.49","46.58"
"10","007","00","008","0815","0000","500","380","120","65","565","953","0","59.29","39.87"
"10","007","00","008","0815","0215","500","380","120","65","565","953","0","59.29","39.87"
"10","007","00","008","0816","0000","1033","800","233","83","1116","1912","0","58.37","41.84"
"10","007","00","008","0816","0216","488","389","99","30","518","987","0","52.48","39.41"
"10","007","00","008","0816","0217","545","411","134","53","598","925","0","64.65","44.43"
"10","007","00","008","0817","0000","1010","809","201","61","1071","1906","0","56.19","42.44"
"10","007","00","008","0817","0218","491","398","93","36","527","951","0","55.42","41.85"
"10","007","00","008","0817","0219","519","411","108","25","544","955","0","56.96","43.04"
"10","007","00","008","0818","0000","846","647","199","52","898","1606","0","55.92","40.29"
"10","007","00","008","0818","0220","456","345","111","31","487","895","0","54.41","38.55"
"10","007","00","008","0818","0221","390","302","88","21","411","711","0","57.81","42.48"
"10","007","00","009","0000","0000","10283","7947","2336","1021","11304","20408","23594","55.39","38.94"
"10","007","00","009","0901","0000","899","692","207","92","991","1752","0","56.56","39.5"
"10","007","00","009","0901","0222","493","374","119","42","535","958","0","55.85","39.04"
"10","007","00","009","0901","0223","406","318","88","50","456","794","0","57.43","40.05"
"10","007","00","009","0902","0000","658","499","159","88","746","1415","0","52.72","35.27"
"10","007","00","009","0902","0224","658","499","159","88","746","1415","0","52.72","35.27"
"10","007","00","009","0903","0000","973","789","184","71","1044","1758","0","59.39","44.88"
"10","007","00","009","0903","0225","538","436","102","32","570","927","0","61.49","47.03"
"10","007","00","009","0903","0226","435","353","82","39","474","831","0","57.04","42.48"
"10","007","00","009","0904","0000","1201","947","254","116","1317","2465","0","53.43","38.42"
"10","007","00","009","0904","0228","590","465","125","48","638","1227","0","52.0","37.9"
"10","007","00","009","0904","0229","611","482","129","68","679","1238","0","54.85","38.93"
"10","007","00","009","0905","0000","1231","953","278","135","1366","2351","0","58.1","40.54"
"10","007","00","009","0905","0230","718","550","168","67","785","1362","0","57.64","40.38"
"10","007","00","009","0905","0231","513","403","110","68","581","989","0","58.75","40.75"
"10","007","00","009","0906","0000","972","778","194","91","1063","1661","0","64.0","46.84"
"10","007","00","009","0906","0232","604","485","119","62","666","1054","0","63.19","46.02"
"10","007","00","009","0906","0233","368","293","75","29","397","607","0","65.4","48.27"
"10","007","00","009","0907","0000","491","390","101","45","536","882","0","60.77","44.22"
"10","007","00","009","0907","0234","491","390","101","45","536","882","0","60.77","44.22"
"10","007","00","009","0908","0000","521","415","106","41","562","1143","0","49.17","36.31"
"10","007","00","009","0908","0235","521","415","106","41","562","1143","0","49.17","36.31"
"10","007","00","009","0909","0000","281","224","57","20","301","661","0","45.54","33.89"
"10","007","00","009","0909","0236","281","224","57","20","301","661","0","45.54","33.89"
"10","007","00","009","0910","0000","811","602","209","36","847","1685","0","50.27","35.73"
"10","007","00","009","0910","0237","401","296","105","3","404","838","0","48.21","35.32"
"10","007","00","009","0910","0238","410","306","104","33","443","847","0","52.3","36.13"
"10","007","00","009","0911","0000","527","412","115","65","592","987","0","59.98","41.74"
"10","007","00","009","0911","0239","527","412","115","65","592","987","0","59.98","41.74"
"10","007","00","009","0912","0000","549","390","159","82","631","1217","0","51.85","32.05"
"10","007","00","009","0912","0240","549","390","159","82","631","1217","0","51.85","32.05"
"10","007","00","009","0913","0000","377","279","98","69","446","865","0","51.56","32.25"
"10","007","00","009","0913","0241","377","279","98","69","446","865","0","51.56","32.25"
"10","007","00","009","0914","0000","496","353","143","43","539","996","0","54.12","35.44"
"10","007","00","009","0914","0242","496","353","143","43","539","996","0","54.12","35.44"
"10","007","00","009","0915","0000","296","224","72","27","323","570","0","56.67","39.3"
"10","007","00","009","0915","0227","296","224","72","27","323","570","0","56.67","39.3"
"10","007","00","010","0000","0000","53737","41981","11756","3746","57483","102028","124755","56.34","41.15"
"10","007","00","010","1001","0000","564","446","118","50","614","1063","0","57.76","41.96"
"10","007","00","010","1001","0504","564","446","118","50","614","1063","0","57.76","41.96"
"10","007","00","010","1002","0000","1519","1089","430","103","1622","2788","0","58.18","39.06"
"10","007","00","010","1002","0505","485","325","160","32","517","925","0","55.89","35.14"
"10","007","00","010","1002","0506","516","380","136","43","559","947","0","59.03","40.13"
"10","007","00","010","1002","0507","518","384","134","28","546","916","0","59.61","41.92"
"10","007","00","010","1003","0000","1679","1337","342","94","1773","3174","0","55.86","42.12"
"10","007","00","010","1003","0528","438","346","92","16","454","867","0","52.36","39.91"
"10","007","00","010","1003","0529","639","507","132","38","677","1201","0","56.37","42.21"
"10","007","00","010","1003","0530","602","484","118","40","642","1106","0","58.05","43.76"
"10","007","00","010","1004","0000","1414","1089","325","117","1531","2588","0","59.16","42.08"
"10","007","00","010","1004","0531","461","338","123","43","504","845","0","59.64","40.0"
"10","007","00","010","1004","0532","490","388","102","35","525","894","0","58.72","43.4"
"10","007","00","010","1004","0533","463","363","100","39","502","849","0","59.13","42.76"
"10","007","00","010","1005","0000","427","331","96","44","471","747","0","63.05","44.31"
"10","007","00","010","1005","0534","427","331","96","44","471","747","0","63.05","44.31"
"10","007","00","010","1006","0000","1475","1142","333","96","1571","2824","0","55.63","40.44"
"10","007","00","010","1006","0535","520","401","119","32","552","884","0","62.44","45.36"
"10","007","00","010","1006","0536","449","344","105","27","476","900","0","52.89","38.22"
"10","007","00","010","1006","0537","506","397","109","37","543","1040","0","52.21","38.17"
"10","007","00","010","1007","0000","433","323","110","20","453","831","0","54.51","38.87"
"10","007","00","010","1007","0538","433","323","110","20","453","831","0","54.51","38.87"
"10","007","00","010","1008","0000","340","254","86","41","381","591","0","64.47","42.98"
"10","007","00","010","1008","0539","340","254","86","41","381","591","0","64.47","42.98"
"10","007","00","010","1009","0000","980","766","214","53","1033","1849","0","55.87","41.43"
"10","007","00","010","1009","0508","446","358","88","32","478","862","0","55.45","41.53"
"10","007","00","010","1009","0509","534","408","126","21","555","987","0","56.23","41.34"
"10","007","00","010","1010","0000","3060","2427","633","162","3222","5677","0","56.76","42.75"
"10","007","00","010","1010","0510","546","437","109","45","591","1085","0","54.47","40.28"
"10","007","00","010","1010","0511","610","494","116","27","637","1110","0","57.39","44.5"
"10","007","00","010","1010","0512","537","421","116","22","559","1095","0","51.05","38.45"
"10","007","00","010","1010","0513","747","584","163","35","782","1278","0","61.19","45.7"
"10","007","00","010","1010","0514","620","491","129","33","653","1109","0","58.88","44.27"
"10","007","00","010","1011","0000","1215","958","257","115","1330","2487","0","53.48","38.52"
"10","007","00","010","1011","0561","545","451","94","84","629","1131","0","55.61","39.88"
"10","007","00","010","1011","0562","670","507","163","31","701","1356","0","51.7","37.39"
"10","007","00","010","1012","0000","2327","1841","486","146","2473","4191","0","59.01","43.93"
"10","007","00","010","1012","0563","721","580","141","53","774","1370","0","56.5","42.34"
"10","007","00","010","1012","0564","586","459","127","42","628","1090","0","57.61","42.11"
"10","007","00","010","1012","0565","512","407","105","18","530","821","0","64.56","49.57"
"10","007","00","010","1012","0566","508","395","113","33","541","910","0","59.45","43.41"
"10","007","00","010","1013","0000","2718","2126","592","159","2877","4993","0","57.62","42.58"
"10","007","00","010","1013","0567","640","496","144","47","687","1203","0","57.11","41.23"
"10","007","00","010","1013","0568","717","573","144","56","773","1378","0","56.1","41.58"
"10","007","00","010","1013","0569","737","577","160","31","768","1352","0","56.8","42.68"
"10","007","00","010","1013","0570","624","480","144","25","649","1060","0","61.23","45.28"
"10","007","00","010","1014","0000","2340","1842","498","172","2512","4559","0","55.1","40.4"
"10","007","00","010","1014","0571","675","541","134","44","719","1317","0","54.59","41.08"
"10","007","00","010","1014","0572","568","437","131","41","609","1120","0","54.38","39.02"
"10","007","00","010","1014","0573","514","420","94","42","556","1025","0","54.24","40.98"
"10","007","00","010","1014","0574","583","444","139","45","628","1097","0","57.25","40.47"
"10","007","00","010","1015","0000","917","678","239","77","994","1696","0","58.61","39.98"
"10","007","00","010","1015","0575","489","363","126","40","529","859","0","61.58","42.26"
"10","007","00","010","1015","0576","428","315","113","37","465","837","0","55.56","37.63"
"10","007","00","010","1016","0000","1162","900","262","117","1279","2163","0","59.13","41.61"
"10","007","00","010","1016","0577","630","480","150","53","683","1090","0","62.66","44.04"
"10","007","00","010","1016","0578","532","420","112","64","596","1073","0","55.55","39.14"
"10","007","00","010","1017","0000","1373","1090","283","83","1456","2625","0","55.47","41.52"
"10","007","00","010","1017","0540","668","515","153","54","722","1330","0","54.29","38.72"
"10","007","00","010","1017","0541","705","575","130","29","734","1295","0","56.68","44.4"
"10","007","00","010","1018","0000","3252","2581","671","206","3458","6205","0","55.73","41.6"
"10","007","00","010","1018","0545","644","506","138","37","681","1176","0","57.91","43.03"
"10","007","00","010","1018","0546","406","335","71","9","415","867","0","47.87","38.64"
"10","007","00","010","1018","0547","568","438","130","52","620","1121","0","55.31","39.07"
"10","007","00","010","1018","0548","598","476","122","33","631","1190","0","53.03","40.0"
"10","007","00","010","1018","0549","526","415","111","39","565","945","0","59.79","43.92"
"10","007","00","010","1018","0550","510","411","99","36","546","906","0","60.26","45.36"
"10","007","00","010","1019","0000","1568","1232","336","130","1698","2876","0","59.04","42.84"
"10","007","00","010","1019","0551","529","397","132","59","588","978","0","60.12","40.59"
"10","007","00","010","1019","0552","507","404","103","48","555","949","0","58.48","42.57"
"10","007","00","010","1019","0553","532","431","101","23","555","949","0","58.48","45.42"
"10","007","00","010","1020","0000","1003","771","232","99","1102","1931","0","57.07","39.93"
"10","007","00","010","1020","0515","533","411","122","70","603","1055","0","57.16","38.96"
"10","007","00","010","1020","0516","470","360","110","29","499","876","0","56.96","41.1"
"10","007","00","010","1021","0000","1153","890","263","93","1246","2301","0","54.15","38.68"
"10","007","00","010","1021","0517","506","369","137","51","557","1115","0","49.96","33.09"
"10","007","00","010","1021","0518","647","521","126","42","689","1186","0","58.09","43.93"
"10","007","00","010","1022","0000","1687","1357","330","85","1772","3195","0","55.46","42.47"
"10","007","00","010","1022","0519","561","447","114","40","601","995","0","60.4","44.92"
"10","007","00","010","1022","0520","501","398","103","12","513","999","0","51.35","39.84"
"10","007","00","010","1022","0521","625","512","113","33","658","1201","0","54.79","42.63"
"10","007","00","010","1023","0000","1248","968","280","66","1314","2428","0","54.12","39.87"
"10","007","00","010","1023","0522","701","548","153","39","740","1342","0","55.14","40.83"
"10","007","00","010","1023","0523","547","420","127","27","574","1086","0","52.85","38.67"
"10","007","00","010","1024","0000","2016","1591","425","101","2117","3624","0","58.42","43.9"
"10","007","00","010","1024","0524","421","322","99","37","458","854","0","53.63","37.7"
"10","007","00","010","1024","0525","558","446","112","27","585","1064","0","54.98","41.92"
"10","007","00","010","1024","0526","508","393","115","10","518","879","0","58.93","44.71"
"10","007","00","010","1024","0527","529","430","99","27","556","827","0","67.23","52.0"
"10","007","00","010","1025","0000","1188","960","228","68","1256","2440","0","51.48","39.34"
"10","007","00","010","1025","0481","535","452","83","25","560","1087","0","51.52","41.58"
"10","007","00","010","1025","0482","653","508","145","43","696","1353","0","51.44","37.55"
"10","007","00","010","1026","0000","1211","960","251","84","1295","2641","0","49.03","36.35"
"10","007","00","010","1026","0483","645","507","138","54","699","1313","0","53.24","38.61"
"10","007","00","010","1026","0484","566","453","113","30","596","1328","0","44.88","34.11"
"10","007","00","010","1027","0000","1455","1103","352","120","1575","2786","0","56.53","39.59"
"10","007","00","010","1027","0485","560","425","135","35","595","1055","0","56.4","40.28"
"10","007","00","010","1027","0486","486","375","111","43","529","959","0","55.16","39.1"
"10","007","00","010","1027","0487","409","303","106","42","451","772","0","58.42","39.25"
"10","007","00","010","1028","0000","804","634","170","56","860","1685","0","51.04","37.63"
"10","007","00","010","1028","0488","466","355","111","45","511","831","0","61.49","42.72"
"10","007","00","010","1028","0489","338","279","59","11","349","854","0","40.87","32.67"
"10","007","00","010","1029","0000","491","381","110","38","529","1190","0","44.45","32.02"
"10","007","00","010","1029","0490","491","381","110","38","529","1190","0","44.45","32.02"
"10","007","00","010","1030","0000","378","302","76","21","399","726","0","54.96","41.6"
"10","007","00","010","1030","0491","378","302","76","21","399","726","0","54.96","41.6"
"10","007","00","010","1031","0000","957","707","250","122","1079","1984","0","54.39","35.64"
"10","007","00","010","1031","0492","562","429","133","65","627","1124","0","55.78","38.17"
"10","007","00","010","1031","0493","395","278","117","57","452","860","0","52.56","32.33"
"10","007","00","010","1032","0000","1222","937","285","98","1320","2197","0","60.08","42.65"
"10","007","00","010","1032","0494","634","502","132","47","681","1122","0","60.7","44.74"
"10","007","00","010","1032","0495","588","435","153","51","639","1075","0","59.44","40.47"
"10","007","00","010","1033","0000","964","762","202","91","1055","1960","0","53.83","38.88"
"10","007","00","010","1033","0496","487","370","117","63","550","993","0","55.39","37.26"
"10","007","00","010","1033","0497","477","392","85","28","505","967","0","52.22","40.54"
"10","007","00","010","1034","0000","929","710","219","104","1033","1812","0","57.01","39.18"
"10","007","00","010","1034","0498","520","396","124","57","577","1008","0","57.24","39.29"
"10","007","00","010","1034","0499","409","314","95","47","456","804","0","56.72","39.05"
"10","007","00","010","1035","0000","882","692","190","61","943","1752","0","53.82","39.5"
"10","007","00","010","1035","0500","444","342","102","31","475","867","0","54.79","39.45"
"10","007","00","010","1035","0501","438","350","88","30","468","885","0","52.88","39.55"
"10","007","00","010","1036","0000","1078","894","184","54","1132","2352","0","48.13","38.01"
"10","007","00","010","1036","0502","450","370","80","19","469","1097","0","42.75","33.73"
"10","007","00","010","1036","0503","628","524","104","35","663","1255","0","52.83","41.75"
"10","007","00","010","1037","0000","1570","1220","350","98","1668","2818","0","59.19","43.29"
"10","007","00","010","1037","0554","536","439","97","29","565","1006","0","56.16","43.64"
"10","007","00","010","1037","0555","479","352","127","49","528","889","0","59.39","39.6"
"10","007","00","010","1037","0556","555","429","126","20","575","923","0","62.3","46.48"
"10","007","00","010","1038","0000","1309","1043","266","86","1395","2284","0","61.08","45.67"
"10","007","00","010","1038","0557","699","559","140","46","745","1209","0","61.62","46.24"
"10","007","00","010","1038","0558","610","484","126","40","650","1075","0","60.47","45.02"
"10","007","00","010","1039","0000","1440","1139","301","72","1512","2381","0","63.5","47.84"
"10","007","00","010","1039","0559","789","637","152","35","824","1342","0","61.4","47.47"
"10","007","00","010","1039","0560","651","502","149","37","688","1039","0","66.22","48.32"
"10","007","00","010","1040","0000","800","602","198","50","850","1388","0","61.24","43.37"
"10","007","00","010","1040","0544","800","602","198","50","850","1388","0","61.24","43.37"
"10","007","00","010","1041","0000","1189","906","283","94","1283","2226","0","57.64","40.7"
"10","007","00","010","1041","0542","657","498","159","58","715","1283","0","55.73","38.82"
"10","007","00","010","1041","0543","532","408","124","36","568","943","0","60.23","43.27"
"10","007","00","011","0000","0000","24080","18938","5142","2056","26136","45147","55412","57.89","41.95"
"10","007","00","011","1101","0000","628","474","154","49","677","1221","0","55.45","38.82"
"10","007","00","011","1101","0640","628","474","154","49","677","1221","0","55.45","38.82"
"10","007","00","011","1102","0000","373","296","77","36","409","638","0","64.11","46.39"
"10","007","00","011","1102","0641","373","296","77","36","409","638","0","64.11","46.39"
"10","007","00","011","1103","0000","987","828","159","83","1070","1785","0","59.94","46.39"
"10","007","00","011","1103","0642","439","370","69","45","484","817","0","59.24","45.29"
"10","007","00","011","1103","0643","548","458","90","38","586","968","0","60.54","47.31"
"10","007","00","011","1104","0000","279","224","55","16","295","448","0","65.85","50.0"
"10","007","00","011","1104","0644","279","224","55","16","295","448","0","65.85","50.0"
"10","007","00","011","1105","0000","1793","1419","374","136","1929","3275","0","58.9","43.33"
"10","007","00","011","1105","0654","565","447","118","44","609","1072","0","56.81","41.7"
"10","007","00","011","1105","0655","616","487","129","50","666","1113","0","59.84","43.76"
"10","007","00","011","1105","0656","612","485","127","42","654","1090","0","60.0","44.5"
"10","007","00","011","1106","0000","1252","976","276","95","1347","2145","0","62.8","45.5"
"10","007","00","011","1106","0657","718","543","175","43","761","1193","0","63.79","45.52"
"10","007","00","011","1106","0658","534","433","101","52","586","952","0","61.55","45.48"
"10","007","00","011","1107","0000","1853","1490","363","164","2017","3387","0","59.55","43.99"
"10","007","00","011","1107","0659","608","473","135","71","679","1172","0","57.94","40.36"
"10","007","00","011","1107","0660","556","445","111","36","592","1027","0","57.64","43.33"
"10","007","00","011","1107","0661","689","572","117","57","746","1188","0","62.79","48.15"
"10","007","00","011","1108","0000","699","529","170","50","749","1403","0","53.39","37.7"
"10","007","00","011","1108","0662","699","529","170","50","749","1403","0","53.39","37.7"
"10","007","00","011","1109","0000","1496","1167","329","125","1621","3033","0","53.45","38.48"
"10","007","00","011","1109","0663","635","486","149","76","711","1397","0","50.89","34.79"
"10","007","00","011","1109","0664","861","681","180","49","910","1636","0","55.62","41.63"
"10","007","00","011","1110","0000","1327","1072","255","144","1471","2512","0","58.56","42.68"
"10","007","00","011","1110","0665","698","552","146","74","772","1298","0","59.48","42.53"
"10","007","00","011","1110","0666","629","520","109","70","699","1214","0","57.58","42.83"
"10","007","00","011","1111","0000","1275","1031","244","106","1381","2265","0","60.97","45.52"
"10","007","00","011","1111","0667","729","590","139","47","776","1297","0","59.83","45.49"
"10","007","00","011","1111","0668","546","441","105","59","605","968","0","62.5","45.56"
"10","007","00","011","1112","0000","466","356","110","35","501","839","0","59.71","42.43"
"10","007","00","011","1112","0669","466","356","110","35","501","839","0","59.71","42.43"
"10","007","00","011","1113","0000","918","697","221","72","990","1805","0","54.85","38.61"
"10","007","00","011","1113","0670","501","368","133","51","552","907","0","60.86","40.57"
"10","007","00","011","1113","0671","417","329","88","21","438","898","0","48.78","36.64"
"10","007","00","011","1114","0000","1258","1008","250","119","1377","2345","0","58.72","42.99"
"10","007","00","011","1114","0649","619","493","126","54","673","1146","0","58.73","43.02"
"10","007","00","011","1114","0650","639","515","124","65","704","1199","0","58.72","42.95"
"10","007","00","011","1115","0000","470","360","110","30","500","851","0","58.75","42.3"
"10","007","00","011","1115","0653","470","360","110","30","500","851","0","58.75","42.3"
"10","007","00","011","1116","0000","769","587","182","93","862","1365","0","63.15","43.0"
"10","007","00","011","1116","0681","769","587","182","93","862","1365","0","63.15","43.0"
"10","007","00","011","1117","0000","1023","808","215","69","1092","1859","0","58.74","43.46"
"10","007","00","011","1117","0651","473","369","104","50","523","895","0","58.44","41.23"
"10","007","00","011","1117","0652","550","439","111","19","569","964","0","59.02","45.54"
"10","007","00","011","1118","0000","2433","1896","537","140","2573","4689","0","54.87","40.44"
"10","007","00","011","1118","0645","534","430","104","26","560","1123","0","49.87","38.29"
"10","007","00","011","1118","0646","606","446","160","50","656","1166","0","56.26","38.25"
"10","007","00","011","1118","0647","603","472","131","30","633","1151","0","55.0","41.01"
"10","007","00","011","1118","0648","690","548","142","34","724","1249","0","57.97","43.88"
"10","007","00","011","1119","0000","411","327","84","38","449","650","0","69.08","50.31"
"10","007","00","011","1119","0672","411","327","84","38","449","650","0","69.08","50.31"
"10","007","00","011","1120","0000","656","532","124","81","737","1279","0","57.62","41.59"
"10","007","00","011","1120","0673","656","532","124","81","737","1279","0","57.62","41.59"
"10","007","00","011","1121","0000","420","323","97","56","476","730","0","65.21","44.25"
"10","007","00","011","1121","0674","420","323","97","56","476","730","0","65.21","44.25"
"10","007","00","011","1122","0000","743","598","145","72","815","1407","0","57.92","42.5"
"10","007","00","011","1122","0675","743","598","145","72","815","1407","0","57.92","42.5"
"10","007","00","011","1123","0000","572","423","149","62","634","1273","0","49.8","33.23"
"10","007","00","011","1123","0676","572","423","149","62","634","1273","0","49.8","33.23"
"10","007","00","011","1124","0000","1037","788","249","105","1142","2201","0","51.89","35.8"
"10","007","00","011","1124","0679","468","354","114","57","525","1052","0","49.9","33.65"
"10","007","00","011","1124","0680","569","434","135","48","617","1149","0","53.7","37.77"
"10","007","00","011","1125","0000","942","729","213","80","1022","1742","0","58.67","41.85"
"10","007","00","011","1125","0677","512","403","109","29","541","988","0","54.76","40.79"
"10","007","00","011","1125","0678","430","326","104","51","481","754","0","63.79","43.24"
"10","007","00","012","0000","0000","18558","14161","4397","1808","20366","35391","41599","57.55","40.01"
"10","007","00","012","1201","0000","399","290","109","77","476","854","0","55.74","33.96"
"10","007","00","012","1201","0742","399","290","109","77","476","854","0","55.74","33.96"
"10","007","00","012","1202","0000","481","374","107","55","536","1138","0","47.1","32.86"
"10","007","00","012","1202","0743","443","347","96","48","491","963","0","50.99","36.03"
"10","007","00","012","1202","0744","38","27","11","7","45","175","0","25.71","15.43"
"10","007","00","012","1203","0000","355","274","81","39","394","739","0","53.32","37.08"
"10","007","00","012","1203","0745","355","274","81","39","394","739","0","53.32","37.08"
"10","007","00","012","1204","0000","792","616","176","95","887","1567","0","56.6","39.31"
"10","007","00","012","1204","0746","404","313","91","36","440","826","0","53.27","37.89"
"10","007","00","012","1204","0747","388","303","85","59","447","741","0","60.32","40.89"
"10","007","00","012","1205","0000","679","518","161","54","733","1507","0","48.64","34.37"
"10","007","00","012","1205","0748","205","163","42","5","210","506","0","41.5","32.21"
"10","007","00","012","1205","0749","474","355","119","49","523","1001","0","52.25","35.46"
"10","007","00","012","1206","0000","658","519","139","76","734","1281","0","57.3","40.52"
"10","007","00","012","1206","0750","658","519","139","76","734","1281","0","57.3","40.52"
"10","007","00","012","1207","0000","953","729","224","87","1040","1757","0","59.19","41.49"
"10","007","00","012","1207","0753","484","377","107","35","519","844","0","61.49","44.67"
"10","007","00","012","1207","0754","469","352","117","52","521","913","0","57.06","38.55"
"10","007","00","012","1208","0000","354","285","69","49","403","613","0","65.74","46.49"
"10","007","00","012","1208","0755","354","285","69","49","403","613","0","65.74","46.49"
"10","007","00","012","1209","0000","1962","1569","393","145","2107","3351","0","62.88","46.82"
"10","007","00","012","1209","0756","754","597","157","65","819","1382","0","59.26","43.2"
"10","007","00","012","1209","0757","630","515","115","41","671","1034","0","64.89","49.81"
"10","007","00","012","1209","0758","578","457","121","39","617","935","0","65.99","48.88"
"10","007","00","012","1210","0000","1329","1007","322","91","1420","2401","0","59.14","41.94"
"10","007","00","012","1210","0759","709","523","186","51","760","1301","0","58.42","40.2"
"10","007","00","012","1210","0760","620","484","136","40","660","1100","0","60.0","44.0"
"10","007","00","012","1211","0000","585","430","155","55","640","1071","0","59.76","40.15"
"10","007","00","012","1211","0761","585","430","155","55","640","1071","0","59.76","40.15"
"10","007","00","012","1212","0000","664","507","157","61","725","1163","0","62.34","43.59"
"10","007","00","012","1212","0762","664","507","157","61","725","1163","0","62.34","43.59"
"10","007","00","012","1213","0000","1124","872","252","104","1228","1964","0","62.53","44.4"
"10","007","00","012","1213","0763","487","383","104","46","533","809","0","65.88","47.34"
"10","007","00","012","1213","0764","637","489","148","58","695","1155","0","60.17","42.34"
"10","007","00","012","1214","0000","1260","984","276","109","1369","2362","0","57.96","41.66"
"10","007","00","012","1214","0751","540","415","125","54","594","1035","0","57.39","40.1"
"10","007","00","012","1214","0752","720","569","151","55","775","1327","0","58.4","42.88"
"10","007","00","012","1215","0000","820","625","195","90","910","1606","0","56.66","38.92"
"10","007","00","012","1215","0766","441","332","109","47","488","870","0","56.09","38.16"
"10","007","00","012","1215","0767","379","293","86","43","422","736","0","57.34","39.81"
"10","007","00","012","1216","0000","632","491","141","61","693","1335","0","51.91","36.78"
"10","007","00","012","1216","0768","632","491","141","61","693","1335","0","51.91","36.78"
"10","007","00","012","1217","0000","879","596","283","105","984","1774","0","55.47","33.6"
"10","007","00","012","1217","0769","445","299","146","45","490","876","0","55.94","34.13"
"10","007","00","012","1217","0770","434","297","137","60","494","898","0","55.01","33.07"
"10","007","00","012","1218","0000","2248","1621","627","155","2403","4224","0","56.89","38.38"
"10","007","00","012","1218","0771","733","571","162","21","754","1298","0","58.09","43.99"
"10","007","00","012","1218","0772","735","538","197","80","815","1451","0","56.17","37.08"
"10","007","00","012","1218","0773","780","512","268","54","834","1475","0","56.54","34.71"
"10","007","00","012","1219","0000","640","482","158","82","722","1270","0","56.85","37.95"
"10","007","00","012","1219","0765","640","482","158","82","722","1270","0","56.85","37.95"
"10","007","00","012","1220","0000","763","655","108","75","838","1576","0","53.17","41.56"
"10","007","00","012","1220","0774","359","275","84","44","403","766","0","52.61","35.9"
"10","007","00","012","1220","0775","404","380","24","31","435","810","0","53.7","46.91"
"10","007","00","012","1221","0000","495","354","141","72","567","953","0","59.5","37.15"
"10","007","00","012","1221","0776","495","354","141","72","567","953","0","59.5","37.15"
"10","007","00","012","1222","0000","486","363","123","71","557","885","0","62.94","41.02"
"10","007","00","012","1222","0777","486","363","123","71","557","885","0","62.94","41.02"
"10","007","00","013","0000","0000","16977","13263","3714","1492","18469","31492","36907","58.65","42.12"
"10","007","00","013","1301","0000","1835","1428","407","151","1986","3152","0","63.01","45.3"
"10","007","00","013","1301","0579","836","639","197","65","901","1426","0","63.18","44.81"
"10","007","00","013","1301","0580","999","789","210","86","1085","1726","0","62.86","45.71"
"10","007","00","013","1302","0000","830","645","185","89","919","1542","0","59.6","41.83"
"10","007","00","013","1302","0581","443","339","104","60","503","797","0","63.11","42.53"
"10","007","00","013","1302","0582","387","306","81","29","416","745","0","55.84","41.07"
"10","007","00","013","1303","0000","752","598","154","83","835","1426","0","58.56","41.94"
"10","007","00","013","1303","0585","752","598","154","83","835","1426","0","58.56","41.94"
"10","007","00","013","1304","0000","614","494","120","73","687","1125","0","61.07","43.91"
"10","007","00","013","1304","0583","614","494","120","73","687","1125","0","61.07","43.91"
"10","007","00","013","1305","0000","601","472","129","40","641","1161","0","55.21","40.65"
"10","007","00","013","1305","0591","601","472","129","40","641","1161","0","55.21","40.65"
"10","007","00","013","1306","0000","1521","1214","307","92","1613","2813","0","57.34","43.16"
"10","007","00","013","1306","0594","763","599","164","57","820","1412","0","58.07","42.42"
"10","007","00","013","1306","0595","758","615","143","35","793","1401","0","56.6","43.9"
"10","007","00","013","1307","0000","1641","1270","371","153","1794","3028","0","59.25","41.94"
"10","007","00","013","1307","0597","540","399","141","61","601","996","0","60.34","40.06"
"10","007","00","013","1307","0598","567","455","112","44","611","1047","0","58.36","43.46"
"10","007","00","013","1307","0599","534","416","118","48","582","985","0","59.09","42.23"
"10","007","00","013","1308","0000","1313","1039","274","109","1422","2494","0","57.02","41.66"
"10","007","00","013","1308","0604","662","516","146","48","710","1189","0","59.71","43.4"
"10","007","00","013","1308","0605","651","523","128","61","712","1305","0","54.56","40.08"
"10","007","00","013","1309","0000","772","571","201","91","863","1486","0","58.08","38.43"
"10","007","00","013","1309","0584","772","571","201","91","863","1486","0","58.08","38.43"
"10","007","00","013","1310","0000","811","647","164","70","881","1478","0","59.61","43.78"
"10","007","00","013","1310","0588","811","647","164","70","881","1478","0","59.61","43.78"
"10","007","00","013","1311","0000","769","612","157","69","838","1395","0","60.07","43.87"
"10","007","00","013","1311","0596","769","612","157","69","838","1395","0","60.07","43.87"
"10","007","00","013","1312","0000","1046","817","229","84","1130","2001","0","56.47","40.83"
"10","007","00","013","1312","0586","486","381","105","39","525","824","0","63.71","46.24"
"10","007","00","013","1312","0587","560","436","124","45","605","1177","0","51.4","37.04"
"10","007","00","013","1313","0000","844","637","207","70","914","1591","0","57.45","40.04"
"10","007","00","013","1313","0589","384","284","100","22","406","779","0","52.12","36.46"
"10","007","00","013","1313","0590","460","353","107","48","508","812","0","62.56","43.47"
"10","007","00","013","1314","0000","1276","1010","266","105","1381","2497","0","55.31","40.45"
"10","007","00","013","1314","0592","619","505","114","36","655","1238","0","52.91","40.79"
"10","007","00","013","1314","0593","657","505","152","69","726","1259","0","57.66","40.11"
"10","007","00","013","1315","0000","1275","979","296","92","1367","2254","0","60.65","43.43"
"10","007","00","013","1315","0600","611","481","130","46","657","1054","0","62.33","45.64"
"10","007","00","013","1315","0601","664","498","166","46","710","1200","0","59.17","41.5"
"10","007","00","013","1316","0000","1077","830","247","121","1198","2049","0","58.47","40.51"
"10","007","00","013","1316","0602","543","430","113","75","618","1003","0","61.62","42.87"
"10","007","00","013","1316","0603","534","400","134","46","580","1046","0","55.45","38.24"
"10","007","00","014","0000","0000","15374","12202","3172","1600","16974","28026","32517","60.57","43.54"
"10","007","00","014","1401","0000","1009","821","188","75","1084","1712","0","63.32","47.96"
"10","007","00","014","1401","0682","551","465","86","41","592","958","0","61.8","48.54"
"10","007","00","014","1401","0683","458","356","102","34","492","754","0","65.25","47.21"
"10","007","00","014","1402","0000","943","742","201","62","1005","1563","0","64.3","47.47"
"10","007","00","014","1402","0684","471","376","95","31","502","757","0","66.31","49.67"
"10","007","00","014","1402","0685","472","366","106","31","503","806","0","62.41","45.41"
"10","007","00","014","1403","0000","696","595","101","61","757","1280","0","59.14","46.48"
"10","007","00","014","1403","0686","696","595","101","61","757","1280","0","59.14","46.48"
"10","007","00","014","1404","0000","505","409","96","45","550","928","0","59.27","44.07"
"10","007","00","014","1404","0687","505","409","96","45","550","928","0","59.27","44.07"
"10","007","00","014","1405","0000","1067","778","289","119","1186","1710","0","69.36","45.5"
"10","007","00","014","1405","0688","599","409","190","60","659","895","0","73.63","45.7"
"10","007","00","014","1405","0689","468","369","99","59","527","815","0","64.66","45.28"
"10","007","00","014","1406","0000","515","415","100","44","559","957","0","58.41","43.36"
"10","007","00","014","1406","0690","515","415","100","44","559","957","0","58.41","43.36"
"10","007","00","014","1407","0000","686","557","129","100","786","1338","0","58.74","41.63"
"10","007","00","014","1407","0691","686","557","129","100","786","1338","0","58.74","41.63"
"10","007","00","014","1408","0000","572","474","98","63","635","1106","0","57.41","42.86"
"10","007","00","014","1408","0692","572","474","98","63","635","1106","0","57.41","42.86"
"10","007","00","014","1409","0000","429","359","70","42","471","690","0","68.26","52.03"
"10","007","00","014","1409","0693","429","359","70","42","471","690","0","68.26","52.03"
"10","007","00","014","1410","0000","660","518","142","88","748","1230","0","60.81","42.11"
"10","007","00","014","1410","0694","660","518","142","88","748","1230","0","60.81","42.11"
"10","007","00","014","1411","0000","980","789","191","68","1048","1744","0","60.09","45.24"
"10","007","00","014","1411","0695","452","364","88","34","486","847","0","57.38","42.98"
"10","007","00","014","1411","0696","528","425","103","34","562","897","0","62.65","47.38"
"10","007","00","014","1412","0000","1149","893","256","95","1244","2062","0","60.33","43.31"
"10","007","00","014","1412","0697","479","358","121","50","529","882","0","59.98","40.59"
"10","007","00","014","1412","0698","670","535","135","45","715","1180","0","60.59","45.34"
"10","007","00","014","1413","0000","631","478","153","74","705","1215","0","58.02","39.34"
"10","007","00","014","1413","0699","631","478","153","74","705","1215","0","58.02","39.34"
"10","007","00","014","1414","0000","259","218","41","22","281","422","0","66.59","51.66"
"10","007","00","014","1414","0700","259","218","41","22","281","422","0","66.59","51.66"
"10","007","00","014","1415","0000","573","490","83","47","620","1106","0","56.06","44.3"
"10","007","00","014","1415","0701","573","490","83","47","620","1106","0","56.06","44.3"
"10","007","00","014","1416","0000","505","399","106","57","562","874","0","64.3","45.65"
"10","007","00","014","1416","0702","505","399","106","57","562","874","0","64.3","45.65"
"10","007","00","014","1417","0000","755","565","190","105","860","1445","0","59.52","39.1"
"10","007","00","014","1417","0703","755","565","190","105","860","1445","0","59.52","39.1"
"10","007","00","014","1418","0000","480","373","107","67","547","875","0","62.51","42.63"
"10","007","00","014","1418","0704","480","373","107","67","547","875","0","62.51","42.63"
"10","007","00","014","1419","0000","765","609","156","96","861","1522","0","56.57","40.01"
"10","007","00","014","1419","0705","390","304","86","59","449","837","0","53.64","36.32"
"10","007","00","014","1419","0706","375","305","70","37","412","685","0","60.15","44.53"
"10","007","00","014","1420","0000","827","638","189","133","960","1531","0","62.7","41.67"
"10","007","00","014","1420","0707","413","330","83","50","463","733","0","63.17","45.02"
"10","007","00","014","1420","0708","414","308","106","83","497","798","0","62.28","38.6"
"10","007","00","014","1421","0000","721","576","145","76","797","1381","0","57.71","41.71"
"10","007","00","014","1421","0709","721","576","145","76","797","1381","0","57.71","41.71"
"10","007","00","014","1422","0000","647","506","141","61","708","1335","0","53.03","37.9"
"10","007","00","014","1422","0710","647","506","141","61","708","1335","0","53.03","37.9"
"10","007","00","015","0000","0000","16525","12765","3760","1644","18169","29642","34739","61.29","43.06"
"10","007","00","015","1501","0000","1975","1518","457","208","2183","3604","0","60.57","42.12"
"10","007","00","015","1501","0711","629","506","123","81","710","1139","0","62.34","44.42"
"10","007","00","015","1501","0712","639","473","166","72","711","1217","0","58.42","38.87"
"10","007","00","015","1501","0713","707","539","168","55","762","1248","0","61.06","43.19"
"10","007","00","015","1502","0000","714","527","187","87","801","1248","0","64.18","42.23"
"10","007","00","015","1502","0714","714","527","187","87","801","1248","0","64.18","42.23"
"10","007","00","015","1503","0000","896","677","219","79","975","1541","0","63.27","43.93"
"10","007","00","015","1503","0715","515","392","123","49","564","916","0","61.57","42.79"
"10","007","00","015","1503","0716","381","285","96","30","411","625","0","65.76","45.6"
"10","007","00","015","1504","0000","654","502","152","76","730","1271","0","57.44","39.5"
"10","007","00","015","1504","0717","654","502","152","76","730","1271","0","57.44","39.5"
"10","007","00","015","1505","0000","1003","784","219","102","1105","1740","0","63.51","45.06"
"10","007","00","015","1505","0718","346","267","79","31","377","608","0","62.01","43.91"
"10","007","00","015","1505","0719","657","517","140","71","728","1132","0","64.31","45.67"
"10","007","00","015","1506","0000","1110","854","256","118","1228","1953","0","62.88","43.73"
"10","007","00","015","1506","0720","580","449","131","61","641","1027","0","62.41","43.72"
"10","007","00","015","1506","0721","530","405","125","57","587","926","0","63.39","43.74"
"10","007","00","015","1507","0000","803","619","184","99","902","1438","0","62.73","43.05"
"10","007","00","015","1507","0722","415","315","100","67","482","778","0","61.95","40.49"
"10","007","00","015","1507","0723","388","304","84","32","420","660","0","63.64","46.06"
"10","007","00","015","1508","0000","1104","936","168","81","1185","2019","0","58.69","46.36"
"10","007","00","015","1508","0726","548","440","108","42","590","985","0","59.9","44.67"
"10","007","00","015","1508","0727","556","496","60","39","595","1034","0","57.54","47.97"
"10","007","00","015","1509","0000","1294","1009","285","102","1396","2321","0","60.15","43.47"
"10","007","00","015","1509","0724","750","592","158","67","817","1330","0","61.43","44.51"
"10","007","00","015","1509","0725","544","417","127","35","579","991","0","58.43","42.08"
"10","007","00","015","1510","0000","348","271","77","48","396","612","0","64.71","44.28"
"10","007","00","015","1510","0728","348","271","77","48","396","612","0","64.71","44.28"
"10","007","00","015","1511","0000","732","583","149","58","790","1236","0","63.92","47.17"
"10","007","00","015","1511","0729","732","583","149","58","790","1236","0","63.92","47.17"
"10","007","00","015","1512","0000","883","667","216","93","976","1513","0","64.51","44.08"
"10","007","00","015","1512","0730","442","333","109","44","486","775","0","62.71","42.97"
"10","007","00","015","1512","0731","441","334","107","49","490","738","0","66.4","45.26"
"10","007","00","015","1513","0000","596","445","151","43","639","1036","0","61.68","42.95"
"10","007","00","015","1513","0732","596","445","151","43","639","1036","0","61.68","42.95"
"10","007","00","015","1514","0000","488","375","113","70","558","975","0","57.23","38.46"
"10","007","00","015","1514","0733","488","375","113","70","558","975","0","57.23","38.46"
"10","007","00","015","1515","0000","722","571","151","76","798","1348","0","59.2","42.36"
"10","007","00","015","1515","0736","366","287","79","47","413","689","0","59.94","41.65"
"10","007","00","015","1515","0737","356","284","72","29","385","659","0","58.42","43.1"
"10","007","00","015","1516","0000","1010","761","249","100","1110","1824","0","60.86","41.72"
"10","007","00","015","1516","0734","474","354","120","47","521","885","0","58.87","40.0"
"10","007","00","015","1516","0735","536","407","129","53","589","939","0","62.73","43.34"
"10","007","00","015","1517","0000","818","614","204","75","893","1352","0","66.05","45.41"
"10","007","00","015","1517","0739","818","614","204","75","893","1352","0","66.05","45.41"
"10","007","00","015","1518","0000","463","349","114","32","495","910","0","54.4","38.35"
"10","007","00","015","1518","0738","463","349","114","32","495","910","0","54.4","38.35"
"10","007","00","015","1519","0000","400","295","105","42","442","759","0","58.23","38.87"
"10","007","00","015","1519","0740","400","295","105","42","442","759","0","58.23","38.87"
"10","007","00","015","1520","0000","512","408","104","55","567","942","0","60.19","43.31"
"10","007","00","015","1520","0741","512","408","104","55","567","942","0","60.19","43.31"
"10","007","00","016","0000","0000","16904","13073","3831","1549","18453","31239","37055","59.07","41.85"
"10","007","00","016","1601","0000","504","406","98","42","546","792","0","68.94","51.26"
"10","007","00","016","1601","0616","504","406","98","42","546","792","0","68.94","51.26"
"10","007","00","016","1602","0000","879","707","172","74","953","1516","0","62.86","46.64"
"10","007","00","016","1602","0617","405","311","94","39","444","695","0","63.88","44.75"
"10","007","00","016","1602","0618","474","396","78","35","509","821","0","62.0","48.23"
"10","007","00","016","1603","0000","1028","801","227","108","1136","1904","0","59.66","42.07"
"10","007","00","016","1603","0619","584","468","116","67","651","1064","0","61.18","43.98"
"10","007","00","016","1603","0620","444","333","111","41","485","840","0","57.74","39.64"
"10","007","00","016","1604","0000","1225","920","305","83","1308","2127","0","61.5","43.25"
"10","007","00","016","1604","0621","614","446","168","40","654","1079","0","60.61","41.33"
"10","007","00","016","1604","0622","611","474","137","43","654","1048","0","62.4","45.23"
"10","007","00","016","1605","0000","1017","796","221","68","1085","1758","0","61.72","45.28"
"10","007","00","016","1605","0623","564","445","119","43","607","960","0","63.23","46.35"
"10","007","00","016","1605","0624","453","351","102","25","478","798","0","59.9","43.98"
"10","007","00","016","1606","0000","820","642","178","85","905","1458","0","62.07","44.03"
"10","007","00","016","1606","0625","487","374","113","39","526","796","0","66.08","46.98"
"10","007","00","016","1606","0626","333","268","65","46","379","662","0","57.25","40.48"
"10","007","00","016","1607","0000","552","397","155","58","610","1040","0","58.65","38.17"
"10","007","00","016","1607","0627","552","397","155","58","610","1040","0","58.65","38.17"
"10","007","00","016","1608","0000","540","411","129","49","589","1025","0","57.46","40.1"
"10","007","00","016","1608","0628","540","411","129","49","589","1025","0","57.46","40.1"
"10","007","00","016","1609","0000","1469","1162","307","128","1597","2593","0","61.59","44.81"
"10","007","00","016","1609","0629","817","644","173","60","877","1357","0","64.63","47.46"
"10","007","00","016","1609","0630","652","518","134","68","720","1236","0","58.25","41.91"
"10","007","00","016","1610","0000","782","597","185","70","852","1393","0","61.16","42.86"
"10","007","00","016","1610","0611","381","298","83","39","420","659","0","63.73","45.22"
"10","007","00","016","1610","0612","401","299","102","31","432","734","0","58.86","40.74"
"10","007","00","016","1611","0000","596","456","140","67","663","1255","0","52.83","36.33"
"10","007","00","016","1611","0606","596","456","140","67","663","1255","0","52.83","36.33"
"10","007","00","016","1612","0000","922","726","196","81","1003","1648","0","60.86","44.05"
"10","007","00","016","1612","0609","408","319","89","42","450","724","0","62.15","44.06"
"10","007","00","016","1612","0610","514","407","107","39","553","924","0","59.85","44.05"
"10","007","00","016","1613","0000","1015","779","236","103","1118","1915","0","58.38","40.68"
"10","007","00","016","1613","0607","481","366","115","60","541","889","0","60.85","41.17"
"10","007","00","016","1613","0608","534","413","121","43","577","1026","0","56.24","40.25"
"10","007","00","016","1614","0000","848","635","213","62","910","1606","0","56.66","39.54"
"10","007","00","016","1614","0613","334","241","93","19","353","758","0","46.57","31.79"
"10","007","00","016","1614","0614","514","394","120","43","557","848","0","65.68","46.46"
"10","007","00","016","1615","0000","677","507","170","80","757","1404","0","53.92","36.11"
"10","007","00","016","1615","0615","677","507","170","80","757","1404","0","53.92","36.11"
"10","007","00","016","1616","0000","463","357","106","53","516","871","0","59.24","40.99"
"10","007","00","016","1616","0631","463","357","106","53","516","871","0","59.24","40.99"
"10","007","00","016","1617","0000","345","261","84","40","385","706","0","54.53","36.97"
"10","007","00","016","1617","0632","345","261","84","40","385","706","0","54.53","36.97"
"10","007","00","016","1618","0000","449","364","85","33","482","770","0","62.6","47.27"
"10","007","00","016","1618","0633","449","364","85","33","482","770","0","62.6","47.27"
"10","007","00","016","1619","0000","406","322","84","34","440","669","0","65.77","48.13"
"10","007","00","016","1619","0634","406","322","84","34","440","669","0","65.77","48.13"
"10","007","00","016","1620","0000","445","332","113","49","494","862","0","57.31","38.52"
"10","007","00","016","1620","0635","445","332","113","49","494","862","0","57.31","38.52"
"10","007","00","016","1621","0000","434","339","95","38","472","847","0","55.73","40.02"
"10","007","00","016","1621","0636","434","339","95","38","472","847","0","55.73","40.02"
"10","007","00","016","1622","0000","381","313","68","48","429","668","0","64.22","46.86"
"10","007","00","016","1622","0637","381","313","68","48","429","668","0","64.22","46.86"
"10","007","00","016","1623","0000","515","391","124","31","546","1073","0","50.89","36.44"
"10","007","00","016","1623","0638","515","391","124","31","546","1073","0","50.89","36.44"
"10","007","00","016","1624","0000","592","452","140","65","657","1339","0","49.07","33.76"
"10","007","00","016","1624","0639","592","452","140","65","657","1339","0","49.07","33.76"
"10","007","00","017","0000","0000","19243","15033","4210","1509","20752","36306","42917","57.16","41.41"
"10","007","00","017","1701","0000","1430","1080","350","105","1535","2765","0","55.52","39.06"
"10","007","00","017","1701","0778","422","287","135","41","463","791","0","58.53","36.28"
"10","007","00","017","1701","0779","516","408","108","43","559","984","0","56.81","41.46"
"10","007","00","017","1701","0780","492","385","107","21","513","990","0","51.82","38.89"
"10","007","00","017","1702","0000","746","585","161","68","814","1478","0","55.07","39.58"
"10","007","00","017","1702","0785","394","322","72","34","428","753","0","56.84","42.76"
"10","007","00","017","1702","0786","352","263","89","34","386","725","0","53.24","36.28"
"10","007","00","017","1703","0000","601","447","154","70","671","1165","0","57.6","38.37"
"10","007","00","017","1703","0805","601","447","154","70","671","1165","0","57.6","38.37"
"10","007","00","017","1704","0000","2501","2028","473","179","2680","4546","0","58.95","44.61"
"10","007","00","017","1704","0781","579","465","114","50","629","1016","0","61.91","45.77"
"10","007","00","017","1704","0782","628","576","52","31","659","1091","0","60.4","52.8"
"10","007","00","017","1704","0783","670","493","177","73","743","1236","0","60.11","39.89"
"10","007","00","017","1704","0784","624","494","130","25","649","1203","0","53.95","41.06"
"10","007","00","017","1705","0000","521","407","114","38","559","933","0","59.91","43.62"
"10","007","00","017","1705","0790","521","407","114","38","559","933","0","59.91","43.62"
"10","007","00","017","1706","0000","536","415","121","34","570","1092","0","52.2","38.0"
"10","007","00","017","1706","0812","536","415","121","34","570","1092","0","52.2","38.0"
"10","007","00","017","1707","0000","1464","1176","288","73","1537","2698","0","56.97","43.59"
"10","007","00","017","1707","0798","364","291","73","18","382","688","0","55.52","42.3"
"10","007","00","017","1707","0799","445","357","88","30","475","870","0","54.6","41.03"
"10","007","00","017","1707","0800","655","528","127","25","680","1140","0","59.65","46.32"
"10","007","00","017","1708","0000","1078","810","268","90","1168","2066","0","56.53","39.21"
"10","007","00","017","1708","0791","554","409","145","51","605","990","0","61.11","41.31"
"10","007","00","017","1708","0792","524","401","123","39","563","1076","0","52.32","37.27"
"10","007","00","017","1709","0000","426","330","96","32","458","724","0","63.26","45.58"
"10","007","00","017","1709","0807","426","330","96","32","458","724","0","63.26","45.58"
"10","007","00","017","1710","0000","505","403","102","47","552","937","0","58.91","43.01"
"10","007","00","017","1710","0803","505","403","102","47","552","937","0","58.91","43.01"
"10","007","00","017","1711","0000","870","666","204","67","937","1645","0","56.96","40.49"
"10","007","00","017","1711","0796","419","314","105","32","451","750","0","60.13","41.87"
"10","007","00","017","1711","0797","451","352","99","35","486","895","0","54.3","39.33"
"10","007","00","017","1712","0000","546","417","129","55","601","992","0","60.58","42.04"
"10","007","00","017","1712","0811","546","417","129","55","601","992","0","60.58","42.04"
"10","007","00","017","1713","0000","729","599","130","58","787","1266","0","62.16","47.31"
"10","007","00","017","1713","0802","729","599","130","58","787","1266","0","62.16","47.31"
"10","007","00","017","1714","0000","760","597","163","47","807","1414","0","57.07","42.22"
"10","007","00","017","1714","0793","426","322","104","21","447","742","0","60.24","43.4"
"10","007","00","017","1714","0794","334","275","59","26","360","672","0","53.57","40.92"
"10","007","00","017","1715","0000","555","455","100","36","591","1015","0","58.23","44.83"
"10","007","00","017","1715","0808","555","455","100","36","591","1015","0","58.23","44.83"
"10","007","00","017","1716","0000","545","409","136","38","583","985","0","59.19","41.52"
"10","007","00","017","1716","0801","545","409","136","38","583","985","0","59.19","41.52"
"10","007","00","017","1717","0000","575","477","98","51","626","1235","0","50.69","38.62"
"10","007","00","017","1717","0795","575","477","98","51","626","1235","0","50.69","38.62"
"10","007","00","017","1718","0000","461","344","117","45","506","828","0","61.11","41.55"
"10","007","00","017","1718","0813","461","344","117","45","506","828","0","61.11","41.55"
"10","007","00","017","1719","0000","887","677","210","71","958","1611","0","59.47","42.02"
"10","007","00","017","1719","0788","344","251","93","33","377","562","0","67.08","44.66"
"10","007","00","017","1719","0789","543","426","117","38","581","1049","0","55.39","40.61"
"10","007","00","017","1720","0000","532","406","126","52","584","986","0","59.23","41.18"
"10","007","00","017","1720","0806","532","406","126","52","584","986","0","59.23","41.18"
"10","007","00","017","1721","0000","703","552","151","67","770","1506","0","51.13","36.65"
"10","007","00","017","1721","0814","375","288","87","51","426","787","0","54.13","36.59"
"10","007","00","017","1721","0815","328","264","64","16","344","719","0","47.84","36.72"
"10","007","00","017","1722","0000","552","430","122","71","623","1023","0","60.9","42.03"
"10","007","00","017","1722","0787","552","430","122","71","623","1023","0","60.9","42.03"
"10","007","00","017","1723","0000","652","526","126","38","690","1219","0","56.6","43.15"
"10","007","00","017","1723","0804","652","526","126","38","690","1219","0","56.6","43.15"
"10","007","00","017","1724","0000","1068","797","271","77","1145","2177","0","52.6","36.61"
"10","007","00","017","1724","0809","546","411","135","25","571","1116","0","51.16","36.83"
"10","007","00","017","1724","0810","522","386","136","52","574","1061","0","54.1","36.38"
"10","007","00","018","0000","0000","7204","5428","1776","783","7987","13339","15193","59.88","40.69"
"10","007","00","018","1801","0000","408","313","95","64","472","871","0","54.19","35.94"
"10","007","00","018","1801","0818","408","313","95","64","472","871","0","54.19","35.94"
"10","007","00","018","1802","0000","491","379","112","70","561","953","0","58.87","39.77"
"10","007","00","018","1802","0819","491","379","112","70","561","953","0","58.87","39.77"
"10","007","00","018","1803","0000","294","220","74","46","340","624","0","54.49","35.26"
"10","007","00","018","1803","0820","294","220","74","46","340","624","0","54.49","35.26"
"10","007","00","018","1804","0000","378","276","102","49","427","645","0","66.2","42.79"
"10","007","00","018","1804","0821","378","276","102","49","427","645","0","66.2","42.79"
"10","007","00","018","1805","0000","553","410","143","66","619","943","0","65.64","43.48"
"10","007","00","018","1805","0823","553","410","143","66","619","943","0","65.64","43.48"
"10","007","00","018","1806","0000","612","494","118","40","652","986","0","66.13","50.1"
"10","007","00","018","1806","0822","612","494","118","40","652","986","0","66.13","50.1"
"10","007","00","018","1807","0000","513","396","117","47","560","831","0","67.39","47.65"
"10","007","00","018","1807","0825","513","396","117","47","560","831","0","67.39","47.65"
"10","007","00","018","1808","0000","261","209","52","3","264","455","0","58.02","45.93"
"10","007","00","018","1808","0824","261","209","52","3","264","455","0","58.02","45.93"
"10","007","00","018","1809","0000","524","385","139","29","553","1013","0","54.59","38.01"
"10","007","00","018","1809","0827","524","385","139","29","553","1013","0","54.59","38.01"
"10","007","00","018","1810","0000","456","351","105","41","497","831","0","59.81","42.24"
"10","007","00","018","1810","0826","456","351","105","41","497","831","0","59.81","42.24"
"10","007","00","018","1811","0000","441","301","140","64","505","796","0","63.44","37.81"
"10","007","00","018","1811","0828","441","301","140","64","505","796","0","63.44","37.81"
"10","007","00","018","1812","0000","408","312","96","44","452","781","0","57.87","39.95"
"10","007","00","018","1812","0829","408","312","96","44","452","781","0","57.87","39.95"
"10","007","00","018","1813","0000","326","244","82","21","347","692","0","50.14","35.26"
"10","007","00","018","1813","0830","326","244","82","21","347","692","0","50.14","35.26"
"10","007","00","018","1814","0000","344","265","79","28","372","635","0","58.58","41.73"
"10","007","00","018","1814","0831","344","265","79","28","372","635","0","58.58","41.73"
"10","007","00","018","1815","0000","290","210","80","36","326","566","0","57.6","37.1"
"10","007","00","018","1815","0832","290","210","80","36","326","566","0","57.6","37.1"
"10","007","00","018","1816","0000","523","374","149","84","607","1028","0","59.05","36.38"
"10","007","00","018","1816","0816","523","374","149","84","607","1028","0","59.05","36.38"
"10","007","00","018","1817","0000","382","289","93","51","433","689","0","62.84","41.94"
"10","007","00","018","1817","0817","382","289","93","51","433","689","0","62.84","41.94"
"10","007","00","019","0000","0000","14702","11516","3186","1353","16055","27593","33335","58.19","41.74"
"10","007","00","019","1901","0000","1005","798","207","73","1078","1790","0","60.22","44.58"
"10","007","00","019","1901","0844","468","370","98","41","509","833","0","61.1","44.42"
"10","007","00","019","1901","0845","537","428","109","32","569","957","0","59.46","44.72"
"10","007","00","019","1902","0000","415","323","92","30","445","783","0","56.83","41.25"
"10","007","00","019","1902","0846","415","323","92","30","445","783","0","56.83","41.25"
"10","007","00","019","1903","0000","285","215","70","29","314","573","0","54.8","37.52"
"10","007","00","019","1903","0847","285","215","70","29","314","573","0","54.8","37.52"
"10","007","00","019","1904","0000","344","259","85","32","376","672","0","55.95","38.54"
"10","007","00","019","1904","0848","344","259","85","32","376","672","0","55.95","38.54"
"10","007","00","019","1905","0000","692","531","161","84","776","1442","0","53.81","36.82"
"10","007","00","019","1905","0849","337","253","84","41","378","695","0","54.39","36.4"
"10","007","00","019","1905","0850","355","278","77","43","398","747","0","53.28","37.22"
"10","007","00","019","1906","0000","741","599","142","61","802","1305","0","61.46","45.9"
"10","007","00","019","1906","0851","382","303","79","27","409","643","0","63.61","47.12"
"10","007","00","019","1906","0852","359","296","63","34","393","662","0","59.37","44.71"
"10","007","00","019","1907","0000","1236","957","279","125","1361","2206","0","61.7","43.38"
"10","007","00","019","1907","0853","633","494","139","60","693","1085","0","63.87","45.53"
"10","007","00","019","1907","0854","603","463","140","65","668","1121","0","59.59","41.3"
"10","007","00","019","1908","0000","1595","1282","313","117","1712","3017","0","56.75","42.49"
"10","007","00","019","1908","0855","466","389","77","42","508","830","0","61.2","46.87"
"10","007","00","019","1908","0856","502","391","111","42","544","975","0","55.79","40.1"
"10","007","00","019","1908","0857","627","502","125","33","660","1212","0","54.46","41.42"
"10","007","00","019","1909","0000","700","552","148","79","779","1302","0","59.83","42.4"
"10","007","00","019","1909","0858","700","552","148","79","779","1302","0","59.83","42.4"
"10","007","00","019","1910","0000","2474","1958","516","223","2697","4597","0","58.67","42.59"
"10","007","00","019","1910","0838","623","511","112","48","671","1124","0","59.7","45.46"
"10","007","00","019","1910","0839","622","502","120","45","667","1096","0","60.86","45.8"
"10","007","00","019","1910","0840","657","509","148","56","713","1213","0","58.78","41.96"
"10","007","00","019","1910","0841","572","436","136","74","646","1164","0","55.5","37.46"
"10","007","00","019","1911","0000","846","660","186","52","898","1608","0","55.85","41.04"
"10","007","00","019","1911","0842","383","291","92","26","409","730","0","56.03","39.86"
"10","007","00","019","1911","0843","463","369","94","26","489","878","0","55.69","42.03"
"10","007","00","019","1912","0000","1432","1099","333","163","1595","2649","0","60.21","41.49"
"10","007","00","019","1912","0833","449","353","96","68","517","925","0","55.89","38.16"
"10","007","00","019","1912","0834","469","357","112","52","521","869","0","59.95","41.08"
"10","007","00","019","1912","0835","514","389","125","43","557","855","0","65.15","45.5"
"10","007","00","019","1913","0000","1062","838","224","112","1174","1893","0","62.02","44.27"
"10","007","00","019","1913","0836","623","500","123","51","674","1065","0","63.29","46.95"
"10","007","00","019","1913","0837","439","338","101","61","500","828","0","60.39","40.82"
"10","007","00","019","1914","0000","940","740","200","94","1034","1994","0","51.86","37.11"
"10","007","00","019","1914","0859","493","384","109","35","528","1077","0","49.03","35.65"
"10","007","00","019","1914","0860","447","356","91","59","506","917","0","55.18","38.82"
"10","007","00","019","1915","0000","935","705","230","79","1014","1762","0","57.55","40.01"
"10","007","00","019","1915","0861","427","323","104","33","460","825","0","55.76","39.15"
"10","007","00","019","1915","0862","508","382","126","46","554","937","0","59.12","40.77"
"10","007","00","020","0000","0000","20312","15738","4574","2130","22442","42976","50709","52.22","36.62"
"10","007","00","020","2001","0000","1133","863","270","102","1235","2148","0","57.5","40.18"
"10","007","00","020","2001","0945","475","361","114","41","516","892","0","57.85","40.47"
"10","007","00","020","2001","0946","658","502","156","61","719","1256","0","57.25","39.97"
"10","007","00","020","2002","0000","1712","1342","370","141","1853","3201","0","57.89","41.92"
"10","007","00","020","2002","0947","525","404","121","45","570","1043","0","54.65","38.73"
"10","007","00","020","2002","0948","611","488","123","38","649","1076","0","60.32","45.35"
"10","007","00","020","2002","0949","576","450","126","58","634","1082","0","58.6","41.59"
"10","007","00","020","2003","0000","692","551","141","64","756","1427","0","52.98","38.61"
"10","007","00","020","2003","0950","692","551","141","64","756","1427","0","52.98","38.61"
"10","007","00","020","2004","0000","1422","1076","346","187","1609","3040","0","52.93","35.39"
"10","007","00","020","2004","0951","459","347","112","69","528","1030","0","51.26","33.69"
"10","007","00","020","2004","0952","472","355","117","68","540","1033","0","52.27","34.37"
"10","007","00","020","2004","0953","491","374","117","50","541","977","0","55.37","38.28"
"10","007","00","020","2005","0000","765","606","159","95","860","1658","0","51.87","36.55"
"10","007","00","020","2005","0954","320","250","70","31","351","683","0","51.39","36.6"
"10","007","00","020","2005","0955","445","356","89","64","509","975","0","52.21","36.51"
"10","007","00","020","2006","0000","532","423","109","64","596","1336","0","44.61","31.66"
"10","007","00","020","2006","0956","532","423","109","64","596","1336","0","44.61","31.66"
"10","007","00","020","2007","0000","419","312","107","63","482","1019","0","47.3","30.62"
"10","007","00","020","2007","0957","419","312","107","63","482","1019","0","47.3","30.62"
"10","007","00","020","2008","0000","378","284","94","50","428","1003","0","42.67","28.32"
"10","007","00","020","2008","0958","378","284","94","50","428","1003","0","42.67","28.32"
"10","007","00","020","2009","0000","578","470","108","67","645","1151","0","56.04","40.83"
"10","007","00","020","2009","0959","578","470","108","67","645","1151","0","56.04","40.83"
"10","007","00","020","2010","0000","811","627","184","99","910","1598","0","56.95","39.24"
"10","007","00","020","2010","0960","811","627","184","99","910","1598","0","56.95","39.24"
"10","007","00","020","2011","0000","1689","1338","351","113","1802","3259","0","55.29","41.06"
"10","007","00","020","2011","0961","747","597","150","49","796","1488","0","53.49","40.12"
"10","007","00","020","2011","0962","942","741","201","64","1006","1771","0","56.8","41.84"
"10","007","00","020","2012","0000","1259","954","305","97","1356","2540","0","53.39","37.56"
"10","007","00","020","2012","0942","296","208","88","22","318","731","0","43.5","28.45"
"10","007","00","020","2012","0943","538","426","112","48","586","1025","0","57.17","41.56"
"10","007","00","020","2012","0944","425","320","105","27","452","784","0","57.65","40.82"
"10","007","00","020","2013","0000","527","400","127","54","581","1360","0","42.72","29.41"
"10","007","00","020","2013","0963","527","400","127","54","581","1360","0","42.72","29.41"
"10","007","00","020","2014","0000","680","539","141","71","751","1613","0","46.56","33.42"
"10","007","00","020","2014","0964","680","539","141","71","751","1613","0","46.56","33.42"
"10","007","00","020","2015","0000","543","428","115","91","634","1228","0","51.63","34.85"
"10","007","00","020","2015","0965","543","428","115","91","634","1228","0","51.63","34.85"
"10","007","00","020","2016","0000","410","336","74","29","439","771","0","56.94","43.58"
"10","007","00","020","2016","0966","410","336","74","29","439","771","0","56.94","43.58"
"10","007","00","020","2017","0000","754","579","175","35","789","1519","0","51.94","38.12"
"10","007","00","020","2017","0967","469","351","118","34","503","858","0","58.62","40.91"
"10","007","00","020","2017","0968","285","228","57","1","286","661","0","43.27","34.49"
"10","007","00","020","2018","0000","545","427","118","83","628","1268","0","49.53","33.68"
"10","007","00","020","2018","0969","545","427","118","83","628","1268","0","49.53","33.68"
"10","007","00","020","2019","0000","465","365","100","44","509","1081","0","47.09","33.77"
"10","007","00","020","2019","0970","465","365","100","44","509","1081","0","47.09","33.77"
"10","007","00","020","2020","0000","1670","1287","383","191","1861","3659","0","50.86","35.17"
"10","007","00","020","2020","0971","546","425","121","38","584","1213","0","48.15","35.04"
"10","007","00","020","2020","0972","671","520","151","72","743","1328","0","55.95","39.16"
"10","007","00","020","2020","0973","453","342","111","81","534","1118","0","47.76","30.59"
"10","007","00","020","2021","0000","435","340","95","38","473","972","0","48.66","34.98"
"10","007","00","020","2021","0975","435","340","95","38","473","972","0","48.66","34.98"
"10","007","00","020","2022","0000","476","350","126","59","535","1157","0","46.24","30.25"
"10","007","00","020","2022","0974","476","350","126","59","535","1157","0","46.24","30.25"
"10","007","00","020","2023","0000","436","332","104","47","483","902","0","53.55","36.81"
"10","007","00","020","2023","0976","436","332","104","47","483","902","0","53.55","36.81"
"10","007","00","020","2024","0000","708","536","172","98","806","1273","0","63.32","42.11"
"10","007","00","020","2024","0977","708","536","172","98","806","1273","0","63.32","42.11"
"10","007","00","020","2025","0000","504","393","111","43","547","1087","0","50.32","36.15"
"10","007","00","020","2025","0978","504","393","111","43","547","1087","0","50.32","36.15"
"10","007","00","020","2026","0000","502","378","124","76","578","987","0","58.56","38.3"
"10","007","00","020","2026","0979","502","378","124","76","578","987","0","58.56","38.3"
"10","007","00","020","2027","0000","267","202","65","29","296","719","0","41.17","28.09"
"10","007","00","020","2027","0980","267","202","65","29","296","719","0","41.17","28.09"
"10","007","00","021","0000","0000","12500","9767","2733","1114","13614","23179","27346","58.73","42.14"
"10","007","00","021","2101","0000","604","462","142","53","657","1284","0","51.17","35.98"
"10","007","00","021","2101","0863","604","462","142","53","657","1284","0","51.17","35.98"
"10","007","00","021","2102","0000","560","455","105","45","605","874","0","69.22","52.06"
"10","007","00","021","2102","0873","560","455","105","45","605","874","0","69.22","52.06"
"10","007","00","021","2103","0000","1483","1216","267","88","1571","2562","0","61.32","47.46"
"10","007","00","021","2103","0871","789","640","149","47","836","1376","0","60.76","46.51"
"10","007","00","021","2103","0872","694","576","118","41","735","1186","0","61.97","48.57"
"10","007","00","021","2104","0000","591","451","140","91","682","1079","0","63.21","41.8"
"10","007","00","021","2104","0882","591","451","140","91","682","1079","0","63.21","41.8"
"10","007","00","021","2105","0000","381","299","82","33","414","760","0","54.47","39.34"
"10","007","00","021","2105","0886","381","299","82","33","414","760","0","54.47","39.34"
"10","007","00","021","2106","0000","625","469","156","76","701","1084","0","64.67","43.27"
"10","007","00","021","2106","0887","625","469","156","76","701","1084","0","64.67","43.27"
"10","007","00","021","2107","0000","595","464","131","56","651","1198","0","54.34","38.73"
"10","007","00","021","2107","0884","595","464","131","56","651","1198","0","54.34","38.73"
"10","007","00","021","2108","0000","308","227","81","46","354","621","0","57.0","36.55"
"10","007","00","021","2108","0885","308","227","81","46","354","621","0","57.0","36.55"
"10","007","00","021","2109","0000","715","567","148","58","773","1336","0","57.86","42.44"
"10","007","00","021","2109","0883","715","567","148","58","773","1336","0","57.86","42.44"
"10","007","00","021","2110","0000","650","495","155","54","704","1337","0","52.66","37.02"
"10","007","00","021","2110","0870","650","495","155","54","704","1337","0","52.66","37.02"
"10","007","00","021","2111","0000","856","665","191","60","916","1555","0","58.91","42.77"
"10","007","00","021","2111","0868","342","276","66","20","362","680","0","53.24","40.59"
"10","007","00","021","2111","0869","514","389","125","40","554","875","0","63.31","44.46"
"10","007","00","021","2112","0000","661","512","149","62","723","1187","0","60.91","43.13"
"10","007","00","021","2112","0864","661","512","149","62","723","1187","0","60.91","43.13"
"10","007","00","021","2113","0000","951","759","192","88","1039","1729","0","60.09","43.9"
"10","007","00","021","2113","0865","571","433","138","43","614","1033","0","59.44","41.92"
"10","007","00","021","2113","0866","380","326","54","45","425","696","0","61.06","46.84"
"10","007","00","021","2114","0000","552","409","143","26","578","938","0","61.62","43.6"
"10","007","00","021","2114","0878","552","409","143","26","578","938","0","61.62","43.6"
"10","007","00","021","2115","0000","516","419","97","47","563","880","0","63.98","47.61"
"10","007","00","021","2115","0879","516","419","97","47","563","880","0","63.98","47.61"
"10","007","00","021","2116","0000","678","520","158","71","749","1396","0","53.65","37.25"
"10","007","00","021","2116","0880","383","293","90","41","424","804","0","52.74","36.44"
"10","007","00","021","2116","0881","295","227","68","30","325","592","0","54.9","38.34"
"10","007","00","021","2117","0000","833","631","202","88","921","1606","0","57.35","39.29"
"10","007","00","021","2117","0874","318","231","87","38","356","647","0","55.02","35.7"
"10","007","00","021","2117","0875","515","400","115","50","565","959","0","58.92","41.71"
"10","007","00","021","2118","0000","132","98","34","11","143","263","0","54.37","37.26"
"10","007","00","021","2118","0876","132","98","34","11","143","263","0","54.37","37.26"
"10","007","00","021","2119","0000","304","237","67","31","335","618","0","54.21","38.35"
"10","007","00","021","2119","0877","304","237","67","31","335","618","0","54.21","38.35"
"10","007","00","021","2120","0000","505","412","93","30","535","872","0","61.35","47.25"
"10","007","00","021","2120","0867","505","412","93","30","535","872","0","61.35","47.25"
"10","007","00","022","0000","0000","12332","9747","2585","1576","13908","25677","30536","54.17","37.96"
"10","007","00","022","2201","0000","1142","881","261","115","1257","2468","0","50.93","35.7"
"10","007","00","022","2201","0888","508","386","122","64","572","1178","0","48.56","32.77"
"10","007","00","022","2201","0889","634","495","139","51","685","1290","0","53.1","38.37"
"10","007","00","022","2202","0000","848","674","174","95","943","1756","0","53.7","38.38"
"10","007","00","022","2202","0890","469","385","84","58","527","973","0","54.16","39.57"
"10","007","00","022","2202","0891","379","289","90","37","416","783","0","53.13","36.91"
"10","007","00","022","2203","0000","821","626","195","120","941","1632","0","57.66","38.36"
"10","007","00","022","2203","0892","364","280","84","52","416","733","0","56.75","38.2"
"10","007","00","022","2203","0893","457","346","111","68","525","899","0","58.4","38.49"
"10","007","00","022","2204","0000","1132","889","243","124","1256","2321","0","54.11","38.3"
"10","007","00","022","2204","0894","486","375","111","58","544","965","0","56.37","38.86"
"10","007","00","022","2204","0895","646","514","132","66","712","1356","0","52.51","37.91"
"10","007","00","022","2205","0000","612","487","125","75","687","1265","0","54.31","38.5"
"10","007","00","022","2205","0896","612","487","125","75","687","1265","0","54.31","38.5"
"10","007","00","022","2206","0000","816","655","161","111","927","1582","0","58.6","41.4"
"10","007","00","022","2206","0897","479","387","92","66","545","877","0","62.14","44.13"
"10","007","00","022","2206","0898","337","268","69","45","382","705","0","54.18","38.01"
"10","007","00","022","2207","0000","1690","1398","292","224","1914","3285","0","58.26","42.56"
"10","007","00","022","2207","0899","534","470","64","103","637","1062","0","59.98","44.26"
"10","007","00","022","2207","0900","680","541","139","59","739","1300","0","56.85","41.62"
"10","007","00","022","2207","0901","476","387","89","62","538","923","0","58.29","41.93"
"10","007","00","022","2208","0000","1071","857","214","112","1183","2188","0","54.07","39.17"
"10","007","00","022","2208","0902","484","381","103","46","530","1085","0","48.85","35.12"
"10","007","00","022","2208","0903","587","476","111","66","653","1103","0","59.2","43.16"
"10","007","00","022","2209","0000","342","314","28","35","377","735","0","51.29","42.72"
"10","007","00","022","2209","0904","342","314","28","35","377","735","0","51.29","42.72"
"10","007","00","022","2210","0000","259","196","63","57","316","574","0","55.05","34.15"
"10","007","00","022","2210","0905","259","196","63","57","316","574","0","55.05","34.15"
"10","007","00","022","2211","0000","683","530","153","107","790","1504","0","52.53","35.24"
"10","007","00","022","2211","0906","335","271","64","49","384","767","0","50.07","35.33"
"10","007","00","022","2211","0907","348","259","89","58","406","737","0","55.09","35.14"
"10","007","00","022","2212","0000","425","306","119","66","491","1058","0","46.41","28.92"
"10","007","00","022","2212","0908","425","306","119","66","491","1058","0","46.41","28.92"
"10","007","00","022","2213","0000","355","270","85","70","425","826","0","51.45","32.69"
"10","007","00","022","2213","0909","355","270","85","70","425","826","0","51.45","32.69"
"10","007","00","022","2214","0000","457","361","96","88","545","1082","0","50.37","33.36"
"10","007","00","022","2214","0910","457","361","96","88","545","1082","0","50.37","33.36"
"10","007","00","022","2215","0000","745","594","151","77","822","1448","0","56.77","41.02"
"10","007","00","022","2215","0911","397","319","78","49","446","737","0","60.52","43.28"
"10","007","00","022","2215","0912","348","275","73","28","376","711","0","52.88","38.68"
"10","007","00","022","2216","0000","524","394","130","69","593","1043","0","56.86","37.78"
"10","007","00","022","2216","0913","524","394","130","69","593","1043","0","56.86","37.78"
"10","007","00","022","2217","0000","410","315","95","31","441","910","0","48.46","34.62"
"10","007","00","022","2217","0914","410","315","95","31","441","910","0","48.46","34.62"
"10","007","00","023","0000","0000","12594","9721","2873","1607","14201","29291","33549","48.48","33.19"
"10","007","00","023","2301","0000","272","201","71","58","330","940","0","35.11","21.38"
"10","007","00","023","2301","0998","272","201","71","58","330","940","0","35.11","21.38"
"10","007","00","023","2302","0000","126","91","35","26","152","403","0","37.72","22.58"
"10","007","00","023","2302","0999","126","91","35","26","152","403","0","37.72","22.58"
"10","007","00","023","2303","0000","336","256","80","39","375","756","0","49.6","33.86"
"10","007","00","023","2303","1000","336","256","80","39","375","756","0","49.6","33.86"
"10","007","00","023","2304","0000","147","107","40","31","178","548","0","32.48","19.53"
"10","007","00","023","2304","1001","147","107","40","31","178","548","0","32.48","19.53"
"10","007","00","023","2305","0000","461","360","101","54","515","997","0","51.65","36.11"
"10","007","00","023","2305","1002","461","360","101","54","515","997","0","51.65","36.11"
"10","007","00","023","2306","0000","916","681","235","105","1021","2159","0","47.29","31.54"
"10","007","00","023","2306","1003","512","389","123","67","579","1300","0","44.54","29.92"
"10","007","00","023","2306","1004","404","292","112","38","442","859","0","51.46","33.99"
"10","007","00","023","2307","0000","607","480","127","43","650","1370","0","47.45","35.04"
"10","007","00","023","2307","1005","328","253","75","18","346","734","0","47.14","34.47"
"10","007","00","023","2307","1006","279","227","52","25","304","636","0","47.8","35.69"
"10","007","00","023","2308","0000","158","122","36","13","171","470","0","36.38","25.96"
"10","007","00","023","2308","1022","158","122","36","13","171","470","0","36.38","25.96"
"10","007","00","023","2309","0000","255","197","58","40","295","668","0","44.16","29.49"
"10","007","00","023","2309","1008","255","197","58","40","295","668","0","44.16","29.49"
"10","007","00","023","2310","0000","348","261","87","28","376","744","0","50.54","35.08"
"10","007","00","023","2310","1009","348","261","87","28","376","744","0","50.54","35.08"
"10","007","00","023","2311","0000","413","332","81","72","485","1026","0","47.27","32.36"
"10","007","00","023","2311","1010","413","332","81","72","485","1026","0","47.27","32.36"
"10","007","00","023","2312","0000","203","156","47","11","214","586","0","36.52","26.62"
"10","007","00","023","2312","1011","203","156","47","11","214","586","0","36.52","26.62"
"10","007","00","023","2313","0000","283","211","72","30","313","593","0","52.78","35.58"
"10","007","00","023","2313","1012","283","211","72","30","313","593","0","52.78","35.58"
"10","007","00","023","2314","0000","306","222","84","69","375","808","0","46.41","27.48"
"10","007","00","023","2314","1007","306","222","84","69","375","808","0","46.41","27.48"
"10","007","00","023","2315","0000","973","722","251","163","1136","2131","0","53.31","33.88"
"10","007","00","023","2315","1013","509","386","123","72","581","1071","0","54.25","36.04"
"10","007","00","023","2315","1014","464","336","128","91","555","1060","0","52.36","31.7"
"10","007","00","023","2316","0000","285","212","73","27","312","708","0","44.07","29.94"
"10","007","00","023","2316","1015","285","212","73","27","312","708","0","44.07","29.94"
"10","007","00","023","2317","0000","288","225","63","60","348","735","0","47.35","30.61"
"10","007","00","023","2317","1016","288","225","63","60","348","735","0","47.35","30.61"
"10","007","00","023","2318","0000","284","211","73","65","349","674","0","51.78","31.31"
"10","007","00","023","2318","1019","284","211","73","65","349","674","0","51.78","31.31"
"10","007","00","023","2319","0000","544","417","127","93","637","1300","0","49.0","32.08"
"10","007","00","023","2319","1017","270","199","71","60","330","571","0","57.79","34.85"
"10","007","00","023","2319","1018","274","218","56","33","307","729","0","42.11","29.9"
"10","007","00","023","2320","0000","790","601","189","91","881","1652","0","53.33","36.38"
"10","007","00","023","2320","1020","387","280","107","41","428","846","0","50.59","33.1"
"10","007","00","023","2320","1021","403","321","82","50","453","806","0","56.2","39.83"
"10","007","00","023","2321","0000","719","592","127","81","800","1441","0","55.52","41.08"
"10","007","00","023","2321","1023","590","486","104","58","648","1124","0","57.65","43.24"
"10","007","00","023","2321","1024","129","106","23","23","152","317","0","47.95","33.44"
"10","007","00","023","2322","0000","427","335","92","50","477","1086","0","43.92","30.85"
"10","007","00","023","2322","1028","427","335","92","50","477","1086","0","43.92","30.85"
"10","007","00","023","2323","0000","844","669","175","84","928","2125","0","43.67","31.48"
"10","007","00","023","2323","1025","441","342","99","57","498","1158","0","43.01","29.53"
"10","007","00","023","2323","1026","403","327","76","27","430","967","0","44.47","33.82"
"10","007","00","023","2324","0000","359","297","62","41","400","762","0","52.49","38.98"
"10","007","00","023","2324","1027","359","297","62","41","400","762","0","52.49","38.98"
"10","007","00","023","2325","0000","578","469","109","56","634","1400","0","45.29","33.5"
"10","007","00","023","2325","1029","343","271","72","25","368","747","0","49.26","36.28"
"10","007","00","023","2325","1030","235","198","37","31","266","653","0","40.74","30.32"
"10","007","00","023","2326","0000","1672","1294","378","177","1849","3209","0","57.62","40.32"
"10","007","00","023","2326","1031","451","361","90","61","512","872","0","58.72","41.4"
"10","007","00","023","2326","1032","690","532","158","55","745","1235","0","60.32","43.08"
"10","007","00","023","2326","1033","531","401","130","61","592","1102","0","53.72","36.39"
"10","007","00","024","0000","0000","4971","3812","1159","633","5604","14713","16781","38.09","25.91"
"10","007","00","024","2401","0000","342","261","81","83","425","1104","0","38.5","23.64"
"10","007","00","024","2401","0982","342","261","81","83","425","1104","0","38.5","23.64"
"10","007","00","024","2402","0000","378","303","75","52","430","1092","0","39.38","27.75"
"10","007","00","024","2402","0986","155","133","22","26","181","518","0","34.94","25.68"
"10","007","00","024","2402","0987","223","170","53","26","249","574","0","43.38","29.62"
"10","007","00","024","2403","0000","546","418","128","62","608","1312","0","46.34","31.86"
"10","007","00","024","2403","0984","546","418","128","62","608","1312","0","46.34","31.86"
"10","007","00","024","2404","0000","305","237","68","61","366","853","0","42.91","27.78"
"10","007","00","024","2404","0985","305","237","68","61","366","853","0","42.91","27.78"
"10","007","00","024","2405","0000","471","367","104","66","537","964","0","55.71","38.07"
"10","007","00","024","2405","0983","471","367","104","66","537","964","0","55.71","38.07"
"10","007","00","024","2406","0000","375","295","80","29","404","1103","0","36.63","26.75"
"10","007","00","024","2406","0993","375","295","80","29","404","1103","0","36.63","26.75"
"10","007","00","024","2407","0000","368","299","69","30","398","1288","0","30.9","23.21"
"10","007","00","024","2407","0981","368","299","69","30","398","1288","0","30.9","23.21"
"10","007","00","024","2408","0000","227","162","65","41","268","702","0","38.18","23.08"
"10","007","00","024","2408","0988","227","162","65","41","268","702","0","38.18","23.08"
"10","007","00","024","2409","0000","199","159","40","26","225","686","0","32.8","23.18"
"10","007","00","024","2409","0996","199","159","40","26","225","686","0","32.8","23.18"
"10","007","00","024","2410","0000","295","229","66","36","331","1069","0","30.96","21.42"
"10","007","00","024","2410","0989","101","76","25","16","117","376","0","31.12","20.21"
"10","007","00","024","2410","0990","194","153","41","20","214","693","0","30.88","22.08"
"10","007","00","024","2411","0000","254","197","57","22","276","899","0","30.7","21.91"
"10","007","00","024","2411","0997","254","197","57","22","276","899","0","30.7","21.91"
"10","007","00","024","2412","0000","373","285","88","33","406","1192","0","34.06","23.91"
"10","007","00","024","2412","0994","373","285","88","33","406","1192","0","34.06","23.91"
"10","007","00","024","2413","0000","325","245","80","36","361","917","0","39.37","26.72"
"10","007","00","024","2413","0995","325","245","80","36","361","917","0","39.37","26.72"
"10","007","00","024","2414","0000","342","239","103","43","385","877","0","43.9","27.25"
"10","007","00","024","2414","0991","342","239","103","43","385","877","0","43.9","27.25"
"10","007","00","024","2415","0000","171","116","55","13","184","655","0","28.09","17.71"
"10","007","00","024","2415","0992","171","116","55","13","184","655","0","28.09","17.71"
"10","007","00","025","0000","0000","6050","4563","1487","772","6822","12821","15117","53.21","35.59"
"10","007","00","025","2501","0000","592","457","135","75","667","1168","0","57.11","39.13"
"10","007","00","025","2501","1034","592","457","135","75","667","1168","0","57.11","39.13"
"10","007","00","025","2502","0000","1040","772","268","95","1135","1925","0","58.96","40.1"
"10","007","00","025","2502","1035","504","370","134","34","538","965","0","55.75","38.34"
"10","007","00","025","2502","1036","536","402","134","61","597","960","0","62.19","41.88"
"10","007","00","025","2503","0000","418","321","97","66","484","743","0","65.14","43.2"
"10","007","00","025","2503","1037","418","321","97","66","484","743","0","65.14","43.2"
"10","007","00","025","2504","0000","300","233","67","37","337","751","0","44.87","31.03"
"10","007","00","025","2504","1038","300","233","67","37","337","751","0","44.87","31.03"
"10","007","00","025","2505","0000","633","481","152","60","693","1525","0","45.44","31.54"
"10","007","00","025","2505","1039","337","250","87","43","380","792","0","47.98","31.57"
"10","007","00","025","2505","1040","296","231","65","17","313","733","0","42.7","31.51"
"10","007","00","025","2506","0000","301","238","63","45","346","657","0","52.66","36.23"
"10","007","00","025","2506","1041","301","238","63","45","346","657","0","52.66","36.23"
"10","007","00","025","2507","0000","489","375","114","40","529","1063","0","49.76","35.28"
"10","007","00","025","2507","1042","489","375","114","40","529","1063","0","49.76","35.28"
"10","007","00","025","2508","0000","551","420","131","80","631","1114","0","56.64","37.7"
"10","007","00","025","2508","1043","551","420","131","80","631","1114","0","56.64","37.7"
"10","007","00","025","2509","0000","288","204","84","55","343","506","0","67.79","40.32"
"10","007","00","025","2509","1044","288","204","84","55","343","506","0","67.79","40.32"
"10","007","00","025","2510","0000","378","289","89","43","421","823","0","51.15","35.12"
"10","007","00","025","2510","1045","378","289","89","43","421","823","0","51.15","35.12"
"10","007","00","025","2511","0000","294","203","91","42","336","654","0","51.38","31.04"
"10","007","00","025","2511","1046","294","203","91","42","336","654","0","51.38","31.04"
"10","007","00","025","2512","0000","211","160","51","33","244","577","0","42.29","27.73"
"10","007","00","025","2512","1047","211","160","51","33","244","577","0","42.29","27.73"
"10","007","00","025","2513","0000","346","258","88","61","407","772","0","52.72","33.42"
"10","007","00","025","2513","1048","346","258","88","61","407","772","0","52.72","33.42"
"10","007","00","025","2514","0000","209","152","57","40","249","543","0","45.86","27.99"
"10","007","00","025","2514","1049","209","152","57","40","249","543","0","45.86","27.99"
"10","007","00","026","0000","0000","11550","8840","2710","1308","12858","25405","29797","50.61","34.8"
"10","007","00","026","2601","0000","841","658","183","85","926","1839","0","50.35","35.78"
"10","007","00","026","2601","0915","381","308","73","49","430","778","0","55.27","39.59"
"10","007","00","026","2601","0916","460","350","110","36","496","1061","0","46.75","32.99"
"10","007","00","026","2602","0000","570","454","116","72","642","1409","0","45.56","32.22"
"10","007","00","026","2602","0925","570","454","116","72","642","1409","0","45.56","32.22"
"10","007","00","026","2603","0000","460","371","89","63","523","1157","0","45.2","32.07"
"10","007","00","026","2603","0930","460","371","89","63","523","1157","0","45.2","32.07"
"10","007","00","026","2604","0000","748","573","175","88","836","1490","0","56.11","38.46"
"10","007","00","026","2604","0941","748","573","175","88","836","1490","0","56.11","38.46"
"10","007","00","026","2605","0000","290","224","66","34","324","701","0","46.22","31.95"
"10","007","00","026","2605","0917","290","224","66","34","324","701","0","46.22","31.95"
"10","007","00","026","2606","0000","676","511","165","87","763","1506","0","50.66","33.93"
"10","007","00","026","2606","0926","349","276","73","28","377","792","0","47.6","34.85"
"10","007","00","026","2606","0927","327","235","92","59","386","714","0","54.06","32.91"
"10","007","00","026","2607","0000","371","298","73","63","434","843","0","51.48","35.35"
"10","007","00","026","2607","0936","371","298","73","63","434","843","0","51.48","35.35"
"10","007","00","026","2608","0000","473","340","133","57","530","879","0","60.3","38.68"
"10","007","00","026","2608","0918","473","340","133","57","530","879","0","60.3","38.68"
"10","007","00","026","2609","0000","849","619","230","116","965","2071","0","46.6","29.89"
"10","007","00","026","2609","0928","472","349","123","66","538","1109","0","48.51","31.47"
"10","007","00","026","2609","0929","377","270","107","50","427","962","0","44.39","28.07"
"10","007","00","026","2610","0000","232","177","55","11","243","711","0","34.18","24.89"
"10","007","00","026","2610","0937","232","177","55","11","243","711","0","34.18","24.89"
"10","007","00","026","2611","0000","835","645","190","84","919","1532","0","59.99","42.1"
"10","007","00","026","2611","0919","391","298","93","39","430","654","0","65.75","45.57"
"10","007","00","026","2611","0920","444","347","97","45","489","878","0","55.69","39.52"
"10","007","00","026","2612","0000","889","682","207","77","966","1839","0","52.53","37.09"
"10","007","00","026","2612","0931","448","349","99","42","490","952","0","51.47","36.66"
"10","007","00","026","2612","0932","441","333","108","35","476","887","0","53.66","37.54"
"10","007","00","026","2613","0000","401","300","101","69","470","851","0","55.23","35.25"
"10","007","00","026","2613","0938","401","300","101","69","470","851","0","55.23","35.25"
"10","007","00","026","2614","0000","957","753","204","87","1044","1813","0","57.58","41.53"
"10","007","00","026","2614","0921","525","420","105","50","575","942","0","61.04","44.59"
"10","007","00","026","2614","0922","432","333","99","37","469","871","0","53.85","38.23"
"10","007","00","026","2615","0000","752","551","201","109","861","1876","0","45.9","29.37"
"10","007","00","026","2615","0933","336","264","72","44","380","866","0","43.88","30.48"
"10","007","00","026","2615","0934","416","287","129","65","481","1010","0","47.62","28.42"
"10","007","00","026","2616","0000","513","400","113","58","571","1247","0","45.79","32.08"
"10","007","00","026","2616","0940","513","400","113","58","571","1247","0","45.79","32.08"
"10","007","00","026","2617","0000","935","711","224","83","1018","1905","0","53.44","37.32"
"10","007","00","026","2617","0923","491","385","106","26","517","1047","0","49.38","36.77"
"10","007","00","026","2617","0924","444","326","118","57","501","858","0","58.39","38.0"
"10","007","00","026","2618","0000","397","295","102","25","422","853","0","49.47","34.58"
"10","007","00","026","2618","0935","397","295","102","25","422","853","0","49.47","34.58"
"10","007","00","026","2619","0000","361","278","83","40","401","883","0","45.41","31.48"
"10","007","00","026","2619","0939","361","278","83","40","401","883","0","45.41","31.48"
"10","008","00","000","0000","0000","225659","178955","46704","18796","244455","427089","497876","57.24","41.9"
"10","008","00","001","0000","0000","47513","38111","9402","3138","50651","84328","99538","60.06","45.19"
"10","008","00","001","0101","0000","524","406","118","26","550","927","0","59.33","43.8"
"10","008","00","001","0101","0001","524","406","118","26","550","927","0","59.33","43.8"
"10","008","00","001","0102","0000","866","705","161","65","931","1440","0","64.65","48.96"
"10","008","00","001","0102","0002","423","335","88","31","454","667","0","68.07","50.22"
"10","008","00","001","0102","0003","443","370","73","34","477","773","0","61.71","47.87"
"10","008","00","001","0103","0000","476","365","111","38","514","818","0","62.84","44.62"
"10","008","00","001","0103","0004","476","365","111","38","514","818","0","62.84","44.62"
"10","008","00","001","0104","0000","328","244","84","28","356","525","0","67.81","46.48"
"10","008","00","001","0104","0005","328","244","84","28","356","525","0","67.81","46.48"
"10","008","00","001","0105","0000","352","283","69","29","381","575","0","66.26","49.22"
"10","008","00","001","0105","0006","352","283","69","29","381","575","0","66.26","49.22"
"10","008","00","001","0106","0000","237","179","58","16","253","368","0","68.75","48.64"
"10","008","00","001","0106","0007","237","179","58","16","253","368","0","68.75","48.64"
"10","008","00","001","0107","0000","585","438","147","47","632","956","0","66.11","45.82"
"10","008","00","001","0107","0008","585","438","147","47","632","956","0","66.11","45.82"
"10","008","00","001","0108","0000","1551","1241","310","115","1666","2632","0","63.3","47.15"
"10","008","00","001","0108","0058","811","649","162","67","878","1387","0","63.3","46.79"
"10","008","00","001","0108","0059","740","592","148","48","788","1245","0","63.29","47.55"
"10","008","00","001","0109","0000","4048","3277","771","247","4295","7018","0","61.2","46.69"
"10","008","00","001","0109","0060","657","536","121","33","690","1199","0","57.55","44.7"
"10","008","00","001","0109","0061","728","588","140","54","782","1288","0","60.71","45.65"
"10","008","00","001","0109","0062","576","467","109","45","621","1040","0","59.71","44.9"
"10","008","00","001","0109","0063","611","494","117","53","664","1070","0","62.06","46.17"
"10","008","00","001","0109","0064","780","647","133","36","816","1299","0","62.82","49.81"
"10","008","00","001","0109","0065","696","545","151","26","722","1122","0","64.35","48.57"
"10","008","00","001","0110","0000","2364","1894","470","169","2533","4543","0","55.76","41.69"
"10","008","00","001","0110","0032","740","595","145","48","788","1356","0","58.11","43.88"
"10","008","00","001","0110","0033","685","544","141","59","744","1373","0","54.19","39.62"
"10","008","00","001","0110","0034","757","595","162","48","805","1452","0","55.44","40.98"
"10","008","00","001","0110","0035","182","160","22","14","196","362","0","54.14","44.2"
"10","008","00","001","0111","0000","209","161","48","27","236","389","0","60.67","41.39"
"10","008","00","001","0111","0036","209","161","48","27","236","389","0","60.67","41.39"
"10","008","00","001","0112","0000","3421","2671","750","247","3668","5992","0","61.21","44.58"
"10","008","00","001","0112","0022","513","395","118","35","548","960","0","57.08","41.15"
"10","008","00","001","0112","0023","519","418","101","39","558","906","0","61.59","46.14"
"10","008","00","001","0112","0024","554","440","114","45","599","957","0","62.59","45.98"
"10","008","00","001","0112","0025","597","447","150","55","652","997","0","65.4","44.83"
"10","008","00","001","0112","0026","581","450","131","46","627","1008","0","62.2","44.64"
"10","008","00","001","0112","0027","657","521","136","27","684","1164","0","58.76","44.76"
"10","008","00","001","0113","0000","1071","830","241","105","1176","2045","0","57.51","40.59"
"10","008","00","001","0113","0028","323","256","67","28","351","587","0","59.8","43.61"
"10","008","00","001","0113","0029","371","276","95","33","404","734","0","55.04","37.6"
"10","008","00","001","0113","0030","377","298","79","44","421","724","0","58.15","41.16"
"10","008","00","001","0114","0000","559","461","98","37","596","1003","0","59.42","45.96"
"10","008","00","001","0114","0031","559","461","98","37","596","1003","0","59.42","45.96"
"10","008","00","001","0115","0000","3036","2609","427","157","3193","5426","0","58.85","48.08"
"10","008","00","001","0115","0009","633","513","120","22","655","1245","0","52.61","41.2"
"10","008","00","001","0115","0010","815","795","20","28","843","1484","0","56.81","53.57"
"10","008","00","001","0115","0011","729","596","133","49","778","1191","0","65.32","50.04"
"10","008","00","001","0115","0012","859","705","154","58","917","1506","0","60.89","46.81"
"10","008","00","001","0116","0000","1674","1302","372","114","1788","2790","0","64.09","46.67"
"10","008","00","001","0116","0013","631","485","146","45","676","1070","0","63.18","45.33"
"10","008","00","001","0116","0014","396","318","78","23","419","670","0","62.54","47.46"
"10","008","00","001","0116","0015","647","499","148","46","693","1050","0","66.0","47.52"
"10","008","00","001","0117","0000","1078","820","258","88","1166","2106","0","55.37","38.94"
"10","008","00","001","0117","0016","557","427","130","52","609","1122","0","54.28","38.06"
"10","008","00","001","0117","0017","521","393","128","36","557","984","0","56.61","39.94"
"10","008","00","001","0118","0000","2556","1999","557","169","2725","4411","0","61.78","45.32"
"10","008","00","001","0118","0018","650","533","117","29","679","1062","0","63.94","50.19"
"10","008","00","001","0118","0019","595","475","120","48","643","1053","0","61.06","45.11"
"10","008","00","001","0118","0020","666","486","180","36","702","1104","0","63.59","44.02"
"10","008","00","001","0118","0021","645","505","140","56","701","1192","0","58.81","42.37"
"10","008","00","001","0119","0000","971","778","193","73","1044","1930","0","54.09","40.31"
"10","008","00","001","0119","0083","490","394","96","47","537","950","0","56.53","41.47"
"10","008","00","001","0119","0084","481","384","97","26","507","980","0","51.73","39.18"
"10","008","00","001","0120","0000","356","251","105","41","397","790","0","50.25","31.77"
"10","008","00","001","0120","0081","356","251","105","41","397","790","0","50.25","31.77"
"10","008","00","001","0121","0000","246","200","46","22","268","647","0","41.42","30.91"
"10","008","00","001","0121","0082","246","200","46","22","268","647","0","41.42","30.91"
"10","008","00","001","0122","0000","491","377","114","103","594","1122","0","52.94","33.6"
"10","008","00","001","0122","0080","491","377","114","103","594","1122","0","52.94","33.6"
"10","008","00","001","0123","0000","2919","2341","578","163","3082","5362","0","57.48","43.66"
"10","008","00","001","0123","0066","789","633","156","44","833","1414","0","58.91","44.77"
"10","008","00","001","0123","0067","625","492","133","41","666","1121","0","59.41","43.89"
"10","008","00","001","0123","0068","781","628","153","29","810","1434","0","56.49","43.79"
"10","008","00","001","0123","0069","724","588","136","49","773","1393","0","55.49","42.21"
"10","008","00","001","0124","0000","2514","2022","492","104","2618","4907","0","53.35","41.21"
"10","008","00","001","0124","0070","574","454","120","17","591","1059","0","55.81","42.87"
"10","008","00","001","0124","0071","668","529","139","30","698","1218","0","57.31","43.43"
"10","008","00","001","0124","0072","636","510","126","25","661","1293","0","51.12","39.44"
"10","008","00","001","0124","0073","636","529","107","32","668","1337","0","49.96","39.57"
"10","008","00","001","0125","0000","1607","1225","382","106","1713","2859","0","59.92","42.85"
"10","008","00","001","0125","0074","514","383","131","40","554","876","0","63.24","43.72"
"10","008","00","001","0125","0075","539","415","124","26","565","971","0","58.19","42.74"
"10","008","00","001","0125","0076","554","427","127","40","594","1012","0","58.7","42.19"
"10","008","00","001","0126","0000","1644","1312","332","130","1774","2999","0","59.15","43.75"
"10","008","00","001","0126","0077","487","404","83","49","536","973","0","55.09","41.52"
"10","008","00","001","0126","0078","589","449","140","40","629","1002","0","62.77","44.81"
"10","008","00","001","0126","0079","568","459","109","41","609","1024","0","59.47","44.82"
"10","008","00","001","0127","0000","3668","3041","627","190","3858","5880","0","65.61","51.72"
"10","008","00","001","0127","0039","541","426","115","52","593","921","0","64.39","46.25"
"10","008","00","001","0127","0040","600","488","112","19","619","892","0","69.39","54.71"
"10","008","00","001","0127","0041","644","542","102","33","677","1050","0","64.48","51.62"
"10","008","00","001","0127","0042","659","552","107","22","681","1078","0","63.17","51.21"
"10","008","00","001","0127","0043","631","537","94","36","667","1078","0","61.87","49.81"
"10","008","00","001","0127","0044","593","496","97","28","621","861","0","72.13","57.61"
"10","008","00","001","0128","0000","1422","1101","321","111","1533","2365","0","64.82","46.55"
"10","008","00","001","0128","0037","771","594","177","60","831","1276","0","65.13","46.55"
"10","008","00","001","0128","0038","651","507","144","51","702","1089","0","64.46","46.56"
"10","008","00","001","0129","0000","3884","3186","698","196","4080","6589","0","61.92","48.35"
"10","008","00","001","0129","0045","670","522","148","58","728","1221","0","59.62","42.75"
"10","008","00","001","0129","0046","614","513","101","34","648","1105","0","58.64","46.43"
"10","008","00","001","0129","0047","729","579","150","27","756","1230","0","61.46","47.07"
"10","008","00","001","0129","0048","655","557","98","20","675","1092","0","61.81","51.01"
"10","008","00","001","0129","0049","805","689","116","17","822","1286","0","63.92","53.58"
"10","008","00","001","0129","0050","411","326","85","40","451","655","0","68.85","49.77"
"10","008","00","001","0130","0000","825","652","173","62","887","1439","0","61.64","45.31"
"10","008","00","001","0130","0051","437","346","91","34","471","719","0","65.51","48.12"
"10","008","00","001","0130","0052","388","306","82","28","416","720","0","57.78","42.5"
"10","008","00","001","0131","0000","490","420","70","21","511","848","0","60.26","49.53"
"10","008","00","001","0131","0057","490","420","70","21","511","848","0","60.26","49.53"
"10","008","00","001","0132","0000","615","533","82","41","656","1108","0","59.21","48.1"
"10","008","00","001","0132","0054","257","226","31","22","279","492","0","56.71","45.93"
"10","008","00","001","0132","0055","358","307","51","19","377","616","0","61.2","49.84"
"10","008","00","001","0133","0000","604","526","78","31","635","1010","0","62.87","52.08"
"10","008","00","001","0133","0056","604","526","78","31","635","1010","0","62.87","52.08"
"10","008","00","001","0134","0000","322","261","61","20","342","509","0","67.19","51.28"
"10","008","00","001","0134","0053","322","261","61","20","342","509","0","67.19","51.28"
"10","008","00","002","0000","0000","36277","29122","7155","2927","39204","68763","80408","57.01","42.35"
"10","008","00","002","0201","0000","1463","1156","307","130","1593","2676","0","59.53","43.2"
"10","008","00","002","0201","0085","456","362","94","45","501","828","0","60.51","43.72"
"10","008","00","002","0201","0086","445","343","102","40","485","786","0","61.7","43.64"
"10","008","00","002","0201","0087","562","451","111","45","607","1062","0","57.16","42.47"
"10","008","00","002","0202","0000","501","399","102","45","546","838","0","65.16","47.61"
"10","008","00","002","0202","0105","501","399","102","45","546","838","0","65.16","47.61"
"10","008","00","002","0203","0000","1577","1269","308","124","1701","3107","0","54.75","40.84"
"10","008","00","002","0203","0102","464","367","97","21","485","901","0","53.83","40.73"
"10","008","00","002","0203","0103","480","396","84","58","538","997","0","53.96","39.72"
"10","008","00","002","0203","0104","633","506","127","45","678","1209","0","56.08","41.85"
"10","008","00","002","0204","0000","1284","1036","248","113","1397","2489","0","56.13","41.62"
"10","008","00","002","0204","0106","561","450","111","50","611","1226","0","49.84","36.7"
"10","008","00","002","0204","0107","723","586","137","63","786","1263","0","62.23","46.4"
"10","008","00","002","0205","0000","1123","895","228","85","1208","2233","0","54.1","40.08"
"10","008","00","002","0205","0121","585","458","127","45","630","1133","0","55.6","40.42"
"10","008","00","002","0205","0122","538","437","101","40","578","1100","0","52.55","39.73"
"10","008","00","002","0206","0000","618","476","142","46","664","1023","0","64.91","46.53"
"10","008","00","002","0206","0126","618","476","142","46","664","1023","0","64.91","46.53"
"10","008","00","002","0207","0000","1884","1512","372","174","2058","3705","0","55.55","40.81"
"10","008","00","002","0207","0123","631","512","119","56","687","1155","0","59.48","44.33"
"10","008","00","002","0207","0124","615","485","130","58","673","1254","0","53.67","38.68"
"10","008","00","002","0207","0125","638","515","123","60","698","1296","0","53.86","39.74"
"10","008","00","002","0208","0000","3135","2528","607","194","3329","5777","0","57.63","43.76"
"10","008","00","002","0208","0127","443","375","68","18","461","964","0","47.82","38.9"
"10","008","00","002","0208","0128","535","437","98","33","568","986","0","57.61","44.32"
"10","008","00","002","0208","0129","589","483","106","28","617","1016","0","60.73","47.54"
"10","008","00","002","0208","0130","486","368","118","46","532","898","0","59.24","40.98"
"10","008","00","002","0208","0131","551","440","111","42","593","980","0","60.51","44.9"
"10","008","00","002","0208","0132","531","425","106","27","558","933","0","59.81","45.55"
"10","008","00","002","0209","0000","596","445","151","54","650","929","0","69.97","47.9"
"10","008","00","002","0209","0133","596","445","151","54","650","929","0","69.97","47.9"
"10","008","00","002","0210","0000","3843","3098","745","278","4121","7458","0","55.26","41.54"
"10","008","00","002","0210","0090","685","556","129","30","715","1282","0","55.77","43.37"
"10","008","00","002","0210","0091","454","374","80","46","500","859","0","58.21","43.54"
"10","008","00","002","0210","0092","670","531","139","74","744","1288","0","57.76","41.23"
"10","008","00","002","0210","0093","726","585","141","32","758","1330","0","56.99","43.98"
"10","008","00","002","0210","0094","708","577","131","58","766","1416","0","54.1","40.75"
"10","008","00","002","0210","0095","600","475","125","38","638","1283","0","49.73","37.02"
"10","008","00","002","0211","0000","1899","1570","329","193","2092","3815","0","54.84","41.15"
"10","008","00","002","0211","0096","520","484","36","80","600","1151","0","52.13","42.05"
"10","008","00","002","0211","0097","595","468","127","39","634","1193","0","53.14","39.23"
"10","008","00","002","0211","0098","784","618","166","74","858","1471","0","58.33","42.01"
"10","008","00","002","0212","0000","463","374","89","70","533","1044","0","51.05","35.82"
"10","008","00","002","0212","0099","463","374","89","70","533","1044","0","51.05","35.82"
"10","008","00","002","0213","0000","606","481","125","64","670","1122","0","59.71","42.87"
"10","008","00","002","0213","0100","606","481","125","64","670","1122","0","59.71","42.87"
"10","008","00","002","0214","0000","677","550","127","48","725","1129","0","64.22","48.72"
"10","008","00","002","0214","0101","677","550","127","48","725","1129","0","64.22","48.72"
"10","008","00","002","0215","0000","523","418","105","66","589","1032","0","57.07","40.5"
"10","008","00","002","0215","0134","523","418","105","66","589","1032","0","57.07","40.5"
"10","008","00","002","0216","0000","138","113","25","9","147","315","0","46.67","35.87"
"10","008","00","002","0216","0135","138","113","25","9","147","315","0","46.67","35.87"
"10","008","00","002","0217","0000","651","503","148","62","713","1363","0","52.31","36.9"
"10","008","00","002","0217","0136","651","503","148","62","713","1363","0","52.31","36.9"
"10","008","00","002","0218","0000","800","600","200","67","867","1430","0","60.63","41.96"
"10","008","00","002","0218","0137","401","313","88","38","439","725","0","60.55","43.17"
"10","008","00","002","0218","0138","399","287","112","29","428","705","0","60.71","40.71"
"10","008","00","002","0219","0000","945","752","193","77","1022","1683","0","60.72","44.68"
"10","008","00","002","0219","0139","455","350","105","33","488","751","0","64.98","46.6"
"10","008","00","002","0219","0140","490","402","88","44","534","932","0","57.3","43.13"
"10","008","00","002","0220","0000","725","568","157","50","775","1332","0","58.18","42.64"
"10","008","00","002","0220","0141","530","412","118","37","567","956","0","59.31","43.1"
"10","008","00","002","0220","0142","195","156","39","13","208","376","0","55.32","41.49"
"10","008","00","002","0221","0000","369","284","85","38","407","682","0","59.68","41.64"
"10","008","00","002","0221","0143","369","284","85","38","407","682","0","59.68","41.64"
"10","008","00","002","0222","0000","590","534","56","55","645","990","0","65.15","53.94"
"10","008","00","002","0222","0144","590","534","56","55","645","990","0","65.15","53.94"
"10","008","00","002","0223","0000","575","473","102","76","651","1170","0","55.64","40.43"
"10","008","00","002","0223","0147","575","473","102","76","651","1170","0","55.64","40.43"
"10","008","00","002","0224","0000","332","258","74","22","354","604","0","58.61","42.72"
"10","008","00","002","0224","0148","332","258","74","22","354","604","0","58.61","42.72"
"10","008","00","002","0225","0000","508","387","121","47","555","999","0","55.56","38.74"
"10","008","00","002","0225","0149","508","387","121","47","555","999","0","55.56","38.74"
"10","008","00","002","0226","0000","1405","1127","278","93","1498","2791","0","53.67","40.38"
"10","008","00","002","0226","0150","422","344","78","25","447","923","0","48.43","37.27"
"10","008","00","002","0226","0151","506","403","103","31","537","887","0","60.54","45.43"
"10","008","00","002","0226","0152","477","380","97","37","514","981","0","52.4","38.74"
"10","008","00","002","0227","0000","882","697","185","78","960","1630","0","58.9","42.76"
"10","008","00","002","0227","0116","380","281","99","48","428","725","0","59.03","38.76"
"10","008","00","002","0227","0117","502","416","86","30","532","905","0","58.78","45.97"
"10","008","00","002","0228","0000","1278","1017","261","117","1395","2588","0","53.9","39.3"
"10","008","00","002","0228","0118","584","455","129","51","635","1179","0","53.86","38.59"
"10","008","00","002","0228","0119","454","367","87","37","491","944","0","52.01","38.88"
"10","008","00","002","0228","0120","240","195","45","29","269","465","0","57.85","41.94"
"10","008","00","002","0229","0000","720","576","144","94","814","1622","0","50.18","35.51"
"10","008","00","002","0229","0145","591","486","105","79","670","1324","0","50.6","36.71"
"10","008","00","002","0229","0146","129","90","39","15","144","298","0","48.32","30.2"
"10","008","00","002","0230","0000","1880","1544","336","126","2006","3227","0","62.16","47.85"
"10","008","00","002","0230","0108","609","509","100","29","638","1045","0","61.05","48.71"
"10","008","00","002","0230","0109","632","518","114","45","677","1120","0","60.45","46.25"
"10","008","00","002","0230","0110","639","517","122","52","691","1062","0","65.07","48.68"
"10","008","00","002","0231","0000","1406","1121","285","73","1479","2616","0","56.54","42.85"
"10","008","00","002","0231","0088","677","532","145","41","718","1201","0","59.78","44.3"
"10","008","00","002","0231","0089","729","589","140","32","761","1415","0","53.78","41.63"
"10","008","00","002","0232","0000","1698","1386","312","100","1798","3179","0","56.56","43.6"
"10","008","00","002","0232","0111","549","443","106","36","585","1022","0","57.24","43.35"
"10","008","00","002","0232","0112","570","468","102","26","596","1051","0","56.71","44.53"
"10","008","00","002","0232","0113","579","475","104","38","617","1106","0","55.79","42.95"
"10","008","00","002","0233","0000","1183","975","208","59","1242","2165","0","57.37","45.03"
"10","008","00","002","0233","0114","581","471","110","28","609","1098","0","55.46","42.9"
"10","008","00","002","0233","0115","602","504","98","31","633","1067","0","59.33","47.24"
"10","008","00","003","0000","0000","44717","35644","9073","2943","47660","82922","97223","57.48","42.98"
"10","008","00","003","0301","0000","1180","973","207","50","1230","2125","0","57.88","45.79"
"10","008","00","003","0301","0153","583","482","101","24","607","998","0","60.82","48.3"
"10","008","00","003","0301","0154","597","491","106","26","623","1127","0","55.28","43.57"
"10","008","00","003","0302","0000","1112","873","239","82","1194","2077","0","57.49","42.03"
"10","008","00","003","0302","0158","500","399","101","34","534","936","0","57.05","42.63"
"10","008","00","003","0302","0159","612","474","138","48","660","1141","0","57.84","41.54"
"10","008","00","003","0303","0000","641","484","157","26","667","1121","0","59.5","43.18"
"10","008","00","003","0303","0161","641","484","157","26","667","1121","0","59.5","43.18"
"10","008","00","003","0304","0000","3537","2844","693","256","3793","6455","0","58.76","44.06"
"10","008","00","003","0304","0164","650","514","136","48","698","1267","0","55.09","40.57"
"10","008","00","003","0304","0165","650","563","87","71","721","1214","0","59.39","46.38"
"10","008","00","003","0304","0166","681","529","152","63","744","1259","0","59.09","42.02"
"10","008","00","003","0304","0167","840","666","174","29","869","1442","0","60.26","46.19"
"10","008","00","003","0304","0168","716","572","144","45","761","1273","0","59.78","44.93"
"10","008","00","003","0305","0000","4217","3485","732","218","4435","7422","0","59.75","46.95"
"10","008","00","003","0305","0169","617","499","118","35","652","1145","0","56.94","43.58"
"10","008","00","003","0305","0170","687","557","130","33","720","1279","0","56.29","43.55"
"10","008","00","003","0305","0171","617","514","103","24","641","1158","0","55.35","44.39"
"10","008","00","003","0305","0172","828","715","113","53","881","1335","0","65.99","53.56"
"10","008","00","003","0305","0173","724","592","132","35","759","1178","0","64.43","50.25"
"10","008","00","003","0305","0174","744","608","136","38","782","1327","0","58.93","45.82"
"10","008","00","003","0306","0000","3441","2703","738","201","3642","6403","0","56.88","42.21"
"10","008","00","003","0306","0208","770","596","174","53","823","1466","0","56.14","40.65"
"10","008","00","003","0306","0209","630","494","136","44","674","1180","0","57.12","41.86"
"10","008","00","003","0306","0210","597","473","124","18","615","1006","0","61.13","47.02"
"10","008","00","003","0306","0211","468","368","100","37","505","1000","0","50.5","36.8"
"10","008","00","003","0306","0212","653","518","135","35","688","1128","0","60.99","45.92"
"10","008","00","003","0306","0213","323","254","69","14","337","623","0","54.09","40.77"
"10","008","00","003","0307","0000","2928","2322","606","175","3103","6046","0","51.32","38.41"
"10","008","00","003","0307","0190","636","515","121","20","656","1395","0","47.03","36.92"
"10","008","00","003","0307","0191","642","512","130","40","682","1101","0","61.94","46.5"
"10","008","00","003","0307","0192","663","521","142","34","697","1297","0","53.74","40.17"
"10","008","00","003","0307","0193","367","287","80","25","392","877","0","44.7","32.73"
"10","008","00","003","0307","0194","620","487","133","56","676","1376","0","49.13","35.39"
"10","008","00","003","0308","0000","2307","1825","482","185","2492","4066","0","61.29","44.88"
"10","008","00","003","0308","0195","608","493","115","43","651","1008","0","64.58","48.91"
"10","008","00","003","0308","0196","627","506","121","40","667","1080","0","61.76","46.85"
"10","008","00","003","0308","0197","504","393","111","58","562","1017","0","55.26","38.64"
"10","008","00","003","0308","0198","568","433","135","44","612","961","0","63.68","45.06"
"10","008","00","003","0309","0000","2239","1775","464","129","2368","4392","0","53.92","40.41"
"10","008","00","003","0309","0181","493","387","106","30","523","1048","0","49.9","36.93"
"10","008","00","003","0309","0182","534","427","107","39","573","1009","0","56.79","42.32"
"10","008","00","003","0309","0183","585","495","90","22","607","1138","0","53.34","43.5"
"10","008","00","003","0309","0184","627","466","161","38","665","1197","0","55.56","38.93"
"10","008","00","003","0310","0000","1342","1070","272","84","1426","2423","0","58.85","44.16"
"10","008","00","003","0310","0185","767","620","147","40","807","1364","0","59.16","45.45"
"10","008","00","003","0310","0186","575","450","125","44","619","1059","0","58.45","42.49"
"10","008","00","003","0311","0000","1594","1285","309","128","1722","2944","0","58.49","43.65"
"10","008","00","003","0311","0187","608","495","113","48","656","1108","0","59.21","44.68"
"10","008","00","003","0311","0188","471","375","96","31","502","879","0","57.11","42.66"
"10","008","00","003","0311","0189","515","415","100","49","564","957","0","58.93","43.36"
"10","008","00","003","0312","0000","1763","1464","299","86","1849","3143","0","58.83","46.58"
"10","008","00","003","0312","0178","593","481","112","29","622","1121","0","55.49","42.91"
"10","008","00","003","0312","0179","585","494","91","36","621","1043","0","59.54","47.36"
"10","008","00","003","0312","0180","585","489","96","21","606","979","0","61.9","49.95"
"10","008","00","003","0313","0000","1914","1523","391","136","2050","3524","0","58.17","43.22"
"10","008","00","003","0313","0199","651","510","141","57","708","1160","0","61.03","43.97"
"10","008","00","003","0313","0200","602","495","107","40","642","1121","0","57.27","44.16"
"10","008","00","003","0313","0201","661","518","143","39","700","1243","0","56.32","41.67"
"10","008","00","003","0314","0000","1554","1185","369","118","1672","2919","0","57.28","40.6"
"10","008","00","003","0314","0205","514","389","125","55","569","923","0","61.65","42.15"
"10","008","00","003","0314","0206","499","375","124","36","535","970","0","55.15","38.66"
"10","008","00","003","0314","0207","541","421","120","27","568","1026","0","55.36","41.03"
"10","008","00","003","0315","0000","724","565","159","44","768","1518","0","50.59","37.22"
"10","008","00","003","0315","0204","724","565","159","44","768","1518","0","50.59","37.22"
"10","008","00","003","0316","0000","1319","1012","307","83","1402","2255","0","62.17","44.88"
"10","008","00","003","0316","0202","519","404","115","25","544","932","0","58.37","43.35"
"10","008","00","003","0316","0203","800","608","192","58","858","1323","0","64.85","45.96"
"10","008","00","003","0317","0000","956","741","215","111","1067","1953","0","54.63","37.94"
"10","008","00","003","0317","0214","369","265","104","52","421","707","0","59.55","37.48"
"10","008","00","003","0317","0215","355","288","67","33","388","719","0","53.96","40.06"
"10","008","00","003","0317","0216","232","188","44","26","258","527","0","48.96","35.67"
"10","008","00","003","0318","0000","1138","901","237","87","1225","2052","0","59.7","43.91"
"10","008","00","003","0318","0217","642","514","128","51","693","1183","0","58.58","43.45"
"10","008","00","003","0318","0218","496","387","109","36","532","869","0","61.22","44.53"
"10","008","00","003","0319","0000","2128","1678","450","146","2274","4114","0","55.27","40.79"
"10","008","00","003","0319","0219","532","403","129","24","556","1132","0","49.12","35.6"
"10","008","00","003","0319","0220","514","399","115","50","564","949","0","59.43","42.04"
"10","008","00","003","0319","0221","554","455","99","36","590","965","0","61.14","47.15"
"10","008","00","003","0319","0222","528","421","107","36","564","1068","0","52.81","39.42"
"10","008","00","003","0320","0000","819","644","175","73","892","1659","0","53.77","38.82"
"10","008","00","003","0320","0224","325","261","64","27","352","642","0","54.83","40.65"
"10","008","00","003","0320","0225","494","383","111","46","540","1017","0","53.1","37.66"
"10","008","00","003","0321","0000","578","453","125","49","627","1024","0","61.23","44.24"
"10","008","00","003","0321","0223","578","453","125","49","627","1024","0","61.23","44.24"
"10","008","00","003","0322","0000","1200","945","255","121","1321","2276","0","58.04","41.52"
"10","008","00","003","0322","0227","595","458","137","61","656","1170","0","56.07","39.15"
"10","008","00","003","0322","0228","605","487","118","60","665","1106","0","60.13","44.03"
"10","008","00","003","0323","0000","584","480","104","39","623","1092","0","57.05","43.96"
"10","008","00","003","0323","0226","584","480","104","39","623","1092","0","57.05","43.96"
"10","008","00","003","0324","0000","418","335","83","27","445","705","0","63.12","47.52"
"10","008","00","003","0324","0160","418","335","83","27","445","705","0","63.12","47.52"
"10","008","00","003","0325","0000","1304","1046","258","92","1396","2278","0","61.28","45.92"
"10","008","00","003","0325","0162","543","426","117","38","581","877","0","66.25","48.57"
"10","008","00","003","0325","0163","761","620","141","54","815","1401","0","58.17","44.25"
"10","008","00","003","0326","0000","1996","1599","397","111","2107","3796","0","55.51","42.12"
"10","008","00","003","0326","0155","704","603","101","27","731","1401","0","52.18","43.04"
"10","008","00","003","0326","0156","580","428","152","35","615","1110","0","55.41","38.56"
"10","008","00","003","0326","0157","712","568","144","49","761","1285","0","59.22","44.2"
"10","008","00","003","0327","0000","1784","1434","350","86","1870","3140","0","59.55","45.67"
"10","008","00","003","0327","0175","568","429","139","23","591","1000","0","59.1","42.9"
"10","008","00","003","0327","0176","684","574","110","30","714","1257","0","56.8","45.66"
"10","008","00","003","0327","0177","532","431","101","33","565","883","0","63.99","48.81"
"10","008","00","004","0000","0000","23588","18660","4928","2221","25809","47034","54689","54.87","39.67"
"10","008","00","004","0401","0000","1132","876","256","104","1236","2020","0","61.19","43.37"
"10","008","00","004","0401","0229","647","515","132","57","704","1170","0","60.17","44.02"
"10","008","00","004","0401","0230","485","361","124","47","532","850","0","62.59","42.47"
"10","008","00","004","0402","0000","302","242","60","40","342","621","0","55.07","38.97"
"10","008","00","004","0402","0231","302","242","60","40","342","621","0","55.07","38.97"
"10","008","00","004","0403","0000","2257","1804","453","219","2476","4505","0","54.96","40.04"
"10","008","00","004","0403","0232","470","362","108","30","500","905","0","55.25","40.0"
"10","008","00","004","0403","0233","495","401","94","61","556","1099","0","50.59","36.49"
"10","008","00","004","0403","0234","579","466","113","64","643","1214","0","52.97","38.39"
"10","008","00","004","0403","0235","713","575","138","64","777","1287","0","60.37","44.68"
"10","008","00","004","0404","0000","1865","1487","378","172","2037","3587","0","56.79","41.46"
"10","008","00","004","0404","0236","608","480","128","67","675","1191","0","56.68","40.3"
"10","008","00","004","0404","0237","569","445","124","68","637","1118","0","56.98","39.8"
"10","008","00","004","0404","0238","688","562","126","37","725","1278","0","56.73","43.97"
"10","008","00","004","0405","0000","910","725","185","73","983","1715","0","57.32","42.27"
"10","008","00","004","0405","0270","437","338","99","52","489","793","0","61.66","42.62"
"10","008","00","004","0405","0271","473","387","86","21","494","922","0","53.58","41.97"
"10","008","00","004","0406","0000","634","530","104","48","682","1193","0","57.17","44.43"
"10","008","00","004","0406","0244","288","241","47","33","321","511","0","62.82","47.16"
"10","008","00","004","0406","0245","346","289","57","15","361","682","0","52.93","42.38"
"10","008","00","004","0407","0000","1856","1468","388","166","2022","3710","0","54.5","39.57"
"10","008","00","004","0407","0241","678","543","135","54","732","1308","0","55.96","41.51"
"10","008","00","004","0407","0242","666","519","147","52","718","1358","0","52.87","38.22"
"10","008","00","004","0407","0243","512","406","106","60","572","1044","0","54.79","38.89"
"10","008","00","004","0408","0000","461","335","126","25","486","989","0","49.14","33.87"
"10","008","00","004","0408","0246","461","335","126","25","486","989","0","49.14","33.87"
"10","008","00","004","0409","0000","707","553","154","43","750","1378","0","54.43","40.13"
"10","008","00","004","0409","0247","707","553","154","43","750","1378","0","54.43","40.13"
"10","008","00","004","0410","0000","385","326","59","33","418","875","0","47.77","37.26"
"10","008","00","004","0410","0272","171","141","30","23","194","366","0","53.01","38.52"
"10","008","00","004","0410","0273","214","185","29","10","224","509","0","44.01","36.35"
"10","008","00","004","0411","0000","1449","1159","290","101","1550","2882","0","53.78","40.22"
"10","008","00","004","0411","0260","716","562","154","49","765","1320","0","57.95","42.58"
"10","008","00","004","0411","0261","466","378","88","28","494","967","0","51.09","39.09"
"10","008","00","004","0411","0262","267","219","48","24","291","595","0","48.91","36.81"
"10","008","00","004","0412","0000","775","586","189","73","848","1729","0","49.05","33.89"
"10","008","00","004","0412","0258","403","321","82","25","428","908","0","47.14","35.35"
"10","008","00","004","0412","0259","372","265","107","48","420","821","0","51.16","32.28"
"10","008","00","004","0413","0000","401","301","100","71","472","859","0","54.95","35.04"
"10","008","00","004","0413","0263","401","301","100","71","472","859","0","54.95","35.04"
"10","008","00","004","0414","0000","2617","2070","547","214","2831","4873","0","58.1","42.48"
"10","008","00","004","0414","0251","740","587","153","70","810","1437","0","56.37","40.85"
"10","008","00","004","0414","0252","728","559","169","43","771","1286","0","59.95","43.47"
"10","008","00","004","0414","0253","596","478","118","61","657","1080","0","60.83","44.26"
"10","008","00","004","0414","0254","553","446","107","40","593","1070","0","55.42","41.68"
"10","008","00","004","0415","0000","915","737","178","101","1016","1845","0","55.07","39.95"
"10","008","00","004","0415","0264","582","472","110","65","647","1196","0","54.1","39.46"
"10","008","00","004","0415","0265","333","265","68","36","369","649","0","56.86","40.83"
"10","008","00","004","0416","0000","677","525","152","64","741","1341","0","55.26","39.15"
"10","008","00","004","0416","0266","677","525","152","64","741","1341","0","55.26","39.15"
"10","008","00","004","0417","0000","540","415","125","73","613","1222","0","50.16","33.96"
"10","008","00","004","0417","0267","540","415","125","73","613","1222","0","50.16","33.96"
"10","008","00","004","0418","0000","320","252","68","27","347","602","0","57.64","41.86"
"10","008","00","004","0418","0268","320","252","68","27","347","602","0","57.64","41.86"
"10","008","00","004","0419","0000","177","131","46","22","199","430","0","46.28","30.47"
"10","008","00","004","0419","0250","177","131","46","22","199","430","0","46.28","30.47"
"10","008","00","004","0420","0000","313","251","62","33","346","617","0","56.08","40.68"
"10","008","00","004","0420","0269","313","251","62","33","346","617","0","56.08","40.68"
"10","008","00","004","0421","0000","326","260","66","29","355","599","0","59.27","43.41"
"10","008","00","004","0421","0274","97","78","19","7","104","193","0","53.89","40.41"
"10","008","00","004","0421","0275","229","182","47","22","251","406","0","61.82","44.83"
"10","008","00","004","0422","0000","324","254","70","34","358","802","0","44.64","31.67"
"10","008","00","004","0422","0276","226","176","50","26","252","495","0","50.91","35.56"
"10","008","00","004","0422","0277","98","78","20","8","106","307","0","34.53","25.41"
"10","008","00","004","0423","0000","270","220","50","43","313","577","0","54.25","38.13"
"10","008","00","004","0423","0279","270","220","50","43","313","577","0","54.25","38.13"
"10","008","00","004","0424","0000","202","171","31","32","234","440","0","53.18","38.86"
"10","008","00","004","0424","0278","202","171","31","32","234","440","0","53.18","38.86"
"10","008","00","004","0425","0000","300","212","88","60","360","889","0","40.49","23.85"
"10","008","00","004","0425","0280","173","109","64","39","212","486","0","43.62","22.43"
"10","008","00","004","0425","0281","127","103","24","21","148","403","0","36.72","25.56"
"10","008","00","004","0426","0000","365","281","84","34","399","696","0","57.33","40.37"
"10","008","00","004","0426","0248","105","75","30","6","111","217","0","51.15","34.56"
"10","008","00","004","0426","0249","260","206","54","28","288","479","0","60.13","43.01"
"10","008","00","004","0427","0000","1907","1527","380","146","2053","3642","0","56.37","41.93"
"10","008","00","004","0427","0255","683","540","143","54","737","1295","0","56.91","41.7"
"10","008","00","004","0427","0256","560","443","117","32","592","1047","0","56.54","42.31"
"10","008","00","004","0427","0257","664","544","120","60","724","1300","0","55.69","41.85"
"10","008","00","004","0428","0000","1201","962","239","141","1342","2396","0","56.01","40.15"
"10","008","00","004","0428","0239","612","486","126","53","665","1153","0","57.68","42.15"
"10","008","00","004","0428","0240","589","476","113","88","677","1243","0","54.47","38.29"
"10","008","00","005","0000","0000","5007","3923","1084","526","5533","9611","10871","57.57","40.82"
"10","008","00","005","0501","0000","602","498","104","47","649","1070","0","60.65","46.54"
"10","008","00","005","0501","0282","602","498","104","47","649","1070","0","60.65","46.54"
"10","008","00","005","0502","0000","528","421","107","33","561","918","0","61.11","45.86"
"10","008","00","005","0502","0283","528","421","107","33","561","918","0","61.11","45.86"
"10","008","00","005","0503","0000","319","247","72","29","348","581","0","59.9","42.51"
"10","008","00","005","0503","0284","319","247","72","29","348","581","0","59.9","42.51"
"10","008","00","005","0504","0000","661","523","138","52","713","1194","0","59.72","43.8"
"10","008","00","005","0504","0285","661","523","138","52","713","1194","0","59.72","43.8"
"10","008","00","005","0505","0000","199","141","58","22","221","488","0","45.29","28.89"
"10","008","00","005","0505","0286","199","141","58","22","221","488","0","45.29","28.89"
"10","008","00","005","0506","0000","275","218","57","38","313","504","0","62.1","43.25"
"10","008","00","005","0506","0287","275","218","57","38","313","504","0","62.1","43.25"
"10","008","00","005","0507","0000","459","353","106","104","563","910","0","61.87","38.79"
"10","008","00","005","0507","0288","459","353","106","104","563","910","0","61.87","38.79"
"10","008","00","005","0508","0000","784","607","177","101","885","1482","0","59.72","40.96"
"10","008","00","005","0508","0289","420","332","88","63","483","773","0","62.48","42.95"
"10","008","00","005","0508","0290","364","275","89","38","402","709","0","56.7","38.79"
"10","008","00","005","0509","0000","505","380","125","28","533","960","0","55.52","39.58"
"10","008","00","005","0509","0291","505","380","125","28","533","960","0","55.52","39.58"
"10","008","00","005","0510","0000","238","187","51","23","261","582","0","44.85","32.13"
"10","008","00","005","0510","0294","238","187","51","23","261","582","0","44.85","32.13"
"10","008","00","005","0511","0000","437","348","89","49","486","922","0","52.71","37.74"
"10","008","00","005","0511","0292","254","193","61","21","275","503","0","54.67","38.37"
"10","008","00","005","0511","0293","183","155","28","28","211","419","0","50.36","36.99"
"10","008","00","006","0000","0000","18080","14150","3930","1870","19950","33408","38376","59.72","42.36"
"10","008","00","006","0601","0000","660","502","158","70","730","1050","0","69.52","47.81"
"10","008","00","006","0601","0295","660","502","158","70","730","1050","0","69.52","47.81"
"10","008","00","006","0602","0000","1939","1533","406","161","2100","3405","0","61.67","45.02"
"10","008","00","006","0602","0296","499","396","103","55","554","920","0","60.22","43.04"
"10","008","00","006","0602","0297","442","340","102","32","474","727","0","65.2","46.77"
"10","008","00","006","0602","0298","513","420","93","39","552","861","0","64.11","48.78"
"10","008","00","006","0602","0299","485","377","108","35","520","897","0","57.97","42.03"
"10","008","00","006","0603","0000","1230","974","256","117","1347","2239","0","60.16","43.5"
"10","008","00","006","0603","0300","601","472","129","47","648","1055","0","61.42","44.74"
"10","008","00","006","0603","0301","629","502","127","70","699","1184","0","59.04","42.4"
"10","008","00","006","0604","0000","847","651","196","85","932","1564","0","59.59","41.62"
"10","008","00","006","0604","0302","407","302","105","39","446","783","0","56.96","38.57"
"10","008","00","006","0604","0303","440","349","91","46","486","781","0","62.23","44.69"
"10","008","00","006","0605","0000","498","396","102","63","561","1015","0","55.27","39.01"
"10","008","00","006","0605","0305","498","396","102","63","561","1015","0","55.27","39.01"
"10","008","00","006","0606","0000","491","399","92","42","533","977","0","54.55","40.84"
"10","008","00","006","0606","0304","491","399","92","42","533","977","0","54.55","40.84"
"10","008","00","006","0607","0000","2321","1853","468","167","2488","4234","0","58.76","43.76"
"10","008","00","006","0607","0306","511","416","95","37","548","914","0","59.96","45.51"
"10","008","00","006","0607","0307","560","446","114","18","578","1028","0","56.23","43.39"
"10","008","00","006","0607","0308","576","471","105","37","613","1018","0","60.22","46.27"
"10","008","00","006","0607","0309","674","520","154","75","749","1274","0","58.79","40.82"
"10","008","00","006","0608","0000","958","731","227","86","1044","1650","0","63.27","44.3"
"10","008","00","006","0608","0310","412","309","103","40","452","755","0","59.87","40.93"
"10","008","00","006","0608","0311","546","422","124","46","592","895","0","66.15","47.15"
"10","008","00","006","0609","0000","495","360","135","57","552","951","0","58.04","37.85"
"10","008","00","006","0609","0313","495","360","135","57","552","951","0","58.04","37.85"
"10","008","00","006","0610","0000","662","515","147","62","724","1261","0","57.41","40.84"
"10","008","00","006","0610","0314","662","515","147","62","724","1261","0","57.41","40.84"
"10","008","00","006","0611","0000","973","749","224","144","1117","1829","0","61.07","40.95"
"10","008","00","006","0611","0316","517","390","127","68","585","962","0","60.81","40.54"
"10","008","00","006","0611","0317","456","359","97","76","532","867","0","61.36","41.41"
"10","008","00","006","0612","0000","505","400","105","57","562","930","0","60.43","43.01"
"10","008","00","006","0612","0318","505","400","105","57","562","930","0","60.43","43.01"
"10","008","00","006","0613","0000","398","297","101","44","442","768","0","57.55","38.67"
"10","008","00","006","0613","0315","398","297","101","44","442","768","0","57.55","38.67"
"10","008","00","006","0614","0000","495","385","110","60","555","931","0","59.61","41.35"
"10","008","00","006","0614","0321","495","385","110","60","555","931","0","59.61","41.35"
"10","008","00","006","0615","0000","579","430","149","89","668","1171","0","57.05","36.72"
"10","008","00","006","0615","0319","329","247","82","59","388","641","0","60.53","38.53"
"10","008","00","006","0615","0320","250","183","67","30","280","530","0","52.83","34.53"
"10","008","00","006","0616","0000","857","669","188","108","965","1570","0","61.46","42.61"
"10","008","00","006","0616","0322","608","480","128","63","671","1127","0","59.54","42.59"
"10","008","00","006","0616","0323","249","189","60","45","294","443","0","66.37","42.66"
"10","008","00","006","0617","0000","821","626","195","101","922","1491","0","61.84","41.99"
"10","008","00","006","0617","0324","485","379","106","47","532","870","0","61.15","43.56"
"10","008","00","006","0617","0325","336","247","89","54","390","621","0","62.8","39.77"
"10","008","00","006","0618","0000","556","413","143","45","601","1179","0","50.98","35.03"
"10","008","00","006","0618","0326","556","413","143","45","601","1179","0","50.98","35.03"
"10","008","00","006","0619","0000","531","418","113","65","596","876","0","68.04","47.72"
"10","008","00","006","0619","0328","531","418","113","65","596","876","0","68.04","47.72"
"10","008","00","006","0620","0000","495","406","89","61","556","881","0","63.11","46.08"
"10","008","00","006","0620","0327","495","406","89","61","556","881","0","63.11","46.08"
"10","008","00","006","0621","0000","417","339","78","57","474","783","0","60.54","43.3"
"10","008","00","006","0621","0329","417","339","78","57","474","783","0","60.54","43.3"
"10","008","00","006","0622","0000","860","685","175","98","958","1761","0","54.4","38.9"
"10","008","00","006","0622","0330","373","298","75","46","419","778","0","53.86","38.3"
"10","008","00","006","0622","0331","487","387","100","52","539","983","0","54.83","39.37"
"10","008","00","006","0623","0000","492","419","73","31","523","892","0","58.63","46.97"
"10","008","00","006","0623","0312","492","419","73","31","523","892","0","58.63","46.97"
"10","008","00","007","0000","0000","7778","6158","1620","737","8515","15941","17698","53.42","38.63"
"10","008","00","007","0701","0000","930","737","193","90","1020","1874","0","54.43","39.33"
"10","008","00","007","0701","0332","442","355","87","41","483","934","0","51.71","38.01"
"10","008","00","007","0701","0333","488","382","106","49","537","940","0","57.13","40.64"
"10","008","00","007","0702","0000","657","533","124","54","711","1430","0","49.72","37.27"
"10","008","00","007","0702","0348","346","278","68","29","375","713","0","52.59","38.99"
"10","008","00","007","0702","0349","311","255","56","25","336","717","0","46.86","35.56"
"10","008","00","007","0703","0000","593","461","132","63","656","1303","0","50.35","35.38"
"10","008","00","007","0703","0334","425","327","98","30","455","852","0","53.4","38.38"
"10","008","00","007","0703","0335","168","134","34","33","201","451","0","44.57","29.71"
"10","008","00","007","0704","0000","1114","903","211","87","1201","1952","0","61.53","46.26"
"10","008","00","007","0704","0336","459","377","82","30","489","810","0","60.37","46.54"
"10","008","00","007","0704","0337","655","526","129","57","712","1142","0","62.35","46.06"
"10","008","00","007","0705","0000","519","404","115","54","573","1045","0","54.83","38.66"
"10","008","00","007","0705","0342","267","204","63","27","294","578","0","50.87","35.29"
"10","008","00","007","0705","0343","252","200","52","27","279","467","0","59.74","42.83"
"10","008","00","007","0706","0000","742","570","172","72","814","1507","0","54.01","37.82"
"10","008","00","007","0706","0345","353","271","82","28","381","740","0","51.49","36.62"
"10","008","00","007","0706","0346","389","299","90","44","433","767","0","56.45","38.98"
"10","008","00","007","0707","0000","487","398","89","42","529","909","0","58.2","43.78"
"10","008","00","007","0707","0347","487","398","89","42","529","909","0","58.2","43.78"
"10","008","00","007","0708","0000","315","255","60","31","346","622","0","55.63","41.0"
"10","008","00","007","0708","0344","315","255","60","31","346","622","0","55.63","41.0"
"10","008","00","007","0709","0000","663","510","153","73","736","1392","0","52.87","36.64"
"10","008","00","007","0709","0340","417","319","98","43","460","811","0","56.72","39.33"
"10","008","00","007","0709","0341","246","191","55","30","276","581","0","47.5","32.87"
"10","008","00","007","0710","0000","801","649","152","77","878","1650","0","53.21","39.33"
"10","008","00","007","0710","0338","332","279","53","29","361","766","0","47.13","36.42"
"10","008","00","007","0710","0339","469","370","99","48","517","884","0","58.48","41.86"
"10","008","00","007","0711","0000","364","278","86","36","400","794","0","50.38","35.01"
"10","008","00","007","0711","0350","364","278","86","36","400","794","0","50.38","35.01"
"10","008","00","007","0712","0000","312","239","73","24","336","726","0","46.28","32.92"
"10","008","00","007","0712","0351","312","239","73","24","336","726","0","46.28","32.92"
"10","008","00","007","0713","0000","281","221","60","34","315","737","0","42.74","29.99"
"10","008","00","007","0713","0352","281","221","60","34","315","737","0","42.74","29.99"
"10","008","00","008","0000","0000","6879","5406","1473","735","7614","13181","14734","57.76","41.01"
"10","008","00","008","0801","0000","448","347","101","59","507","822","0","61.68","42.21"
"10","008","00","008","0801","0353","448","347","101","59","507","822","0","61.68","42.21"
"10","008","00","008","0802","0000","233","178","55","16","249","474","0","52.53","37.55"
"10","008","00","008","0802","0354","145","109","36","10","155","253","0","61.26","43.08"
"10","008","00","008","0802","0355","88","69","19","6","94","221","0","42.53","31.22"
"10","008","00","008","0803","0000","358","293","65","36","394","780","0","50.51","37.56"
"10","008","00","008","0803","0356","151","126","25","6","157","353","0","44.48","35.69"
"10","008","00","008","0803","0357","207","167","40","30","237","427","0","55.5","39.11"
"10","008","00","008","0804","0000","366","286","80","35","401","661","0","60.67","43.27"
"10","008","00","008","0804","0360","366","286","80","35","401","661","0","60.67","43.27"
"10","008","00","008","0805","0000","348","265","83","38","386","713","0","54.14","37.17"
"10","008","00","008","0805","0358","205","156","49","22","227","406","0","55.91","38.42"
"10","008","00","008","0805","0359","143","109","34","16","159","307","0","51.79","35.5"
"10","008","00","008","0806","0000","962","742","220","67","1029","1727","0","59.58","42.96"
"10","008","00","008","0806","0362","537","409","128","36","573","973","0","58.89","42.03"
"10","008","00","008","0806","0363","425","333","92","31","456","754","0","60.48","44.16"
"10","008","00","008","0807","0000","169","130","39","24","193","290","0","66.55","44.83"
"10","008","00","008","0807","0361","169","130","39","24","193","290","0","66.55","44.83"
"10","008","00","008","0808","0000","337","263","74","31","368","662","0","55.59","39.73"
"10","008","00","008","0808","0364","337","263","74","31","368","662","0","55.59","39.73"
"10","008","00","008","0809","0000","217","177","40","12","229","490","0","46.73","36.12"
"10","008","00","008","0809","0365","217","177","40","12","229","490","0","46.73","36.12"
"10","008","00","008","0810","0000","688","558","130","63","751","1325","0","56.68","42.11"
"10","008","00","008","0810","0366","155","122","33","20","175","335","0","52.24","36.42"
"10","008","00","008","0810","0367","533","436","97","43","576","990","0","58.18","44.04"
"10","008","00","008","0811","0000","617","475","142","55","672","1075","0","62.51","44.19"
"10","008","00","008","0811","0368","268","212","56","24","292","461","0","63.34","45.99"
"10","008","00","008","0811","0369","349","263","86","31","380","614","0","61.89","42.83"
"10","008","00","008","0812","0000","442","341","101","76","518","895","0","57.88","38.1"
"10","008","00","008","0812","0370","442","341","101","76","518","895","0","57.88","38.1"
"10","008","00","008","0813","0000","352","286","66","50","402","682","0","58.94","41.94"
"10","008","00","008","0813","0372","352","286","66","50","402","682","0","58.94","41.94"
"10","008","00","008","0814","0000","346","277","69","49","395","643","0","61.43","43.08"
"10","008","00","008","0814","0374","346","277","69","49","395","643","0","61.43","43.08"
"10","008","00","008","0815","0000","235","183","52","32","267","528","0","50.57","34.66"
"10","008","00","008","0815","0376","235","183","52","32","267","528","0","50.57","34.66"
"10","008","00","008","0816","0000","229","177","52","37","266","465","0","57.2","38.06"
"10","008","00","008","0816","0371","229","177","52","37","266","465","0","57.2","38.06"
"10","008","00","008","0817","0000","265","218","47","19","284","459","0","61.87","47.49"
"10","008","00","008","0817","0375","265","218","47","19","284","459","0","61.87","47.49"
"10","008","00","008","0818","0000","267","210","57","36","303","490","0","61.84","42.86"
"10","008","00","008","0818","0373","267","210","57","36","303","490","0","61.84","42.86"
"10","008","00","009","0000","0000","6926","5432","1494","632","7558","13958","15823","54.15","38.92"
"10","008","00","009","0901","0000","820","654","166","73","893","1580","0","56.52","41.39"
"10","008","00","009","0901","0379","353","275","78","33","386","720","0","53.61","38.19"
"10","008","00","009","0901","0380","467","379","88","40","507","860","0","58.95","44.07"
"10","008","00","009","0902","0000","1076","848","228","102","1178","2020","0","58.32","41.98"
"10","008","00","009","0902","0377","486","377","109","46","532","922","0","57.7","40.89"
"10","008","00","009","0902","0378","590","471","119","56","646","1098","0","58.83","42.9"
"10","008","00","009","0903","0000","459","357","102","37","496","1017","0","48.77","35.1"
"10","008","00","009","0903","0394","251","202","49","21","272","578","0","47.06","34.95"
"10","008","00","009","0903","0395","208","155","53","16","224","439","0","51.03","35.31"
"10","008","00","009","0904","0000","690","526","164","58","748","1386","0","53.97","37.95"
"10","008","00","009","0904","0387","401","318","83","26","427","841","0","50.77","37.81"
"10","008","00","009","0904","0388","154","115","39","15","169","270","0","62.59","42.59"
"10","008","00","009","0904","0389","135","93","42","17","152","275","0","55.27","33.82"
"10","008","00","009","0905","0000","497","380","117","47","544","1088","0","50.0","34.93"
"10","008","00","009","0905","0381","226","162","64","36","262","514","0","50.97","31.52"
"10","008","00","009","0905","0382","271","218","53","11","282","574","0","49.13","37.98"
"10","008","00","009","0906","0000","612","473","139","59","671","1249","0","53.72","37.87"
"10","008","00","009","0906","0383","612","473","139","59","671","1249","0","53.72","37.87"
"10","008","00","009","0907","0000","520","392","128","52","572","992","0","57.66","39.52"
"10","008","00","009","0907","0384","175","144","31","17","192","293","0","65.53","49.15"
"10","008","00","009","0907","0385","249","176","73","29","278","513","0","54.19","34.31"
"10","008","00","009","0907","0386","96","72","24","6","102","186","0","54.84","38.71"
"10","008","00","009","0908","0000","295","224","71","20","315","674","0","46.74","33.23"
"10","008","00","009","0908","0390","121","85","36","8","129","282","0","45.74","30.14"
"10","008","00","009","0908","0391","174","139","35","12","186","392","0","47.45","35.46"
"10","008","00","009","0909","0000","356","285","71","43","399","732","0","54.51","38.93"
"10","008","00","009","0909","0392","271","213","58","32","303","556","0","54.5","38.31"
"10","008","00","009","0909","0393","85","72","13","11","96","176","0","54.55","40.91"
"10","008","00","009","0910","0000","465","387","78","27","492","844","0","58.29","45.85"
"10","008","00","009","0910","0396","465","387","78","27","492","844","0","58.29","45.85"
"10","008","00","009","0911","0000","458","363","95","37","495","942","0","52.55","38.54"
"10","008","00","009","0911","0398","178","149","29","12","190","405","0","46.91","36.79"
"10","008","00","009","0911","0399","280","214","66","25","305","537","0","56.8","39.85"
"10","008","00","009","0912","0000","250","205","45","38","288","566","0","50.88","36.22"
"10","008","00","009","0912","0400","164","134","30","20","184","335","0","54.93","40.0"
"10","008","00","009","0912","0401","86","71","15","18","104","231","0","45.02","30.74"
"10","008","00","009","0913","0000","428","338","90","39","467","868","0","53.8","38.94"
"10","008","00","009","0913","0397","428","338","90","39","467","868","0","53.8","38.94"
"10","008","00","010","0000","0000","8501","6677","1824","784","9285","16597","18699","55.94","40.23"
"10","008","00","010","1001","0000","932","760","172","83","1015","1700","0","59.71","44.71"
"10","008","00","010","1001","0402","540","440","100","60","600","964","0","62.24","45.64"
"10","008","00","010","1001","0403","392","320","72","23","415","736","0","56.39","43.48"
"10","008","00","010","1002","0000","942","777","165","69","1011","1765","0","57.28","44.02"
"10","008","00","010","1002","0404","423","343","80","54","477","801","0","59.55","42.82"
"10","008","00","010","1002","0405","519","434","85","15","534","964","0","55.39","45.02"
"10","008","00","010","1003","0000","348","283","65","37","385","686","0","56.12","41.25"
"10","008","00","010","1003","0406","348","283","65","37","385","686","0","56.12","41.25"
"10","008","00","010","1004","0000","885","674","211","76","961","1880","0","51.12","35.85"
"10","008","00","010","1004","0411","515","386","129","53","568","1012","0","56.13","38.14"
"10","008","00","010","1004","0412","370","288","82","23","393","868","0","45.28","33.18"
"10","008","00","010","1005","0000","664","548","116","76","740","1391","0","53.2","39.4"
"10","008","00","010","1005","0407","329","267","62","33","362","661","0","54.77","40.39"
"10","008","00","010","1005","0408","335","281","54","43","378","730","0","51.78","38.49"
"10","008","00","010","1006","0000","400","313","87","23","423","706","0","59.92","44.33"
"10","008","00","010","1006","0410","400","313","87","23","423","706","0","59.92","44.33"
"10","008","00","010","1007","0000","1008","843","165","89","1097","1855","0","59.14","45.44"
"10","008","00","010","1007","0413","530","452","78","32","562","918","0","61.22","49.24"
"10","008","00","010","1007","0414","478","391","87","57","535","937","0","57.1","41.73"
"10","008","00","010","1008","0000","402","309","93","51","453","815","0","55.58","37.91"
"10","008","00","010","1008","0415","402","309","93","51","453","815","0","55.58","37.91"
"10","008","00","010","1009","0000","636","356","280","44","680","1134","0","59.96","31.39"
"10","008","00","010","1009","0416","636","356","280","44","680","1134","0","59.96","31.39"
"10","008","00","010","1010","0000","772","620","152","69","841","1543","0","54.5","40.18"
"10","008","00","010","1010","0418","556","454","102","48","604","1095","0","55.16","41.46"
"10","008","00","010","1010","0419","216","166","50","21","237","448","0","52.9","37.05"
"10","008","00","010","1011","0000","793","643","150","74","867","1634","0","53.06","39.35"
"10","008","00","010","1011","0420","519","421","98","51","570","1064","0","53.57","39.57"
"10","008","00","010","1011","0421","274","222","52","23","297","570","0","52.11","38.95"
"10","008","00","010","1012","0000","344","275","69","34","378","714","0","52.94","38.52"
"10","008","00","010","1012","0417","344","275","69","34","378","714","0","52.94","38.52"
"10","008","00","010","1013","0000","375","276","99","59","434","774","0","56.07","35.66"
"10","008","00","010","1013","0409","375","276","99","59","434","774","0","56.07","35.66"
"10","008","00","011","0000","0000","7836","6143","1693","693","8529","15458","17582","55.18","39.74"
"10","008","00","011","1101","0000","390","312","78","32","422","757","0","55.75","41.22"
"10","008","00","011","1101","0422","390","312","78","32","422","757","0","55.75","41.22"
"10","008","00","011","1102","0000","273","221","52","9","282","480","0","58.75","46.04"
"10","008","00","011","1102","0427","273","221","52","9","282","480","0","58.75","46.04"
"10","008","00","011","1103","0000","807","597","210","85","892","1553","0","57.44","38.44"
"10","008","00","011","1103","0423","278","216","62","35","313","554","0","56.5","38.99"
"10","008","00","011","1103","0424","529","381","148","50","579","999","0","57.96","38.14"
"10","008","00","011","1104","0000","291","228","63","23","314","616","0","50.97","37.01"
"10","008","00","011","1104","0425","291","228","63","23","314","616","0","50.97","37.01"
"10","008","00","011","1105","0000","473","381","92","37","510","875","0","58.29","43.54"
"10","008","00","011","1105","0426","473","381","92","37","510","875","0","58.29","43.54"
"10","008","00","011","1106","0000","556","426","130","30","586","1004","0","58.37","42.43"
"10","008","00","011","1106","0430","556","426","130","30","586","1004","0","58.37","42.43"
"10","008","00","011","1107","0000","579","454","125","62","641","998","0","64.23","45.49"
"10","008","00","011","1107","0433","579","454","125","62","641","998","0","64.23","45.49"
"10","008","00","011","1108","0000","718","554","164","85","803","1389","0","57.81","39.88"
"10","008","00","011","1108","0434","375","284","91","64","439","800","0","54.88","35.5"
"10","008","00","011","1108","0435","343","270","73","21","364","589","0","61.8","45.84"
"10","008","00","011","1109","0000","589","472","117","44","633","1217","0","52.01","38.78"
"10","008","00","011","1109","0437","589","472","117","44","633","1217","0","52.01","38.78"
"10","008","00","011","1110","0000","215","173","42","30","245","450","0","54.44","38.44"
"10","008","00","011","1110","0428","215","173","42","30","245","450","0","54.44","38.44"
"10","008","00","011","1111","0000","311","244","67","43","354","643","0","55.05","37.95"
"10","008","00","011","1111","0429","311","244","67","43","354","643","0","55.05","37.95"
"10","008","00","011","1112","0000","71","60","11","1","72","205","0","35.12","29.27"
"10","008","00","011","1112","0438","71","60","11","1","72","205","0","35.12","29.27"
"10","008","00","011","1113","0000","181","148","33","28","209","330","0","63.33","44.85"
"10","008","00","011","1113","0439","181","148","33","28","209","330","0","63.33","44.85"
"10","008","00","011","1114","0000","528","418","110","33","561","1100","0","51.0","38.0"
"10","008","00","011","1114","0440","528","418","110","33","561","1100","0","51.0","38.0"
"10","008","00","011","1115","0000","414","326","88","58","472","887","0","53.21","36.75"
"10","008","00","011","1115","0436","414","326","88","58","472","887","0","53.21","36.75"
"10","008","00","011","1116","0000","123","96","27","4","127","318","0","39.94","30.19"
"10","008","00","011","1116","0442","123","96","27","4","127","318","0","39.94","30.19"
"10","008","00","011","1117","0000","396","304","92","53","449","818","0","54.89","37.16"
"10","008","00","011","1117","0443","396","304","92","53","449","818","0","54.89","37.16"
"10","008","00","011","1118","0000","88","70","18","3","91","275","0","33.09","25.45"
"10","008","00","011","1118","0441","88","70","18","3","91","275","0","33.09","25.45"
"10","008","00","011","1119","0000","833","659","174","33","866","1543","0","56.12","42.71"
"10","008","00","011","1119","0431","381","316","65","15","396","741","0","53.44","42.65"
"10","008","00","011","1119","0432","452","343","109","18","470","802","0","58.6","42.77"
"10","008","00","012","0000","0000","6425","4802","1623","1071","7496","13299","16281","56.37","36.11"
"10","008","00","012","1201","0000","568","432","136","192","760","1203","0","63.18","35.91"
"10","008","00","012","1201","0459","463","357","106","174","637","929","0","68.57","38.43"
"10","008","00","012","1201","0460","105","75","30","18","123","274","0","44.89","27.37"
"10","008","00","012","1202","0000","557","445","112","75","632","900","0","70.22","49.44"
"10","008","00","012","1202","0461","557","445","112","75","632","900","0","70.22","49.44"
"10","008","00","012","1203","0000","305","235","70","40","345","560","0","61.61","41.96"
"10","008","00","012","1203","0463","305","235","70","40","345","560","0","61.61","41.96"
"10","008","00","012","1204","0000","721","569","152","127","848","1530","0","55.42","37.19"
"10","008","00","012","1204","0444","576","448","128","105","681","1201","0","56.7","37.3"
"10","008","00","012","1204","0445","145","121","24","22","167","329","0","50.76","36.78"
"10","008","00","012","1205","0000","243","169","74","21","264","516","0","51.16","32.75"
"10","008","00","012","1205","0446","243","169","74","21","264","516","0","51.16","32.75"
"10","008","00","012","1206","0000","311","253","58","30","341","745","0","45.77","33.96"
"10","008","00","012","1206","0447","167","136","31","23","190","424","0","44.81","32.08"
"10","008","00","012","1206","0448","144","117","27","7","151","321","0","47.04","36.45"
"10","008","00","012","1207","0000","339","268","71","10","349","1376","0","25.36","19.48"
"10","008","00","012","1207","0451","339","268","71","10","349","1376","0","25.36","19.48"
"10","008","00","012","1208","0000","704","526","178","108","812","1509","0","53.81","34.86"
"10","008","00","012","1208","0452","395","307","88","26","421","979","0","43.0","31.36"
"10","008","00","012","1208","0453","309","219","90","82","391","530","0","73.77","41.32"
"10","008","00","012","1209","0000","667","552","115","74","741","1425","0","52.0","38.74"
"10","008","00","012","1209","0454","432","348","84","54","486","961","0","50.57","36.21"
"10","008","00","012","1209","0455","235","204","31","20","255","464","0","54.96","43.97"
"10","008","00","012","1210","0000","348","113","235","43","391","666","0","58.71","16.97"
"10","008","00","012","1210","0456","273","60","213","30","303","517","0","58.61","11.61"
"10","008","00","012","1210","0457","75","53","22","13","88","149","0","59.06","35.57"
"10","008","00","012","1211","0000","593","423","170","167","760","1020","0","74.51","41.47"
"10","008","00","012","1211","0458","593","423","170","167","760","1020","0","74.51","41.47"
"10","008","00","012","1212","0000","395","297","98","56","451","617","0","73.1","48.14"
"10","008","00","012","1212","0462","395","297","98","56","451","617","0","73.1","48.14"
"10","008","00","012","1213","0000","326","253","73","98","424","584","0","72.6","43.32"
"10","008","00","012","1213","0450","326","253","73","98","424","584","0","72.6","43.32"
"10","008","00","012","1214","0000","348","267","81","30","378","648","0","58.33","41.2"
"10","008","00","012","1214","0449","348","267","81","30","378","648","0","58.33","41.2"
"10","008","00","013","0000","0000","6132","4727","1405","519","6651","12589","15954","52.83","37.55"
"10","008","00","013","1301","0000","282","215","67","16","298","763","0","39.06","28.18"
"10","008","00","013","1301","0484","282","215","67","16","298","763","0","39.06","28.18"
"10","008","00","013","1302","0000","525","448","77","39","564","889","0","63.44","50.39"
"10","008","00","013","1302","0485","525","448","77","39","564","889","0","63.44","50.39"
"10","008","00","013","1303","0000","646","368","278","65","711","1119","0","63.54","32.89"
"10","008","00","013","1303","0486","392","311","81","47","439","672","0","65.33","46.28"
"10","008","00","013","1303","0487","254","57","197","18","272","447","0","60.85","12.75"
"10","008","00","013","1304","0000","287","239","48","15","302","409","0","73.84","58.44"
"10","008","00","013","1304","0488","287","239","48","15","302","409","0","73.84","58.44"
"10","008","00","013","1305","0000","345","273","72","36","381","509","0","74.85","53.63"
"10","008","00","013","1305","0477","345","273","72","36","381","509","0","74.85","53.63"
"10","008","00","013","1306","0000","407","335","72","33","440","769","0","57.22","43.56"
"10","008","00","013","1306","0474","223","184","39","24","247","384","0","64.32","47.92"
"10","008","00","013","1306","0475","57","45","12","5","62","121","0","51.24","37.19"
"10","008","00","013","1306","0476","127","106","21","4","131","264","0","49.62","40.15"
"10","008","00","013","1307","0000","156","116","40","5","161","597","0","26.97","19.43"
"10","008","00","013","1307","0473","156","116","40","5","161","597","0","26.97","19.43"
"10","008","00","013","1308","0000","509","390","119","51","560","1151","0","48.65","33.88"
"10","008","00","013","1308","0480","264","213","51","29","293","613","0","47.8","34.75"
"10","008","00","013","1308","0481","173","127","46","17","190","404","0","47.03","31.44"
"10","008","00","013","1308","0482","72","50","22","5","77","134","0","57.46","37.31"
"10","008","00","013","1309","0000","844","692","152","38","882","1665","0","52.97","41.56"
"10","008","00","013","1309","0466","384","320","64","17","401","900","0","44.56","35.56"
"10","008","00","013","1309","0467","284","223","61","14","298","460","0","64.78","48.48"
"10","008","00","013","1309","0468","176","149","27","7","183","305","0","60.0","48.85"
"10","008","00","013","1310","0000","629","486","143","39","668","1269","0","52.64","38.3"
"10","008","00","013","1310","0464","487","377","110","31","518","973","0","53.24","38.75"
"10","008","00","013","1310","0465","142","109","33","8","150","296","0","50.68","36.82"
"10","008","00","013","1311","0000","353","285","68","16","369","952","0","38.76","29.94"
"10","008","00","013","1311","0470","353","285","68","16","369","952","0","38.76","29.94"
"10","008","00","013","1312","0000","232","185","47","5","237","679","0","34.9","27.25"
"10","008","00","013","1312","0471","232","185","47","5","237","679","0","34.9","27.25"
"10","008","00","013","1313","0000","326","235","91","64","390","630","0","61.9","37.3"
"10","008","00","013","1313","0483","326","235","91","64","390","630","0","61.9","37.3"
"10","008","00","013","1314","0000","17","14","3","3","20","58","0","34.48","24.14"
"10","008","00","013","1314","0469","17","14","3","3","20","58","0","34.48","24.14"
"10","008","00","013","1315","0000","259","202","57","40","299","507","0","58.97","39.84"
"10","008","00","013","1315","0478","175","133","42","32","207","338","0","61.24","39.35"
"10","008","00","013","1315","0479","84","69","15","8","92","169","0","54.44","40.83"
"10","008","00","013","1316","0000","315","244","71","54","369","623","0","59.23","39.17"
"10","008","00","013","1316","0472","315","244","71","54","369","623","0","59.23","39.17"
"10","009","00","000","0000","0000","267344","205923","61421","29764","297108","584480","687195","50.83","35.23"
"10","009","00","001","0000","0000","47647","37857","9790","3219","50866","89761","108487","56.67","42.18"
"10","009","00","001","0101","0000","839","631","208","32","871","1415","0","61.55","44.59"
"10","009","00","001","0101","0431","839","631","208","32","871","1415","0","61.55","44.59"
"10","009","00","001","0102","0000","624","470","154","48","672","1101","0","61.04","42.69"
"10","009","00","001","0102","0432","624","470","154","48","672","1101","0","61.04","42.69"
"10","009","00","001","0103","0000","322","242","80","10","332","644","0","51.55","37.58"
"10","009","00","001","0103","0411","322","242","80","10","332","644","0","51.55","37.58"
"10","009","00","001","0104","0000","306","226","80","36","342","617","0","55.43","36.63"
"10","009","00","001","0104","0412","306","226","80","36","342","617","0","55.43","36.63"
"10","009","00","001","0105","0000","469","378","91","33","502","764","0","65.71","49.48"
"10","009","00","001","0105","0413","469","378","91","33","502","764","0","65.71","49.48"
"10","009","00","001","0106","0000","455","335","120","32","487","784","0","62.12","42.73"
"10","009","00","001","0106","0414","455","335","120","32","487","784","0","62.12","42.73"
"10","009","00","001","0107","0000","407","307","100","32","439","760","0","57.76","40.39"
"10","009","00","001","0107","0415","407","307","100","32","439","760","0","57.76","40.39"
"10","009","00","001","0108","0000","2536","2029","507","132","2668","4634","0","57.57","43.79"
"10","009","00","001","0108","0422","816","648","168","30","846","1529","0","55.33","42.38"
"10","009","00","001","0108","0423","739","614","125","44","783","1335","0","58.65","45.99"
"10","009","00","001","0108","0424","981","767","214","58","1039","1770","0","58.7","43.33"
"10","009","00","001","0109","0000","1593","1282","311","71","1664","3236","0","51.42","39.62"
"10","009","00","001","0109","0433","824","655","169","40","864","1648","0","52.43","39.75"
"10","009","00","001","0109","0434","769","627","142","31","800","1588","0","50.38","39.48"
"10","009","00","001","0110","0000","1634","1288","346","94","1728","2765","0","62.5","46.58"
"10","009","00","001","0110","0427","707","528","179","42","749","1193","0","62.78","44.26"
"10","009","00","001","0110","0428","927","760","167","52","979","1572","0","62.28","48.35"
"10","009","00","001","0111","0000","1003","788","215","62","1065","1747","0","60.96","45.11"
"10","009","00","001","0111","0449","1003","788","215","62","1065","1747","0","60.96","45.11"
"10","009","00","001","0112","0000","1854","1456","398","96","1950","3513","0","55.51","41.45"
"10","009","00","001","0112","0444","575","448","127","22","597","1097","0","54.42","40.84"
"10","009","00","001","0112","0445","684","552","132","34","718","1262","0","56.89","43.74"
"10","009","00","001","0112","0446","595","456","139","40","635","1154","0","55.03","39.51"
"10","009","00","001","0113","0000","2248","1787","461","121","2369","4188","0","56.57","42.67"
"10","009","00","001","0113","0439","820","669","151","46","866","1421","0","60.94","47.08"
"10","009","00","001","0113","0440","681","537","144","33","714","1261","0","56.62","42.59"
"10","009","00","001","0113","0441","747","581","166","42","789","1506","0","52.39","38.58"
"10","009","00","001","0114","0000","1076","851","225","75","1151","2329","0","49.42","36.54"
"10","009","00","001","0114","0437","525","433","92","31","556","1187","0","46.84","36.48"
"10","009","00","001","0114","0438","551","418","133","44","595","1142","0","52.1","36.6"
"10","009","00","001","0115","0000","397","303","94","25","422","669","0","63.08","45.29"
"10","009","00","001","0115","0453","397","303","94","25","422","669","0","63.08","45.29"
"10","009","00","001","0116","0000","1089","879","210","80","1169","2202","0","53.09","39.92"
"10","009","00","001","0116","0454","380","310","70","47","427","752","0","56.78","41.22"
"10","009","00","001","0116","0455","709","569","140","33","742","1450","0","51.17","39.24"
"10","009","00","001","0117","0000","281","220","61","38","319","555","0","57.48","39.64"
"10","009","00","001","0117","0456","281","220","61","38","319","555","0","57.48","39.64"
"10","009","00","001","0118","0000","1281","1034","247","96","1377","2414","0","57.04","42.83"
"10","009","00","001","0118","0451","582","470","112","47","629","1112","0","56.56","42.27"
"10","009","00","001","0118","0452","699","564","135","49","748","1302","0","57.45","43.32"
"10","009","00","001","0119","0000","754","603","151","61","815","1418","0","57.48","42.52"
"10","009","00","001","0119","0450","754","603","151","61","815","1418","0","57.48","42.52"
"10","009","00","001","0120","0000","1245","1008","237","71","1316","2397","0","54.9","42.05"
"10","009","00","001","0120","0457","717","582","135","51","768","1470","0","52.24","39.59"
"10","009","00","001","0120","0458","528","426","102","20","548","927","0","59.12","45.95"
"10","009","00","001","0121","0000","808","645","163","95","903","1748","0","51.66","36.9"
"10","009","00","001","0121","0466","808","645","163","95","903","1748","0","51.66","36.9"
"10","009","00","001","0122","0000","2900","2299","601","146","3046","5306","0","57.41","43.33"
"10","009","00","001","0122","0462","800","650","150","43","843","1412","0","59.7","46.03"
"10","009","00","001","0122","0463","794","632","162","35","829","1354","0","61.23","46.68"
"10","009","00","001","0122","0464","663","522","141","32","695","1267","0","54.85","41.2"
"10","009","00","001","0122","0465","643","495","148","36","679","1273","0","53.34","38.88"
"10","009","00","001","0123","0000","2736","2142","594","215","2951","5374","0","54.91","39.86"
"10","009","00","001","0123","0459","1046","844","202","56","1102","1893","0","58.21","44.59"
"10","009","00","001","0123","0460","875","658","217","101","976","1708","0","57.14","38.52"
"10","009","00","001","0123","0461","815","640","175","58","873","1773","0","49.24","36.1"
"10","009","00","001","0124","0000","954","725","229","105","1059","1813","0","58.41","39.99"
"10","009","00","001","0124","0472","385","299","86","39","424","702","0","60.4","42.59"
"10","009","00","001","0124","0473","569","426","143","66","635","1111","0","57.16","38.34"
"10","009","00","001","0125","0000","494","378","116","41","535","1123","0","47.64","33.66"
"10","009","00","001","0125","0474","494","378","116","41","535","1123","0","47.64","33.66"
"10","009","00","001","0126","0000","2324","1832","492","218","2542","4406","0","57.69","41.58"
"10","009","00","001","0126","0467","643","491","152","87","730","1238","0","58.97","39.66"
"10","009","00","001","0126","0468","823","664","159","69","892","1648","0","54.13","40.29"
"10","009","00","001","0126","0469","858","677","181","62","920","1520","0","60.53","44.54"
"10","009","00","001","0127","0000","518","405","113","39","557","1087","0","51.24","37.26"
"10","009","00","001","0127","0470","518","405","113","39","557","1087","0","51.24","37.26"
"10","009","00","001","0128","0000","1007","794","213","80","1087","1904","0","57.09","41.7"
"10","009","00","001","0128","0471","1007","794","213","80","1087","1904","0","57.09","41.7"
"10","009","00","001","0129","0000","1568","1273","295","161","1729","3095","0","55.86","41.13"
"10","009","00","001","0129","0477","516","387","129","67","583","1023","0","56.99","37.83"
"10","009","00","001","0129","0478","1052","886","166","94","1146","2072","0","55.31","42.76"
"10","009","00","001","0130","0000","1433","1118","315","89","1522","2932","0","51.91","38.13"
"10","009","00","001","0130","0475","542","424","118","45","587","1146","0","51.22","37.0"
"10","009","00","001","0130","0476","891","694","197","44","935","1786","0","52.35","38.86"
"10","009","00","001","0131","0000","545","430","115","33","578","1128","0","51.24","38.12"
"10","009","00","001","0131","0479","545","430","115","33","578","1128","0","51.24","38.12"
"10","009","00","001","0132","0000","1404","1160","244","69","1473","2345","0","62.81","49.47"
"10","009","00","001","0132","0418","730","603","127","39","769","1255","0","61.27","48.05"
"10","009","00","001","0132","0419","674","557","117","30","704","1090","0","64.59","51.1"
"10","009","00","001","0133","0000","1984","1570","414","140","2124","3710","0","57.25","42.32"
"10","009","00","001","0133","0416","1063","840","223","76","1139","1881","0","60.55","44.66"
"10","009","00","001","0133","0417","921","730","191","64","985","1829","0","53.85","39.91"
"10","009","00","001","0134","0000","1558","1275","283","79","1637","2814","0","58.17","45.31"
"10","009","00","001","0134","0435","777","637","140","36","813","1392","0","58.41","45.76"
"10","009","00","001","0134","0436","781","638","143","43","824","1422","0","57.95","44.87"
"10","009","00","001","0135","0000","1236","993","243","85","1321","2286","0","57.79","43.44"
"10","009","00","001","0135","0447","459","360","99","47","506","847","0","59.74","42.5"
"10","009","00","001","0135","0448","777","633","144","38","815","1439","0","56.64","43.99"
"10","009","00","001","0136","0000","1220","981","239","75","1295","2204","0","58.76","44.51"
"10","009","00","001","0136","0429","521","420","101","30","551","1009","0","54.61","41.63"
"10","009","00","001","0136","0430","699","561","138","45","744","1195","0","62.26","46.95"
"10","009","00","001","0137","0000","1793","1429","364","114","1907","3479","0","54.81","41.08"
"10","009","00","001","0137","0425","706","547","159","36","742","1308","0","56.73","41.82"
"10","009","00","001","0137","0426","1087","882","205","78","1165","2171","0","53.66","40.63"
"10","009","00","001","0138","0000","1455","1240","215","108","1563","2576","0","60.68","48.14"
"10","009","00","001","0138","0442","672","528","144","29","701","1214","0","57.74","43.49"
"10","009","00","001","0138","0443","783","712","71","79","862","1362","0","63.29","52.28"
"10","009","00","001","0139","0000","1297","1051","246","82","1379","2279","0","60.51","46.12"
"10","009","00","001","0139","0420","640","527","113","33","673","1103","0","61.02","47.78"
"10","009","00","001","0139","0421","657","524","133","49","706","1176","0","60.03","44.56"
"10","009","00","002","0000","0000","19477","15189","4288","1835","21312","38138","44608","55.88","39.83"
"10","009","00","002","0201","0000","630","502","128","52","682","1166","0","58.49","43.05"
"10","009","00","002","0201","0498","630","502","128","52","682","1166","0","58.49","43.05"
"10","009","00","002","0202","0000","1219","965","254","73","1292","2110","0","61.23","45.73"
"10","009","00","002","0202","0499","647","504","143","41","688","1135","0","60.62","44.41"
"10","009","00","002","0202","0500","572","461","111","32","604","975","0","61.95","47.28"
"10","009","00","002","0203","0000","1129","903","226","102","1231","2228","0","55.25","40.53"
"10","009","00","002","0203","0503","681","528","153","53","734","1321","0","55.56","39.97"
"10","009","00","002","0203","0504","448","375","73","49","497","907","0","54.8","41.35"
"10","009","00","002","0204","0000","833","658","175","86","919","1473","0","62.39","44.67"
"10","009","00","002","0204","0505","833","658","175","86","919","1473","0","62.39","44.67"
"10","009","00","002","0205","0000","745","552","193","58","803","1277","0","62.88","43.23"
"10","009","00","002","0205","0506","745","552","193","58","803","1277","0","62.88","43.23"
"10","009","00","002","0206","0000","1393","1034","359","105","1498","2673","0","56.04","38.68"
"10","009","00","002","0206","0514","583","440","143","43","626","1042","0","60.08","42.23"
"10","009","00","002","0206","0515","810","594","216","62","872","1631","0","53.46","36.42"
"10","009","00","002","0207","0000","656","495","161","93","749","1333","0","56.19","37.13"
"10","009","00","002","0207","0507","656","495","161","93","749","1333","0","56.19","37.13"
"10","009","00","002","0208","0000","375","297","78","37","412","777","0","53.02","38.22"
"10","009","00","002","0208","0508","375","297","78","37","412","777","0","53.02","38.22"
"10","009","00","002","0209","0000","435","351","84","57","492","899","0","54.73","39.04"
"10","009","00","002","0209","0510","435","351","84","57","492","899","0","54.73","39.04"
"10","009","00","002","0210","0000","272","212","60","42","314","688","0","45.64","30.81"
"10","009","00","002","0210","0511","272","212","60","42","314","688","0","45.64","30.81"
"10","009","00","002","0211","0000","503","409","94","41","544","1147","0","47.43","35.66"
"10","009","00","002","0211","0512","503","409","94","41","544","1147","0","47.43","35.66"
"10","009","00","002","0212","0000","842","596","246","98","940","1709","0","55.0","34.87"
"10","009","00","002","0212","0513","842","596","246","98","940","1709","0","55.0","34.87"
"10","009","00","002","0213","0000","471","364","107","31","502","981","0","51.17","37.1"
"10","009","00","002","0213","0525","471","364","107","31","502","981","0","51.17","37.1"
"10","009","00","002","0214","0000","1306","1018","288","149","1455","2715","0","53.59","37.5"
"10","009","00","002","0214","0526","486","375","111","33","519","1129","0","45.97","33.22"
"10","009","00","002","0214","0527","820","643","177","116","936","1586","0","59.02","40.54"
"10","009","00","002","0215","0000","1109","880","229","111","1220","2227","0","54.78","39.52"
"10","009","00","002","0215","0528","672","547","125","84","756","1243","0","60.82","44.01"
"10","009","00","002","0215","0529","437","333","104","27","464","984","0","47.15","33.84"
"10","009","00","002","0216","0000","1774","1360","414","163","1937","3266","0","59.31","41.64"
"10","009","00","002","0216","0516","935","727","208","89","1024","1702","0","60.16","42.71"
"10","009","00","002","0216","0517","839","633","206","74","913","1564","0","58.38","40.47"
"10","009","00","002","0217","0000","368","289","79","21","389","897","0","43.37","32.22"
"10","009","00","002","0217","0520","368","289","79","21","389","897","0","43.37","32.22"
"10","009","00","002","0218","0000","395","306","89","30","425","803","0","52.93","38.11"
"10","009","00","002","0218","0521","395","306","89","30","425","803","0","52.93","38.11"
"10","009","00","002","0219","0000","455","364","91","48","503","866","0","58.08","42.03"
"10","009","00","002","0219","0522","455","364","91","48","503","866","0","58.08","42.03"
"10","009","00","002","0220","0000","761","546","215","119","880","1523","0","57.78","35.85"
"10","009","00","002","0220","0523","433","311","122","69","502","852","0","58.92","36.5"
"10","009","00","002","0220","0524","328","235","93","50","378","671","0","56.33","35.02"
"10","009","00","002","0221","0000","741","600","141","83","824","1507","0","54.68","39.81"
"10","009","00","002","0221","0530","741","600","141","83","824","1507","0","54.68","39.81"
"10","009","00","002","0222","0000","433","405","28","43","476","877","0","54.28","46.18"
"10","009","00","002","0222","0509","433","405","28","43","476","877","0","54.28","46.18"
"10","009","00","002","0223","0000","1544","1229","315","102","1646","2810","0","58.58","43.74"
"10","009","00","002","0223","0501","811","648","163","44","855","1459","0","58.6","44.41"
"10","009","00","002","0223","0502","733","581","152","58","791","1351","0","58.55","43.01"
"10","009","00","002","0224","0000","1088","854","234","91","1179","2186","0","53.93","39.07"
"10","009","00","002","0224","0518","380","296","84","41","421","910","0","46.26","32.53"
"10","009","00","002","0224","0519","708","558","150","50","758","1276","0","59.4","43.73"
"10","009","00","003","0000","0000","28177","22054","6123","2270","30447","58167","70892","52.34","37.91"
"10","009","00","003","0301","0000","498","386","112","70","568","941","0","60.36","41.02"
"10","009","00","003","0301","0117","498","386","112","70","568","941","0","60.36","41.02"
"10","009","00","003","0302","0000","776","589","187","89","865","1675","0","51.64","35.16"
"10","009","00","003","0302","0111","389","288","101","38","427","785","0","54.39","36.69"
"10","009","00","003","0302","0112","387","301","86","51","438","890","0","49.21","33.82"
"10","009","00","003","0303","0000","1386","1094","292","97","1483","2605","0","56.93","42.0"
"10","009","00","003","0303","0109","691","559","132","53","744","1347","0","55.23","41.5"
"10","009","00","003","0303","0110","695","535","160","44","739","1258","0","58.74","42.53"
"10","009","00","003","0304","0000","1550","1244","306","114","1664","2844","0","58.51","43.74"
"10","009","00","003","0304","0113","746","610","136","52","798","1413","0","56.48","43.17"
"10","009","00","003","0304","0114","804","634","170","62","866","1431","0","60.52","44.3"
"10","009","00","003","0305","0000","1189","948","241","120","1309","2549","0","51.35","37.19"
"10","009","00","003","0305","0115","586","462","124","71","657","1224","0","53.68","37.75"
"10","009","00","003","0305","0116","603","486","117","49","652","1325","0","49.21","36.68"
"10","009","00","003","0306","0000","1606","1282","324","68","1674","3254","0","51.44","39.4"
"10","009","00","003","0306","0118","829","669","160","26","855","1613","0","53.01","41.48"
"10","009","00","003","0306","0119","777","613","164","42","819","1641","0","49.91","37.36"
"10","009","00","003","0307","0000","814","641","173","45","859","1438","0","59.74","44.58"
"10","009","00","003","0307","0123","814","641","173","45","859","1438","0","59.74","44.58"
"10","009","00","003","0308","0000","2479","2015","464","111","2590","4295","0","60.3","46.92"
"10","009","00","003","0308","0124","759","622","137","33","792","1361","0","58.19","45.7"
"10","009","00","003","0308","0125","826","658","168","42","868","1444","0","60.11","45.57"
"10","009","00","003","0308","0126","894","735","159","36","930","1490","0","62.42","49.33"
"10","009","00","003","0309","0000","1226","961","265","86","1312","2274","0","57.7","42.26"
"10","009","00","003","0309","0127","775","621","154","52","827","1307","0","63.27","47.51"
"10","009","00","003","0309","0128","451","340","111","34","485","967","0","50.16","35.16"
"10","009","00","003","0310","0000","1896","1524","372","79","1975","3745","0","52.74","40.69"
"10","009","00","003","0310","0129","915","752","163","41","956","1865","0","51.26","40.32"
"10","009","00","003","0310","0130","981","772","209","38","1019","1880","0","54.2","41.06"
"10","009","00","003","0311","0000","982","738","244","71","1053","2000","0","52.65","36.9"
"10","009","00","003","0311","0131","521","385","136","43","564","1099","0","51.32","35.03"
"10","009","00","003","0311","0132","461","353","108","28","489","901","0","54.27","39.18"
"10","009","00","003","0312","0000","553","440","113","19","572","1120","0","51.07","39.29"
"10","009","00","003","0312","0133","553","440","113","19","572","1120","0","51.07","39.29"
"10","009","00","003","0313","0000","557","438","119","78","635","1272","0","49.92","34.43"
"10","009","00","003","0313","0154","557","438","119","78","635","1272","0","49.92","34.43"
"10","009","00","003","0314","0000","360","272","88","31","391","851","0","45.95","31.96"
"10","009","00","003","0314","0153","360","272","88","31","391","851","0","45.95","31.96"
"10","009","00","003","0315","0000","623","468","155","95","718","1549","0","46.35","30.21"
"10","009","00","003","0315","0152","623","468","155","95","718","1549","0","46.35","30.21"
"10","009","00","003","0316","0000","644","515","129","65","709","1509","0","46.98","34.13"
"10","009","00","003","0316","0150","644","515","129","65","709","1509","0","46.98","34.13"
"10","009","00","003","0317","0000","302","220","82","60","362","855","0","42.34","25.73"
"10","009","00","003","0317","0151","302","220","82","60","362","855","0","42.34","25.73"
"10","009","00","003","0318","0000","1288","1025","263","62","1350","2668","0","50.6","38.42"
"10","009","00","003","0318","0135","686","542","144","62","748","1420","0","52.68","38.17"
"10","009","00","003","0318","0136","602","483","119","0","602","1248","0","48.24","38.7"
"10","009","00","003","0319","0000","385","299","86","31","416","799","0","52.07","37.42"
"10","009","00","003","0319","0137","385","299","86","31","416","799","0","52.07","37.42"
"10","009","00","003","0320","0000","783","579","204","114","897","1760","0","50.97","32.9"
"10","009","00","003","0320","0138","385","284","101","61","446","836","0","53.35","33.97"
"10","009","00","003","0320","0139","398","295","103","53","451","924","0","48.81","31.93"
"10","009","00","003","0321","0000","652","510","142","33","685","1648","0","41.57","30.95"
"10","009","00","003","0321","0140","652","510","142","33","685","1648","0","41.57","30.95"
"10","009","00","003","0322","0000","1355","1005","350","165","1520","3162","0","48.07","31.78"
"10","009","00","003","0322","0141","661","486","175","110","771","1616","0","47.71","30.07"
"10","009","00","003","0322","0142","694","519","175","55","749","1546","0","48.45","33.57"
"10","009","00","003","0323","0000","1067","827","240","76","1143","2361","0","48.41","35.03"
"10","009","00","003","0323","0143","585","448","137","39","624","1283","0","48.64","34.92"
"10","009","00","003","0323","0144","482","379","103","37","519","1078","0","48.14","35.16"
"10","009","00","003","0324","0000","1114","820","294","84","1198","2597","0","46.13","31.57"
"10","009","00","003","0324","0145","554","414","140","48","602","1313","0","45.85","31.53"
"10","009","00","003","0324","0146","560","406","154","36","596","1284","0","46.42","31.62"
"10","009","00","003","0325","0000","629","506","123","99","728","1356","0","53.69","37.32"
"10","009","00","003","0325","0147","629","506","123","99","728","1356","0","53.69","37.32"
"10","009","00","003","0326","0000","712","536","176","92","804","1504","0","53.46","35.64"
"10","009","00","003","0326","0148","712","536","176","92","804","1504","0","53.46","35.64"
"10","009","00","003","0327","0000","224","171","53","16","240","545","0","44.04","31.38"
"10","009","00","003","0327","0134","224","171","53","16","240","545","0","44.04","31.38"
"10","009","00","003","0328","0000","2035","1608","427","160","2195","3767","0","58.27","42.69"
"10","009","00","003","0328","0120","673","543","130","49","722","1200","0","60.17","45.25"
"10","009","00","003","0328","0121","681","517","164","75","756","1294","0","58.42","39.95"
"10","009","00","003","0328","0122","681","548","133","36","717","1273","0","56.32","43.05"
"10","009","00","003","0329","0000","492","393","99","40","532","1224","0","43.46","32.11"
"10","009","00","003","0329","0149","492","393","99","40","532","1224","0","43.46","32.11"
"10","009","00","004","0000","0000","17907","13877","4030","2025","19932","38142","46135","52.26","36.38"
"10","009","00","004","0401","0000","731","541","190","67","798","1590","0","50.19","34.03"
"10","009","00","004","0401","0340","731","541","190","67","798","1590","0","50.19","34.03"
"10","009","00","004","0402","0000","851","660","191","91","942","1741","0","54.11","37.91"
"10","009","00","004","0402","0341","851","660","191","91","942","1741","0","54.11","37.91"
"10","009","00","004","0403","0000","1207","969","238","133","1340","2120","0","63.21","45.71"
"10","009","00","004","0403","0342","630","505","125","63","693","1080","0","64.17","46.76"
"10","009","00","004","0403","0343","577","464","113","70","647","1040","0","62.21","44.62"
"10","009","00","004","0404","0000","1528","1230","298","93","1621","2971","0","54.56","41.4"
"10","009","00","004","0404","0344","711","565","146","36","747","1346","0","55.5","41.98"
"10","009","00","004","0404","0345","817","665","152","57","874","1625","0","53.78","40.92"
"10","009","00","004","0405","0000","201","164","37","17","218","354","0","61.58","46.33"
"10","009","00","004","0405","0346","201","164","37","17","218","354","0","61.58","46.33"
"10","009","00","004","0406","0000","276","209","67","43","319","580","0","55.0","36.03"
"10","009","00","004","0406","0347","276","209","67","43","319","580","0","55.0","36.03"
"10","009","00","004","0407","0000","340","258","82","33","373","591","0","63.11","43.65"
"10","009","00","004","0407","0348","340","258","82","33","373","591","0","63.11","43.65"
"10","009","00","004","0408","0000","561","431","130","59","620","1050","0","59.05","41.05"
"10","009","00","004","0408","0349","561","431","130","59","620","1050","0","59.05","41.05"
"10","009","00","004","0409","0000","1410","1064","346","159","1569","2749","0","57.08","38.7"
"10","009","00","004","0409","0350","633","476","157","73","706","1147","0","61.55","41.5"
"10","009","00","004","0409","0351","777","588","189","86","863","1602","0","53.87","36.7"
"10","009","00","004","0410","0000","2176","1836","340","111","2287","4335","0","52.76","42.35"
"10","009","00","004","0410","0352","699","505","194","56","755","1452","0","52.0","34.78"
"10","009","00","004","0410","0353","852","832","20","23","875","1578","0","55.45","52.72"
"10","009","00","004","0410","0354","625","499","126","32","657","1305","0","50.34","38.24"
"10","009","00","004","0411","0000","546","404","142","52","598","1327","0","45.06","30.44"
"10","009","00","004","0411","0355","546","404","142","52","598","1327","0","45.06","30.44"
"10","009","00","004","0412","0000","709","558","151","66","775","1516","0","51.12","36.81"
"10","009","00","004","0412","0356","709","558","151","66","775","1516","0","51.12","36.81"
"10","009","00","004","0413","0000","465","358","107","68","533","983","0","54.22","36.42"
"10","009","00","004","0413","0369","465","358","107","68","533","983","0","54.22","36.42"
"10","009","00","004","0414","0000","486","385","101","58","544","1014","0","53.65","37.97"
"10","009","00","004","0414","0370","486","385","101","58","544","1014","0","53.65","37.97"
"10","009","00","004","0415","0000","764","567","197","133","897","1805","0","49.7","31.41"
"10","009","00","004","0415","0371","389","291","98","83","472","939","0","50.27","30.99"
"10","009","00","004","0415","0372","375","276","99","50","425","866","0","49.08","31.87"
"10","009","00","004","0416","0000","629","497","132","95","724","1486","0","48.72","33.45"
"10","009","00","004","0416","0373","629","497","132","95","724","1486","0","48.72","33.45"
"10","009","00","004","0417","0000","538","400","138","57","595","1616","0","36.82","24.75"
"10","009","00","004","0417","0357","279","201","78","32","311","828","0","37.56","24.28"
"10","009","00","004","0417","0358","259","199","60","25","284","788","0","36.04","25.25"
"10","009","00","004","0418","0000","377","261","116","77","454","863","0","52.61","30.24"
"10","009","00","004","0418","0359","377","261","116","77","454","863","0","52.61","30.24"
"10","009","00","004","0419","0000","426","303","123","87","513","984","0","52.13","30.79"
"10","009","00","004","0419","0360","426","303","123","87","513","984","0","52.13","30.79"
"10","009","00","004","0420","0000","409","281","128","57","466","870","0","53.56","32.3"
"10","009","00","004","0420","0362","409","281","128","57","466","870","0","53.56","32.3"
"10","009","00","004","0421","0000","658","471","187","151","809","1514","0","53.43","31.11"
"10","009","00","004","0421","0361","658","471","187","151","809","1514","0","53.43","31.11"
"10","009","00","004","0422","0000","451","344","107","65","516","971","0","53.14","35.43"
"10","009","00","004","0422","0363","451","344","107","65","516","971","0","53.14","35.43"
"10","009","00","004","0423","0000","405","316","89","43","448","823","0","54.43","38.4"
"10","009","00","004","0423","0366","405","316","89","43","448","823","0","54.43","38.4"
"10","009","00","004","0424","0000","322","256","66","32","354","726","0","48.76","35.26"
"10","009","00","004","0424","0365","322","256","66","32","354","726","0","48.76","35.26"
"10","009","00","004","0425","0000","525","405","120","61","586","1304","0","44.94","31.06"
"10","009","00","004","0425","0364","525","405","120","61","586","1304","0","44.94","31.06"
"10","009","00","004","0426","0000","325","254","71","22","347","886","0","39.16","28.67"
"10","009","00","004","0426","0367","325","254","71","22","347","886","0","39.16","28.67"
"10","009","00","004","0427","0000","591","455","136","95","686","1373","0","49.96","33.14"
"10","009","00","004","0427","0368","591","455","136","95","686","1373","0","49.96","33.14"
"10","009","00","005","0000","0000","11166","8494","2672","1471","12637","24412","28827","51.77","34.79"
"10","009","00","005","0501","0000","452","352","100","60","512","809","0","63.29","43.51"
"10","009","00","005","0501","0080","452","352","100","60","512","809","0","63.29","43.51"
"10","009","00","005","0502","0000","476","345","131","59","535","896","0","59.71","38.5"
"10","009","00","005","0502","0081","476","345","131","59","535","896","0","59.71","38.5"
"10","009","00","005","0503","0000","785","620","165","83","868","1389","0","62.49","44.64"
"10","009","00","005","0503","0082","350","266","84","48","398","687","0","57.93","38.72"
"10","009","00","005","0503","0083","435","354","81","35","470","702","0","66.95","50.43"
"10","009","00","005","0504","0000","599","471","128","37","636","1032","0","61.63","45.64"
"10","009","00","005","0504","0084","599","471","128","37","636","1032","0","61.63","45.64"
"10","009","00","005","0505","0000","496","375","121","100","596","1124","0","53.02","33.36"
"10","009","00","005","0505","0085","309","235","74","61","370","697","0","53.08","33.72"
"10","009","00","005","0505","0086","187","140","47","39","226","427","0","52.93","32.79"
"10","009","00","005","0506","0000","643","492","151","56","699","1430","0","48.88","34.41"
"10","009","00","005","0506","0089","266","202","64","12","278","634","0","43.85","31.86"
"10","009","00","005","0506","0090","377","290","87","44","421","796","0","52.89","36.43"
"10","009","00","005","0507","0000","548","388","160","70","618","1321","0","46.78","29.37"
"10","009","00","005","0507","0091","283","198","85","47","330","745","0","44.3","26.58"
"10","009","00","005","0507","0092","265","190","75","23","288","576","0","50.0","32.99"
"10","009","00","005","0508","0000","510","378","132","76","586","1277","0","45.89","29.6"
"10","009","00","005","0508","0093","294","225","69","60","354","743","0","47.64","30.28"
"10","009","00","005","0508","0094","216","153","63","16","232","534","0","43.45","28.65"
"10","009","00","005","0509","0000","392","306","86","64","456","843","0","54.09","36.3"
"10","009","00","005","0509","0099","392","306","86","64","456","843","0","54.09","36.3"
"10","009","00","005","0510","0000","1441","1123","318","102","1543","2734","0","56.44","41.08"
"10","009","00","005","0510","0087","756","595","161","71","827","1451","0","57.0","41.01"
"10","009","00","005","0510","0088","685","528","157","31","716","1283","0","55.81","41.15"
"10","009","00","005","0511","0000","813","623","190","139","952","1864","0","51.07","33.42"
"10","009","00","005","0511","0100","400","307","93","87","487","916","0","53.17","33.52"
"10","009","00","005","0511","0101","413","316","97","52","465","948","0","49.05","33.33"
"10","009","00","005","0512","0000","827","637","190","104","931","1774","0","52.48","35.91"
"10","009","00","005","0512","0102","431","328","103","35","466","914","0","50.98","35.89"
"10","009","00","005","0512","0103","396","309","87","69","465","860","0","54.07","35.93"
"10","009","00","005","0513","0000","319","255","64","44","363","896","0","40.51","28.46"
"10","009","00","005","0513","0106","319","255","64","44","363","896","0","40.51","28.46"
"10","009","00","005","0514","0000","757","559","198","131","888","1804","0","49.22","30.99"
"10","009","00","005","0514","0104","411","305","106","60","471","929","0","50.7","32.83"
"10","009","00","005","0514","0105","346","254","92","71","417","875","0","47.66","29.03"
"10","009","00","005","0515","0000","914","680","234","172","1086","2276","0","47.72","29.88"
"10","009","00","005","0515","0095","464","349","115","82","546","1199","0","45.54","29.11"
"10","009","00","005","0515","0096","450","331","119","90","540","1077","0","50.14","30.73"
"10","009","00","005","0516","0000","619","466","153","81","700","1503","0","46.57","31.0"
"10","009","00","005","0516","0097","300","231","69","33","333","819","0","40.66","28.21"
"10","009","00","005","0516","0098","319","235","84","48","367","684","0","53.65","34.36"
"10","009","00","005","0517","0000","575","424","151","93","668","1440","0","46.39","29.44"
"10","009","00","005","0517","0107","288","210","78","53","341","757","0","45.05","27.74"
"10","009","00","005","0517","0108","287","214","73","40","327","683","0","47.88","31.33"
"10","009","00","006","0000","0000","16241","12419","3822","2050","18291","33958","39975","53.86","36.57"
"10","009","00","006","0601","0000","365","279","86","62","427","724","0","58.98","38.54"
"10","009","00","006","0601","0256","365","279","86","62","427","724","0","58.98","38.54"
"10","009","00","006","0602","0000","363","272","91","68","431","688","0","62.65","39.53"
"10","009","00","006","0602","0257","363","272","91","68","431","688","0","62.65","39.53"
"10","009","00","006","0603","0000","223","168","55","41","264","452","0","58.41","37.17"
"10","009","00","006","0603","0258","223","168","55","41","264","452","0","58.41","37.17"
"10","009","00","006","0604","0000","434","329","105","72","506","866","0","58.43","37.99"
"10","009","00","006","0604","0259","434","329","105","72","506","866","0","58.43","37.99"
"10","009","00","006","0605","0000","156","109","47","22","178","336","0","52.98","32.44"
"10","009","00","006","0605","0260","156","109","47","22","178","336","0","52.98","32.44"
"10","009","00","006","0606","0000","188","156","32","27","215","395","0","54.43","39.49"
"10","009","00","006","0606","0261","188","156","32","27","215","395","0","54.43","39.49"
"10","009","00","006","0607","0000","205","174","31","32","237","376","0","63.03","46.28"
"10","009","00","006","0607","0262","205","174","31","32","237","376","0","63.03","46.28"
"10","009","00","006","0608","0000","502","364","138","43","545","950","0","57.37","38.32"
"10","009","00","006","0608","0263","502","364","138","43","545","950","0","57.37","38.32"
"10","009","00","006","0609","0000","274","197","77","45","319","512","0","62.3","38.48"
"10","009","00","006","0609","0264","274","197","77","45","319","512","0","62.3","38.48"
"10","009","00","006","0610","0000","169","123","46","29","198","324","0","61.11","37.96"
"10","009","00","006","0610","0265","169","123","46","29","198","324","0","61.11","37.96"
"10","009","00","006","0611","0000","262","189","73","36","298","546","0","54.58","34.62"
"10","009","00","006","0611","0266","262","189","73","36","298","546","0","54.58","34.62"
"10","009","00","006","0612","0000","602","456","146","87","689","1184","0","58.19","38.51"
"10","009","00","006","0612","0267","235","185","50","23","258","433","0","59.58","42.73"
"10","009","00","006","0612","0268","367","271","96","64","431","751","0","57.39","36.09"
"10","009","00","006","0613","0000","243","193","50","30","273","442","0","61.76","43.67"
"10","009","00","006","0613","0269","243","193","50","30","273","442","0","61.76","43.67"
"10","009","00","006","0614","0000","2514","1916","598","261","2775","4912","0","56.49","39.01"
"10","009","00","006","0614","0270","597","455","142","70","667","1151","0","57.95","39.53"
"10","009","00","006","0614","0271","660","516","144","56","716","1224","0","58.5","42.16"
"10","009","00","006","0614","0272","588","442","146","60","648","1211","0","53.51","36.5"
"10","009","00","006","0614","0273","669","503","166","75","744","1326","0","56.11","37.93"
"10","009","00","006","0615","0000","1000","786","214","105","1105","1721","0","64.21","45.67"
"10","009","00","006","0615","0274","433","333","100","45","478","744","0","64.25","44.76"
"10","009","00","006","0615","0275","567","453","114","60","627","977","0","64.18","46.37"
"10","009","00","006","0616","0000","3217","2551","666","326","3543","6230","0","56.87","40.95"
"10","009","00","006","0616","0278","721","564","157","64","785","1364","0","57.55","41.35"
"10","009","00","006","0616","0279","597","479","118","59","656","1123","0","58.41","42.65"
"10","009","00","006","0616","0280","748","606","142","72","820","1451","0","56.51","41.76"
"10","009","00","006","0616","0281","620","488","132","72","692","1162","0","59.55","42.0"
"10","009","00","006","0616","0282","531","414","117","59","590","1130","0","52.21","36.64"
"10","009","00","006","0617","0000","526","408","118","44","570","1149","0","49.61","35.51"
"10","009","00","006","0617","0283","526","408","118","44","570","1149","0","49.61","35.51"
"10","009","00","006","0618","0000","324","242","82","25","349","809","0","43.14","29.91"
"10","009","00","006","0618","0287","324","242","82","25","349","809","0","43.14","29.91"
"10","009","00","006","0619","0000","552","426","126","92","644","1397","0","46.1","30.49"
"10","009","00","006","0619","0288","552","426","126","92","644","1397","0","46.1","30.49"
"10","009","00","006","0620","0000","420","314","106","105","525","1145","0","45.85","27.42"
"10","009","00","006","0620","0289","420","314","106","105","525","1145","0","45.85","27.42"
"10","009","00","006","0621","0000","445","328","117","66","511","966","0","52.9","33.95"
"10","009","00","006","0621","0284","205","154","51","35","240","533","0","45.03","28.89"
"10","009","00","006","0621","0285","240","174","66","31","271","433","0","62.59","40.18"
"10","009","00","006","0622","0000","237","170","67","75","312","828","0","37.68","20.53"
"10","009","00","006","0622","0290","237","170","67","75","312","828","0","37.68","20.53"
"10","009","00","006","0623","0000","194","143","51","26","220","557","0","39.5","25.67"
"10","009","00","006","0623","0291","194","143","51","26","220","557","0","39.5","25.67"
"10","009","00","006","0624","0000","687","492","195","90","777","1637","0","47.46","30.05"
"10","009","00","006","0624","0292","446","309","137","53","499","1060","0","47.08","29.15"
"10","009","00","006","0624","0293","241","183","58","37","278","577","0","48.18","31.72"
"10","009","00","006","0625","0000","1359","1053","306","145","1504","2981","0","50.45","35.32"
"10","009","00","006","0625","0294","332","248","84","73","405","931","0","43.5","26.64"
"10","009","00","006","0625","0295","503","388","115","44","547","1018","0","53.73","38.11"
"10","009","00","006","0625","0296","524","417","107","28","552","1032","0","53.49","40.41"
"10","009","00","006","0626","0000","453","328","125","74","527","960","0","54.9","34.17"
"10","009","00","006","0626","0276","453","328","125","74","527","960","0","54.9","34.17"
"10","009","00","006","0627","0000","161","121","40","10","171","494","0","34.62","24.49"
"10","009","00","006","0627","0277","161","121","40","10","171","494","0","34.62","24.49"
"10","009","00","006","0628","0000","166","132","34","12","178","377","0","47.21","35.01"
"10","009","00","006","0628","0286","166","132","34","12","178","377","0","47.21","35.01"
"10","009","00","007","0000","0000","12765","9837","2928","1454","14219","27477","31464","51.75","35.8"
"10","009","00","007","0701","0000","554","420","134","90","644","1255","0","51.31","33.47"
"10","009","00","007","0701","0539","554","420","134","90","644","1255","0","51.31","33.47"
"10","009","00","007","0702","0000","603","472","131","49","652","1078","0","60.48","43.78"
"10","009","00","007","0702","0540","603","472","131","49","652","1078","0","60.48","43.78"
"10","009","00","007","0703","0000","588","479","109","93","681","1169","0","58.25","40.98"
"10","009","00","007","0703","0538","588","479","109","93","681","1169","0","58.25","40.98"
"10","009","00","007","0704","0000","635","486","149","105","740","1426","0","51.89","34.08"
"10","009","00","007","0704","0536","545","417","128","100","645","1122","0","57.49","37.17"
"10","009","00","007","0704","0537","90","69","21","5","95","304","0","31.25","22.7"
"10","009","00","007","0705","0000","1438","1124","314","128","1566","3074","0","50.94","36.56"
"10","009","00","007","0705","0534","644","508","136","55","699","1302","0","53.69","39.02"
"10","009","00","007","0705","0535","794","616","178","73","867","1772","0","48.93","34.76"
"10","009","00","007","0706","0000","694","510","184","63","757","1517","0","49.9","33.62"
"10","009","00","007","0706","0533","694","510","184","63","757","1517","0","49.9","33.62"
"10","009","00","007","0707","0000","994","760","234","144","1138","2120","0","53.68","35.85"
"10","009","00","007","0707","0531","546","422","124","70","616","1126","0","54.71","37.48"
"10","009","00","007","0707","0532","448","338","110","74","522","994","0","52.52","34.0"
"10","009","00","007","0708","0000","252","200","52","13","265","734","0","36.1","27.25"
"10","009","00","007","0708","0554","252","200","52","13","265","734","0","36.1","27.25"
"10","009","00","007","0709","0000","102","70","32","7","109","285","0","38.25","24.56"
"10","009","00","007","0709","0553","102","70","32","7","109","285","0","38.25","24.56"
"10","009","00","007","0710","0000","1026","801","225","111","1137","2138","0","53.18","37.46"
"10","009","00","007","0710","0547","429","324","105","58","487","998","0","48.8","32.46"
"10","009","00","007","0710","0548","597","477","120","53","650","1140","0","57.02","41.84"
"10","009","00","007","0711","0000","541","385","156","92","633","1150","0","55.04","33.48"
"10","009","00","007","0711","0555","541","385","156","92","633","1150","0","55.04","33.48"
"10","009","00","007","0712","0000","530","380","150","31","561","1233","0","45.5","30.82"
"10","009","00","007","0712","0552","530","380","150","31","561","1233","0","45.5","30.82"
"10","009","00","007","0713","0000","212","160","52","18","230","453","0","50.77","35.32"
"10","009","00","007","0713","0556","212","160","52","18","230","453","0","50.77","35.32"
"10","009","00","007","0714","0000","246","198","48","31","277","571","0","48.51","34.68"
"10","009","00","007","0714","0557","246","198","48","31","277","571","0","48.51","34.68"
"10","009","00","007","0715","0000","1000","746","254","85","1085","2058","0","52.72","36.25"
"10","009","00","007","0715","0549","540","388","152","49","589","1102","0","53.45","35.21"
"10","009","00","007","0715","0550","460","358","102","36","496","956","0","51.88","37.45"
"10","009","00","007","0716","0000","337","252","85","26","363","695","0","52.23","36.26"
"10","009","00","007","0716","0551","337","252","85","26","363","695","0","52.23","36.26"
"10","009","00","007","0717","0000","982","778","204","130","1112","2243","0","49.58","34.69"
"10","009","00","007","0717","0541","406","331","75","36","442","943","0","46.87","35.1"
"10","009","00","007","0717","0542","576","447","129","94","670","1300","0","51.54","34.38"
"10","009","00","007","0718","0000","978","758","220","117","1095","2108","0","51.94","35.96"
"10","009","00","007","0718","0543","417","322","95","61","478","964","0","49.59","33.4"
"10","009","00","007","0718","0544","561","436","125","56","617","1144","0","53.93","38.11"
"10","009","00","007","0719","0000","710","579","131","78","788","1482","0","53.17","39.07"
"10","009","00","007","0719","0545","710","579","131","78","788","1482","0","53.17","39.07"
"10","009","00","007","0720","0000","343","279","64","43","386","688","0","56.1","40.55"
"10","009","00","007","0720","0546","343","279","64","43","386","688","0","56.1","40.55"
"10","009","00","008","0000","0000","7566","5545","2021","839","8405","16509","19083","50.91","33.59"
"10","009","00","008","0801","0000","378","306","72","44","422","750","0","56.27","40.8"
"10","009","00","008","0801","0480","378","306","72","44","422","750","0","56.27","40.8"
"10","009","00","008","0802","0000","1030","771","259","101","1131","2095","0","53.99","36.8"
"10","009","00","008","0802","0484","706","521","185","69","775","1495","0","51.84","34.85"
"10","009","00","008","0802","0485","324","250","74","32","356","600","0","59.33","41.67"
"10","009","00","008","0803","0000","531","401","130","59","590","1004","0","58.76","39.94"
"10","009","00","008","0803","0486","531","401","130","59","590","1004","0","58.76","39.94"
"10","009","00","008","0804","0000","341","259","82","20","361","948","0","38.08","27.32"
"10","009","00","008","0804","0487","341","259","82","20","361","948","0","38.08","27.32"
"10","009","00","008","0805","0000","824","613","211","99","923","1895","0","48.71","32.35"
"10","009","00","008","0805","0489","625","460","165","65","690","1430","0","48.25","32.17"
"10","009","00","008","0805","0490","199","153","46","34","233","465","0","50.11","32.9"
"10","009","00","008","0806","0000","803","614","189","78","881","1781","0","49.47","34.48"
"10","009","00","008","0806","0491","587","457","130","55","642","1307","0","49.12","34.97"
"10","009","00","008","0806","0492","216","157","59","23","239","474","0","50.42","33.12"
"10","009","00","008","0807","0000","752","573","179","79","831","1539","0","54.0","37.23"
"10","009","00","008","0807","0488","752","573","179","79","831","1539","0","54.0","37.23"
"10","009","00","008","0808","0000","625","446","179","101","726","1220","0","59.51","36.56"
"10","009","00","008","0808","0493","625","446","179","101","726","1220","0","59.51","36.56"
"10","009","00","008","0809","0000","323","249","74","31","354","719","0","49.24","34.63"
"10","009","00","008","0809","0481","323","249","74","31","354","719","0","49.24","34.63"
"10","009","00","008","0810","0000","289","237","52","24","313","603","0","51.91","39.3"
"10","009","00","008","0810","0482","289","237","52","24","313","603","0","51.91","39.3"
"10","009","00","008","0811","0000","460","345","115","57","517","1106","0","46.75","31.19"
"10","009","00","008","0811","0483","460","345","115","57","517","1106","0","46.75","31.19"
"10","009","00","008","0812","0000","323","74","249","21","344","733","0","46.93","10.1"
"10","009","00","008","0812","0494","323","74","249","21","344","733","0","46.93","10.1"
"10","009","00","008","0813","0000","328","255","73","41","369","681","0","54.19","37.44"
"10","009","00","008","0813","0495","328","255","73","41","369","681","0","54.19","37.44"
"10","009","00","008","0814","0000","260","188","72","35","295","712","0","41.43","26.4"
"10","009","00","008","0814","0496","260","188","72","35","295","712","0","41.43","26.4"
"10","009","00","008","0815","0000","299","214","85","49","348","723","0","48.13","29.6"
"10","009","00","008","0815","0497","299","214","85","49","348","723","0","48.13","29.6"
"10","009","00","009","0000","0000","11802","8760","3042","1627","13429","24570","28727","54.66","35.65"
"10","009","00","009","0901","0000","2045","1556","489","244","2289","4079","0","56.12","38.15"
"10","009","00","009","0901","0374","755","561","194","96","851","1507","0","56.47","37.23"
"10","009","00","009","0901","0375","649","510","139","47","696","1300","0","53.54","39.23"
"10","009","00","009","0901","0376","641","485","156","101","742","1272","0","58.33","38.13"
"10","009","00","009","0902","0000","388","275","113","71","459","861","0","53.31","31.94"
"10","009","00","009","0902","0377","388","275","113","71","459","861","0","53.31","31.94"
"10","009","00","009","0903","0000","640","488","152","85","725","1565","0","46.33","31.18"
"10","009","00","009","0903","0378","640","488","152","85","725","1565","0","46.33","31.18"
"10","009","00","009","0904","0000","516","370","146","64","580","1213","0","47.82","30.5"
"10","009","00","009","0904","0379","260","196","64","21","281","577","0","48.7","33.97"
"10","009","00","009","0904","0380","256","174","82","43","299","636","0","47.01","27.36"
"10","009","00","009","0905","0000","497","354","143","97","594","1110","0","53.51","31.89"
"10","009","00","009","0905","0381","497","354","143","97","594","1110","0","53.51","31.89"
"10","009","00","009","0906","0000","983","715","268","146","1129","1958","0","57.66","36.52"
"10","009","00","009","0906","0382","512","382","130","68","580","973","0","59.61","39.26"
"10","009","00","009","0906","0383","471","333","138","78","549","985","0","55.74","33.81"
"10","009","00","009","0907","0000","1519","1152","367","215","1734","2991","0","57.97","38.52"
"10","009","00","009","0907","0384","884","677","207","126","1010","1707","0","59.17","39.66"
"10","009","00","009","0907","0385","635","475","160","89","724","1284","0","56.39","36.99"
"10","009","00","009","0908","0000","656","431","225","76","732","1293","0","56.61","33.33"
"10","009","00","009","0908","0386","656","431","225","76","732","1293","0","56.61","33.33"
"10","009","00","009","0909","0000","547","417","130","36","583","1165","0","50.04","35.79"
"10","009","00","009","0909","0389","547","417","130","36","583","1165","0","50.04","35.79"
"10","009","00","009","0910","0000","961","725","236","169","1130","1940","0","58.25","37.37"
"10","009","00","009","0910","0387","449","340","109","61","510","900","0","56.67","37.78"
"10","009","00","009","0910","0388","512","385","127","108","620","1040","0","59.62","37.02"
"10","009","00","009","0911","0000","908","685","223","124","1032","1756","0","58.77","39.01"
"10","009","00","009","0911","0390","432","326","106","62","494","871","0","56.72","37.43"
"10","009","00","009","0911","0391","476","359","117","62","538","885","0","60.79","40.56"
"10","009","00","009","0912","0000","645","474","171","75","720","1489","0","48.35","31.83"
"10","009","00","009","0912","0392","645","474","171","75","720","1489","0","48.35","31.83"
"10","009","00","009","0913","0000","572","443","129","96","668","1347","0","49.59","32.89"
"10","009","00","009","0913","0393","572","443","129","96","668","1347","0","49.59","32.89"
"10","009","00","009","0914","0000","925","675","250","129","1054","1803","0","58.46","37.44"
"10","009","00","009","0914","0394","584","429","155","83","667","1150","0","58.0","37.3"
"10","009","00","009","0914","0395","341","246","95","46","387","653","0","59.26","37.67"
"10","009","00","010","0000","0000","7685","5885","1800","1061","8746","15551","18089","56.24","37.84"
"10","009","00","010","1001","0000","572","446","126","83","655","1036","0","63.22","43.05"
"10","009","00","010","1001","0396","572","446","126","83","655","1036","0","63.22","43.05"
"10","009","00","010","1002","0000","1771","1343","428","223","1994","3652","0","54.6","36.77"
"10","009","00","010","1002","0397","753","561","192","81","834","1490","0","55.97","37.65"
"10","009","00","010","1002","0398","717","548","169","81","798","1491","0","53.52","36.75"
"10","009","00","010","1002","0399","301","234","67","61","362","671","0","53.95","34.87"
"10","009","00","010","1003","0000","1113","843","270","192","1305","2187","0","59.67","38.55"
"10","009","00","010","1003","0400","745","568","177","117","862","1436","0","60.03","39.55"
"10","009","00","010","1003","0401","368","275","93","75","443","751","0","58.99","36.62"
"10","009","00","010","1004","0000","259","189","70","34","293","535","0","54.77","35.33"
"10","009","00","010","1004","0402","259","189","70","34","293","535","0","54.77","35.33"
"10","009","00","010","1005","0000","331","258","73","52","383","811","0","47.23","31.81"
"10","009","00","010","1005","0403","331","258","73","52","383","811","0","47.23","31.81"
"10","009","00","010","1006","0000","1294","1029","265","177","1471","2625","0","56.04","39.2"
"10","009","00","010","1006","0404","665","515","150","99","764","1339","0","57.06","38.46"
"10","009","00","010","1006","0405","629","514","115","78","707","1286","0","54.98","39.97"
"10","009","00","010","1007","0000","322","239","83","33","355","646","0","54.95","37.0"
"10","009","00","010","1007","0406","322","239","83","33","355","646","0","54.95","37.0"
"10","009","00","010","1008","0000","565","415","150","87","652","1158","0","56.3","35.84"
"10","009","00","010","1008","0407","565","415","150","87","652","1158","0","56.3","35.84"
"10","009","00","010","1009","0000","550","420","130","64","614","1090","0","56.33","38.53"
"10","009","00","010","1009","0408","550","420","130","64","614","1090","0","56.33","38.53"
"10","009","00","010","1010","0000","908","703","205","116","1024","1811","0","56.54","38.82"
"10","009","00","010","1010","0409","498","386","112","76","574","950","0","60.42","40.63"
"10","009","00","010","1010","0410","410","317","93","40","450","861","0","52.26","36.82"
"10","009","00","011","0000","0000","9554","7059","2495","1370","10924","23367","26906","46.75","30.21"
"10","009","00","011","1101","0000","613","464","149","38","651","1463","0","44.5","31.72"
"10","009","00","011","1101","0317","613","464","149","38","651","1463","0","44.5","31.72"
"10","009","00","011","1102","0000","708","502","206","65","773","1738","0","44.48","28.88"
"10","009","00","011","1102","0318","708","502","206","65","773","1738","0","44.48","28.88"
"10","009","00","011","1103","0000","666","498","168","124","790","1643","0","48.08","30.31"
"10","009","00","011","1103","0319","246","176","70","51","297","625","0","47.52","28.16"
"10","009","00","011","1103","0320","420","322","98","73","493","1018","0","48.43","31.63"
"10","009","00","011","1104","0000","495","373","122","57","552","1496","0","36.9","24.93"
"10","009","00","011","1104","0321","149","107","42","6","155","448","0","34.6","23.88"
"10","009","00","011","1104","0322","346","266","80","51","397","1048","0","37.88","25.38"
"10","009","00","011","1105","0000","546","412","134","86","632","1161","0","54.44","35.49"
"10","009","00","011","1105","0323","546","412","134","86","632","1161","0","54.44","35.49"
"10","009","00","011","1106","0000","890","672","218","116","1006","1840","0","54.67","36.52"
"10","009","00","011","1106","0324","458","349","109","49","507","991","0","51.16","35.22"
"10","009","00","011","1106","0325","432","323","109","67","499","849","0","58.78","38.04"
"10","009","00","011","1107","0000","395","288","107","55","450","890","0","50.56","32.36"
"10","009","00","011","1107","0326","395","288","107","55","450","890","0","50.56","32.36"
"10","009","00","011","1108","0000","374","286","88","41","415","891","0","46.58","32.1"
"10","009","00","011","1108","0328","374","286","88","41","415","891","0","46.58","32.1"
"10","009","00","011","1109","0000","287","223","64","26","313","757","0","41.35","29.46"
"10","009","00","011","1109","0329","287","223","64","26","313","757","0","41.35","29.46"
"10","009","00","011","1110","0000","609","409","200","117","726","1497","0","48.5","27.32"
"10","009","00","011","1110","0330","609","409","200","117","726","1497","0","48.5","27.32"
"10","009","00","011","1111","0000","815","586","229","138","953","1857","0","51.32","31.56"
"10","009","00","011","1111","0331","478","338","140","78","556","1171","0","47.48","28.86"
"10","009","00","011","1111","0332","337","248","89","60","397","686","0","57.87","36.15"
"10","009","00","011","1112","0000","295","220","75","91","386","864","0","44.68","25.46"
"10","009","00","011","1112","0333","295","220","75","91","386","864","0","44.68","25.46"
"10","009","00","011","1113","0000","796","604","192","103","899","1769","0","50.82","34.14"
"10","009","00","011","1113","0334","537","408","129","78","615","1073","0","57.32","38.02"
"10","009","00","011","1113","0335","259","196","63","25","284","696","0","40.8","28.16"
"10","009","00","011","1114","0000","387","283","104","61","448","1271","0","35.25","22.27"
"10","009","00","011","1114","0336","387","283","104","61","448","1271","0","35.25","22.27"
"10","009","00","011","1115","0000","359","265","94","47","406","912","0","44.52","29.06"
"10","009","00","011","1115","0337","359","265","94","47","406","912","0","44.52","29.06"
"10","009","00","011","1116","0000","333","233","100","37","370","861","0","42.97","27.06"
"10","009","00","011","1116","0338","333","233","100","37","370","861","0","42.97","27.06"
"10","009","00","011","1117","0000","381","279","102","67","448","1030","0","43.5","27.09"
"10","009","00","011","1117","0339","381","279","102","67","448","1030","0","43.5","27.09"
"10","009","00","011","1118","0000","605","462","143","101","706","1427","0","49.47","32.38"
"10","009","00","011","1118","0327","605","462","143","101","706","1427","0","49.47","32.38"
"10","009","00","012","0000","0000","8922","6828","2094","1095","10017","21050","24427","47.59","32.44"
"10","009","00","012","1201","0000","577","448","129","75","652","1176","0","55.44","38.1"
"10","009","00","012","1201","0297","577","448","129","75","652","1176","0","55.44","38.1"
"10","009","00","012","1202","0000","643","518","125","50","693","1439","0","48.16","36.0"
"10","009","00","012","1202","0298","643","518","125","50","693","1439","0","48.16","36.0"
"10","009","00","012","1203","0000","1188","957","231","109","1297","2286","0","56.74","41.86"
"10","009","00","012","1203","0299","555","438","117","54","609","1027","0","59.3","42.65"
"10","009","00","012","1203","0300","633","519","114","55","688","1259","0","54.65","41.22"
"10","009","00","012","1204","0000","894","688","206","70","964","2056","0","46.89","33.46"
"10","009","00","012","1204","0301","481","370","111","38","519","1058","0","49.05","34.97"
"10","009","00","012","1204","0302","413","318","95","32","445","998","0","44.59","31.86"
"10","009","00","012","1205","0000","913","692","221","89","1002","2023","0","49.53","34.21"
"10","009","00","012","1205","0303","417","318","99","33","450","968","0","46.49","32.85"
"10","009","00","012","1205","0304","496","374","122","56","552","1055","0","52.32","35.45"
"10","009","00","012","1206","0000","533","397","136","84","617","1315","0","46.92","30.19"
"10","009","00","012","1206","0305","533","397","136","84","617","1315","0","46.92","30.19"
"10","009","00","012","1207","0000","783","581","202","131","914","2024","0","45.16","28.71"
"10","009","00","012","1207","0306","298","214","84","26","324","1027","0","31.55","20.84"
"10","009","00","012","1207","0307","485","367","118","105","590","997","0","59.18","36.81"
"10","009","00","012","1208","0000","378","298","80","42","420","807","0","52.04","36.93"
"10","009","00","012","1208","0308","378","298","80","42","420","807","0","52.04","36.93"
"10","009","00","012","1209","0000","563","405","158","87","650","1502","0","43.28","26.96"
"10","009","00","012","1209","0309","257","178","79","27","284","698","0","40.69","25.5"
"10","009","00","012","1209","0310","306","227","79","60","366","804","0","45.52","28.23"
"10","009","00","012","1210","0000","667","523","144","76","743","1753","0","42.38","29.83"
"10","009","00","012","1210","0311","367","288","79","38","405","867","0","46.71","33.22"
"10","009","00","012","1210","0312","300","235","65","38","338","886","0","38.15","26.52"
"10","009","00","012","1211","0000","513","401","112","103","616","1476","0","41.73","27.17"
"10","009","00","012","1211","0313","513","401","112","103","616","1476","0","41.73","27.17"
"10","009","00","012","1212","0000","333","249","84","45","378","1159","0","32.61","21.48"
"10","009","00","012","1212","0314","333","249","84","45","378","1159","0","32.61","21.48"
"10","009","00","012","1213","0000","567","393","174","96","663","1220","0","54.34","32.21"
"10","009","00","012","1213","0315","567","393","174","96","663","1220","0","54.34","32.21"
"10","009","00","012","1214","0000","370","278","92","38","408","814","0","50.12","34.15"
"10","009","00","012","1214","0316","370","278","92","38","408","814","0","50.12","34.15"
"10","009","00","013","0000","0000","16124","12612","3512","1876","18000","37119","46004","48.49","33.98"
"10","009","00","013","1301","0000","1710","1342","368","202","1912","4029","0","47.46","33.31"
"10","009","00","013","1301","0005","545","426","119","59","604","1340","0","45.07","31.79"
"10","009","00","013","1301","0006","480","372","108","73","553","1138","0","48.59","32.69"
"10","009","00","013","1301","0007","685","544","141","70","755","1551","0","48.68","35.07"
"10","009","00","013","1302","0000","3011","2317","694","308","3319","6988","0","47.5","33.16"
"10","009","00","013","1302","0001","562","446","116","74","636","1497","0","42.48","29.79"
"10","009","00","013","1302","0002","812","660","152","60","872","1738","0","50.17","37.97"
"10","009","00","013","1302","0003","862","702","160","95","957","1921","0","49.82","36.54"
"10","009","00","013","1302","0004","775","509","266","79","854","1832","0","46.62","27.78"
"10","009","00","013","1303","0000","711","545","166","91","802","1909","0","42.01","28.55"
"10","009","00","013","1303","0008","271","216","55","40","311","715","0","43.5","30.21"
"10","009","00","013","1303","0009","440","329","111","51","491","1194","0","41.12","27.55"
"10","009","00","013","1304","0000","989","762","227","86","1075","2581","0","41.65","29.52"
"10","009","00","013","1304","0010","438","337","101","50","488","1023","0","47.7","32.94"
"10","009","00","013","1304","0011","551","425","126","36","587","1558","0","37.68","27.28"
"10","009","00","013","1305","0000","1122","918","204","138","1260","2559","0","49.24","35.87"
"10","009","00","013","1305","0019","539","458","81","81","620","1230","0","50.41","37.24"
"10","009","00","013","1305","0020","583","460","123","57","640","1329","0","48.16","34.61"
"10","009","00","013","1306","0000","1279","996","283","176","1455","2959","0","49.17","33.66"
"10","009","00","013","1306","0014","612","470","142","83","695","1363","0","50.99","34.48"
"10","009","00","013","1306","0015","667","526","141","93","760","1596","0","47.62","32.96"
"10","009","00","013","1307","0000","824","625","199","69","893","2170","0","41.15","28.8"
"10","009","00","013","1307","0012","437","327","110","36","473","1187","0","39.85","27.55"
"10","009","00","013","1307","0013","387","298","89","33","420","983","0","42.73","30.32"
"10","009","00","013","1308","0000","746","593","153","102","848","2002","0","42.36","29.62"
"10","009","00","013","1308","0017","363","286","77","56","419","964","0","43.46","29.67"
"10","009","00","013","1308","0018","383","307","76","46","429","1038","0","41.33","29.58"
"10","009","00","013","1309","0000","1813","1435","378","292","2105","3841","0","54.8","37.36"
"10","009","00","013","1309","0021","518","398","120","89","607","1129","0","53.76","35.25"
"10","009","00","013","1309","0022","591","466","125","102","693","1241","0","55.84","37.55"
"10","009","00","013","1309","0023","704","571","133","101","805","1471","0","54.72","38.82"
"10","009","00","013","1310","0000","561","418","143","71","632","1107","0","57.09","37.76"
"10","009","00","013","1310","0024","561","418","143","71","632","1107","0","57.09","37.76"
"10","009","00","013","1311","0000","1577","1235","342","144","1721","3391","0","50.75","36.42"
"10","009","00","013","1311","0025","809","634","175","85","894","1636","0","54.65","38.75"
"10","009","00","013","1311","0026","768","601","167","59","827","1755","0","47.12","34.25"
"10","009","00","013","1312","0000","1038","850","188","78","1116","2114","0","52.79","40.21"
"10","009","00","013","1312","0027","563","462","101","40","603","1158","0","52.07","39.9"
"10","009","00","013","1312","0028","475","388","87","38","513","956","0","53.66","40.59"
"10","009","00","013","1313","0000","743","576","167","119","862","1469","0","58.68","39.21"
"10","009","00","013","1313","0016","743","576","167","119","862","1469","0","58.68","39.21"
"10","009","00","014","0000","0000","5614","4284","1330","843","6457","13239","14845","48.77","32.36"
"10","009","00","014","1401","0000","778","622","156","91","869","1533","0","56.69","40.57"
"10","009","00","014","1401","0055","778","622","156","91","869","1533","0","56.69","40.57"
"10","009","00","014","1402","0000","613","465","148","101","714","1203","0","59.35","38.65"
"10","009","00","014","1402","0056","613","465","148","101","714","1203","0","59.35","38.65"
"10","009","00","014","1403","0000","672","502","170","94","766","1624","0","47.17","30.91"
"10","009","00","014","1403","0053","338","249","89","35","373","896","0","41.63","27.79"
"10","009","00","014","1403","0054","334","253","81","59","393","728","0","53.98","34.75"
"10","009","00","014","1404","0000","290","223","67","36","326","540","0","60.37","41.3"
"10","009","00","014","1404","0052","290","223","67","36","326","540","0","60.37","41.3"
"10","009","00","014","1405","0000","477","365","112","59","536","1207","0","44.41","30.24"
"10","009","00","014","1405","0051","477","365","112","59","536","1207","0","44.41","30.24"
"10","009","00","014","1406","0000","291","230","61","34","325","546","0","59.52","42.12"
"10","009","00","014","1406","0058","291","230","61","34","325","546","0","59.52","42.12"
"10","009","00","014","1407","0000","321","240","81","69","390","817","0","47.74","29.38"
"10","009","00","014","1407","0057","321","240","81","69","390","817","0","47.74","29.38"
"10","009","00","014","1408","0000","291","208","83","69","360","856","0","42.06","24.3"
"10","009","00","014","1408","0060","291","208","83","69","360","856","0","42.06","24.3"
"10","009","00","014","1409","0000","361","259","102","77","438","853","0","51.35","30.36"
"10","009","00","014","1409","0059","361","259","102","77","438","853","0","51.35","30.36"
"10","009","00","014","1410","0000","814","614","200","112","926","1945","0","47.61","31.57"
"10","009","00","014","1410","0061","381","289","92","64","445","923","0","48.21","31.31"
"10","009","00","014","1410","0062","433","325","108","48","481","1022","0","47.06","31.8"
"10","009","00","014","1411","0000","360","279","81","45","405","1087","0","37.26","25.67"
"10","009","00","014","1411","0065","360","279","81","45","405","1087","0","37.26","25.67"
"10","009","00","014","1412","0000","346","277","69","56","402","1028","0","39.11","26.95"
"10","009","00","014","1412","0063","208","164","44","33","241","634","0","38.01","25.87"
"10","009","00","014","1412","0064","138","113","25","23","161","394","0","40.86","28.68"
"10","009","00","015","0000","0000","5146","3848","1298","550","5696","11381","12992","50.05","33.81"
"10","009","00","015","1501","0000","985","779","206","109","1094","1916","0","57.1","40.66"
"10","009","00","015","1501","0066","439","353","86","71","510","923","0","55.25","38.24"
"10","009","00","015","1501","0067","546","426","120","38","584","993","0","58.81","42.9"
"10","009","00","015","1502","0000","685","549","136","49","734","1450","0","50.62","37.86"
"10","009","00","015","1502","0068","357","287","70","34","391","748","0","52.27","38.37"
"10","009","00","015","1502","0069","328","262","66","15","343","702","0","48.86","37.32"
"10","009","00","015","1503","0000","709","569","140","51","760","1508","0","50.4","37.73"
"10","009","00","015","1503","0070","332","274","58","22","354","752","0","47.07","36.44"
"10","009","00","015","1503","0071","377","295","82","29","406","756","0","53.7","39.02"
"10","009","00","015","1504","0000","553","308","245","49","602","1207","0","49.88","25.52"
"10","009","00","015","1504","0074","212","162","50","19","231","470","0","49.15","34.47"
"10","009","00","015","1504","0075","341","146","195","30","371","737","0","50.34","19.81"
"10","009","00","015","1505","0000","624","471","153","53","677","1524","0","44.42","30.91"
"10","009","00","015","1505","0072","230","172","58","20","250","490","0","51.02","35.1"
"10","009","00","015","1505","0073","394","299","95","33","427","1034","0","41.3","28.92"
"10","009","00","015","1506","0000","396","305","91","41","437","878","0","49.77","34.74"
"10","009","00","015","1506","0076","396","305","91","41","437","878","0","49.77","34.74"
"10","009","00","015","1507","0000","330","257","73","60","390","778","0","50.13","33.03"
"10","009","00","015","1507","0077","330","257","73","60","390","778","0","50.13","33.03"
"10","009","00","015","1508","0000","523","374","149","63","586","1224","0","47.88","30.56"
"10","009","00","015","1508","0078","523","374","149","63","586","1224","0","47.88","30.56"
"10","009","00","015","1509","0000","341","236","105","75","416","896","0","46.43","26.34"
"10","009","00","015","1509","0079","341","236","105","75","416","896","0","46.43","26.34"
"10","009","00","016","0000","0000","8264","6431","1833","1227","9491","21125","23824","44.93","30.44"
"10","009","00","016","1601","0000","600","494","106","77","677","1238","0","54.68","39.9"
"10","009","00","016","1601","0029","600","494","106","77","677","1238","0","54.68","39.9"
"10","009","00","016","1602","0000","501","401","100","72","573","1098","0","52.19","36.52"
"10","009","00","016","1602","0031","501","401","100","72","573","1098","0","52.19","36.52"
"10","009","00","016","1603","0000","473","365","108","49","522","1091","0","47.85","33.46"
"10","009","00","016","1603","0030","473","365","108","49","522","1091","0","47.85","33.46"
"10","009","00","016","1604","0000","807","634","173","121","928","2073","0","44.77","30.58"
"10","009","00","016","1604","0032","393","300","93","44","437","1048","0","41.7","28.63"
"10","009","00","016","1604","0033","414","334","80","77","491","1025","0","47.9","32.59"
"10","009","00","016","1605","0000","539","401","138","102","641","1460","0","43.9","27.47"
"10","009","00","016","1605","0035","539","401","138","102","641","1460","0","43.9","27.47"
"10","009","00","016","1606","0000","553","418","135","122","675","1890","0","35.71","22.12"
"10","009","00","016","1606","0036","354","257","97","86","440","1180","0","37.29","21.78"
"10","009","00","016","1606","0037","199","161","38","36","235","710","0","33.1","22.68"
"10","009","00","016","1607","0000","202","153","49","11","213","620","0","34.35","24.68"
"10","009","00","016","1607","0038","202","153","49","11","213","620","0","34.35","24.68"
"10","009","00","016","1608","0000","225","170","55","52","277","687","0","40.32","24.75"
"10","009","00","016","1608","0040","225","170","55","52","277","687","0","40.32","24.75"
"10","009","00","016","1609","0000","180","130","50","33","213","449","0","47.44","28.95"
"10","009","00","016","1609","0039","180","130","50","33","213","449","0","47.44","28.95"
"10","009","00","016","1610","0000","375","297","78","55","430","850","0","50.59","34.94"
"10","009","00","016","1610","0034","375","297","78","55","430","850","0","50.59","34.94"
"10","009","00","016","1611","0000","635","487","148","101","736","1514","0","48.61","32.17"
"10","009","00","016","1611","0043","447","337","110","70","517","1042","0","49.62","32.34"
"10","009","00","016","1611","0044","188","150","38","31","219","472","0","46.4","31.78"
"10","009","00","016","1612","0000","508","420","88","35","543","1409","0","38.54","29.81"
"10","009","00","016","1612","0045","508","420","88","35","543","1409","0","38.54","29.81"
"10","009","00","016","1613","0000","1232","930","302","216","1448","3067","0","47.21","30.32"
"10","009","00","016","1613","0046","464","355","109","94","558","1061","0","52.59","33.46"
"10","009","00","016","1613","0047","358","276","82","40","398","993","0","40.08","27.79"
"10","009","00","016","1613","0048","410","299","111","82","492","1013","0","48.57","29.52"
"10","009","00","016","1614","0000","768","612","156","82","850","1849","0","45.97","33.1"
"10","009","00","016","1614","0049","534","433","101","52","586","1233","0","47.53","35.12"
"10","009","00","016","1614","0050","234","179","55","30","264","616","0","42.86","29.06"
"10","009","00","016","1615","0000","666","519","147","99","765","1830","0","41.8","28.36"
"10","009","00","016","1615","0041","482","366","116","77","559","1247","0","44.83","29.35"
"10","009","00","016","1615","0042","184","153","31","22","206","583","0","35.33","26.24"
"10","009","00","017","0000","0000","8402","6209","2193","1168","9570","22830","25784","41.92","27.2"
"10","009","00","017","1701","0000","1403","1059","344","119","1522","3349","0","45.45","31.62"
"10","009","00","017","1701","0180","404","299","105","40","444","915","0","48.52","32.68"
"10","009","00","017","1701","0181","532","401","131","35","567","1284","0","44.16","31.23"
"10","009","00","017","1701","0182","467","359","108","44","511","1150","0","44.43","31.22"
"10","009","00","017","1702","0000","598","456","142","113","711","1534","0","46.35","29.73"
"10","009","00","017","1702","0183","268","202","66","54","322","744","0","43.28","27.15"
"10","009","00","017","1702","0184","330","254","76","59","389","790","0","49.24","32.15"
"10","009","00","017","1703","0000","480","350","130","76","556","1356","0","41.0","25.81"
"10","009","00","017","1703","0185","480","350","130","76","556","1356","0","41.0","25.81"
"10","009","00","017","1704","0000","289","195","94","66","355","739","0","48.04","26.39"
"10","009","00","017","1704","0186","289","195","94","66","355","739","0","48.04","26.39"
"10","009","00","017","1705","0000","333","254","79","41","374","965","0","38.76","26.32"
"10","009","00","017","1705","0187","333","254","79","41","374","965","0","38.76","26.32"
"10","009","00","017","1706","0000","389","295","94","75","464","1080","0","42.96","27.31"
"10","009","00","017","1706","0188","389","295","94","75","464","1080","0","42.96","27.31"
"10","009","00","017","1707","0000","326","254","72","51","377","948","0","39.77","26.79"
"10","009","00","017","1707","0189","326","254","72","51","377","948","0","39.77","26.79"
"10","009","00","017","1708","0000","212","143","69","32","244","762","0","32.02","18.77"
"10","009","00","017","1708","0190","212","143","69","32","244","762","0","32.02","18.77"
"10","009","00","017","1709","0000","241","179","62","23","264","582","0","45.36","30.76"
"10","009","00","017","1709","0191","241","179","62","23","264","582","0","45.36","30.76"
"10","009","00","017","1710","0000","290","238","52","17","307","865","0","35.49","27.51"
"10","009","00","017","1710","0192","290","238","52","17","307","865","0","35.49","27.51"
"10","009","00","017","1711","0000","71","55","16","6","77","362","0","21.27","15.19"
"10","009","00","017","1711","0193","71","55","16","6","77","362","0","21.27","15.19"
"10","009","00","017","1712","0000","385","297","88","43","428","1162","0","36.83","25.56"
"10","009","00","017","1712","0194","385","297","88","43","428","1162","0","36.83","25.56"
"10","009","00","017","1713","0000","564","435","129","57","621","1527","0","40.67","28.49"
"10","009","00","017","1713","0195","564","435","129","57","621","1527","0","40.67","28.49"
"10","009","00","017","1714","0000","407","290","117","80","487","1006","0","48.41","28.83"
"10","009","00","017","1714","0196","407","290","117","80","487","1006","0","48.41","28.83"
"10","009","00","017","1715","0000","315","247","68","30","345","855","0","40.35","28.89"
"10","009","00","017","1715","0197","315","247","68","30","345","855","0","40.35","28.89"
"10","009","00","017","1716","0000","468","352","116","89","557","1181","0","47.16","29.81"
"10","009","00","017","1716","0198","468","352","116","89","557","1181","0","47.16","29.81"
"10","009","00","017","1717","0000","305","221","84","49","354","864","0","40.97","25.58"
"10","009","00","017","1717","0199","305","221","84","49","354","864","0","40.97","25.58"
"10","009","00","017","1718","0000","530","390","140","74","604","1545","0","39.09","25.24"
"10","009","00","017","1718","0200","223","157","66","41","264","667","0","39.58","23.54"
"10","009","00","017","1718","0201","307","233","74","33","340","878","0","38.72","26.54"
"10","009","00","017","1719","0000","159","39","120","12","171","610","0","28.03","6.39"
"10","009","00","017","1719","0202","159","39","120","12","171","610","0","28.03","6.39"
"10","009","00","017","1720","0000","328","227","101","71","399","837","0","47.67","27.12"
"10","009","00","017","1720","0203","328","227","101","71","399","837","0","47.67","27.12"
"10","009","00","017","1721","0000","309","233","76","44","353","701","0","50.36","33.24"
"10","009","00","017","1721","0204","309","233","76","44","353","701","0","50.36","33.24"
"10","009","00","018","0000","0000","6966","5308","1658","1030","7996","20983","23317","38.11","25.3"
"10","009","00","018","1801","0000","730","558","172","113","843","1758","0","47.95","31.74"
"10","009","00","018","1801","0155","415","321","94","64","479","1082","0","44.27","29.67"
"10","009","00","018","1801","0156","315","237","78","49","364","676","0","53.85","35.06"
"10","009","00","018","1802","0000","218","169","49","18","236","650","0","36.31","26.0"
"10","009","00","018","1802","0160","218","169","49","18","236","650","0","36.31","26.0"
"10","009","00","018","1803","0000","375","282","93","28","403","969","0","41.59","29.1"
"10","009","00","018","1803","0161","375","282","93","28","403","969","0","41.59","29.1"
"10","009","00","018","1804","0000","319","223","96","52","371","925","0","40.11","24.11"
"10","009","00","018","1804","0162","319","223","96","52","371","925","0","40.11","24.11"
"10","009","00","018","1805","0000","980","774","206","86","1066","2291","0","46.53","33.78"
"10","009","00","018","1805","0157","382","304","78","21","403","862","0","46.75","35.27"
"10","009","00","018","1805","0158","135","105","30","26","161","477","0","33.75","22.01"
"10","009","00","018","1805","0159","463","365","98","39","502","952","0","52.73","38.34"
"10","009","00","018","1806","0000","392","302","90","54","446","1219","0","36.59","24.77"
"10","009","00","018","1806","0165","392","302","90","54","446","1219","0","36.59","24.77"
"10","009","00","018","1807","0000","188","142","46","54","242","759","0","31.88","18.71"
"10","009","00","018","1807","0164","188","142","46","54","242","759","0","31.88","18.71"
"10","009","00","018","1808","0000","340","264","76","39","379","914","0","41.47","28.88"
"10","009","00","018","1808","0163","340","264","76","39","379","914","0","41.47","28.88"
"10","009","00","018","1809","0000","258","189","69","38","296","876","0","33.79","21.58"
"10","009","00","018","1809","0169","258","189","69","38","296","876","0","33.79","21.58"
"10","009","00","018","1810","0000","114","93","21","25","139","360","0","38.61","25.83"
"10","009","00","018","1810","0170","114","93","21","25","139","360","0","38.61","25.83"
"10","009","00","018","1811","0000","200","153","47","17","217","773","0","28.07","19.79"
"10","009","00","018","1811","0167","200","153","47","17","217","773","0","28.07","19.79"
"10","009","00","018","1812","0000","267","197","70","52","319","937","0","34.04","21.02"
"10","009","00","018","1812","0166","267","197","70","52","319","937","0","34.04","21.02"
"10","009","00","018","1813","0000","459","350","109","90","549","1718","0","31.96","20.37"
"10","009","00","018","1813","0171","218","164","54","45","263","885","0","29.72","18.53"
"10","009","00","018","1813","0172","241","186","55","45","286","833","0","34.33","22.33"
"10","009","00","018","1814","0000","278","206","72","44","322","785","0","41.02","26.24"
"10","009","00","018","1814","0173","278","206","72","44","322","785","0","41.02","26.24"
"10","009","00","018","1815","0000","287","226","61","49","336","705","0","47.66","32.06"
"10","009","00","018","1815","0174","287","226","61","49","336","705","0","47.66","32.06"
"10","009","00","018","1816","0000","253","203","50","28","281","927","0","30.31","21.9"
"10","009","00","018","1816","0175","253","203","50","28","281","927","0","30.31","21.9"
"10","009","00","018","1817","0000","346","244","102","59","405","1071","0","37.82","22.78"
"10","009","00","018","1817","0177","346","244","102","59","405","1071","0","37.82","22.78"
"10","009","00","018","1818","0000","248","200","48","20","268","1022","0","26.22","19.57"
"10","009","00","018","1818","0178","248","200","48","20","268","1022","0","26.22","19.57"
"10","009","00","018","1819","0000","239","181","58","38","277","711","0","38.96","25.46"
"10","009","00","018","1819","0179","239","181","58","38","277","711","0","38.96","25.46"
"10","009","00","018","1820","0000","173","128","45","52","225","555","0","40.54","23.06"
"10","009","00","018","1820","0168","173","128","45","52","225","555","0","40.54","23.06"
"10","009","00","018","1821","0000","302","224","78","74","376","1058","0","35.54","21.17"
"10","009","00","018","1821","0176","302","224","78","74","376","1058","0","35.54","21.17"
"10","009","00","019","0000","0000","9593","7175","2418","1543","11136","24193","27383","46.03","29.66"
"10","009","00","019","1901","0000","558","433","125","108","666","1225","0","54.37","35.35"
"10","009","00","019","1901","0206","558","433","125","108","666","1225","0","54.37","35.35"
"10","009","00","019","1902","0000","509","373","136","66","575","1134","0","50.71","32.89"
"10","009","00","019","1902","0205","509","373","136","66","575","1134","0","50.71","32.89"
"10","009","00","019","1903","0000","227","162","65","45","272","647","0","42.04","25.04"
"10","009","00","019","1903","0207","227","162","65","45","272","647","0","42.04","25.04"
"10","009","00","019","1904","0000","333","230","103","94","427","900","0","47.44","25.56"
"10","009","00","019","1904","0209","333","230","103","94","427","900","0","47.44","25.56"
"10","009","00","019","1905","0000","303","221","82","35","338","709","0","47.67","31.17"
"10","009","00","019","1905","0208","303","221","82","35","338","709","0","47.67","31.17"
"10","009","00","019","1906","0000","416","316","100","76","492","1011","0","48.66","31.26"
"10","009","00","019","1906","0210","416","316","100","76","492","1011","0","48.66","31.26"
"10","009","00","019","1907","0000","488","350","138","37","525","1437","0","36.53","24.36"
"10","009","00","019","1907","0211","488","350","138","37","525","1437","0","36.53","24.36"
"10","009","00","019","1908","0000","647","489","158","48","695","2041","0","34.05","23.96"
"10","009","00","019","1908","0212","235","180","55","10","245","848","0","28.89","21.23"
"10","009","00","019","1908","0213","412","309","103","38","450","1193","0","37.72","25.9"
"10","009","00","019","1909","0000","543","398","145","111","654","1574","0","41.55","25.29"
"10","009","00","019","1909","0214","226","172","54","62","288","759","0","37.94","22.66"
"10","009","00","019","1909","0215","317","226","91","49","366","815","0","44.91","27.73"
"10","009","00","019","1910","0000","606","451","155","98","704","1460","0","48.22","30.89"
"10","009","00","019","1910","0216","606","451","155","98","704","1460","0","48.22","30.89"
"10","009","00","019","1911","0000","153","96","57","10","163","556","0","29.32","17.27"
"10","009","00","019","1911","0217","153","96","57","10","163","556","0","29.32","17.27"
"10","009","00","019","1912","0000","627","507","120","59","686","1532","0","44.78","33.09"
"10","009","00","019","1912","0218","627","507","120","59","686","1532","0","44.78","33.09"
"10","009","00","019","1913","0000","336","266","70","23","359","847","0","42.38","31.4"
"10","009","00","019","1913","0219","336","266","70","23","359","847","0","42.38","31.4"
"10","009","00","019","1914","0000","797","597","200","217","1014","1882","0","53.88","31.72"
"10","009","00","019","1914","0220","153","125","28","29","182","374","0","48.66","33.42"
"10","009","00","019","1914","0221","644","472","172","188","832","1508","0","55.17","31.3"
"10","009","00","019","1915","0000","438","345","93","84","522","951","0","54.89","36.28"
"10","009","00","019","1915","0222","438","345","93","84","522","951","0","54.89","36.28"
"10","009","00","019","1916","0000","335","232","103","33","368","1006","0","36.58","23.06"
"10","009","00","019","1916","0228","335","232","103","33","368","1006","0","36.58","23.06"
"10","009","00","019","1917","0000","405","318","87","57","462","952","0","48.53","33.4"
"10","009","00","019","1917","0226","405","318","87","57","462","952","0","48.53","33.4"
"10","009","00","019","1918","0000","332","238","94","57","389","720","0","54.03","33.06"
"10","009","00","019","1918","0227","332","238","94","57","389","720","0","54.03","33.06"
"10","009","00","019","1919","0000","887","651","236","144","1031","1789","0","57.63","36.39"
"10","009","00","019","1919","0223","436","310","126","89","525","910","0","57.69","34.07"
"10","009","00","019","1919","0224","451","341","110","55","506","879","0","57.57","38.79"
"10","009","00","019","1920","0000","457","352","105","130","587","1213","0","48.39","29.02"
"10","009","00","019","1920","0225","457","352","105","130","587","1213","0","48.39","29.02"
"10","009","00","019","1921","0000","196","150","46","11","207","607","0","34.1","24.71"
"10","009","00","019","1921","0229","196","150","46","11","207","607","0","34.1","24.71"
"10","009","00","020","0000","0000","8326","6252","2074","1211","9537","22508","25426","42.37","27.78"
"10","009","00","020","2001","0000","913","695","218","91","1004","2242","0","44.78","31.0"
"10","009","00","020","2001","0230","528","396","132","74","602","1355","0","44.43","29.23"
"10","009","00","020","2001","0231","385","299","86","17","402","887","0","45.32","33.71"
"10","009","00","020","2002","0000","979","712","267","82","1061","1997","0","53.13","35.65"
"10","009","00","020","2002","0232","644","478","166","66","710","1234","0","57.54","38.74"
"10","009","00","020","2002","0233","335","234","101","16","351","763","0","46.0","30.67"
"10","009","00","020","2003","0000","425","327","98","69","494","1022","0","48.34","32.0"
"10","009","00","020","2003","0253","425","327","98","69","494","1022","0","48.34","32.0"
"10","009","00","020","2004","0000","429","349","80","39","468","1191","0","39.29","29.3"
"10","009","00","020","2004","0254","429","349","80","39","468","1191","0","39.29","29.3"
"10","009","00","020","2005","0000","397","280","117","94","491","1006","0","48.81","27.83"
"10","009","00","020","2005","0240","397","280","117","94","491","1006","0","48.81","27.83"
"10","009","00","020","2006","0000","250","196","54","8","258","651","0","39.63","30.11"
"10","009","00","020","2006","0241","250","196","54","8","258","651","0","39.63","30.11"
"10","009","00","020","2007","0000","205","163","42","28","233","607","0","38.39","26.85"
"10","009","00","020","2007","0242","205","163","42","28","233","607","0","38.39","26.85"
"10","009","00","020","2008","0000","361","259","102","68","429","1033","0","41.53","25.07"
"10","009","00","020","2008","0243","361","259","102","68","429","1033","0","41.53","25.07"
"10","009","00","020","2009","0000","181","140","41","15","196","631","0","31.06","22.19"
"10","009","00","020","2009","0244","181","140","41","15","196","631","0","31.06","22.19"
"10","009","00","020","2010","0000","343","254","89","61","404","961","0","42.04","26.43"
"10","009","00","020","2010","0245","343","254","89","61","404","961","0","42.04","26.43"
"10","009","00","020","2011","0000","257","180","77","49","306","721","0","42.44","24.97"
"10","009","00","020","2011","0234","257","180","77","49","306","721","0","42.44","24.97"
"10","009","00","020","2012","0000","210","164","46","15","225","647","0","34.78","25.35"
"10","009","00","020","2012","0235","210","164","46","15","225","647","0","34.78","25.35"
"10","009","00","020","2013","0000","346","268","78","25","371","1081","0","34.32","24.79"
"10","009","00","020","2013","0238","346","268","78","25","371","1081","0","34.32","24.79"
"10","009","00","020","2014","0000","368","280","88","62","430","989","0","43.48","28.31"
"10","009","00","020","2014","0236","368","280","88","62","430","989","0","43.48","28.31"
"10","009","00","020","2015","0000","268","197","71","39","307","837","0","36.68","23.54"
"10","009","00","020","2015","0237","268","197","71","39","307","837","0","36.68","23.54"
"10","009","00","020","2016","0000","332","238","94","87","419","951","0","44.06","25.03"
"10","009","00","020","2016","0246","332","238","94","87","419","951","0","44.06","25.03"
"10","009","00","020","2017","0000","323","240","83","37","360","838","0","42.96","28.64"
"10","009","00","020","2017","0247","323","240","83","37","360","838","0","42.96","28.64"
"10","009","00","020","2018","0000","395","297","98","105","500","1055","0","47.39","28.15"
"10","009","00","020","2018","0248","395","297","98","105","500","1055","0","47.39","28.15"
"10","009","00","020","2019","0000","142","114","28","28","170","512","0","33.2","22.27"
"10","009","00","020","2019","0249","142","114","28","28","170","512","0","33.2","22.27"
"10","009","00","020","2020","0000","212","167","45","19","231","671","0","34.43","24.89"
"10","009","00","020","2020","0250","212","167","45","19","231","671","0","34.43","24.89"
"10","009","00","020","2021","0000","164","113","51","47","211","693","0","30.45","16.31"
"10","009","00","020","2021","0251","164","113","51","47","211","693","0","30.45","16.31"
"10","009","00","020","2022","0000","191","143","48","48","239","689","0","34.69","20.75"
"10","009","00","020","2022","0252","191","143","48","48","239","689","0","34.69","20.75"
"10","009","00","020","2023","0000","271","196","75","45","316","704","0","44.89","27.84"
"10","009","00","020","2023","0239","271","196","75","45","316","704","0","44.89","27.84"
"10","009","00","020","2024","0000","364","280","84","50","414","779","0","53.15","35.94"
"10","009","00","020","2024","0255","364","280","84","50","414","779","0","53.15","35.94"
"10","010","00","000","0000","0000","197411","149984","47427","22181","219592","442775","507780","49.59","33.87"
"10","010","00","001","0000","0000","14971","11386","3585","1457","16428","31568","38048","52.04","36.07"
"10","010","00","001","0101","0000","1135","887","248","118","1253","2286","0","54.81","38.8"
"10","010","00","001","0101","0001","604","464","140","74","678","1210","0","56.03","38.35"
"10","010","00","001","0101","0002","531","423","108","44","575","1076","0","53.44","39.31"
"10","010","00","001","0102","0000","210","159","51","26","236","488","0","48.36","32.58"
"10","010","00","001","0102","0003","210","159","51","26","236","488","0","48.36","32.58"
"10","010","00","001","0103","0000","645","477","168","64","709","1475","0","48.07","32.34"
"10","010","00","001","0103","0004","645","477","168","64","709","1475","0","48.07","32.34"
"10","010","00","001","0104","0000","717","543","174","79","796","1673","0","47.58","32.46"
"10","010","00","001","0104","0005","321","251","70","36","357","790","0","45.19","31.77"
"10","010","00","001","0104","0006","396","292","104","43","439","883","0","49.72","33.07"
"10","010","00","001","0105","0000","508","417","91","46","554","1147","0","48.3","36.36"
"10","010","00","001","0105","0007","359","296","63","41","400","758","0","52.77","39.05"
"10","010","00","001","0105","0008","149","121","28","5","154","389","0","39.59","31.11"
"10","010","00","001","0106","0000","458","344","114","56","514","1101","0","46.68","31.24"
"10","010","00","001","0106","0009","458","344","114","56","514","1101","0","46.68","31.24"
"10","010","00","001","0107","0000","396","300","96","18","414","853","0","48.53","35.17"
"10","010","00","001","0107","0010","396","300","96","18","414","853","0","48.53","35.17"
"10","010","00","001","0108","0000","807","642","165","46","853","1692","0","50.41","37.94"
"10","010","00","001","0108","0014","393","305","88","27","420","913","0","46.0","33.41"
"10","010","00","001","0108","0015","414","337","77","19","433","779","0","55.58","43.26"
"10","010","00","001","0109","0000","606","428","178","96","702","1278","0","54.93","33.49"
"10","010","00","001","0109","0016","606","428","178","96","702","1278","0","54.93","33.49"
"10","010","00","001","0110","0000","1092","827","265","72","1164","2392","0","48.66","34.57"
"10","010","00","001","0110","0017","343","257","86","42","385","819","0","47.01","31.38"
"10","010","00","001","0110","0018","749","570","179","30","779","1573","0","49.52","36.24"
"10","010","00","001","0111","0000","372","291","81","30","402","726","0","55.37","40.08"
"10","010","00","001","0111","0019","236","181","55","25","261","481","0","54.26","37.63"
"10","010","00","001","0111","0020","136","110","26","5","141","245","0","57.55","44.9"
"10","010","00","001","0112","0000","256","187","69","31","287","575","0","49.91","32.52"
"10","010","00","001","0112","0021","147","105","42","22","169","317","0","53.31","33.12"
"10","010","00","001","0112","0022","109","82","27","9","118","258","0","45.74","31.78"
"10","010","00","001","0113","0000","1677","1252","425","140","1817","3333","0","54.52","37.56"
"10","010","00","001","0113","0023","276","205","71","57","333","611","0","54.5","33.55"
"10","010","00","001","0113","0024","782","582","200","53","835","1526","0","54.72","38.14"
"10","010","00","001","0113","0025","619","465","154","30","649","1196","0","54.26","38.88"
"10","010","00","001","0114","0000","2224","1653","571","230","2454","4467","0","54.94","37.0"
"10","010","00","001","0114","0026","739","528","211","97","836","1536","0","54.43","34.38"
"10","010","00","001","0114","0027","746","551","195","81","827","1481","0","55.84","37.2"
"10","010","00","001","0114","0028","739","574","165","52","791","1450","0","54.55","39.59"
"10","010","00","001","0115","0000","829","606","223","60","889","1829","0","48.61","33.13"
"10","010","00","001","0115","0029","365","272","93","23","388","840","0","46.19","32.38"
"10","010","00","001","0115","0030","464","334","130","37","501","989","0","50.66","33.77"
"10","010","00","001","0116","0000","1486","1140","346","204","1690","3040","0","55.59","37.5"
"10","010","00","001","0116","0031","736","576","160","109","845","1529","0","55.26","37.67"
"10","010","00","001","0116","0032","750","564","186","95","845","1511","0","55.92","37.33"
"10","010","00","001","0117","0000","279","211","68","40","319","697","0","45.77","30.27"
"10","010","00","001","0117","0033","279","211","68","40","319","697","0","45.77","30.27"
"10","010","00","001","0118","0000","1274","1022","252","101","1375","2516","0","54.65","40.62"
"10","010","00","001","0118","0011","77","54","23","15","92","224","0","41.07","24.11"
"10","010","00","001","0118","0012","263","198","65","55","318","662","0","48.04","29.91"
"10","010","00","001","0118","0013","934","770","164","31","965","1630","0","59.2","47.24"
"10","010","00","002","0000","0000","16242","12495","3747","1655","17897","35191","42143","50.86","35.51"
"10","010","00","002","0201","0000","961","726","235","96","1057","1938","0","54.54","37.46"
"10","010","00","002","0201","0233","593","469","124","51","644","1183","0","54.44","39.64"
"10","010","00","002","0201","0234","368","257","111","45","413","755","0","54.7","34.04"
"10","010","00","002","0202","0000","1205","958","247","108","1313","2331","0","56.33","41.1"
"10","010","00","002","0202","0235","629","504","125","40","669","1253","0","53.39","40.22"
"10","010","00","002","0202","0236","576","454","122","68","644","1078","0","59.74","42.12"
"10","010","00","002","0203","0000","615","454","161","70","685","1117","0","61.32","40.64"
"10","010","00","002","0203","0237","615","454","161","70","685","1117","0","61.32","40.64"
"10","010","00","002","0204","0000","214","153","61","16","230","387","0","59.43","39.53"
"10","010","00","002","0204","0238","214","153","61","16","230","387","0","59.43","39.53"
"10","010","00","002","0205","0000","312","245","67","47","359","633","0","56.71","38.7"
"10","010","00","002","0205","0239","312","245","67","47","359","633","0","56.71","38.7"
"10","010","00","002","0206","0000","333","297","36","27","360","650","0","55.38","45.69"
"10","010","00","002","0206","0240","333","297","36","27","360","650","0","55.38","45.69"
"10","010","00","002","0207","0000","471","371","100","46","517","825","0","62.67","44.97"
"10","010","00","002","0207","0241","471","371","100","46","517","825","0","62.67","44.97"
"10","010","00","002","0208","0000","889","703","186","104","993","1750","0","56.74","40.17"
"10","010","00","002","0208","0242","394","310","84","52","446","810","0","55.06","38.27"
"10","010","00","002","0208","0243","495","393","102","52","547","940","0","58.19","41.81"
"10","010","00","002","0209","0000","1147","864","283","103","1250","2510","0","49.8","34.42"
"10","010","00","002","0209","0244","434","326","108","52","486","905","0","53.7","36.02"
"10","010","00","002","0209","0245","713","538","175","51","764","1605","0","47.6","33.52"
"10","010","00","002","0210","0000","2218","1690","528","181","2399","4193","0","57.21","40.31"
"10","010","00","002","0210","0246","777","587","190","66","843","1479","0","57.0","39.69"
"10","010","00","002","0210","0247","639","479","160","60","699","1218","0","57.39","39.33"
"10","010","00","002","0210","0248","802","624","178","55","857","1496","0","57.29","41.71"
"10","010","00","002","0211","0000","302","218","84","34","336","667","0","50.37","32.68"
"10","010","00","002","0211","0249","302","218","84","34","336","667","0","50.37","32.68"
"10","010","00","002","0212","0000","220","160","60","24","244","627","0","38.92","25.52"
"10","010","00","002","0212","0250","220","160","60","24","244","627","0","38.92","25.52"
"10","010","00","002","0213","0000","341","267","74","54","395","791","0","49.94","33.75"
"10","010","00","002","0213","0251","341","267","74","54","395","791","0","49.94","33.75"
"10","010","00","002","0214","0000","467","346","121","106","573","1034","0","55.42","33.46"
"10","010","00","002","0214","0252","467","346","121","106","573","1034","0","55.42","33.46"
"10","010","00","002","0215","0000","773","610","163","25","798","1710","0","46.67","35.67"
"10","010","00","002","0215","0253","773","610","163","25","798","1710","0","46.67","35.67"
"10","010","00","002","0216","0000","1278","1027","251","89","1367","3218","0","42.48","31.91"
"10","010","00","002","0216","0254","708","573","135","44","752","1671","0","45.0","34.29"
"10","010","00","002","0216","0255","570","454","116","45","615","1547","0","39.75","29.35"
"10","010","00","002","0217","0000","1277","1009","268","99","1376","2904","0","47.38","34.75"
"10","010","00","002","0217","0256","570","430","140","70","640","1602","0","39.95","26.84"
"10","010","00","002","0217","0257","707","579","128","29","736","1302","0","56.53","44.47"
"10","010","00","002","0218","0000","327","245","82","49","376","740","0","50.81","33.11"
"10","010","00","002","0218","0258","327","245","82","49","376","740","0","50.81","33.11"
"10","010","00","002","0219","0000","556","429","127","63","619","1054","0","58.73","40.7"
"10","010","00","002","0219","0259","556","429","127","63","619","1054","0","58.73","40.7"
"10","010","00","002","0220","0000","330","246","84","17","347","907","0","38.26","27.12"
"10","010","00","002","0220","0260","330","246","84","17","347","907","0","38.26","27.12"
"10","010","00","002","0221","0000","120","85","35","26","146","251","0","58.17","33.86"
"10","010","00","002","0221","0262","120","85","35","26","146","251","0","58.17","33.86"
"10","010","00","002","0222","0000","273","195","78","33","306","720","0","42.5","27.08"
"10","010","00","002","0222","0261","273","195","78","33","306","720","0","42.5","27.08"
"10","010","00","002","0223","0000","272","182","90","62","334","767","0","43.55","23.73"
"10","010","00","002","0223","0263","272","182","90","62","334","767","0","43.55","23.73"
"10","010","00","002","0224","0000","345","256","89","44","389","702","0","55.41","36.47"
"10","010","00","002","0224","0264","345","256","89","44","389","702","0","55.41","36.47"
"10","010","00","002","0225","0000","430","320","110","56","486","1038","0","46.82","30.83"
"10","010","00","002","0225","0265","430","320","110","56","486","1038","0","46.82","30.83"
"10","010","00","002","0226","0000","355","276","79","30","385","1228","0","31.35","22.48"
"10","010","00","002","0226","0266","355","276","79","30","385","1228","0","31.35","22.48"
"10","010","00","002","0227","0000","211","163","48","46","257","499","0","51.5","32.67"
"10","010","00","002","0227","0267","211","163","48","46","257","499","0","51.5","32.67"
"10","010","00","003","0000","0000","10100","7715","2385","1333","11433","23965","26846","47.71","32.19"
"10","010","00","003","0301","0000","261","207","54","31","292","614","0","47.56","33.71"
"10","010","00","003","0301","0325","261","207","54","31","292","614","0","47.56","33.71"
"10","010","00","003","0302","0000","151","115","36","16","167","372","0","44.89","30.91"
"10","010","00","003","0302","0326","151","115","36","16","167","372","0","44.89","30.91"
"10","010","00","003","0303","0000","958","729","229","184","1142","2112","0","54.07","34.52"
"10","010","00","003","0303","0327","414","313","101","91","505","914","0","55.25","34.25"
"10","010","00","003","0303","0328","544","416","128","93","637","1198","0","53.17","34.72"
"10","010","00","003","0304","0000","450","343","107","74","524","1113","0","47.08","30.82"
"10","010","00","003","0304","0329","450","343","107","74","524","1113","0","47.08","30.82"
"10","010","00","003","0305","0000","776","614","162","92","868","1681","0","51.64","36.53"
"10","010","00","003","0305","0330","465","367","98","80","545","992","0","54.94","37.0"
"10","010","00","003","0305","0331","311","247","64","12","323","689","0","46.88","35.85"
"10","010","00","003","0306","0000","394","291","103","72","466","882","0","52.83","32.99"
"10","010","00","003","0306","0332","394","291","103","72","466","882","0","52.83","32.99"
"10","010","00","003","0307","0000","339","262","77","40","379","731","0","51.85","35.84"
"10","010","00","003","0307","0333","339","262","77","40","379","731","0","51.85","35.84"
"10","010","00","003","0308","0000","383","297","86","35","418","779","0","53.66","38.13"
"10","010","00","003","0308","0334","383","297","86","35","418","779","0","53.66","38.13"
"10","010","00","003","0309","0000","404","324","80","47","451","953","0","47.32","34.0"
"10","010","00","003","0309","0349","404","324","80","47","451","953","0","47.32","34.0"
"10","010","00","003","0310","0000","608","436","172","80","688","1292","0","53.25","33.75"
"10","010","00","003","0310","0350","608","436","172","80","688","1292","0","53.25","33.75"
"10","010","00","003","0311","0000","1069","810","259","108","1177","2371","0","49.64","34.16"
"10","010","00","003","0311","0351","524","410","114","77","601","1127","0","53.33","36.38"
"10","010","00","003","0311","0352","545","400","145","31","576","1244","0","46.3","32.15"
"10","010","00","003","0312","0000","425","305","120","25","450","1106","0","40.69","27.58"
"10","010","00","003","0312","0353","425","305","120","25","450","1106","0","40.69","27.58"
"10","010","00","003","0313","0000","473","374","99","61","534","1145","0","46.64","32.66"
"10","010","00","003","0313","0342","473","374","99","61","534","1145","0","46.64","32.66"
"10","010","00","003","0314","0000","793","612","181","74","867","1894","0","45.78","32.31"
"10","010","00","003","0314","0343","378","292","86","36","414","936","0","44.23","31.2"
"10","010","00","003","0314","0344","415","320","95","38","453","958","0","47.29","33.4"
"10","010","00","003","0315","0000","121","95","26","14","135","298","0","45.3","31.88"
"10","010","00","003","0315","0345","121","95","26","14","135","298","0","45.3","31.88"
"10","010","00","003","0316","0000","207","167","40","37","244","428","0","57.01","39.02"
"10","010","00","003","0316","0346","207","167","40","37","244","428","0","57.01","39.02"
"10","010","00","003","0317","0000","92","72","20","8","100","295","0","33.9","24.41"
"10","010","00","003","0317","0347","47","38","9","4","51","121","0","42.15","31.4"
"10","010","00","003","0317","0348","45","34","11","4","49","174","0","28.16","19.54"
"10","010","00","003","0318","0000","301","233","68","39","340","762","0","44.62","30.58"
"10","010","00","003","0318","0335","301","233","68","39","340","762","0","44.62","30.58"
"10","010","00","003","0319","0000","468","371","97","48","516","1184","0","43.58","31.33"
"10","010","00","003","0319","0336","468","371","97","48","516","1184","0","43.58","31.33"
"10","010","00","003","0320","0000","460","346","114","71","531","1351","0","39.3","25.61"
"10","010","00","003","0320","0338","460","346","114","71","531","1351","0","39.3","25.61"
"10","010","00","003","0321","0000","482","362","120","76","558","1423","0","39.21","25.44"
"10","010","00","003","0321","0337","482","362","120","76","558","1423","0","39.21","25.44"
"10","010","00","003","0322","0000","206","146","60","17","223","518","0","43.05","28.19"
"10","010","00","003","0322","0339","108","81","27","5","113","275","0","41.09","29.45"
"10","010","00","003","0322","0340","98","65","33","12","110","243","0","45.27","26.75"
"10","010","00","003","0323","0000","279","204","75","84","363","661","0","54.92","30.86"
"10","010","00","003","0323","0341","279","204","75","84","363","661","0","54.92","30.86"
"10","010","00","004","0000","0000","12439","9524","2915","1139","13578","26922","30954","50.43","35.38"
"10","010","00","004","0401","0000","229","160","69","36","265","483","0","54.87","33.13"
"10","010","00","004","0401","0169","229","160","69","36","265","483","0","54.87","33.13"
"10","010","00","004","0402","0000","944","733","211","68","1012","1823","0","55.51","40.21"
"10","010","00","004","0402","0170","944","733","211","68","1012","1823","0","55.51","40.21"
"10","010","00","004","0403","0000","495","386","109","17","512","955","0","53.61","40.42"
"10","010","00","004","0403","0171","495","386","109","17","512","955","0","53.61","40.42"
"10","010","00","004","0404","0000","2902","2220","682","225","3127","5874","0","53.23","37.79"
"10","010","00","004","0404","0172","682","519","163","34","716","1436","0","49.86","36.14"
"10","010","00","004","0404","0173","650","483","167","60","710","1390","0","51.08","34.75"
"10","010","00","004","0404","0174","764","589","175","79","843","1512","0","55.75","38.96"
"10","010","00","004","0404","0175","806","629","177","52","858","1536","0","55.86","40.95"
"10","010","00","004","0405","0000","510","405","105","38","548","1165","0","47.04","34.76"
"10","010","00","004","0405","0176","510","405","105","38","548","1165","0","47.04","34.76"
"10","010","00","004","0406","0000","940","708","232","79","1019","1730","0","58.9","40.92"
"10","010","00","004","0406","0177","940","708","232","79","1019","1730","0","58.9","40.92"
"10","010","00","004","0407","0000","226","169","57","15","241","602","0","40.03","28.07"
"10","010","00","004","0407","0178","226","169","57","15","241","602","0","40.03","28.07"
"10","010","00","004","0408","0000","294","212","82","66","360","716","0","50.28","29.61"
"10","010","00","004","0408","0179","294","212","82","66","360","716","0","50.28","29.61"
"10","010","00","004","0409","0000","196","153","43","9","205","625","0","32.8","24.48"
"10","010","00","004","0409","0180","196","153","43","9","205","625","0","32.8","24.48"
"10","010","00","004","0410","0000","67","55","12","1","68","193","0","35.23","28.5"
"10","010","00","004","0410","0181","67","55","12","1","68","193","0","35.23","28.5"
"10","010","00","004","0411","0000","681","495","186","70","751","1642","0","45.74","30.15"
"10","010","00","004","0411","0182","681","495","186","70","751","1642","0","45.74","30.15"
"10","010","00","004","0412","0000","697","540","157","62","759","1465","0","51.81","36.86"
"10","010","00","004","0412","0183","697","540","157","62","759","1465","0","51.81","36.86"
"10","010","00","004","0413","0000","497","391","106","72","569","1289","0","44.14","30.33"
"10","010","00","004","0413","0184","361","284","77","49","410","928","0","44.18","30.6"
"10","010","00","004","0413","0185","136","107","29","23","159","361","0","44.04","29.64"
"10","010","00","004","0414","0000","323","243","80","21","344","814","0","42.26","29.85"
"10","010","00","004","0414","0186","323","243","80","21","344","814","0","42.26","29.85"
"10","010","00","004","0415","0000","681","524","157","38","719","1579","0","45.54","33.19"
"10","010","00","004","0415","0187","681","524","157","38","719","1579","0","45.54","33.19"
"10","010","00","004","0416","0000","952","734","218","94","1046","2041","0","51.25","35.96"
"10","010","00","004","0416","0188","952","734","218","94","1046","2041","0","51.25","35.96"
"10","010","00","004","0417","0000","420","327","93","54","474","931","0","50.91","35.12"
"10","010","00","004","0417","0189","420","327","93","54","474","931","0","50.91","35.12"
"10","010","00","004","0418","0000","303","233","70","41","344","675","0","50.96","34.52"
"10","010","00","004","0418","0190","303","233","70","41","344","675","0","50.96","34.52"
"10","010","00","004","0419","0000","280","225","55","29","309","655","0","47.18","34.35"
"10","010","00","004","0419","0191","280","225","55","29","309","655","0","47.18","34.35"
"10","010","00","004","0420","0000","364","281","83","42","406","833","0","48.74","33.73"
"10","010","00","004","0420","0192","364","281","83","42","406","833","0","48.74","33.73"
"10","010","00","004","0421","0000","438","330","108","62","500","832","0","60.1","39.66"
"10","010","00","004","0421","0193","438","330","108","62","500","832","0","60.1","39.66"
"10","010","00","005","0000","0000","29462","22263","7199","3013","32475","61209","71327","53.06","36.37"
"10","010","00","005","0501","0000","1160","894","266","91","1251","2297","0","54.46","38.92"
"10","010","00","005","0501","0093","674","528","146","53","727","1267","0","57.38","41.67"
"10","010","00","005","0501","0094","486","366","120","38","524","1030","0","50.87","35.53"
"10","010","00","005","0502","0000","850","732","118","89","939","1590","0","59.06","46.04"
"10","010","00","005","0502","0095","850","732","118","89","939","1590","0","59.06","46.04"
"10","010","00","005","0503","0000","1654","1254","400","118","1772","3391","0","52.26","36.98"
"10","010","00","005","0503","0096","773","610","163","40","813","1673","0","48.6","36.46"
"10","010","00","005","0503","0097","881","644","237","78","959","1718","0","55.82","37.49"
"10","010","00","005","0504","0000","1096","851","245","111","1207","2140","0","56.4","39.77"
"10","010","00","005","0504","0098","564","443","121","50","614","1040","0","59.04","42.6"
"10","010","00","005","0504","0099","532","408","124","61","593","1100","0","53.91","37.09"
"10","010","00","005","0505","0000","726","570","156","72","798","1559","0","51.19","36.56"
"10","010","00","005","0505","0100","726","570","156","72","798","1559","0","51.19","36.56"
"10","010","00","005","0506","0000","857","639","218","81","938","1862","0","50.38","34.32"
"10","010","00","005","0506","0101","857","639","218","81","938","1862","0","50.38","34.32"
"10","010","00","005","0507","0000","736","558","178","72","808","1435","0","56.31","38.89"
"10","010","00","005","0507","0102","736","558","178","72","808","1435","0","56.31","38.89"
"10","010","00","005","0508","0000","757","532","225","158","915","1751","0","52.26","30.38"
"10","010","00","005","0508","0103","757","532","225","158","915","1751","0","52.26","30.38"
"10","010","00","005","0509","0000","459","358","101","61","520","933","0","55.73","38.37"
"10","010","00","005","0509","0104","459","358","101","61","520","933","0","55.73","38.37"
"10","010","00","005","0510","0000","455","313","142","62","517","827","0","62.52","37.85"
"10","010","00","005","0510","0105","455","313","142","62","517","827","0","62.52","37.85"
"10","010","00","005","0511","0000","335","258","77","57","392","843","0","46.5","30.6"
"10","010","00","005","0511","0106","335","258","77","57","392","843","0","46.5","30.6"
"10","010","00","005","0512","0000","1032","768","264","87","1119","2159","0","51.83","35.57"
"10","010","00","005","0512","0107","871","650","221","66","937","1774","0","52.82","36.64"
"10","010","00","005","0512","0108","161","118","43","21","182","385","0","47.27","30.65"
"10","010","00","005","0513","0000","692","512","180","56","748","1306","0","57.27","39.2"
"10","010","00","005","0513","0109","692","512","180","56","748","1306","0","57.27","39.2"
"10","010","00","005","0514","0000","275","206","69","45","320","535","0","59.81","38.5"
"10","010","00","005","0514","0110","275","206","69","45","320","535","0","59.81","38.5"
"10","010","00","005","0515","0000","523","402","121","89","612","1055","0","58.01","38.1"
"10","010","00","005","0515","0111","523","402","121","89","612","1055","0","58.01","38.1"
"10","010","00","005","0516","0000","847","627","220","107","954","1875","0","50.88","33.44"
"10","010","00","005","0516","0127","847","627","220","107","954","1875","0","50.88","33.44"
"10","010","00","005","0517","0000","1343","1002","341","124","1467","2746","0","53.42","36.49"
"10","010","00","005","0517","0128","676","506","170","53","729","1305","0","55.86","38.77"
"10","010","00","005","0517","0129","667","496","171","71","738","1441","0","51.21","34.42"
"10","010","00","005","0518","0000","990","731","259","123","1113","2004","0","55.54","36.48"
"10","010","00","005","0518","0132","990","731","259","123","1113","2004","0","55.54","36.48"
"10","010","00","005","0519","0000","1274","972","302","117","1391","2430","0","57.24","40.0"
"10","010","00","005","0519","0133","725","557","168","69","794","1354","0","58.64","41.14"
"10","010","00","005","0519","0134","549","415","134","48","597","1076","0","55.48","38.57"
"10","010","00","005","0520","0000","1687","1284","403","213","1900","3606","0","52.69","35.61"
"10","010","00","005","0520","0135","786","573","213","124","910","1629","0","55.86","35.17"
"10","010","00","005","0520","0136","901","711","190","89","990","1977","0","50.08","35.96"
"10","010","00","005","0521","0000","598","405","193","86","684","1295","0","52.82","31.27"
"10","010","00","005","0521","0137","598","405","193","86","684","1295","0","52.82","31.27"
"10","010","00","005","0522","0000","2387","1791","596","218","2605","5171","0","50.38","34.64"
"10","010","00","005","0522","0112","733","548","185","61","794","1476","0","53.79","37.13"
"10","010","00","005","0522","0113","730","567","163","64","794","1583","0","50.16","35.82"
"10","010","00","005","0522","0114","310","207","103","34","344","758","0","45.38","27.31"
"10","010","00","005","0522","0115","614","469","145","59","673","1354","0","49.7","34.64"
"10","010","00","005","0523","0000","1204","898","306","126","1330","2377","0","55.95","37.78"
"10","010","00","005","0523","0116","605","445","160","79","684","1202","0","56.91","37.02"
"10","010","00","005","0523","0117","599","453","146","47","646","1175","0","54.98","38.55"
"10","010","00","005","0524","0000","1076","812","264","118","1194","2371","0","50.36","34.25"
"10","010","00","005","0524","0122","430","323","107","58","488","1019","0","47.89","31.7"
"10","010","00","005","0524","0123","646","489","157","60","706","1352","0","52.22","36.17"
"10","010","00","005","0525","0000","1238","924","314","124","1362","2563","0","53.14","36.05"
"10","010","00","005","0525","0124","797","589","208","92","889","1620","0","54.88","36.36"
"10","010","00","005","0525","0125","441","335","106","32","473","943","0","50.16","35.52"
"10","010","00","005","0526","0000","730","536","194","63","793","1720","0","46.1","31.16"
"10","010","00","005","0526","0126","730","536","194","63","793","1720","0","46.1","31.16"
"10","010","00","005","0527","0000","1427","1077","350","150","1577","2973","0","53.04","36.23"
"10","010","00","005","0527","0130","684","522","162","68","752","1413","0","53.22","36.94"
"10","010","00","005","0527","0131","743","555","188","82","825","1560","0","52.88","35.58"
"10","010","00","005","0528","0000","3054","2357","697","195","3249","6395","0","50.81","36.86"
"10","010","00","005","0528","0118","661","503","158","65","726","1423","0","51.02","35.35"
"10","010","00","005","0528","0119","803","641","162","44","847","1612","0","52.54","39.76"
"10","010","00","005","0528","0120","887","687","200","35","922","1695","0","54.4","40.53"
"10","010","00","005","0528","0121","703","526","177","51","754","1665","0","45.29","31.59"
"10","010","00","006","0000","0000","5736","4264","1472","724","6460","13105","14670","49.29","32.54"
"10","010","00","006","0601","0000","647","480","167","100","747","1318","0","56.68","36.42"
"10","010","00","006","0601","0194","647","480","167","100","747","1318","0","56.68","36.42"
"10","010","00","006","0602","0000","338","251","87","52","390","677","0","57.61","37.08"
"10","010","00","006","0602","0195","338","251","87","52","390","677","0","57.61","37.08"
"10","010","00","006","0603","0000","314","229","85","32","346","690","0","50.14","33.19"
"10","010","00","006","0603","0196","185","141","44","14","199","417","0","47.72","33.81"
"10","010","00","006","0603","0197","129","88","41","18","147","273","0","53.85","32.23"
"10","010","00","006","0604","0000","356","264","92","39","395","1003","0","39.38","26.32"
"10","010","00","006","0604","0210","356","264","92","39","395","1003","0","39.38","26.32"
"10","010","00","006","0605","0000","256","198","58","26","282","701","0","40.23","28.25"
"10","010","00","006","0605","0209","256","198","58","26","282","701","0","40.23","28.25"
"10","010","00","006","0606","0000","386","294","92","44","430","786","0","54.71","37.4"
"10","010","00","006","0606","0203","386","294","92","44","430","786","0","54.71","37.4"
"10","010","00","006","0607","0000","335","239","96","46","381","807","0","47.21","29.62"
"10","010","00","006","0607","0204","335","239","96","46","381","807","0","47.21","29.62"
"10","010","00","006","0608","0000","406","318","88","20","426","1168","0","36.47","27.23"
"10","010","00","006","0608","0205","406","318","88","20","426","1168","0","36.47","27.23"
"10","010","00","006","0609","0000","499","373","126","87","586","1052","0","55.7","35.46"
"10","010","00","006","0609","0206","499","373","126","87","586","1052","0","55.7","35.46"
"10","010","00","006","0610","0000","415","309","106","75","490","953","0","51.42","32.42"
"10","010","00","006","0610","0207","232","157","75","53","285","565","0","50.44","27.79"
"10","010","00","006","0610","0208","183","152","31","22","205","388","0","52.84","39.18"
"10","010","00","006","0611","0000","619","447","172","72","691","1294","0","53.4","34.54"
"10","010","00","006","0611","0198","465","332","133","63","528","908","0","58.15","36.56"
"10","010","00","006","0611","0199","154","115","39","9","163","386","0","42.23","29.79"
"10","010","00","006","0612","0000","514","370","144","62","576","1039","0","55.44","35.61"
"10","010","00","006","0612","0200","514","370","144","62","576","1039","0","55.44","35.61"
"10","010","00","006","0613","0000","274","205","69","54","328","708","0","46.33","28.95"
"10","010","00","006","0613","0201","274","205","69","54","328","708","0","46.33","28.95"
"10","010","00","006","0614","0000","377","287","90","15","392","909","0","43.12","31.57"
"10","010","00","006","0614","0202","377","287","90","15","392","909","0","43.12","31.57"
"10","010","00","007","0000","0000","12785","9650","3135","1652","14437","27342","31755","52.8","35.29"
"10","010","00","007","0701","0000","1190","961","229","103","1293","2203","0","58.69","43.62"
"10","010","00","007","0701","0138","529","429","100","31","560","1087","0","51.52","39.47"
"10","010","00","007","0701","0139","661","532","129","72","733","1116","0","65.68","47.67"
"10","010","00","007","0702","0000","728","544","184","118","846","1567","0","53.99","34.72"
"10","010","00","007","0702","0140","358","269","89","51","409","740","0","55.27","36.35"
"10","010","00","007","0702","0141","370","275","95","67","437","827","0","52.84","33.25"
"10","010","00","007","0703","0000","791","601","190","109","900","1472","0","61.14","40.83"
"10","010","00","007","0703","0142","380","295","85","51","431","704","0","61.22","41.9"
"10","010","00","007","0703","0143","411","306","105","58","469","768","0","61.07","39.84"
"10","010","00","007","0704","0000","778","578","200","110","888","1611","0","55.12","35.88"
"10","010","00","007","0704","0144","412","294","118","44","456","761","0","59.92","38.63"
"10","010","00","007","0704","0145","366","284","82","66","432","850","0","50.82","33.41"
"10","010","00","007","0705","0000","622","469","153","71","693","1327","0","52.22","35.34"
"10","010","00","007","0705","0146","622","469","153","71","693","1327","0","52.22","35.34"
"10","010","00","007","0706","0000","725","533","192","152","877","1572","0","55.79","33.91"
"10","010","00","007","0706","0147","350","254","96","66","416","756","0","55.03","33.6"
"10","010","00","007","0706","0148","375","279","96","86","461","816","0","56.5","34.19"
"10","010","00","007","0707","0000","690","514","176","92","782","1609","0","48.6","31.95"
"10","010","00","007","0707","0149","271","190","81","31","302","667","0","45.28","28.49"
"10","010","00","007","0707","0150","419","324","95","61","480","942","0","50.96","34.39"
"10","010","00","007","0708","0000","372","277","95","66","438","918","0","47.71","30.17"
"10","010","00","007","0708","0151","372","277","95","66","438","918","0","47.71","30.17"
"10","010","00","007","0709","0000","211","160","51","14","225","554","0","40.61","28.88"
"10","010","00","007","0709","0152","211","160","51","14","225","554","0","40.61","28.88"
"10","010","00","007","0710","0000","394","301","93","44","438","929","0","47.15","32.4"
"10","010","00","007","0710","0153","394","301","93","44","438","929","0","47.15","32.4"
"10","010","00","007","0711","0000","171","129","42","34","205","487","0","42.09","26.49"
"10","010","00","007","0711","0154","171","129","42","34","205","487","0","42.09","26.49"
"10","010","00","007","0712","0000","228","163","65","42","270","487","0","55.44","33.47"
"10","010","00","007","0712","0155","228","163","65","42","270","487","0","55.44","33.47"
"10","010","00","007","0713","0000","749","519","230","110","859","1681","0","51.1","30.87"
"10","010","00","007","0713","0156","349","235","114","49","398","836","0","47.61","28.11"
"10","010","00","007","0713","0157","400","284","116","61","461","845","0","54.56","33.61"
"10","010","00","007","0714","0000","773","572","201","105","878","1587","0","55.32","36.04"
"10","010","00","007","0714","0158","403","304","99","50","453","834","0","54.32","36.45"
"10","010","00","007","0714","0159","370","268","102","55","425","753","0","56.44","35.59"
"10","010","00","007","0715","0000","628","461","167","73","701","1328","0","52.79","34.71"
"10","010","00","007","0715","0160","628","461","167","73","701","1328","0","52.79","34.71"
"10","010","00","007","0716","0000","785","615","170","65","850","1400","0","60.71","43.93"
"10","010","00","007","0716","0163","785","615","170","65","850","1400","0","60.71","43.93"
"10","010","00","007","0717","0000","550","412","138","66","616","1043","0","59.06","39.5"
"10","010","00","007","0717","0162","550","412","138","66","616","1043","0","59.06","39.5"
"10","010","00","007","0718","0000","499","373","126","52","551","969","0","56.86","38.49"
"10","010","00","007","0718","0161","499","373","126","52","551","969","0","56.86","38.49"
"10","010","00","007","0719","0000","306","228","78","32","338","1017","0","33.24","22.42"
"10","010","00","007","0719","0164","306","228","78","32","338","1017","0","33.24","22.42"
"10","010","00","007","0720","0000","453","332","121","55","508","1132","0","44.88","29.33"
"10","010","00","007","0720","0165","453","332","121","55","508","1132","0","44.88","29.33"
"10","010","00","007","0721","0000","475","363","112","62","537","1037","0","51.78","35.0"
"10","010","00","007","0721","0166","475","363","112","62","537","1037","0","51.78","35.0"
"10","010","00","007","0722","0000","268","207","61","65","333","563","0","59.15","36.77"
"10","010","00","007","0722","0167","268","207","61","65","333","563","0","59.15","36.77"
"10","010","00","007","0723","0000","399","338","61","12","411","849","0","48.41","39.81"
"10","010","00","007","0723","0168","399","338","61","12","411","849","0","48.41","39.81"
"10","010","00","008","0000","0000","7419","5627","1792","954","8373","20821","23049","40.21","27.03"
"10","010","00","008","0801","0000","442","346","96","41","483","1165","0","41.46","29.7"
"10","010","00","008","0801","0268","442","346","96","41","483","1165","0","41.46","29.7"
"10","010","00","008","0802","0000","248","192","56","20","268","825","0","32.48","23.27"
"10","010","00","008","0802","0269","248","192","56","20","268","825","0","32.48","23.27"
"10","010","00","008","0803","0000","325","234","91","35","360","850","0","42.35","27.53"
"10","010","00","008","0803","0270","325","234","91","35","360","850","0","42.35","27.53"
"10","010","00","008","0804","0000","111","85","26","21","132","222","0","59.46","38.29"
"10","010","00","008","0804","0271","111","85","26","21","132","222","0","59.46","38.29"
"10","010","00","008","0805","0000","526","401","125","60","586","1216","0","48.19","32.98"
"10","010","00","008","0805","0272","526","401","125","60","586","1216","0","48.19","32.98"
"10","010","00","008","0806","0000","387","305","82","49","436","1200","0","36.33","25.42"
"10","010","00","008","0806","0273","387","305","82","49","436","1200","0","36.33","25.42"
"10","010","00","008","0807","0000","360","284","76","49","409","877","0","46.64","32.38"
"10","010","00","008","0807","0274","360","284","76","49","409","877","0","46.64","32.38"
"10","010","00","008","0808","0000","232","185","47","41","273","644","0","42.39","28.73"
"10","010","00","008","0808","0275","232","185","47","41","273","644","0","42.39","28.73"
"10","010","00","008","0809","0000","228","178","50","13","241","761","0","31.67","23.39"
"10","010","00","008","0809","0276","190","144","46","12","202","594","0","34.01","24.24"
"10","010","00","008","0809","0277","38","34","4","1","39","167","0","23.35","20.36"
"10","010","00","008","0810","0000","222","165","57","47","269","714","0","37.68","23.11"
"10","010","00","008","0810","0283","222","165","57","47","269","714","0","37.68","23.11"
"10","010","00","008","0811","0000","423","342","81","61","484","1051","0","46.05","32.54"
"10","010","00","008","0811","0284","423","342","81","61","484","1051","0","46.05","32.54"
"10","010","00","008","0812","0000","415","302","113","67","482","934","0","51.61","32.33"
"10","010","00","008","0812","0285","415","302","113","67","482","934","0","51.61","32.33"
"10","010","00","008","0813","0000","453","337","116","58","511","1044","0","48.95","32.28"
"10","010","00","008","0813","0286","453","337","116","58","511","1044","0","48.95","32.28"
"10","010","00","008","0814","0000","544","417","127","39","583","1476","0","39.5","28.25"
"10","010","00","008","0814","0287","544","417","127","39","583","1476","0","39.5","28.25"
"10","010","00","008","0815","0000","193","140","53","23","216","618","0","34.95","22.65"
"10","010","00","008","0815","0288","193","140","53","23","216","618","0","34.95","22.65"
"10","010","00","008","0816","0000","114","84","30","48","162","478","0","33.89","17.57"
"10","010","00","008","0816","0289","114","84","30","48","162","478","0","33.89","17.57"
"10","010","00","008","0817","0000","180","136","44","52","232","642","0","36.14","21.18"
"10","010","00","008","0817","0290","180","136","44","52","232","642","0","36.14","21.18"
"10","010","00","008","0818","0000","249","187","62","14","263","883","0","29.78","21.18"
"10","010","00","008","0818","0291","249","187","62","14","263","883","0","29.78","21.18"
"10","010","00","008","0819","0000","541","409","132","71","612","1391","0","44.0","29.4"
"10","010","00","008","0819","0278","68","44","24","1","69","204","0","33.82","21.57"
"10","010","00","008","0819","0279","82","63","19","7","89","234","0","38.03","26.92"
"10","010","00","008","0819","0280","118","84","34","6","124","361","0","34.35","23.27"
"10","010","00","008","0819","0281","273","218","55","57","330","592","0","55.74","36.82"
"10","010","00","008","0820","0000","271","190","81","37","308","619","0","49.76","30.69"
"10","010","00","008","0820","0282","271","190","81","37","308","619","0","49.76","30.69"
"10","010","00","008","0821","0000","199","160","39","8","207","739","0","28.01","21.65"
"10","010","00","008","0821","0292","199","160","39","8","207","739","0","28.01","21.65"
"10","010","00","008","0822","0000","188","134","54","27","215","554","0","38.81","24.19"
"10","010","00","008","0822","0293","188","134","54","27","215","554","0","38.81","24.19"
"10","010","00","008","0823","0000","178","128","50","23","201","649","0","30.97","19.72"
"10","010","00","008","0823","0294","178","128","50","23","201","649","0","30.97","19.72"
"10","010","00","008","0824","0000","204","158","46","27","231","689","0","33.53","22.93"
"10","010","00","008","0824","0295","204","158","46","27","231","689","0","33.53","22.93"
"10","010","00","008","0825","0000","186","128","58","23","209","580","0","36.03","22.07"
"10","010","00","008","0825","0296","153","106","47","18","171","455","0","37.58","23.3"
"10","010","00","008","0825","0297","33","22","11","5","38","125","0","30.4","17.6"
"10","010","00","009","0000","0000","7150","5321","1829","1256","8406","21915","24658","38.36","24.28"
"10","010","00","009","0901","0000","702","507","195","105","807","1915","0","42.14","26.48"
"10","010","00","009","0901","0298","702","507","195","105","807","1915","0","42.14","26.48"
"10","010","00","009","0902","0000","303","221","82","65","368","938","0","39.23","23.56"
"10","010","00","009","0902","0299","303","221","82","65","368","938","0","39.23","23.56"
"10","010","00","009","0903","0000","341","259","82","36","377","1366","0","27.6","18.96"
"10","010","00","009","0903","0300","341","259","82","36","377","1366","0","27.6","18.96"
"10","010","00","009","0904","0000","546","407","139","7","553","1676","0","33.0","24.28"
"10","010","00","009","0904","0301","546","407","139","7","553","1676","0","33.0","24.28"
"10","010","00","009","0905","0000","360","263","97","104","464","1151","0","40.31","22.85"
"10","010","00","009","0905","0302","360","263","97","104","464","1151","0","40.31","22.85"
"10","010","00","009","0906","0000","237","182","55","85","322","716","0","44.97","25.42"
"10","010","00","009","0906","0303","237","182","55","85","322","716","0","44.97","25.42"
"10","010","00","009","0907","0000","120","97","23","11","131","387","0","33.85","25.06"
"10","010","00","009","0907","0304","120","97","23","11","131","387","0","33.85","25.06"
"10","010","00","009","0908","0000","218","164","54","13","231","864","0","26.74","18.98"
"10","010","00","009","0908","0305","218","164","54","13","231","864","0","26.74","18.98"
"10","010","00","009","0909","0000","250","183","67","17","267","910","0","29.34","20.11"
"10","010","00","009","0909","0306","250","183","67","17","267","910","0","29.34","20.11"
"10","010","00","009","0910","0000","226","176","50","17","243","760","0","31.97","23.16"
"10","010","00","009","0910","0307","226","176","50","17","243","760","0","31.97","23.16"
"10","010","00","009","0911","0000","131","89","42","31","162","378","0","42.86","23.54"
"10","010","00","009","0911","0308","69","44","25","16","85","166","0","51.2","26.51"
"10","010","00","009","0911","0309","62","45","17","15","77","212","0","36.32","21.23"
"10","010","00","009","0912","0000","274","203","71","48","322","993","0","32.43","20.44"
"10","010","00","009","0912","0310","274","203","71","48","322","993","0","32.43","20.44"
"10","010","00","009","0913","0000","449","335","114","105","554","1226","0","45.19","27.32"
"10","010","00","009","0913","0314","449","335","114","105","554","1226","0","45.19","27.32"
"10","010","00","009","0914","0000","300","222","78","67","367","843","0","43.53","26.33"
"10","010","00","009","0914","0315","300","222","78","67","367","843","0","43.53","26.33"
"10","010","00","009","0915","0000","141","84","57","37","178","693","0","25.69","12.12"
"10","010","00","009","0915","0316","141","84","57","37","178","693","0","25.69","12.12"
"10","010","00","009","0916","0000","336","260","76","76","412","839","0","49.11","30.99"
"10","010","00","009","0916","0317","336","260","76","76","412","839","0","49.11","30.99"
"10","010","00","009","0917","0000","233","185","48","22","255","684","0","37.28","27.05"
"10","010","00","009","0917","0318","135","108","27","11","146","363","0","40.22","29.75"
"10","010","00","009","0917","0319","98","77","21","11","109","321","0","33.96","23.99"
"10","010","00","009","0918","0000","489","350","139","111","600","1083","0","55.4","32.32"
"10","010","00","009","0918","0320","489","350","139","111","600","1083","0","55.4","32.32"
"10","010","00","009","0919","0000","349","253","96","62","411","901","0","45.62","28.08"
"10","010","00","009","0919","0321","349","253","96","62","411","901","0","45.62","28.08"
"10","010","00","009","0920","0000","325","267","58","41","366","1216","0","30.1","21.96"
"10","010","00","009","0920","0322","325","267","58","41","366","1216","0","30.1","21.96"
"10","010","00","009","0921","0000","344","263","81","60","404","789","0","51.2","33.33"
"10","010","00","009","0921","0323","204","155","49","45","249","418","0","59.57","37.08"
"10","010","00","009","0921","0324","140","108","32","15","155","371","0","41.78","29.11"
"10","010","00","009","0922","0000","95","69","26","16","111","306","0","36.27","22.55"
"10","010","00","009","0922","0311","95","69","26","16","111","306","0","36.27","22.55"
"10","010","00","009","0923","0000","381","282","99","120","501","1281","0","39.11","22.01"
"10","010","00","009","0923","0312","318","234","84","93","411","1046","0","39.29","22.37"
"10","010","00","009","0923","0313","63","48","15","27","90","235","0","38.3","20.43"
"10","010","00","010","0000","0000","7337","5589","1748","920","8257","16647","18297","49.6","33.57"
"10","010","00","010","1001","0000","314","240","74","47","361","705","0","51.21","34.04"
"10","010","00","010","1001","0354","201","153","48","29","230","482","0","47.72","31.74"
"10","010","00","010","1001","0355","113","87","26","18","131","223","0","58.74","39.01"
"10","010","00","010","1002","0000","724","546","178","88","812","1529","0","53.11","35.71"
"10","010","00","010","1002","0356","724","546","178","88","812","1529","0","53.11","35.71"
"10","010","00","010","1003","0000","583","453","130","70","653","1175","0","55.57","38.55"
"10","010","00","010","1003","0357","583","453","130","70","653","1175","0","55.57","38.55"
"10","010","00","010","1004","0000","490","374","116","54","544","886","0","61.4","42.21"
"10","010","00","010","1004","0358","490","374","116","54","544","886","0","61.4","42.21"
"10","010","00","010","1005","0000","295","226","69","39","334","743","0","44.95","30.42"
"10","010","00","010","1005","0359","295","226","69","39","334","743","0","44.95","30.42"
"10","010","00","010","1006","0000","588","431","157","87","675","1236","0","54.61","34.87"
"10","010","00","010","1006","0360","588","431","157","87","675","1236","0","54.61","34.87"
"10","010","00","010","1007","0000","174","137","37","20","194","377","0","51.46","36.34"
"10","010","00","010","1007","0361","174","137","37","20","194","377","0","51.46","36.34"
"10","010","00","010","1008","0000","187","152","35","24","211","440","0","47.95","34.55"
"10","010","00","010","1008","0362","133","108","25","19","152","338","0","44.97","31.95"
"10","010","00","010","1008","0363","54","44","10","5","59","102","0","57.84","43.14"
"10","010","00","010","1009","0000","303","231","72","24","327","763","0","42.86","30.28"
"10","010","00","010","1009","0364","303","231","72","24","327","763","0","42.86","30.28"
"10","010","00","010","1010","0000","211","152","59","28","239","429","0","55.71","35.43"
"10","010","00","010","1010","0365","211","152","59","28","239","429","0","55.71","35.43"
"10","010","00","010","1011","0000","184","139","45","23","207","427","0","48.48","32.55"
"10","010","00","010","1011","0366","184","139","45","23","207","427","0","48.48","32.55"
"10","010","00","010","1012","0000","282","213","69","47","329","607","0","54.2","35.09"
"10","010","00","010","1012","0367","282","213","69","47","329","607","0","54.2","35.09"
"10","010","00","010","1013","0000","612","485","127","49","661","1486","0","44.48","32.64"
"10","010","00","010","1013","0368","612","485","127","49","661","1486","0","44.48","32.64"
"10","010","00","010","1014","0000","413","325","88","63","476","835","0","57.01","38.92"
"10","010","00","010","1014","0369","413","325","88","63","476","835","0","57.01","38.92"
"10","010","00","010","1015","0000","289","226","63","64","353","816","0","43.26","27.7"
"10","010","00","010","1015","0370","289","226","63","64","353","816","0","43.26","27.7"
"10","010","00","010","1016","0000","320","217","103","61","381","833","0","45.74","26.05"
"10","010","00","010","1016","0371","320","217","103","61","381","833","0","45.74","26.05"
"10","010","00","010","1017","0000","195","145","50","17","212","433","0","48.96","33.49"
"10","010","00","010","1017","0372","195","145","50","17","212","433","0","48.96","33.49"
"10","010","00","010","1018","0000","233","196","37","6","239","558","0","42.83","35.13"
"10","010","00","010","1018","0373","233","196","37","6","239","558","0","42.83","35.13"
"10","010","00","010","1019","0000","322","232","90","41","363","742","0","48.92","31.27"
"10","010","00","010","1019","0374","269","189","80","41","310","602","0","51.5","31.4"
"10","010","00","010","1019","0375","53","43","10","0","53","140","0","37.86","30.71"
"10","010","00","010","1020","0000","149","109","40","26","175","393","0","44.53","27.74"
"10","010","00","010","1020","0376","149","109","40","26","175","393","0","44.53","27.74"
"10","010","00","010","1021","0000","262","208","54","22","284","585","0","48.55","35.56"
"10","010","00","010","1021","0377","262","208","54","22","284","585","0","48.55","35.56"
"10","010","00","010","1022","0000","207","152","55","20","227","649","0","34.98","23.42"
"10","010","00","010","1022","0378","151","116","35","9","160","526","0","30.42","22.05"
"10","010","00","010","1022","0379","56","36","20","11","67","123","0","54.47","29.27"
"10","010","00","011","0000","0000","5549","4178","1371","951","6500","13937","15422","46.64","29.98"
"10","010","00","011","1101","0000","194","142","52","46","240","522","0","45.98","27.2"
"10","010","00","011","1101","0034","194","142","52","46","240","522","0","45.98","27.2"
"10","010","00","011","1102","0000","254","180","74","45","299","563","0","53.11","31.97"
"10","010","00","011","1102","0035","254","180","74","45","299","563","0","53.11","31.97"
"10","010","00","011","1103","0000","550","422","128","89","639","1304","0","49.0","32.36"
"10","010","00","011","1103","0036","550","422","128","89","639","1304","0","49.0","32.36"
"10","010","00","011","1104","0000","592","438","154","65","657","1312","0","50.08","33.38"
"10","010","00","011","1104","0037","592","438","154","65","657","1312","0","50.08","33.38"
"10","010","00","011","1105","0000","232","184","48","6","238","738","0","32.25","24.93"
"10","010","00","011","1105","0038","125","94","31","3","128","320","0","40.0","29.38"
"10","010","00","011","1105","0039","107","90","17","3","110","418","0","26.32","21.53"
"10","010","00","011","1106","0000","380","295","85","57","437","1025","0","42.63","28.78"
"10","010","00","011","1106","0040","380","295","85","57","437","1025","0","42.63","28.78"
"10","010","00","011","1107","0000","156","106","50","30","186","451","0","41.24","23.5"
"10","010","00","011","1107","0041","156","106","50","30","186","451","0","41.24","23.5"
"10","010","00","011","1108","0000","338","256","82","105","443","830","0","53.37","30.84"
"10","010","00","011","1108","0042","338","256","82","105","443","830","0","53.37","30.84"
"10","010","00","011","1109","0000","396","301","95","93","489","1050","0","46.57","28.67"
"10","010","00","011","1109","0043","396","301","95","93","489","1050","0","46.57","28.67"
"10","010","00","011","1110","0000","342","265","77","57","399","972","0","41.05","27.26"
"10","010","00","011","1110","0044","342","265","77","57","399","972","0","41.05","27.26"
"10","010","00","011","1111","0000","381","277","104","59","440","962","0","45.74","28.79"
"10","010","00","011","1111","0045","381","277","104","59","440","962","0","45.74","28.79"
"10","010","00","011","1112","0000","394","295","99","90","484","940","0","51.49","31.38"
"10","010","00","011","1112","0046","292","219","73","56","348","678","0","51.33","32.3"
"10","010","00","011","1112","0047","102","76","26","34","136","262","0","51.91","29.01"
"10","010","00","011","1113","0000","436","330","106","59","495","1212","0","40.84","27.23"
"10","010","00","011","1113","0048","342","257","85","48","390","906","0","43.05","28.37"
"10","010","00","011","1113","0049","94","73","21","11","105","306","0","34.31","23.86"
"10","010","00","011","1114","0000","630","475","155","103","733","1435","0","51.08","33.1"
"10","010","00","011","1114","0050","463","357","106","74","537","1062","0","50.56","33.62"
"10","010","00","011","1114","0051","167","118","49","29","196","373","0","52.55","31.64"
"10","010","00","011","1115","0000","274","212","62","47","321","621","0","51.69","34.14"
"10","010","00","011","1115","0052","150","114","36","25","175","324","0","54.01","35.19"
"10","010","00","011","1115","0053","124","98","26","22","146","297","0","49.16","33.0"
"10","010","00","012","0000","0000","20641","15484","5157","2221","22862","43857","49406","52.13","35.31"
"10","010","00","012","1201","0000","1858","1376","482","194","2052","3971","0","51.67","34.65"
"10","010","00","012","1201","0054","456","341","115","44","500","1024","0","48.83","33.3"
"10","010","00","012","1201","0055","542","390","152","70","612","1015","0","60.3","38.42"
"10","010","00","012","1201","0056","860","645","215","80","940","1932","0","48.65","33.39"
"10","010","00","012","1202","0000","1318","1009","309","125","1443","2475","0","58.3","40.77"
"10","010","00","012","1202","0057","631","473","158","47","678","1170","0","57.95","40.43"
"10","010","00","012","1202","0058","687","536","151","78","765","1305","0","58.62","41.07"
"10","010","00","012","1203","0000","839","630","209","98","937","1564","0","59.91","40.28"
"10","010","00","012","1203","0066","358","282","76","49","407","626","0","65.02","45.05"
"10","010","00","012","1203","0067","311","227","84","27","338","570","0","59.3","39.82"
"10","010","00","012","1203","0068","170","121","49","22","192","368","0","52.17","32.88"
"10","010","00","012","1204","0000","933","680","253","175","1108","2102","0","52.71","32.35"
"10","010","00","012","1204","0069","433","306","127","100","533","1037","0","51.4","29.51"
"10","010","00","012","1204","0070","500","374","126","75","575","1065","0","53.99","35.12"
"10","010","00","012","1205","0000","428","318","110","81","509","802","0","63.47","39.65"
"10","010","00","012","1205","0071","428","318","110","81","509","802","0","63.47","39.65"
"10","010","00","012","1206","0000","690","512","178","86","776","1566","0","49.55","32.69"
"10","010","00","012","1206","0059","546","405","141","68","614","1242","0","49.44","32.61"
"10","010","00","012","1206","0060","144","107","37","18","162","324","0","50.0","33.02"
"10","010","00","012","1207","0000","858","677","181","102","960","1838","0","52.23","36.83"
"10","010","00","012","1207","0061","308","238","70","17","325","622","0","52.25","38.26"
"10","010","00","012","1207","0062","550","439","111","85","635","1216","0","52.22","36.1"
"10","010","00","012","1208","0000","962","749","213","76","1038","1791","0","57.96","41.82"
"10","010","00","012","1208","0063","525","421","104","33","558","1020","0","54.71","41.27"
"10","010","00","012","1208","0064","437","328","109","43","480","771","0","62.26","42.54"
"10","010","00","012","1209","0000","253","190","63","23","276","441","0","62.59","43.08"
"10","010","00","012","1209","0065","253","190","63","23","276","441","0","62.59","43.08"
"10","010","00","012","1210","0000","347","268","79","24","371","641","0","57.88","41.81"
"10","010","00","012","1210","0074","347","268","79","24","371","641","0","57.88","41.81"
"10","010","00","012","1211","0000","203","163","40","21","224","408","0","54.9","39.95"
"10","010","00","012","1211","0075","203","163","40","21","224","408","0","54.9","39.95"
"10","010","00","012","1212","0000","634","451","183","92","726","1363","0","53.26","33.09"
"10","010","00","012","1212","0076","398","286","112","59","457","794","0","57.56","36.02"
"10","010","00","012","1212","0077","236","165","71","33","269","569","0","47.28","29.0"
"10","010","00","012","1213","0000","848","647","201","56","904","1948","0","46.41","33.21"
"10","010","00","012","1213","0072","848","647","201","56","904","1948","0","46.41","33.21"
"10","010","00","012","1214","0000","456","329","127","68","524","1028","0","50.97","32.0"
"10","010","00","012","1214","0073","456","329","127","68","524","1028","0","50.97","32.0"
"10","010","00","012","1215","0000","996","742","254","114","1110","2035","0","54.55","36.46"
"10","010","00","012","1215","0080","996","742","254","114","1110","2035","0","54.55","36.46"
"10","010","00","012","1216","0000","922","691","231","95","1017","1987","0","51.18","34.78"
"10","010","00","012","1216","0081","922","691","231","95","1017","1987","0","51.18","34.78"
"10","010","00","012","1217","0000","915","700","215","89","1004","1766","0","56.85","39.64"
"10","010","00","012","1217","0078","410","311","99","41","451","806","0","55.96","38.59"
"10","010","00","012","1217","0079","505","389","116","48","553","960","0","57.6","40.52"
"10","010","00","012","1218","0000","1887","1423","464","155","2042","4310","0","47.38","33.02"
"10","010","00","012","1218","0083","1022","782","240","84","1106","2208","0","50.09","35.42"
"10","010","00","012","1218","0084","865","641","224","71","936","2102","0","44.53","30.49"
"10","010","00","012","1219","0000","1404","1036","368","164","1568","2980","0","52.62","34.77"
"10","010","00","012","1219","0085","578","441","137","83","661","1309","0","50.5","33.69"
"10","010","00","012","1219","0086","826","595","231","81","907","1671","0","54.28","35.61"
"10","010","00","012","1220","0000","890","649","241","101","991","1919","0","51.64","33.82"
"10","010","00","012","1220","0089","890","649","241","101","991","1919","0","51.64","33.82"
"10","010","00","012","1221","0000","781","571","210","57","838","1772","0","47.29","32.22"
"10","010","00","012","1221","0088","781","571","210","57","838","1772","0","47.29","32.22"
"10","010","00","012","1222","0000","342","255","87","26","368","912","0","40.35","27.96"
"10","010","00","012","1222","0090","342","255","87","26","368","912","0","40.35","27.96"
"10","010","00","012","1223","0000","432","340","92","37","469","992","0","47.28","34.27"
"10","010","00","012","1223","0091","432","340","92","37","469","992","0","47.28","34.27"
"10","010","00","012","1224","0000","498","349","149","65","563","1270","0","44.33","27.48"
"10","010","00","012","1224","0092","498","349","149","65","563","1270","0","44.33","27.48"
"10","010","00","012","1225","0000","556","437","119","47","603","1154","0","52.25","37.87"
"10","010","00","012","1225","0082","556","437","119","47","603","1154","0","52.25","37.87"
"10","010","00","012","1226","0000","391","292","99","50","441","822","0","53.65","35.52"
"10","010","00","012","1226","0087","391","292","99","50","441","822","0","53.65","35.52"
"10","010","00","013","0000","0000","16293","12424","3869","1632","17925","39139","44605","45.8","31.74"
"10","010","00","013","1301","0000","737","557","180","82","819","1809","0","45.27","30.79"
"10","010","00","013","1301","0392","737","557","180","82","819","1809","0","45.27","30.79"
"10","010","00","013","1302","0000","422","319","103","31","453","953","0","47.53","33.47"
"10","010","00","013","1302","0393","422","319","103","31","453","953","0","47.53","33.47"
"10","010","00","013","1303","0000","304","235","69","15","319","828","0","38.53","28.38"
"10","010","00","013","1303","0401","304","235","69","15","319","828","0","38.53","28.38"
"10","010","00","013","1304","0000","343","255","88","51","394","879","0","44.82","29.01"
"10","010","00","013","1304","0400","343","255","88","51","394","879","0","44.82","29.01"
"10","010","00","013","1305","0000","590","442","148","77","667","1441","0","46.29","30.67"
"10","010","00","013","1305","0394","590","442","148","77","667","1441","0","46.29","30.67"
"10","010","00","013","1306","0000","1134","867","267","111","1245","2834","0","43.93","30.59"
"10","010","00","013","1306","0380","388","302","86","16","404","1046","0","38.62","28.87"
"10","010","00","013","1306","0381","746","565","181","95","841","1788","0","47.04","31.6"
"10","010","00","013","1307","0000","1428","1069","359","115","1543","3311","0","46.6","32.29"
"10","010","00","013","1307","0382","717","529","188","56","773","1730","0","44.68","30.58"
"10","010","00","013","1307","0383","711","540","171","59","770","1581","0","48.7","34.16"
"10","010","00","013","1308","0000","3051","2369","682","208","3259","7060","0","46.16","33.56"
"10","010","00","013","1308","0384","629","479","150","47","676","1594","0","42.41","30.05"
"10","010","00","013","1308","0385","831","648","183","48","879","1801","0","48.81","35.98"
"10","010","00","013","1308","0386","848","663","185","80","928","1862","0","49.84","35.61"
"10","010","00","013","1308","0387","743","579","164","33","776","1803","0","43.04","32.11"
"10","010","00","013","1309","0000","2504","1908","596","264","2768","5642","0","49.06","33.82"
"10","010","00","013","1309","0388","702","553","149","63","765","1481","0","51.65","37.34"
"10","010","00","013","1309","0389","647","494","153","70","717","1366","0","52.49","36.16"
"10","010","00","013","1309","0390","628","471","157","83","711","1599","0","44.47","29.46"
"10","010","00","013","1309","0391","527","390","137","48","575","1196","0","48.08","32.61"
"10","010","00","013","1310","0000","801","628","173","64","865","1882","0","45.96","33.37"
"10","010","00","013","1310","0395","801","628","173","64","865","1882","0","45.96","33.37"
"10","010","00","013","1311","0000","479","364","115","24","503","1470","0","34.22","24.76"
"10","010","00","013","1311","0396","479","364","115","24","503","1470","0","34.22","24.76"
"10","010","00","013","1312","0000","822","654","168","102","924","2121","0","43.56","30.83"
"10","010","00","013","1312","0397","670","532","138","81","751","1699","0","44.2","31.31"
"10","010","00","013","1312","0398","152","122","30","21","173","422","0","41.0","28.91"
"10","010","00","013","1313","0000","444","330","114","69","513","1030","0","49.81","32.04"
"10","010","00","013","1313","0399","444","330","114","69","513","1030","0","49.81","32.04"
"10","010","00","013","1314","0000","565","431","134","81","646","1177","0","54.89","36.62"
"10","010","00","013","1314","0402","438","345","93","60","498","881","0","56.53","39.16"
"10","010","00","013","1314","0403","127","86","41","21","148","296","0","50.0","29.05"
"10","010","00","013","1315","0000","381","265","116","98","479","979","0","48.93","27.07"
"10","010","00","013","1315","0404","381","265","116","98","479","979","0","48.93","27.07"
"10","010","00","013","1316","0000","667","504","163","48","715","1938","0","36.89","26.01"
"10","010","00","013","1316","0405","482","362","120","41","523","1268","0","41.25","28.55"
"10","010","00","013","1316","0406","185","142","43","7","192","670","0","28.66","21.19"
"10","010","00","013","1317","0000","264","210","54","28","292","741","0","39.41","28.34"
"10","010","00","013","1317","0409","264","210","54","28","292","741","0","39.41","28.34"
"10","010","00","013","1318","0000","407","315","92","43","450","1000","0","45.0","31.5"
"10","010","00","013","1318","0410","205","168","37","4","209","518","0","40.35","32.43"
"10","010","00","013","1318","0411","202","147","55","39","241","482","0","50.0","30.5"
"10","010","00","013","1319","0000","315","236","79","39","354","648","0","54.63","36.42"
"10","010","00","013","1319","0408","315","236","79","39","354","648","0","54.63","36.42"
"10","010","00","013","1320","0000","371","270","101","60","431","754","0","57.16","35.81"
"10","010","00","013","1320","0407","371","270","101","60","431","754","0","57.16","35.81"
"10","010","00","013","1321","0000","134","97","37","8","142","348","0","40.8","27.87"
"10","010","00","013","1321","0412","134","97","37","8","142","348","0","40.8","27.87"
"10","010","00","013","1322","0000","130","99","31","14","144","294","0","48.98","33.67"
"10","010","00","013","1322","0413","130","99","31","14","144","294","0","48.98","33.67"
"10","010","00","014","0000","0000","14105","10766","3339","1485","15590","31228","35625","49.92","34.48"
"10","010","00","014","1401","0000","1201","912","289","70","1271","2522","0","50.4","36.16"
"10","010","00","014","1401","0414","603","431","172","43","646","1312","0","49.24","32.85"
"10","010","00","014","1401","0415","598","481","117","27","625","1210","0","51.65","39.75"
"10","010","00","014","1402","0000","1039","817","222","107","1146","2198","0","52.14","37.17"
"10","010","00","014","1402","0416","502","388","114","51","553","991","0","55.8","39.15"
"10","010","00","014","1402","0417","537","429","108","56","593","1207","0","49.13","35.54"
"10","010","00","014","1403","0000","289","215","74","17","306","752","0","40.69","28.59"
"10","010","00","014","1403","0418","289","215","74","17","306","752","0","40.69","28.59"
"10","010","00","014","1404","0000","413","313","100","69","482","833","0","57.86","37.58"
"10","010","00","014","1404","0419","413","313","100","69","482","833","0","57.86","37.58"
"10","010","00","014","1405","0000","598","448","150","91","689","1220","0","56.48","36.72"
"10","010","00","014","1405","0420","598","448","150","91","689","1220","0","56.48","36.72"
"10","010","00","014","1406","0000","322","236","86","18","340","616","0","55.19","38.31"
"10","010","00","014","1406","0421","322","236","86","18","340","616","0","55.19","38.31"
"10","010","00","014","1407","0000","466","350","116","62","528","1031","0","51.21","33.95"
"10","010","00","014","1407","0422","466","350","116","62","528","1031","0","51.21","33.95"
"10","010","00","014","1408","0000","2421","1827","594","218","2639","5283","0","49.95","34.58"
"10","010","00","014","1408","0423","586","421","165","82","668","1292","0","51.7","32.59"
"10","010","00","014","1408","0424","1000","765","235","94","1094","1995","0","54.84","38.35"
"10","010","00","014","1408","0425","835","641","194","42","877","1996","0","43.94","32.11"
"10","010","00","014","1409","0000","663","517","146","93","756","1449","0","52.17","35.68"
"10","010","00","014","1409","0426","663","517","146","93","756","1449","0","52.17","35.68"
"10","010","00","014","1410","0000","642","515","127","49","691","1420","0","48.66","36.27"
"10","010","00","014","1410","0427","642","515","127","49","691","1420","0","48.66","36.27"
"10","010","00","014","1411","0000","784","596","188","49","833","1590","0","52.39","37.48"
"10","010","00","014","1411","0428","784","596","188","49","833","1590","0","52.39","37.48"
"10","010","00","014","1412","0000","769","555","214","98","867","1785","0","48.57","31.09"
"10","010","00","014","1412","0429","342","261","81","44","386","771","0","50.06","33.85"
"10","010","00","014","1412","0430","427","294","133","54","481","1014","0","47.44","28.99"
"10","010","00","014","1413","0000","268","209","59","24","292","641","0","45.55","32.61"
"10","010","00","014","1413","0433","268","209","59","24","292","641","0","45.55","32.61"
"10","010","00","014","1414","0000","424","318","106","39","463","1014","0","45.66","31.36"
"10","010","00","014","1414","0431","96","71","25","12","108","327","0","33.03","21.71"
"10","010","00","014","1414","0432","328","247","81","27","355","687","0","51.67","35.95"
"10","010","00","014","1415","0000","373","306","67","37","410","857","0","47.84","35.71"
"10","010","00","014","1415","0434","215","177","38","10","225","474","0","47.47","37.34"
"10","010","00","014","1415","0435","158","129","29","27","185","383","0","48.3","33.68"
"10","010","00","014","1416","0000","313","240","73","61","374","619","0","60.42","38.77"
"10","010","00","014","1416","0436","313","240","73","61","374","619","0","60.42","38.77"
"10","010","00","014","1417","0000","784","587","197","128","912","1782","0","51.18","32.94"
"10","010","00","014","1417","0437","90","66","24","8","98","214","0","45.79","30.84"
"10","010","00","014","1417","0438","694","521","173","120","814","1568","0","51.91","33.23"
"10","010","00","014","1418","0000","253","200","53","36","289","658","0","43.92","30.4"
"10","010","00","014","1418","0439","253","200","53","36","289","658","0","43.92","30.4"
"10","010","00","014","1419","0000","216","152","64","38","254","434","0","58.53","35.02"
"10","010","00","014","1419","0440","216","152","64","38","254","434","0","58.53","35.02"
"10","010","00","014","1420","0000","861","667","194","102","963","1898","0","50.74","35.14"
"10","010","00","014","1420","0441","438","346","92","54","492","917","0","53.65","37.73"
"10","010","00","014","1420","0442","423","321","102","48","471","981","0","48.01","32.72"
"10","010","00","014","1421","0000","320","249","71","25","345","897","0","38.46","27.76"
"10","010","00","014","1421","0443","293","224","69","24","317","789","0","40.18","28.39"
"10","010","00","014","1421","0444","27","25","2","1","28","108","0","25.93","23.15"
"10","010","00","014","1422","0000","50","41","9","2","52","235","0","22.13","17.45"
"10","010","00","014","1422","0445","50","41","9","2","52","235","0","22.13","17.45"
"10","010","00","014","1423","0000","387","302","85","24","411","781","0","52.62","38.67"
"10","010","00","014","1423","0446","128","102","26","8","136","331","0","41.09","30.82"
"10","010","00","014","1423","0447","259","200","59","16","275","450","0","61.11","44.44"
"10","010","00","014","1424","0000","249","194","55","28","277","713","0","38.85","27.21"
"10","010","00","014","1424","0448","164","130","34","9","173","462","0","37.45","28.14"
"10","010","00","014","1424","0449","85","64","21","19","104","251","0","41.43","25.5"
"10","010","00","015","0000","0000","8242","6323","1919","1001","9243","17083","19303","54.11","37.01"
"10","010","00","015","1501","0000","1117","839","278","131","1248","2286","0","54.59","36.7"
"10","010","00","015","1501","0211","484","368","116","30","514","1041","0","49.38","35.35"
"10","010","00","015","1501","0212","633","471","162","101","734","1245","0","58.96","37.83"
"10","010","00","015","1502","0000","499","378","121","64","563","917","0","61.4","41.22"
"10","010","00","015","1502","0213","499","378","121","64","563","917","0","61.4","41.22"
"10","010","00","015","1503","0000","292","231","61","51","343","545","0","62.94","42.39"
"10","010","00","015","1503","0217","292","231","61","51","343","545","0","62.94","42.39"
"10","010","00","015","1504","0000","2172","1681","491","192","2364","4404","0","53.68","38.17"
"10","010","00","015","1504","0214","595","464","131","34","629","1189","0","52.9","39.02"
"10","010","00","015","1504","0215","702","545","157","84","786","1388","0","56.63","39.27"
"10","010","00","015","1504","0216","875","672","203","74","949","1827","0","51.94","36.78"
"10","010","00","015","1505","0000","150","107","43","33","183","407","0","44.96","26.29"
"10","010","00","015","1505","0218","150","107","43","33","183","407","0","44.96","26.29"
"10","010","00","015","1506","0000","283","205","78","43","326","526","0","61.98","38.97"
"10","010","00","015","1506","0223","283","205","78","43","326","526","0","61.98","38.97"
"10","010","00","015","1507","0000","144","102","42","36","180","372","0","48.39","27.42"
"10","010","00","015","1507","0224","144","102","42","36","180","372","0","48.39","27.42"
"10","010","00","015","1508","0000","304","224","80","33","337","636","0","52.99","35.22"
"10","010","00","015","1508","0219","304","224","80","33","337","636","0","52.99","35.22"
"10","010","00","015","1509","0000","806","612","194","104","910","1674","0","54.36","36.56"
"10","010","00","015","1509","0221","806","612","194","104","910","1674","0","54.36","36.56"
"10","010","00","015","1510","0000","268","204","64","61","329","576","0","57.12","35.42"
"10","010","00","015","1510","0220","268","204","64","61","329","576","0","57.12","35.42"
"10","010","00","015","1511","0000","345","270","75","15","360","858","0","41.96","31.47"
"10","010","00","015","1511","0222","345","270","75","15","360","858","0","41.96","31.47"
"10","010","00","015","1512","0000","220","164","56","33","253","506","0","50.0","32.41"
"10","010","00","015","1512","0225","220","164","56","33","253","506","0","50.0","32.41"
"10","010","00","015","1513","0000","128","96","32","17","145","293","0","49.49","32.76"
"10","010","00","015","1513","0228","128","96","32","17","145","293","0","49.49","32.76"
"10","010","00","015","1514","0000","271","231","40","33","304","433","0","70.21","53.35"
"10","010","00","015","1514","0226","271","231","40","33","304","433","0","70.21","53.35"
"10","010","00","015","1515","0000","388","317","71","60","448","712","0","62.92","44.52"
"10","010","00","015","1515","0229","388","317","71","60","448","712","0","62.92","44.52"
"10","010","00","015","1516","0000","335","255","80","38","373","602","0","61.96","42.36"
"10","010","00","015","1516","0230","335","255","80","38","373","602","0","61.96","42.36"
"10","010","00","015","1517","0000","369","287","82","45","414","932","0","44.42","30.79"
"10","010","00","015","1517","0231","220","171","49","30","250","515","0","48.54","33.2"
"10","010","00","015","1517","0232","149","116","33","15","164","417","0","39.33","27.82"
"10","010","00","015","1518","0000","151","120","31","12","163","404","0","40.35","29.7"
"10","010","00","015","1518","0227","151","120","31","12","163","404","0","40.35","29.7"
"10","010","00","016","0000","0000","5049","3930","1119","520","5569","10156","11470","54.83","38.7"
"10","010","00","016","1601","0000","636","478","158","71","707","1174","0","60.22","40.72"
"10","010","00","016","1601","0450","636","478","158","71","707","1174","0","60.22","40.72"
"10","010","00","016","1602","0000","247","194","53","13","260","449","0","57.91","43.21"
"10","010","00","016","1602","0451","247","194","53","13","260","449","0","57.91","43.21"
"10","010","00","016","1603","0000","633","496","137","68","701","1304","0","53.76","38.04"
"10","010","00","016","1603","0452","404","320","84","39","443","753","0","58.83","42.5"
"10","010","00","016","1603","0453","229","176","53","29","258","551","0","46.82","31.94"
"10","010","00","016","1604","0000","920","731","189","82","1002","1791","0","55.95","40.82"
"10","010","00","016","1604","0454","920","731","189","82","1002","1791","0","55.95","40.82"
"10","010","00","016","1605","0000","472","340","132","65","537","849","0","63.25","40.05"
"10","010","00","016","1605","0455","472","340","132","65","537","849","0","63.25","40.05"
"10","010","00","016","1606","0000","442","332","110","47","489","866","0","56.47","38.34"
"10","010","00","016","1606","0456","442","332","110","47","489","866","0","56.47","38.34"
"10","010","00","016","1607","0000","612","480","132","77","689","1244","0","55.39","38.59"
"10","010","00","016","1607","0457","401","335","66","38","439","800","0","54.88","41.88"
"10","010","00","016","1607","0458","211","145","66","39","250","444","0","56.31","32.66"
"10","010","00","016","1608","0000","226","177","49","18","244","635","0","38.43","27.87"
"10","010","00","016","1608","0459","226","177","49","18","244","635","0","38.43","27.87"
"10","010","00","016","1609","0000","475","396","79","44","519","961","0","54.01","41.21"
"10","010","00","016","1609","0460","127","106","21","16","143","319","0","44.83","33.23"
"10","010","00","016","1609","0461","348","290","58","28","376","642","0","58.57","45.17"
"10","010","00","016","1610","0000","204","162","42","25","229","509","0","44.99","31.83"
"10","010","00","016","1610","0462","204","162","42","25","229","509","0","44.99","31.83"
"10","010","00","016","1611","0000","182","144","38","10","192","374","0","51.34","38.5"
"10","010","00","016","1611","0463","79","65","14","0","79","162","0","48.77","40.12"
"10","010","00","016","1611","0464","103","79","24","10","113","212","0","53.3","37.26"
"10","010","00","017","0000","0000","1951","1505","446","163","2114","3999","4592","52.86","37.63"
"10","010","00","017","1701","0000","723","559","164","79","802","1468","0","54.63","38.08"
"10","010","00","017","1701","0465","723","559","164","79","802","1468","0","54.63","38.08"
"10","010","00","017","1702","0000","259","199","60","20","279","624","0","44.71","31.89"
"10","010","00","017","1702","0466","105","85","20","6","111","320","0","34.69","26.56"
"10","010","00","017","1702","0467","154","114","40","14","168","304","0","55.26","37.5"
"10","010","00","017","1703","0000","230","172","58","17","247","418","0","59.09","41.15"
"10","010","00","017","1703","0468","91","65","26","2","93","184","0","50.54","35.33"
"10","010","00","017","1703","0469","139","107","32","15","154","234","0","65.81","45.73"
"10","010","00","017","1704","0000","411","314","97","27","438","920","0","47.61","34.13"
"10","010","00","017","1704","0470","225","179","46","10","235","495","0","47.47","36.16"
"10","010","00","017","1704","0471","97","72","25","5","102","199","0","51.26","36.18"
"10","010","00","017","1704","0472","89","63","26","12","101","226","0","44.69","27.88"
"10","010","00","017","1705","0000","328","261","67","20","348","569","0","61.16","45.87"
"10","010","00","017","1705","0473","328","261","67","20","348","569","0","61.16","45.87"
"10","010","00","018","0000","0000","1940","1540","400","105","2045","4691","5610","43.59","32.83"
"10","010","00","018","1801","0000","163","132","31","5","168","371","0","45.28","35.58"
"10","010","00","018","1801","0474","163","132","31","5","168","371","0","45.28","35.58"
"10","010","00","018","1802","0000","75","59","16","9","84","197","0","42.64","29.95"
"10","010","00","018","1802","0475","75","59","16","9","84","197","0","42.64","29.95"
"10","010","00","018","1803","0000","66","51","15","3","69","152","0","45.39","33.55"
"10","010","00","018","1803","0476","66","51","15","3","69","152","0","45.39","33.55"
"10","010","00","018","1804","0000","90","65","25","6","96","303","0","31.68","21.45"
"10","010","00","018","1804","0477","71","51","20","4","75","231","0","32.47","22.08"
"10","010","00","018","1804","0478","19","14","5","2","21","72","0","29.17","19.44"
"10","010","00","018","1805","0000","148","122","26","16","164","306","0","53.59","39.87"
"10","010","00","018","1805","0480","148","122","26","16","164","306","0","53.59","39.87"
"10","010","00","018","1806","0000","111","93","18","3","114","311","0","36.66","29.9"
"10","010","00","018","1806","0479","111","93","18","3","114","311","0","36.66","29.9"
"10","010","00","018","1807","0000","430","349","81","24","454","827","0","54.9","42.2"
"10","010","00","018","1807","0482","430","349","81","24","454","827","0","54.9","42.2"
"10","010","00","018","1808","0000","403","329","74","8","411","970","0","42.37","33.92"
"10","010","00","018","1808","0481","403","329","74","8","411","970","0","42.37","33.92"
"10","010","00","018","1809","0000","114","88","26","0","114","238","0","47.9","36.97"
"10","010","00","018","1809","0483","114","88","26","0","114","238","0","47.9","36.97"
"10","010","00","018","1810","0000","111","82","29","7","118","479","0","24.63","17.12"
"10","010","00","018","1810","0484","111","82","29","7","118","479","0","24.63","17.12"
"10","010","00","018","1811","0000","89","69","20","6","95","291","0","32.65","23.71"
"10","010","00","018","1811","0485","89","69","20","6","95","291","0","32.65","23.71"
"10","010","00","018","1812","0000","140","101","39","18","158","246","0","64.23","41.06"
"10","010","00","018","1812","0486","140","101","39","18","158","246","0","64.23","41.06"
"10","013","00","000","0000","0000","328562","248756","79806","34063","362625","711720","826779","50.95","34.95"
"10","013","00","001","0000","0000","82801","64458","18343","5695","88496","170148","199807","52.01","37.88"
"10","013","00","001","0101","0000","371","261","110","27","398","713","0","55.82","36.61"
"10","013","00","001","0101","0004","371","261","110","27","398","713","0","55.82","36.61"
"10","013","00","001","0102","0000","140","107","33","2","142","249","0","57.03","42.97"
"10","013","00","001","0102","0007","140","107","33","2","142","249","0","57.03","42.97"
"10","013","00","001","0103","0000","138","92","46","27","165","294","0","56.12","31.29"
"10","013","00","001","0103","0002","138","92","46","27","165","294","0","56.12","31.29"
"10","013","00","001","0104","0000","280","188","92","15","295","582","0","50.69","32.3"
"10","013","00","001","0104","0003","280","188","92","15","295","582","0","50.69","32.3"
"10","013","00","001","0105","0000","268","200","68","12","280","455","0","61.54","43.96"
"10","013","00","001","0105","0006","268","200","68","12","280","455","0","61.54","43.96"
"10","013","00","001","0106","0000","121","78","43","7","128","237","0","54.01","32.91"
"10","013","00","001","0106","0001","121","78","43","7","128","237","0","54.01","32.91"
"10","013","00","001","0107","0000","279","205","74","36","315","572","0","55.07","35.84"
"10","013","00","001","0107","0005","279","205","74","36","315","572","0","55.07","35.84"
"10","013","00","001","0108","0000","399","288","111","40","439","713","0","61.57","40.39"
"10","013","00","001","0108","0010","399","288","111","40","439","713","0","61.57","40.39"
"10","013","00","001","0109","0000","322","233","89","42","364","573","0","63.53","40.66"
"10","013","00","001","0109","0011","322","233","89","42","364","573","0","63.53","40.66"
"10","013","00","001","0110","0000","263","189","74","18","281","409","0","68.7","46.21"
"10","013","00","001","0110","0013","263","189","74","18","281","409","0","68.7","46.21"
"10","013","00","001","0111","0000","178","122","56","21","199","297","0","67.0","41.08"
"10","013","00","001","0111","0012","178","122","56","21","199","297","0","67.0","41.08"
"10","013","00","001","0112","0000","1129","834","295","76","1205","2688","0","44.83","31.03"
"10","013","00","001","0112","0008","556","429","127","30","586","1315","0","44.56","32.62"
"10","013","00","001","0112","0009","573","405","168","46","619","1373","0","45.08","29.5"
"10","013","00","001","0113","0000","237","146","91","12","249","459","0","54.25","31.81"
"10","013","00","001","0113","0017","237","146","91","12","249","459","0","54.25","31.81"
"10","013","00","001","0114","0000","389","291","98","25","414","672","0","61.61","43.3"
"10","013","00","001","0114","0018","389","291","98","25","414","672","0","61.61","43.3"
"10","013","00","001","0115","0000","208","155","53","17","225","421","0","53.44","36.82"
"10","013","00","001","0115","0015","208","155","53","17","225","421","0","53.44","36.82"
"10","013","00","001","0116","0000","308","219","89","15","323","569","0","56.77","38.49"
"10","013","00","001","0116","0016","308","219","89","15","323","569","0","56.77","38.49"
"10","013","00","001","0117","0000","144","105","39","16","160","286","0","55.94","36.71"
"10","013","00","001","0117","0014","144","105","39","16","160","286","0","55.94","36.71"
"10","013","00","001","0118","0000","380","254","126","43","423","668","0","63.32","38.02"
"10","013","00","001","0118","0019","380","254","126","43","423","668","0","63.32","38.02"
"10","013","00","001","0119","0000","225","156","69","14","239","411","0","58.15","37.96"
"10","013","00","001","0119","0020","225","156","69","14","239","411","0","58.15","37.96"
"10","013","00","001","0120","0000","809","591","218","67","876","1554","0","56.37","38.03"
"10","013","00","001","0120","0021","406","292","114","33","439","768","0","57.16","38.02"
"10","013","00","001","0120","0022","403","299","104","34","437","786","0","55.6","38.04"
"10","013","00","001","0121","0000","483","348","135","38","521","890","0","58.54","39.1"
"10","013","00","001","0121","0023","483","348","135","38","521","890","0","58.54","39.1"
"10","013","00","001","0122","0000","977","803","174","68","1045","1911","0","54.68","42.02"
"10","013","00","001","0122","0039","446","386","60","38","484","939","0","51.54","41.11"
"10","013","00","001","0122","0040","531","417","114","30","561","972","0","57.72","42.9"
"10","013","00","001","0123","0000","1334","1014","320","113","1447","2517","0","57.49","40.29"
"10","013","00","001","0123","0034","683","530","153","55","738","1258","0","58.66","42.13"
"10","013","00","001","0123","0035","651","484","167","58","709","1259","0","56.31","38.44"
"10","013","00","001","0124","0000","1887","1467","420","107","1994","3556","0","56.07","41.25"
"10","013","00","001","0124","0036","544","425","119","41","585","1076","0","54.37","39.5"
"10","013","00","001","0124","0037","631","484","147","33","664","1162","0","57.14","41.65"
"10","013","00","001","0124","0038","712","558","154","33","745","1318","0","56.53","42.34"
"10","013","00","001","0125","0000","2028","1582","446","124","2152","4039","0","53.28","39.17"
"10","013","00","001","0125","0031","678","521","157","53","731","1297","0","56.36","40.17"
"10","013","00","001","0125","0032","681","536","145","29","710","1361","0","52.17","39.38"
"10","013","00","001","0125","0033","669","525","144","42","711","1381","0","51.48","38.02"
"10","013","00","001","0126","0000","4813","3748","1065","251","5064","9307","0","54.41","40.27"
"10","013","00","001","0126","0024","715","559","156","45","760","1353","0","56.17","41.32"
"10","013","00","001","0126","0025","686","523","163","27","713","1386","0","51.44","37.73"
"10","013","00","001","0126","0026","719","580","139","37","756","1413","0","53.5","41.05"
"10","013","00","001","0126","0027","652","516","136","35","687","1272","0","54.01","40.57"
"10","013","00","001","0126","0028","661","526","135","35","696","1287","0","54.08","40.87"
"10","013","00","001","0126","0029","711","549","162","46","757","1311","0","57.74","41.88"
"10","013","00","001","0126","0030","669","495","174","26","695","1285","0","54.09","38.52"
"10","013","00","001","0127","0000","633","472","161","107","740","1540","0","48.05","30.65"
"10","013","00","001","0127","0047","633","472","161","107","740","1540","0","48.05","30.65"
"10","013","00","001","0128","0000","529","406","123","62","591","1061","0","55.7","38.27"
"10","013","00","001","0128","0046","529","406","123","62","591","1061","0","55.7","38.27"
"10","013","00","001","0129","0000","488","356","132","20","508","1141","0","44.52","31.2"
"10","013","00","001","0129","0048","488","356","132","20","508","1141","0","44.52","31.2"
"10","013","00","001","0130","0000","3486","2805","681","187","3673","7243","0","50.71","38.73"
"10","013","00","001","0130","0041","830","652","178","30","860","1535","0","56.03","42.48"
"10","013","00","001","0130","0042","643","514","129","44","687","1419","0","48.41","36.22"
"10","013","00","001","0130","0043","648","503","145","22","670","1398","0","47.93","35.98"
"10","013","00","001","0130","0044","686","534","152","60","746","1405","0","53.1","38.01"
"10","013","00","001","0130","0045","679","602","77","31","710","1486","0","47.78","40.51"
"10","013","00","001","0131","0000","2695","2046","649","235","2930","5428","0","53.98","37.69"
"10","013","00","001","0131","0075","720","536","184","87","807","1485","0","54.34","36.09"
"10","013","00","001","0131","0076","702","547","155","61","763","1387","0","55.01","39.44"
"10","013","00","001","0131","0077","446","358","88","35","481","953","0","50.47","37.57"
"10","013","00","001","0131","0078","827","605","222","52","879","1603","0","54.83","37.74"
"10","013","00","001","0132","0000","250","187","63","36","286","535","0","53.46","34.95"
"10","013","00","001","0132","0079","250","187","63","36","286","535","0","53.46","34.95"
"10","013","00","001","0133","0000","1243","917","326","103","1346","2843","0","47.34","32.25"
"10","013","00","001","0133","0089","531","397","134","18","549","1215","0","45.19","32.67"
"10","013","00","001","0133","0090","712","520","192","85","797","1628","0","48.96","31.94"
"10","013","00","001","0134","0000","416","321","95","57","473","867","0","54.56","37.02"
"10","013","00","001","0134","0086","416","321","95","57","473","867","0","54.56","37.02"
"10","013","00","001","0135","0000","480","376","104","39","519","918","0","56.54","40.96"
"10","013","00","001","0135","0087","480","376","104","39","519","918","0","56.54","40.96"
"10","013","00","001","0136","0000","629","508","121","42","671","1209","0","55.5","42.02"
"10","013","00","001","0136","0091","629","508","121","42","671","1209","0","55.5","42.02"
"10","013","00","001","0137","0000","294","216","78","49","343","663","0","51.73","32.58"
"10","013","00","001","0137","0088","294","216","78","49","343","663","0","51.73","32.58"
"10","013","00","001","0138","0000","673","550","123","23","696","1110","0","62.7","49.55"
"10","013","00","001","0138","0092","673","550","123","23","696","1110","0","62.7","49.55"
"10","013","00","001","0139","0000","301","223","78","21","322","684","0","47.08","32.6"
"10","013","00","001","0139","0093","301","223","78","21","322","684","0","47.08","32.6"
"10","013","00","001","0140","0000","3374","2714","660","238","3612","7190","0","50.24","37.75"
"10","013","00","001","0140","0094","531","428","103","32","563","1349","0","41.73","31.73"
"10","013","00","001","0140","0095","660","623","37","57","717","1457","0","49.21","42.76"
"10","013","00","001","0140","0096","743","581","162","49","792","1447","0","54.73","40.15"
"10","013","00","001","0140","0097","630","473","157","28","658","1354","0","48.6","34.93"
"10","013","00","001","0140","0098","810","609","201","72","882","1583","0","55.72","38.47"
"10","013","00","001","0141","0000","1180","897","283","66","1246","2503","0","49.78","35.84"
"10","013","00","001","0141","0072","600","447","153","31","631","1284","0","49.14","34.81"
"10","013","00","001","0141","0073","580","450","130","35","615","1219","0","50.45","36.92"
"10","013","00","001","0142","0000","782","601","181","87","869","1544","0","56.28","38.92"
"10","013","00","001","0142","0074","782","601","181","87","869","1544","0","56.28","38.92"
"10","013","00","001","0143","0000","1081","829","252","93","1174","2266","0","51.81","36.58"
"10","013","00","001","0143","0083","568","441","127","41","609","1227","0","49.63","35.94"
"10","013","00","001","0143","0084","513","388","125","52","565","1039","0","54.38","37.34"
"10","013","00","001","0144","0000","689","507","182","97","786","1485","0","52.93","34.14"
"10","013","00","001","0144","0085","689","507","182","97","786","1485","0","52.93","34.14"
"10","013","00","001","0145","0000","530","430","100","44","574","1119","0","51.3","38.43"
"10","013","00","001","0145","0080","530","430","100","44","574","1119","0","51.3","38.43"
"10","013","00","001","0146","0000","905","679","226","111","1016","1770","0","57.4","38.36"
"10","013","00","001","0146","0081","434","333","101","38","472","847","0","55.73","39.32"
"10","013","00","001","0146","0082","471","346","125","73","544","923","0","58.94","37.49"
"10","013","00","001","0147","0000","107","105","2","4","111","391","0","28.39","26.85"
"10","013","00","001","0147","0060","107","105","2","4","111","391","0","28.39","26.85"
"10","013","00","001","0148","0000","117","94","23","4","121","231","0","52.38","40.69"
"10","013","00","001","0148","0063","117","94","23","4","121","231","0","52.38","40.69"
"10","013","00","001","0149","0000","952","699","253","113","1065","1998","0","53.3","34.98"
"10","013","00","001","0149","0064","462","332","130","55","517","945","0","54.71","35.13"
"10","013","00","001","0149","0065","490","367","123","58","548","1053","0","52.04","34.85"
"10","013","00","001","0150","0000","473","356","117","53","526","1043","0","50.43","34.13"
"10","013","00","001","0150","0066","473","356","117","53","526","1043","0","50.43","34.13"
"10","013","00","001","0151","0000","603","453","150","23","626","1205","0","51.95","37.59"
"10","013","00","001","0151","0071","603","453","150","23","626","1205","0","51.95","37.59"
"10","013","00","001","0153","0000","4118","3170","948","273","4391","8175","0","53.71","38.78"
"10","013","00","001","0153","0052","634","506","128","51","685","1253","0","54.67","40.38"
"10","013","00","001","0153","0053","662","517","145","50","712","1315","0","54.14","39.32"
"10","013","00","001","0153","0054","690","520","170","43","733","1425","0","51.44","36.49"
"10","013","00","001","0153","0055","673","521","152","33","706","1423","0","49.61","36.61"
"10","013","00","001","0153","0056","720","558","162","51","771","1400","0","55.07","39.86"
"10","013","00","001","0153","0057","739","548","191","45","784","1359","0","57.69","40.32"
"10","013","00","001","0154","0000","1305","967","338","177","1482","2922","0","50.72","33.09"
"10","013","00","001","0154","0069","658","481","177","111","769","1468","0","52.38","32.77"
"10","013","00","001","0154","0070","647","486","161","66","713","1454","0","49.04","33.43"
"10","013","00","001","0155","0000","1969","1563","406","114","2083","3996","0","52.13","39.11"
"10","013","00","001","0155","0049","574","455","119","36","610","1247","0","48.92","36.49"
"10","013","00","001","0155","0050","692","550","142","38","730","1446","0","50.48","38.04"
"10","013","00","001","0155","0051","703","558","145","40","743","1303","0","57.02","42.82"
"10","013","00","001","0156","0000","894","654","240","114","1008","1937","0","52.04","33.76"
"10","013","00","001","0156","0067","481","365","116","73","554","1061","0","52.21","34.4"
"10","013","00","001","0156","0068","413","289","124","41","454","876","0","51.83","32.99"
"10","013","00","001","0157","0000","141","103","38","25","166","328","0","50.61","31.4"
"10","013","00","001","0157","0062","141","103","38","25","166","328","0","50.61","31.4"
"10","013","00","001","0158","0000","106","79","27","11","117","200","0","58.5","39.5"
"10","013","00","001","0158","0061","106","79","27","11","117","200","0","58.5","39.5"
"10","013","00","001","0159","0000","915","697","218","44","959","1722","0","55.69","40.48"
"10","013","00","001","0159","0122","430","324","106","26","456","853","0","53.46","37.98"
"10","013","00","001","0159","0123","485","373","112","18","503","869","0","57.88","42.92"
"10","013","00","001","0160","0000","2531","2027","504","133","2664","4870","0","54.7","41.62"
"10","013","00","001","0160","0124","623","494","129","46","669","1169","0","57.23","42.26"
"10","013","00","001","0160","0125","559","444","115","26","585","1058","0","55.29","41.97"
"10","013","00","001","0160","0126","636","512","124","36","672","1344","0","50.0","38.1"
"10","013","00","001","0160","0127","713","577","136","25","738","1299","0","56.81","44.42"
"10","013","00","001","0161","0000","399","314","85","27","426","744","0","57.26","42.2"
"10","013","00","001","0161","0143","399","314","85","27","426","744","0","57.26","42.2"
"10","013","00","001","0162","0000","337","260","77","28","365","678","0","53.83","38.35"
"10","013","00","001","0162","0144","337","260","77","28","365","678","0","53.83","38.35"
"10","013","00","001","0163","0000","358","271","87","35","393","681","0","57.71","39.79"
"10","013","00","001","0163","0145","358","271","87","35","393","681","0","57.71","39.79"
"10","013","00","001","0164","0000","2287","1765","522","119","2406","4705","0","51.14","37.51"
"10","013","00","001","0164","0140","789","585","204","47","836","1491","0","56.07","39.24"
"10","013","00","001","0164","0141","638","505","133","39","677","1411","0","47.98","35.79"
"10","013","00","001","0164","0142","860","675","185","33","893","1803","0","49.53","37.44"
"10","013","00","001","0165","0000","2357","1868","489","128","2485","5541","0","44.85","33.71"
"10","013","00","001","0165","0118","481","387","94","42","523","1683","0","31.08","22.99"
"10","013","00","001","0165","0119","710","568","142","21","731","1497","0","48.83","37.94"
"10","013","00","001","0165","0120","537","404","133","26","563","1129","0","49.87","35.78"
"10","013","00","001","0165","0121","629","509","120","39","668","1232","0","54.22","41.31"
"10","013","00","001","0166","0000","791","611","180","45","836","1920","0","43.54","31.82"
"10","013","00","001","0166","0113","365","293","72","24","389","821","0","47.38","35.69"
"10","013","00","001","0166","0114","426","318","108","21","447","1099","0","40.67","28.94"
"10","013","00","001","0167","0000","1090","846","244","65","1155","2327","0","49.63","36.36"
"10","013","00","001","0167","0128","541","420","121","32","573","1204","0","47.59","34.88"
"10","013","00","001","0167","0129","549","426","123","33","582","1123","0","51.83","37.93"
"10","013","00","001","0168","0000","1238","954","284","78","1316","2404","0","54.74","39.68"
"10","013","00","001","0168","0138","689","541","148","49","738","1289","0","57.25","41.97"
"10","013","00","001","0168","0139","549","413","136","29","578","1115","0","51.84","37.04"
"10","013","00","001","0169","0000","3019","2391","628","138","3157","6072","0","51.99","39.38"
"10","013","00","001","0169","0133","530","416","114","33","563","1215","0","46.34","34.24"
"10","013","00","001","0169","0134","683","555","128","42","725","1370","0","52.92","40.51"
"10","013","00","001","0169","0135","610","488","122","15","625","1240","0","50.4","39.35"
"10","013","00","001","0169","0136","622","479","143","45","667","1168","0","57.11","41.01"
"10","013","00","001","0169","0137","574","453","121","3","577","1079","0","53.48","41.98"
"10","013","00","001","0170","0000","1190","936","254","66","1256","2172","0","57.83","43.09"
"10","013","00","001","0170","0148","569","448","121","35","604","1018","0","59.33","44.01"
"10","013","00","001","0170","0149","621","488","133","31","652","1154","0","56.5","42.29"
"10","013","00","001","0171","0000","975","731","244","97","1072","2082","0","51.49","35.11"
"10","013","00","001","0171","0116","538","408","130","45","583","1167","0","49.96","34.96"
"10","013","00","001","0171","0117","437","323","114","52","489","915","0","53.44","35.3"
"10","013","00","001","0173","0000","5810","4859","951","218","6028","11833","0","50.94","41.06"
"10","013","00","001","0173","0099","830","675","155","25","855","1707","0","50.09","39.54"
"10","013","00","001","0173","0100","753","697","56","27","780","1637","0","47.65","42.58"
"10","013","00","001","0173","0101","685","547","138","11","696","1459","0","47.7","37.49"
"10","013","00","001","0173","0102","945","740","205","47","992","1759","0","56.4","42.07"
"10","013","00","001","0173","0103","968","808","160","33","1001","1950","0","51.33","41.44"
"10","013","00","001","0173","0104","870","791","79","50","920","1729","0","53.21","45.75"
"10","013","00","001","0173","0105","759","601","158","25","784","1592","0","49.25","37.75"
"10","013","00","001","0174","0000","818","676","142","47","865","1688","0","51.24","40.05"
"10","013","00","001","0174","0115","818","676","142","47","865","1688","0","51.24","40.05"
"10","013","00","001","0175","0000","5527","4507","1020","261","5788","11483","0","50.4","39.25"
"10","013","00","001","0175","0106","684","549","135","38","722","1437","0","50.24","38.2"
"10","013","00","001","0175","0107","568","474","94","31","599","1204","0","49.75","39.37"
"10","013","00","001","0175","0108","696","557","139","38","734","1340","0","54.78","41.57"
"10","013","00","001","0175","0109","680","534","146","37","717","1322","0","54.24","40.39"
"10","013","00","001","0175","0110","692","565","127","39","731","1462","0","50.0","38.65"
"10","013","00","001","0175","0111","1520","1259","261","48","1568","3241","0","48.38","38.85"
"10","013","00","001","0175","0112","687","569","118","30","717","1477","0","48.54","38.52"
"10","013","00","001","0176","0000","549","417","132","39","588","1318","0","44.61","31.64"
"10","013","00","001","0176","0130","549","417","132","39","588","1318","0","44.61","31.64"
"10","013","00","001","0177","0000","454","334","120","60","514","865","0","59.42","38.61"
"10","013","00","001","0177","0131","454","334","120","60","514","865","0","59.42","38.61"
"10","013","00","001","0178","0000","450","350","100","27","477","1100","0","43.36","31.82"
"10","013","00","001","0178","0132","450","350","100","27","477","1100","0","43.36","31.82"
"10","013","00","001","0179","0000","476","355","121","77","553","954","0","57.97","37.21"
"10","013","00","001","0179","0147","476","355","121","77","553","954","0","57.97","37.21"
"10","013","00","001","0180","0000","224","88","136","32","256","1535","0","16.68","5.73"
"10","013","00","001","0180","0146","224","88","136","32","256","1535","0","16.68","5.73"
"10","013","00","001","0181","0000","1453","1242","211","70","1523","2867","0","53.12","43.32"
"10","013","00","001","0181","0058","688","593","95","27","715","1328","0","53.84","44.65"
"10","013","00","001","0181","0059","765","649","116","43","808","1539","0","52.5","42.17"
"10","013","00","002","0000","0000","21878","16646","5232","1897","23775","46444","53924","51.19","35.84"
"10","013","00","002","0201","0000","268","203","65","37","305","504","0","60.52","40.28"
"10","013","00","002","0201","0150","268","203","65","37","305","504","0","60.52","40.28"
"10","013","00","002","0202","0000","328","220","108","47","375","603","0","62.19","36.48"
"10","013","00","002","0202","0154","328","220","108","47","375","603","0","62.19","36.48"
"10","013","00","002","0203","0000","682","513","169","50","732","1245","0","58.8","41.2"
"10","013","00","002","0203","0170","682","513","169","50","732","1245","0","58.8","41.2"
"10","013","00","002","0204","0000","493","422","71","53","546","972","0","56.17","43.42"
"10","013","00","002","0204","0169","493","422","71","53","546","972","0","56.17","43.42"
"10","013","00","002","0205","0000","2145","1622","523","113","2258","4759","0","47.45","34.08"
"10","013","00","002","0205","0151","746","559","187","56","802","1711","0","46.87","32.67"
"10","013","00","002","0205","0152","780","580","200","28","808","1634","0","49.45","35.5"
"10","013","00","002","0205","0153","619","483","136","29","648","1414","0","45.83","34.16"
"10","013","00","002","0206","0000","424","319","105","63","487","896","0","54.35","35.6"
"10","013","00","002","0206","0155","424","319","105","63","487","896","0","54.35","35.6"
"10","013","00","002","0207","0000","2653","1991","662","240","2893","5309","0","54.49","37.5"
"10","013","00","002","0207","0156","617","458","159","58","675","1285","0","52.53","35.64"
"10","013","00","002","0207","0157","812","658","154","70","882","1744","0","50.57","37.73"
"10","013","00","002","0207","0158","581","436","145","46","627","1071","0","58.54","40.71"
"10","013","00","002","0207","0159","643","439","204","66","709","1209","0","58.64","36.31"
"10","013","00","002","0208","0000","3171","2420","751","246","3417","6490","0","52.65","37.29"
"10","013","00","002","0208","0160","561","429","132","46","607","1159","0","52.37","37.01"
"10","013","00","002","0208","0161","553","408","145","54","607","1296","0","46.84","31.48"
"10","013","00","002","0208","0162","740","586","154","45","785","1466","0","53.55","39.97"
"10","013","00","002","0208","0163","591","447","144","54","645","1130","0","57.08","39.56"
"10","013","00","002","0208","0164","726","550","176","47","773","1439","0","53.72","38.22"
"10","013","00","002","0209","0000","1105","888","217","102","1207","2122","0","56.88","41.85"
"10","013","00","002","0209","0165","469","380","89","53","522","897","0","58.19","42.36"
"10","013","00","002","0209","0166","636","508","128","49","685","1225","0","55.92","41.47"
"10","013","00","002","0210","0000","690","518","172","52","742","1415","0","52.44","36.61"
"10","013","00","002","0210","0171","690","518","172","52","742","1415","0","52.44","36.61"
"10","013","00","002","0211","0000","890","676","214","47","937","2313","0","40.51","29.23"
"10","013","00","002","0211","0172","519","408","111","17","536","1255","0","42.71","32.51"
"10","013","00","002","0211","0173","371","268","103","30","401","1058","0","37.9","25.33"
"10","013","00","002","0212","0000","1116","889","227","100","1216","2270","0","53.57","39.16"
"10","013","00","002","0212","0174","575","450","125","35","610","1187","0","51.39","37.91"
"10","013","00","002","0212","0175","541","439","102","65","606","1083","0","55.96","40.54"
"10","013","00","002","0213","0000","3313","2553","760","228","3541","7022","0","50.43","36.36"
"10","013","00","002","0213","0176","706","559","147","40","746","1590","0","46.92","35.16"
"10","013","00","002","0213","0177","681","510","171","66","747","1543","0","48.41","33.05"
"10","013","00","002","0213","0178","762","577","185","46","808","1631","0","49.54","35.38"
"10","013","00","002","0213","0179","588","474","114","35","623","1159","0","53.75","40.9"
"10","013","00","002","0213","0180","576","433","143","41","617","1099","0","56.14","39.4"
"10","013","00","002","0214","0000","540","404","136","57","597","1200","0","49.75","33.67"
"10","013","00","002","0214","0181","540","404","136","57","597","1200","0","49.75","33.67"
"10","013","00","002","0215","0000","639","502","137","65","704","1391","0","50.61","36.09"
"10","013","00","002","0215","0182","639","502","137","65","704","1391","0","50.61","36.09"
"10","013","00","002","0216","0000","442","333","109","65","507","881","0","57.55","37.8"
"10","013","00","002","0216","0183","442","333","109","65","507","881","0","57.55","37.8"
"10","013","00","002","0217","0000","167","115","52","27","194","454","0","42.73","25.33"
"10","013","00","002","0217","0184","167","115","52","27","194","454","0","42.73","25.33"
"10","013","00","002","0218","0000","714","521","193","87","801","1639","0","48.87","31.79"
"10","013","00","002","0218","0167","537","400","137","48","585","1158","0","50.52","34.54"
"10","013","00","002","0218","0168","177","121","56","39","216","481","0","44.91","25.16"
"10","013","00","002","0219","0000","780","561","219","95","875","1658","0","52.77","33.84"
"10","013","00","002","0219","0185","780","561","219","95","875","1658","0","52.77","33.84"
"10","013","00","002","0220","0000","718","526","192","56","774","1770","0","43.73","29.72"
"10","013","00","002","0220","0186","349","262","87","36","385","822","0","46.84","31.87"
"10","013","00","002","0220","0187","369","264","105","20","389","948","0","41.03","27.85"
"10","013","00","002","0221","0000","600","450","150","67","667","1531","0","43.57","29.39"
"10","013","00","002","0221","0188","444","334","110","32","476","1194","0","39.87","27.97"
"10","013","00","002","0221","0189","156","116","40","35","191","337","0","56.68","34.42"
"10","013","00","003","0000","0000","18425","13808","4617","2364","20789","39495","47654","52.64","34.96"
"10","013","00","003","0301","0000","1091","856","235","134","1225","2051","0","59.73","41.74"
"10","013","00","003","0301","0190","530","450","80","66","596","981","0","60.75","45.87"
"10","013","00","003","0301","0191","561","406","155","68","629","1070","0","58.79","37.94"
"10","013","00","003","0302","0000","289","222","67","52","341","527","0","64.71","42.13"
"10","013","00","003","0302","0192","289","222","67","52","341","527","0","64.71","42.13"
"10","013","00","003","0303","0000","208","144","64","29","237","395","0","60.0","36.46"
"10","013","00","003","0303","0193","208","144","64","29","237","395","0","60.0","36.46"
"10","013","00","003","0304","0000","291","224","67","47","338","659","0","51.29","33.99"
"10","013","00","003","0304","0194","291","224","67","47","338","659","0","51.29","33.99"
"10","013","00","003","0305","0000","249","177","72","26","275","513","0","53.61","34.5"
"10","013","00","003","0305","0195","249","177","72","26","275","513","0","53.61","34.5"
"10","013","00","003","0306","0000","355","260","95","36","391","695","0","56.26","37.41"
"10","013","00","003","0306","0203","355","260","95","36","391","695","0","56.26","37.41"
"10","013","00","003","0307","0000","821","594","227","127","948","1643","0","57.7","36.15"
"10","013","00","003","0307","0204","569","412","157","91","660","1076","0","61.34","38.29"
"10","013","00","003","0307","0205","252","182","70","36","288","567","0","50.79","32.1"
"10","013","00","003","0308","0000","352","262","90","48","400","806","0","49.63","32.51"
"10","013","00","003","0308","0206","352","262","90","48","400","806","0","49.63","32.51"
"10","013","00","003","0309","0000","606","452","154","77","683","1227","0","55.66","36.84"
"10","013","00","003","0309","0207","606","452","154","77","683","1227","0","55.66","36.84"
"10","013","00","003","0310","0000","259","187","72","62","321","599","0","53.59","31.22"
"10","013","00","003","0310","0208","259","187","72","62","321","599","0","53.59","31.22"
"10","013","00","003","0311","0000","504","362","142","46","550","1354","0","40.62","26.74"
"10","013","00","003","0311","0209","504","362","142","46","550","1354","0","40.62","26.74"
"10","013","00","003","0312","0000","827","591","236","196","1023","1841","0","55.57","32.1"
"10","013","00","003","0312","0210","318","230","88","70","388","734","0","52.86","31.34"
"10","013","00","003","0312","0211","509","361","148","126","635","1107","0","57.36","32.61"
"10","013","00","003","0313","0000","1183","883","300","230","1413","2812","0","50.25","31.4"
"10","013","00","003","0313","0212","499","380","119","93","592","1198","0","49.42","31.72"
"10","013","00","003","0313","0213","684","503","181","137","821","1614","0","50.87","31.16"
"10","013","00","003","0314","0000","818","619","199","119","937","1738","0","53.91","35.62"
"10","013","00","003","0314","0214","373","289","84","47","420","826","0","50.85","34.99"
"10","013","00","003","0314","0215","445","330","115","72","517","912","0","56.69","36.18"
"10","013","00","003","0315","0000","732","511","221","175","907","1636","0","55.44","31.23"
"10","013","00","003","0315","0216","173","117","56","52","225","432","0","52.08","27.08"
"10","013","00","003","0315","0217","559","394","165","123","682","1204","0","56.64","32.72"
"10","013","00","003","0316","0000","2546","1940","606","220","2766","5318","0","52.01","36.48"
"10","013","00","003","0316","0218","662","492","170","61","723","1304","0","55.44","37.73"
"10","013","00","003","0316","0219","680","517","163","66","746","1317","0","56.64","39.26"
"10","013","00","003","0316","0220","651","505","146","51","702","1387","0","50.61","36.41"
"10","013","00","003","0316","0221","553","426","127","42","595","1310","0","45.42","32.52"
"10","013","00","003","0317","0000","852","603","249","105","957","1994","0","47.99","30.24"
"10","013","00","003","0317","0222","535","388","147","49","584","1228","0","47.56","31.6"
"10","013","00","003","0317","0223","317","215","102","56","373","766","0","48.69","28.07"
"10","013","00","003","0318","0000","647","472","175","89","736","1578","0","46.64","29.91"
"10","013","00","003","0318","0224","403","280","123","67","470","823","0","57.11","34.02"
"10","013","00","003","0318","0225","244","192","52","22","266","755","0","35.23","25.43"
"10","013","00","003","0319","0000","4338","3351","987","395","4733","8957","0","52.84","37.41"
"10","013","00","003","0319","0196","815","609","206","66","881","1732","0","50.87","35.16"
"10","013","00","003","0319","0197","897","710","187","52","949","1779","0","53.34","39.91"
"10","013","00","003","0319","0198","586","434","152","57","643","1270","0","50.63","34.17"
"10","013","00","003","0319","0199","631","472","159","56","687","1327","0","51.77","35.57"
"10","013","00","003","0319","0200","628","477","151","65","693","1242","0","55.8","38.41"
"10","013","00","003","0319","0201","781","649","132","99","880","1607","0","54.76","40.39"
"10","013","00","003","0320","0000","577","444","133","40","617","1305","0","47.28","34.02"
"10","013","00","003","0320","0202","577","444","133","40","617","1305","0","47.28","34.02"
"10","013","00","003","0321","0000","538","389","149","84","622","1094","0","56.86","35.56"
"10","013","00","003","0321","0226","538","389","149","84","622","1094","0","56.86","35.56"
"10","013","00","003","0322","0000","342","265","77","27","369","753","0","49.0","35.19"
"10","013","00","003","0322","0227","342","265","77","27","369","753","0","49.0","35.19"
"10","013","00","004","0000","0000","10906","8238","2668","894","11800","25661","30812","45.98","32.1"
"10","013","00","004","0401","0000","404","309","95","33","437","902","0","48.45","34.26"
"10","013","00","004","0401","0228","404","309","95","33","437","902","0","48.45","34.26"
"10","013","00","004","0402","0000","1094","879","215","84","1178","2249","0","52.38","39.08"
"10","013","00","004","0402","0229","515","394","121","38","553","969","0","57.07","40.66"
"10","013","00","004","0402","0230","579","485","94","46","625","1280","0","48.83","37.89"
"10","013","00","004","0403","0000","575","442","133","31","606","1133","0","53.49","39.01"
"10","013","00","004","0403","0231","575","442","133","31","606","1133","0","53.49","39.01"
"10","013","00","004","0404","0000","1795","1395","400","125","1920","4159","0","46.16","33.54"
"10","013","00","004","0404","0246","672","511","161","35","707","1505","0","46.98","33.95"
"10","013","00","004","0404","0247","466","359","107","48","514","1111","0","46.26","32.31"
"10","013","00","004","0404","0248","657","525","132","42","699","1543","0","45.3","34.02"
"10","013","00","004","0405","0000","1159","903","256","73","1232","3037","0","40.57","29.73"
"10","013","00","004","0405","0232","600","482","118","18","618","1552","0","39.82","31.06"
"10","013","00","004","0405","0233","559","421","138","55","614","1485","0","41.35","28.35"
"10","013","00","004","0406","0000","445","311","134","36","481","896","0","53.68","34.71"
"10","013","00","004","0406","0234","445","311","134","36","481","896","0","53.68","34.71"
"10","013","00","004","0407","0000","219","154","65","26","245","531","0","46.14","29.0"
"10","013","00","004","0407","0235","219","154","65","26","245","531","0","46.14","29.0"
"10","013","00","004","0408","0000","196","141","55","14","210","478","0","43.93","29.5"
"10","013","00","004","0408","0236","196","141","55","14","210","478","0","43.93","29.5"
"10","013","00","004","0409","0000","449","322","127","40","489","1020","0","47.94","31.57"
"10","013","00","004","0409","0237","449","322","127","40","489","1020","0","47.94","31.57"
"10","013","00","004","0410","0000","409","272","137","23","432","924","0","46.75","29.44"
"10","013","00","004","0410","0238","409","272","137","23","432","924","0","46.75","29.44"
"10","013","00","004","0411","0000","421","320","101","19","440","1079","0","40.78","29.66"
"10","013","00","004","0411","0239","421","320","101","19","440","1079","0","40.78","29.66"
"10","013","00","004","0412","0000","636","485","151","73","709","1588","0","44.65","30.54"
"10","013","00","004","0412","0240","252","186","66","25","277","775","0","35.74","24.0"
"10","013","00","004","0412","0241","384","299","85","48","432","813","0","53.14","36.78"
"10","013","00","004","0413","0000","906","663","243","107","1013","2214","0","45.75","29.95"
"10","013","00","004","0413","0242","468","364","104","51","519","1104","0","47.01","32.97"
"10","013","00","004","0413","0243","438","299","139","56","494","1110","0","44.5","26.94"
"10","013","00","004","0414","0000","465","335","130","69","534","1400","0","38.14","23.93"
"10","013","00","004","0414","0244","235","162","73","62","297","692","0","42.92","23.41"
"10","013","00","004","0414","0245","230","173","57","7","237","708","0","33.47","24.44"
"10","013","00","004","0415","0000","707","517","190","51","758","1672","0","45.33","30.92"
"10","013","00","004","0415","0249","296","216","80","21","317","828","0","38.29","26.09"
"10","013","00","004","0415","0250","411","301","110","30","441","844","0","52.25","35.66"
"10","013","00","004","0416","0000","556","418","138","47","603","1253","0","48.12","33.36"
"10","013","00","004","0416","0251","556","418","138","47","603","1253","0","48.12","33.36"
"10","013","00","004","0417","0000","470","372","98","43","513","1126","0","45.56","33.04"
"10","013","00","004","0417","0252","470","372","98","43","513","1126","0","45.56","33.04"
"10","013","00","005","0000","0000","20447","15318","5129","2282","22729","43478","50595","52.28","35.23"
"10","013","00","005","0501","0000","319","235","84","28","347","595","0","58.32","39.5"
"10","013","00","005","0501","0267","319","235","84","28","347","595","0","58.32","39.5"
"10","013","00","005","0502","0000","454","334","120","31","485","847","0","57.26","39.43"
"10","013","00","005","0502","0262","454","334","120","31","485","847","0","57.26","39.43"
"10","013","00","005","0503","0000","1645","1250","395","148","1793","3458","0","51.85","36.15"
"10","013","00","005","0503","0263","533","403","130","47","580","1149","0","50.48","35.07"
"10","013","00","005","0503","0264","555","438","117","51","606","1131","0","53.58","38.73"
"10","013","00","005","0503","0265","557","409","148","50","607","1178","0","51.53","34.72"
"10","013","00","005","0504","0000","387","289","98","39","426","711","0","59.92","40.65"
"10","013","00","005","0504","0266","387","289","98","39","426","711","0","59.92","40.65"
"10","013","00","005","0505","0000","735","573","162","64","799","1403","0","56.95","40.84"
"10","013","00","005","0505","0268","735","573","162","64","799","1403","0","56.95","40.84"
"10","013","00","005","0506","0000","1086","845","241","79","1165","2252","0","51.73","37.52"
"10","013","00","005","0506","0269","499","400","99","34","533","1094","0","48.72","36.56"
"10","013","00","005","0506","0270","587","445","142","45","632","1158","0","54.58","38.43"
"10","013","00","005","0507","0000","1049","733","316","112","1161","2025","0","57.33","36.2"
"10","013","00","005","0507","0271","547","362","185","53","600","963","0","62.31","37.59"
"10","013","00","005","0507","0272","502","371","131","59","561","1062","0","52.82","34.93"
"10","013","00","005","0508","0000","783","575","208","107","890","1684","0","52.85","34.14"
"10","013","00","005","0508","0273","783","575","208","107","890","1684","0","52.85","34.14"
"10","013","00","005","0509","0000","1190","888","302","145","1335","2250","0","59.33","39.47"
"10","013","00","005","0509","0290","542","392","150","80","622","1023","0","60.8","38.32"
"10","013","00","005","0509","0291","648","496","152","65","713","1227","0","58.11","40.42"
"10","013","00","005","0510","0000","458","312","146","49","507","976","0","51.95","31.97"
"10","013","00","005","0510","0275","458","312","146","49","507","976","0","51.95","31.97"
"10","013","00","005","0511","0000","831","577","254","105","936","1860","0","50.32","31.02"
"10","013","00","005","0511","0276","492","354","138","64","556","1013","0","54.89","34.95"
"10","013","00","005","0511","0277","339","223","116","41","380","847","0","44.86","26.33"
"10","013","00","005","0512","0000","783","580","203","129","912","1570","0","58.09","36.94"
"10","013","00","005","0512","0278","783","580","203","129","912","1570","0","58.09","36.94"
"10","013","00","005","0513","0000","613","473","140","78","691","1411","0","48.97","33.52"
"10","013","00","005","0513","0279","613","473","140","78","691","1411","0","48.97","33.52"
"10","013","00","005","0514","0000","386","282","104","59","445","804","0","55.35","35.07"
"10","013","00","005","0514","0282","386","282","104","59","445","804","0","55.35","35.07"
"10","013","00","005","0515","0000","612","440","172","79","691","1284","0","53.82","34.27"
"10","013","00","005","0515","0283","612","440","172","79","691","1284","0","53.82","34.27"
"10","013","00","005","0516","0000","643","585","58","58","701","1430","0","49.02","40.91"
"10","013","00","005","0516","0284","643","585","58","58","701","1430","0","49.02","40.91"
"10","013","00","005","0517","0000","529","400","129","68","597","960","0","62.19","41.67"
"10","013","00","005","0517","0285","529","400","129","68","597","960","0","62.19","41.67"
"10","013","00","005","0518","0000","986","698","288","139","1125","1944","0","57.87","35.91"
"10","013","00","005","0518","0286","428","315","113","48","476","786","0","60.56","40.08"
"10","013","00","005","0518","0287","558","383","175","91","649","1158","0","56.04","33.07"
"10","013","00","005","0519","0000","687","532","155","83","770","1666","0","46.22","31.93"
"10","013","00","005","0519","0289","687","532","155","83","770","1666","0","46.22","31.93"
"10","013","00","005","0520","0000","645","493","152","64","709","1647","0","43.05","29.93"
"10","013","00","005","0520","0288","645","493","152","64","709","1647","0","43.05","29.93"
"10","013","00","005","0521","0000","737","586","151","50","787","1702","0","46.24","34.43"
"10","013","00","005","0521","0274","737","586","151","50","787","1702","0","46.24","34.43"
"10","013","00","005","0522","0000","891","682","209","118","1009","2096","0","48.14","32.54"
"10","013","00","005","0522","0254","493","390","103","71","564","1147","0","49.17","34.0"
"10","013","00","005","0522","0255","398","292","106","47","445","949","0","46.89","30.77"
"10","013","00","005","0523","0000","536","407","129","59","595","1527","0","38.97","26.65"
"10","013","00","005","0523","0253","536","407","129","59","595","1527","0","38.97","26.65"
"10","013","00","005","0524","0000","527","382","145","73","600","1046","0","57.36","36.52"
"10","013","00","005","0524","0280","527","382","145","73","600","1046","0","57.36","36.52"
"10","013","00","005","0525","0000","848","637","211","44","892","2012","0","44.33","31.66"
"10","013","00","005","0525","0256","445","326","119","30","475","990","0","47.98","32.93"
"10","013","00","005","0525","0257","403","311","92","14","417","1022","0","40.8","30.43"
"10","013","00","005","0526","0000","594","423","171","36","630","1385","0","45.49","30.54"
"10","013","00","005","0526","0281","594","423","171","36","630","1385","0","45.49","30.54"
"10","013","00","005","0527","0000","578","442","136","93","671","1159","0","57.89","38.14"
"10","013","00","005","0527","0259","578","442","136","93","671","1159","0","57.89","38.14"
"10","013","00","005","0528","0000","424","302","122","72","496","837","0","59.26","36.08"
"10","013","00","005","0528","0260","424","302","122","72","496","837","0","59.26","36.08"
"10","013","00","005","0529","0000","309","229","80","58","367","545","0","67.34","42.02"
"10","013","00","005","0529","0258","309","229","80","58","367","545","0","67.34","42.02"
"10","013","00","005","0530","0000","182","134","48","15","197","392","0","50.26","34.18"
"10","013","00","005","0530","0261","182","134","48","15","197","392","0","50.26","34.18"
"10","013","00","006","0000","0000","12745","9495","3250","1553","14298","26256","29714","54.46","36.16"
"10","013","00","006","0601","0000","1298","973","325","151","1449","2632","0","55.05","36.97"
"10","013","00","006","0601","0292","503","375","128","68","571","1018","0","56.09","36.84"
"10","013","00","006","0601","0293","795","598","197","83","878","1614","0","54.4","37.05"
"10","013","00","006","0602","0000","1834","1408","426","165","1999","3555","0","56.23","39.61"
"10","013","00","006","0602","0294","959","742","217","88","1047","1848","0","56.66","40.15"
"10","013","00","006","0602","0295","875","666","209","77","952","1707","0","55.77","39.02"
"10","013","00","006","0603","0000","1015","784","231","103","1118","1961","0","57.01","39.98"
"10","013","00","006","0603","0296","510","401","109","40","550","972","0","56.58","41.26"
"10","013","00","006","0603","0297","505","383","122","63","568","989","0","57.43","38.73"
"10","013","00","006","0604","0000","1221","891","330","117","1338","2548","0","52.51","34.97"
"10","013","00","006","0604","0298","390","280","110","55","445","735","0","60.54","38.1"
"10","013","00","006","0604","0299","831","611","220","62","893","1813","0","49.26","33.7"
"10","013","00","006","0605","0000","595","446","149","53","648","1073","0","60.39","41.57"
"10","013","00","006","0605","0300","595","446","149","53","648","1073","0","60.39","41.57"
"10","013","00","006","0606","0000","444","341","103","59","503","884","0","56.9","38.57"
"10","013","00","006","0606","0305","444","341","103","59","503","884","0","56.9","38.57"
"10","013","00","006","0607","0000","552","423","129","70","622","1090","0","57.06","38.81"
"10","013","00","006","0607","0306","552","423","129","70","622","1090","0","57.06","38.81"
"10","013","00","006","0608","0000","710","500","210","97","807","1492","0","54.09","33.51"
"10","013","00","006","0608","0304","710","500","210","97","807","1492","0","54.09","33.51"
"10","013","00","006","0609","0000","795","697","98","78","873","1654","0","52.78","42.14"
"10","013","00","006","0609","0301","795","697","98","78","873","1654","0","52.78","42.14"
"10","013","00","006","0610","0000","608","434","174","73","681","1205","0","56.51","36.02"
"10","013","00","006","0610","0302","608","434","174","73","681","1205","0","56.51","36.02"
"10","013","00","006","0611","0000","385","279","106","46","431","758","0","56.86","36.81"
"10","013","00","006","0611","0303","385","279","106","46","431","758","0","56.86","36.81"
"10","013","00","006","0612","0000","1008","760","248","135","1143","2401","0","47.61","31.65"
"10","013","00","006","0612","0311","577","428","149","113","690","1242","0","55.56","34.46"
"10","013","00","006","0612","0312","431","332","99","22","453","1159","0","39.09","28.65"
"10","013","00","006","0613","0000","824","590","234","163","987","1770","0","55.76","33.33"
"10","013","00","006","0613","0308","397","286","111","64","461","845","0","54.56","33.85"
"10","013","00","006","0613","0309","427","304","123","99","526","925","0","56.86","32.86"
"10","013","00","006","0614","0000","575","307","268","108","683","1422","0","48.03","21.59"
"10","013","00","006","0614","0307","575","307","268","108","683","1422","0","48.03","21.59"
"10","013","00","006","0615","0000","516","401","115","98","614","1138","0","53.95","35.24"
"10","013","00","006","0615","0310","516","401","115","98","614","1138","0","53.95","35.24"
"10","013","00","006","0616","0000","365","261","104","37","402","673","0","59.73","38.78"
"10","013","00","006","0616","0313","365","261","104","37","402","673","0","59.73","38.78"
"10","013","00","007","0000","0000","5146","3938","1208","423","5569","9970","11068","55.86","39.5"
"10","013","00","007","0701","0000","1170","907","263","65","1235","2174","0","56.81","41.72"
"10","013","00","007","0701","0314","408","315","93","37","445","788","0","56.47","39.97"
"10","013","00","007","0701","0315","762","592","170","28","790","1386","0","57.0","42.71"
"10","013","00","007","0702","0000","524","405","119","53","577","957","0","60.29","42.32"
"10","013","00","007","0702","0316","524","405","119","53","577","957","0","60.29","42.32"
"10","013","00","007","0703","0000","837","646","191","110","947","1537","0","61.61","42.03"
"10","013","00","007","0703","0317","392","305","87","51","443","731","0","60.6","41.72"
"10","013","00","007","0703","0318","445","341","104","59","504","806","0","62.53","42.31"
"10","013","00","007","0704","0000","1265","976","289","97","1362","2547","0","53.47","38.32"
"10","013","00","007","0704","0319","538","403","135","17","555","1207","0","45.98","33.39"
"10","013","00","007","0704","0320","727","573","154","80","807","1340","0","60.22","42.76"
"10","013","00","007","0705","0000","638","466","172","64","702","1221","0","57.49","38.17"
"10","013","00","007","0705","0321","638","466","172","64","702","1221","0","57.49","38.17"
"10","013","00","007","0706","0000","402","307","95","19","421","851","0","49.47","36.08"
"10","013","00","007","0706","0322","402","307","95","19","421","851","0","49.47","36.08"
"10","013","00","007","0707","0000","310","231","79","15","325","683","0","47.58","33.82"
"10","013","00","007","0707","0323","310","231","79","15","325","683","0","47.58","33.82"
"10","013","00","008","0000","0000","9042","6789","2253","1276","10318","19132","22095","53.93","35.49"
"10","013","00","008","0801","0000","755","567","188","81","836","1491","0","56.07","38.03"
"10","013","00","008","0801","0324","755","567","188","81","836","1491","0","56.07","38.03"
"10","013","00","008","0802","0000","660","497","163","73","733","1375","0","53.31","36.15"
"10","013","00","008","0802","0325","660","497","163","73","733","1375","0","53.31","36.15"
"10","013","00","008","0803","0000","740","597","143","51","791","1678","0","47.14","35.58"
"10","013","00","008","0803","0326","740","597","143","51","791","1678","0","47.14","35.58"
"10","013","00","008","0804","0000","491","359","132","56","547","1276","0","42.87","28.13"
"10","013","00","008","0804","0328","491","359","132","56","547","1276","0","42.87","28.13"
"10","013","00","008","0805","0000","593","449","144","85","678","1166","0","58.15","38.51"
"10","013","00","008","0805","0327","593","449","144","85","678","1166","0","58.15","38.51"
"10","013","00","008","0806","0000","706","507","199","118","824","1600","0","51.5","31.69"
"10","013","00","008","0806","0334","706","507","199","118","824","1600","0","51.5","31.69"
"10","013","00","008","0807","0000","838","595","243","199","1037","1792","0","57.87","33.2"
"10","013","00","008","0807","0336","838","595","243","199","1037","1792","0","57.87","33.2"
"10","013","00","008","0808","0000","589","435","154","91","680","1248","0","54.49","34.86"
"10","013","00","008","0808","0335","589","435","154","91","680","1248","0","54.49","34.86"
"10","013","00","008","0809","0000","708","533","175","102","810","1482","0","54.66","35.96"
"10","013","00","008","0809","0337","708","533","175","102","810","1482","0","54.66","35.96"
"10","013","00","008","0810","0000","2097","1578","519","310","2407","4414","0","54.53","35.75"
"10","013","00","008","0810","0331","331","240","91","67","398","649","0","61.33","36.98"
"10","013","00","008","0810","0332","938","699","239","151","1089","1999","0","54.48","34.97"
"10","013","00","008","0810","0333","828","639","189","92","920","1766","0","52.1","36.18"
"10","013","00","008","0811","0000","865","672","193","110","975","1610","0","60.56","41.74"
"10","013","00","008","0811","0329","502","391","111","76","578","1033","0","55.95","37.85"
"10","013","00","008","0811","0330","363","281","82","34","397","577","0","68.8","48.7"
"10","013","00","009","0000","0000","10639","7828","2811","1417","12056","22128","26092","54.48","35.38"
"10","013","00","009","0901","0000","1528","1157","371","170","1698","3032","0","56.0","38.16"
"10","013","00","009","0901","0338","816","619","197","94","910","1552","0","58.63","39.88"
"10","013","00","009","0901","0339","712","538","174","76","788","1480","0","53.24","36.35"
"10","013","00","009","0902","0000","616","451","165","61","677","1127","0","60.07","40.02"
"10","013","00","009","0902","0342","616","451","165","61","677","1127","0","60.07","40.02"
"10","013","00","009","0903","0000","436","339","97","56","492","845","0","58.22","40.12"
"10","013","00","009","0903","0343","436","339","97","56","492","845","0","58.22","40.12"
"10","013","00","009","0904","0000","601","450","151","64","665","1282","0","51.87","35.1"
"10","013","00","009","0904","0344","601","450","151","64","665","1282","0","51.87","35.1"
"10","013","00","009","0905","0000","1030","772","258","131","1161","2012","0","57.7","38.37"
"10","013","00","009","0905","0345","511","388","123","56","567","981","0","57.8","39.55"
"10","013","00","009","0905","0346","519","384","135","75","594","1031","0","57.61","37.25"
"10","013","00","009","0906","0000","693","493","200","107","800","1423","0","56.22","34.65"
"10","013","00","009","0906","0347","693","493","200","107","800","1423","0","56.22","34.65"
"10","013","00","009","0907","0000","622","430","192","55","677","1534","0","44.13","28.03"
"10","013","00","009","0907","0340","622","430","192","55","677","1534","0","44.13","28.03"
"10","013","00","009","0908","0000","737","549","188","113","850","1578","0","53.87","34.79"
"10","013","00","009","0908","0341","737","549","188","113","850","1578","0","53.87","34.79"
"10","013","00","009","0909","0000","706","494","212","157","863","1566","0","55.11","31.55"
"10","013","00","009","0909","0348","140","94","46","26","166","363","0","45.73","25.9"
"10","013","00","009","0909","0349","566","400","166","131","697","1203","0","57.94","33.25"
"10","013","00","009","0910","0000","1147","831","316","133","1280","2411","0","53.09","34.47"
"10","013","00","009","0910","0350","562","401","161","72","634","1027","0","61.73","39.05"
"10","013","00","009","0910","0351","585","430","155","61","646","1384","0","46.68","31.07"
"10","013","00","009","0911","0000","973","767","206","112","1085","2034","0","53.34","37.71"
"10","013","00","009","0911","0352","685","526","159","92","777","1512","0","51.39","34.79"
"10","013","00","009","0911","0353","288","241","47","20","308","522","0","59.0","46.17"
"10","013","00","009","0912","0000","824","583","241","165","989","1829","0","54.07","31.88"
"10","013","00","009","0912","0354","391","287","104","68","459","822","0","55.84","34.91"
"10","013","00","009","0912","0355","433","296","137","97","530","1007","0","52.63","29.39"
"10","013","00","009","0913","0000","469","317","152","68","537","956","0","56.17","33.16"
"10","013","00","009","0913","0356","469","317","152","68","537","956","0","56.17","33.16"
"10","013","00","009","0914","0000","257","195","62","25","282","499","0","56.51","39.08"
"10","013","00","009","0914","0357","257","195","62","25","282","499","0","56.51","39.08"
"10","013","00","010","0000","0000","10266","7682","2584","1126","11392","22402","25740","50.85","34.29"
"10","013","00","010","1001","0000","1356","998","358","158","1514","3148","0","48.09","31.7"
"10","013","00","010","1001","0370","641","498","143","44","685","1598","0","42.87","31.16"
"10","013","00","010","1001","0371","715","500","215","114","829","1550","0","53.48","32.26"
"10","013","00","010","1002","0000","1232","917","315","138","1370","2832","0","48.38","32.38"
"10","013","00","010","1002","0365","635","458","177","73","708","1367","0","51.79","33.5"
"10","013","00","010","1002","0366","597","459","138","65","662","1465","0","45.19","31.33"
"10","013","00","010","1003","0000","834","642","192","64","898","1850","0","48.54","34.7"
"10","013","00","010","1003","0358","439","350","89","35","474","951","0","49.84","36.8"
"10","013","00","010","1003","0359","395","292","103","29","424","899","0","47.16","32.48"
"10","013","00","010","1004","0000","1005","775","230","84","1089","2357","0","46.2","32.88"
"10","013","00","010","1004","0360","432","334","98","36","468","1116","0","41.94","29.93"
"10","013","00","010","1004","0361","573","441","132","48","621","1241","0","50.04","35.54"
"10","013","00","010","1005","0000","786","605","181","104","890","1732","0","51.39","34.93"
"10","013","00","010","1005","0362","335","251","84","53","388","770","0","50.39","32.6"
"10","013","00","010","1005","0363","451","354","97","51","502","962","0","52.18","36.8"
"10","013","00","010","1006","0000","559","429","130","71","630","1041","0","60.52","41.21"
"10","013","00","010","1006","0364","559","429","130","71","630","1041","0","60.52","41.21"
"10","013","00","010","1007","0000","757","542","215","58","815","1852","0","44.01","29.27"
"10","013","00","010","1007","0367","363","252","111","54","417","894","0","46.64","28.19"
"10","013","00","010","1007","0368","394","290","104","4","398","958","0","41.54","30.27"
"10","013","00","010","1008","0000","272","196","76","33","305","553","0","55.15","35.44"
"10","013","00","010","1008","0377","272","196","76","33","305","553","0","55.15","35.44"
"10","013","00","010","1009","0000","401","303","98","90","491","924","0","53.14","32.79"
"10","013","00","010","1009","0369","401","303","98","90","491","924","0","53.14","32.79"
"10","013","00","010","1010","0000","783","546","237","71","854","1619","0","52.75","33.72"
"10","013","00","010","1010","0376","783","546","237","71","854","1619","0","52.75","33.72"
"10","013","00","010","1011","0000","1727","1296","431","218","1945","3510","0","55.41","36.92"
"10","013","00","010","1011","0372","528","406","122","73","601","1127","0","53.33","36.02"
"10","013","00","010","1011","0373","589","437","152","80","669","1150","0","58.17","38.0"
"10","013","00","010","1011","0374","610","453","157","65","675","1233","0","54.74","36.74"
"10","013","00","010","1012","0000","554","433","121","37","591","984","0","60.06","44.0"
"10","013","00","010","1012","0375","554","433","121","37","591","984","0","60.06","44.0"
"10","013","00","011","0000","0000","9056","6606","2450","1304","10360","21697","24444","47.75","30.45"
"10","013","00","011","1101","0000","885","642","243","117","1002","2138","0","46.87","30.03"
"10","013","00","011","1101","0378","457","331","126","88","545","883","0","61.72","37.49"
"10","013","00","011","1101","0379","428","311","117","29","457","1255","0","36.41","24.78"
"10","013","00","011","1102","0000","568","412","156","38","606","1278","0","47.42","32.24"
"10","013","00","011","1102","0380","568","412","156","38","606","1278","0","47.42","32.24"
"10","013","00","011","1103","0000","289","217","72","28","317","738","0","42.95","29.4"
"10","013","00","011","1103","0381","289","217","72","28","317","738","0","42.95","29.4"
"10","013","00","011","1104","0000","235","167","68","14","249","585","0","42.56","28.55"
"10","013","00","011","1104","0382","235","167","68","14","249","585","0","42.56","28.55"
"10","013","00","011","1105","0000","454","330","124","134","588","1012","0","58.1","32.61"
"10","013","00","011","1105","0383","454","330","124","134","588","1012","0","58.1","32.61"
"10","013","00","011","1106","0000","474","352","122","89","563","1148","0","49.04","30.66"
"10","013","00","011","1106","0384","474","352","122","89","563","1148","0","49.04","30.66"
"10","013","00","011","1107","0000","255","173","82","40","295","591","0","49.92","29.27"
"10","013","00","011","1107","0385","255","173","82","40","295","591","0","49.92","29.27"
"10","013","00","011","1108","0000","295","221","74","58","353","786","0","44.91","28.12"
"10","013","00","011","1108","0386","295","221","74","58","353","786","0","44.91","28.12"
"10","013","00","011","1109","0000","240","181","59","24","264","649","0","40.68","27.89"
"10","013","00","011","1109","0387","240","181","59","24","264","649","0","40.68","27.89"
"10","013","00","011","1110","0000","423","303","120","78","501","1229","0","40.76","24.65"
"10","013","00","011","1110","0388","423","303","120","78","501","1229","0","40.76","24.65"
"10","013","00","011","1111","0000","517","392","125","68","585","1446","0","40.46","27.11"
"10","013","00","011","1111","0389","517","392","125","68","585","1446","0","40.46","27.11"
"10","013","00","011","1112","0000","735","512","223","77","812","1821","0","44.59","28.12"
"10","013","00","011","1112","0390","325","218","107","15","340","899","0","37.82","24.25"
"10","013","00","011","1112","0391","410","294","116","62","472","922","0","51.19","31.89"
"10","013","00","011","1113","0000","514","379","135","73","587","1259","0","46.62","30.1"
"10","013","00","011","1113","0392","514","379","135","73","587","1259","0","46.62","30.1"
"10","013","00","011","1114","0000","354","273","81","28","382","1056","0","36.17","25.85"
"10","013","00","011","1114","0393","354","273","81","28","382","1056","0","36.17","25.85"
"10","013","00","011","1115","0000","527","384","143","74","601","1116","0","53.85","34.41"
"10","013","00","011","1115","0394","527","384","143","74","601","1116","0","53.85","34.41"
"10","013","00","011","1116","0000","494","361","133","89","583","1020","0","57.16","35.39"
"10","013","00","011","1116","0395","494","361","133","89","583","1020","0","57.16","35.39"
"10","013","00","011","1117","0000","481","341","140","92","573","1055","0","54.31","32.32"
"10","013","00","011","1117","0396","481","341","140","92","573","1055","0","54.31","32.32"
"10","013","00","011","1118","0000","568","414","154","75","643","1231","0","52.23","33.63"
"10","013","00","011","1118","0397","375","267","108","48","423","738","0","57.32","36.18"
"10","013","00","011","1118","0398","193","147","46","27","220","493","0","44.62","29.82"
"10","013","00","011","1119","0000","748","552","196","108","856","1539","0","55.62","35.87"
"10","013","00","011","1119","0399","748","552","196","108","856","1539","0","55.62","35.87"
"10","013","00","012","0000","0000","7879","5851","2028","1026","8905","17945","20585","49.62","32.61"
"10","013","00","012","1201","0000","532","385","147","40","572","1239","0","46.17","31.07"
"10","013","00","012","1201","0400","532","385","147","40","572","1239","0","46.17","31.07"
"10","013","00","012","1202","0000","367","270","97","58","425","759","0","55.99","35.57"
"10","013","00","012","1202","0401","367","270","97","58","425","759","0","55.99","35.57"
"10","013","00","012","1203","0000","855","649","206","155","1010","1701","0","59.38","38.15"
"10","013","00","012","1203","0402","454","342","112","93","547","932","0","58.69","36.7"
"10","013","00","012","1203","0403","401","307","94","62","463","769","0","60.21","39.92"
"10","013","00","012","1204","0000","429","313","116","73","502","920","0","54.57","34.02"
"10","013","00","012","1204","0404","429","313","116","73","502","920","0","54.57","34.02"
"10","013","00","012","1205","0000","287","210","77","39","326","560","0","58.21","37.5"
"10","013","00","012","1205","0405","287","210","77","39","326","560","0","58.21","37.5"
"10","013","00","012","1206","0000","470","359","111","29","499","1120","0","44.55","32.05"
"10","013","00","012","1206","0406","470","359","111","29","499","1120","0","44.55","32.05"
"10","013","00","012","1207","0000","453","350","103","31","484","1048","0","46.18","33.4"
"10","013","00","012","1207","0407","453","350","103","31","484","1048","0","46.18","33.4"
"10","013","00","012","1208","0000","570","437","133","47","617","1438","0","42.91","30.39"
"10","013","00","012","1208","0408","570","437","133","47","617","1438","0","42.91","30.39"
"10","013","00","012","1209","0000","881","647","234","127","1008","2027","0","49.73","31.92"
"10","013","00","012","1209","0411","384","285","99","47","431","1020","0","42.25","27.94"
"10","013","00","012","1209","0412","497","362","135","80","577","1007","0","57.3","35.95"
"10","013","00","012","1210","0000","701","489","212","138","839","1647","0","50.94","29.69"
"10","013","00","012","1210","0409","353","244","109","63","416","834","0","49.88","29.26"
"10","013","00","012","1210","0410","348","245","103","75","423","813","0","52.03","30.14"
"10","013","00","012","1211","0000","634","466","168","95","729","1648","0","44.24","28.28"
"10","013","00","012","1211","0413","634","466","168","95","729","1648","0","44.24","28.28"
"10","013","00","012","1212","0000","654","487","167","67","721","1437","0","50.17","33.89"
"10","013","00","012","1212","0414","654","487","167","67","721","1437","0","50.17","33.89"
"10","013","00","012","1213","0000","477","355","122","22","499","1228","0","40.64","28.91"
"10","013","00","012","1213","0415","477","355","122","22","499","1228","0","40.64","28.91"
"10","013","00","012","1214","0000","569","434","135","105","674","1173","0","57.46","37.0"
"10","013","00","012","1214","0416","307","248","59","53","360","597","0","60.3","41.54"
"10","013","00","012","1214","0417","262","186","76","52","314","576","0","54.51","32.29"
"10","013","00","013","0000","0000","20076","15290","4786","1864","21940","47558","54167","46.13","32.15"
"10","013","00","013","1301","0000","1698","1307","391","94","1792","3979","0","45.04","32.85"
"10","013","00","013","1301","0418","558","422","136","39","597","1305","0","45.75","32.34"
"10","013","00","013","1301","0419","535","414","121","38","573","1287","0","44.52","32.17"
"10","013","00","013","1301","0420","605","471","134","17","622","1387","0","44.84","33.96"
"10","013","00","013","1302","0000","1355","1056","299","106","1461","3145","0","46.45","33.58"
"10","013","00","013","1302","0421","657","515","142","53","710","1540","0","46.1","33.44"
"10","013","00","013","1302","0422","698","541","157","53","751","1605","0","46.79","33.71"
"10","013","00","013","1303","0000","598","457","141","56","654","1326","0","49.32","34.46"
"10","013","00","013","1303","0423","598","457","141","56","654","1326","0","49.32","34.46"
"10","013","00","013","1304","0000","284","201","83","50","334","591","0","56.51","34.01"
"10","013","00","013","1304","0424","284","201","83","50","334","591","0","56.51","34.01"
"10","013","00","013","1305","0000","967","735","232","68","1035","2202","0","47.0","33.38"
"10","013","00","013","1305","0425","480","363","117","47","527","1123","0","46.93","32.32"
"10","013","00","013","1305","0426","487","372","115","21","508","1079","0","47.08","34.48"
"10","013","00","013","1306","0000","1350","1064","286","115","1465","2733","0","53.6","38.93"
"10","013","00","013","1306","0427","695","530","165","71","766","1485","0","51.58","35.69"
"10","013","00","013","1306","0428","655","534","121","44","699","1248","0","56.01","42.79"
"10","013","00","013","1307","0000","1953","1514","439","133","2086","4482","0","46.54","33.78"
"10","013","00","013","1307","0429","733","572","161","50","783","1569","0","49.9","36.46"
"10","013","00","013","1307","0430","649","485","164","61","710","1493","0","47.56","32.48"
"10","013","00","013","1307","0431","571","457","114","22","593","1420","0","41.76","32.18"
"10","013","00","013","1308","0000","1270","965","305","160","1430","2853","0","50.12","33.82"
"10","013","00","013","1308","0432","609","472","137","83","692","1334","0","51.87","35.38"
"10","013","00","013","1308","0433","661","493","168","77","738","1519","0","48.58","32.46"
"10","013","00","013","1309","0000","799","606","193","123","922","1672","0","55.14","36.24"
"10","013","00","013","1309","0434","367","281","86","54","421","784","0","53.7","35.84"
"10","013","00","013","1309","0435","432","325","107","69","501","888","0","56.42","36.6"
"10","013","00","013","1310","0000","667","497","170","44","711","1915","0","37.13","25.95"
"10","013","00","013","1310","0436","243","187","56","15","258","747","0","34.54","25.03"
"10","013","00","013","1310","0437","424","310","114","29","453","1168","0","38.78","26.54"
"10","013","00","013","1311","0000","853","641","212","96","949","1824","0","52.03","35.14"
"10","013","00","013","1311","0438","271","197","74","41","312","546","0","57.14","36.08"
"10","013","00","013","1311","0439","582","444","138","55","637","1278","0","49.84","34.74"
"10","013","00","013","1312","0000","1085","806","279","139","1224","2898","0","42.24","27.81"
"10","013","00","013","1312","0440","526","383","143","50","576","1348","0","42.73","28.41"
"10","013","00","013","1312","0441","559","423","136","89","648","1550","0","41.81","27.29"
"10","013","00","013","1313","0000","492","364","128","82","574","947","0","60.61","38.44"
"10","013","00","013","1313","0442","492","364","128","82","574","947","0","60.61","38.44"
"10","013","00","013","1314","0000","488","354","134","77","565","1097","0","51.5","32.27"
"10","013","00","013","1314","0443","488","354","134","77","565","1097","0","51.5","32.27"
"10","013","00","013","1315","0000","808","573","235","72","880","2381","0","36.96","24.07"
"10","013","00","013","1315","0444","427","290","137","48","475","1128","0","42.11","25.71"
"10","013","00","013","1315","0445","381","283","98","24","405","1253","0","32.32","22.59"
"10","013","00","013","1316","0000","517","390","127","31","548","1525","0","35.93","25.57"
"10","013","00","013","1316","0446","517","390","127","31","548","1525","0","35.93","25.57"
"10","013","00","013","1317","0000","1020","784","236","111","1131","2431","0","46.52","32.25"
"10","013","00","013","1317","0447","550","407","143","87","637","1215","0","52.43","33.5"
"10","013","00","013","1317","0448","470","377","93","24","494","1216","0","40.63","31.0"
"10","013","00","013","1318","0000","991","779","212","78","1069","2379","0","44.93","32.74"
"10","013","00","013","1318","0449","549","437","112","34","583","1353","0","43.09","32.3"
"10","013","00","013","1318","0450","442","342","100","44","486","1026","0","47.37","33.33"
"10","013","00","013","1319","0000","346","267","79","30","376","862","0","43.62","30.97"
"10","013","00","013","1319","0451","346","267","79","30","376","862","0","43.62","30.97"
"10","013","00","013","1320","0000","709","513","196","49","758","1775","0","42.7","28.9"
"10","013","00","013","1320","0452","331","228","103","25","356","921","0","38.65","24.76"
"10","013","00","013","1320","0453","378","285","93","24","402","854","0","47.07","33.37"
"10","013","00","013","1321","0000","932","711","221","65","997","2434","0","40.96","29.21"
"10","013","00","013","1321","0454","471","362","109","44","515","1230","0","41.87","29.43"
"10","013","00","013","1321","0455","461","349","112","21","482","1204","0","40.03","28.99"
"10","013","00","013","1322","0000","492","387","105","40","532","1301","0","40.89","29.75"
"10","013","00","013","1322","0456","492","387","105","40","532","1301","0","40.89","29.75"
"10","013","00","013","1323","0000","402","319","83","45","447","806","0","55.46","39.58"
"10","013","00","013","1323","0457","402","319","83","45","447","806","0","55.46","39.58"
"10","013","00","014","0000","0000","7873","5870","2003","909","8782","15353","17181","57.2","38.23"
"10","013","00","014","1401","0000","743","561","182","92","835","1503","0","55.56","37.33"
"10","013","00","014","1401","0458","743","561","182","92","835","1503","0","55.56","37.33"
"10","013","00","014","1402","0000","510","391","119","44","554","899","0","61.62","43.49"
"10","013","00","014","1402","0459","510","391","119","44","554","899","0","61.62","43.49"
"10","013","00","014","1403","0000","403","298","105","47","450","716","0","62.85","41.62"
"10","013","00","014","1403","0460","403","298","105","47","450","716","0","62.85","41.62"
"10","013","00","014","1404","0000","336","232","104","46","382","581","0","65.75","39.93"
"10","013","00","014","1404","0461","336","232","104","46","382","581","0","65.75","39.93"
"10","013","00","014","1405","0000","630","462","168","110","740","1327","0","55.76","34.82"
"10","013","00","014","1405","0462","630","462","168","110","740","1327","0","55.76","34.82"
"10","013","00","014","1406","0000","537","372","165","83","620","997","0","62.19","37.31"
"10","013","00","014","1406","0463","537","372","165","83","620","997","0","62.19","37.31"
"10","013","00","014","1407","0000","321","239","82","22","343","649","0","52.85","36.83"
"10","013","00","014","1407","0464","321","239","82","22","343","649","0","52.85","36.83"
"10","013","00","014","1408","0000","317","247","70","28","345","476","0","72.48","51.89"
"10","013","00","014","1408","0465","317","247","70","28","345","476","0","72.48","51.89"
"10","013","00","014","1409","0000","1244","933","311","132","1376","2486","0","55.35","37.53"
"10","013","00","014","1409","0466","671","500","171","64","735","1259","0","58.38","39.71"
"10","013","00","014","1409","0467","573","433","140","68","641","1227","0","52.24","35.29"
"10","013","00","014","1410","0000","277","219","58","45","322","504","0","63.89","43.45"
"10","013","00","014","1410","0468","277","219","58","45","322","504","0","63.89","43.45"
"10","013","00","014","1411","0000","410","308","102","52","462","860","0","53.72","35.81"
"10","013","00","014","1411","0469","410","308","102","52","462","860","0","53.72","35.81"
"10","013","00","014","1412","0000","389","306","83","17","406","800","0","50.75","38.25"
"10","013","00","014","1412","0470","389","306","83","17","406","800","0","50.75","38.25"
"10","013","00","014","1413","0000","590","435","155","63","653","1134","0","57.58","38.36"
"10","013","00","014","1413","0471","590","435","155","63","653","1134","0","57.58","38.36"
"10","013","00","014","1414","0000","612","437","175","65","677","1229","0","55.09","35.56"
"10","013","00","014","1414","0472","612","437","175","65","677","1229","0","55.09","35.56"
"10","013","00","014","1415","0000","554","430","124","63","617","1192","0","51.76","36.07"
"10","013","00","014","1415","0473","554","430","124","63","617","1192","0","51.76","36.07"
"10","013","00","015","0000","0000","3980","2922","1058","490","4470","9033","10035","49.49","32.35"
"10","013","00","015","1501","0000","875","675","200","74","949","2026","0","46.84","33.32"
"10","013","00","015","1501","0474","726","568","158","50","776","1712","0","45.33","33.18"
"10","013","00","015","1501","0475","149","107","42","24","173","314","0","55.1","34.08"
"10","013","00","015","1502","0000","529","385","144","60","589","1086","0","54.24","35.45"
"10","013","00","015","1502","0476","368","269","99","38","406","752","0","53.99","35.77"
"10","013","00","015","1502","0477","161","116","45","22","183","334","0","54.79","34.73"
"10","013","00","015","1503","0000","482","360","122","54","536","957","0","56.01","37.62"
"10","013","00","015","1503","0478","482","360","122","54","536","957","0","56.01","37.62"
"10","013","00","015","1504","0000","391","279","112","60","451","764","0","59.03","36.52"
"10","013","00","015","1504","0479","391","279","112","60","451","764","0","59.03","36.52"
"10","013","00","015","1505","0000","740","535","205","99","839","1752","0","47.89","30.54"
"10","013","00","015","1505","0480","179","116","63","34","213","373","0","57.1","31.1"
"10","013","00","015","1505","0481","280","203","77","34","314","678","0","46.31","29.94"
"10","013","00","015","1505","0482","281","216","65","31","312","701","0","44.51","30.81"
"10","013","00","015","1506","0000","493","365","128","79","572","1125","0","50.84","32.44"
"10","013","00","015","1506","0484","262","188","74","47","309","541","0","57.12","34.75"
"10","013","00","015","1506","0485","231","177","54","32","263","584","0","45.03","30.31"
"10","013","00","015","1507","0000","470","323","147","64","534","1323","0","40.36","24.41"
"10","013","00","015","1507","0483","470","323","147","64","534","1323","0","40.36","24.41"
"10","013","00","016","0000","0000","9818","7274","2544","1418","11236","21394","24413","52.52","34.0"
"10","013","00","016","1601","0000","604","463","141","76","680","1213","0","56.06","38.17"
"10","013","00","016","1601","0486","604","463","141","76","680","1213","0","56.06","38.17"
"10","013","00","016","1602","0000","435","324","111","77","512","891","0","57.46","36.36"
"10","013","00","016","1602","0487","435","324","111","77","512","891","0","57.46","36.36"
"10","013","00","016","1603","0000","410","292","118","87","497","970","0","51.24","30.1"
"10","013","00","016","1603","0488","410","292","118","87","497","970","0","51.24","30.1"
"10","013","00","016","1604","0000","304","232","72","32","336","629","0","53.42","36.88"
"10","013","00","016","1604","0489","304","232","72","32","336","629","0","53.42","36.88"
"10","013","00","016","1605","0000","823","608","215","89","912","1614","0","56.51","37.67"
"10","013","00","016","1605","0490","428","313","115","48","476","840","0","56.67","37.26"
"10","013","00","016","1605","0491","395","295","100","41","436","774","0","56.33","38.11"
"10","013","00","016","1606","0000","1940","1439","501","247","2187","4157","0","52.61","34.62"
"10","013","00","016","1606","0492","633","454","179","83","716","1379","0","51.92","32.92"
"10","013","00","016","1606","0493","739","567","172","76","815","1502","0","54.26","37.75"
"10","013","00","016","1606","0494","568","418","150","88","656","1276","0","51.41","32.76"
"10","013","00","016","1607","0000","953","729","224","162","1115","1969","0","56.63","37.02"
"10","013","00","016","1607","0495","440","327","113","71","511","964","0","53.01","33.92"
"10","013","00","016","1607","0496","513","402","111","91","604","1005","0","60.1","40.0"
"10","013","00","016","1608","0000","658","517","141","89","747","1459","0","51.2","35.44"
"10","013","00","016","1608","0497","315","244","71","24","339","734","0","46.19","33.24"
"10","013","00","016","1608","0498","343","273","70","65","408","725","0","56.28","37.66"
"10","013","00","016","1609","0000","971","703","268","145","1116","2113","0","52.82","33.27"
"10","013","00","016","1609","0499","437","299","138","76","513","1046","0","49.04","28.59"
"10","013","00","016","1609","0500","534","404","130","69","603","1067","0","56.51","37.86"
"10","013","00","016","1610","0000","210","137","73","66","276","718","0","38.44","19.08"
"10","013","00","016","1610","0501","210","137","73","66","276","718","0","38.44","19.08"
"10","013","00","016","1611","0000","375","269","106","50","425","903","0","47.07","29.79"
"10","013","00","016","1611","0502","375","269","106","50","425","903","0","47.07","29.79"
"10","013","00","016","1612","0000","350","260","90","36","386","959","0","40.25","27.11"
"10","013","00","016","1612","0506","350","260","90","36","386","959","0","40.25","27.11"
"10","013","00","016","1613","0000","201","164","37","34","235","427","0","55.04","38.41"
"10","013","00","016","1613","0507","201","164","37","34","235","427","0","55.04","38.41"
"10","013","00","016","1614","0000","1252","927","325","175","1427","2754","0","51.82","33.66"
"10","013","00","016","1614","0503","600","426","174","89","689","1387","0","49.68","30.71"
"10","013","00","016","1614","0504","652","501","151","86","738","1367","0","53.99","36.65"
"10","013","00","016","1615","0000","332","210","122","53","385","618","0","62.3","33.98"
"10","013","00","016","1615","0505","332","210","122","53","385","618","0","62.3","33.98"
"10","013","00","017","0000","0000","13890","10271","3619","1967","15857","30706","34961","51.64","33.45"
"10","013","00","017","1701","0000","873","664","209","108","981","1663","0","58.99","39.93"
"10","013","00","017","1701","0508","422","307","115","50","472","820","0","57.56","37.44"
"10","013","00","017","1701","0509","451","357","94","58","509","843","0","60.38","42.35"
"10","013","00","017","1702","0000","1260","962","298","124","1384","2532","0","54.66","37.99"
"10","013","00","017","1702","0510","585","454","131","58","643","1242","0","51.77","36.55"
"10","013","00","017","1702","0511","675","508","167","66","741","1290","0","57.44","39.38"
"10","013","00","017","1703","0000","961","667","294","161","1122","2161","0","51.92","30.87"
"10","013","00","017","1703","0512","513","390","123","51","564","1073","0","52.56","36.35"
"10","013","00","017","1703","0513","448","277","171","110","558","1088","0","51.29","25.46"
"10","013","00","017","1704","0000","380","283","97","38","418","845","0","49.47","33.49"
"10","013","00","017","1704","0514","380","283","97","38","418","845","0","49.47","33.49"
"10","013","00","017","1705","0000","421","298","123","48","469","862","0","54.41","34.57"
"10","013","00","017","1705","0515","421","298","123","48","469","862","0","54.41","34.57"
"10","013","00","017","1706","0000","1036","745","291","164","1200","2292","0","52.36","32.5"
"10","013","00","017","1706","0516","515","371","144","74","589","1183","0","49.79","31.36"
"10","013","00","017","1706","0517","521","374","147","90","611","1109","0","55.09","33.72"
"10","013","00","017","1707","0000","992","739","253","55","1047","2271","0","46.1","32.54"
"10","013","00","017","1707","0518","468","354","114","13","481","1119","0","42.98","31.64"
"10","013","00","017","1707","0519","524","385","139","42","566","1152","0","49.13","33.42"
"10","013","00","017","1708","0000","507","376","131","0","507","1240","0","40.89","30.32"
"10","013","00","017","1708","0522","507","376","131","0","507","1240","0","40.89","30.32"
"10","013","00","017","1709","0000","944","696","248","99","1043","2194","0","47.54","31.72"
"10","013","00","017","1709","0523","390","284","106","29","419","1120","0","37.41","25.36"
"10","013","00","017","1709","0524","554","412","142","70","624","1074","0","58.1","38.36"
"10","013","00","017","1710","0000","696","509","187","112","808","1598","0","50.56","31.85"
"10","013","00","017","1710","0525","353","265","88","44","397","849","0","46.76","31.21"
"10","013","00","017","1710","0526","343","244","99","68","411","749","0","54.87","32.58"
"10","013","00","017","1711","0000","622","457","165","94","716","1416","0","50.56","32.27"
"10","013","00","017","1711","0527","622","457","165","94","716","1416","0","50.56","32.27"
"10","013","00","017","1712","0000","1010","747","263","150","1160","2134","0","54.36","35.0"
"10","013","00","017","1712","0520","519","380","139","54","573","1030","0","55.63","36.89"
"10","013","00","017","1712","0521","491","367","124","96","587","1104","0","53.17","33.24"
"10","013","00","017","1713","0000","1313","1003","310","196","1509","2800","0","53.89","35.82"
"10","013","00","017","1713","0528","408","312","96","72","480","895","0","53.63","34.86"
"10","013","00","017","1713","0529","451","353","98","67","518","933","0","55.52","37.83"
"10","013","00","017","1713","0530","454","338","116","57","511","972","0","52.57","34.77"
"10","013","00","017","1714","0000","1858","1394","464","346","2204","4377","0","50.35","31.85"
"10","013","00","017","1714","0531","519","383","136","89","608","1454","0","41.82","26.34"
"10","013","00","017","1714","0532","813","619","194","152","965","1653","0","58.38","37.45"
"10","013","00","017","1714","0533","526","392","134","105","631","1270","0","49.69","30.87"
"10","013","00","017","1715","0000","1017","731","286","272","1289","2321","0","55.54","31.5"
"10","013","00","017","1715","0534","531","375","156","146","677","1123","0","60.28","33.39"
"10","013","00","017","1715","0535","486","356","130","126","612","1198","0","51.09","29.72"
"10","013","00","018","0000","0000","5700","4264","1436","588","6288","12270","15524","51.25","34.75"
"10","013","00","018","1801","0000","1033","784","249","111","1144","2234","0","51.21","35.09"
"10","013","00","018","1801","0536","518","399","119","43","561","1190","0","47.14","33.53"
"10","013","00","018","1801","0537","515","385","130","68","583","1044","0","55.84","36.88"
"10","013","00","018","1802","0000","974","714","260","101","1075","2032","0","52.9","35.14"
"10","013","00","018","1802","0538","404","283","121","48","452","818","0","55.26","34.6"
"10","013","00","018","1802","0539","570","431","139","53","623","1214","0","51.32","35.5"
"10","013","00","018","1803","0000","633","484","149","66","699","1253","0","55.79","38.63"
"10","013","00","018","1803","0541","633","484","149","66","699","1253","0","55.79","38.63"
"10","013","00","018","1804","0000","563","429","134","40","603","1325","0","45.51","32.38"
"10","013","00","018","1804","0540","563","429","134","40","603","1325","0","45.51","32.38"
"10","013","00","018","1805","0000","474","367","107","54","528","1039","0","50.82","35.32"
"10","013","00","018","1805","0542","474","367","107","54","528","1039","0","50.82","35.32"
"10","013","00","018","1806","0000","649","466","183","66","715","1549","0","46.16","30.08"
"10","013","00","018","1806","0543","341","248","93","44","385","813","0","47.36","30.5"
"10","013","00","018","1806","0544","308","218","90","22","330","736","0","44.84","29.62"
"10","013","00","018","1807","0000","483","355","128","42","525","934","0","56.21","38.01"
"10","013","00","018","1807","0545","483","355","128","42","525","934","0","56.21","38.01"
"10","013","00","018","1808","0000","891","665","226","108","999","1904","0","52.47","34.93"
"10","013","00","018","1808","0546","416","296","120","55","471","900","0","52.33","32.89"
"10","013","00","018","1808","0547","475","369","106","53","528","1004","0","52.59","36.75"
"10","013","00","019","0000","0000","7589","5595","1994","1007","8596","15691","17842","54.78","35.66"
"10","013","00","019","1901","0000","741","555","186","117","858","1458","0","58.85","38.07"
"10","013","00","019","1901","0548","741","555","186","117","858","1458","0","58.85","38.07"
"10","013","00","019","1902","0000","847","653","194","88","935","1586","0","58.95","41.17"
"10","013","00","019","1902","0549","469","350","119","50","519","891","0","58.25","39.28"
"10","013","00","019","1902","0550","378","303","75","38","416","695","0","59.86","43.6"
"10","013","00","019","1903","0000","832","590","242","126","958","1634","0","58.63","36.11"
"10","013","00","019","1903","0555","419","297","122","69","488","841","0","58.03","35.32"
"10","013","00","019","1903","0556","413","293","120","57","470","793","0","59.27","36.95"
"10","013","00","019","1904","0000","421","291","130","39","460","725","0","63.45","40.14"
"10","013","00","019","1904","0554","421","291","130","39","460","725","0","63.45","40.14"
"10","013","00","019","1905","0000","1603","1195","408","199","1802","3189","0","56.51","37.47"
"10","013","00","019","1905","0551","525","372","153","78","603","1015","0","59.41","36.65"
"10","013","00","019","1905","0552","617","476","141","57","674","1171","0","57.56","40.65"
"10","013","00","019","1905","0553","461","347","114","64","525","1003","0","52.34","34.6"
"10","013","00","019","1906","0000","730","525","205","105","835","1816","0","45.98","28.91"
"10","013","00","019","1906","0559","319","217","102","52","371","783","0","47.38","27.71"
"10","013","00","019","1906","0560","411","308","103","53","464","1033","0","44.92","29.82"
"10","013","00","019","1907","0000","578","420","158","61","639","1283","0","49.81","32.74"
"10","013","00","019","1907","0558","578","420","158","61","639","1283","0","49.81","32.74"
"10","013","00","019","1908","0000","483","362","121","62","545","919","0","59.3","39.39"
"10","013","00","019","1908","0557","483","362","121","62","545","919","0","59.3","39.39"
"10","013","00","019","1909","0000","882","648","234","172","1054","1959","0","53.8","33.08"
"10","013","00","019","1909","0561","533","393","140","101","634","1186","0","53.46","33.14"
"10","013","00","019","1909","0562","349","255","94","71","420","773","0","54.33","32.99"
"10","013","00","019","1910","0000","472","356","116","38","510","1122","0","45.45","31.73"
"10","013","00","019","1910","0563","472","356","116","38","510","1122","0","45.45","31.73"
"10","013","00","020","0000","0000","4377","3287","1090","571","4948","9479","10650","52.2","34.68"
"10","013","00","020","2001","0000","772","585","187","98","870","1666","0","52.22","35.11"
"10","013","00","020","2001","0564","389","300","89","48","437","872","0","50.11","34.4"
"10","013","00","020","2001","0565","383","285","98","50","433","794","0","54.53","35.89"
"10","013","00","020","2002","0000","505","369","136","51","556","962","0","57.8","38.36"
"10","013","00","020","2002","0566","505","369","136","51","556","962","0","57.8","38.36"
"10","013","00","020","2003","0000","247","176","71","24","271","466","0","58.15","37.77"
"10","013","00","020","2003","0569","247","176","71","24","271","466","0","58.15","37.77"
"10","013","00","020","2004","0000","380","303","77","36","416","708","0","58.76","42.8"
"10","013","00","020","2004","0570","380","303","77","36","416","708","0","58.76","42.8"
"10","013","00","020","2005","0000","523","378","145","63","586","1033","0","56.73","36.59"
"10","013","00","020","2005","0567","523","378","145","63","586","1033","0","56.73","36.59"
"10","013","00","020","2006","0000","460","341","119","54","514","1007","0","51.04","33.86"
"10","013","00","020","2006","0568","460","341","119","54","514","1007","0","51.04","33.86"
"10","013","00","020","2007","0000","468","397","71","123","591","1044","0","56.61","38.03"
"10","013","00","020","2007","0571","468","397","71","123","591","1044","0","56.61","38.03"
"10","013","00","020","2008","0000","377","270","107","51","428","1071","0","39.96","25.21"
"10","013","00","020","2008","0572","377","270","107","51","428","1071","0","39.96","25.21"
"10","013","00","020","2009","0000","406","284","122","37","443","979","0","45.25","29.01"
"10","013","00","020","2009","0573","406","284","122","37","443","979","0","45.25","29.01"
"10","013","00","020","2010","0000","239","184","55","34","273","543","0","50.28","33.89"
"10","013","00","020","2010","0574","239","184","55","34","273","543","0","50.28","33.89"
"10","013","00","021","0000","0000","7315","5642","1673","1050","8365","17063","19172","49.02","33.07"
"10","013","00","021","2101","0000","604","460","144","83","687","1472","0","46.67","31.25"
"10","013","00","021","2101","0575","604","460","144","83","687","1472","0","46.67","31.25"
"10","013","00","021","2102","0000","523","392","131","73","596","1360","0","43.82","28.82"
"10","013","00","021","2102","0576","523","392","131","73","596","1360","0","43.82","28.82"
"10","013","00","021","2103","0000","391","273","118","72","463","804","0","57.59","33.96"
"10","013","00","021","2103","0577","391","273","118","72","463","804","0","57.59","33.96"
"10","013","00","021","2104","0000","758","635","123","101","859","1780","0","48.26","35.67"
"10","013","00","021","2104","0578","410","287","123","76","486","925","0","52.54","31.03"
"10","013","00","021","2104","0579","348","348","0","25","373","855","0","43.63","40.7"
"10","013","00","021","2105","0000","852","663","189","127","979","1988","0","49.25","33.35"
"10","013","00","021","2105","0580","425","331","94","57","482","981","0","49.13","33.74"
"10","013","00","021","2105","0581","427","332","95","70","497","1007","0","49.35","32.97"
"10","013","00","021","2106","0000","838","597","241","106","944","2127","0","44.38","28.07"
"10","013","00","021","2106","0582","342","235","107","57","399","872","0","45.76","26.95"
"10","013","00","021","2106","0583","496","362","134","49","545","1255","0","43.43","28.84"
"10","013","00","021","2107","0000","515","414","101","101","616","995","0","61.91","41.61"
"10","013","00","021","2107","0584","515","414","101","101","616","995","0","61.91","41.61"
"10","013","00","021","2108","0000","251","184","67","28","279","734","0","38.01","25.07"
"10","013","00","021","2108","0585","251","184","67","28","279","734","0","38.01","25.07"
"10","013","00","021","2109","0000","443","343","100","39","482","1178","0","40.92","29.12"
"10","013","00","021","2109","0586","443","343","100","39","482","1178","0","40.92","29.12"
"10","013","00","021","2110","0000","448","325","123","53","501","1095","0","45.75","29.68"
"10","013","00","021","2110","0587","448","325","123","53","501","1095","0","45.75","29.68"
"10","013","00","021","2111","0000","523","384","139","118","641","1097","0","58.43","35.0"
"10","013","00","021","2111","0588","523","384","139","118","641","1097","0","58.43","35.0"
"10","013","00","021","2112","0000","1169","972","197","149","1318","2433","0","54.17","39.95"
"10","013","00","021","2112","0589","583","549","34","80","663","1273","0","52.08","43.13"
"10","013","00","021","2112","0590","586","423","163","69","655","1160","0","56.47","36.47"
"10","013","00","022","0000","0000","3795","2928","867","552","4347","10706","12395","40.6","27.35"
"10","013","00","022","2201","0000","766","599","167","105","871","2083","0","41.81","28.76"
"10","013","00","022","2201","0591","395","312","83","49","444","1111","0","39.96","28.08"
"10","013","00","022","2201","0592","371","287","84","56","427","972","0","43.93","29.53"
"10","013","00","022","2202","0000","569","439","130","80","649","1278","0","50.78","34.35"
"10","013","00","022","2202","0593","569","439","130","80","649","1278","0","50.78","34.35"
"10","013","00","022","2203","0000","410","330","80","85","495","976","0","50.72","33.81"
"10","013","00","022","2203","0594","410","330","80","85","495","976","0","50.72","33.81"
"10","013","00","022","2204","0000","697","549","148","90","787","1658","0","47.47","33.11"
"10","013","00","022","2204","0595","697","549","148","90","787","1658","0","47.47","33.11"
"10","013","00","022","2205","0000","384","300","84","56","440","1146","0","38.39","26.18"
"10","013","00","022","2205","0596","384","300","84","56","440","1146","0","38.39","26.18"
"10","013","00","022","2206","0000","167","88","79","48","215","1079","0","19.93","8.16"
"10","013","00","022","2206","0597","167","88","79","48","215","1079","0","19.93","8.16"
"10","013","00","022","2207","0000","415","328","87","31","446","1613","0","27.65","20.33"
"10","013","00","022","2207","0598","415","328","87","31","446","1613","0","27.65","20.33"
"10","013","00","022","2208","0000","387","295","92","57","444","873","0","50.86","33.79"
"10","013","00","022","2208","0599","387","295","92","57","444","873","0","50.86","33.79"
"10","013","00","023","0000","0000","2725","1997","728","297","3022","7595","8619","39.79","26.29"
"10","013","00","023","2301","0000","557","412","145","56","613","1347","0","45.51","30.59"
"10","013","00","023","2301","0602","192","146","46","24","216","491","0","43.99","29.74"
"10","013","00","023","2301","0603","365","266","99","32","397","856","0","46.38","31.07"
"10","013","00","023","2302","0000","214","155","59","9","223","554","0","40.25","27.98"
"10","013","00","023","2302","0604","214","155","59","9","223","554","0","40.25","27.98"
"10","013","00","023","2303","0000","206","155","51","35","241","647","0","37.25","23.96"
"10","013","00","023","2303","0601","206","155","51","35","241","647","0","37.25","23.96"
"10","013","00","023","2304","0000","262","183","79","47","309","737","0","41.93","24.83"
"10","013","00","023","2304","0600","262","183","79","47","309","737","0","41.93","24.83"
"10","013","00","023","2305","0000","136","104","32","4","140","388","0","36.08","26.8"
"10","013","00","023","2305","0605","136","104","32","4","140","388","0","36.08","26.8"
"10","013","00","023","2306","0000","316","229","87","47","363","922","0","39.37","24.84"
"10","013","00","023","2306","0606","316","229","87","47","363","922","0","39.37","24.84"
"10","013","00","023","2307","0000","341","256","85","17","358","1220","0","29.34","20.98"
"10","013","00","023","2307","0607","175","134","41","4","179","597","0","29.98","22.45"
"10","013","00","023","2307","0608","166","122","44","13","179","623","0","28.73","19.58"
"10","013","00","023","2308","0000","167","121","46","24","191","425","0","44.94","28.47"
"10","013","00","023","2308","0609","167","121","46","24","191","425","0","44.94","28.47"
"10","013","00","023","2309","0000","193","146","47","22","215","428","0","50.23","34.11"
"10","013","00","023","2309","0610","193","146","47","22","215","428","0","50.23","34.11"
"10","013","00","023","2310","0000","150","112","38","14","164","504","0","32.54","22.22"
"10","013","00","023","2310","0611","150","112","38","14","164","504","0","32.54","22.22"
"10","013","00","023","2311","0000","183","124","59","22","205","423","0","48.46","29.31"
"10","013","00","023","2311","0612","183","124","59","22","205","423","0","48.46","29.31"
"10","013","00","024","0000","0000","2775","2125","650","219","2994","7206","8068","41.55","29.49"
"10","013","00","024","2401","0000","654","478","176","48","702","1575","0","44.57","30.35"
"10","013","00","024","2401","0613","654","478","176","48","702","1575","0","44.57","30.35"
"10","013","00","024","2402","0000","177","142","35","9","186","420","0","44.29","33.81"
"10","013","00","024","2402","0614","177","142","35","9","186","420","0","44.29","33.81"
"10","013","00","024","2403","0000","439","318","121","18","457","1302","0","35.1","24.42"
"10","013","00","024","2403","0616","439","318","121","18","457","1302","0","35.1","24.42"
"10","013","00","024","2404","0000","558","500","58","50","608","1314","0","46.27","38.05"
"10","013","00","024","2404","0617","558","500","58","50","608","1314","0","46.27","38.05"
"10","013","00","024","2405","0000","318","232","86","31","349","602","0","57.97","38.54"
"10","013","00","024","2405","0615","318","232","86","31","349","602","0","57.97","38.54"
"10","013","00","024","2406","0000","362","261","101","28","390","1308","0","29.82","19.95"
"10","013","00","024","2406","0618","362","261","101","28","390","1308","0","29.82","19.95"
"10","013","00","024","2407","0000","124","78","46","12","136","367","0","37.06","21.25"
"10","013","00","024","2407","0619","124","78","46","12","136","367","0","37.06","21.25"
"10","013","00","024","2408","0000","143","116","27","23","166","318","0","52.2","36.48"
"10","013","00","024","2408","0620","143","116","27","23","166","318","0","52.2","36.48"
"10","013","00","025","0000","0000","2154","1577","577","247","2401","4856","5547","49.44","32.48"
"10","013","00","025","2501","0000","565","428","137","58","623","1032","0","60.37","41.47"
"10","013","00","025","2501","0621","339","260","79","26","365","604","0","60.43","43.05"
"10","013","00","025","2501","0622","226","168","58","32","258","428","0","60.28","39.25"
"10","013","00","025","2502","0000","933","696","237","104","1037","1900","0","54.58","36.63"
"10","013","00","025","2502","0623","501","382","119","77","578","928","0","62.28","41.16"
"10","013","00","025","2502","0624","432","314","118","27","459","972","0","47.22","32.3"
"10","013","00","025","2503","0000","385","282","103","66","451","1041","0","43.32","27.09"
"10","013","00","025","2503","0625","385","282","103","66","451","1041","0","43.32","27.09"
"10","013","00","025","2504","0000","271","171","100","19","290","883","0","32.84","19.37"
"10","013","00","025","2504","0626","271","171","100","19","290","883","0","32.84","19.37"
"10","013","00","026","0000","0000","2890","2114","776","296","3186","6373","7694","49.99","33.17"
"10","013","00","026","2601","0000","734","537","197","60","794","1448","0","54.83","37.09"
"10","013","00","026","2601","0630","734","537","197","60","794","1448","0","54.83","37.09"
"10","013","00","026","2602","0000","125","94","31","16","141","323","0","43.65","29.1"
"10","013","00","026","2602","0629","125","94","31","16","141","323","0","43.65","29.1"
"10","013","00","026","2603","0000","274","198","76","72","346","572","0","60.49","34.62"
"10","013","00","026","2603","0628","274","198","76","72","346","572","0","60.49","34.62"
"10","013","00","026","2604","0000","239","178","61","19","258","616","0","41.88","28.9"
"10","013","00","026","2604","0627","239","178","61","19","258","616","0","41.88","28.9"
"10","013","00","026","2605","0000","216","172","44","3","219","726","0","30.17","23.69"
"10","013","00","026","2605","0631","216","172","44","3","219","726","0","30.17","23.69"
"10","013","00","026","2606","0000","260","188","72","26","286","554","0","51.62","33.94"
"10","013","00","026","2606","0632","260","188","72","26","286","554","0","51.62","33.94"
"10","013","00","026","2607","0000","163","103","60","17","180","346","0","52.02","29.77"
"10","013","00","026","2607","0633","163","103","60","17","180","346","0","52.02","29.77"
"10","013","00","026","2608","0000","154","104","50","2","156","458","0","34.06","22.71"
"10","013","00","026","2608","0634","154","104","50","2","156","458","0","34.06","22.71"
"10","013","00","026","2609","0000","343","260","83","15","358","692","0","51.73","37.57"
"10","013","00","026","2609","0635","343","260","83","15","358","692","0","51.73","37.57"
"10","013","00","026","2610","0000","382","280","102","66","448","638","0","70.22","43.89"
"10","013","00","026","2610","0636","382","280","102","66","448","638","0","70.22","43.89"
"10","013","00","027","0000","0000","1458","1077","381","112","1570","2950","3376","53.22","36.51"
"10","013","00","027","2701","0000","619","467","152","39","658","1185","0","55.53","39.41"
"10","013","00","027","2701","0637","241","175","66","26","267","346","0","77.17","50.58"
"10","013","00","027","2701","0638","327","252","75","13","340","677","0","50.22","37.22"
"10","013","00","027","2701","0639","51","40","11","0","51","162","0","31.48","24.69"
"10","013","00","027","2702","0000","175","138","37","35","210","296","0","70.95","46.62"
"10","013","00","027","2702","0641","175","138","37","35","210","296","0","70.95","46.62"
"10","013","00","027","2703","0000","84","66","18","5","89","189","0","47.09","34.92"
"10","013","00","027","2703","0640","84","66","18","5","89","189","0","47.09","34.92"
"10","013","00","027","2704","0000","190","135","55","18","208","450","0","46.22","30.0"
"10","013","00","027","2704","0644","190","135","55","18","208","450","0","46.22","30.0"
"10","013","00","027","2705","0000","132","91","41","5","137","347","0","39.48","26.22"
"10","013","00","027","2705","0643","132","91","41","5","137","347","0","39.48","26.22"
"10","013","00","027","2706","0000","258","180","78","10","268","483","0","55.49","37.27"
"10","013","00","027","2706","0642","258","180","78","10","268","483","0","55.49","37.27"
"10","013","00","028","0000","0000","3044","2264","780","235","3279","5663","6833","57.9","39.98"
"10","013","00","028","2801","0000","211","149","62","3","214","455","0","47.03","32.75"
"10","013","00","028","2801","0645","211","149","62","3","214","455","0","47.03","32.75"
"10","013","00","028","2802","0000","494","331","163","46","540","821","0","65.77","40.32"
"10","013","00","028","2802","0646","494","331","163","46","540","821","0","65.77","40.32"
"10","013","00","028","2803","0000","417","310","107","12","429","1057","0","40.59","29.33"
"10","013","00","028","2803","0650","417","310","107","12","429","1057","0","40.59","29.33"
"10","013","00","028","2804","0000","449","351","98","36","485","900","0","53.89","39.0"
"10","013","00","028","2804","0651","449","351","98","36","485","900","0","53.89","39.0"
"10","013","00","028","2805","0000","194","149","45","10","204","429","0","47.55","34.73"
"10","013","00","028","2805","0652","194","149","45","10","204","429","0","47.55","34.73"
"10","013","00","028","2806","0000","1279","974","305","128","1407","2001","0","70.31","48.68"
"10","013","00","028","2806","0647","393","274","119","69","462","635","0","72.76","43.15"
"10","013","00","028","2806","0648","483","373","110","33","516","695","0","74.24","53.67"
"10","013","00","028","2806","0649","403","327","76","26","429","671","0","63.93","48.73"
"10","013","00","029","0000","0000","2382","1771","611","318","2700","4344","5403","62.15","40.77"
"10","013","00","029","2901","0000","422","335","87","28","450","859","0","52.39","39.0"
"10","013","00","029","2901","0653","336","272","64","19","355","669","0","53.06","40.66"
"10","013","00","029","2901","0654","86","63","23","9","95","190","0","50.0","33.16"
"10","013","00","029","2902","0000","534","382","152","73","607","922","0","65.84","41.43"
"10","013","00","029","2902","0655","534","382","152","73","607","922","0","65.84","41.43"
"10","013","00","029","2903","0000","382","270","112","61","443","598","0","74.08","45.15"
"10","013","00","029","2903","0656","382","270","112","61","443","598","0","74.08","45.15"
"10","013","00","029","2904","0000","246","182","64","56","302","414","0","72.95","43.96"
"10","013","00","029","2904","0658","246","182","64","56","302","414","0","72.95","43.96"
"10","013","00","029","2905","0000","356","249","107","39","395","780","0","50.64","31.92"
"10","013","00","029","2905","0659","356","249","107","39","395","780","0","50.64","31.92"
"10","013","00","029","2906","0000","442","353","89","61","503","771","0","65.24","45.78"
"10","013","00","029","2906","0657","442","353","89","61","503","771","0","65.24","45.78"
"10","013","00","030","0000","0000","3177","2515","662","389","3566","6257","7445","56.99","40.19"
"10","013","00","030","3001","0000","469","383","86","120","589","917","0","64.23","41.77"
"10","013","00","030","3001","0660","469","383","86","120","589","917","0","64.23","41.77"
"10","013","00","030","3002","0000","237","181","56","18","255","577","0","44.19","31.37"
"10","013","00","030","3002","0661","164","123","41","17","181","361","0","50.14","34.07"
"10","013","00","030","3002","0662","73","58","15","1","74","216","0","34.26","26.85"
"10","013","00","030","3003","0000","466","384","82","52","518","725","0","71.45","52.97"
"10","013","00","030","3003","0663","311","260","51","25","336","445","0","75.51","58.43"
"10","013","00","030","3003","0664","155","124","31","27","182","280","0","65.0","44.29"
"10","013","00","030","3004","0000","593","497","96","56","649","1097","0","59.16","45.31"
"10","013","00","030","3004","0665","593","497","96","56","649","1097","0","59.16","45.31"
"10","013","00","030","3005","0000","494","389","105","65","559","840","0","66.55","46.31"
"10","013","00","030","3005","0666","494","389","105","65","559","840","0","66.55","46.31"
"10","013","00","030","3006","0000","400","303","97","19","419","889","0","47.13","34.08"
"10","013","00","030","3006","0667","400","303","97","19","419","889","0","47.13","34.08"
"10","013","00","030","3007","0000","518","378","140","59","577","1212","0","47.61","31.19"
"10","013","00","030","3007","0668","518","378","140","59","577","1212","0","47.61","31.19"
"10","013","00","031","0000","0000","980","719","261","48","1028","3923","4903","26.2","18.33"
"10","013","00","031","3101","0000","191","143","48","4","195","909","0","21.45","15.73"
"10","013","00","031","3101","0669","191","143","48","4","195","909","0","21.45","15.73"
"10","013","00","031","3102","0000","183","123","60","15","198","663","0","29.86","18.55"
"10","013","00","031","3102","0670","183","123","60","15","198","663","0","29.86","18.55"
"10","013","00","031","3103","0000","41","33","8","0","41","304","0","13.49","10.86"
"10","013","00","031","3103","0671","41","33","8","0","41","304","0","13.49","10.86"
"10","013","00","031","3104","0000","309","226","83","18","327","928","0","35.24","24.35"
"10","013","00","031","3104","0672","309","226","83","18","327","928","0","35.24","24.35"
"10","013","00","031","3105","0000","155","118","37","8","163","641","0","25.43","18.41"
"10","013","00","031","3105","0673","155","118","37","8","163","641","0","25.43","18.41"
"10","013","00","031","3106","0000","101","76","25","3","104","478","0","21.76","15.9"
"10","013","00","031","3106","0674","101","76","25","3","104","478","0","21.76","15.9"
"10","013","00","032","0000","0000","1713","1346","367","121","1834","4230","5018","43.36","31.82"
"10","013","00","032","3201","0000","334","299","35","20","354","751","0","47.14","39.81"
"10","013","00","032","3201","0675","334","299","35","20","354","751","0","47.14","39.81"
"10","013","00","032","3202","0000","326","246","80","28","354","776","0","45.62","31.7"
"10","013","00","032","3202","0676","326","246","80","28","354","776","0","45.62","31.7"
"10","013","00","032","3203","0000","261","201","60","11","272","711","0","38.26","28.27"
"10","013","00","032","3203","0677","261","201","60","11","272","711","0","38.26","28.27"
"10","013","00","032","3204","0000","155","112","43","28","183","243","0","75.31","46.09"
"10","013","00","032","3204","0678","155","112","43","28","183","243","0","75.31","46.09"
"10","013","00","032","3205","0000","164","114","50","14","178","325","0","54.77","35.08"
"10","013","00","032","3205","0679","164","114","50","14","178","325","0","54.77","35.08"
"10","013","00","032","3206","0000","129","99","30","5","134","476","0","28.15","20.8"
"10","013","00","032","3206","0680","129","99","30","5","134","476","0","28.15","20.8"
"10","013","00","032","3207","0000","228","178","50","9","237","602","0","39.37","29.57"
"10","013","00","032","3207","0681","228","178","50","9","237","602","0","39.37","29.57"
"10","013","00","032","3208","0000","116","97","19","6","122","346","0","35.26","28.03"
"10","013","00","032","3208","0682","116","97","19","6","122","346","0","35.26","28.03"
"10","013","00","033","0000","0000","1621","1251","370","108","1729","4314","5003","40.08","29.0"
"10","013","00","033","3301","0000","741","591","150","64","805","1648","0","48.85","35.86"
"10","013","00","033","3301","0683","132","98","34","10","142","342","0","41.52","28.65"
"10","013","00","033","3301","0684","609","493","116","54","663","1306","0","50.77","37.75"
"10","013","00","033","3302","0000","165","134","31","3","168","693","0","24.24","19.34"
"10","013","00","033","3302","0685","165","134","31","3","168","693","0","24.24","19.34"
"10","013","00","033","3303","0000","146","100","46","14","160","437","0","36.61","22.88"
"10","013","00","033","3303","0686","146","100","46","14","160","437","0","36.61","22.88"
"10","013","00","033","3304","0000","183","136","47","11","194","392","0","49.49","34.69"
"10","013","00","033","3304","0687","183","136","47","11","194","392","0","49.49","34.69"
"10","013","00","033","3305","0000","261","188","73","10","271","593","0","45.7","31.7"
"10","013","00","033","3305","0688","261","188","73","10","271","593","0","45.7","31.7"
"10","013","00","033","3306","0000","125","102","23","6","131","551","0","23.77","18.51"
"10","013","00","033","3306","0689","125","102","23","6","131","551","0","23.77","18.51"
"10","002","00","000","0000","0000","194257","149047","45210","17663","211920","386089","455508","54.89","38.6"
"10","002","00","001","0000","0000","41268","32123","9145","3184","44452","79167","95747","56.15","40.58"
"10","002","00","001","0101","0000","1321","1026","295","127","1448","2598","0","55.74","39.49"
"10","002","00","001","0101","0023","342","251","91","51","393","669","0","58.74","37.52"
"10","002","00","001","0101","0024","488","392","96","39","527","923","0","57.1","42.47"
"10","002","00","001","0101","0025","491","383","108","37","528","1006","0","52.49","38.07"
"10","002","00","001","0102","0000","807","603","204","43","850","1747","0","48.65","34.52"
"10","002","00","001","0102","0021","546","416","130","30","576","1282","0","44.93","32.45"
"10","002","00","001","0102","0022","261","187","74","13","274","465","0","58.92","40.22"
"10","002","00","001","0108","0000","1114","869","245","63","1177","2122","0","55.47","40.95"
"10","002","00","001","0108","0029","602","469","133","42","644","1143","0","56.34","41.03"
"10","002","00","001","0108","0030","512","400","112","21","533","979","0","54.44","40.86"
"10","002","00","001","0109","0000","607","482","125","54","661","1214","0","54.45","39.7"
"10","002","00","001","0109","0031","607","482","125","54","661","1214","0","54.45","39.7"
"10","002","00","001","0110","0000","965","731","234","58","1023","1717","0","59.58","42.57"
"10","002","00","001","0110","0035","513","398","115","18","531","943","0","56.31","42.21"
"10","002","00","001","0110","0036","452","333","119","40","492","774","0","63.57","43.02"
"10","002","00","001","0111","0000","1063","861","202","71","1134","2036","0","55.7","42.29"
"10","002","00","001","0111","0033","511","402","109","37","548","946","0","57.93","42.49"
"10","002","00","001","0111","0034","552","459","93","34","586","1090","0","53.76","42.11"
"10","002","00","001","0112","0000","653","488","165","67","720","1283","0","56.12","38.04"
"10","002","00","001","0112","0032","653","488","165","67","720","1283","0","56.12","38.04"
"10","002","00","001","0113","0000","937","759","178","103","1040","1815","0","57.3","41.82"
"10","002","00","001","0113","0051","452","378","74","54","506","905","0","55.91","41.77"
"10","002","00","001","0113","0052","485","381","104","49","534","910","0","58.68","41.87"
"10","002","00","001","0114","0000","1187","959","228","82","1269","2214","0","57.32","43.32"
"10","002","00","001","0114","0046","599","481","118","26","625","1110","0","56.31","43.33"
"10","002","00","001","0114","0047","588","478","110","56","644","1104","0","58.33","43.3"
"10","002","00","001","0115","0000","1720","1370","350","107","1827","3262","0","56.01","42.0"
"10","002","00","001","0115","0040","561","438","123","51","612","1084","0","56.46","40.41"
"10","002","00","001","0115","0041","560","449","111","33","593","1095","0","54.16","41.0"
"10","002","00","001","0115","0042","599","483","116","23","622","1083","0","57.43","44.6"
"10","002","00","001","0116","0000","640","489","151","32","672","1434","0","46.86","34.1"
"10","002","00","001","0116","0053","640","489","151","32","672","1434","0","46.86","34.1"
"10","002","00","001","0117","0000","888","676","212","66","954","1803","0","52.91","37.49"
"10","002","00","001","0117","0059","437","326","111","27","464","909","0","51.05","35.86"
"10","002","00","001","0117","0060","451","350","101","39","490","894","0","54.81","39.15"
"10","002","00","001","0118","0000","911","676","235","97","1008","1560","0","64.62","43.33"
"10","002","00","001","0118","0027","415","306","109","36","451","727","0","62.04","42.09"
"10","002","00","001","0118","0028","496","370","126","61","557","833","0","66.87","44.42"
"10","002","00","001","0119","0000","538","393","145","37","575","966","0","59.52","40.68"
"10","002","00","001","0119","0055","538","393","145","37","575","966","0","59.52","40.68"
"10","002","00","001","0121","0000","863","657","206","85","948","1595","0","59.44","41.19"
"10","002","00","001","0121","0056","373","279","94","41","414","711","0","58.23","39.24"
"10","002","00","001","0121","0057","490","378","112","44","534","884","0","60.41","42.76"
"10","002","00","001","0122","0000","710","538","172","56","766","1326","0","57.77","40.57"
"10","002","00","001","0122","0058","710","538","172","56","766","1326","0","57.77","40.57"
"10","002","00","001","0123","0000","570","419","151","67","637","1152","0","55.3","36.37"
"10","002","00","001","0123","0054","570","419","151","67","637","1152","0","55.3","36.37"
"10","002","00","001","0124","0000","1366","1123","243","134","1500","2584","0","58.05","43.46"
"10","002","00","001","0124","0064","720","548","172","87","807","1454","0","55.5","37.69"
"10","002","00","001","0124","0065","646","575","71","47","693","1130","0","61.33","50.88"
"10","002","00","001","0125","0000","1010","800","210","75","1085","2025","0","53.58","39.51"
"10","002","00","001","0125","0066","490","399","91","18","508","1087","0","46.73","36.71"
"10","002","00","001","0125","0067","520","401","119","57","577","938","0","61.51","42.75"
"10","002","00","001","0126","0000","1098","835","263","94","1192","2237","0","53.29","37.33"
"10","002","00","001","0126","0068","645","500","145","67","712","1285","0","55.41","38.91"
"10","002","00","001","0126","0069","453","335","118","27","480","952","0","50.42","35.19"
"10","002","00","001","0127","0000","1591","1221","370","186","1777","3123","0","56.9","39.1"
"10","002","00","001","0127","0070","508","360","148","63","571","948","0","60.23","37.97"
"10","002","00","001","0127","0071","556","429","127","49","605","1160","0","52.16","36.98"
"10","002","00","001","0127","0072","527","432","95","74","601","1015","0","59.21","42.56"
"10","002","00","001","0128","0000","617","443","174","58","675","1162","0","58.09","38.12"
"10","002","00","001","0128","0078","617","443","174","58","675","1162","0","58.09","38.12"
"10","002","00","001","0131","0000","457","333","124","58","515","959","0","53.7","34.72"
"10","002","00","001","0131","0075","457","333","124","58","515","959","0","53.7","34.72"
"10","002","00","001","0132","0000","941","705","236","96","1037","1699","0","61.04","41.49"
"10","002","00","001","0132","0076","463","354","109","46","509","814","0","62.53","43.49"
"10","002","00","001","0132","0077","478","351","127","50","528","885","0","59.66","39.66"
"10","002","00","001","0134","0000","757","579","178","66","823","1388","0","59.29","41.71"
"10","002","00","001","0134","0073","244","190","54","17","261","424","0","61.56","44.81"
"10","002","00","001","0134","0074","513","389","124","49","562","964","0","58.3","40.35"
"10","002","00","001","0135","0000","1494","1169","325","125","1619","2933","0","55.2","39.86"
"10","002","00","001","0135","0007","470","374","96","33","503","912","0","55.15","41.01"
"10","002","00","001","0135","0008","694","539","155","57","751","1335","0","56.25","40.37"
"10","002","00","001","0135","0009","330","256","74","35","365","686","0","53.21","37.32"
"10","002","00","001","0136","0000","1143","886","257","71","1214","2252","0","53.91","39.34"
"10","002","00","001","0136","0001","493","376","117","23","516","982","0","52.55","38.29"
"10","002","00","001","0136","0002","650","510","140","48","698","1270","0","54.96","40.16"
"10","002","00","001","0137","0000","855","674","181","46","901","1605","0","56.14","41.99"
"10","002","00","001","0137","0003","443","356","87","18","461","849","0","54.3","41.93"
"10","002","00","001","0137","0004","412","318","94","28","440","756","0","58.2","42.06"
"10","002","00","001","0138","0000","2366","1895","471","109","2475","4269","0","57.98","44.39"
"10","002","00","001","0138","0010","785","635","150","30","815","1366","0","59.66","46.49"
"10","002","00","001","0138","0011","741","586","155","35","776","1363","0","56.93","42.99"
"10","002","00","001","0138","0012","840","674","166","44","884","1540","0","57.4","43.77"
"10","002","00","001","0139","0000","1556","1193","363","107","1663","3045","0","54.61","39.18"
"10","002","00","001","0139","0015","467","351","116","40","507","900","0","56.33","39.0"
"10","002","00","001","0139","0016","474","369","105","40","514","980","0","52.45","37.65"
"10","002","00","001","0139","0017","615","473","142","27","642","1165","0","55.11","40.6"
"10","002","00","001","0140","0000","1402","1100","302","97","1499","2695","0","55.62","40.82"
"10","002","00","001","0140","0018","479","383","96","24","503","904","0","55.64","42.37"
"10","002","00","001","0140","0019","428","341","87","29","457","813","0","56.21","41.94"
"10","002","00","001","0140","0020","495","376","119","44","539","978","0","55.11","38.45"
"10","002","00","001","0141","0000","1592","1267","325","96","1688","3051","0","55.33","41.53"
"10","002","00","001","0141","0043","554","450","104","37","591","1108","0","53.34","40.61"
"10","002","00","001","0141","0044","473","363","110","21","494","848","0","58.25","42.81"
"10","002","00","001","0141","0045","565","454","111","38","603","1095","0","55.07","41.46"
"10","002","00","001","0142","0000","1694","1331","363","133","1827","3156","0","57.89","42.17"
"10","002","00","001","0142","0048","601","475","126","39","640","1134","0","56.44","41.89"
"10","002","00","001","0142","0049","616","478","138","43","659","1146","0","57.5","41.71"
"10","002","00","001","0142","0050","477","378","99","51","528","876","0","60.27","43.15"
"10","002","00","001","0143","0000","1330","1050","280","81","1411","2550","0","55.33","41.18"
"10","002","00","001","0143","0013","703","563","140","24","727","1341","0","54.21","41.98"
"10","002","00","001","0143","0014","627","487","140","57","684","1209","0","56.58","40.28"
"10","002","00","001","0144","0000","955","731","224","87","1042","2000","0","52.1","36.55"
"10","002","00","001","0144","0005","503","367","136","43","546","1107","0","49.32","33.15"
"10","002","00","001","0144","0006","452","364","88","44","496","893","0","55.54","40.76"
"10","002","00","001","0145","0000","453","345","108","44","497","762","0","65.22","45.28"
"10","002","00","001","0145","0026","453","345","108","44","497","762","0","65.22","45.28"
"10","002","00","001","0146","0000","1432","1150","282","96","1528","2915","0","52.42","39.45"
"10","002","00","001","0146","0061","600","487","113","35","635","1259","0","50.44","38.68"
"10","002","00","001","0146","0062","389","308","81","30","419","789","0","53.11","39.04"
"10","002","00","001","0146","0063","443","355","88","31","474","867","0","54.67","40.95"
"10","002","00","001","0147","0000","1665","1297","368","110","1775","2913","0","60.93","44.52"
"10","002","00","001","0147","0037","558","440","118","33","591","968","0","61.05","45.45"
"10","002","00","001","0147","0038","545","424","121","27","572","926","0","61.77","45.79"
"10","002","00","001","0147","0039","562","433","129","50","612","1019","0","60.06","42.49"
"10","002","00","002","0000","0000","30763","23633","7130","2324","33087","57686","72457","57.36","40.97"
"10","002","00","002","0204","0000","757","543","214","66","823","1475","0","55.8","36.81"
"10","002","00","002","0204","0081","757","543","214","66","823","1475","0","55.8","36.81"
"10","002","00","002","0205","0000","1771","1354","417","163","1934","3504","0","55.19","38.64"
"10","002","00","002","0205","0082","730","552","178","65","795","1466","0","54.23","37.65"
"10","002","00","002","0205","0083","567","436","131","36","603","1075","0","56.09","40.56"
"10","002","00","002","0205","0084","474","366","108","62","536","963","0","55.66","38.01"
"10","002","00","002","0206","0000","1311","1019","292","128","1439","2677","0","53.75","38.06"
"10","002","00","002","0206","0085","721","573","148","92","813","1511","0","53.81","37.92"
"10","002","00","002","0206","0086","590","446","144","36","626","1166","0","53.69","38.25"
"10","002","00","002","0207","0000","1540","1194","346","106","1646","3008","0","54.72","39.69"
"10","002","00","002","0207","0087","669","506","163","62","731","1273","0","57.42","39.75"
"10","002","00","002","0207","0088","871","688","183","44","915","1735","0","52.74","39.65"
"10","002","00","002","0208","0000","1258","980","278","84","1342","2324","0","57.75","42.17"
"10","002","00","002","0208","0089","783","608","175","57","840","1487","0","56.49","40.89"
"10","002","00","002","0208","0090","475","372","103","27","502","837","0","59.98","44.44"
"10","002","00","002","0209","0000","719","549","170","66","785","1312","0","59.83","41.84"
"10","002","00","002","0209","0091","719","549","170","66","785","1312","0","59.83","41.84"
"10","002","00","002","0210","0000","746","580","166","55","801","1502","0","53.33","38.62"
"10","002","00","002","0210","0092","746","580","166","55","801","1502","0","53.33","38.62"
"10","002","00","002","0211","0000","559","431","128","23","582","1138","0","51.14","37.87"
"10","002","00","002","0211","0093","559","431","128","23","582","1138","0","51.14","37.87"
"10","002","00","002","0216","0000","1859","1418","441","149","2008","3681","0","54.55","38.52"
"10","002","00","002","0216","0096","576","441","135","36","612","1089","0","56.2","40.5"
"10","002","00","002","0216","0097","661","515","146","46","707","1304","0","54.22","39.49"
"10","002","00","002","0216","0098","622","462","160","67","689","1288","0","53.49","35.87"
"10","002","00","002","0217","0000","1543","1179","364","116","1659","2850","0","58.21","41.37"
"10","002","00","002","0217","0102","769","557","212","70","839","1420","0","59.08","39.23"
"10","002","00","002","0217","0103","774","622","152","46","820","1430","0","57.34","43.5"
"10","002","00","002","0218","0000","1513","1167","346","108","1621","2804","0","57.81","41.62"
"10","002","00","002","0218","0104","584","453","131","47","631","1075","0","58.7","42.14"
"10","002","00","002","0218","0105","485","374","111","36","521","879","0","59.27","42.55"
"10","002","00","002","0218","0106","444","340","104","25","469","850","0","55.18","40.0"
"10","002","00","002","0219","0000","1921","1513","408","126","2047","3623","0","56.5","41.76"
"10","002","00","002","0219","0111","751","587","164","54","805","1431","0","56.25","41.02"
"10","002","00","002","0219","0112","592","464","128","40","632","1109","0","56.99","41.84"
"10","002","00","002","0219","0113","578","462","116","32","610","1083","0","56.33","42.66"
"10","002","00","002","0220","0000","1445","1100","345","104","1549","2692","0","57.54","40.86"
"10","002","00","002","0220","0114","756","591","165","54","810","1404","0","57.69","42.09"
"10","002","00","002","0220","0115","689","509","180","50","739","1288","0","57.38","39.52"
"10","002","00","002","0221","0000","500","357","143","46","546","1183","0","46.15","30.18"
"10","002","00","002","0221","0116","500","357","143","46","546","1183","0","46.15","30.18"
"10","002","00","002","0222","0000","1617","1248","369","118","1735","2865","0","60.56","43.56"
"10","002","00","002","0222","0117","621","481","140","40","661","1105","0","59.82","43.53"
"10","002","00","002","0222","0118","564","423","141","37","601","987","0","60.89","42.86"
"10","002","00","002","0222","0119","432","344","88","41","473","773","0","61.19","44.5"
"10","002","00","002","0223","0000","1529","1141","388","139","1668","2926","0","57.01","39.0"
"10","002","00","002","0223","0123","510","382","128","52","562","977","0","57.52","39.1"
"10","002","00","002","0223","0124","478","354","124","52","530","972","0","54.53","36.42"
"10","002","00","002","0223","0125","541","405","136","35","576","977","0","58.96","41.45"
"10","002","00","002","0224","0000","1958","1495","463","130","2088","3551","0","58.8","42.1"
"10","002","00","002","0224","0126","767","576","191","55","822","1398","0","58.8","41.2"
"10","002","00","002","0224","0127","547","410","137","28","575","1022","0","56.26","40.12"
"10","002","00","002","0224","0128","644","509","135","47","691","1131","0","61.1","45.0"
"10","002","00","002","0225","0000","2055","1644","411","111","2166","3431","0","63.13","47.92"
"10","002","00","002","0225","0120","824","664","160","41","865","1366","0","63.32","48.61"
"10","002","00","002","0225","0121","557","434","123","27","584","907","0","64.39","47.85"
"10","002","00","002","0225","0122","674","546","128","43","717","1158","0","61.92","47.15"
"10","002","00","002","0226","0000","2495","1946","549","149","2644","4360","0","60.64","44.63"
"10","002","00","002","0226","0107","632","498","134","30","662","1111","0","59.59","44.82"
"10","002","00","002","0226","0108","668","524","144","41","709","1139","0","62.25","46.01"
"10","002","00","002","0226","0109","660","528","132","34","694","1130","0","61.42","46.73"
"10","002","00","002","0226","0110","535","396","139","44","579","980","0","59.08","40.41"
"10","002","00","002","0227","0000","1711","1344","367","136","1847","2990","0","61.77","44.95"
"10","002","00","002","0227","0099","585","448","137","57","642","1036","0","61.97","43.24"
"10","002","00","002","0227","0100","574","457","117","39","613","969","0","63.26","47.16"
"10","002","00","002","0227","0101","552","439","113","40","592","985","0","60.1","44.57"
"10","002","00","002","0228","0000","744","561","183","61","805","1407","0","57.21","39.87"
"10","002","00","002","0228","0079","375","280","95","32","407","689","0","59.07","40.64"
"10","002","00","002","0228","0080","369","281","88","29","398","718","0","55.43","39.14"
"10","002","00","002","0229","0000","700","498","202","90","790","1373","0","57.54","36.27"
"10","002","00","002","0229","0095","700","498","202","90","790","1373","0","57.54","36.27"
"10","002","00","002","0230","0000","512","372","140","50","562","1010","0","55.64","36.83"
"10","002","00","002","0230","0094","512","372","140","50","562","1010","0","55.64","36.83"
"10","002","00","003","0000","0000","17212","13047","4165","1971","19183","34512","39785","55.58","37.8"
"10","002","00","003","0301","0000","1732","1313","419","170","1902","3364","0","56.54","39.03"
"10","002","00","003","0301","0129","600","458","142","72","672","1194","0","56.28","38.36"
"10","002","00","003","0301","0130","543","402","141","44","587","1128","0","52.04","35.64"
"10","002","00","003","0301","0131","589","453","136","54","643","1042","0","61.71","43.47"
"10","002","00","003","0302","0000","544","429","115","39","583","997","0","58.48","43.03"
"10","002","00","003","0302","0132","544","429","115","39","583","997","0","58.48","43.03"
"10","002","00","003","0303","0000","1898","1433","465","215","2113","3693","0","57.22","38.8"
"10","002","00","003","0303","0133","675","506","169","63","738","1303","0","56.64","38.83"
"10","002","00","003","0303","0134","672","508","164","74","746","1260","0","59.21","40.32"
"10","002","00","003","0303","0135","551","419","132","78","629","1130","0","55.66","37.08"
"10","002","00","003","0304","0000","415","319","96","80","495","910","0","54.4","35.05"
"10","002","00","003","0304","0136","267","210","57","48","315","559","0","56.35","37.57"
"10","002","00","003","0304","0137","148","109","39","32","180","351","0","51.28","31.05"
"10","002","00","003","0305","0000","642","479","163","80","722","1323","0","54.57","36.21"
"10","002","00","003","0305","0138","431","323","108","57","488","889","0","54.89","36.33"
"10","002","00","003","0305","0139","211","156","55","23","234","434","0","53.92","35.94"
"10","002","00","003","0307","0000","1576","1187","389","152","1728","2945","0","58.68","40.31"
"10","002","00","003","0307","0140","471","357","114","31","502","835","0","60.12","42.75"
"10","002","00","003","0307","0141","506","384","122","47","553","975","0","56.72","39.38"
"10","002","00","003","0307","0142","599","446","153","74","673","1135","0","59.3","39.3"
"10","002","00","003","0308","0000","693","507","186","66","759","1257","0","60.38","40.33"
"10","002","00","003","0308","0143","476","357","119","35","511","788","0","64.85","45.3"
"10","002","00","003","0308","0144","217","150","67","31","248","469","0","52.88","31.98"
"10","002","00","003","0309","0000","1151","902","249","101","1252","2300","0","54.43","39.22"
"10","002","00","003","0309","0148","563","439","124","36","599","1146","0","52.27","38.31"
"10","002","00","003","0309","0149","588","463","125","65","653","1154","0","56.59","40.12"
"10","002","00","003","0310","0000","1214","945","269","110","1324","2398","0","55.21","39.41"
"10","002","00","003","0310","0150","412","307","105","30","442","908","0","48.68","33.81"
"10","002","00","003","0310","0151","342","273","69","22","364","656","0","55.49","41.62"
"10","002","00","003","0310","0152","460","365","95","58","518","834","0","62.11","43.76"
"10","002","00","003","0311","0000","559","417","142","46","605","1025","0","59.02","40.68"
"10","002","00","003","0311","0153","559","417","142","46","605","1025","0","59.02","40.68"
"10","002","00","003","0312","0000","244","163","81","20","264","455","0","58.02","35.82"
"10","002","00","003","0312","0154","244","163","81","20","264","455","0","58.02","35.82"
"10","002","00","003","0313","0000","288","223","65","25","313","535","0","58.5","41.68"
"10","002","00","003","0313","0155","288","223","65","25","313","535","0","58.5","41.68"
"10","002","00","003","0314","0000","302","226","76","36","338","536","0","63.06","42.16"
"10","002","00","003","0314","0156","302","226","76","36","338","536","0","63.06","42.16"
"10","002","00","003","0315","0000","251","181","70","23","274","451","0","60.75","40.13"
"10","002","00","003","0315","0157","251","181","70","23","274","451","0","60.75","40.13"
"10","002","00","003","0316","0000","287","205","82","43","330","593","0","55.65","34.57"
"10","002","00","003","0316","0158","287","205","82","43","330","593","0","55.65","34.57"
"10","002","00","003","0317","0000","219","172","47","28","247","441","0","56.01","39.0"
"10","002","00","003","0317","0159","219","172","47","28","247","441","0","56.01","39.0"
"10","002","00","003","0318","0000","493","384","109","55","548","954","0","57.44","40.25"
"10","002","00","003","0318","0160","493","384","109","55","548","954","0","57.44","40.25"
"10","002","00","003","0319","0000","451","338","113","67","518","952","0","54.41","35.5"
"10","002","00","003","0319","0161","451","338","113","67","518","952","0","54.41","35.5"
"10","002","00","003","0320","0000","512","363","149","75","587","1125","0","52.18","32.27"
"10","002","00","003","0320","0162","512","363","149","75","587","1125","0","52.18","32.27"
"10","002","00","003","0321","0000","626","483","143","113","739","1469","0","50.31","32.88"
"10","002","00","003","0321","0163","356","283","73","72","428","763","0","56.09","37.09"
"10","002","00","003","0321","0164","270","200","70","41","311","706","0","44.05","28.33"
"10","002","00","003","0322","0000","441","327","114","74","515","1068","0","48.22","30.62"
"10","002","00","003","0322","0165","441","327","114","74","515","1068","0","48.22","30.62"
"10","002","00","003","0323","0000","571","412","159","142","713","1240","0","57.5","33.23"
"10","002","00","003","0323","0166","324","234","90","64","388","666","0","58.26","35.14"
"10","002","00","003","0323","0167","247","178","69","78","325","574","0","56.62","31.01"
"10","002","00","003","0324","0000","125","97","28","9","134","351","0","38.18","27.64"
"10","002","00","003","0324","0168","125","97","28","9","134","351","0","38.18","27.64"
"10","002","00","003","0325","0000","346","260","86","59","405","717","0","56.49","36.26"
"10","002","00","003","0325","0169","346","260","86","59","405","717","0","56.49","36.26"
"10","002","00","003","0326","0000","212","170","42","32","244","596","0","40.94","28.52"
"10","002","00","003","0326","0170","136","117","19","18","154","373","0","41.29","31.37"
"10","002","00","003","0326","0171","76","53","23","14","90","223","0","40.36","23.77"
"10","002","00","003","0327","0000","1420","1112","308","111","1531","2817","0","54.35","39.47"
"10","002","00","003","0327","0145","398","304","94","33","431","811","0","53.14","37.48"
"10","002","00","003","0327","0146","439","362","77","21","460","867","0","53.06","41.75"
"10","002","00","003","0327","0147","583","446","137","57","640","1139","0","56.19","39.16"
"10","002","00","004","0000","0000","12379","9379","3000","1381","13760","25135","29173","54.74","37.31"
"10","002","00","004","0401","0000","93","62","31","11","104","292","0","35.62","21.23"
"10","002","00","004","0401","0172","93","62","31","11","104","292","0","35.62","21.23"
"10","002","00","004","0402","0000","323","239","84","45","368","688","0","53.49","34.74"
"10","002","00","004","0402","0173","323","239","84","45","368","688","0","53.49","34.74"
"10","002","00","004","0403","0000","388","279","109","56","444","879","0","50.51","31.74"
"10","002","00","004","0403","0175","388","279","109","56","444","879","0","50.51","31.74"
"10","002","00","004","0404","0000","177","126","51","27","204","335","0","60.9","37.61"
"10","002","00","004","0404","0176","177","126","51","27","204","335","0","60.9","37.61"
"10","002","00","004","0405","0000","648","447","201","88","736","1356","0","54.28","32.96"
"10","002","00","004","0405","0177","352","235","117","41","393","624","0","62.98","37.66"
"10","002","00","004","0405","0178","296","212","84","47","343","732","0","46.86","28.96"
"10","002","00","004","0406","0000","372","280","92","47","419","892","0","46.97","31.39"
"10","002","00","004","0406","0179","372","280","92","47","419","892","0","46.97","31.39"
"10","002","00","004","0407","0000","285","211","74","28","313","690","0","45.36","30.58"
"10","002","00","004","0407","0180","285","211","74","28","313","690","0","45.36","30.58"
"10","002","00","004","0408","0000","780","583","197","82","862","1578","0","54.63","36.95"
"10","002","00","004","0408","0181","409","311","98","43","452","842","0","53.68","36.94"
"10","002","00","004","0408","0182","371","272","99","39","410","736","0","55.71","36.96"
"10","002","00","004","0409","0000","618","458","160","62","680","1348","0","50.45","33.98"
"10","002","00","004","0409","0183","362","281","81","32","394","788","0","50.0","35.66"
"10","002","00","004","0409","0184","256","177","79","30","286","560","0","51.07","31.61"
"10","002","00","004","0410","0000","392","302","90","31","423","712","0","59.41","42.42"
"10","002","00","004","0410","0185","392","302","90","31","423","712","0","59.41","42.42"
"10","002","00","004","0411","0000","287","229","58","34","321","502","0","63.94","45.62"
"10","002","00","004","0411","0186","287","229","58","34","321","502","0","63.94","45.62"
"10","002","00","004","0412","0000","324","253","71","35","359","569","0","63.09","44.46"
"10","002","00","004","0412","0187","324","253","71","35","359","569","0","63.09","44.46"
"10","002","00","004","0413","0000","328","258","70","33","361","633","0","57.03","40.76"
"10","002","00","004","0413","0188","328","258","70","33","361","633","0","57.03","40.76"
"10","002","00","004","0414","0000","908","673","235","115","1023","2167","0","47.21","31.06"
"10","002","00","004","0414","0189","455","328","127","73","528","1132","0","46.64","28.98"
"10","002","00","004","0414","0190","453","345","108","42","495","1035","0","47.83","33.33"
"10","002","00","004","0415","0000","1072","804","268","89","1161","2019","0","57.5","39.82"
"10","002","00","004","0415","0191","466","342","124","37","503","847","0","59.39","40.38"
"10","002","00","004","0415","0192","606","462","144","52","658","1172","0","56.14","39.42"
"10","002","00","004","0416","0000","1040","829","211","50","1090","1971","0","55.3","42.06"
"10","002","00","004","0416","0193","443","348","95","22","465","896","0","51.9","38.84"
"10","002","00","004","0416","0194","597","481","116","28","625","1075","0","58.14","44.74"
"10","002","00","004","0417","0000","482","356","126","66","548","931","0","58.86","38.24"
"10","002","00","004","0417","0195","482","356","126","66","548","931","0","58.86","38.24"
"10","002","00","004","0418","0000","805","625","180","104","909","1730","0","52.54","36.13"
"10","002","00","004","0418","0196","509","403","106","53","562","1021","0","55.04","39.47"
"10","002","00","004","0418","0197","296","222","74","51","347","709","0","48.94","31.31"
"10","002","00","004","0419","0000","402","310","92","40","442","689","0","64.15","44.99"
"10","002","00","004","0419","0198","402","310","92","40","442","689","0","64.15","44.99"
"10","002","00","004","0420","0000","703","549","154","96","799","1374","0","58.15","39.96"
"10","002","00","004","0420","0199","338","265","73","46","384","615","0","62.44","43.09"
"10","002","00","004","0420","0200","365","284","81","50","415","759","0","54.68","37.42"
"10","002","00","004","0421","0000","489","376","113","73","562","917","0","61.29","41.0"
"10","002","00","004","0421","0201","489","376","113","73","562","917","0","61.29","41.0"
"10","002","00","004","0422","0000","537","409","128","63","600","1045","0","57.42","39.14"
"10","002","00","004","0422","0202","537","409","128","63","600","1045","0","57.42","39.14"
"10","002","00","004","0423","0000","568","441","127","68","636","1130","0","56.28","39.03"
"10","002","00","004","0423","0203","568","441","127","68","636","1130","0","56.28","39.03"
"10","002","00","004","0424","0000","358","280","78","38","396","688","0","57.56","40.7"
"10","002","00","004","0424","0174","358","280","78","38","396","688","0","57.56","40.7"
"10","002","00","005","0000","0000","15289","11637","3652","1324","16613","31084","35668","53.45","37.44"
"10","002","00","005","0501","0000","730","575","155","66","796","1627","0","48.92","35.34"
"10","002","00","005","0501","0204","492","397","95","38","530","1122","0","47.24","35.38"
"10","002","00","005","0501","0205","238","178","60","28","266","505","0","52.67","35.25"
"10","002","00","005","0502","0000","940","702","238","82","1022","1959","0","52.17","35.83"
"10","002","00","005","0502","0206","467","356","111","42","509","988","0","51.52","36.03"
"10","002","00","005","0502","0207","473","346","127","40","513","971","0","52.83","35.63"
"10","002","00","005","0503","0000","1776","1343","433","136","1912","4033","0","47.41","33.3"
"10","002","00","005","0503","0208","560","434","126","56","616","1246","0","49.44","34.83"
"10","002","00","005","0503","0209","739","560","179","45","784","1655","0","47.37","33.84"
"10","002","00","005","0503","0210","477","349","128","35","512","1132","0","45.23","30.83"
"10","002","00","005","0504","0000","1276","996","280","110","1386","2559","0","54.16","38.92"
"10","002","00","005","0504","0211","405","317","88","30","435","783","0","55.56","40.49"
"10","002","00","005","0504","0212","460","348","112","38","498","928","0","53.66","37.5"
"10","002","00","005","0504","0213","411","331","80","42","453","848","0","53.42","39.03"
"10","002","00","005","0505","0000","382","291","91","35","417","663","0","62.9","43.89"
"10","002","00","005","0505","0214","382","291","91","35","417","663","0","62.9","43.89"
"10","002","00","005","0506","0000","735","563","172","66","801","1441","0","55.59","39.07"
"10","002","00","005","0506","0215","310","236","74","27","337","608","0","55.43","38.82"
"10","002","00","005","0506","0216","425","327","98","39","464","833","0","55.7","39.26"
"10","002","00","005","0507","0000","534","421","113","23","557","1233","0","45.17","34.14"
"10","002","00","005","0507","0217","534","421","113","23","557","1233","0","45.17","34.14"
"10","002","00","005","0508","0000","682","495","187","85","767","1429","0","53.67","34.64"
"10","002","00","005","0508","0218","422","310","112","57","479","854","0","56.09","36.3"
"10","002","00","005","0508","0219","260","185","75","28","288","575","0","50.09","32.17"
"10","002","00","005","0509","0000","1110","834","276","100","1210","2140","0","56.54","38.97"
"10","002","00","005","0509","0220","423","311","112","43","466","835","0","55.81","37.25"
"10","002","00","005","0509","0221","687","523","164","57","744","1305","0","57.01","40.08"
"10","002","00","005","0510","0000","1251","911","340","129","1380","2402","0","57.45","37.93"
"10","002","00","005","0510","0222","425","321","104","35","460","830","0","55.42","38.67"
"10","002","00","005","0510","0223","383","254","129","45","428","649","0","65.95","39.14"
"10","002","00","005","0510","0224","443","336","107","49","492","923","0","53.3","36.4"
"10","002","00","005","0511","0000","483","381","102","49","532","1177","0","45.2","32.37"
"10","002","00","005","0511","0225","483","381","102","49","532","1177","0","45.2","32.37"
"10","002","00","005","0512","0000","416","310","106","44","460","840","0","54.76","36.9"
"10","002","00","005","0512","0226","416","310","106","44","460","840","0","54.76","36.9"
"10","002","00","005","0513","0000","536","414","122","35","571","1051","0","54.33","39.39"
"10","002","00","005","0513","0227","536","414","122","35","571","1051","0","54.33","39.39"
"10","002","00","005","0514","0000","605","457","148","54","659","1339","0","49.22","34.13"
"10","002","00","005","0514","0228","605","457","148","54","659","1339","0","49.22","34.13"
"10","002","00","005","0515","0000","1330","1039","291","144","1474","2508","0","58.77","41.43"
"10","002","00","005","0515","0229","649","522","127","53","702","1194","0","58.79","43.72"
"10","002","00","005","0515","0230","681","517","164","91","772","1314","0","58.75","39.35"
"10","002","00","005","0516","0000","1715","1314","401","149","1864","3311","0","56.3","39.69"
"10","002","00","005","0516","0231","572","435","137","23","595","1125","0","52.89","38.67"
"10","002","00","005","0516","0232","649","502","147","71","720","1207","0","59.65","41.59"
"10","002","00","005","0516","0233","494","377","117","55","549","979","0","56.08","38.51"
"10","002","00","005","0517","0000","575","432","143","10","585","954","0","61.32","45.28"
"10","002","00","005","0517","0234","575","432","143","10","585","954","0","61.32","45.28"
"10","002","00","005","0518","0000","213","159","54","7","220","418","0","52.63","38.04"
"10","002","00","005","0518","0235","213","159","54","7","220","418","0","52.63","38.04"
"10","002","00","006","0000","0000","10973","8267","2706","1259","12232","21447","24315","57.03","38.55"
"10","002","00","006","0601","0000","1343","982","361","143","1486","2484","0","59.82","39.53"
"10","002","00","006","0601","0236","769","563","206","92","861","1435","0","60.0","39.23"
"10","002","00","006","0601","0237","574","419","155","51","625","1049","0","59.58","39.94"
"10","002","00","006","0602","0000","891","681","210","114","1005","1835","0","54.77","37.11"
"10","002","00","006","0602","0239","417","299","118","80","497","868","0","57.26","34.45"
"10","002","00","006","0602","0240","474","382","92","34","508","967","0","52.53","39.5"
"10","002","00","006","0603","0000","506","395","111","71","577","940","0","61.38","42.02"
"10","002","00","006","0603","0241","506","395","111","71","577","940","0","61.38","42.02"
"10","002","00","006","0604","0000","414","322","92","38","452","975","0","46.36","33.03"
"10","002","00","006","0604","0242","414","322","92","38","452","975","0","46.36","33.03"
"10","002","00","006","0605","0000","815","611","204","140","955","1605","0","59.5","38.07"
"10","002","00","006","0605","0243","414","306","108","76","490","797","0","61.48","38.39"
"10","002","00","006","0605","0244","401","305","96","64","465","808","0","57.55","37.75"
"10","002","00","006","0606","0000","743","529","214","111","854","1523","0","56.07","34.73"
"10","002","00","006","0606","0245","456","307","149","82","538","911","0","59.06","33.7"
"10","002","00","006","0606","0246","287","222","65","29","316","612","0","51.63","36.27"
"10","002","00","006","0607","0000","452","329","123","51","503","790","0","63.67","41.65"
"10","002","00","006","0607","0247","452","329","123","51","503","790","0","63.67","41.65"
"10","002","00","006","0608","0000","1200","819","381","143","1343","2338","0","57.44","35.03"
"10","002","00","006","0608","0248","467","356","111","56","523","878","0","59.57","40.55"
"10","002","00","006","0608","0249","412","329","83","51","463","723","0","64.04","45.5"
"10","002","00","006","0608","0250","321","134","187","36","357","737","0","48.44","18.18"
"10","002","00","006","0609","0000","805","604","201","53","858","1581","0","54.27","38.2"
"10","002","00","006","0609","0251","361","264","97","52","413","686","0","60.2","38.48"
"10","002","00","006","0609","0252","444","340","104","1","445","895","0","49.72","37.99"
"10","002","00","006","0610","0000","686","543","143","67","753","1237","0","60.87","43.9"
"10","002","00","006","0610","0253","686","543","143","67","753","1237","0","60.87","43.9"
"10","002","00","006","0611","0000","1139","878","261","123","1262","2241","0","56.31","39.18"
"10","002","00","006","0611","0254","588","455","133","62","650","1134","0","57.32","40.12"
"10","002","00","006","0611","0255","551","423","128","61","612","1107","0","55.28","38.21"
"10","002","00","006","0612","0000","549","413","136","47","596","1057","0","56.39","39.07"
"10","002","00","006","0612","0256","549","413","136","47","596","1057","0","56.39","39.07"
"10","002","00","006","0613","0000","844","731","113","88","932","1773","0","52.57","41.23"
"10","002","00","006","0613","0257","497","476","21","38","535","1051","0","50.9","45.29"
"10","002","00","006","0613","0258","347","255","92","50","397","722","0","54.99","35.32"
"10","002","00","006","0614","0000","586","430","156","70","656","1068","0","61.42","40.26"
"10","002","00","006","0614","0238","586","430","156","70","656","1068","0","61.42","40.26"
"10","002","00","007","0000","0000","13445","10227","3218","1551","14996","28131","32281","53.31","36.35"
"10","002","00","007","0701","0000","2715","2170","545","200","2915","5648","0","51.61","38.42"
"10","002","00","007","0701","0259","670","519","151","29","699","1393","0","50.18","37.26"
"10","002","00","007","0701","0260","430","331","99","29","459","895","0","51.28","36.98"
"10","002","00","007","0701","0261","593","484","109","76","669","1231","0","54.35","39.32"
"10","002","00","007","0701","0262","533","440","93","27","560","1098","0","51.0","40.07"
"10","002","00","007","0701","0263","489","396","93","39","528","1031","0","51.21","38.41"
"10","002","00","007","0702","0000","975","756","219","125","1100","2198","0","50.05","34.39"
"10","002","00","007","0702","0264","482","377","105","73","555","1030","0","53.88","36.6"
"10","002","00","007","0702","0265","493","379","114","52","545","1168","0","46.66","32.45"
"10","002","00","007","0703","0000","795","588","207","110","905","1587","0","57.03","37.05"
"10","002","00","007","0703","0266","402","288","114","56","458","809","0","56.61","35.6"
"10","002","00","007","0703","0267","393","300","93","54","447","778","0","57.46","38.56"
"10","002","00","007","0704","0000","774","616","158","68","842","1465","0","57.47","42.05"
"10","002","00","007","0704","0268","774","616","158","68","842","1465","0","57.47","42.05"
"10","002","00","007","0705","0000","953","727","226","102","1055","1839","0","57.37","39.53"
"10","002","00","007","0705","0269","523","398","125","55","578","979","0","59.04","40.65"
"10","002","00","007","0705","0270","430","329","101","47","477","860","0","55.47","38.26"
"10","002","00","007","0706","0000","523","384","139","74","597","1205","0","49.54","31.87"
"10","002","00","007","0706","0271","523","384","139","74","597","1205","0","49.54","31.87"
"10","002","00","007","0707","0000","725","538","187","126","851","1494","0","56.96","36.01"
"10","002","00","007","0707","0272","522","397","125","86","608","1082","0","56.19","36.69"
"10","002","00","007","0707","0273","203","141","62","40","243","412","0","58.98","34.22"
"10","002","00","007","0708","0000","261","179","82","29","290","635","0","45.67","28.19"
"10","002","00","007","0708","0274","168","113","55","18","186","403","0","46.15","28.04"
"10","002","00","007","0708","0275","93","66","27","11","104","232","0","44.83","28.45"
"10","002","00","007","0709","0000","886","652","234","111","997","1838","0","54.24","35.47"
"10","002","00","007","0709","0276","450","316","134","55","505","944","0","53.5","33.47"
"10","002","00","007","0709","0277","436","336","100","56","492","894","0","55.03","37.58"
"10","002","00","007","0710","0000","664","530","134","88","752","1356","0","55.46","39.09"
"10","002","00","007","0710","0278","664","530","134","88","752","1356","0","55.46","39.09"
"10","002","00","007","0711","0000","1159","792","367","172","1331","2295","0","58.0","34.51"
"10","002","00","007","0711","0279","400","299","101","53","453","780","0","58.08","38.33"
"10","002","00","007","0711","0280","499","318","181","85","584","932","0","62.66","34.12"
"10","002","00","007","0711","0281","260","175","85","34","294","583","0","50.43","30.02"
"10","002","00","007","0712","0000","1181","899","282","153","1334","2435","0","54.78","36.92"
"10","002","00","007","0712","0282","434","346","88","70","504","900","0","56.0","38.44"
"10","002","00","007","0712","0283","364","264","100","40","404","747","0","54.08","35.34"
"10","002","00","007","0712","0284","383","289","94","43","426","788","0","54.06","36.68"
"10","002","00","007","0713","0000","415","313","102","50","465","884","0","52.6","35.41"
"10","002","00","007","0713","0285","415","313","102","50","465","884","0","52.6","35.41"
"10","002","00","007","0714","0000","387","307","80","23","410","857","0","47.84","35.82"
"10","002","00","007","0714","0286","387","307","80","23","410","857","0","47.84","35.82"
"10","002","00","007","0715","0000","456","344","112","29","485","1016","0","47.74","33.86"
"10","002","00","007","0715","0287","456","344","112","29","485","1016","0","47.74","33.86"
"10","002","00","007","0716","0000","576","432","144","91","667","1379","0","48.37","31.33"
"10","002","00","007","0716","0288","272","204","68","33","305","690","0","44.2","29.57"
"10","002","00","007","0716","0289","304","228","76","58","362","689","0","52.54","33.09"
"10","002","00","008","0000","0000","22432","17337","5095","1730","24162","45405","52843","53.21","38.18"
"10","002","00","008","0801","0000","556","444","112","86","642","1217","0","52.75","36.48"
"10","002","00","008","0801","0312","556","444","112","86","642","1217","0","52.75","36.48"
"10","002","00","008","0802","0000","885","683","202","58","943","1624","0","58.07","42.06"
"10","002","00","008","0802","0290","444","340","104","43","487","807","0","60.35","42.13"
"10","002","00","008","0802","0291","441","343","98","15","456","817","0","55.81","41.98"
"10","002","00","008","0803","0000","601","472","129","57","658","1156","0","56.92","40.83"
"10","002","00","008","0803","0292","601","472","129","57","658","1156","0","56.92","40.83"
"10","002","00","008","0804","0000","437","331","106","37","474","892","0","53.14","37.11"
"10","002","00","008","0804","0293","437","331","106","37","474","892","0","53.14","37.11"
"10","002","00","008","0805","0000","482","362","120","43","525","897","0","58.53","40.36"
"10","002","00","008","0805","0294","482","362","120","43","525","897","0","58.53","40.36"
"10","002","00","008","0806","0000","766","585","181","66","832","1392","0","59.77","42.03"
"10","002","00","008","0806","0295","766","585","181","66","832","1392","0","59.77","42.03"
"10","002","00","008","0807","0000","1395","1056","339","76","1471","2906","0","50.62","36.34"
"10","002","00","008","0807","0296","793","603","190","44","837","1471","0","56.9","40.99"
"10","002","00","008","0807","0297","602","453","149","32","634","1435","0","44.18","31.57"
"10","002","00","008","0808","0000","1528","1194","334","58","1586","2975","0","53.31","40.13"
"10","002","00","008","0808","0298","732","566","166","37","769","1519","0","50.63","37.26"
"10","002","00","008","0808","0299","796","628","168","21","817","1456","0","56.11","43.13"
"10","002","00","008","0809","0000","367","300","67","38","405","694","0","58.36","43.23"
"10","002","00","008","0809","0301","367","300","67","38","405","694","0","58.36","43.23"
"10","002","00","008","0810","0000","378","272","106","51","429","711","0","60.34","38.26"
"10","002","00","008","0810","0300","378","272","106","51","429","711","0","60.34","38.26"
"10","002","00","008","0811","0000","892","655","237","61","953","1526","0","62.45","42.92"
"10","002","00","008","0811","0302","892","655","237","61","953","1526","0","62.45","42.92"
"10","002","00","008","0812","0000","442","332","110","31","473","884","0","53.51","37.56"
"10","002","00","008","0812","0303","442","332","110","31","473","884","0","53.51","37.56"
"10","002","00","008","0813","0000","644","505","139","73","717","1465","0","48.94","34.47"
"10","002","00","008","0813","0304","644","505","139","73","717","1465","0","48.94","34.47"
"10","002","00","008","0814","0000","239","173","66","37","276","488","0","56.56","35.45"
"10","002","00","008","0814","0305","239","173","66","37","276","488","0","56.56","35.45"
"10","002","00","008","0815","0000","2360","1864","496","177","2537","4993","0","50.81","37.33"
"10","002","00","008","0815","0306","588","466","122","59","647","1218","0","53.12","38.26"
"10","002","00","008","0815","0307","612","498","114","43","655","1291","0","50.74","38.57"
"10","002","00","008","0815","0308","628","484","144","35","663","1324","0","50.08","36.56"
"10","002","00","008","0815","0309","532","416","116","40","572","1160","0","49.31","35.86"
"10","002","00","008","0816","0000","1454","1158","296","95","1549","3000","0","51.63","38.6"
"10","002","00","008","0816","0310","613","476","137","58","671","1246","0","53.85","38.2"
"10","002","00","008","0816","0311","841","682","159","37","878","1754","0","50.06","38.88"
"10","002","00","008","0817","0000","2178","1681","497","188","2366","4651","0","50.87","36.14"
"10","002","00","008","0817","0313","657","526","131","61","718","1495","0","48.03","35.18"
"10","002","00","008","0817","0314","472","359","113","38","510","937","0","54.43","38.31"
"10","002","00","008","0817","0315","529","402","127","29","558","1101","0","50.68","36.51"
"10","002","00","008","0817","0316","520","394","126","60","580","1118","0","51.88","35.24"
"10","002","00","008","0818","0000","1954","1520","434","130","2084","3732","0","55.84","40.73"
"10","002","00","008","0818","0317","703","554","149","49","752","1301","0","57.8","42.58"
"10","002","00","008","0818","0318","593","469","124","35","628","1225","0","51.27","38.29"
"10","002","00","008","0818","0319","658","497","161","46","704","1206","0","58.37","41.21"
"10","002","00","008","0819","0000","1159","874","285","63","1222","2429","0","50.31","35.98"
"10","002","00","008","0819","0320","595","443","152","33","628","1278","0","49.14","34.66"
"10","002","00","008","0819","0321","564","431","133","30","594","1151","0","51.61","37.45"
"10","002","00","008","0820","0000","493","382","111","48","541","1094","0","49.45","34.92"
"10","002","00","008","0820","0322","493","382","111","48","541","1094","0","49.45","34.92"
"10","002","00","008","0821","0000","1214","950","264","120","1334","2494","0","53.49","38.09"
"10","002","00","008","0821","0323","646","507","139","61","707","1247","0","56.7","40.66"
"10","002","00","008","0821","0324","568","443","125","59","627","1247","0","50.28","35.53"
"10","002","00","008","0822","0000","902","713","189","51","953","1677","0","56.83","42.52"
"10","002","00","008","0822","0325","503","403","100","27","530","979","0","54.14","41.16"
"10","002","00","008","0822","0326","399","310","89","24","423","698","0","60.6","44.41"
"10","002","00","008","0823","0000","796","601","195","67","863","1726","0","50.0","34.82"
"10","002","00","008","0823","0327","796","601","195","67","863","1726","0","50.0","34.82"
"10","002","00","008","0824","0000","310","230","80","19","329","782","0","42.07","29.41"
"10","002","00","008","0824","0328","310","230","80","19","329","782","0","42.07","29.41"
"10","002","00","009","0000","0000","17122","13187","3935","1445","18567","34892","39577","53.21","37.79"
"10","002","00","009","0901","0000","953","732","221","80","1033","2020","0","51.14","36.24"
"10","002","00","009","0901","0329","496","387","109","54","550","1076","0","51.12","35.97"
"10","002","00","009","0901","0330","457","345","112","26","483","944","0","51.17","36.55"
"10","002","00","009","0902","0000","904","718","186","75","979","1773","0","55.22","40.5"
"10","002","00","009","0902","0331","425","347","78","27","452","836","0","54.07","41.51"
"10","002","00","009","0902","0332","479","371","108","48","527","937","0","56.24","39.59"
"10","002","00","009","0903","0000","1233","914","319","107","1340","2525","0","53.07","36.2"
"10","002","00","009","0903","0333","617","468","149","40","657","1255","0","52.35","37.29"
"10","002","00","009","0903","0334","616","446","170","67","683","1270","0","53.78","35.12"
"10","002","00","009","0904","0000","751","589","162","62","813","1603","0","50.72","36.74"
"10","002","00","009","0904","0335","371","295","76","25","396","801","0","49.44","36.83"
"10","002","00","009","0904","0336","380","294","86","37","417","802","0","52.0","36.66"
"10","002","00","009","0905","0000","611","476","135","39","650","1306","0","49.77","36.45"
"10","002","00","009","0905","0337","611","476","135","39","650","1306","0","49.77","36.45"
"10","002","00","009","0906","0000","1218","959","259","82","1300","2506","0","51.88","38.27"
"10","002","00","009","0906","0338","573","455","118","53","626","1190","0","52.61","38.24"
"10","002","00","009","0906","0339","645","504","141","29","674","1316","0","51.22","38.3"
"10","002","00","009","0907","0000","889","714","175","64","953","1779","0","53.57","40.13"
"10","002","00","009","0907","0340","491","399","92","27","518","965","0","53.68","41.35"
"10","002","00","009","0907","0341","398","315","83","37","435","814","0","53.44","38.7"
"10","002","00","009","0908","0000","1838","1435","403","137","1975","3637","0","54.3","39.46"
"10","002","00","009","0908","0342","601","469","132","42","643","1254","0","51.28","37.4"
"10","002","00","009","0908","0343","546","439","107","59","605","1060","0","57.08","41.42"
"10","002","00","009","0908","0344","691","527","164","36","727","1323","0","54.95","39.83"
"10","002","00","009","0909","0000","1894","1501","393","139","2033","3591","0","56.61","41.8"
"10","002","00","009","0909","0348","515","408","107","21","536","924","0","58.01","44.16"
"10","002","00","009","0909","0349","515","409","106","46","561","933","0","60.13","43.84"
"10","002","00","009","0909","0350","497","399","98","31","528","986","0","53.55","40.47"
"10","002","00","009","0909","0351","367","285","82","41","408","748","0","54.55","38.1"
"10","002","00","009","0910","0000","1649","1269","380","112","1761","3233","0","54.47","39.25"
"10","002","00","009","0910","0345","599","464","135","42","641","1120","0","57.23","41.43"
"10","002","00","009","0910","0346","448","357","91","25","473","893","0","52.97","39.98"
"10","002","00","009","0910","0347","602","448","154","45","647","1220","0","53.03","36.72"
"10","002","00","009","0911","0000","733","573","160","100","833","1550","0","53.74","36.97"
"10","002","00","009","0911","0352","733","573","160","100","833","1550","0","53.74","36.97"
"10","002","00","009","0912","0000","733","545","188","62","795","1435","0","55.4","37.98"
"10","002","00","009","0912","0353","329","247","82","26","355","629","0","56.44","39.27"
"10","002","00","009","0912","0354","404","298","106","36","440","806","0","54.59","36.97"
"10","002","00","009","0913","0000","969","700","269","90","1059","2022","0","52.37","34.62"
"10","002","00","009","0913","0355","448","313","135","45","493","956","0","51.57","32.74"
"10","002","00","009","0913","0356","521","387","134","45","566","1066","0","53.1","36.3"
"10","002","00","009","0914","0000","1452","1115","337","121","1573","3079","0","51.09","36.21"
"10","002","00","009","0914","0357","679","531","148","70","749","1513","0","49.5","35.1"
"10","002","00","009","0914","0358","773","584","189","51","824","1566","0","52.62","37.29"
"10","002","00","009","0915","0000","1295","947","348","175","1470","2833","0","51.89","33.43"
"10","002","00","009","0915","0359","428","319","109","65","493","894","0","55.15","35.68"
"10","002","00","009","0915","0360","514","361","153","67","581","1235","0","47.04","29.23"
"10","002","00","009","0915","0361","353","267","86","43","396","704","0","56.25","37.93"
"10","002","00","010","0000","0000","8922","6720","2202","991","9913","19051","21391","52.03","35.27"
"10","002","00","010","1001","0000","100","78","22","14","114","215","0","53.02","36.28"
"10","002","00","010","1001","0362","100","78","22","14","114","215","0","53.02","36.28"
"10","002","00","010","1002","0000","204","150","54","37","241","523","0","46.08","28.68"
"10","002","00","010","1002","0363","204","150","54","37","241","523","0","46.08","28.68"
"10","002","00","010","1003","0000","338","224","114","52","390","745","0","52.35","30.07"
"10","002","00","010","1003","0364","338","224","114","52","390","745","0","52.35","30.07"
"10","002","00","010","1004","0000","275","205","70","49","324","583","0","55.57","35.16"
"10","002","00","010","1004","0368","275","205","70","49","324","583","0","55.57","35.16"
"10","002","00","010","1005","0000","202","160","42","31","233","436","0","53.44","36.7"
"10","002","00","010","1005","0369","202","160","42","31","233","436","0","53.44","36.7"
"10","002","00","010","1006","0000","568","425","143","68","636","1224","0","51.96","34.72"
"10","002","00","010","1006","0370","568","425","143","68","636","1224","0","51.96","34.72"
"10","002","00","010","1007","0000","490","369","121","53","543","1151","0","47.18","32.06"
"10","002","00","010","1007","0371","490","369","121","53","543","1151","0","47.18","32.06"
"10","002","00","010","1008","0000","441","318","123","36","477","870","0","54.83","36.55"
"10","002","00","010","1008","0372","441","318","123","36","477","870","0","54.83","36.55"
"10","002","00","010","1009","0000","485","378","107","47","532","1284","0","41.43","29.44"
"10","002","00","010","1009","0373","485","378","107","47","532","1284","0","41.43","29.44"
"10","002","00","010","1010","0000","2073","1605","468","158","2231","4286","0","52.05","37.45"
"10","002","00","010","1010","0375","714","558","156","60","774","1439","0","53.79","38.78"
"10","002","00","010","1010","0376","676","504","172","55","731","1445","0","50.59","34.88"
"10","002","00","010","1010","0377","683","543","140","43","726","1402","0","51.78","38.73"
"10","002","00","010","1011","0000","484","361","123","46","530","897","0","59.09","40.25"
"10","002","00","010","1011","0374","484","361","123","46","530","897","0","59.09","40.25"
"10","002","00","010","1012","0000","270","201","69","33","303","617","0","49.11","32.58"
"10","002","00","010","1012","0365","270","201","69","33","303","617","0","49.11","32.58"
"10","002","00","010","1013","0000","225","157","68","39","264","497","0","53.12","31.59"
"10","002","00","010","1013","0366","225","157","68","39","264","497","0","53.12","31.59"
"10","002","00","010","1014","0000","350","261","89","61","411","735","0","55.92","35.51"
"10","002","00","010","1014","0367","350","261","89","61","411","735","0","55.92","35.51"
"10","002","00","010","1015","0000","585","416","169","55","640","1230","0","52.03","33.82"
"10","002","00","010","1015","0378","585","416","169","55","640","1230","0","52.03","33.82"
"10","002","00","010","1016","0000","371","288","83","61","432","774","0","55.81","37.21"
"10","002","00","010","1016","0379","371","288","83","61","432","774","0","55.81","37.21"
"10","002","00","010","1017","0000","790","590","200","77","867","1563","0","55.47","37.75"
"10","002","00","010","1017","0380","434","330","104","43","477","827","0","57.68","39.9"
"10","002","00","010","1017","0381","356","260","96","34","390","736","0","52.99","35.33"
"10","002","00","010","1018","0000","671","534","137","74","745","1421","0","52.43","37.58"
"10","002","00","010","1018","0382","671","534","137","74","745","1421","0","52.43","37.58"
"10","002","00","011","0000","0000","2038","1552","486","285","2323","4935","6247","47.07","31.45"
"10","002","00","011","1101","0000","303","222","81","56","359","893","0","40.2","24.86"
"10","002","00","011","1101","0383","303","222","81","56","359","893","0","40.2","24.86"
"10","002","00","011","1102","0000","408","322","86","53","461","632","0","72.94","50.95"
"10","002","00","011","1102","0384","408","322","86","53","461","632","0","72.94","50.95"
"10","002","00","011","1103","0000","269","220","49","23","292","684","0","42.69","32.16"
"10","002","00","011","1103","0385","269","220","49","23","292","684","0","42.69","32.16"
"10","002","00","011","1104","0000","143","106","37","32","175","264","0","66.29","40.15"
"10","002","00","011","1104","0386","143","106","37","32","175","264","0","66.29","40.15"
"10","002","00","011","1105","0000","107","93","14","6","113","337","0","33.53","27.6"
"10","002","00","011","1105","0387","107","93","14","6","113","337","0","33.53","27.6"
"10","002","00","011","1106","0000","131","102","29","9","140","404","0","34.65","25.25"
"10","002","00","011","1106","0388","131","102","29","9","140","404","0","34.65","25.25"
"10","002","00","011","1107","0000","22","16","6","4","26","55","0","47.27","29.09"
"10","002","00","011","1107","0389","22","16","6","4","26","55","0","47.27","29.09"
"10","002","00","011","1108","0000","227","165","62","21","248","787","0","31.51","20.97"
"10","002","00","011","1108","0391","227","165","62","21","248","787","0","31.51","20.97"
"10","002","00","011","1109","0000","299","223","76","57","356","680","0","52.35","32.79"
"10","002","00","011","1109","0392","299","223","76","57","356","680","0","52.35","32.79"
"10","002","00","011","1110","0000","129","83","46","24","153","199","0","76.88","41.71"
"10","002","00","011","1110","0390","129","83","46","24","153","199","0","76.88","41.71"
"10","002","00","012","0000","0000","2414","1938","476","218","2632","4644","6024","56.68","41.73"
"10","002","00","012","1201","0000","563","463","100","28","591","1210","0","48.84","38.26"
"10","002","00","012","1201","0394","563","463","100","28","591","1210","0","48.84","38.26"
"10","002","00","012","1202","0000","503","402","101","77","580","962","0","60.29","41.79"
"10","002","00","012","1202","0395","503","402","101","77","580","962","0","60.29","41.79"
"10","002","00","012","1203","0000","213","173","40","12","225","444","0","50.68","38.96"
"10","002","00","012","1203","0393","213","173","40","12","225","444","0","50.68","38.96"
"10","002","00","012","1204","0000","146","112","34","4","150","411","0","36.5","27.25"
"10","002","00","012","1204","0396","146","112","34","4","150","411","0","36.5","27.25"
"10","002","00","012","1205","0000","289","238","51","18","307","447","0","68.68","53.24"
"10","002","00","012","1205","0397","289","238","51","18","307","447","0","68.68","53.24"
"10","002","00","012","1206","0000","330","251","79","38","368","475","0","77.47","52.84"
"10","002","00","012","1206","0398","330","251","79","38","368","475","0","77.47","52.84"
"10","002","00","012","1207","0000","370","299","71","41","411","695","0","59.14","43.02"
"10","002","00","012","1207","0399","370","299","71","41","411","695","0","59.14","43.02"
"10","015","00","000","0000","0000","132500","104326","28174","11987","144487","278059","328331","51.96","37.52"
"10","015","00","001","0000","0000","42673","34380","8293","2728","45401","84807","103798","53.53","40.54"
"10","015","00","001","0101","0000","689","542","147","28","717","1512","0","47.42","35.85"
"10","015","00","001","0101","0019","689","542","147","28","717","1512","0","47.42","35.85"
"10","015","00","001","0102","0000","1005","783","222","103","1108","1996","0","55.51","39.23"
"10","015","00","001","0102","0014","513","399","114","68","581","1071","0","54.25","37.25"
"10","015","00","001","0102","0015","492","384","108","35","527","925","0","56.97","41.51"
"10","015","00","001","0103","0000","233","195","38","16","249","442","0","56.33","44.12"
"10","015","00","001","0103","0023","233","195","38","16","249","442","0","56.33","44.12"
"10","015","00","001","0104","0000","276","221","55","33","309","566","0","54.59","39.05"
"10","015","00","001","0104","0029","276","221","55","33","309","566","0","54.59","39.05"
"10","015","00","001","0105","0000","303","251","52","20","323","565","0","57.17","44.42"
"10","015","00","001","0105","0031","303","251","52","20","323","565","0","57.17","44.42"
"10","015","00","001","0106","0000","1480","1194","286","137","1617","2983","0","54.21","40.03"
"10","015","00","001","0106","0033","436","356","80","40","476","911","0","52.25","39.08"
"10","015","00","001","0106","0034","488","391","97","48","536","1029","0","52.09","38.0"
"10","015","00","001","0106","0035","556","447","109","49","605","1043","0","58.01","42.86"
"10","015","00","001","0107","0000","742","589","153","56","798","1840","0","43.37","32.01"
"10","015","00","001","0107","0052","464","365","99","34","498","1339","0","37.19","27.26"
"10","015","00","001","0107","0053","278","224","54","22","300","501","0","59.88","44.71"
"10","015","00","001","0108","0000","1789","1462","327","99","1888","3241","0","58.25","45.11"
"10","015","00","001","0108","0049","600","486","114","40","640","1022","0","62.62","47.55"
"10","015","00","001","0108","0050","619","507","112","19","638","1135","0","56.21","44.67"
"10","015","00","001","0108","0051","570","469","101","40","610","1084","0","56.27","43.27"
"10","015","00","001","0109","0000","830","653","177","29","859","1522","0","56.44","42.9"
"10","015","00","001","0109","0001","830","653","177","29","859","1522","0","56.44","42.9"
"10","015","00","001","0110","0000","883","722","161","86","969","2029","0","47.76","35.58"
"10","015","00","001","0110","0005","213","164","49","25","238","470","0","50.64","34.89"
"10","015","00","001","0110","0006","387","320","67","43","430","838","0","51.31","38.19"
"10","015","00","001","0110","0007","283","238","45","18","301","721","0","41.75","33.01"
"10","015","00","001","0112","0000","233","192","41","12","245","469","0","52.24","40.94"
"10","015","00","001","0112","0030","233","192","41","12","245","469","0","52.24","40.94"
"10","015","00","001","0113","0000","285","226","59","24","309","538","0","57.43","42.01"
"10","015","00","001","0113","0028","285","226","59","24","309","538","0","57.43","42.01"
"10","015","00","001","0114","0000","1864","1505","359","122","1986","3514","0","56.52","42.83"
"10","015","00","001","0114","0038","697","559","138","54","751","1331","0","56.42","42.0"
"10","015","00","001","0114","0039","652","533","119","39","691","1228","0","56.27","43.4"
"10","015","00","001","0114","0040","515","413","102","29","544","955","0","56.96","43.25"
"10","015","00","001","0115","0000","473","379","94","24","497","904","0","54.98","41.92"
"10","015","00","001","0115","0054","473","379","94","24","497","904","0","54.98","41.92"
"10","015","00","001","0116","0000","2558","2051","507","141","2699","5074","0","53.19","40.42"
"10","015","00","001","0116","0069","651","515","136","48","699","1410","0","49.57","36.52"
"10","015","00","001","0116","0070","671","552","119","19","690","1303","0","52.95","42.36"
"10","015","00","001","0116","0071","643","512","131","31","674","1256","0","53.66","40.76"
"10","015","00","001","0116","0072","593","472","121","43","636","1105","0","57.56","42.71"
"10","015","00","001","0117","0000","1927","1553","374","124","2051","3583","0","57.24","43.34"
"10","015","00","001","0117","0016","659","521","138","51","710","1141","0","62.23","45.66"
"10","015","00","001","0117","0017","572","462","110","27","599","1163","0","51.5","39.72"
"10","015","00","001","0117","0018","696","570","126","46","742","1279","0","58.01","44.57"
"10","015","00","001","0118","0000","1692","1366","326","71","1763","3181","0","55.42","42.94"
"10","015","00","001","0118","0002","623","510","113","28","651","1114","0","58.44","45.78"
"10","015","00","001","0118","0003","354","275","79","21","375","670","0","55.97","41.04"
"10","015","00","001","0118","0004","715","581","134","22","737","1397","0","52.76","41.59"
"10","015","00","001","0119","0000","534","452","82","26","560","1114","0","50.27","40.57"
"10","015","00","001","0119","0024","534","452","82","26","560","1114","0","50.27","40.57"
"10","015","00","001","0120","0000","333","265","68","19","352","577","0","61.01","45.93"
"10","015","00","001","0120","0026","333","265","68","19","352","577","0","61.01","45.93"
"10","015","00","001","0121","0000","974","776","198","52","1026","1835","0","55.91","42.29"
"10","015","00","001","0121","0036","466","371","95","23","489","856","0","57.13","43.34"
"10","015","00","001","0121","0037","508","405","103","29","537","979","0","54.85","41.37"
"10","015","00","001","0122","0000","533","441","92","32","565","1192","0","47.4","37.0"
"10","015","00","001","0122","0056","533","441","92","32","565","1192","0","47.4","37.0"
"10","015","00","001","0123","0000","1301","1038","263","65","1366","2766","0","49.39","37.53"
"10","015","00","001","0123","0062","601","489","112","18","619","1311","0","47.22","37.3"
"10","015","00","001","0123","0063","700","549","151","47","747","1455","0","51.34","37.73"
"10","015","00","001","0124","0000","901","730","171","68","969","1715","0","56.5","42.57"
"10","015","00","001","0124","0067","389","313","76","25","414","715","0","57.9","43.78"
"10","015","00","001","0124","0068","512","417","95","43","555","1000","0","55.5","41.7"
"10","015","00","001","0125","0000","489","380","109","39","528","918","0","57.52","41.39"
"10","015","00","001","0125","0008","489","380","109","39","528","918","0","57.52","41.39"
"10","015","00","001","0126","0000","308","244","64","25","333","615","0","54.15","39.67"
"10","015","00","001","0126","0020","308","244","64","25","333","615","0","54.15","39.67"
"10","015","00","001","0127","0000","254","212","42","32","286","559","0","51.16","37.92"
"10","015","00","001","0127","0022","254","212","42","32","286","559","0","51.16","37.92"
"10","015","00","001","0128","0000","462","371","91","32","494","810","0","60.99","45.8"
"10","015","00","001","0128","0027","462","371","91","32","494","810","0","60.99","45.8"
"10","015","00","001","0129","0000","1344","1092","252","95","1439","2674","0","53.81","40.84"
"10","015","00","001","0129","0047","599","480","119","59","658","1184","0","55.57","40.54"
"10","015","00","001","0129","0048","745","612","133","36","781","1490","0","52.42","41.07"
"10","015","00","001","0130","0000","286","217","69","18","304","490","0","62.04","44.29"
"10","015","00","001","0130","0055","286","217","69","18","304","490","0","62.04","44.29"
"10","015","00","001","0131","0000","1011","822","189","81","1092","1975","0","55.29","41.62"
"10","015","00","001","0131","0060","508","419","89","32","540","993","0","54.38","42.2"
"10","015","00","001","0131","0061","503","403","100","49","552","982","0","56.21","41.04"
"10","015","00","001","0132","0000","579","448","131","30","609","1068","0","57.02","41.95"
"10","015","00","001","0132","0077","579","448","131","30","609","1068","0","57.02","41.95"
"10","015","00","001","0133","0000","1463","1165","298","89","1552","2942","0","52.75","39.6"
"10","015","00","001","0133","0009","766","596","170","41","807","1539","0","52.44","38.73"
"10","015","00","001","0133","0010","697","569","128","48","745","1403","0","53.1","40.56"
"10","015","00","001","0134","0000","331","247","84","16","347","606","0","57.26","40.76"
"10","015","00","001","0134","0021","331","247","84","16","347","606","0","57.26","40.76"
"10","015","00","001","0135","0000","219","180","39","15","234","416","0","56.25","43.27"
"10","015","00","001","0135","0025","219","180","39","15","234","416","0","56.25","43.27"
"10","015","00","001","0136","0000","371","302","69","30","401","816","0","49.14","37.01"
"10","015","00","001","0136","0032","371","302","69","30","401","816","0","49.14","37.01"
"10","015","00","001","0137","0000","2610","2136","474","175","2785","5217","0","53.38","40.94"
"10","015","00","001","0137","0043","712","595","117","59","771","1369","0","56.32","43.46"
"10","015","00","001","0137","0044","606","486","120","33","639","1435","0","44.53","33.87"
"10","015","00","001","0137","0045","600","487","113","40","640","1164","0","54.98","41.84"
"10","015","00","001","0137","0046","692","568","124","43","735","1249","0","58.85","45.48"
"10","015","00","001","0138","0000","1151","937","214","84","1235","2226","0","55.48","42.09"
"10","015","00","001","0138","0058","642","527","115","35","677","1267","0","53.43","41.59"
"10","015","00","001","0138","0059","509","410","99","49","558","959","0","58.19","42.75"
"10","015","00","001","0139","0000","409","337","72","26","435","869","0","50.06","38.78"
"10","015","00","001","0139","0057","409","337","72","26","435","869","0","50.06","38.78"
"10","015","00","001","0140","0000","639","483","156","35","674","1482","0","45.48","32.59"
"10","015","00","001","0140","0081","639","483","156","35","674","1482","0","45.48","32.59"
"10","015","00","001","0141","0000","2116","1733","383","111","2227","4183","0","53.24","41.43"
"10","015","00","001","0141","0073","533","417","116","24","557","1089","0","51.15","38.29"
"10","015","00","001","0141","0074","492","396","96","22","514","1043","0","49.28","37.97"
"10","015","00","001","0141","0075","588","494","94","28","616","1080","0","57.04","45.74"
"10","015","00","001","0141","0076","503","426","77","37","540","971","0","55.61","43.87"
"10","015","00","001","0142","0000","1210","968","242","76","1286","2498","0","51.48","38.75"
"10","015","00","001","0142","0041","604","485","119","36","640","1268","0","50.47","38.25"
"10","015","00","001","0142","0042","606","483","123","40","646","1230","0","52.52","39.27"
"10","015","00","001","0143","0000","1701","1374","327","89","1790","3727","0","48.03","36.87"
"10","015","00","001","0143","0064","516","407","109","20","536","1151","0","46.57","35.36"
"10","015","00","001","0143","0065","584","467","117","26","610","1237","0","49.31","37.75"
"10","015","00","001","0143","0066","601","500","101","43","644","1339","0","48.1","37.34"
"10","015","00","001","0144","0000","2048","1665","383","121","2169","4064","0","53.37","40.97"
"10","015","00","001","0144","0078","660","560","100","34","694","1379","0","50.33","40.61"
"10","015","00","001","0144","0079","670","538","132","47","717","1362","0","52.64","39.5"
"10","015","00","001","0144","0080","718","567","151","40","758","1323","0","57.29","42.86"
"10","015","00","001","0145","0000","1834","1481","353","122","1956","3494","0","55.98","42.39"
"10","015","00","001","0145","0011","533","434","99","30","563","1068","0","52.72","40.64"
"10","015","00","001","0145","0012","612","499","113","31","643","1167","0","55.1","42.76"
"10","015","00","001","0145","0013","689","548","141","61","750","1259","0","59.57","43.53"
"10","015","00","002","0000","0000","4738","3785","953","555","5293","9676","10902","54.7","39.12"
"10","015","00","002","0201","0000","670","547","123","64","734","1192","0","61.58","45.89"
"10","015","00","002","0201","0195","670","547","123","64","734","1192","0","61.58","45.89"
"10","015","00","002","0202","0000","298","239","59","25","323","639","0","50.55","37.4"
"10","015","00","002","0202","0196","298","239","59","25","323","639","0","50.55","37.4"
"10","015","00","002","0203","0000","356","286","70","44","400","601","0","66.56","47.59"
"10","015","00","002","0203","0197","356","286","70","44","400","601","0","66.56","47.59"
"10","015","00","002","0204","0000","676","563","113","49","725","1137","0","63.76","49.52"
"10","015","00","002","0204","0198","676","563","113","49","725","1137","0","63.76","49.52"
"10","015","00","002","0205","0000","686","547","139","80","766","1352","0","56.66","40.46"
"10","015","00","002","0205","0199","366","270","96","51","417","742","0","56.2","36.39"
"10","015","00","002","0205","0200","320","277","43","29","349","610","0","57.21","45.41"
"10","015","00","002","0206","0000","212","157","55","46","258","513","0","50.29","30.6"
"10","015","00","002","0206","0201","150","105","45","42","192","295","0","65.08","35.59"
"10","015","00","002","0206","0202","62","52","10","4","66","218","0","30.28","23.85"
"10","015","00","002","0207","0000","527","411","116","58","585","1248","0","46.88","32.93"
"10","015","00","002","0207","0203","273","213","60","26","299","720","0","41.53","29.58"
"10","015","00","002","0207","0204","254","198","56","32","286","528","0","54.17","37.5"
"10","015","00","002","0208","0000","259","189","70","29","288","560","0","51.43","33.75"
"10","015","00","002","0208","0205","259","189","70","29","288","560","0","51.43","33.75"
"10","015","00","002","0209","0000","242","199","43","49","291","541","0","53.79","36.78"
"10","015","00","002","0209","0206","242","199","43","49","291","541","0","53.79","36.78"
"10","015","00","002","0210","0000","401","325","76","63","464","818","0","56.72","39.73"
"10","015","00","002","0210","0207","401","325","76","63","464","818","0","56.72","39.73"
"10","015","00","002","0211","0000","370","293","77","40","410","984","0","41.67","29.78"
"10","015","00","002","0211","0208","370","293","77","40","410","984","0","41.67","29.78"
"10","015","00","002","0212","0000","41","29","12","8","49","91","0","53.85","31.87"
"10","015","00","002","0212","0209","41","29","12","8","49","91","0","53.85","31.87"
"10","015","00","003","0000","0000","8451","6471","1980","1232","9683","20650","24066","46.89","31.34"
"10","015","00","003","0301","0000","2549","2030","519","249","2798","5111","0","54.74","39.72"
"10","015","00","003","0301","0254","503","400","103","43","546","1008","0","54.17","39.68"
"10","015","00","003","0301","0255","513","419","94","43","556","939","0","59.21","44.62"
"10","015","00","003","0301","0256","590","493","97","66","656","1256","0","52.23","39.25"
"10","015","00","003","0301","0257","448","337","111","57","505","929","0","54.36","36.28"
"10","015","00","003","0301","0258","495","381","114","40","535","979","0","54.65","38.92"
"10","015","00","003","0302","0000","696","540","156","100","796","1619","0","49.17","33.35"
"10","015","00","003","0302","0260","371","290","81","45","416","847","0","49.11","34.24"
"10","015","00","003","0302","0261","325","250","75","55","380","772","0","49.22","32.38"
"10","015","00","003","0303","0000","526","407","119","69","595","1286","0","46.27","31.65"
"10","015","00","003","0303","0264","526","407","119","69","595","1286","0","46.27","31.65"
"10","015","00","003","0304","0000","495","380","115","43","538","1358","0","39.62","27.98"
"10","015","00","003","0304","0262","255","196","59","22","277","558","0","49.64","35.13"
"10","015","00","003","0304","0263","240","184","56","21","261","800","0","32.63","23.0"
"10","015","00","003","0305","0000","683","551","132","47","730","1244","0","58.68","44.29"
"10","015","00","003","0305","0259","683","551","132","47","730","1244","0","58.68","44.29"
"10","015","00","003","0306","0000","520","402","118","79","599","1246","0","48.07","32.26"
"10","015","00","003","0306","0265","520","402","118","79","599","1246","0","48.07","32.26"
"10","015","00","003","0307","0000","279","184","95","66","345","647","0","53.32","28.44"
"10","015","00","003","0307","0266","279","184","95","66","345","647","0","53.32","28.44"
"10","015","00","003","0308","0000","200","159","41","21","221","990","0","22.32","16.06"
"10","015","00","003","0308","0267","200","159","41","21","221","990","0","22.32","16.06"
"10","015","00","003","0309","0000","212","148","64","51","263","530","0","49.62","27.92"
"10","015","00","003","0309","0268","212","148","64","51","263","530","0","49.62","27.92"
"10","015","00","003","0310","0000","536","398","138","147","683","1536","0","44.47","25.91"
"10","015","00","003","0310","0269","316","225","91","47","363","979","0","37.08","22.98"
"10","015","00","003","0310","0270","220","173","47","100","320","557","0","57.45","31.06"
"10","015","00","003","0311","0000","416","304","112","103","519","1499","0","34.62","20.28"
"10","015","00","003","0311","0271","139","107","32","19","158","434","0","36.41","24.65"
"10","015","00","003","0311","0272","277","197","80","84","361","1065","0","33.9","18.5"
"10","015","00","003","0312","0000","353","239","114","108","461","866","0","53.23","27.6"
"10","015","00","003","0312","0273","353","239","114","108","461","866","0","53.23","27.6"
"10","015","00","003","0313","0000","267","191","76","51","318","769","0","41.35","24.84"
"10","015","00","003","0313","0274","267","191","76","51","318","769","0","41.35","24.84"
"10","015","00","003","0314","0000","328","245","83","43","371","869","0","42.69","28.19"
"10","015","00","003","0314","0275","328","245","83","43","371","869","0","42.69","28.19"
"10","015","00","003","0315","0000","391","293","98","55","446","1080","0","41.3","27.13"
"10","015","00","003","0315","0276","391","293","98","55","446","1080","0","41.3","27.13"
"10","015","00","004","0000","0000","8474","6577","1897","685","9159","17029","20112","53.78","38.62"
"10","015","00","004","0401","0000","622","492","130","32","654","1296","0","50.46","37.96"
"10","015","00","004","0401","0082","196","148","48","16","212","367","0","57.77","40.33"
"10","015","00","004","0401","0083","426","344","82","16","442","929","0","47.58","37.03"
"10","015","00","004","0402","0000","443","312","131","83","526","897","0","58.64","34.78"
"10","015","00","004","0402","0084","297","217","80","57","354","590","0","60.0","36.78"
"10","015","00","004","0402","0085","146","95","51","26","172","307","0","56.03","30.94"
"10","015","00","004","0403","0000","1214","938","276","109","1323","2428","0","54.49","38.63"
"10","015","00","004","0403","0086","141","105","36","19","160","260","0","61.54","40.38"
"10","015","00","004","0403","0087","655","509","146","65","720","1283","0","56.12","39.67"
"10","015","00","004","0403","0088","418","324","94","25","443","885","0","50.06","36.61"
"10","015","00","004","0404","0000","1939","1505","434","127","2066","3962","0","52.15","37.99"
"10","015","00","004","0404","0092","539","404","135","51","590","1163","0","50.73","34.74"
"10","015","00","004","0404","0093","803","623","180","34","837","1605","0","52.15","38.82"
"10","015","00","004","0404","0094","597","478","119","42","639","1194","0","53.52","40.03"
"10","015","00","004","0405","0000","509","407","102","42","551","979","0","56.28","41.57"
"10","015","00","004","0405","0095","509","407","102","42","551","979","0","56.28","41.57"
"10","015","00","004","0406","0000","1894","1508","386","117","2011","3719","0","54.07","40.55"
"10","015","00","004","0406","0096","772","611","161","49","821","1485","0","55.29","41.14"
"10","015","00","004","0406","0097","521","416","105","34","555","1070","0","51.87","38.88"
"10","015","00","004","0406","0098","601","481","120","34","635","1164","0","54.55","41.32"
"10","015","00","004","0407","0000","584","433","151","73","657","1249","0","52.6","34.67"
"10","015","00","004","0407","0099","413","309","104","55","468","880","0","53.18","35.11"
"10","015","00","004","0407","0100","171","124","47","18","189","369","0","51.22","33.6"
"10","015","00","004","0408","0000","1269","982","287","102","1371","2499","0","54.86","39.3"
"10","015","00","004","0408","0089","406","310","96","35","441","770","0","57.27","40.26"
"10","015","00","004","0408","0090","684","538","146","54","738","1363","0","54.15","39.47"
"10","015","00","004","0408","0091","179","134","45","13","192","366","0","52.46","36.61"
"10","015","00","005","0000","0000","35331","28426","6905","2503","37834","72116","83262","52.46","39.42"
"10","015","00","005","0501","0000","3691","3062","629","199","3890","7071","0","55.01","43.3"
"10","015","00","005","0501","0147","575","470","105","34","609","1135","0","53.66","41.41"
"10","015","00","005","0501","0148","667","570","97","28","695","1223","0","56.83","46.61"
"10","015","00","005","0501","0149","652","552","100","45","697","1274","0","54.71","43.33"
"10","015","00","005","0501","0150","562","451","111","32","594","1124","0","52.85","40.12"
"10","015","00","005","0501","0151","617","509","108","33","650","1158","0","56.13","43.96"
"10","015","00","005","0501","0152","618","510","108","27","645","1157","0","55.75","44.08"
"10","015","00","005","0502","0000","2529","2041","488","120","2649","4926","0","53.78","41.43"
"10","015","00","005","0502","0153","643","528","115","43","686","1258","0","54.53","41.97"
"10","015","00","005","0502","0154","642","498","144","29","671","1257","0","53.38","39.62"
"10","015","00","005","0502","0155","617","504","113","31","648","1245","0","52.05","40.48"
"10","015","00","005","0502","0156","627","511","116","17","644","1166","0","55.23","43.83"
"10","015","00","005","0503","0000","1697","1319","378","127","1824","3739","0","48.78","35.28"
"10","015","00","005","0503","0119","540","421","119","34","574","1107","0","51.85","38.03"
"10","015","00","005","0503","0120","550","422","128","37","587","1179","0","49.79","35.79"
"10","015","00","005","0503","0121","607","476","131","56","663","1453","0","45.63","32.76"
"10","015","00","005","0504","0000","2079","1700","379","143","2222","4178","0","53.18","40.69"
"10","015","00","005","0504","0115","518","429","89","36","554","1059","0","52.31","40.51"
"10","015","00","005","0504","0116","510","429","81","35","545","983","0","55.44","43.64"
"10","015","00","005","0504","0117","527","438","89","35","562","1031","0","54.51","42.48"
"10","015","00","005","0504","0118","524","404","120","37","561","1105","0","50.77","36.56"
"10","015","00","005","0505","0000","3498","2870","628","209","3707","6870","0","53.96","41.78"
"10","015","00","005","0505","0122","796","657","139","45","841","1432","0","58.73","45.88"
"10","015","00","005","0505","0123","690","556","134","40","730","1320","0","55.3","42.12"
"10","015","00","005","0505","0124","649","531","118","31","680","1356","0","50.15","39.16"
"10","015","00","005","0505","0125","620","512","108","39","659","1295","0","50.89","39.54"
"10","015","00","005","0505","0126","743","614","129","54","797","1467","0","54.33","41.85"
"10","015","00","005","0506","0000","2608","2081","527","139","2747","5242","0","52.4","39.7"
"10","015","00","005","0506","0127","751","567","184","33","784","1515","0","51.75","37.43"
"10","015","00","005","0506","0128","576","477","99","53","629","1063","0","59.17","44.87"
"10","015","00","005","0506","0129","543","437","106","19","562","1284","0","43.77","34.03"
"10","015","00","005","0506","0130","738","600","138","34","772","1380","0","55.94","43.48"
"10","015","00","005","0507","0000","1443","1137","306","142","1585","2959","0","53.57","38.43"
"10","015","00","005","0507","0131","671","536","135","61","732","1297","0","56.44","41.33"
"10","015","00","005","0507","0132","772","601","171","81","853","1662","0","51.32","36.16"
"10","015","00","005","0508","0000","654","481","173","95","749","1563","0","47.92","30.77"
"10","015","00","005","0508","0133","654","481","173","95","749","1563","0","47.92","30.77"
"10","015","00","005","0509","0000","573","452","121","48","621","1288","0","48.21","35.09"
"10","015","00","005","0509","0134","573","452","121","48","621","1288","0","48.21","35.09"
"10","015","00","005","0510","0000","1395","1084","311","102","1497","2845","0","52.62","38.1"
"10","015","00","005","0510","0135","457","360","97","41","498","907","0","54.91","39.69"
"10","015","00","005","0510","0136","444","342","102","29","473","917","0","51.58","37.3"
"10","015","00","005","0510","0137","494","382","112","32","526","1021","0","51.52","37.41"
"10","015","00","005","0511","0000","1623","1329","294","164","1787","3187","0","56.07","41.7"
"10","015","00","005","0511","0138","570","471","99","44","614","1033","0","59.44","45.6"
"10","015","00","005","0511","0139","497","404","93","53","550","966","0","56.94","41.82"
"10","015","00","005","0511","0140","556","454","102","67","623","1188","0","52.44","38.22"
"10","015","00","005","0512","0000","1927","1563","364","106","2033","4066","0","50.0","38.44"
"10","015","00","005","0512","0141","735","594","141","30","765","1480","0","51.69","40.14"
"10","015","00","005","0512","0142","630","514","116","45","675","1393","0","48.46","36.9"
"10","015","00","005","0512","0143","562","455","107","31","593","1193","0","49.71","38.14"
"10","015","00","005","0513","0000","1909","1517","392","172","2081","3961","0","52.54","38.3"
"10","015","00","005","0513","0144","662","544","118","31","693","1445","0","47.96","37.65"
"10","015","00","005","0513","0145","606","472","134","90","696","1301","0","53.5","36.28"
"10","015","00","005","0513","0146","641","501","140","51","692","1215","0","56.95","41.23"
"10","015","00","005","0514","0000","3017","2450","567","231","3248","6041","0","53.77","40.56"
"10","015","00","005","0514","0157","645","522","123","63","708","1358","0","52.14","38.44"
"10","015","00","005","0514","0158","599","502","97","31","630","1214","0","51.89","41.35"
"10","015","00","005","0514","0159","568","452","116","54","622","1151","0","54.04","39.27"
"10","015","00","005","0514","0160","596","475","121","44","640","1157","0","55.32","41.05"
"10","015","00","005","0514","0161","609","499","110","39","648","1161","0","55.81","42.98"
"10","015","00","005","0515","0000","2606","2075","531","169","2775","5491","0","50.54","37.79"
"10","015","00","005","0515","0162","687","558","129","49","736","1304","0","56.44","42.79"
"10","015","00","005","0515","0163","662","511","151","52","714","1367","0","52.23","37.38"
"10","015","00","005","0515","0164","629","489","140","35","664","1411","0","47.06","34.66"
"10","015","00","005","0515","0165","628","517","111","33","661","1409","0","46.91","36.69"
"10","015","00","005","0516","0000","1079","850","229","121","1200","2338","0","51.33","36.36"
"10","015","00","005","0516","0166","490","393","97","41","531","1125","0","47.2","34.93"
"10","015","00","005","0516","0167","589","457","132","80","669","1213","0","55.15","37.68"
"10","015","00","005","0517","0000","2019","1604","415","157","2176","4415","0","49.29","36.33"
"10","015","00","005","0517","0168","589","452","137","35","624","1141","0","54.69","39.61"
"10","015","00","005","0517","0169","497","414","83","32","529","1156","0","45.76","35.81"
"10","015","00","005","0517","0170","508","421","87","52","560","1092","0","51.28","38.55"
"10","015","00","005","0517","0171","425","317","108","38","463","1026","0","45.13","30.9"
"10","015","00","005","0518","0000","984","811","173","59","1043","1936","0","53.87","41.89"
"10","015","00","005","0518","0172","403","330","73","15","418","804","0","51.99","41.04"
"10","015","00","005","0518","0173","581","481","100","44","625","1132","0","55.21","42.49"
"10","015","00","006","0000","0000","7880","5961","1919","861","8741","15847","18006","55.16","37.62"
"10","015","00","006","0601","0000","188","147","41","30","218","357","0","61.06","41.18"
"10","015","00","006","0601","0175","188","147","41","30","218","357","0","61.06","41.18"
"10","015","00","006","0602","0000","455","350","105","46","501","1052","0","47.62","33.27"
"10","015","00","006","0602","0174","455","350","105","46","501","1052","0","47.62","33.27"
"10","015","00","006","0603","0000","964","733","231","101","1065","1897","0","56.14","38.64"
"10","015","00","006","0603","0176","465","366","99","52","517","1022","0","50.59","35.81"
"10","015","00","006","0603","0177","499","367","132","49","548","875","0","62.63","41.94"
"10","015","00","006","0604","0000","674","501","173","73","747","1399","0","53.4","35.81"
"10","015","00","006","0604","0178","373","270","103","50","423","691","0","61.22","39.07"
"10","015","00","006","0604","0179","301","231","70","23","324","708","0","45.76","32.63"
"10","015","00","006","0605","0000","428","339","89","45","473","894","0","52.91","37.92"
"10","015","00","006","0605","0180","428","339","89","45","473","894","0","52.91","37.92"
"10","015","00","006","0606","0000","397","318","79","32","429","695","0","61.73","45.76"
"10","015","00","006","0606","0183","397","318","79","32","429","695","0","61.73","45.76"
"10","015","00","006","0607","0000","794","600","194","82","876","1627","0","53.84","36.88"
"10","015","00","006","0607","0181","375","296","79","32","407","746","0","54.56","39.68"
"10","015","00","006","0607","0182","419","304","115","50","469","881","0","53.23","34.51"
"10","015","00","006","0608","0000","432","306","126","79","511","816","0","62.62","37.5"
"10","015","00","006","0608","0184","432","306","126","79","511","816","0","62.62","37.5"
"10","015","00","006","0609","0000","358","259","99","37","395","773","0","51.1","33.51"
"10","015","00","006","0609","0185","358","259","99","37","395","773","0","51.1","33.51"
"10","015","00","006","0610","0000","756","590","166","93","849","1436","0","59.12","41.09"
"10","015","00","006","0610","0186","532","404","128","60","592","1029","0","57.53","39.26"
"10","015","00","006","0610","0187","224","186","38","33","257","407","0","63.14","45.7"
"10","015","00","006","0611","0000","1310","989","321","99","1409","2549","0","55.28","38.8"
"10","015","00","006","0611","0188","596","464","132","53","649","1139","0","56.98","40.74"
"10","015","00","006","0611","0189","539","390","149","34","573","996","0","57.53","39.16"
"10","015","00","006","0611","0190","175","135","40","12","187","414","0","45.17","32.61"
"10","015","00","006","0612","0000","148","110","38","9","157","270","0","58.15","40.74"
"10","015","00","006","0612","0191","148","110","38","9","157","270","0","58.15","40.74"
"10","015","00","006","0613","0000","426","319","107","62","488","836","0","58.37","38.16"
"10","015","00","006","0613","0192","426","319","107","62","488","836","0","58.37","38.16"
"10","015","00","006","0614","0000","268","195","73","48","316","739","0","42.76","26.39"
"10","015","00","006","0614","0194","268","195","73","48","316","739","0","42.76","26.39"
"10","015","00","006","0615","0000","282","205","77","25","307","507","0","60.55","40.43"
"10","015","00","006","0615","0193","282","205","77","25","307","507","0","60.55","40.43"
"10","015","00","007","0000","0000","5075","3869","1206","741","5816","11417","12847","50.94","33.89"
"10","015","00","007","0701","0000","460","387","73","43","503","859","0","58.56","45.05"
"10","015","00","007","0701","0211","460","387","73","43","503","859","0","58.56","45.05"
"10","015","00","007","0702","0000","628","498","130","89","717","1295","0","55.37","38.46"
"10","015","00","007","0702","0210","628","498","130","89","717","1295","0","55.37","38.46"
"10","015","00","007","0703","0000","466","346","120","103","569","958","0","59.39","36.12"
"10","015","00","007","0703","0212","466","346","120","103","569","958","0","59.39","36.12"
"10","015","00","007","0704","0000","490","356","134","97","587","1011","0","58.06","35.21"
"10","015","00","007","0704","0213","490","356","134","97","587","1011","0","58.06","35.21"
"10","015","00","007","0705","0000","524","366","158","79","603","1041","0","57.93","35.16"
"10","015","00","007","0705","0214","524","366","158","79","603","1041","0","57.93","35.16"
"10","015","00","007","0706","0000","241","211","30","27","268","471","0","56.9","44.8"
"10","015","00","007","0706","0221","241","211","30","27","268","471","0","56.9","44.8"
"10","015","00","007","0707","0000","351","250","101","52","403","756","0","53.31","33.07"
"10","015","00","007","0707","0222","309","215","94","49","358","640","0","55.94","33.59"
"10","015","00","007","0707","0223","42","35","7","3","45","116","0","38.79","30.17"
"10","015","00","007","0708","0000","133","105","28","10","143","496","0","28.83","21.17"
"10","015","00","007","0708","0224","133","105","28","10","143","496","0","28.83","21.17"
"10","015","00","007","0709","0000","135","101","34","11","146","324","0","45.06","31.17"
"10","015","00","007","0709","0225","135","101","34","11","146","324","0","45.06","31.17"
"10","015","00","007","0710","0000","156","123","33","20","176","454","0","38.77","27.09"
"10","015","00","007","0710","0226","156","123","33","20","176","454","0","38.77","27.09"
"10","015","00","007","0711","0000","398","297","101","87","485","1009","0","48.07","29.44"
"10","015","00","007","0711","0215","362","266","96","86","448","821","0","54.57","32.4"
"10","015","00","007","0711","0216","36","31","5","1","37","188","0","19.68","16.49"
"10","015","00","007","0712","0000","393","309","84","47","440","960","0","45.83","32.19"
"10","015","00","007","0712","0217","248","198","50","34","282","514","0","54.86","38.52"
"10","015","00","007","0712","0218","145","111","34","13","158","446","0","35.43","24.89"
"10","015","00","007","0713","0000","377","287","90","53","430","851","0","50.53","33.73"
"10","015","00","007","0713","0219","377","287","90","53","430","851","0","50.53","33.73"
"10","015","00","007","0714","0000","323","233","90","23","346","932","0","37.12","25.0"
"10","015","00","007","0714","0220","323","233","90","23","346","932","0","37.12","25.0"
"10","015","00","008","0000","0000","1585","1129","456","302","1887","4395","4811","42.94","25.69"
"10","015","00","008","0801","0000","627","473","154","78","705","1779","0","39.63","26.59"
"10","015","00","008","0801","0229","237","162","75","50","287","613","0","46.82","26.43"
"10","015","00","008","0801","0230","338","270","68","26","364","809","0","44.99","33.37"
"10","015","00","008","0801","0231","52","41","11","2","54","357","0","15.13","11.48"
"10","015","00","008","0802","0000","265","175","90","75","340","669","0","50.82","26.16"
"10","015","00","008","0802","0232","265","175","90","75","340","669","0","50.82","26.16"
"10","015","00","008","0803","0000","186","152","34","10","196","479","0","40.92","31.73"
"10","015","00","008","0803","0233","186","152","34","10","196","479","0","40.92","31.73"
"10","015","00","008","0804","0000","250","150","100","54","304","751","0","40.48","19.97"
"10","015","00","008","0804","0228","250","150","100","54","304","751","0","40.48","19.97"
"10","015","00","008","0805","0000","257","179","78","85","342","717","0","47.7","24.97"
"10","015","00","008","0805","0227","257","179","78","85","342","717","0","47.7","24.97"
"10","015","00","009","0000","0000","4421","3418","1003","601","5022","10279","11716","48.86","33.25"
"10","015","00","009","0901","0000","955","775","180","124","1079","1904","0","56.67","40.7"
"10","015","00","009","0901","0241","419","341","78","50","469","813","0","57.69","41.94"
"10","015","00","009","0901","0242","536","434","102","74","610","1091","0","55.91","39.78"
"10","015","00","009","0902","0000","923","723","200","107","1030","1814","0","56.78","39.86"
"10","015","00","009","0902","0243","426","337","89","47","473","839","0","56.38","40.17"
"10","015","00","009","0902","0244","497","386","111","60","557","975","0","57.13","39.59"
"10","015","00","009","0903","0000","234","172","62","20","254","546","0","46.52","31.5"
"10","015","00","009","0903","0245","234","172","62","20","254","546","0","46.52","31.5"
"10","015","00","009","0904","0000","495","376","119","75","570","1002","0","56.89","37.52"
"10","015","00","009","0904","0246","495","376","119","75","570","1002","0","56.89","37.52"
"10","015","00","009","0905","0000","236","179","57","40","276","593","0","46.54","30.19"
"10","015","00","009","0905","0247","236","179","57","40","276","593","0","46.54","30.19"
"10","015","00","009","0906","0000","477","362","115","81","558","965","0","57.82","37.51"
"10","015","00","009","0906","0248","477","362","115","81","558","965","0","57.82","37.51"
"10","015","00","009","0907","0000","394","291","103","81","475","863","0","55.04","33.72"
"10","015","00","009","0907","0249","394","291","103","81","475","863","0","55.04","33.72"
"10","015","00","009","0908","0000","69","51","18","8","77","340","0","22.65","15.0"
"10","015","00","009","0908","0250","69","51","18","8","77","340","0","22.65","15.0"
"10","015","00","009","0909","0000","316","243","73","38","354","764","0","46.34","31.81"
"10","015","00","009","0909","0251","316","243","73","38","354","764","0","46.34","31.81"
"10","015","00","009","0910","0000","158","118","40","11","169","868","0","19.47","13.59"
"10","015","00","009","0910","0252","158","118","40","11","169","868","0","19.47","13.59"
"10","015","00","009","0911","0000","164","128","36","16","180","620","0","29.03","20.65"
"10","015","00","009","0911","0253","164","128","36","16","180","620","0","29.03","20.65"
"10","015","00","010","0000","0000","3571","2681","890","547","4118","9065","10331","45.43","29.58"
"10","015","00","010","1001","0000","174","131","43","22","196","467","0","41.97","28.05"
"10","015","00","010","1001","0277","174","131","43","22","196","467","0","41.97","28.05"
"10","015","00","010","1002","0000","344","260","84","63","407","1032","0","39.44","25.19"
"10","015","00","010","1002","0278","344","260","84","63","407","1032","0","39.44","25.19"
"10","015","00","010","1003","0000","240","184","56","37","277","638","0","43.42","28.84"
"10","015","00","010","1003","0279","240","184","56","37","277","638","0","43.42","28.84"
"10","015","00","010","1004","0000","239","174","65","84","323","591","0","54.65","29.44"
"10","015","00","010","1004","0280","239","174","65","84","323","591","0","54.65","29.44"
"10","015","00","010","1005","0000","524","402","122","69","593","1087","0","54.55","36.98"
"10","015","00","010","1005","0281","524","402","122","69","593","1087","0","54.55","36.98"
"10","015","00","010","1006","0000","202","145","57","22","224","431","0","51.97","33.64"
"10","015","00","010","1006","0282","202","145","57","22","224","431","0","51.97","33.64"
"10","015","00","010","1007","0000","390","312","78","46","436","893","0","48.82","34.94"
"10","015","00","010","1007","0283","390","312","78","46","436","893","0","48.82","34.94"
"10","015","00","010","1008","0000","121","90","31","28","149","361","0","41.27","24.93"
"10","015","00","010","1008","0284","121","90","31","28","149","361","0","41.27","24.93"
"10","015","00","010","1009","0000","486","359","127","53","539","1362","0","39.57","26.36"
"10","015","00","010","1009","0285","486","359","127","53","539","1362","0","39.57","26.36"
"10","015","00","010","1010","0000","211","158","53","28","239","458","0","52.18","34.5"
"10","015","00","010","1010","0286","211","158","53","28","239","458","0","52.18","34.5"
"10","015","00","010","1011","0000","161","121","40","33","194","621","0","31.24","19.48"
"10","015","00","010","1011","0287","161","121","40","33","194","621","0","31.24","19.48"
"10","015","00","010","1012","0000","216","151","65","27","243","493","0","49.29","30.63"
"10","015","00","010","1012","0288","216","151","65","27","243","493","0","49.29","30.63"
"10","015","00","010","1013","0000","263","194","69","35","298","631","0","47.23","30.74"
"10","015","00","010","1013","0289","263","194","69","35","298","631","0","47.23","30.74"
"10","015","00","011","0000","0000","5478","4080","1398","550","6028","12562","15937","47.99","32.48"
"10","015","00","011","1101","0000","461","310","151","56","517","1373","0","37.65","22.58"
"10","015","00","011","1101","0103","461","310","151","56","517","1373","0","37.65","22.58"
"10","015","00","011","1102","0000","707","529","178","89","796","1806","0","44.08","29.29"
"10","015","00","011","1102","0104","622","463","159","85","707","1644","0","43.0","28.16"
"10","015","00","011","1102","0105","85","66","19","4","89","162","0","54.94","40.74"
"10","015","00","011","1103","0000","698","543","155","71","769","1766","0","43.54","30.75"
"10","015","00","011","1103","0106","164","118","46","29","193","384","0","50.26","30.73"
"10","015","00","011","1103","0107","534","425","109","42","576","1382","0","41.68","30.75"
"10","015","00","011","1104","0000","602","444","158","102","704","1139","0","61.81","38.98"
"10","015","00","011","1104","0111","602","444","158","102","704","1139","0","61.81","38.98"
"10","015","00","011","1105","0000","576","435","141","10","586","1213","0","48.31","35.86"
"10","015","00","011","1105","0112","576","435","141","10","586","1213","0","48.31","35.86"
"10","015","00","011","1106","0000","479","375","104","50","529","1084","0","48.8","34.59"
"10","015","00","011","1106","0113","353","274","79","32","385","754","0","51.06","36.34"
"10","015","00","011","1106","0114","126","101","25","18","144","330","0","43.64","30.61"
"10","015","00","011","1107","0000","737","544","193","60","797","1752","0","45.49","31.05"
"10","015","00","011","1107","0108","470","354","116","42","512","1125","0","45.51","31.47"
"10","015","00","011","1107","0109","267","190","77","18","285","627","0","45.45","30.3"
"10","015","00","011","1108","0000","543","405","138","51","594","987","0","60.18","41.03"
"10","015","00","011","1108","0110","543","405","138","51","594","987","0","60.18","41.03"
"10","015","00","011","1109","0000","675","495","180","61","736","1442","0","51.04","34.33"
"10","015","00","011","1109","0101","405","313","92","34","439","867","0","50.63","36.1"
"10","015","00","011","1109","0102","270","182","88","27","297","575","0","51.65","31.65"
"10","015","00","012","0000","0000","2482","1748","734","344","2826","5269","6439","53.63","33.18"
"10","015","00","012","1201","0000","516","362","154","78","594","1072","0","55.41","33.77"
"10","015","00","012","1201","0234","516","362","154","78","594","1072","0","55.41","33.77"
"10","015","00","012","1202","0000","207","158","49","11","218","560","0","38.93","28.21"
"10","015","00","012","1202","0235","207","158","49","11","218","560","0","38.93","28.21"
"10","015","00","012","1203","0000","419","316","103","39","458","773","0","59.25","40.88"
"10","015","00","012","1203","0236","419","316","103","39","458","773","0","59.25","40.88"
"10","015","00","012","1204","0000","237","170","67","13","250","661","0","37.82","25.72"
"10","015","00","012","1204","0237","237","170","67","13","250","661","0","37.82","25.72"
"10","015","00","012","1205","0000","482","333","149","88","570","1117","0","51.03","29.81"
"10","015","00","012","1205","0238","205","150","55","18","223","442","0","50.45","33.94"
"10","015","00","012","1205","0239","277","183","94","70","347","675","0","51.41","27.11"
"10","015","00","012","1206","0000","621","409","212","115","736","1086","0","67.77","37.66"
"10","015","00","012","1206","0240","621","409","212","115","736","1086","0","67.77","37.66"
"10","015","00","013","0000","0000","2341","1801","540","338","2679","4947","6104","54.15","36.41"
"10","015","00","013","1301","0000","259","204","55","23","282","533","0","52.91","38.27"
"10","015","00","013","1301","0290","259","204","55","23","282","533","0","52.91","38.27"
"10","015","00","013","1302","0000","437","319","118","68","505","1015","0","49.75","31.43"
"10","015","00","013","1302","0291","274","192","82","51","325","522","0","62.26","36.78"
"10","015","00","013","1302","0292","163","127","36","17","180","493","0","36.51","25.76"
"10","015","00","013","1303","0000","389","309","80","49","438","701","0","62.48","44.08"
"10","015","00","013","1303","0293","389","309","80","49","438","701","0","62.48","44.08"
"10","015","00","013","1304","0000","385","298","87","58","443","746","0","59.38","39.95"
"10","015","00","013","1304","0294","385","298","87","58","443","746","0","59.38","39.95"
"10","015","00","013","1305","0000","427","306","121","89","516","1021","0","50.54","29.97"
"10","015","00","013","1305","0295","316","219","97","70","386","616","0","62.66","35.55"
"10","015","00","013","1305","0296","111","87","24","19","130","405","0","32.1","21.48"
"10","015","00","013","1306","0000","444","365","79","51","495","931","0","53.17","39.21"
"10","015","00","013","1306","0297","159","127","32","20","179","329","0","54.41","38.6"
"10","015","00","013","1306","0298","196","160","36","22","218","428","0","50.93","37.38"
"10","015","00","013","1306","0299","89","78","11","9","98","174","0","56.32","44.83"
"10","014","00","000","0000","0000","84822","65154","19668","9028","93850","185996","219268","50.46","35.03"
"10","014","00","001","0000","0000","43823","34398","9425","3431","47254","87803","105587","53.82","39.18"
"10","014","00","001","0101","0000","662","480","182","110","772","1505","0","51.3","31.89"
"10","014","00","001","0101","0052","662","480","182","110","772","1505","0","51.3","31.89"
"10","014","00","001","0102","0000","343","272","71","61","404","836","0","48.33","32.54"
"10","014","00","001","0102","0053","343","272","71","61","404","836","0","48.33","32.54"
"10","014","00","001","0103","0000","1119","910","209","77","1196","2162","0","55.32","42.09"
"10","014","00","001","0103","0056","1119","910","209","77","1196","2162","0","55.32","42.09"
"10","014","00","001","0104","0000","1331","1063","268","106","1437","2688","0","53.46","39.55"
"10","014","00","001","0104","0059","651","538","113","47","698","1359","0","51.36","39.59"
"10","014","00","001","0104","0060","680","525","155","59","739","1329","0","55.61","39.5"
"10","014","00","001","0105","0000","1519","1211","308","117","1636","2767","0","59.13","43.77"
"10","014","00","001","0105","0057","905","734","171","60","965","1627","0","59.31","45.11"
"10","014","00","001","0105","0058","614","477","137","57","671","1140","0","58.86","41.84"
"10","014","00","001","0106","0000","1342","1028","314","111","1453","2644","0","54.95","38.88"
"10","014","00","001","0106","0054","686","529","157","48","734","1294","0","56.72","40.88"
"10","014","00","001","0106","0055","656","499","157","63","719","1350","0","53.26","36.96"
"10","014","00","001","0107","0000","3459","2796","663","220","3679","6543","0","56.23","42.73"
"10","014","00","001","0107","0026","897","712","185","53","950","1638","0","58.0","43.47"
"10","014","00","001","0107","0027","812","655","157","57","869","1576","0","55.14","41.56"
"10","014","00","001","0107","0028","826","679","147","66","892","1595","0","55.92","42.57"
"10","014","00","001","0107","0029","924","750","174","44","968","1734","0","55.82","43.25"
"10","014","00","001","0108","0000","1723","1358","365","98","1821","3141","0","57.98","43.23"
"10","014","00","001","0108","0006","847","668","179","48","895","1651","0","54.21","40.46"
"10","014","00","001","0108","0007","876","690","186","50","926","1490","0","62.15","46.31"
"10","014","00","001","0109","0000","413","315","98","32","445","859","0","51.8","36.67"
"10","014","00","001","0109","0008","413","315","98","32","445","859","0","51.8","36.67"
"10","014","00","001","0110","0000","1496","1227","269","107","1603","2651","0","60.47","46.28"
"10","014","00","001","0110","0032","729","595","134","56","785","1313","0","59.79","45.32"
"10","014","00","001","0110","0033","767","632","135","51","818","1338","0","61.14","47.23"
"10","014","00","001","0111","0000","1655","1312","343","111","1766","3021","0","58.46","43.43"
"10","014","00","001","0111","0030","775","612","163","67","842","1476","0","57.05","41.46"
"10","014","00","001","0111","0031","880","700","180","44","924","1545","0","59.81","45.31"
"10","014","00","001","0112","0000","2170","1743","427","127","2297","4021","0","57.13","43.35"
"10","014","00","001","0112","0003","663","539","124","32","695","1259","0","55.2","42.81"
"10","014","00","001","0112","0004","717","564","153","44","761","1399","0","54.4","40.31"
"10","014","00","001","0112","0005","790","640","150","51","841","1363","0","61.7","46.96"
"10","014","00","001","0113","0000","835","667","168","66","901","1469","0","61.33","45.41"
"10","014","00","001","0113","0002","835","667","168","66","901","1469","0","61.33","45.41"
"10","014","00","001","0114","0000","338","253","85","38","376","651","0","57.76","38.86"
"10","014","00","001","0114","0010","338","253","85","38","376","651","0","57.76","38.86"
"10","014","00","001","0115","0000","755","583","172","71","826","1650","0","50.06","35.33"
"10","014","00","001","0115","0011","755","583","172","71","826","1650","0","50.06","35.33"
"10","014","00","001","0116","0000","354","262","92","27","381","632","0","60.28","41.46"
"10","014","00","001","0116","0013","354","262","92","27","381","632","0","60.28","41.46"
"10","014","00","001","0117","0000","628","467","161","92","720","1299","0","55.43","35.95"
"10","014","00","001","0117","0016","628","467","161","92","720","1299","0","55.43","35.95"
"10","014","00","001","0118","0000","503","384","119","32","535","890","0","60.11","43.15"
"10","014","00","001","0118","0009","503","384","119","32","535","890","0","60.11","43.15"
"10","014","00","001","0119","0000","415","309","106","35","450","724","0","62.15","42.68"
"10","014","00","001","0119","0012","415","309","106","35","450","724","0","62.15","42.68"
"10","014","00","001","0120","0000","453","339","114","32","485","811","0","59.8","41.8"
"10","014","00","001","0120","0017","453","339","114","32","485","811","0","59.8","41.8"
"10","014","00","001","0121","0000","417","326","91","46","463","771","0","60.05","42.28"
"10","014","00","001","0121","0014","417","326","91","46","463","771","0","60.05","42.28"
"10","014","00","001","0122","0000","380","282","98","27","407","798","0","51.0","35.34"
"10","014","00","001","0122","0015","380","282","98","27","407","798","0","51.0","35.34"
"10","014","00","001","0123","0000","410","326","84","19","429","874","0","49.08","37.3"
"10","014","00","001","0123","0001","410","326","84","19","429","874","0","49.08","37.3"
"10","014","00","001","0124","0000","445","355","90","44","489","764","0","64.01","46.47"
"10","014","00","001","0124","0018","445","355","90","44","489","764","0","64.01","46.47"
"10","014","00","001","0125","0000","272","206","66","24","296","601","0","49.25","34.28"
"10","014","00","001","0125","0023","272","206","66","24","296","601","0","49.25","34.28"
"10","014","00","001","0126","0000","386","282","104","11","397","784","0","50.64","35.97"
"10","014","00","001","0126","0019","386","282","104","11","397","784","0","50.64","35.97"
"10","014","00","001","0127","0000","192","151","41","11","203","417","0","48.68","36.21"
"10","014","00","001","0127","0024","192","151","41","11","203","417","0","48.68","36.21"
"10","014","00","001","0128","0000","194","145","49","14","208","427","0","48.71","33.96"
"10","014","00","001","0128","0020","194","145","49","14","208","427","0","48.71","33.96"
"10","014","00","001","0129","0000","756","582","174","82","838","1597","0","52.47","36.44"
"10","014","00","001","0129","0063","756","582","174","82","838","1597","0","52.47","36.44"
"10","014","00","001","0130","0000","1001","773","228","101","1102","2028","0","54.34","38.12"
"10","014","00","001","0130","0061","473","366","107","42","515","990","0","52.02","36.97"
"10","014","00","001","0130","0062","528","407","121","59","587","1038","0","56.55","39.21"
"10","014","00","001","0131","0000","1313","1022","291","121","1434","2959","0","48.46","34.54"
"10","014","00","001","0131","0036","608","450","158","69","677","1407","0","48.12","31.98"
"10","014","00","001","0131","0037","705","572","133","52","757","1552","0","48.78","36.86"
"10","014","00","001","0132","0000","1361","1116","245","83","1444","2577","0","56.03","43.31"
"10","014","00","001","0132","0034","663","564","99","36","699","1312","0","53.28","42.99"
"10","014","00","001","0132","0035","698","552","146","47","745","1265","0","58.89","43.64"
"10","014","00","001","0133","0000","738","574","164","72","810","1445","0","56.06","39.72"
"10","014","00","001","0133","0038","738","574","164","72","810","1445","0","56.06","39.72"
"10","014","00","001","0134","0000","1109","877","232","77","1186","2098","0","56.53","41.8"
"10","014","00","001","0134","0039","1109","877","232","77","1186","2098","0","56.53","41.8"
"10","014","00","001","0135","0000","697","544","153","83","780","1324","0","58.91","41.09"
"10","014","00","001","0135","0040","697","544","153","83","780","1324","0","58.91","41.09"
"10","014","00","001","0136","0000","1425","1157","268","45","1470","2793","0","52.63","41.42"
"10","014","00","001","0136","0021","608","493","115","29","637","1292","0","49.3","38.16"
"10","014","00","001","0136","0022","817","664","153","16","833","1501","0","55.5","44.24"
"10","014","00","001","0137","0000","503","397","106","48","551","1001","0","55.04","39.66"
"10","014","00","001","0137","0025","503","397","106","48","551","1001","0","55.04","39.66"
"10","014","00","001","0138","0000","3902","3088","814","244","4146","8002","0","51.81","38.59"
"10","014","00","001","0138","0041","798","633","165","42","840","1598","0","52.57","39.61"
"10","014","00","001","0138","0042","743","605","138","30","773","1513","0","51.09","39.99"
"10","014","00","001","0138","0043","811","641","170","38","849","1679","0","50.57","38.18"
"10","014","00","001","0138","0044","672","517","155","67","739","1414","0","52.26","36.56"
"10","014","00","001","0138","0045","878","692","186","67","945","1798","0","52.56","38.49"
"10","014","00","001","0139","0000","2334","1815","519","225","2559","5087","0","50.3","35.68"
"10","014","00","001","0139","0046","736","548","188","66","802","1749","0","45.85","31.33"
"10","014","00","001","0139","0047","841","650","191","92","933","1709","0","54.59","38.03"
"10","014","00","001","0139","0048","757","617","140","67","824","1629","0","50.58","37.88"
"10","014","00","001","0140","0000","1030","799","231","100","1130","2375","0","47.58","33.64"
"10","014","00","001","0140","0049","522","401","121","69","591","1116","0","52.96","35.93"
"10","014","00","001","0140","0050","508","398","110","31","539","1259","0","42.81","31.61"
"10","014","00","001","0141","0000","510","380","130","44","554","1232","0","44.97","30.84"
"10","014","00","001","0141","0051","510","380","130","44","554","1232","0","44.97","30.84"
"10","014","00","001","0142","0000","650","478","172","94","744","1385","0","53.72","34.51"
"10","014","00","001","0142","0064","650","478","172","94","744","1385","0","53.72","34.51"
"10","014","00","001","0143","0000","388","307","81","21","409","939","0","43.56","32.69"
"10","014","00","001","0143","0065","388","307","81","21","409","939","0","43.56","32.69"
"10","014","00","001","0144","0000","499","374","125","56","555","1258","0","44.12","29.73"
"10","014","00","001","0144","0066","499","374","125","56","555","1258","0","44.12","29.73"
"10","014","00","001","0145","0000","621","450","171","5","626","1350","0","46.37","33.33"
"10","014","00","001","0145","0067","621","450","171","5","626","1350","0","46.37","33.33"
"10","014","00","001","0146","0000","777","613","164","64","841","1953","0","43.06","31.39"
"10","014","00","001","0146","0068","440","357","83","34","474","1058","0","44.8","33.74"
"10","014","00","001","0146","0069","337","256","81","30","367","895","0","41.01","28.6"
"10","014","00","002","0000","0000","5231","4034","1197","846","6077","12426","14105","48.91","32.46"
"10","014","00","002","0201","0000","189","138","51","30","219","637","0","34.38","21.66"
"10","014","00","002","0201","0085","71","54","17","2","73","373","0","19.57","14.48"
"10","014","00","002","0201","0086","118","84","34","28","146","264","0","55.3","31.82"
"10","014","00","002","0202","0000","317","239","78","95","412","969","0","42.52","24.66"
"10","014","00","002","0202","0083","166","125","41","52","218","488","0","44.67","25.61"
"10","014","00","002","0202","0084","151","114","37","43","194","481","0","40.33","23.7"
"10","014","00","002","0203","0000","491","371","120","143","634","1403","0","45.19","26.44"
"10","014","00","002","0203","0081","203","148","55","60","263","516","0","50.97","28.68"
"10","014","00","002","0203","0082","288","223","65","83","371","887","0","41.83","25.14"
"10","014","00","002","0204","0000","1217","977","240","193","1410","2731","0","51.63","35.77"
"10","014","00","002","0204","0079","590","476","114","104","694","1365","0","50.84","34.87"
"10","014","00","002","0204","0080","627","501","126","89","716","1366","0","52.42","36.68"
"10","014","00","002","0205","0000","925","743","182","73","998","1901","0","52.5","39.08"
"10","014","00","002","0205","0077","457","354","103","46","503","931","0","54.03","38.02"
"10","014","00","002","0205","0078","468","389","79","27","495","970","0","51.03","40.1"
"10","014","00","002","0206","0000","988","759","229","105","1093","2197","0","49.75","34.55"
"10","014","00","002","0206","0074","139","102","37","21","160","339","0","47.2","30.09"
"10","014","00","002","0206","0075","423","332","91","27","450","995","0","45.23","33.37"
"10","014","00","002","0206","0076","426","325","101","57","483","863","0","55.97","37.66"
"10","014","00","002","0207","0000","277","193","84","68","345","747","0","46.18","25.84"
"10","014","00","002","0207","0073","277","193","84","68","345","747","0","46.18","25.84"
"10","014","00","002","0208","0000","827","614","213","139","966","1841","0","52.47","33.35"
"10","014","00","002","0208","0070","213","164","49","41","254","516","0","49.22","31.78"
"10","014","00","002","0208","0071","512","367","145","81","593","960","0","61.77","38.23"
"10","014","00","002","0208","0072","102","83","19","17","119","365","0","32.6","22.74"
"10","014","00","003","0000","0000","3414","2664","750","259","3673","7509","8727","48.91","35.48"
"10","014","00","003","0301","0000","703","532","171","61","764","1691","0","45.18","31.46"
"10","014","00","003","0301","0093","422","324","98","43","465","912","0","50.99","35.53"
"10","014","00","003","0301","0094","281","208","73","18","299","779","0","38.38","26.7"
"10","014","00","003","0302","0000","584","470","114","32","616","1137","0","54.18","41.34"
"10","014","00","003","0302","0091","584","470","114","32","616","1137","0","54.18","41.34"
"10","014","00","003","0303","0000","342","268","74","25","367","887","0","41.38","30.21"
"10","014","00","003","0303","0090","342","268","74","25","367","887","0","41.38","30.21"
"10","014","00","003","0304","0000","457","364","93","43","500","828","0","60.39","43.96"
"10","014","00","003","0304","0089","457","364","93","43","500","828","0","60.39","43.96"
"10","014","00","003","0305","0000","829","646","183","44","873","1699","0","51.38","38.02"
"10","014","00","003","0305","0087","512","406","106","25","537","909","0","59.08","44.66"
"10","014","00","003","0305","0088","317","240","77","19","336","790","0","42.53","30.38"
"10","014","00","003","0306","0000","183","144","39","20","203","535","0","37.94","26.92"
"10","014","00","003","0306","0095","183","144","39","20","203","535","0","37.94","26.92"
"10","014","00","003","0307","0000","316","240","76","34","350","732","0","47.81","32.79"
"10","014","00","003","0307","0092","316","240","76","34","350","732","0","47.81","32.79"
"10","014","00","004","0000","0000","6937","5260","1677","840","7777","14976","17314","51.93","35.12"
"10","014","00","004","0401","0000","190","125","65","21","211","476","0","44.33","26.26"
"10","014","00","004","0401","0105","88","51","37","8","96","261","0","36.78","19.54"
"10","014","00","004","0401","0106","102","74","28","13","115","215","0","53.49","34.42"
"10","014","00","004","0402","0000","199","161","38","26","225","436","0","51.61","36.93"
"10","014","00","004","0402","0117","199","161","38","26","225","436","0","51.61","36.93"
"10","014","00","004","0403","0000","196","165","31","23","219","488","0","44.88","33.81"
"10","014","00","004","0403","0115","196","165","31","23","219","488","0","44.88","33.81"
"10","014","00","004","0404","0000","185","151","34","19","204","347","0","58.79","43.52"
"10","014","00","004","0404","0116","185","151","34","19","204","347","0","58.79","43.52"
"10","014","00","004","0405","0000","500","381","119","74","574","1163","0","49.36","32.76"
"10","014","00","004","0405","0103","303","232","71","43","346","727","0","47.59","31.91"
"10","014","00","004","0405","0104","197","149","48","31","228","436","0","52.29","34.17"
"10","014","00","004","0406","0000","535","412","123","64","599","1270","0","47.17","32.44"
"10","014","00","004","0406","0101","300","226","74","29","329","767","0","42.89","29.47"
"10","014","00","004","0406","0102","235","186","49","35","270","503","0","53.68","36.98"
"10","014","00","004","0407","0000","392","288","104","73","465","1066","0","43.62","27.02"
"10","014","00","004","0407","0098","74","50","24","22","96","219","0","43.84","22.83"
"10","014","00","004","0407","0099","178","128","50","36","214","460","0","46.52","27.83"
"10","014","00","004","0407","0100","140","110","30","15","155","387","0","40.05","28.42"
"10","014","00","004","0408","0000","1052","805","247","112","1164","2206","0","52.77","36.49"
"10","014","00","004","0408","0096","526","379","147","73","599","1041","0","57.54","36.41"
"10","014","00","004","0408","0097","526","426","100","39","565","1165","0","48.5","36.57"
"10","014","00","004","0409","0000","522","370","152","72","594","1110","0","53.51","33.33"
"10","014","00","004","0409","0110","522","370","152","72","594","1110","0","53.51","33.33"
"10","014","00","004","0410","0000","1517","1184","333","125","1642","3015","0","54.46","39.27"
"10","014","00","004","0410","0107","749","587","162","52","801","1442","0","55.55","40.71"
"10","014","00","004","0410","0108","245","203","42","17","262","527","0","49.72","38.52"
"10","014","00","004","0410","0109","523","394","129","56","579","1046","0","55.35","37.67"
"10","014","00","004","0411","0000","576","442","134","49","625","1105","0","56.56","40.0"
"10","014","00","004","0411","0111","576","442","134","49","625","1105","0","56.56","40.0"
"10","014","00","004","0412","0000","598","437","161","128","726","1167","0","62.21","37.45"
"10","014","00","004","0412","0112","598","437","161","128","726","1167","0","62.21","37.45"
"10","014","00","004","0413","0000","475","339","136","54","529","1127","0","46.94","30.08"
"10","014","00","004","0413","0113","421","301","120","49","470","968","0","48.55","31.1"
"10","014","00","004","0413","0114","54","38","16","5","59","159","0","37.11","23.9"
"10","014","00","005","0000","0000","2744","2037","707","342","3086","6936","7891","44.49","29.37"
"10","014","00","005","0501","0000","236","157","79","52","288","675","0","42.67","23.26"
"10","014","00","005","0501","0125","236","157","79","52","288","675","0","42.67","23.26"
"10","014","00","005","0502","0000","345","247","98","50","395","905","0","43.65","27.29"
"10","014","00","005","0502","0126","190","137","53","23","213","435","0","48.97","31.49"
"10","014","00","005","0502","0127","155","110","45","27","182","470","0","38.72","23.4"
"10","014","00","005","0503","0000","351","245","106","56","407","864","0","47.11","28.36"
"10","014","00","005","0503","0124","351","245","106","56","407","864","0","47.11","28.36"
"10","014","00","005","0504","0000","611","478","133","55","666","1446","0","46.06","33.06"
"10","014","00","005","0504","0121","474","365","109","38","512","1104","0","46.38","33.06"
"10","014","00","005","0504","0122","137","113","24","17","154","342","0","45.03","33.04"
"10","014","00","005","0505","0000","361","273","88","58","419","895","0","46.82","30.5"
"10","014","00","005","0505","0123","361","273","88","58","419","895","0","46.82","30.5"
"10","014","00","005","0506","0000","459","355","104","37","496","1096","0","45.26","32.39"
"10","014","00","005","0506","0118","180","139","41","9","189","522","0","36.21","26.63"
"10","014","00","005","0506","0119","279","216","63","28","307","574","0","53.48","37.63"
"10","014","00","005","0507","0000","381","282","99","34","415","1055","0","39.34","26.73"
"10","014","00","005","0507","0120","381","282","99","34","415","1055","0","39.34","26.73"
"10","014","00","006","0000","0000","2899","2180","719","342","3241","7162","8207","45.25","30.44"
"10","014","00","006","0601","0000","453","320","133","62","515","1137","0","45.29","28.14"
"10","014","00","006","0601","0130","181","134","47","29","210","434","0","48.39","30.88"
"10","014","00","006","0601","0131","272","186","86","33","305","703","0","43.39","26.46"
"10","014","00","006","0602","0000","240","187","53","22","262","654","0","40.06","28.59"
"10","014","00","006","0602","0132","240","187","53","22","262","654","0","40.06","28.59"
"10","014","00","006","0603","0000","112","79","33","16","128","324","0","39.51","24.38"
"10","014","00","006","0603","0133","112","79","33","16","128","324","0","39.51","24.38"
"10","014","00","006","0604","0000","316","234","82","40","356","794","0","44.84","29.47"
"10","014","00","006","0604","0134","316","234","82","40","356","794","0","44.84","29.47"
"10","014","00","006","0605","0000","890","692","198","78","968","1921","0","50.39","36.02"
"10","014","00","006","0605","0128","436","337","99","24","460","992","0","46.37","33.97"
"10","014","00","006","0605","0129","454","355","99","54","508","929","0","54.68","38.21"
"10","014","00","006","0606","0000","128","105","23","12","140","344","0","40.7","30.52"
"10","014","00","006","0606","0136","128","105","23","12","140","344","0","40.7","30.52"
"10","014","00","006","0607","0000","365","277","88","48","413","856","0","48.25","32.36"
"10","014","00","006","0607","0135","365","277","88","48","413","856","0","48.25","32.36"
"10","014","00","006","0608","0000","149","115","34","23","172","311","0","55.31","36.98"
"10","014","00","006","0608","0137","149","115","34","23","172","311","0","55.31","36.98"
"10","014","00","006","0609","0000","117","81","36","19","136","386","0","35.23","20.98"
"10","014","00","006","0609","0138","117","81","36","19","136","386","0","35.23","20.98"
"10","014","00","006","0610","0000","129","90","39","22","151","435","0","34.71","20.69"
"10","014","00","006","0610","0139","129","90","39","22","151","435","0","34.71","20.69"
"10","014","00","007","0000","0000","2776","2037","739","424","3200","7635","8518","41.91","26.68"
"10","014","00","007","0701","0000","449","322","127","77","526","1620","0","32.47","19.88"
"10","014","00","007","0701","0147","177","126","51","33","210","867","0","24.22","14.53"
"10","014","00","007","0701","0148","126","96","30","22","148","345","0","42.9","27.83"
"10","014","00","007","0701","0149","146","100","46","22","168","408","0","41.18","24.51"
"10","014","00","007","0702","0000","276","206","70","12","288","1197","0","24.06","17.21"
"10","014","00","007","0702","0146","276","206","70","12","288","1197","0","24.06","17.21"
"10","014","00","007","0703","0000","365","264","101","30","395","977","0","40.43","27.02"
"10","014","00","007","0703","0145","365","264","101","30","395","977","0","40.43","27.02"
"10","014","00","007","0704","0000","106","83","23","8","114","262","0","43.51","31.68"
"10","014","00","007","0704","0150","106","83","23","8","114","262","0","43.51","31.68"
"10","014","00","007","0705","0000","214","165","49","41","255","555","0","45.95","29.73"
"10","014","00","007","0705","0144","214","165","49","41","255","555","0","45.95","29.73"
"10","014","00","007","0706","0000","344","260","84","84","428","918","0","46.62","28.32"
"10","014","00","007","0706","0143","344","260","84","84","428","918","0","46.62","28.32"
"10","014","00","007","0707","0000","1022","737","285","172","1194","2106","0","56.7","35.0"
"10","014","00","007","0707","0140","96","73","23","26","122","290","0","42.07","25.17"
"10","014","00","007","0707","0141","298","221","77","38","336","620","0","54.19","35.65"
"10","014","00","007","0707","0142","628","443","185","108","736","1196","0","61.54","37.04"
"10","014","00","008","0000","0000","2145","1578","567","448","2593","6484","7196","39.99","24.34"
"10","014","00","008","0801","0000","197","150","47","66","263","630","0","41.75","23.81"
"10","014","00","008","0801","0160","11","8","3","2","13","25","0","52.0","32.0"
"10","014","00","008","0801","0161","186","142","44","64","250","605","0","41.32","23.47"
"10","014","00","008","0802","0000","320","233","87","86","406","1191","0","34.09","19.56"
"10","014","00","008","0802","0157","210","148","62","69","279","660","0","42.27","22.42"
"10","014","00","008","0802","0158","59","48","11","4","63","336","0","18.75","14.29"
"10","014","00","008","0802","0159","51","37","14","13","64","195","0","32.82","18.97"
"10","014","00","008","0803","0000","123","89","34","10","133","532","0","25.0","16.73"
"10","014","00","008","0803","0156","123","89","34","10","133","532","0","25.0","16.73"
"10","014","00","008","0804","0000","668","511","157","94","762","1993","0","38.23","25.64"
"10","014","00","008","0804","0154","400","321","79","27","427","1268","0","33.68","25.32"
"10","014","00","008","0804","0155","268","190","78","67","335","725","0","46.21","26.21"
"10","014","00","008","0805","0000","387","280","107","112","499","913","0","54.65","30.67"
"10","014","00","008","0805","0153","387","280","107","112","499","913","0","54.65","30.67"
"10","014","00","008","0806","0000","450","315","135","80","530","1225","0","43.27","25.71"
"10","014","00","008","0806","0151","256","166","90","53","309","536","0","57.65","30.97"
"10","014","00","008","0806","0152","194","149","45","27","221","689","0","32.08","21.63"
"10","014","00","009","0000","0000","4017","3009","1008","545","4562","9666","11186","47.2","31.13"
"10","014","00","009","0901","0000","602","470","132","73","675","1297","0","52.04","36.24"
"10","014","00","009","0901","0162","337","274","63","47","384","722","0","53.19","37.95"
"10","014","00","009","0901","0163","265","196","69","26","291","575","0","50.61","34.09"
"10","014","00","009","0902","0000","273","203","70","37","310","623","0","49.76","32.58"
"10","014","00","009","0902","0164","273","203","70","37","310","623","0","49.76","32.58"
"10","014","00","009","0903","0000","246","185","61","49","295","622","0","47.43","29.74"
"10","014","00","009","0903","0165","246","185","61","49","295","622","0","47.43","29.74"
"10","014","00","009","0904","0000","191","154","37","11","202","560","0","36.07","27.5"
"10","014","00","009","0904","0166","191","154","37","11","202","560","0","36.07","27.5"
"10","014","00","009","0905","0000","695","538","157","98","793","1410","0","56.24","38.16"
"10","014","00","009","0905","0169","366","283","83","48","414","673","0","61.52","42.05"
"10","014","00","009","0905","0170","329","255","74","50","379","737","0","51.42","34.6"
"10","014","00","009","0906","0000","758","549","209","139","897","1766","0","50.79","31.09"
"10","014","00","009","0906","0167","438","338","100","101","539","957","0","56.32","35.32"
"10","014","00","009","0906","0168","320","211","109","38","358","809","0","44.25","26.08"
"10","014","00","009","0907","0000","363","238","125","54","417","798","0","52.26","29.82"
"10","014","00","009","0907","0171","207","140","67","31","238","424","0","56.13","33.02"
"10","014","00","009","0907","0172","156","98","58","23","179","374","0","47.86","26.2"
"10","014","00","009","0908","0000","518","394","124","29","547","1698","0","32.21","23.2"
"10","014","00","009","0908","0173","257","195","62","20","277","829","0","33.41","23.52"
"10","014","00","009","0908","0174","261","199","62","9","270","869","0","31.07","22.9"
"10","014","00","009","0909","0000","371","278","93","55","426","892","0","47.76","31.17"
"10","014","00","009","0909","0175","59","49","10","5","64","223","0","28.7","21.97"
"10","014","00","009","0909","0176","312","229","83","50","362","669","0","54.11","34.23"
"10","014","00","010","0000","0000","2128","1563","565","543","2671","5266","6100","50.72","29.68"
"10","014","00","010","1001","0000","291","193","98","89","380","763","0","49.8","25.29"
"10","014","00","010","1001","0181","153","102","51","60","213","386","0","55.18","26.42"
"10","014","00","010","1001","0182","138","91","47","29","167","377","0","44.3","24.14"
"10","014","00","010","1002","0000","418","298","120","117","535","1134","0","47.18","26.28"
"10","014","00","010","1002","0180","418","298","120","117","535","1134","0","47.18","26.28"
"10","014","00","010","1003","0000","590","450","140","116","706","1327","0","53.2","33.91"
"10","014","00","010","1003","0179","590","450","140","116","706","1327","0","53.2","33.91"
"10","014","00","010","1004","0000","567","433","134","153","720","1474","0","48.85","29.38"
"10","014","00","010","1004","0178","567","433","134","153","720","1474","0","48.85","29.38"
"10","014","00","010","1005","0000","262","189","73","68","330","568","0","58.1","33.27"
"10","014","00","010","1005","0177","262","189","73","68","330","568","0","58.1","33.27"
"10","014","00","011","0000","0000","1456","1139","317","92","1548","3579","4097","43.25","31.82"
"10","014","00","011","1101","0000","449","345","104","29","478","1023","0","46.73","33.72"
"10","014","00","011","1101","0185","355","272","83","26","381","813","0","46.86","33.46"
"10","014","00","011","1101","0186","94","73","21","3","97","210","0","46.19","34.76"
"10","014","00","011","1102","0000","444","346","98","28","472","1082","0","43.62","31.98"
"10","014","00","011","1102","0184","444","346","98","28","472","1082","0","43.62","31.98"
"10","014","00","011","1103","0000","563","448","115","35","598","1474","0","40.57","30.39"
"10","014","00","011","1103","0183","563","448","115","35","598","1474","0","40.57","30.39"
"10","014","00","012","0000","0000","1526","1102","424","206","1732","3278","4207","52.84","33.62"
"10","014","00","012","1201","0000","352","250","102","41","393","728","0","53.98","34.34"
"10","014","00","012","1201","0190","352","250","102","41","393","728","0","53.98","34.34"
"10","014","00","012","1202","0000","121","83","38","19","140","259","0","54.05","32.05"
"10","014","00","012","1202","0191","121","83","38","19","140","259","0","54.05","32.05"
"10","014","00","012","1203","0000","112","75","37","14","126","254","0","49.61","29.53"
"10","014","00","012","1203","0192","112","75","37","14","126","254","0","49.61","29.53"
"10","014","00","012","1204","0000","420","311","109","60","480","971","0","49.43","32.03"
"10","014","00","012","1204","0189","420","311","109","60","480","971","0","49.43","32.03"
"10","014","00","012","1205","0000","299","219","80","31","330","569","0","58.0","38.49"
"10","014","00","012","1205","0188","299","219","80","31","330","569","0","58.0","38.49"
"10","014","00","012","1206","0000","222","164","58","41","263","497","0","52.92","33.0"
"10","014","00","012","1206","0187","222","164","58","41","263","497","0","52.92","33.0"
"10","014","00","013","0000","0000","1325","979","346","186","1511","2930","3656","51.57","33.41"
"10","014","00","013","1301","0000","213","157","56","19","232","579","0","40.07","27.12"
"10","014","00","013","1301","0196","213","157","56","19","232","579","0","40.07","27.12"
"10","014","00","013","1302","0000","183","141","42","25","208","315","0","66.03","44.76"
"10","014","00","013","1302","0195","183","141","42","25","208","315","0","66.03","44.76"
"10","014","00","013","1303","0000","233","155","78","63","296","426","0","69.48","36.38"
"10","014","00","013","1303","0194","233","155","78","63","296","426","0","69.48","36.38"
"10","014","00","013","1304","0000","251","185","66","24","275","596","0","46.14","31.04"
"10","014","00","013","1304","0197","251","185","66","24","275","596","0","46.14","31.04"
"10","014","00","013","1305","0000","445","341","104","55","500","1014","0","49.31","33.63"
"10","014","00","013","1305","0193","445","341","104","55","500","1014","0","49.31","33.63"
"10","014","00","014","0000","0000","1407","1011","396","210","1617","3028","3748","53.4","33.39"
"10","014","00","014","1401","0000","342","256","86","51","393","520","0","75.58","49.23"
"10","014","00","014","1401","0200","342","256","86","51","393","520","0","75.58","49.23"
"10","014","00","014","1402","0000","307","225","82","38","345","601","0","57.4","37.44"
"10","014","00","014","1402","0199","307","225","82","38","345","601","0","57.4","37.44"
"10","014","00","014","1403","0000","475","339","136","62","537","1241","0","43.27","27.32"
"10","014","00","014","1403","0198","475","339","136","62","537","1241","0","43.27","27.32"
"10","014","00","014","1404","0000","163","109","54","26","189","336","0","56.25","32.44"
"10","014","00","014","1404","0201","163","109","54","26","189","336","0","56.25","32.44"
"10","014","00","014","1405","0000","120","82","38","33","153","330","0","46.36","24.85"
"10","014","00","014","1405","0202","120","82","38","33","153","330","0","46.36","24.85"
"10","014","00","015","0000","0000","1579","1191","388","186","1765","3137","3615","56.26","37.97"
"10","014","00","015","1501","0000","236","166","70","23","259","628","0","41.24","26.43"
"10","014","00","015","1501","0208","236","166","70","23","259","628","0","41.24","26.43"
"10","014","00","015","1502","0000","412","294","118","51","463","867","0","53.4","33.91"
"10","014","00","015","1502","0209","412","294","118","51","463","867","0","53.4","33.91"
"10","014","00","015","1503","0000","186","138","48","25","211","331","0","63.75","41.69"
"10","014","00","015","1503","0207","186","138","48","25","211","331","0","63.75","41.69"
"10","014","00","015","1504","0000","334","272","62","38","372","586","0","63.48","46.42"
"10","014","00","015","1504","0203","130","101","29","24","154","246","0","62.6","41.06"
"10","014","00","015","1504","0204","204","171","33","14","218","340","0","64.12","50.29"
"10","014","00","015","1505","0000","228","173","55","37","265","429","0","61.77","40.33"
"10","014","00","015","1505","0206","228","173","55","37","265","429","0","61.77","40.33"
"10","014","00","015","1506","0000","183","148","35","12","195","296","0","65.88","50.0"
"10","014","00","015","1506","0205","183","148","35","12","195","296","0","65.88","50.0"
"10","014","00","016","0000","0000","1415","972","443","128","1543","4181","5114","36.91","23.25"
"10","014","00","016","1601","0000","347","219","128","18","365","1240","0","29.44","17.66"
"10","014","00","016","1601","0212","347","219","128","18","365","1240","0","29.44","17.66"
"10","014","00","016","1602","0000","242","158","84","37","279","760","0","36.71","20.79"
"10","014","00","016","1602","0213","242","158","84","37","279","760","0","36.71","20.79"
"10","014","00","016","1603","0000","490","350","140","39","529","1238","0","42.73","28.27"
"10","014","00","016","1603","0211","490","350","140","39","529","1238","0","42.73","28.27"
"10","014","00","016","1604","0000","336","245","91","34","370","943","0","39.24","25.98"
"10","014","00","016","1604","0210","336","245","91","34","370","943","0","39.24","25.98"
"10","016","00","000","0000","0000","36539","28923","7616","3443","39982","90405","104400","44.23","31.99"
"10","016","00","001","0000","0000","23960","19190","4770","1889","25849","53655","62523","48.18","35.77"
"10","016","00","001","0102","0000","208","164","44","15","223","481","0","46.36","34.1"
"10","016","00","001","0102","0001","208","164","44","15","223","481","0","46.36","34.1"
"10","016","00","001","0103","0000","266","218","48","18","284","558","0","50.9","39.07"
"10","016","00","001","0103","0002","266","218","48","18","284","558","0","50.9","39.07"
"10","016","00","001","0104","0000","221","169","52","42","263","533","0","49.34","31.71"
"10","016","00","001","0104","0003","221","169","52","42","263","533","0","49.34","31.71"
"10","016","00","001","0105","0000","411","303","108","34","445","922","0","48.26","32.86"
"10","016","00","001","0105","0004","411","303","108","34","445","922","0","48.26","32.86"
"10","016","00","001","0106","0000","501","387","114","37","538","1021","0","52.69","37.9"
"10","016","00","001","0106","0005","501","387","114","37","538","1021","0","52.69","37.9"
"10","016","00","001","0107","0000","369","291","78","34","403","793","0","50.82","36.7"
"10","016","00","001","0107","0006","369","291","78","34","403","793","0","50.82","36.7"
"10","016","00","001","0108","0000","929","737","192","73","1002","1955","0","51.25","37.7"
"10","016","00","001","0108","0007","468","367","101","41","509","954","0","53.35","38.47"
"10","016","00","001","0108","0008","461","370","91","32","493","1001","0","49.25","36.96"
"10","016","00","001","0109","0000","1914","1558","356","120","2034","4130","0","49.25","37.72"
"10","016","00","001","0109","0010","609","486","123","46","655","1402","0","46.72","34.66"
"10","016","00","001","0109","0011","661","551","110","30","691","1389","0","49.75","39.67"
"10","016","00","001","0109","0012","644","521","123","44","688","1339","0","51.38","38.91"
"10","016","00","001","0110","0000","485","380","105","43","528","1192","0","44.3","31.88"
"10","016","00","001","0110","0009","485","380","105","43","528","1192","0","44.3","31.88"
"10","016","00","001","0111","0000","2396","1898","498","211","2607","5281","0","49.37","35.94"
"10","016","00","001","0111","0013","533","416","117","53","586","1254","0","46.73","33.17"
"10","016","00","001","0111","0014","546","443","103","53","599","1194","0","50.17","37.1"
"10","016","00","001","0111","0015","609","461","148","63","672","1393","0","48.24","33.09"
"10","016","00","001","0111","0016","708","578","130","42","750","1440","0","52.08","40.14"
"10","016","00","001","0112","0000","1120","906","214","104","1224","2499","0","48.98","36.25"
"10","016","00","001","0112","0017","540","420","120","53","593","1215","0","48.81","34.57"
"10","016","00","001","0112","0018","580","486","94","51","631","1284","0","49.14","37.85"
"10","016","00","001","0113","0000","684","542","142","67","751","1512","0","49.67","35.85"
"10","016","00","001","0113","0019","684","542","142","67","751","1512","0","49.67","35.85"
"10","016","00","001","0114","0000","2734","2121","613","166","2900","6044","0","47.98","35.09"
"10","016","00","001","0114","0020","507","397","110","60","567","1181","0","48.01","33.62"
"10","016","00","001","0114","0021","631","518","113","40","671","1348","0","49.78","38.43"
"10","016","00","001","0114","0022","688","550","138","27","715","1391","0","51.4","39.54"
"10","016","00","001","0114","0023","908","656","252","39","947","2124","0","44.59","30.89"
"10","016","00","001","0115","0000","1423","1176","247","92","1515","3082","0","49.16","38.16"
"10","016","00","001","0115","0024","683","553","130","58","741","1500","0","49.4","36.87"
"10","016","00","001","0115","0025","740","623","117","34","774","1582","0","48.93","39.38"
"10","016","00","001","0116","0000","1513","1218","295","89","1602","3192","0","50.19","38.16"
"10","016","00","001","0116","0026","752","607","145","40","792","1638","0","48.35","37.06"
"10","016","00","001","0116","0027","761","611","150","49","810","1554","0","52.12","39.32"
"10","016","00","001","0117","0000","761","634","127","60","821","1872","0","43.86","33.87"
"10","016","00","001","0117","0028","349","289","60","27","376","980","0","38.37","29.49"
"10","016","00","001","0117","0029","412","345","67","33","445","892","0","49.89","38.68"
"10","016","00","001","0118","0000","306","268","38","15","321","778","0","41.26","34.45"
"10","016","00","001","0118","0030","306","268","38","15","321","778","0","41.26","34.45"
"10","016","00","001","0119","0000","440","361","79","31","471","930","0","50.65","38.82"
"10","016","00","001","0119","0031","440","361","79","31","471","930","0","50.65","38.82"
"10","016","00","001","0120","0000","1384","1143","241","60","1444","2609","0","55.35","43.81"
"10","016","00","001","0120","0032","814","681","133","38","852","1481","0","57.53","45.98"
"10","016","00","001","0120","0033","570","462","108","22","592","1128","0","52.48","40.96"
"10","016","00","001","0121","0000","188","150","38","28","216","415","0","52.05","36.14"
"10","016","00","001","0121","0034","188","150","38","28","216","415","0","52.05","36.14"
"10","016","00","001","0122","0000","997","849","148","74","1071","2070","0","51.74","41.01"
"10","016","00","001","0122","0035","515","438","77","42","557","1120","0","49.73","39.11"
"10","016","00","001","0122","0036","482","411","71","32","514","950","0","54.11","43.26"
"10","016","00","001","0123","0000","256","207","49","24","280","627","0","44.66","33.01"
"10","016","00","001","0123","0037","256","207","49","24","280","627","0","44.66","33.01"
"10","016","00","001","0124","0000","474","385","89","40","514","989","0","51.97","38.93"
"10","016","00","001","0124","0039","474","385","89","40","514","989","0","51.97","38.93"
"10","016","00","001","0125","0000","491","409","82","21","512","1055","0","48.53","38.77"
"10","016","00","001","0125","0038","491","409","82","21","512","1055","0","48.53","38.77"
"10","016","00","001","0126","0000","296","235","61","33","329","591","0","55.67","39.76"
"10","016","00","001","0126","0040","296","235","61","33","329","591","0","55.67","39.76"
"10","016","00","001","0127","0000","713","576","137","64","777","1700","0","45.71","33.88"
"10","016","00","001","0127","0043","354","289","65","43","397","797","0","49.81","36.26"
"10","016","00","001","0127","0044","359","287","72","21","380","903","0","42.08","31.78"
"10","016","00","001","0128","0000","995","760","235","127","1122","2466","0","45.5","30.82"
"10","016","00","001","0128","0041","586","453","133","71","657","1387","0","47.37","32.66"
"10","016","00","001","0128","0042","409","307","102","56","465","1079","0","43.1","28.45"
"10","016","00","001","0129","0000","151","118","33","23","174","376","0","46.28","31.38"
"10","016","00","001","0129","0045","151","118","33","23","174","376","0","46.28","31.38"
"10","016","00","001","0130","0000","177","130","47","17","194","371","0","52.29","35.04"
"10","016","00","001","0130","0046","177","130","47","17","194","371","0","52.29","35.04"
"10","016","00","001","0131","0000","423","340","83","18","441","1173","0","37.6","28.99"
"10","016","00","001","0131","0047","423","340","83","18","441","1173","0","37.6","28.99"
"10","016","00","001","0132","0000","425","335","90","29","454","1389","0","32.69","24.12"
"10","016","00","001","0132","0048","425","335","90","29","454","1389","0","32.69","24.12"
"10","016","00","001","0133","0000","154","108","46","59","213","761","0","27.99","14.19"
"10","016","00","001","0133","0049","154","108","46","59","213","761","0","27.99","14.19"
"10","016","00","001","0134","0000","155","114","41","21","176","288","0","61.11","39.58"
"10","016","00","001","0134","0050","155","114","41","21","176","288","0","61.11","39.58"
"10","016","00","002","0000","0000","4883","3895","988","469","5352","12741","14533","42.01","30.57"
"10","016","00","002","0201","0000","511","430","81","61","572","1120","0","51.07","38.39"
"10","016","00","002","0201","0051","511","430","81","61","572","1120","0","51.07","38.39"
"10","016","00","002","0202","0000","127","101","26","13","140","332","0","42.17","30.42"
"10","016","00","002","0202","0052","127","101","26","13","140","332","0","42.17","30.42"
"10","016","00","002","0203","0000","85","64","21","2","87","242","0","35.95","26.45"
"10","016","00","002","0203","0053","85","64","21","2","87","242","0","35.95","26.45"
"10","016","00","002","0204","0000","90","67","23","9","99","293","0","33.79","22.87"
"10","016","00","002","0204","0054","90","67","23","9","99","293","0","33.79","22.87"
"10","016","00","002","0205","0000","225","172","53","48","273","666","0","40.99","25.83"
"10","016","00","002","0205","0055","225","172","53","48","273","666","0","40.99","25.83"
"10","016","00","002","0206","0000","143","118","25","19","162","326","0","49.69","36.2"
"10","016","00","002","0206","0056","143","118","25","19","162","326","0","49.69","36.2"
"10","016","00","002","0207","0000","250","199","51","17","267","732","0","36.48","27.19"
"10","016","00","002","0207","0057","250","199","51","17","267","732","0","36.48","27.19"
"10","016","00","002","0208","0000","273","234","39","24","297","651","0","45.62","35.94"
"10","016","00","002","0208","0058","273","234","39","24","297","651","0","45.62","35.94"
"10","016","00","002","0209","0000","297","237","60","12","309","744","0","41.53","31.85"
"10","016","00","002","0209","0059","297","237","60","12","309","744","0","41.53","31.85"
"10","016","00","002","0210","0000","71","56","15","3","74","134","0","55.22","41.79"
"10","016","00","002","0210","0060","71","56","15","3","74","134","0","55.22","41.79"
"10","016","00","002","0211","0000","76","65","11","2","78","216","0","36.11","30.09"
"10","016","00","002","0211","0062","76","65","11","2","78","216","0","36.11","30.09"
"10","016","00","002","0212","0000","125","99","26","5","130","279","0","46.59","35.48"
"10","016","00","002","0212","0064","125","99","26","5","130","279","0","46.59","35.48"
"10","016","00","002","0213","0000","184","143","41","9","193","664","0","29.07","21.54"
"10","016","00","002","0213","0063","184","143","41","9","193","664","0","29.07","21.54"
"10","016","00","002","0214","0000","138","113","25","7","145","296","0","48.99","38.18"
"10","016","00","002","0214","0065","138","113","25","7","145","296","0","48.99","38.18"
"10","016","00","002","0215","0000","237","188","49","22","259","794","0","32.62","23.68"
"10","016","00","002","0215","0061","237","188","49","22","259","794","0","32.62","23.68"
"10","016","00","002","0216","0000","112","96","16","6","118","257","0","45.91","37.35"
"10","016","00","002","0216","0066","112","96","16","6","118","257","0","45.91","37.35"
"10","016","00","002","0217","0000","26","22","4","1","27","89","0","30.34","24.72"
"10","016","00","002","0217","0067","26","22","4","1","27","89","0","30.34","24.72"
"10","016","00","002","0218","0000","354","265","89","29","383","815","0","46.99","32.52"
"10","016","00","002","0218","0068","354","265","89","29","383","815","0","46.99","32.52"
"10","016","00","002","0219","0000","357","287","70","21","378","975","0","38.77","29.44"
"10","016","00","002","0219","0069","357","287","70","21","378","975","0","38.77","29.44"
"10","016","00","002","0220","0000","273","222","51","42","315","648","0","48.61","34.26"
"10","016","00","002","0220","0070","273","222","51","42","315","648","0","48.61","34.26"
"10","016","00","002","0221","0000","696","549","147","99","795","1739","0","45.72","31.57"
"10","016","00","002","0221","0071","334","266","68","23","357","893","0","39.98","29.79"
"10","016","00","002","0221","0072","362","283","79","76","438","846","0","51.77","33.45"
"10","016","00","002","0222","0000","233","168","65","18","251","729","0","34.43","23.05"
"10","016","00","002","0222","0073","233","168","65","18","251","729","0","34.43","23.05"
"10","016","00","003","0000","0000","3228","2487","741","372","3600","8625","9856","41.74","28.83"
"10","016","00","003","0301","0000","237","167","70","18","255","514","0","49.61","32.49"
"10","016","00","003","0301","0074","237","167","70","18","255","514","0","49.61","32.49"
"10","016","00","003","0302","0000","315","235","80","18","333","657","0","50.68","35.77"
"10","016","00","003","0302","0075","315","235","80","18","333","657","0","50.68","35.77"
"10","016","00","003","0303","0000","67","56","11","5","72","109","0","66.06","51.38"
"10","016","00","003","0303","0076","67","56","11","5","72","109","0","66.06","51.38"
"10","016","00","003","0304","0000","61","54","7","4","65","156","0","41.67","34.62"
"10","016","00","003","0304","0077","61","54","7","4","65","156","0","41.67","34.62"
"10","016","00","003","0305","0000","114","84","30","6","120","293","0","40.96","28.67"
"10","016","00","003","0305","0078","114","84","30","6","120","293","0","40.96","28.67"
"10","016","00","003","0306","0000","69","58","11","2","71","231","0","30.74","25.11"
"10","016","00","003","0306","0079","69","58","11","2","71","231","0","30.74","25.11"
"10","016","00","003","0307","0000","78","58","20","9","87","161","0","54.04","36.02"
"10","016","00","003","0307","0080","78","58","20","9","87","161","0","54.04","36.02"
"10","016","00","003","0308","0000","723","581","142","60","783","1705","0","45.92","34.08"
"10","016","00","003","0308","0081","723","581","142","60","783","1705","0","45.92","34.08"
"10","016","00","003","0309","0000","113","90","23","8","121","285","0","42.46","31.58"
"10","016","00","003","0309","0082","113","90","23","8","121","285","0","42.46","31.58"
"10","016","00","003","0310","0000","199","142","57","11","210","723","0","29.05","19.64"
"10","016","00","003","0310","0083","199","142","57","11","210","723","0","29.05","19.64"
"10","016","00","003","0311","0000","256","197","59","29","285","774","0","36.82","25.45"
"10","016","00","003","0311","0084","256","197","59","29","285","774","0","36.82","25.45"
"10","016","00","003","0312","0000","378","260","118","108","486","1429","0","34.01","18.19"
"10","016","00","003","0312","0085","378","260","118","108","486","1429","0","34.01","18.19"
"10","016","00","003","0313","0000","426","354","72","73","499","1084","0","46.03","32.66"
"10","016","00","003","0313","0086","426","354","72","73","499","1084","0","46.03","32.66"
"10","016","00","003","0314","0000","120","99","21","5","125","251","0","49.8","39.44"
"10","016","00","003","0314","0087","120","99","21","5","125","251","0","49.8","39.44"
"10","016","00","003","0315","0000","72","52","20","16","88","253","0","34.78","20.55"
"10","016","00","003","0315","0088","72","52","20","16","88","253","0","34.78","20.55"
"10","016","00","004","0000","0000","2067","1545","522","362","2429","7382","8396","32.9","20.93"
"10","016","00","004","0401","0000","41","28","13","1","42","283","0","14.84","9.89"
"10","016","00","004","0401","0089","41","28","13","1","42","283","0","14.84","9.89"
"10","016","00","004","0402","0000","108","84","24","14","122","424","0","28.77","19.81"
"10","016","00","004","0402","0090","108","84","24","14","122","424","0","28.77","19.81"
"10","016","00","004","0403","0000","95","63","32","10","105","282","0","37.23","22.34"
"10","016","00","004","0403","0092","95","63","32","10","105","282","0","37.23","22.34"
"10","016","00","004","0404","0000","236","181","55","48","284","826","0","34.38","21.91"
"10","016","00","004","0404","0091","236","181","55","48","284","826","0","34.38","21.91"
"10","016","00","004","0405","0000","195","136","59","55","250","661","0","37.82","20.57"
"10","016","00","004","0405","0093","195","136","59","55","250","661","0","37.82","20.57"
"10","016","00","004","0406","0000","23","16","7","4","27","141","0","19.15","11.35"
"10","016","00","004","0406","0094","23","16","7","4","27","141","0","19.15","11.35"
"10","016","00","004","0407","0000","164","132","32","12","176","635","0","27.72","20.79"
"10","016","00","004","0407","0095","164","132","32","12","176","635","0","27.72","20.79"
"10","016","00","004","0408","0000","62","49","13","4","66","216","0","30.56","22.69"
"10","016","00","004","0408","0096","62","49","13","4","66","216","0","30.56","22.69"
"10","016","00","004","0409","0000","106","84","22","26","132","572","0","23.08","14.69"
"10","016","00","004","0409","0097","106","84","22","26","132","572","0","23.08","14.69"
"10","016","00","004","0410","0000","409","316","93","90","499","1267","0","39.38","24.94"
"10","016","00","004","0410","0098","409","316","93","90","499","1267","0","39.38","24.94"
"10","016","00","004","0411","0000","628","456","172","98","726","2075","0","34.99","21.98"
"10","016","00","004","0411","0099","274","201","73","24","298","942","0","31.63","21.34"
"10","016","00","004","0411","0100","354","255","99","74","428","1133","0","37.78","22.51"
"10","016","00","005","0000","0000","1526","1146","380","233","1759","4628","5237","38.01","24.76"
"10","016","00","005","0501","0000","288","226","62","39","327","734","0","44.55","30.79"
"10","016","00","005","0501","0101","288","226","62","39","327","734","0","44.55","30.79"
"10","016","00","005","0502","0000","159","131","28","31","190","454","0","41.85","28.85"
"10","016","00","005","0502","0102","159","131","28","31","190","454","0","41.85","28.85"
"10","016","00","005","0503","0000","77","58","19","15","92","300","0","30.67","19.33"
"10","016","00","005","0503","0103","77","58","19","15","92","300","0","30.67","19.33"
"10","016","00","005","0504","0000","197","135","62","41","238","471","0","50.53","28.66"
"10","016","00","005","0504","0104","197","135","62","41","238","471","0","50.53","28.66"
"10","016","00","005","0505","0000","428","310","118","73","501","1414","0","35.43","21.92"
"10","016","00","005","0505","0105","182","147","35","21","203","672","0","30.21","21.88"
"10","016","00","005","0505","0106","246","163","83","52","298","742","0","40.16","21.97"
"10","016","00","005","0506","0000","163","129","34","7","170","476","0","35.71","27.1"
"10","016","00","005","0506","0108","163","129","34","7","170","476","0","35.71","27.1"
"10","016","00","005","0507","0000","37","26","11","5","42","208","0","20.19","12.5"
"10","016","00","005","0507","0109","37","26","11","5","42","208","0","20.19","12.5"
"10","016","00","005","0508","0000","92","64","28","16","108","264","0","40.91","24.24"
"10","016","00","005","0508","0107","92","64","28","16","108","264","0","40.91","24.24"
"10","016","00","005","0509","0000","85","67","18","6","91","307","0","29.64","21.82"
"10","016","00","005","0509","0110","85","67","18","6","91","307","0","29.64","21.82"
"10","016","00","006","0000","0000","875","660","215","118","993","3374","3855","29.43","19.56"
"10","016","00","006","0601","0000","61","45","16","5","66","248","0","26.61","18.15"
"10","016","00","006","0601","0111","61","45","16","5","66","248","0","26.61","18.15"
"10","016","00","006","0602","0000","172","122","50","32","204","581","0","35.11","21.0"
"10","016","00","006","0602","0112","172","122","50","32","204","581","0","35.11","21.0"
"10","016","00","006","0603","0000","189","139","50","35","224","641","0","34.95","21.68"
"10","016","00","006","0603","0113","189","139","50","35","224","641","0","34.95","21.68"
"10","016","00","006","0604","0000","107","87","20","5","112","382","0","29.32","22.77"
"10","016","00","006","0604","0114","107","87","20","5","112","382","0","29.32","22.77"
"10","016","00","006","0605","0000","66","51","15","6","72","351","0","20.51","14.53"
"10","016","00","006","0605","0115","66","51","15","6","72","351","0","20.51","14.53"
"10","016","00","006","0606","0000","280","216","64","35","315","1171","0","26.9","18.45"
"10","016","00","006","0606","0116","280","216","64","35","315","1171","0","26.9","18.45"
"10","017","00","000","0000","0000","153139","119425","33714","9960","163099","320030","370269","50.96","37.32"
"10","017","00","001","0000","0000","19675","15237","4438","1514","21189","45545","51716","46.52","33.45"
"10","017","00","001","0101","0000","413","313","100","26","439","709","0","61.92","44.15"
"10","017","00","001","0101","0035","413","313","100","26","439","709","0","61.92","44.15"
"10","017","00","001","0102","0000","575","438","137","59","634","1219","0","52.01","35.93"
"10","017","00","001","0102","0033","575","438","137","59","634","1219","0","52.01","35.93"
"10","017","00","001","0103","0000","403","293","110","27","430","904","0","47.57","32.41"
"10","017","00","001","0103","0034","403","293","110","27","430","904","0","47.57","32.41"
"10","017","00","001","0104","0000","477","354","123","62","539","1037","0","51.98","34.14"
"10","017","00","001","0104","0032","477","354","123","62","539","1037","0","51.98","34.14"
"10","017","00","001","0105","0000","633","485","148","45","678","1210","0","56.03","40.08"
"10","017","00","001","0105","0031","633","485","148","45","678","1210","0","56.03","40.08"
"10","017","00","001","0106","0000","550","406","144","66","616","1175","0","52.43","34.55"
"10","017","00","001","0106","0030","550","406","144","66","616","1175","0","52.43","34.55"
"10","017","00","001","0107","0000","566","451","115","50","616","1267","0","48.62","35.6"
"10","017","00","001","0107","0029","566","451","115","50","616","1267","0","48.62","35.6"
"10","017","00","001","0108","0000","382","284","98","46","428","802","0","53.37","35.41"
"10","017","00","001","0108","0028","382","284","98","46","428","802","0","53.37","35.41"
"10","017","00","001","0109","0000","594","471","123","61","655","1594","0","41.09","29.55"
"10","017","00","001","0109","0027","594","471","123","61","655","1594","0","41.09","29.55"
"10","017","00","001","0110","0000","1061","840","221","74","1135","2316","0","49.01","36.27"
"10","017","00","001","0110","0025","427","330","97","43","470","859","0","54.71","38.42"
"10","017","00","001","0110","0026","634","510","124","31","665","1457","0","45.64","35.0"
"10","017","00","001","0111","0000","672","517","155","65","737","1341","0","54.96","38.55"
"10","017","00","001","0111","0024","672","517","155","65","737","1341","0","54.96","38.55"
"10","017","00","001","0112","0000","893","698","195","90","983","2000","0","49.15","34.9"
"10","017","00","001","0112","0022","525","407","118","48","573","1138","0","50.35","35.76"
"10","017","00","001","0112","0023","368","291","77","42","410","862","0","47.56","33.76"
"10","017","00","001","0113","0000","956","742","214","52","1008","1960","0","51.43","37.86"
"10","017","00","001","0113","0020","528","421","107","33","561","1090","0","51.47","38.62"
"10","017","00","001","0113","0021","428","321","107","19","447","870","0","51.38","36.9"
"10","017","00","001","0114","0000","600","470","130","32","632","1270","0","49.76","37.01"
"10","017","00","001","0114","0019","600","470","130","32","632","1270","0","49.76","37.01"
"10","017","00","001","0115","0000","478","393","85","30","508","1166","0","43.57","33.7"
"10","017","00","001","0115","0016","478","393","85","30","508","1166","0","43.57","33.7"
"10","017","00","001","0116","0000","782","556","226","85","867","1753","0","49.46","31.72"
"10","017","00","001","0116","0014","782","556","226","85","867","1753","0","49.46","31.72"
"10","017","00","001","0117","0000","405","296","109","37","442","984","0","44.92","30.08"
"10","017","00","001","0117","0015","405","296","109","37","442","984","0","44.92","30.08"
"10","017","00","001","0118","0000","519","394","125","68","587","1261","0","46.55","31.25"
"10","017","00","001","0118","0013","519","394","125","68","587","1261","0","46.55","31.25"
"10","017","00","001","0119","0000","580","428","152","56","636","1474","0","43.15","29.04"
"10","017","00","001","0119","0005","580","428","152","56","636","1474","0","43.15","29.04"
"10","017","00","001","0120","0000","490","398","92","60","550","1271","0","43.27","31.31"
"10","017","00","001","0120","0006","490","398","92","60","550","1271","0","43.27","31.31"
"10","017","00","001","0121","0000","227","181","46","21","248","466","0","53.22","38.84"
"10","017","00","001","0121","0001","227","181","46","21","248","466","0","53.22","38.84"
"10","017","00","001","0122","0000","2035","1576","459","100","2135","5256","0","40.62","29.98"
"10","017","00","001","0122","0002","500","386","114","26","526","1262","0","41.68","30.59"
"10","017","00","001","0122","0003","502","344","158","52","554","1171","0","47.31","29.38"
"10","017","00","001","0122","0004","1033","846","187","22","1055","2823","0","37.37","29.97"
"10","017","00","001","0123","0000","583","461","122","30","613","1694","0","36.19","27.21"
"10","017","00","001","0123","0018","583","461","122","30","613","1694","0","36.19","27.21"
"10","017","00","001","0124","0000","436","339","97","33","469","973","0","48.2","34.84"
"10","017","00","001","0124","0017","436","339","97","33","469","973","0","48.2","34.84"
"10","017","00","001","0125","0000","2342","1849","493","83","2425","5430","0","44.66","34.05"
"10","017","00","001","0125","0010","626","484","142","17","643","1352","0","47.56","35.8"
"10","017","00","001","0125","0011","619","496","123","19","638","1413","0","45.15","35.1"
"10","017","00","001","0125","0012","1097","869","228","47","1144","2665","0","42.93","32.61"
"10","017","00","001","0126","0000","2023","1604","419","156","2179","5013","0","43.47","32.0"
"10","017","00","001","0126","0007","1085","831","254","75","1160","2707","0","42.85","30.7"
"10","017","00","001","0126","0008","685","564","121","65","750","1545","0","48.54","36.5"
"10","017","00","001","0126","0009","253","209","44","16","269","761","0","35.35","27.46"
"10","017","00","002","0000","0000","22635","17292","5343","1570","24205","46256","53819","52.33","37.38"
"10","017","00","002","0201","0000","1884","1436","448","148","2032","3754","0","54.13","38.25"
"10","017","00","002","0201","0219","641","487","154","64","705","1258","0","56.04","38.71"
"10","017","00","002","0201","0220","634","477","157","52","686","1237","0","55.46","38.56"
"10","017","00","002","0201","0221","609","472","137","32","641","1259","0","50.91","37.49"
"10","017","00","002","0202","0000","1094","852","242","98","1192","2464","0","48.38","34.58"
"10","017","00","002","0202","0222","504","384","120","52","556","1120","0","49.64","34.29"
"10","017","00","002","0202","0223","590","468","122","46","636","1344","0","47.32","34.82"
"10","017","00","002","0203","0000","1871","1355","516","127","1998","3568","0","56.0","37.98"
"10","017","00","002","0203","0226","904","718","186","64","968","1735","0","55.79","41.38"
"10","017","00","002","0203","0227","967","637","330","63","1030","1833","0","56.19","34.75"
"10","017","00","002","0204","0000","985","756","229","74","1059","1900","0","55.74","39.79"
"10","017","00","002","0204","0228","462","345","117","25","487","938","0","51.92","36.78"
"10","017","00","002","0204","0229","523","411","112","49","572","962","0","59.46","42.72"
"10","017","00","002","0205","0000","1155","879","276","80","1235","2190","0","56.39","40.14"
"10","017","00","002","0205","0230","638","480","158","35","673","1191","0","56.51","40.3"
"10","017","00","002","0205","0231","517","399","118","45","562","999","0","56.26","39.94"
"10","017","00","002","0206","0000","721","548","173","52","773","1525","0","50.69","35.93"
"10","017","00","002","0206","0232","129","105","24","8","137","282","0","48.58","37.23"
"10","017","00","002","0206","0233","592","443","149","44","636","1243","0","51.17","35.64"
"10","017","00","002","0207","0000","515","391","124","47","562","1092","0","51.47","35.81"
"10","017","00","002","0207","0234","515","391","124","47","562","1092","0","51.47","35.81"
"10","017","00","002","0208","0000","1076","834","242","47","1123","2260","0","49.69","36.9"
"10","017","00","002","0208","0238","434","341","93","18","452","975","0","46.36","34.97"
"10","017","00","002","0208","0239","642","493","149","29","671","1285","0","52.22","38.37"
"10","017","00","002","0209","0000","2097","1580","517","141","2238","4286","0","52.22","36.86"
"10","017","00","002","0209","0235","609","456","153","59","668","1246","0","53.61","36.6"
"10","017","00","002","0209","0236","842","636","206","44","886","1722","0","51.45","36.93"
"10","017","00","002","0209","0237","646","488","158","38","684","1318","0","51.9","37.03"
"10","017","00","002","0210","0000","1708","1310","398","131","1839","3463","0","53.1","37.83"
"10","017","00","002","0210","0244","873","655","218","71","944","1774","0","53.21","36.92"
"10","017","00","002","0210","0245","835","655","180","60","895","1689","0","52.99","38.78"
"10","017","00","002","0211","0000","909","697","212","75","984","2066","0","47.63","33.74"
"10","017","00","002","0211","0240","471","364","107","46","517","1077","0","48.0","33.8"
"10","017","00","002","0211","0241","438","333","105","29","467","989","0","47.22","33.67"
"10","017","00","002","0212","0000","211","156","55","7","218","428","0","50.93","36.45"
"10","017","00","002","0212","0253","211","156","55","7","218","428","0","50.93","36.45"
"10","017","00","002","0213","0000","166","114","52","30","196","326","0","60.12","34.97"
"10","017","00","002","0213","0254","166","114","52","30","196","326","0","60.12","34.97"
"10","017","00","002","0214","0000","225","176","49","23","248","351","0","70.66","50.14"
"10","017","00","002","0214","0255","225","176","49","23","248","351","0","70.66","50.14"
"10","017","00","002","0215","0000","841","676","165","32","873","1871","0","46.66","36.13"
"10","017","00","002","0215","0256","841","676","165","32","873","1871","0","46.66","36.13"
"10","017","00","002","0216","0000","194","142","52","5","199","448","0","44.42","31.7"
"10","017","00","002","0216","0257","194","142","52","5","199","448","0","44.42","31.7"
"10","017","00","002","0217","0000","1004","773","231","76","1080","1936","0","55.79","39.93"
"10","017","00","002","0217","0224","569","449","120","47","616","1011","0","60.93","44.41"
"10","017","00","002","0217","0225","435","324","111","29","464","925","0","50.16","35.03"
"10","017","00","002","0218","0000","2834","2216","618","160","2994","6059","0","49.41","36.57"
"10","017","00","002","0218","0246","630","510","120","60","690","1355","0","50.92","37.64"
"10","017","00","002","0218","0247","705","518","187","56","761","1512","0","50.33","34.26"
"10","017","00","002","0218","0248","679","526","153","20","699","1486","0","47.04","35.4"
"10","017","00","002","0218","0249","820","662","158","24","844","1706","0","49.47","38.8"
"10","017","00","002","0219","0000","1977","1514","463","126","2103","3803","0","55.3","39.81"
"10","017","00","002","0219","0250","690","531","159","56","746","1384","0","53.9","38.37"
"10","017","00","002","0219","0251","587","437","150","39","626","1045","0","59.9","41.82"
"10","017","00","002","0219","0252","700","546","154","31","731","1374","0","53.2","39.74"
"10","017","00","002","0220","0000","1168","887","281","91","1259","2466","0","51.05","35.97"
"10","017","00","002","0220","0242","553","423","130","42","595","1193","0","49.87","35.46"
"10","017","00","002","0220","0243","615","464","151","49","664","1273","0","52.16","36.45"
"10","017","00","003","0000","0000","16311","12776","3535","832","17143","33225","38606","51.6","38.45"
"10","017","00","003","0301","0000","655","495","160","45","700","1431","0","48.92","34.59"
"10","017","00","003","0301","0191","655","495","160","45","700","1431","0","48.92","34.59"
"10","017","00","003","0302","0000","333","245","88","20","353","637","0","55.42","38.46"
"10","017","00","003","0302","0193","333","245","88","20","353","637","0","55.42","38.46"
"10","017","00","003","0303","0000","397","303","94","25","422","735","0","57.41","41.22"
"10","017","00","003","0303","0194","397","303","94","25","422","735","0","57.41","41.22"
"10","017","00","003","0304","0000","1710","1340","370","101","1811","3641","0","49.74","36.8"
"10","017","00","003","0304","0195","481","380","101","26","507","1078","0","47.03","35.25"
"10","017","00","003","0304","0196","597","447","150","38","635","1238","0","51.29","36.11"
"10","017","00","003","0304","0197","632","513","119","37","669","1325","0","50.49","38.72"
"10","017","00","003","0305","0000","1354","1063","291","78","1432","2626","0","54.53","40.48"
"10","017","00","003","0305","0206","678","529","149","39","717","1267","0","56.59","41.75"
"10","017","00","003","0305","0207","676","534","142","39","715","1359","0","52.61","39.29"
"10","017","00","003","0306","0000","1473","1198","275","67","1540","2916","0","52.81","41.08"
"10","017","00","003","0306","0208","537","442","95","21","558","970","0","57.53","45.57"
"10","017","00","003","0306","0209","490","416","74","23","513","1002","0","51.2","41.52"
"10","017","00","003","0306","0210","446","340","106","23","469","944","0","49.68","36.02"
"10","017","00","003","0307","0000","1238","972","266","66","1304","2553","0","51.08","38.07"
"10","017","00","003","0307","0200","606","474","132","40","646","1110","0","58.2","42.7"
"10","017","00","003","0307","0201","632","498","134","26","658","1443","0","45.6","34.51"
"10","017","00","003","0308","0000","1228","966","262","67","1295","2654","0","48.79","36.4"
"10","017","00","003","0308","0198","731","581","150","39","770","1475","0","52.2","39.39"
"10","017","00","003","0308","0199","497","385","112","28","525","1179","0","44.53","32.65"
"10","017","00","003","0309","0000","198","146","52","25","223","415","0","53.73","35.18"
"10","017","00","003","0309","0202","198","146","52","25","223","415","0","53.73","35.18"
"10","017","00","003","0310","0000","2285","1791","494","101","2386","4551","0","52.43","39.35"
"10","017","00","003","0310","0203","630","501","129","22","652","1378","0","47.31","36.36"
"10","017","00","003","0310","0204","786","601","185","21","807","1570","0","51.4","38.28"
"10","017","00","003","0310","0205","869","689","180","58","927","1603","0","57.83","42.98"
"10","017","00","003","0311","0000","195","158","37","7","202","456","0","44.3","34.65"
"10","017","00","003","0311","0192","195","158","37","7","202","456","0","44.3","34.65"
"10","017","00","003","0312","0000","2522","1966","556","113","2635","4893","0","53.85","40.18"
"10","017","00","003","0312","0215","688","538","150","33","721","1328","0","54.29","40.51"
"10","017","00","003","0312","0216","561","418","143","27","588","1173","0","50.13","35.64"
"10","017","00","003","0312","0217","564","455","109","35","599","1019","0","58.78","44.65"
"10","017","00","003","0312","0218","709","555","154","18","727","1373","0","52.95","40.42"
"10","017","00","003","0313","0000","2723","2133","590","117","2840","5717","0","49.68","37.31"
"10","017","00","003","0313","0211","798","615","183","42","840","1500","0","56.0","41.0"
"10","017","00","003","0313","0212","549","426","123","28","577","1442","0","40.01","29.54"
"10","017","00","003","0313","0213","600","484","116","23","623","1165","0","53.48","41.55"
"10","017","00","003","0313","0214","776","608","168","24","800","1610","0","49.69","37.76"
"10","017","00","004","0000","0000","17957","13796","4161","1543","19500","36738","43950","53.08","37.55"
"10","017","00","004","0401","0000","728","556","172","94","822","1782","0","46.13","31.2"
"10","017","00","004","0401","0072","728","556","172","94","822","1782","0","46.13","31.2"
"10","017","00","004","0402","0000","544","428","116","49","593","1055","0","56.21","40.57"
"10","017","00","004","0402","0073","544","428","116","49","593","1055","0","56.21","40.57"
"10","017","00","004","0403","0000","668","515","153","43","711","1558","0","45.64","33.06"
"10","017","00","004","0403","0074","668","515","153","43","711","1558","0","45.64","33.06"
"10","017","00","004","0404","0000","845","674","171","46","891","1736","0","51.32","38.82"
"10","017","00","004","0404","0075","845","674","171","46","891","1736","0","51.32","38.82"
"10","017","00","004","0405","0000","1271","966","305","85","1356","2352","0","57.65","41.07"
"10","017","00","004","0405","0076","685","519","166","48","733","1243","0","58.97","41.75"
"10","017","00","004","0405","0077","586","447","139","37","623","1109","0","56.18","40.31"
"10","017","00","004","0406","0000","922","768","154","48","970","1684","0","57.6","45.61"
"10","017","00","004","0406","0078","922","768","154","48","970","1684","0","57.6","45.61"
"10","017","00","004","0407","0000","461","354","107","40","501","919","0","54.52","38.52"
"10","017","00","004","0407","0079","461","354","107","40","501","919","0","54.52","38.52"
"10","017","00","004","0408","0000","490","359","131","22","512","991","0","51.66","36.23"
"10","017","00","004","0408","0080","490","359","131","22","512","991","0","51.66","36.23"
"10","017","00","004","0409","0000","442","355","87","22","464","876","0","52.97","40.53"
"10","017","00","004","0409","0081","442","355","87","22","464","876","0","52.97","40.53"
"10","017","00","004","0410","0000","797","627","170","70","867","1480","0","58.58","42.36"
"10","017","00","004","0410","0082","561","442","119","43","604","1046","0","57.74","42.26"
"10","017","00","004","0410","0083","236","185","51","27","263","434","0","60.6","42.63"
"10","017","00","004","0411","0000","397","306","91","48","445","764","0","58.25","40.05"
"10","017","00","004","0411","0084","397","306","91","48","445","764","0","58.25","40.05"
"10","017","00","004","0412","0000","470","341","129","26","496","968","0","51.24","35.23"
"10","017","00","004","0412","0085","470","341","129","26","496","968","0","51.24","35.23"
"10","017","00","004","0413","0000","1094","812","282","103","1197","2641","0","45.32","30.75"
"10","017","00","004","0413","0086","591","433","158","62","653","1326","0","49.25","32.65"
"10","017","00","004","0413","0087","503","379","124","41","544","1315","0","41.37","28.82"
"10","017","00","004","0414","0000","396","297","99","50","446","775","0","57.55","38.32"
"10","017","00","004","0414","0088","396","297","99","50","446","775","0","57.55","38.32"
"10","017","00","004","0415","0000","673","491","182","79","752","1326","0","56.71","37.03"
"10","017","00","004","0415","0089","330","226","104","45","375","652","0","57.52","34.66"
"10","017","00","004","0415","0090","343","265","78","34","377","674","0","55.93","39.32"
"10","017","00","004","0416","0000","374","283","91","36","410","789","0","51.96","35.87"
"10","017","00","004","0416","0091","374","283","91","36","410","789","0","51.96","35.87"
"10","017","00","004","0417","0000","838","665","173","66","904","1715","0","52.71","38.78"
"10","017","00","004","0417","0092","838","665","173","66","904","1715","0","52.71","38.78"
"10","017","00","004","0418","0000","401","304","97","50","451","849","0","53.12","35.81"
"10","017","00","004","0418","0093","401","304","97","50","451","849","0","53.12","35.81"
"10","017","00","004","0419","0000","440","353","87","29","469","875","0","53.6","40.34"
"10","017","00","004","0419","0094","440","353","87","29","469","875","0","53.6","40.34"
"10","017","00","004","0420","0000","395","310","85","38","433","851","0","50.88","36.43"
"10","017","00","004","0420","0095","395","310","85","38","433","851","0","50.88","36.43"
"10","017","00","004","0421","0000","397","307","90","29","426","735","0","57.96","41.77"
"10","017","00","004","0421","0096","397","307","90","29","426","735","0","57.96","41.77"
"10","017","00","004","0422","0000","466","347","119","69","535","1009","0","53.02","34.39"
"10","017","00","004","0422","0097","466","347","119","69","535","1009","0","53.02","34.39"
"10","017","00","004","0423","0000","479","350","129","49","528","1082","0","48.8","32.35"
"10","017","00","004","0423","0098","479","350","129","49","528","1082","0","48.8","32.35"
"10","017","00","004","0424","0000","1419","1119","300","111","1530","2797","0","54.7","40.01"
"10","017","00","004","0424","0099","595","438","157","66","661","1278","0","51.72","34.27"
"10","017","00","004","0424","0100","824","681","143","45","869","1519","0","57.21","44.83"
"10","017","00","004","0425","0000","337","259","78","44","381","708","0","53.81","36.58"
"10","017","00","004","0425","0103","337","259","78","44","381","708","0","53.81","36.58"
"10","017","00","004","0426","0000","332","242","90","23","355","567","0","62.61","42.68"
"10","017","00","004","0426","0104","332","242","90","23","355","567","0","62.61","42.68"
"10","017","00","004","0427","0000","363","270","93","53","416","751","0","55.39","35.95"
"10","017","00","004","0427","0105","363","270","93","53","416","751","0","55.39","35.95"
"10","017","00","004","0428","0000","330","240","90","23","353","589","0","59.93","40.75"
"10","017","00","004","0428","0106","330","240","90","23","353","589","0","59.93","40.75"
"10","017","00","004","0429","0000","1188","898","290","98","1286","2514","0","51.15","35.72"
"10","017","00","004","0429","0101","553","419","134","41","594","1336","0","44.46","31.36"
"10","017","00","004","0429","0102","635","479","156","57","692","1178","0","58.74","40.66"
"10","017","00","005","0000","0000","19697","15210","4487","1264","20961","41856","47428","50.08","36.34"
"10","017","00","005","0501","0000","373","293","80","28","401","796","0","50.38","36.81"
"10","017","00","005","0501","0107","373","293","80","28","401","796","0","50.38","36.81"
"10","017","00","005","0502","0000","589","483","106","49","638","1036","0","61.58","46.62"
"10","017","00","005","0502","0108","589","483","106","49","638","1036","0","61.58","46.62"
"10","017","00","005","0503","0000","388","302","86","44","432","756","0","57.14","39.95"
"10","017","00","005","0503","0109","388","302","86","44","432","756","0","57.14","39.95"
"10","017","00","005","0504","0000","383","271","112","24","407","957","0","42.53","28.32"
"10","017","00","005","0504","0110","383","271","112","24","407","957","0","42.53","28.32"
"10","017","00","005","0505","0000","390","312","78","15","405","802","0","50.5","38.9"
"10","017","00","005","0505","0111","390","312","78","15","405","802","0","50.5","38.9"
"10","017","00","005","0506","0000","631","498","133","44","675","1263","0","53.44","39.43"
"10","017","00","005","0506","0112","631","498","133","44","675","1263","0","53.44","39.43"
"10","017","00","005","0507","0000","422","331","91","20","442","778","0","56.81","42.54"
"10","017","00","005","0507","0113","422","331","91","20","442","778","0","56.81","42.54"
"10","017","00","005","0508","0000","588","442","146","85","673","1180","0","57.03","37.46"
"10","017","00","005","0508","0114","588","442","146","85","673","1180","0","57.03","37.46"
"10","017","00","005","0509","0000","438","336","102","25","463","990","0","46.77","33.94"
"10","017","00","005","0509","0115","438","336","102","25","463","990","0","46.77","33.94"
"10","017","00","005","0510","0000","511","394","117","31","542","1332","0","40.69","29.58"
"10","017","00","005","0510","0116","511","394","117","31","542","1332","0","40.69","29.58"
"10","017","00","005","0511","0000","767","608","159","51","818","1770","0","46.21","34.35"
"10","017","00","005","0511","0117","357","278","79","35","392","848","0","46.23","32.78"
"10","017","00","005","0511","0118","410","330","80","16","426","922","0","46.2","35.79"
"10","017","00","005","0512","0000","670","505","165","33","703","1584","0","44.38","31.88"
"10","017","00","005","0512","0122","670","505","165","33","703","1584","0","44.38","31.88"
"10","017","00","005","0513","0000","451","344","107","34","485","1319","0","36.77","26.08"
"10","017","00","005","0513","0123","451","344","107","34","485","1319","0","36.77","26.08"
"10","017","00","005","0514","0000","247","208","39","33","280","574","0","48.78","36.24"
"10","017","00","005","0514","0120","247","208","39","33","280","574","0","48.78","36.24"
"10","017","00","005","0515","0000","402","301","101","52","454","877","0","51.77","34.32"
"10","017","00","005","0515","0121","402","301","101","52","454","877","0","51.77","34.32"
"10","017","00","005","0516","0000","379","270","109","49","428","715","0","59.86","37.76"
"10","017","00","005","0516","0141","379","270","109","49","428","715","0","59.86","37.76"
"10","017","00","005","0517","0000","465","323","142","48","513","849","0","60.42","38.04"
"10","017","00","005","0517","0140","465","323","142","48","513","849","0","60.42","38.04"
"10","017","00","005","0518","0000","413","322","91","19","432","932","0","46.35","34.55"
"10","017","00","005","0518","0139","413","322","91","19","432","932","0","46.35","34.55"
"10","017","00","005","0519","0000","683","498","185","72","755","1642","0","45.98","30.33"
"10","017","00","005","0519","0138","683","498","185","72","755","1642","0","45.98","30.33"
"10","017","00","005","0520","0000","2767","2177","590","121","2888","5387","0","53.61","40.41"
"10","017","00","005","0520","0126","1068","855","213","30","1098","2088","0","52.59","40.95"
"10","017","00","005","0520","0127","993","785","208","32","1025","1946","0","52.67","40.34"
"10","017","00","005","0520","0128","706","537","169","59","765","1353","0","56.54","39.69"
"10","017","00","005","0521","0000","2797","2184","613","139","2936","5560","0","52.81","39.28"
"10","017","00","005","0521","0129","626","472","154","48","674","1317","0","51.18","35.84"
"10","017","00","005","0521","0130","466","351","115","30","496","870","0","57.01","40.34"
"10","017","00","005","0521","0131","688","560","128","28","716","1322","0","54.16","42.36"
"10","017","00","005","0521","0132","579","459","120","12","591","1295","0","45.64","35.44"
"10","017","00","005","0521","0133","438","342","96","21","459","756","0","60.71","45.24"
"10","017","00","005","0522","0000","1753","1352","401","111","1864","3815","0","48.86","35.44"
"10","017","00","005","0522","0124","919","702","217","58","977","1938","0","50.41","36.22"
"10","017","00","005","0522","0125","834","650","184","53","887","1877","0","47.26","34.63"
"10","017","00","005","0523","0000","260","184","76","11","271","459","0","59.04","40.09"
"10","017","00","005","0523","0119","260","184","76","11","271","459","0","59.04","40.09"
"10","017","00","005","0524","0000","2930","2272","658","126","3056","6483","0","47.14","35.05"
"10","017","00","005","0524","0134","683","536","147","30","713","1602","0","44.51","33.46"
"10","017","00","005","0524","0135","710","536","174","38","748","1568","0","47.7","34.18"
"10","017","00","005","0524","0136","705","519","186","32","737","1404","0","52.49","36.97"
"10","017","00","005","0524","0137","832","681","151","26","858","1909","0","44.94","35.67"
"10","017","00","006","0000","0000","34319","27117","7202","2039","36358","70396","82263","51.65","38.52"
"10","017","00","006","0601","0000","544","435","109","35","579","1213","0","47.73","35.86"
"10","017","00","006","0601","0143","544","435","109","35","579","1213","0","47.73","35.86"
"10","017","00","006","0602","0000","421","317","104","29","450","1026","0","43.86","30.9"
"10","017","00","006","0602","0144","421","317","104","29","450","1026","0","43.86","30.9"
"10","017","00","006","0603","0000","606","451","155","65","671","1361","0","49.3","33.14"
"10","017","00","006","0603","0142","606","451","155","65","671","1361","0","49.3","33.14"
"10","017","00","006","0604","0000","542","422","120","85","627","1038","0","60.4","40.66"
"10","017","00","006","0604","0145","542","422","120","85","627","1038","0","60.4","40.66"
"10","017","00","006","0605","0000","451","314","137","55","506","897","0","56.41","35.01"
"10","017","00","006","0605","0146","451","314","137","55","506","897","0","56.41","35.01"
"10","017","00","006","0606","0000","888","675","213","68","956","2042","0","46.82","33.06"
"10","017","00","006","0606","0147","682","518","164","59","741","1401","0","52.89","36.97"
"10","017","00","006","0606","0148","206","157","49","9","215","641","0","33.54","24.49"
"10","017","00","006","0607","0000","903","694","209","82","985","1944","0","50.67","35.7"
"10","017","00","006","0607","0149","675","515","160","55","730","1472","0","49.59","34.99"
"10","017","00","006","0607","0150","228","179","49","27","255","472","0","54.03","37.92"
"10","017","00","006","0608","0000","1486","1120","366","89","1575","3250","0","48.46","34.46"
"10","017","00","006","0608","0153","837","633","204","43","880","1901","0","46.29","33.3"
"10","017","00","006","0608","0154","649","487","162","46","695","1349","0","51.52","36.1"
"10","017","00","006","0609","0000","461","361","100","29","490","841","0","58.26","42.93"
"10","017","00","006","0609","0151","461","361","100","29","490","841","0","58.26","42.93"
"10","017","00","006","0610","0000","274","204","70","29","303","571","0","53.06","35.73"
"10","017","00","006","0610","0152","274","204","70","29","303","571","0","53.06","35.73"
"10","017","00","006","0611","0000","1907","1481","426","277","2184","3922","0","55.69","37.76"
"10","017","00","006","0611","0179","983","771","212","63","1046","1960","0","53.37","39.34"
"10","017","00","006","0611","0180","924","710","214","214","1138","1962","0","58.0","36.19"
"10","017","00","006","0612","0000","796","622","174","51","847","1641","0","51.61","37.9"
"10","017","00","006","0612","0186","796","622","174","51","847","1641","0","51.61","37.9"
"10","017","00","006","0613","0000","2618","2042","576","129","2747","5289","0","51.94","38.61"
"10","017","00","006","0613","0187","620","473","147","39","659","1279","0","51.52","36.98"
"10","017","00","006","0613","0188","664","542","122","24","688","1360","0","50.59","39.85"
"10","017","00","006","0613","0189","723","547","176","36","759","1399","0","54.25","39.1"
"10","017","00","006","0613","0190","611","480","131","30","641","1251","0","51.24","38.37"
"10","017","00","006","0614","0000","1829","1487","342","101","1930","3946","0","48.91","37.68"
"10","017","00","006","0614","0181","1033","822","211","63","1096","2117","0","51.77","38.83"
"10","017","00","006","0614","0182","796","665","131","38","834","1829","0","45.6","36.36"
"10","017","00","006","0615","0000","1272","1010","262","93","1365","2576","0","52.99","39.21"
"10","017","00","006","0615","0155","581","472","109","40","621","1225","0","50.69","38.53"
"10","017","00","006","0615","0156","691","538","153","53","744","1351","0","55.07","39.82"
"10","017","00","006","0616","0000","2554","2032","522","99","2653","4768","0","55.64","42.62"
"10","017","00","006","0616","0159","835","699","136","37","872","1613","0","54.06","43.34"
"10","017","00","006","0616","0160","903","703","200","36","939","1731","0","54.25","40.61"
"10","017","00","006","0616","0161","816","630","186","26","842","1424","0","59.13","44.24"
"10","017","00","006","0617","0000","1743","1394","349","102","1845","3485","0","52.94","40.0"
"10","017","00","006","0617","0162","854","678","176","54","908","1806","0","50.28","37.54"
"10","017","00","006","0617","0163","889","716","173","48","937","1679","0","55.81","42.64"
"10","017","00","006","0618","0000","1980","1567","413","78","2058","3942","0","52.21","39.75"
"10","017","00","006","0618","0164","971","761","210","38","1009","1902","0","53.05","40.01"
"10","017","00","006","0618","0165","1009","806","203","40","1049","2040","0","51.42","39.51"
"10","017","00","006","0619","0000","1241","954","287","68","1309","2556","0","51.21","37.32"
"10","017","00","006","0619","0166","658","514","144","47","705","1313","0","53.69","39.15"
"10","017","00","006","0619","0167","583","440","143","21","604","1243","0","48.59","35.4"
"10","017","00","006","0620","0000","1317","1020","297","52","1369","2968","0","46.13","34.37"
"10","017","00","006","0620","0171","641","496","145","21","662","1557","0","42.52","31.86"
"10","017","00","006","0620","0172","676","524","152","31","707","1411","0","50.11","37.14"
"10","017","00","006","0621","0000","2224","1829","395","84","2308","4538","0","50.86","40.3"
"10","017","00","006","0621","0183","706","581","125","30","736","1529","0","48.14","38.0"
"10","017","00","006","0621","0184","912","740","172","40","952","1869","0","50.94","39.59"
"10","017","00","006","0621","0185","606","508","98","14","620","1140","0","54.39","44.56"
"10","017","00","006","0622","0000","1810","1385","425","64","1874","3319","0","56.46","41.73"
"10","017","00","006","0622","0168","856","670","186","31","887","1759","0","50.43","38.09"
"10","017","00","006","0622","0169","422","309","113","15","437","694","0","62.97","44.52"
"10","017","00","006","0622","0170","532","406","126","18","550","866","0","63.51","46.88"
"10","017","00","006","0623","0000","2058","1660","398","100","2158","4650","0","46.41","35.7"
"10","017","00","006","0623","0176","774","632","142","19","793","1673","0","47.4","37.78"
"10","017","00","006","0623","0177","510","398","112","48","558","1054","0","52.94","37.76"
"10","017","00","006","0623","0178","774","630","144","33","807","1923","0","41.97","32.76"
"10","017","00","006","0624","0000","2289","1893","396","84","2373","4499","0","52.75","42.08"
"10","017","00","006","0624","0173","858","703","155","31","889","1568","0","56.7","44.83"
"10","017","00","006","0624","0174","673","535","138","40","713","1400","0","50.93","38.21"
"10","017","00","006","0624","0175","758","655","103","13","771","1531","0","50.36","42.78"
"10","017","00","006","0625","0000","2105","1748","357","91","2196","4114","0","53.38","42.49"
"10","017","00","006","0625","0157","860","706","154","47","907","1601","0","56.65","44.1"
"10","017","00","006","0625","0158","1245","1042","203","44","1289","2513","0","51.29","41.46"
"10","017","00","007","0000","0000","22545","17997","4548","1198","23743","46014","52487","51.6","39.11"
"10","017","00","007","0701","0000","546","426","120","45","591","1096","0","53.92","38.87"
"10","017","00","007","0701","0036","546","426","120","45","591","1096","0","53.92","38.87"
"10","017","00","007","0702","0000","696","546","150","37","733","1232","0","59.5","44.32"
"10","017","00","007","0702","0037","696","546","150","37","733","1232","0","59.5","44.32"
"10","017","00","007","0703","0000","595","464","131","17","612","1184","0","51.69","39.19"
"10","017","00","007","0703","0038","595","464","131","17","612","1184","0","51.69","39.19"
"10","017","00","007","0704","0000","1218","955","263","104","1322","2321","0","56.96","41.15"
"10","017","00","007","0704","0039","600","470","130","63","663","1133","0","58.52","41.48"
"10","017","00","007","0704","0040","618","485","133","41","659","1188","0","55.47","40.82"
"10","017","00","007","0705","0000","383","287","96","39","422","725","0","58.21","39.59"
"10","017","00","007","0705","0041","383","287","96","39","422","725","0","58.21","39.59"
"10","017","00","007","0706","0000","677","518","159","43","720","1524","0","47.24","33.99"
"10","017","00","007","0706","0042","677","518","159","43","720","1524","0","47.24","33.99"
"10","017","00","007","0707","0000","363","279","84","34","397","736","0","53.94","37.91"
"10","017","00","007","0707","0043","363","279","84","34","397","736","0","53.94","37.91"
"10","017","00","007","0708","0000","691","527","164","39","730","1562","0","46.73","33.74"
"10","017","00","007","0708","0044","283","226","57","23","306","611","0","50.08","36.99"
"10","017","00","007","0708","0045","408","301","107","16","424","951","0","44.58","31.65"
"10","017","00","007","0709","0000","781","617","164","40","821","1616","0","50.8","38.18"
"10","017","00","007","0709","0046","781","617","164","40","821","1616","0","50.8","38.18"
"10","017","00","007","0710","0000","782","625","157","35","817","1516","0","53.89","41.23"
"10","017","00","007","0710","0047","782","625","157","35","817","1516","0","53.89","41.23"
"10","017","00","007","0711","0000","1038","805","233","53","1091","2118","0","51.51","38.01"
"10","017","00","007","0711","0048","514","403","111","24","538","1049","0","51.29","38.42"
"10","017","00","007","0711","0049","524","402","122","29","553","1069","0","51.73","37.61"
"10","017","00","007","0712","0000","854","685","169","34","888","1763","0","50.37","38.85"
"10","017","00","007","0712","0054","488","398","90","20","508","999","0","50.85","39.84"
"10","017","00","007","0712","0055","366","287","79","14","380","764","0","49.74","37.57"
"10","017","00","007","0713","0000","1647","1298","349","60","1707","3570","0","47.82","36.36"
"10","017","00","007","0713","0056","713","564","149","30","743","1555","0","47.78","36.27"
"10","017","00","007","0713","0057","934","734","200","30","964","2015","0","47.84","36.43"
"10","017","00","007","0714","0000","1444","1179","265","102","1546","2837","0","54.49","41.56"
"10","017","00","007","0714","0058","678","564","114","42","720","1268","0","56.78","44.48"
"10","017","00","007","0714","0059","766","615","151","60","826","1569","0","52.64","39.2"
"10","017","00","007","0715","0000","652","505","147","43","695","1295","0","53.67","39.0"
"10","017","00","007","0715","0071","652","505","147","43","695","1295","0","53.67","39.0"
"10","017","00","007","0716","0000","2280","1811","469","124","2404","4113","0","58.45","44.03"
"10","017","00","007","0716","0050","395","311","84","25","420","727","0","57.77","42.78"
"10","017","00","007","0716","0051","523","436","87","20","543","929","0","58.45","46.93"
"10","017","00","007","0716","0052","652","500","152","38","690","1118","0","61.72","44.72"
"10","017","00","007","0716","0053","710","564","146","41","751","1339","0","56.09","42.12"
"10","017","00","007","0717","0000","1511","1239","272","74","1585","3780","0","41.93","32.78"
"10","017","00","007","0717","0069","822","681","141","39","861","2016","0","42.71","33.78"
"10","017","00","007","0717","0070","689","558","131","35","724","1764","0","41.04","31.63"
"10","017","00","007","0718","0000","1664","1379","285","90","1754","3461","0","50.68","39.84"
"10","017","00","007","0718","0060","891","723","168","62","953","1985","0","48.01","36.42"
"10","017","00","007","0718","0061","773","656","117","28","801","1476","0","54.27","44.44"
"10","017","00","007","0719","0000","1120","917","203","62","1182","2494","0","47.39","36.77"
"10","017","00","007","0719","0067","642","534","108","37","679","1485","0","45.72","35.96"
"10","017","00","007","0719","0068","478","383","95","25","503","1009","0","49.85","37.96"
"10","017","00","007","0720","0000","3603","2935","668","123","3726","7071","0","52.69","41.51"
"10","017","00","007","0720","0062","809","648","161","28","837","1493","0","56.06","43.4"
"10","017","00","007","0720","0063","723","589","134","27","750","1249","0","60.05","47.16"
"10","017","00","007","0720","0064","739","581","158","22","761","1559","0","48.81","37.27"
"10","017","00","007","0720","0065","536","446","90","18","554","1168","0","47.43","38.18"
"10","017","00","007","0720","0066","796","671","125","28","824","1602","0","51.44","41.89"
"10","018","00","000","0000","0000","185743","146486","39257","10937","196680","351775","444775","55.91","41.64"
"10","018","00","001","0000","0000","87611","69052","18559","4576","92187","163757","215079","56.29","42.17"
"10","018","00","001","0101","0000","388","293","95","31","419","714","0","58.68","41.04"
"10","018","00","001","0101","0101","388","293","95","31","419","714","0","58.68","41.04"
"10","018","00","001","0102","0000","731","574","157","54","785","1396","0","56.23","41.12"
"10","018","00","001","0102","0103","731","574","157","54","785","1396","0","56.23","41.12"
"10","018","00","001","0103","0000","456","337","119","52","508","875","0","58.06","38.51"
"10","018","00","001","0103","0102","456","337","119","52","508","875","0","58.06","38.51"
"10","018","00","001","0104","0000","255","188","67","14","269","507","0","53.06","37.08"
"10","018","00","001","0104","0100","255","188","67","14","269","507","0","53.06","37.08"
"10","018","00","001","0105","0000","324","238","86","28","352","566","0","62.19","42.05"
"10","018","00","001","0105","0004","324","238","86","28","352","566","0","62.19","42.05"
"10","018","00","001","0106","0000","149","114","35","23","172","305","0","56.39","37.38"
"10","018","00","001","0106","0006","149","114","35","23","172","305","0","56.39","37.38"
"10","018","00","001","0107","0000","343","256","87","24","367","640","0","57.34","40.0"
"10","018","00","001","0107","0005","343","256","87","24","367","640","0","57.34","40.0"
"10","018","00","001","0108","0000","281","215","66","19","300","475","0","63.16","45.26"
"10","018","00","001","0108","0113","281","215","66","19","300","475","0","63.16","45.26"
"10","018","00","001","0109","0000","408","309","99","45","453","752","0","60.24","41.09"
"10","018","00","001","0109","0112","408","309","99","45","453","752","0","60.24","41.09"
"10","018","00","001","0110","0000","373","275","98","29","402","710","0","56.62","38.73"
"10","018","00","001","0110","0111","373","275","98","29","402","710","0","56.62","38.73"
"10","018","00","001","0111","0000","479","363","116","15","494","1512","0","32.67","24.01"
"10","018","00","001","0111","0001","479","363","116","15","494","1512","0","32.67","24.01"
"10","018","00","001","0112","0000","318","233","85","19","337","563","0","59.86","41.39"
"10","018","00","001","0112","0007","318","233","85","19","337","563","0","59.86","41.39"
"10","018","00","001","0113","0000","1674","1338","336","87","1761","3123","0","56.39","42.84"
"10","018","00","001","0113","0027","829","657","172","42","871","1573","0","55.37","41.77"
"10","018","00","001","0113","0028","845","681","164","45","890","1550","0","57.42","43.94"
"10","018","00","001","0114","0000","1561","1160","401","91","1652","2928","0","56.42","39.62"
"10","018","00","001","0114","0114","435","320","115","30","465","880","0","52.84","36.36"
"10","018","00","001","0114","0115","546","394","152","30","576","989","0","58.24","39.84"
"10","018","00","001","0114","0116","580","446","134","31","611","1059","0","57.7","42.12"
"10","018","00","001","0115","0000","758","562","196","86","844","1422","0","59.35","39.52"
"10","018","00","001","0115","0117","322","240","82","48","370","607","0","60.96","39.54"
"10","018","00","001","0115","0118","436","322","114","38","474","815","0","58.16","39.51"
"10","018","00","001","0116","0000","2650","2050","600","149","2799","5524","0","50.67","37.11"
"10","018","00","001","0116","0104","611","465","146","38","649","1232","0","52.68","37.74"
"10","018","00","001","0116","0105","669","507","162","46","715","1323","0","54.04","38.32"
"10","018","00","001","0116","0106","669","544","125","22","691","1516","0","45.58","35.88"
"10","018","00","001","0116","0107","701","534","167","43","744","1453","0","51.2","36.75"
"10","018","00","001","0117","0000","958","760","198","43","1001","1682","0","59.51","45.18"
"10","018","00","001","0117","0002","558","446","112","23","581","953","0","60.97","46.8"
"10","018","00","001","0117","0003","400","314","86","20","420","729","0","57.61","43.07"
"10","018","00","001","0118","0000","2394","1929","465","90","2484","4456","0","55.75","43.29"
"10","018","00","001","0118","0010","841","689","152","24","865","1615","0","53.56","42.66"
"10","018","00","001","0118","0011","702","555","147","38","740","1287","0","57.5","43.12"
"10","018","00","001","0118","0012","851","685","166","28","879","1554","0","56.56","44.08"
"10","018","00","001","0119","0000","2253","1768","485","125","2378","4162","0","57.14","42.48"
"10","018","00","001","0119","0013","772","612","160","29","801","1388","0","57.71","44.09"
"10","018","00","001","0119","0014","784","627","157","38","822","1419","0","57.93","44.19"
"10","018","00","001","0119","0015","697","529","168","58","755","1355","0","55.72","39.04"
"10","018","00","001","0120","0000","2565","2033","532","179","2744","4714","0","58.21","43.13"
"10","018","00","001","0120","0019","570","475","95","40","610","1062","0","57.44","44.73"
"10","018","00","001","0120","0020","703","551","152","49","752","1315","0","57.19","41.9"
"10","018","00","001","0120","0021","543","433","110","51","594","1000","0","59.4","43.3"
"10","018","00","001","0120","0022","749","574","175","39","788","1337","0","58.94","42.93"
"10","018","00","001","0121","0000","2969","2384","585","125","3094","5333","0","58.02","44.7"
"10","018","00","001","0121","0023","911","747","164","29","940","1747","0","53.81","42.76"
"10","018","00","001","0121","0024","919","729","190","38","957","1600","0","59.81","45.56"
"10","018","00","001","0121","0025","628","509","119","28","656","1158","0","56.65","43.96"
"10","018","00","001","0121","0026","511","399","112","30","541","828","0","65.34","48.19"
"10","018","00","001","0122","0000","1320","1047","273","96","1416","2283","0","62.02","45.86"
"10","018","00","001","0122","0039","689","536","153","76","765","1271","0","60.19","42.17"
"10","018","00","001","0122","0040","631","511","120","20","651","1012","0","64.33","50.49"
"10","018","00","001","0123","0000","1326","1012","314","114","1440","2604","0","55.3","38.86"
"10","018","00","001","0123","0041","528","413","115","59","587","1001","0","58.64","41.26"
"10","018","00","001","0123","0042","798","599","199","55","853","1603","0","53.21","37.37"
"10","018","00","001","0124","0000","2399","1885","514","134","2533","4297","0","58.95","43.87"
"10","018","00","001","0124","0050","668","488","180","38","706","1195","0","59.08","40.84"
"10","018","00","001","0124","0051","806","636","170","62","868","1569","0","55.32","40.54"
"10","018","00","001","0124","0052","925","761","164","34","959","1533","0","62.56","49.64"
"10","018","00","001","0125","0000","2287","1942","345","119","2406","3992","0","60.27","48.65"
"10","018","00","001","0125","0053","771","639","132","41","812","1336","0","60.78","47.83"
"10","018","00","001","0125","0054","771","676","95","36","807","1367","0","59.03","49.45"
"10","018","00","001","0125","0055","745","627","118","42","787","1289","0","61.06","48.64"
"10","018","00","001","0126","0000","3527","2791","736","171","3698","6055","0","61.07","46.09"
"10","018","00","001","0126","0034","717","553","164","41","758","1262","0","60.06","43.82"
"10","018","00","001","0126","0035","655","525","130","25","680","1199","0","56.71","43.79"
"10","018","00","001","0126","0036","717","581","136","36","753","1226","0","61.42","47.39"
"10","018","00","001","0126","0037","833","674","159","43","876","1377","0","63.62","48.95"
"10","018","00","001","0126","0038","605","458","147","26","631","991","0","63.67","46.22"
"10","018","00","001","0127","0000","1738","1420","318","89","1827","3142","0","58.15","45.19"
"10","018","00","001","0127","0031","516","438","78","27","543","935","0","58.07","46.84"
"10","018","00","001","0127","0032","571","465","106","24","595","1074","0","55.4","43.3"
"10","018","00","001","0127","0033","651","517","134","38","689","1133","0","60.81","45.63"
"10","018","00","001","0128","0000","1758","1404","354","81","1839","3440","0","53.46","40.81"
"10","018","00","001","0128","0122","518","406","112","37","555","1062","0","52.26","38.23"
"10","018","00","001","0128","0123","575","470","105","25","600","1046","0","57.36","44.93"
"10","018","00","001","0128","0124","665","528","137","19","684","1332","0","51.35","39.64"
"10","018","00","001","0129","0000","1570","1209","361","105","1675","2999","0","55.85","40.31"
"10","018","00","001","0129","0108","478","349","129","39","517","880","0","58.75","39.66"
"10","018","00","001","0129","0109","530","440","90","32","562","1058","0","53.12","41.59"
"10","018","00","001","0129","0110","562","420","142","34","596","1061","0","56.17","39.59"
"10","018","00","001","0130","0000","2735","2140","595","123","2858","5036","0","56.75","42.49"
"10","018","00","001","0130","0132","659","509","150","34","693","1315","0","52.7","38.71"
"10","018","00","001","0130","0133","747","593","154","34","781","1413","0","55.27","41.97"
"10","018","00","001","0130","0134","568","454","114","30","598","1064","0","56.2","42.67"
"10","018","00","001","0130","0135","761","584","177","25","786","1244","0","63.18","46.95"
"10","018","00","001","0131","0000","2907","2196","711","147","3054","5678","0","53.79","38.68"
"10","018","00","001","0131","0125","729","532","197","53","782","1350","0","57.93","39.41"
"10","018","00","001","0131","0126","706","551","155","17","723","1438","0","50.28","38.32"
"10","018","00","001","0131","0127","669","509","160","48","717","1414","0","50.71","36.0"
"10","018","00","001","0131","0128","803","604","199","29","832","1476","0","56.37","40.92"
"10","018","00","001","0132","0000","673","525","148","27","700","1233","0","56.77","42.58"
"10","018","00","001","0132","0099","673","525","148","27","700","1233","0","56.77","42.58"
"10","018","00","001","0133","0000","1643","1272","371","109","1752","3003","0","58.34","42.36"
"10","018","00","001","0133","0063","625","500","125","49","674","1132","0","59.54","44.17"
"10","018","00","001","0133","0064","141","97","44","11","152","251","0","60.56","38.65"
"10","018","00","001","0133","0065","877","675","202","49","926","1620","0","57.16","41.67"
"10","018","00","001","0135","0000","477","408","69","37","514","915","0","56.17","44.59"
"10","018","00","001","0135","0059","477","408","69","37","514","915","0","56.17","44.59"
"10","018","00","001","0136","0000","1531","1200","331","102","1633","2751","0","59.36","43.62"
"10","018","00","001","0136","0056","499","388","111","29","528","960","0","55.0","40.42"
"10","018","00","001","0136","0057","505","400","105","29","534","843","0","63.35","47.45"
"10","018","00","001","0136","0058","527","412","115","44","571","948","0","60.23","43.46"
"10","018","00","001","0137","0000","1984","1634","350","76","2060","3556","0","57.93","45.95"
"10","018","00","001","0137","0060","997","840","157","38","1035","1801","0","57.47","46.64"
"10","018","00","001","0137","0061","584","456","128","26","610","1079","0","56.53","42.26"
"10","018","00","001","0137","0062","403","338","65","12","415","676","0","61.39","50.0"
"10","018","00","001","0138","0000","1320","1024","296","88","1408","2768","0","50.87","36.99"
"10","018","00","001","0138","0043","629","471","158","41","670","1236","0","54.21","38.11"
"10","018","00","001","0138","0044","691","553","138","47","738","1532","0","48.17","36.1"
"10","018","00","001","0139","0000","1726","1366","360","132","1858","3331","0","55.78","41.01"
"10","018","00","001","0139","0045","682","534","148","39","721","1306","0","55.21","40.89"
"10","018","00","001","0139","0046","563","450","113","63","626","1073","0","58.34","41.94"
"10","018","00","001","0139","0047","481","382","99","30","511","952","0","53.68","40.13"
"10","018","00","001","0140","0000","965","776","189","51","1016","2076","0","48.94","37.38"
"10","018","00","001","0140","0048","570","448","122","34","604","1298","0","46.53","34.51"
"10","018","00","001","0140","0049","395","328","67","17","412","778","0","52.96","42.16"
"10","018","00","001","0141","0000","2350","1838","512","95","2445","4669","0","52.37","39.37"
"10","018","00","001","0141","0077","592","467","125","22","614","1215","0","50.53","38.44"
"10","018","00","001","0141","0078","498","390","108","38","536","1067","0","50.23","36.55"
"10","018","00","001","0141","0079","639","491","148","17","656","1194","0","54.94","41.12"
"10","018","00","001","0141","0080","621","490","131","18","639","1193","0","53.56","41.07"
"10","018","00","001","0142","0000","4224","3285","939","158","4382","7900","0","55.47","41.58"
"10","018","00","001","0142","0066","763","595","168","37","800","1479","0","54.09","40.23"
"10","018","00","001","0142","0067","729","555","174","24","753","1402","0","53.71","39.59"
"10","018","00","001","0142","0068","678","532","146","39","717","1280","0","56.02","41.56"
"10","018","00","001","0142","0069","703","541","162","23","726","1228","0","59.12","44.06"
"10","018","00","001","0142","0070","610","484","126","8","618","1157","0","53.41","41.83"
"10","018","00","001","0142","0071","741","578","163","27","768","1354","0","56.72","42.69"
"10","018","00","001","0143","0000","2853","2287","566","152","3005","5242","0","57.33","43.63"
"10","018","00","001","0143","0081","735","568","167","70","805","1388","0","58.0","40.92"
"10","018","00","001","0143","0082","707","570","137","24","731","1267","0","57.7","44.99"
"10","018","00","001","0143","0083","708","579","129","22","730","1299","0","56.2","44.57"
"10","018","00","001","0143","0084","703","570","133","36","739","1288","0","57.38","44.25"
"10","018","00","001","0144","0000","2421","1922","499","105","2526","4240","0","59.58","45.33"
"10","018","00","001","0144","0096","823","660","163","35","858","1400","0","61.29","47.14"
"10","018","00","001","0144","0097","869","684","185","30","899","1473","0","61.03","46.44"
"10","018","00","001","0144","0098","729","578","151","40","769","1367","0","56.25","42.28"
"10","018","00","001","0145","0000","2546","2063","483","106","2652","5042","0","52.6","40.92"
"10","018","00","001","0145","0092","680","542","138","36","716","1323","0","54.12","40.97"
"10","018","00","001","0145","0093","613","515","98","21","634","1207","0","52.53","42.67"
"10","018","00","001","0145","0094","591","493","98","33","624","1264","0","49.37","39.0"
"10","018","00","001","0145","0095","662","513","149","16","678","1248","0","54.33","41.11"
"10","018","00","001","0146","0000","2385","1913","472","133","2518","4634","0","54.34","41.28"
"10","018","00","001","0146","0088","560","464","96","40","600","1135","0","52.86","40.88"
"10","018","00","001","0146","0089","564","463","101","24","588","1165","0","50.47","39.74"
"10","018","00","001","0146","0090","586","465","121","33","619","1124","0","55.07","41.37"
"10","018","00","001","0146","0091","675","521","154","36","711","1210","0","58.76","43.06"
"10","018","00","001","0147","0000","3661","2934","727","152","3813","6262","0","60.89","46.85"
"10","018","00","001","0147","0072","767","622","145","30","797","1334","0","59.75","46.63"
"10","018","00","001","0147","0073","683","555","128","38","721","1234","0","58.43","44.98"
"10","018","00","001","0147","0074","846","670","176","33","879","1398","0","62.88","47.93"
"10","018","00","001","0147","0075","548","403","145","22","570","928","0","61.42","43.43"
"10","018","00","001","0147","0076","817","684","133","29","846","1368","0","61.84","50.0"
"10","018","00","001","0148","0000","1290","967","323","75","1365","2357","0","57.91","41.03"
"10","018","00","001","0148","0029","691","526","165","31","722","1317","0","54.82","39.94"
"10","018","00","001","0148","0030","599","441","158","44","643","1040","0","61.83","42.4"
"10","018","00","001","0149","0000","1717","1315","402","110","1827","3392","0","53.86","38.77"
"10","018","00","001","0149","0119","440","344","96","41","481","777","0","61.9","44.27"
"10","018","00","001","0149","0120","645","496","149","30","675","1399","0","48.25","35.45"
"10","018","00","001","0149","0121","632","475","157","39","671","1216","0","55.18","39.06"
"10","018","00","001","0150","0000","2562","2047","515","106","2668","4777","0","55.85","42.85"
"10","018","00","001","0150","0016","785","621","164","39","824","1490","0","55.3","41.68"
"10","018","00","001","0150","0017","867","702","165","31","898","1615","0","55.6","43.47"
"10","018","00","001","0150","0018","910","724","186","36","946","1672","0","56.58","43.3"
"10","018","00","001","0151","0000","959","750","209","35","994","1782","0","55.78","42.09"
"10","018","00","001","0151","0008","386","308","78","18","404","741","0","54.52","41.57"
"10","018","00","001","0151","0009","573","442","131","17","590","1041","0","56.68","42.46"
"10","018","00","001","0152","0000","2001","1585","416","91","2092","3526","0","59.33","44.95"
"10","018","00","001","0152","0129","758","604","154","52","810","1326","0","61.09","45.55"
"10","018","00","001","0152","0130","559","448","111","14","573","927","0","61.81","48.33"
"10","018","00","001","0152","0131","684","533","151","25","709","1273","0","55.7","41.87"
"10","018","00","001","0153","0000","2305","1813","492","75","2380","4816","0","49.42","37.65"
"10","018","00","001","0153","0136","589","450","139","7","596","1160","0","51.38","38.79"
"10","018","00","001","0153","0137","661","520","141","23","684","1398","0","48.93","37.2"
"10","018","00","001","0153","0138","550","432","118","14","564","1384","0","40.75","31.21"
"10","018","00","001","0153","0139","505","411","94","31","536","874","0","61.33","47.03"
"10","018","00","001","0154","0000","2164","1703","461","54","2218","3600","0","61.61","47.31"
"10","018","00","001","0154","0085","723","549","174","21","744","1228","0","60.59","44.71"
"10","018","00","001","0154","0086","677","547","130","12","689","1135","0","60.7","48.19"
"10","018","00","001","0154","0087","764","607","157","21","785","1237","0","63.46","49.07"
"10","018","00","002","0000","0000","64097","50518","13579","4102","68199","123122","151391","55.39","41.03"
"10","018","00","002","0201","0000","299","226","73","22","321","535","0","60.0","42.24"
"10","018","00","002","0201","0141","299","226","73","22","321","535","0","60.0","42.24"
"10","018","00","002","0202","0000","400","305","95","39","439","711","0","61.74","42.9"
"10","018","00","002","0202","0144","400","305","95","39","439","711","0","61.74","42.9"
"10","018","00","002","0203","0000","388","278","110","56","444","746","0","59.52","37.27"
"10","018","00","002","0203","0142","388","278","110","56","444","746","0","59.52","37.27"
"10","018","00","002","0204","0000","223","164","59","11","234","477","0","49.06","34.38"
"10","018","00","002","0204","0140","223","164","59","11","234","477","0","49.06","34.38"
"10","018","00","002","0205","0000","528","414","114","38","566","1143","0","49.52","36.22"
"10","018","00","002","0205","0145","528","414","114","38","566","1143","0","49.52","36.22"
"10","018","00","002","0206","0000","262","188","74","16","278","546","0","50.92","34.43"
"10","018","00","002","0206","0143","262","188","74","16","278","546","0","50.92","34.43"
"10","018","00","002","0207","0000","664","508","156","46","710","1370","0","51.82","37.08"
"10","018","00","002","0207","0146","664","508","156","46","710","1370","0","51.82","37.08"
"10","018","00","002","0208","0000","496","384","112","36","532","957","0","55.59","40.13"
"10","018","00","002","0208","0172","496","384","112","36","532","957","0","55.59","40.13"
"10","018","00","002","0209","0000","314","253","61","46","360","561","0","64.17","45.1"
"10","018","00","002","0209","0169","314","253","61","46","360","561","0","64.17","45.1"
"10","018","00","002","0210","0000","439","350","89","26","465","761","0","61.1","45.99"
"10","018","00","002","0210","0167","439","350","89","26","465","761","0","61.1","45.99"
"10","018","00","002","0211","0000","427","316","111","41","468","788","0","59.39","40.1"
"10","018","00","002","0211","0168","427","316","111","41","468","788","0","59.39","40.1"
"10","018","00","002","0212","0000","637","483","154","32","669","1398","0","47.85","34.55"
"10","018","00","002","0212","0171","637","483","154","32","669","1398","0","47.85","34.55"
"10","018","00","002","0213","0000","737","574","163","85","822","1558","0","52.76","36.84"
"10","018","00","002","0213","0170","737","574","163","85","822","1558","0","52.76","36.84"
"10","018","00","002","0214","0000","2386","1855","531","176","2562","4800","0","53.38","38.65"
"10","018","00","002","0214","0173","626","502","124","52","678","1195","0","56.74","42.01"
"10","018","00","002","0214","0174","573","431","142","36","609","1236","0","49.27","34.87"
"10","018","00","002","0214","0175","600","456","144","54","654","1255","0","52.11","36.33"
"10","018","00","002","0214","0176","587","466","121","34","621","1114","0","55.75","41.83"
"10","018","00","002","0215","0000","1499","1169","330","87","1586","2949","0","53.78","39.64"
"10","018","00","002","0215","0188","716","568","148","38","754","1457","0","51.75","38.98"
"10","018","00","002","0215","0189","783","601","182","49","832","1492","0","55.76","40.28"
"10","018","00","002","0216","0000","1932","1507","425","148","2080","3906","0","53.25","38.58"
"10","018","00","002","0216","0185","568","444","124","23","591","1272","0","46.46","34.91"
"10","018","00","002","0216","0186","682","530","152","60","742","1306","0","56.81","40.58"
"10","018","00","002","0216","0187","682","533","149","65","747","1328","0","56.25","40.14"
"10","018","00","002","0217","0000","1171","910","261","103","1274","2131","0","59.78","42.7"
"10","018","00","002","0217","0190","649","506","143","55","704","1160","0","60.69","43.62"
"10","018","00","002","0217","0191","522","404","118","48","570","971","0","58.7","41.61"
"10","018","00","002","0218","0000","864","665","199","58","922","1651","0","55.84","40.28"
"10","018","00","002","0218","0228","474","366","108","26","500","946","0","52.85","38.69"
"10","018","00","002","0218","0229","390","299","91","32","422","705","0","59.86","42.41"
"10","018","00","002","0219","0000","2046","1648","398","101","2147","3852","0","55.74","42.78"
"10","018","00","002","0219","0221","638","514","124","28","666","1175","0","56.68","43.74"
"10","018","00","002","0219","0222","740","604","136","24","764","1371","0","55.73","44.06"
"10","018","00","002","0219","0223","668","530","138","49","717","1306","0","54.9","40.58"
"10","018","00","002","0220","0000","441","333","108","63","504","848","0","59.43","39.27"
"10","018","00","002","0220","0230","441","333","108","63","504","848","0","59.43","39.27"
"10","018","00","002","0221","0000","1454","1140","314","68","1522","2712","0","56.12","42.04"
"10","018","00","002","0221","0199","752","594","158","44","796","1442","0","55.2","41.19"
"10","018","00","002","0221","0200","702","546","156","24","726","1270","0","57.17","42.99"
"10","018","00","002","0222","0000","3318","2599","719","202","3520","5949","0","59.17","43.69"
"10","018","00","002","0222","0208","589","459","130","25","614","1106","0","55.52","41.5"
"10","018","00","002","0222","0209","605","481","124","23","628","1044","0","60.15","46.07"
"10","018","00","002","0222","0210","593","457","136","35","628","1061","0","59.19","43.07"
"10","018","00","002","0222","0211","825","651","174","69","894","1518","0","58.89","42.89"
"10","018","00","002","0222","0212","706","551","155","50","756","1220","0","61.97","45.16"
"10","018","00","002","0223","0000","2677","2174","503","132","2809","4623","0","60.76","47.03"
"10","018","00","002","0223","0217","595","403","192","17","612","1059","0","57.79","38.05"
"10","018","00","002","0223","0218","648","547","101","38","686","1130","0","60.71","48.41"
"10","018","00","002","0223","0219","713","603","110","37","750","1208","0","62.09","49.92"
"10","018","00","002","0223","0220","721","621","100","40","761","1226","0","62.07","50.65"
"10","018","00","002","0224","0000","2683","2148","535","162","2845","5718","0","49.76","37.57"
"10","018","00","002","0224","0231","654","523","131","31","685","1295","0","52.9","40.39"
"10","018","00","002","0224","0232","698","573","125","40","738","1467","0","50.31","39.06"
"10","018","00","002","0224","0233","703","555","148","47","750","1659","0","45.21","33.45"
"10","018","00","002","0224","0234","628","497","131","44","672","1297","0","51.81","38.32"
"10","018","00","002","0225","0000","303","232","71","43","346","594","0","58.25","39.06"
"10","018","00","002","0225","0244","303","232","71","43","346","594","0","58.25","39.06"
"10","018","00","002","0226","0000","1492","1188","304","137","1629","2831","0","57.54","41.96"
"10","018","00","002","0226","0235","725","557","168","64","789","1374","0","57.42","40.54"
"10","018","00","002","0226","0236","767","631","136","73","840","1457","0","57.65","43.31"
"10","018","00","002","0227","0000","756","577","179","93","849","1609","0","52.77","35.86"
"10","018","00","002","0227","0243","756","577","179","93","849","1609","0","52.77","35.86"
"10","018","00","002","0228","0000","1837","1484","353","125","1962","3393","0","57.82","43.74"
"10","018","00","002","0228","0237","600","498","102","32","632","1072","0","58.96","46.46"
"10","018","00","002","0228","0238","671","544","127","54","725","1350","0","53.7","40.3"
"10","018","00","002","0228","0239","566","442","124","39","605","971","0","62.31","45.52"
"10","018","00","002","0229","0000","1989","1591","398","119","2108","3723","0","56.62","42.73"
"10","018","00","002","0229","0240","791","641","150","58","849","1450","0","58.55","44.21"
"10","018","00","002","0229","0241","480","364","116","26","506","895","0","56.54","40.67"
"10","018","00","002","0229","0242","718","586","132","35","753","1378","0","54.64","42.53"
"10","018","00","002","0230","0000","929","721","208","40","969","1766","0","54.87","40.83"
"10","018","00","002","0230","0158","601","474","127","24","625","1128","0","55.41","42.02"
"10","018","00","002","0230","0159","328","247","81","16","344","638","0","53.92","38.71"
"10","018","00","002","0231","0000","1860","1435","425","87","1947","3589","0","54.25","39.98"
"10","018","00","002","0231","0147","709","529","180","40","749","1390","0","53.88","38.06"
"10","018","00","002","0231","0148","500","407","93","30","530","962","0","55.09","42.31"
"10","018","00","002","0231","0149","651","499","152","17","668","1237","0","54.0","40.34"
"10","018","00","002","0232","0000","2477","1972","505","148","2625","5156","0","50.91","38.25"
"10","018","00","002","0232","0151","345","262","83","15","360","758","0","47.49","34.56"
"10","018","00","002","0232","0152","636","520","116","26","662","1320","0","50.15","39.39"
"10","018","00","002","0232","0153","705","562","143","58","763","1519","0","50.23","37.0"
"10","018","00","002","0232","0154","128","99","29","5","133","347","0","38.33","28.53"
"10","018","00","002","0232","0155","663","529","134","44","707","1212","0","58.33","43.65"
"10","018","00","002","0233","0000","1442","1100","342","101","1543","2912","0","52.99","37.77"
"10","018","00","002","0233","0156","731","566","165","37","768","1484","0","51.75","38.14"
"10","018","00","002","0233","0157","711","534","177","64","775","1428","0","54.27","37.39"
"10","018","00","002","0234","0000","2075","1593","482","142","2217","4121","0","53.8","38.66"
"10","018","00","002","0234","0163","696","566","130","52","748","1394","0","53.66","40.6"
"10","018","00","002","0234","0164","719","545","174","45","764","1568","0","48.72","34.76"
"10","018","00","002","0234","0165","660","482","178","45","705","1159","0","60.83","41.59"
"10","018","00","002","0235","0000","100","86","14","5","105","252","0","41.67","34.13"
"10","018","00","002","0235","0166","100","86","14","5","105","252","0","41.67","34.13"
"10","018","00","002","0236","0000","2549","2032","517","168","2717","4656","0","58.35","43.64"
"10","018","00","002","0236","0224","677","541","136","24","701","1340","0","52.31","40.37"
"10","018","00","002","0236","0225","624","478","146","59","683","1111","0","61.48","43.02"
"10","018","00","002","0236","0226","708","561","147","51","759","1197","0","63.41","46.87"
"10","018","00","002","0236","0227","540","452","88","34","574","1008","0","56.94","44.84"
"10","018","00","002","0237","0000","2752","2174","578","152","2904","5296","0","54.83","41.05"
"10","018","00","002","0237","0177","730","577","153","24","754","1396","0","54.01","41.33"
"10","018","00","002","0237","0178","781","603","178","55","836","1456","0","57.42","41.41"
"10","018","00","002","0237","0179","712","583","129","29","741","1374","0","53.93","42.43"
"10","018","00","002","0237","0180","529","411","118","44","573","1070","0","53.55","38.41"
"10","018","00","002","0238","0000","2361","1848","513","180","2541","4524","0","56.17","40.85"
"10","018","00","002","0238","0181","579","461","118","60","639","1142","0","55.95","40.37"
"10","018","00","002","0238","0182","533","402","131","22","555","1103","0","50.32","36.45"
"10","018","00","002","0238","0183","606","457","149","71","677","1190","0","56.89","38.4"
"10","018","00","002","0238","0184","643","528","115","27","670","1089","0","61.52","48.48"
"10","018","00","002","0239","0000","1903","1506","397","94","1997","4112","0","48.57","36.62"
"10","018","00","002","0239","0192","421","330","91","19","440","1401","0","31.41","23.55"
"10","018","00","002","0239","0193","724","581","143","38","762","1340","0","56.87","43.36"
"10","018","00","002","0239","0194","758","595","163","37","795","1371","0","57.99","43.4"
"10","018","00","002","0240","0000","2565","2028","537","139","2704","4793","0","56.42","42.31"
"10","018","00","002","0240","0195","651","516","135","22","673","1267","0","53.12","40.73"
"10","018","00","002","0240","0196","622","500","122","44","666","1073","0","62.07","46.6"
"10","018","00","002","0240","0197","630","499","131","48","678","1159","0","58.5","43.05"
"10","018","00","002","0240","0198","662","513","149","25","687","1294","0","53.09","39.64"
"10","018","00","002","0241","0000","3088","2458","630","140","3228","5721","0","56.42","42.96"
"10","018","00","002","0241","0213","821","646","175","16","837","1475","0","56.75","43.8"
"10","018","00","002","0241","0214","691","542","149","54","745","1373","0","54.26","39.48"
"10","018","00","002","0241","0215","791","632","159","28","819","1450","0","56.48","43.59"
"10","018","00","002","0241","0216","785","638","147","42","827","1423","0","58.12","44.83"
"10","018","00","002","0242","0000","3487","2788","699","168","3655","6417","0","56.96","43.45"
"10","018","00","002","0242","0203","629","500","129","44","673","1163","0","57.87","42.99"
"10","018","00","002","0242","0204","691","544","147","26","717","1334","0","53.75","40.78"
"10","018","00","002","0242","0205","756","616","140","38","794","1415","0","56.11","43.53"
"10","018","00","002","0242","0206","757","588","169","32","789","1305","0","60.46","45.06"
"10","018","00","002","0242","0207","654","540","114","28","682","1200","0","56.83","45.0"
"10","018","00","002","0243","0000","1245","976","269","76","1321","2128","0","62.08","45.86"
"10","018","00","002","0243","0201","684","528","156","40","724","1179","0","61.41","44.78"
"10","018","00","002","0243","0202","561","448","113","36","597","949","0","62.91","47.21"
"10","018","00","002","0244","0000","747","568","179","45","792","1604","0","49.38","35.41"
"10","018","00","002","0244","0150","747","568","179","45","792","1604","0","49.38","35.41"
"10","018","00","002","0245","0000","1855","1570","285","106","1961","3235","0","60.62","48.53"
"10","018","00","002","0245","0160","655","576","79","50","705","1222","0","57.69","47.14"
"10","018","00","002","0245","0161","618","510","108","27","645","1076","0","59.94","47.4"
"10","018","00","002","0245","0162","582","484","98","29","611","937","0","65.21","51.65"
"10","018","00","003","0000","0000","34035","26916","7119","2259","36294","64896","78305","55.93","41.48"
"10","018","00","003","0301","0000","1355","1066","289","149","1504","2513","0","59.85","42.42"
"10","018","00","003","0301","0271","592","474","118","66","658","1182","0","55.67","40.1"
"10","018","00","003","0301","0272","763","592","171","83","846","1331","0","63.56","44.48"
"10","018","00","003","0302","0000","2730","2119","611","170","2900","5255","0","55.19","40.32"
"10","018","00","003","0302","0266","559","431","128","47","606","1088","0","55.7","39.61"
"10","018","00","003","0302","0267","410","330","80","20","430","903","0","47.62","36.54"
"10","018","00","003","0302","0268","550","398","152","39","589","1012","0","58.2","39.33"
"10","018","00","003","0302","0269","539","422","117","36","575","1014","0","56.71","41.62"
"10","018","00","003","0302","0270","672","538","134","28","700","1238","0","56.54","43.46"
"10","018","00","003","0303","0000","1221","981","240","72","1293","2288","0","56.51","42.88"
"10","018","00","003","0303","0264","517","410","107","27","544","970","0","56.08","42.27"
"10","018","00","003","0303","0265","704","571","133","45","749","1318","0","56.83","43.32"
"10","018","00","003","0304","0000","1344","1074","270","137","1481","2371","0","62.46","45.3"
"10","018","00","003","0304","0262","721","581","140","79","800","1348","0","59.35","43.1"
"10","018","00","003","0304","0263","623","493","130","58","681","1023","0","66.57","48.19"
"10","018","00","003","0305","0000","1206","933","273","114","1320","2095","0","63.01","44.53"
"10","018","00","003","0305","0260","632","473","159","58","690","1138","0","60.63","41.56"
"10","018","00","003","0305","0261","574","460","114","56","630","957","0","65.83","48.07"
"10","018","00","003","0306","0000","1739","1380","359","117","1856","3128","0","59.34","44.12"
"10","018","00","003","0306","0257","566","450","116","20","586","1067","0","54.92","42.17"
"10","018","00","003","0306","0258","496","389","107","33","529","863","0","61.3","45.08"
"10","018","00","003","0306","0259","677","541","136","64","741","1198","0","61.85","45.16"
"10","018","00","003","0307","0000","1566","1257","309","74","1640","2881","0","56.92","43.63"
"10","018","00","003","0307","0252","801","628","173","51","852","1473","0","57.84","42.63"
"10","018","00","003","0307","0253","765","629","136","23","788","1408","0","55.97","44.67"
"10","018","00","003","0308","0000","2212","1774","438","117","2329","4517","0","51.56","39.27"
"10","018","00","003","0308","0254","587","467","120","30","617","1318","0","46.81","35.43"
"10","018","00","003","0308","0255","702","571","131","54","756","1337","0","56.54","42.71"
"10","018","00","003","0308","0256","923","736","187","33","956","1862","0","51.34","39.53"
"10","018","00","003","0309","0000","2567","2102","465","139","2706","4959","0","54.57","42.39"
"10","018","00","003","0309","0245","723","599","124","55","778","1443","0","53.92","41.51"
"10","018","00","003","0309","0246","645","502","143","40","685","1241","0","55.2","40.45"
"10","018","00","003","0309","0247","621","516","105","25","646","1194","0","54.1","43.22"
"10","018","00","003","0309","0248","578","485","93","19","597","1081","0","55.23","44.87"
"10","018","00","003","0310","0000","2186","1724","462","107","2293","3917","0","58.54","44.01"
"10","018","00","003","0310","0273","603","464","139","15","618","976","0","63.32","47.54"
"10","018","00","003","0310","0274","427","328","99","17","444","834","0","53.24","39.33"
"10","018","00","003","0310","0275","492","401","91","38","530","919","0","57.67","43.63"
"10","018","00","003","0310","0276","664","531","133","37","701","1188","0","59.01","44.7"
"10","018","00","003","0311","0000","1869","1466","403","125","1994","3342","0","59.66","43.87"
"10","018","00","003","0311","0277","586","439","147","39","625","1086","0","57.55","40.42"
"10","018","00","003","0311","0278","669","529","140","44","713","1144","0","62.33","46.24"
"10","018","00","003","0311","0279","614","498","116","42","656","1112","0","58.99","44.78"
"10","018","00","003","0312","0000","2344","1875","469","128","2472","4231","0","58.43","44.32"
"10","018","00","003","0312","0280","801","655","146","50","851","1476","0","57.66","44.38"
"10","018","00","003","0312","0281","690","560","130","29","719","1291","0","55.69","43.38"
"10","018","00","003","0312","0282","853","660","193","49","902","1464","0","61.61","45.08"
"10","018","00","003","0313","0000","1496","1197","299","103","1599","2763","0","57.87","43.32"
"10","018","00","003","0313","0283","781","638","143","70","851","1427","0","59.64","44.71"
"10","018","00","003","0313","0284","715","559","156","33","748","1336","0","55.99","41.84"
"10","018","00","003","0314","0000","622","390","232","34","656","1131","0","58.0","34.48"
"10","018","00","003","0314","0285","622","390","232","34","656","1131","0","58.0","34.48"
"10","018","00","003","0315","0000","1124","861","263","142","1266","2076","0","60.98","41.47"
"10","018","00","003","0315","0286","568","432","136","81","649","1070","0","60.65","40.37"
"10","018","00","003","0315","0287","556","429","127","61","617","1006","0","61.33","42.64"
"10","018","00","003","0316","0000","1103","874","229","61","1164","2342","0","49.7","37.32"
"10","018","00","003","0316","0288","526","425","101","33","559","1223","0","45.71","34.75"
"10","018","00","003","0316","0289","577","449","128","28","605","1119","0","54.07","40.13"
"10","018","00","003","0317","0000","421","345","76","25","446","896","0","49.78","38.5"
"10","018","00","003","0317","0299","421","345","76","25","446","896","0","49.78","38.5"
"10","018","00","003","0318","0000","471","381","90","41","512","890","0","57.53","42.81"
"10","018","00","003","0318","0298","471","381","90","41","512","890","0","57.53","42.81"
"10","018","00","003","0319","0000","406","323","83","24","430","776","0","55.41","41.62"
"10","018","00","003","0319","0297","406","323","83","24","430","776","0","55.41","41.62"
"10","018","00","003","0320","0000","848","656","192","49","897","1784","0","50.28","36.77"
"10","018","00","003","0320","0295","369","288","81","30","399","719","0","55.49","40.06"
"10","018","00","003","0320","0296","479","368","111","19","498","1065","0","46.76","34.55"
"10","018","00","003","0321","0000","1969","1561","408","145","2114","4325","0","48.88","36.09"
"10","018","00","003","0321","0291","714","566","148","38","752","1627","0","46.22","34.79"
"10","018","00","003","0321","0292","596","475","121","51","647","1289","0","50.19","36.85"
"10","018","00","003","0321","0293","659","520","139","56","715","1409","0","50.75","36.91"
"10","018","00","003","0322","0000","644","509","135","40","684","1400","0","48.86","36.36"
"10","018","00","003","0322","0290","644","509","135","40","684","1400","0","48.86","36.36"
"10","018","00","003","0323","0000","387","290","97","28","415","814","0","50.98","35.63"
"10","018","00","003","0323","0294","387","290","97","28","415","814","0","50.98","35.63"
"10","018","00","003","0324","0000","2205","1778","427","118","2323","4202","0","55.28","42.31"
"10","018","00","003","0324","0249","429","346","83","25","454","807","0","56.26","42.87"
"10","018","00","003","0324","0250","903","714","189","53","956","1760","0","54.32","40.57"
"10","018","00","003","0324","0251","873","718","155","40","913","1635","0","55.84","43.91"
"10","020","00","000","0000","0000","110566","84825","25741","7468","118034","221553","268741","53.28","38.29"
"10","020","00","001","0000","0000","50516","38093","12423","3289","53805","100647","121279","53.46","37.85"
"10","020","00","001","0101","0000","2194","1726","468","137","2331","4386","0","53.15","39.35"
"10","020","00","001","0101","0079","589","440","149","53","642","1282","0","50.08","34.32"
"10","020","00","001","0101","0080","874","710","164","54","928","1571","0","59.07","45.19"
"10","020","00","001","0101","0081","731","576","155","30","761","1533","0","49.64","37.57"
"10","020","00","001","0102","0000","1437","1125","312","65","1502","3393","0","44.27","33.16"
"10","020","00","001","0102","0077","718","570","148","30","748","1823","0","41.03","31.27"
"10","020","00","001","0102","0078","719","555","164","35","754","1570","0","48.03","35.35"
"10","020","00","001","0103","0000","1331","1053","278","65","1396","2832","0","49.29","37.18"
"10","020","00","001","0103","0075","592","458","134","24","616","1404","0","43.87","32.62"
"10","020","00","001","0103","0076","739","595","144","41","780","1428","0","54.62","41.67"
"10","020","00","001","0104","0000","1595","1195","400","138","1733","3249","0","53.34","36.78"
"10","020","00","001","0104","0069","805","571","234","71","876","1682","0","52.08","33.95"
"10","020","00","001","0104","0070","790","624","166","67","857","1567","0","54.69","39.82"
"10","020","00","001","0105","0000","1161","921","240","39","1200","2188","0","54.84","42.09"
"10","020","00","001","0105","0071","618","488","130","21","639","1207","0","52.94","40.43"
"10","020","00","001","0105","0072","543","433","110","18","561","981","0","57.19","44.14"
"10","020","00","001","0134","0000","2189","1707","482","142","2331","4205","0","55.43","40.59"
"10","020","00","001","0134","0021","605","459","146","52","657","1199","0","54.8","38.28"
"10","020","00","001","0134","0022","641","522","119","30","671","1236","0","54.29","42.23"
"10","020","00","001","0134","0023","449","352","97","21","470","890","0","52.81","39.55"
"10","020","00","001","0134","0024","494","374","120","39","533","880","0","60.57","42.5"
"10","020","00","001","0135","0000","2268","1723","545","141","2409","4172","0","57.74","41.3"
"10","020","00","001","0135","0018","863","645","218","45","908","1552","0","58.51","41.56"
"10","020","00","001","0135","0019","828","644","184","56","884","1558","0","56.74","41.34"
"10","020","00","001","0135","0020","577","434","143","40","617","1062","0","58.1","40.87"
"10","020","00","001","0136","0000","1929","1508","421","108","2037","3967","0","51.35","38.01"
"10","020","00","001","0136","0015","649","489","160","50","699","1453","0","48.11","33.65"
"10","020","00","001","0136","0016","532","423","109","22","554","1094","0","50.64","38.67"
"10","020","00","001","0136","0017","748","596","152","36","784","1420","0","55.21","41.97"
"10","020","00","001","0137","0000","1242","918","324","51","1293","2334","0","55.4","39.33"
"10","020","00","001","0137","0011","667","500","167","27","694","1221","0","56.84","40.95"
"10","020","00","001","0137","0012","575","418","157","24","599","1113","0","53.82","37.56"
"10","020","00","001","0138","0000","951","740","211","54","1005","1794","0","56.02","41.25"
"10","020","00","001","0138","0005","398","298","100","33","431","702","0","61.4","42.45"
"10","020","00","001","0138","0006","553","442","111","21","574","1092","0","52.56","40.48"
"10","020","00","001","0139","0000","2234","1721","513","115","2349","4239","0","55.41","40.6"
"10","020","00","001","0139","0027","736","569","167","44","780","1435","0","54.36","39.65"
"10","020","00","001","0139","0028","763","582","181","47","810","1349","0","60.04","43.14"
"10","020","00","001","0139","0029","735","570","165","24","759","1455","0","52.16","39.18"
"10","020","00","001","0141","0000","867","681","186","66","933","1816","0","51.38","37.5"
"10","020","00","001","0141","0008","867","681","186","66","933","1816","0","51.38","37.5"
"10","020","00","001","0142","0000","438","332","106","13","451","1023","0","44.09","32.45"
"10","020","00","001","0142","0007","438","332","106","13","451","1023","0","44.09","32.45"
"10","020","00","001","0143","0000","1585","1206","379","85","1670","2847","0","58.66","42.36"
"10","020","00","001","0143","0013","774","574","200","49","823","1452","0","56.68","39.53"
"10","020","00","001","0143","0014","811","632","179","36","847","1395","0","60.72","45.3"
"10","020","00","001","0144","0000","1179","931","248","53","1232","2301","0","53.54","40.46"
"10","020","00","001","0144","0001","541","427","114","30","571","1025","0","55.71","41.66"
"10","020","00","001","0144","0002","638","504","134","23","661","1276","0","51.8","39.5"
"10","020","00","001","0145","0000","1001","716","285","50","1051","1987","0","52.89","36.03"
"10","020","00","001","0145","0042","466","303","163","19","485","938","0","51.71","32.3"
"10","020","00","001","0145","0043","535","413","122","31","566","1049","0","53.96","39.37"
"10","020","00","001","0146","0000","636","469","167","69","705","1360","0","51.84","34.49"
"10","020","00","001","0146","0044","636","469","167","69","705","1360","0","51.84","34.49"
"10","020","00","001","0147","0000","683","464","219","99","782","1615","0","48.42","28.73"
"10","020","00","001","0147","0045","683","464","219","99","782","1615","0","48.42","28.73"
"10","020","00","001","0148","0000","620","464","156","52","672","1267","0","53.04","36.62"
"10","020","00","001","0148","0046","620","464","156","52","672","1267","0","53.04","36.62"
"10","020","00","001","0149","0000","1540","1167","373","150","1690","3410","0","49.56","34.22"
"10","020","00","001","0149","0047","682","515","167","70","752","1579","0","47.63","32.62"
"10","020","00","001","0149","0048","858","652","206","80","938","1831","0","51.23","35.61"
"10","020","00","001","0150","0000","1080","813","267","64","1144","2146","0","53.31","37.88"
"10","020","00","001","0150","0049","520","400","120","33","553","977","0","56.6","40.94"
"10","020","00","001","0150","0050","560","413","147","31","591","1169","0","50.56","35.33"
"10","020","00","001","0151","0000","1328","998","330","91","1419","2504","0","56.67","39.86"
"10","020","00","001","0151","0051","660","479","181","77","737","1238","0","59.53","38.69"
"10","020","00","001","0151","0052","668","519","149","14","682","1266","0","53.87","41.0"
"10","020","00","001","0152","0000","1287","1018","269","62","1349","2717","0","49.65","37.47"
"10","020","00","001","0152","0053","621","490","131","40","661","1429","0","46.26","34.29"
"10","020","00","001","0152","0054","666","528","138","22","688","1288","0","53.42","40.99"
"10","020","00","001","0153","0000","1232","947","285","109","1341","2347","0","57.14","40.35"
"10","020","00","001","0153","0060","557","429","128","46","603","1170","0","51.54","36.67"
"10","020","00","001","0153","0061","675","518","157","63","738","1177","0","62.7","44.01"
"10","020","00","001","0154","0000","2033","1581","452","117","2150","3893","0","55.23","40.61"
"10","020","00","001","0154","0057","613","458","155","49","662","1133","0","58.43","40.42"
"10","020","00","001","0154","0058","657","517","140","50","707","1235","0","57.25","41.86"
"10","020","00","001","0154","0059","763","606","157","18","781","1525","0","51.21","39.74"
"10","020","00","001","0155","0000","1877","1435","442","201","2078","3667","0","56.67","39.13"
"10","020","00","001","0155","0062","623","470","153","60","683","1207","0","56.59","38.94"
"10","020","00","001","0155","0063","670","533","137","53","723","1272","0","56.84","41.9"
"10","020","00","001","0155","0064","584","432","152","88","672","1188","0","56.57","36.36"
"10","020","00","001","0156","0000","1112","845","267","146","1258","2101","0","59.88","40.22"
"10","020","00","001","0156","0040","555","442","113","59","614","1023","0","60.02","43.21"
"10","020","00","001","0156","0041","557","403","154","87","644","1078","0","59.74","37.38"
"10","020","00","001","0157","0000","832","632","200","87","919","1824","0","50.38","34.65"
"10","020","00","001","0157","0038","504","388","116","61","565","961","0","58.79","40.37"
"10","020","00","001","0157","0039","328","244","84","26","354","863","0","41.02","28.27"
"10","020","00","001","0158","0000","948","698","250","53","1001","2058","0","48.64","33.92"
"10","020","00","001","0158","0036","427","318","109","26","453","967","0","46.85","32.89"
"10","020","00","001","0158","0037","521","380","141","27","548","1091","0","50.23","34.83"
"10","020","00","001","0159","0000","998","745","253","78","1076","2021","0","53.24","36.86"
"10","020","00","001","0159","0032","474","359","115","55","529","941","0","56.22","38.15"
"10","020","00","001","0159","0033","524","386","138","23","547","1080","0","50.65","35.74"
"10","020","00","001","0160","0000","980","704","276","58","1038","1867","0","55.6","37.71"
"10","020","00","001","0160","0030","494","368","126","32","526","915","0","57.49","40.22"
"10","020","00","001","0160","0031","486","336","150","26","512","952","0","53.78","35.29"
"10","020","00","001","0161","0000","968","735","233","39","1007","1858","0","54.2","39.56"
"10","020","00","001","0161","0025","610","466","144","17","627","1189","0","52.73","39.19"
"10","020","00","001","0161","0026","358","269","89","22","380","669","0","56.8","40.21"
"10","020","00","001","0162","0000","1089","811","278","55","1144","2210","0","51.76","36.7"
"10","020","00","001","0162","0034","514","381","133","24","538","1157","0","46.5","32.93"
"10","020","00","001","0162","0035","575","430","145","31","606","1053","0","57.55","40.84"
"10","020","00","001","0163","0000","1282","974","308","92","1374","2343","0","58.64","41.57"
"10","020","00","001","0163","0067","697","534","163","55","752","1332","0","56.46","40.09"
"10","020","00","001","0163","0068","585","440","145","37","622","1011","0","61.52","43.52"
"10","020","00","001","0164","0000","1102","844","258","66","1168","2192","0","53.28","38.5"
"10","020","00","001","0164","0065","549","418","131","25","574","1172","0","48.98","35.67"
"10","020","00","001","0164","0066","553","426","127","41","594","1020","0","58.24","41.76"
"10","020","00","001","0165","0000","1130","863","267","83","1213","2149","0","56.44","40.16"
"10","020","00","001","0165","0003","457","348","109","38","495","974","0","50.82","35.73"
"10","020","00","001","0165","0004","673","515","158","45","718","1175","0","61.11","43.83"
"10","020","00","001","0166","0000","1905","951","954","79","1984","3634","0","54.6","26.17"
"10","020","00","001","0166","0009","1002","261","741","52","1054","1936","0","54.44","13.48"
"10","020","00","001","0166","0010","903","690","213","27","930","1698","0","54.77","40.64"
"10","020","00","001","0167","0000","949","725","224","56","1005","1902","0","52.84","38.12"
"10","020","00","001","0167","0055","509","391","118","29","538","980","0","54.9","39.9"
"10","020","00","001","0167","0056","440","334","106","27","467","922","0","50.65","36.23"
"10","020","00","001","0168","0000","1304","1007","297","61","1365","2829","0","48.25","35.6"
"10","020","00","001","0168","0073","683","534","149","39","722","1395","0","51.76","38.28"
"10","020","00","001","0168","0074","621","473","148","22","643","1434","0","44.84","32.98"
"10","020","00","002","0000","0000","60050","46732","13318","4179","64229","120906","147462","53.12","38.65"
"10","020","00","002","0201","0000","395","286","109","50","445","770","0","57.79","37.14"
"10","020","00","002","0201","0152","395","286","109","50","445","770","0","57.79","37.14"
"10","020","00","002","0202","0000","990","748","242","66","1056","2071","0","50.99","36.12"
"10","020","00","002","0202","0157","462","350","112","37","499","997","0","50.05","35.11"
"10","020","00","002","0202","0158","528","398","130","29","557","1074","0","51.86","37.06"
"10","020","00","002","0203","0000","1194","931","263","97","1291","2257","0","57.2","41.25"
"10","020","00","002","0203","0148","602","483","119","71","673","1146","0","58.73","42.15"
"10","020","00","002","0203","0149","592","448","144","26","618","1111","0","55.63","40.32"
"10","020","00","002","0205","0000","831","581","250","99","930","1970","0","47.21","29.49"
"10","020","00","002","0205","0153","459","310","149","16","475","1135","0","41.85","27.31"
"10","020","00","002","0205","0154","372","271","101","83","455","835","0","54.49","32.46"
"10","020","00","002","0209","0000","2017","1552","465","96","2113","4311","0","49.01","36.0"
"10","020","00","002","0209","0159","601","460","141","21","622","1460","0","42.6","31.51"
"10","020","00","002","0209","0160","651","508","143","30","681","1352","0","50.37","37.57"
"10","020","00","002","0209","0161","765","584","181","45","810","1499","0","54.04","38.96"
"10","020","00","002","0210","0000","2103","1607","496","263","2366","4132","0","57.26","38.89"
"10","020","00","002","0210","0168","738","550","188","114","852","1467","0","58.08","37.49"
"10","020","00","002","0210","0169","673","509","164","71","744","1431","0","51.99","35.57"
"10","020","00","002","0210","0170","692","548","144","78","770","1234","0","62.4","44.41"
"10","020","00","002","0211","0000","1519","1225","294","27","1546","3214","0","48.1","38.11"
"10","020","00","002","0211","0165","786","656","130","1","787","1674","0","47.01","39.19"
"10","020","00","002","0211","0166","733","569","164","26","759","1540","0","49.29","36.95"
"10","020","00","002","0212","0000","1434","1056","378","117","1551","2868","0","54.08","36.82"
"10","020","00","002","0212","0175","814","583","231","87","901","1546","0","58.28","37.71"
"10","020","00","002","0212","0176","620","473","147","30","650","1322","0","49.17","35.78"
"10","020","00","002","0213","0000","780","584","196","88","868","1549","0","56.04","37.7"
"10","020","00","002","0213","0177","780","584","196","88","868","1549","0","56.04","37.7"
"10","020","00","002","0214","0000","513","398","115","20","533","1155","0","46.15","34.46"
"10","020","00","002","0214","0174","513","398","115","20","533","1155","0","46.15","34.46"
"10","020","00","002","0215","0000","1107","856","251","91","1198","2120","0","56.51","40.38"
"10","020","00","002","0215","0093","579","440","139","64","643","1053","0","61.06","41.79"
"10","020","00","002","0215","0094","528","416","112","27","555","1067","0","52.01","38.99"
"10","020","00","002","0216","0000","1896","1466","430","158","2054","4105","0","50.04","35.71"
"10","020","00","002","0216","0097","538","432","106","47","585","1196","0","48.91","36.12"
"10","020","00","002","0216","0098","566","431","135","25","591","1280","0","46.17","33.67"
"10","020","00","002","0216","0099","792","603","189","86","878","1629","0","53.9","37.02"
"10","020","00","002","0217","0000","1558","1234","324","136","1694","3195","0","53.02","38.62"
"10","020","00","002","0217","0110","652","503","149","67","719","1396","0","51.5","36.03"
"10","020","00","002","0217","0111","906","731","175","69","975","1799","0","54.2","40.63"
"10","020","00","002","0218","0000","1532","1232","300","86","1618","3440","0","47.03","35.81"
"10","020","00","002","0218","0095","614","533","81","33","647","1575","0","41.08","33.84"
"10","020","00","002","0218","0096","918","699","219","53","971","1865","0","52.06","37.48"
"10","020","00","002","0219","0000","1862","1453","409","89","1951","3351","0","58.22","43.36"
"10","020","00","002","0219","0105","573","456","117","26","599","1000","0","59.9","45.6"
"10","020","00","002","0219","0106","601","469","132","24","625","1095","0","57.08","42.83"
"10","020","00","002","0219","0107","688","528","160","39","727","1256","0","57.88","42.04"
"10","020","00","002","0220","0000","1019","803","216","67","1086","1827","0","59.44","43.95"
"10","020","00","002","0220","0108","514","425","89","45","559","962","0","58.11","44.18"
"10","020","00","002","0220","0109","505","378","127","22","527","865","0","60.92","43.7"
"10","020","00","002","0221","0000","3080","2465","615","143","3223","6594","0","48.88","37.38"
"10","020","00","002","0221","0112","693","565","128","34","727","1505","0","48.31","37.54"
"10","020","00","002","0221","0113","819","661","158","65","884","1698","0","52.06","38.93"
"10","020","00","002","0221","0114","921","727","194","27","948","1854","0","51.13","39.21"
"10","020","00","002","0221","0115","647","512","135","17","664","1537","0","43.2","33.31"
"10","020","00","002","0222","0000","993","757","236","86","1079","2024","0","53.31","37.4"
"10","020","00","002","0222","0103","447","331","116","78","525","841","0","62.43","39.36"
"10","020","00","002","0222","0104","546","426","120","8","554","1183","0","46.83","36.01"
"10","020","00","002","0231","0000","978","734","244","84","1062","1994","0","53.26","36.81"
"10","020","00","002","0231","0082","434","323","111","25","459","885","0","51.86","36.5"
"10","020","00","002","0231","0083","544","411","133","59","603","1109","0","54.37","37.06"
"10","020","00","002","0245","0000","893","722","171","52","945","1625","0","58.15","44.43"
"10","020","00","002","0245","0140","437","336","101","37","474","756","0","62.7","44.44"
"10","020","00","002","0245","0141","456","386","70","15","471","869","0","54.2","44.42"
"10","020","00","002","0246","0000","896","703","193","43","939","1904","0","49.32","36.92"
"10","020","00","002","0246","0138","333","259","74","22","355","736","0","48.23","35.19"
"10","020","00","002","0246","0139","563","444","119","21","584","1168","0","50.0","38.01"
"10","020","00","002","0247","0000","2981","2368","613","216","3197","5706","0","56.03","41.5"
"10","020","00","002","0247","0134","793","637","156","74","867","1548","0","56.01","41.15"
"10","020","00","002","0247","0135","647","502","145","35","682","1295","0","52.66","38.76"
"10","020","00","002","0247","0136","742","581","161","55","797","1318","0","60.47","44.08"
"10","020","00","002","0247","0137","799","648","151","52","851","1545","0","55.08","41.94"
"10","020","00","002","0248","0000","2828","2211","617","175","3003","5397","0","55.64","40.97"
"10","020","00","002","0248","0130","723","594","129","28","751","1185","0","63.38","50.13"
"10","020","00","002","0248","0131","707","527","180","59","766","1278","0","59.94","41.24"
"10","020","00","002","0248","0132","587","467","120","33","620","1394","0","44.48","33.5"
"10","020","00","002","0248","0133","811","623","188","55","866","1540","0","56.23","40.45"
"10","020","00","002","0249","0000","2313","1805","508","86","2399","4343","0","55.24","41.56"
"10","020","00","002","0249","0120","692","532","160","49","741","1362","0","54.41","39.06"
"10","020","00","002","0249","0121","685","514","171","36","721","1279","0","56.37","40.19"
"10","020","00","002","0249","0122","936","759","177","1","937","1702","0","55.05","44.59"
"10","020","00","002","0250","0000","1999","1641","358","199","2198","3715","0","59.17","44.17"
"10","020","00","002","0250","0117","530","400","130","65","595","944","0","63.03","42.37"
"10","020","00","002","0250","0118","847","769","78","84","931","1627","0","57.22","47.26"
"10","020","00","002","0250","0119","622","472","150","50","672","1144","0","58.74","41.26"
"10","020","00","002","0251","0000","964","751","213","83","1047","1811","0","57.81","41.47"
"10","020","00","002","0251","0142","530","410","120","48","578","983","0","58.8","41.71"
"10","020","00","002","0251","0143","434","341","93","35","469","828","0","56.64","41.18"
"10","020","00","002","0252","0000","935","776","159","44","979","1775","0","55.15","43.72"
"10","020","00","002","0252","0144","935","776","159","44","979","1775","0","55.15","43.72"
"10","020","00","002","0253","0000","2599","2063","536","146","2745","4992","0","54.99","41.33"
"10","020","00","002","0253","0126","721","571","150","38","759","1280","0","59.3","44.61"
"10","020","00","002","0253","0127","556","437","119","32","588","1220","0","48.2","35.82"
"10","020","00","002","0253","0128","634","524","110","33","667","1172","0","56.91","44.71"
"10","020","00","002","0253","0129","688","531","157","43","731","1320","0","55.38","40.23"
"10","020","00","002","0254","0000","694","594","100","44","738","1419","0","52.01","41.86"
"10","020","00","002","0254","0145","694","594","100","44","738","1419","0","52.01","41.86"
"10","020","00","002","0255","0000","741","553","188","77","818","1604","0","51.0","34.48"
"10","020","00","002","0255","0116","741","553","188","77","818","1604","0","51.0","34.48"
"10","020","00","002","0256","0000","975","736","239","96","1071","1945","0","55.06","37.84"
"10","020","00","002","0256","0084","452","336","116","43","495","1020","0","48.53","32.94"
"10","020","00","002","0256","0085","523","400","123","53","576","925","0","62.27","43.24"
"10","020","00","002","0257","0000","682","471","211","40","722","1671","0","43.21","28.19"
"10","020","00","002","0257","0086","682","471","211","40","722","1671","0","43.21","28.19"
"10","020","00","002","0258","0000","1114","881","233","52","1166","2251","0","51.8","39.14"
"10","020","00","002","0258","0087","619","484","135","26","645","1215","0","53.09","39.84"
"10","020","00","002","0258","0088","495","397","98","26","521","1036","0","50.29","38.32"
"10","020","00","002","0259","0000","976","807","169","59","1035","2256","0","45.88","35.77"
"10","020","00","002","0259","0089","534","388","146","30","564","1129","0","49.96","34.37"
"10","020","00","002","0259","0090","442","419","23","29","471","1127","0","41.79","37.18"
"10","020","00","002","0260","0000","655","521","134","27","682","1366","0","49.93","38.14"
"10","020","00","002","0260","0092","655","521","134","27","682","1366","0","49.93","38.14"
"10","020","00","002","0261","0000","689","514","175","51","740","1415","0","52.3","36.33"
"10","020","00","002","0261","0091","689","514","175","51","740","1415","0","52.3","36.33"
"10","020","00","002","0262","0000","767","596","171","34","801","1634","0","49.02","36.47"
"10","020","00","002","0262","0146","372","282","90","18","390","779","0","50.06","36.2"
"10","020","00","002","0262","0147","395","314","81","16","411","855","0","48.07","36.73"
"10","020","00","002","0263","0000","797","592","205","77","874","1584","0","55.18","37.37"
"10","020","00","002","0263","0150","441","330","111","51","492","767","0","64.15","43.02"
"10","020","00","002","0263","0151","356","262","94","26","382","817","0","46.76","32.07"
"10","020","00","002","0264","0000","921","697","224","76","997","2126","0","46.9","32.78"
"10","020","00","002","0264","0155","524","405","119","36","560","1182","0","47.38","34.26"
"10","020","00","002","0264","0156","397","292","105","40","437","944","0","46.29","30.93"
"10","020","00","002","0265","0000","2045","1562","483","167","2212","4164","0","53.12","37.51"
"10","020","00","002","0265","0100","716","554","162","72","788","1393","0","56.57","39.77"
"10","020","00","002","0265","0101","573","428","145","53","626","1077","0","58.12","39.74"
"10","020","00","002","0265","0102","756","580","176","42","798","1694","0","47.11","34.24"
"10","020","00","002","0266","0000","1505","1157","348","117","1622","2718","0","59.68","42.57"
"10","020","00","002","0266","0123","743","575","168","50","793","1358","0","58.39","42.34"
"10","020","00","002","0266","0124","762","582","180","67","829","1360","0","60.96","42.79"
"10","020","00","002","0267","0000","842","662","180","51","893","1589","0","56.2","41.66"
"10","020","00","002","0267","0125","842","662","180","51","893","1589","0","56.2","41.66"
"10","020","00","002","0268","0000","1869","1476","393","65","1934","3598","0","53.75","41.02"
"10","020","00","002","0268","0171","630","505","125","13","643","1266","0","50.79","39.89"
"10","020","00","002","0268","0172","632","492","140","28","660","1211","0","54.5","40.63"
"10","020","00","002","0268","0173","607","479","128","24","631","1121","0","56.29","42.73"
"10","020","00","002","0269","0000","2002","1475","527","209","2211","4295","0","51.48","34.34"
"10","020","00","002","0269","0162","591","413","178","102","693","1262","0","54.91","32.73"
"10","020","00","002","0269","0163","620","458","162","43","663","1299","0","51.04","35.26"
"10","020","00","002","0269","0164","791","604","187","64","855","1734","0","49.31","34.83"
"10","020","00","002","0270","0000","567","430","137","30","597","1056","0","56.53","40.72"
"10","020","00","002","0270","0167","567","430","137","30","597","1056","0","56.53","40.72"
"09","020","00","000","0000","0000","40638","33982","6656","3092","43730","122695","138845","35.64","27.7"
"09","020","00","001","0000","0000","12311","10357","1954","872","13183","37815","43315","34.86","27.39"
"09","020","00","001","0101","0000","1686","1391","295","132","1818","4977","0","36.53","27.95"
"09","020","00","001","0101","0001","467","400","67","25","492","1396","0","35.24","28.65"
"09","020","00","001","0101","0002","628","504","124","60","688","1831","0","37.58","27.53"
"09","020","00","001","0101","0003","591","487","104","47","638","1750","0","36.46","27.83"
"09","020","00","001","0102","0000","3381","2854","527","211","3592","9882","0","36.35","28.88"
"09","020","00","001","0102","0007","494","395","99","62","556","1610","0","34.53","24.53"
"09","020","00","001","0102","0008","569","484","85","33","602","1687","0","35.68","28.69"
"09","020","00","001","0102","0009","553","474","79","27","580","1594","0","36.39","29.74"
"09","020","00","001","0102","0010","571","488","83","27","598","1726","0","34.65","28.27"
"09","020","00","001","0102","0011","598","505","93","33","631","1733","0","36.41","29.14"
"09","020","00","001","0102","0012","596","508","88","29","625","1532","0","40.8","33.16"
"09","020","00","001","0103","0000","1897","1607","290","138","2035","5465","0","37.24","29.41"
"09","020","00","001","0103","0004","664","570","94","54","718","1889","0","38.01","30.17"
"09","020","00","001","0103","0005","501","411","90","36","537","1675","0","32.06","24.54"
"09","020","00","001","0103","0006","732","626","106","48","780","1901","0","41.03","32.93"
"09","020","00","001","0104","0000","1272","1083","189","98","1370","4112","0","33.32","26.34"
"09","020","00","001","0104","0013","662","554","108","59","721","2079","0","34.68","26.65"
"09","020","00","001","0104","0014","610","529","81","39","649","2033","0","31.92","26.02"
"09","020","00","001","0105","0000","949","788","161","103","1052","3788","0","27.77","20.8"
"09","020","00","001","0105","0018","647","549","98","60","707","2435","0","29.03","22.55"
"09","020","00","001","0105","0019","302","239","63","43","345","1353","0","25.5","17.66"
"09","020","00","001","0106","0000","693","586","107","41","734","2140","0","34.3","27.38"
"09","020","00","001","0106","0017","693","586","107","41","734","2140","0","34.3","27.38"
"09","020","00","001","0107","0000","914","770","144","60","974","2851","0","34.16","27.01"
"09","020","00","001","0107","0020","474","398","76","22","496","1574","0","31.51","25.29"
"09","020","00","001","0107","0021","440","372","68","38","478","1277","0","37.43","29.13"
"09","020","00","001","0108","0000","1519","1278","241","89","1608","4600","0","34.96","27.78"
"09","020","00","001","0108","0015","836","709","127","46","882","2517","0","35.04","28.17"
"09","020","00","001","0108","0016","683","569","114","43","726","2083","0","34.85","27.32"
"09","020","00","002","0000","0000","6017","5110","907","545","6562","18560","20751","35.36","27.53"
"09","020","00","002","0201","0000","1667","1423","244","158","1825","5106","0","35.74","27.87"
"09","020","00","002","0201","0066","603","505","98","52","655","1909","0","34.31","26.45"
"09","020","00","002","0201","0067","574","487","87","51","625","1524","0","41.01","31.96"
"09","020","00","002","0201","0068","490","431","59","55","545","1673","0","32.58","25.76"
"09","020","00","002","0202","0000","654","581","73","47","701","1895","0","36.99","30.66"
"09","020","00","002","0202","0075","654","581","73","47","701","1895","0","36.99","30.66"
"09","020","00","002","0203","0000","429","357","72","34","463","1135","0","40.79","31.45"
"09","020","00","002","0203","0076","429","357","72","34","463","1135","0","40.79","31.45"
"09","020","00","002","0204","0000","832","717","115","65","897","2377","0","37.74","30.16"
"09","020","00","002","0204","0077","396","336","60","39","435","1252","0","34.74","26.84"
"09","020","00","002","0204","0078","436","381","55","26","462","1125","0","41.07","33.87"
"09","020","00","002","0205","0000","587","502","85","73","660","2003","0","32.95","25.06"
"09","020","00","002","0205","0069","587","502","85","73","660","2003","0","32.95","25.06"
"09","020","00","002","0206","0000","436","371","65","43","479","1540","0","31.1","24.09"
"09","020","00","002","0206","0072","436","371","65","43","479","1540","0","31.1","24.09"
"09","020","00","002","0207","0000","573","480","93","61","634","2166","0","29.27","22.16"
"09","020","00","002","0207","0073","339","280","59","37","376","1216","0","30.92","23.03"
"09","020","00","002","0207","0074","234","200","34","24","258","950","0","27.16","21.05"
"09","020","00","002","0208","0000","839","679","160","64","903","2338","0","38.62","29.04"
"09","020","00","002","0208","0070","463","382","81","30","493","1212","0","40.68","31.52"
"09","020","00","002","0208","0071","376","297","79","34","410","1126","0","36.41","26.38"
"09","020","00","003","0000","0000","8646","7148","1498","730","9376","25915","29658","36.18","27.58"
"09","020","00","003","0301","0000","1491","1230","261","137","1628","4137","0","39.35","29.73"
"09","020","00","003","0301","0049","492","401","91","48","540","1348","0","40.06","29.75"
"09","020","00","003","0301","0050","439","348","91","45","484","1386","0","34.92","25.11"
"09","020","00","003","0301","0051","560","481","79","44","604","1403","0","43.05","34.28"
"09","020","00","003","0302","0000","1134","955","179","99","1233","3264","0","37.78","29.26"
"09","020","00","003","0302","0052","633","540","93","40","673","1771","0","38.0","30.49"
"09","020","00","003","0302","0053","501","415","86","59","560","1493","0","37.51","27.8"
"09","020","00","003","0303","0000","802","661","141","81","883","2618","0","33.73","25.25"
"09","020","00","003","0303","0062","376","314","62","36","412","1236","0","33.33","25.4"
"09","020","00","003","0303","0063","426","347","79","45","471","1382","0","34.08","25.11"
"09","020","00","003","0304","0000","606","510","96","60","666","2006","0","33.2","25.42"
"09","020","00","003","0304","0056","606","510","96","60","666","2006","0","33.2","25.42"
"09","020","00","003","0305","0000","969","826","143","85","1054","3145","0","33.51","26.26"
"09","020","00","003","0305","0064","518","452","66","42","560","1631","0","34.33","27.71"
"09","020","00","003","0305","0065","451","374","77","43","494","1514","0","32.63","24.7"
"09","020","00","003","0306","0000","2710","2168","542","159","2869","7628","0","37.61","28.42"
"09","020","00","003","0306","0057","617","431","186","26","643","1780","0","36.12","24.21"
"09","020","00","003","0306","0058","604","516","88","31","635","1739","0","36.52","29.67"
"09","020","00","003","0306","0059","446","374","72","32","478","1384","0","34.54","27.02"
"09","020","00","003","0306","0060","491","397","94","37","528","1400","0","37.71","28.36"
"09","020","00","003","0306","0061","552","450","102","33","585","1325","0","44.15","33.96"
"09","020","00","003","0307","0000","471","399","72","64","535","1510","0","35.43","26.42"
"09","020","00","003","0307","0054","471","399","72","64","535","1510","0","35.43","26.42"
"09","020","00","003","0308","0000","463","399","64","45","508","1607","0","31.61","24.83"
"09","020","00","003","0308","0055","463","399","64","45","508","1607","0","31.61","24.83"
"09","020","00","004","0000","0000","9539","7833","1706","651","10190","28162","31588","36.18","27.81"
"09","020","00","004","0401","0000","915","755","160","110","1025","3272","0","31.33","23.07"
"09","020","00","004","0401","0022","465","388","77","76","541","1735","0","31.18","22.36"
"09","020","00","004","0401","0023","450","367","83","34","484","1537","0","31.49","23.88"
"09","020","00","004","0402","0000","1463","1214","249","113","1576","4507","0","34.97","26.94"
"09","020","00","004","0402","0024","548","445","103","43","591","1766","0","33.47","25.2"
"09","020","00","004","0402","0025","358","303","55","17","375","1015","0","36.95","29.85"
"09","020","00","004","0402","0026","557","466","91","53","610","1726","0","35.34","27.0"
"09","020","00","004","0403","0000","471","394","77","34","505","1537","0","32.86","25.63"
"09","020","00","004","0403","0038","471","394","77","34","505","1537","0","32.86","25.63"
"09","020","00","004","0404","0000","2612","2134","478","147","2759","7318","0","37.7","29.16"
"09","020","00","004","0404","0027","496","414","82","36","532","1691","0","31.46","24.48"
"09","020","00","004","0404","0028","823","586","237","42","865","2044","0","42.32","28.67"
"09","020","00","004","0404","0029","726","636","90","38","764","1848","0","41.34","34.42"
"09","020","00","004","0404","0030","567","498","69","31","598","1735","0","34.47","28.7"
"09","020","00","004","0405","0000","1638","1361","277","122","1760","5157","0","34.13","26.39"
"09","020","00","004","0405","0031","587","487","100","40","627","1795","0","34.93","27.13"
"09","020","00","004","0405","0032","530","441","89","51","581","1834","0","31.68","24.05"
"09","020","00","004","0405","0033","521","433","88","31","552","1528","0","36.13","28.34"
"09","020","00","004","0406","0000","2440","1975","465","125","2565","6371","0","40.26","31.0"
"09","020","00","004","0406","0034","542","470","72","26","568","1473","0","38.56","31.91"
"09","020","00","004","0406","0035","548","473","75","51","599","1679","0","35.68","28.17"
"09","020","00","004","0406","0036","901","661","240","30","931","1921","0","48.46","34.41"
"09","020","00","004","0406","0037","449","371","78","18","467","1298","0","35.98","28.58"
"09","020","00","005","0000","0000","3971","3399","572","283","4254","11676","12847","36.43","29.11"
"09","020","00","005","0501","0000","968","834","134","62","1030","2841","0","36.25","29.36"
"09","020","00","005","0501","0045","501","426","75","24","525","1412","0","37.18","30.17"
"09","020","00","005","0501","0046","467","408","59","38","505","1429","0","35.34","28.55"
"09","020","00","005","0502","0000","447","374","73","39","486","1425","0","34.11","26.25"
"09","020","00","005","0502","0044","447","374","73","39","486","1425","0","34.11","26.25"
"09","020","00","005","0503","0000","729","609","120","66","795","2395","0","33.19","25.43"
"09","020","00","005","0503","0042","400","334","66","40","440","1296","0","33.95","25.77"
"09","020","00","005","0503","0043","329","275","54","26","355","1099","0","32.3","25.02"
"09","020","00","005","0504","0000","1267","1110","157","72","1339","3380","0","39.62","32.84"
"09","020","00","005","0504","0039","684","604","80","38","722","1647","0","43.84","36.67"
"09","020","00","005","0504","0040","583","506","77","34","617","1733","0","35.6","29.2"
"09","020","00","005","0505","0000","560","472","88","44","604","1635","0","36.94","28.87"
"09","020","00","005","0505","0041","560","472","88","44","604","1635","0","36.94","28.87"
"09","020","00","006","0000","0000","154","135","19","11","165","567","686","29.1","23.81"
"09","020","00","006","0601","0000","74","64","10","4","78","275","0","28.36","23.27"
"09","020","00","006","0601","0047","74","64","10","4","78","275","0","28.36","23.27"
"09","020","00","006","0602","0000","80","71","9","7","87","292","0","29.79","24.32"
"09","020","00","006","0602","0048","80","71","9","7","87","292","0","29.79","24.32"
"09","007","00","000","0000","0000","5487","4751","736","248","5735","11205","13062","51.18","42.4"
"09","007","00","001","0000","0000","3142","2746","396","132","3274","6461","7657","50.67","42.5"
"09","007","00","001","0101","0000","963","837","126","50","1013","1967","0","51.5","42.55"
"09","007","00","001","0101","0001","963","837","126","50","1013","1967","0","51.5","42.55"
"09","007","00","001","01x2","0000","838","727","111","40","878","1837","0","47.8","39.58"
"09","007","00","001","01x2","0002","838","727","111","40","878","1837","0","47.8","39.58"
"09","007","00","001","01x4","0000","568","476","92","21","589","1114","0","52.87","42.73"
"09","007","00","001","01x4","0003","568","476","92","21","589","1114","0","52.87","42.73"
"09","007","00","001","01x5","0000","773","706","67","21","794","1543","0","51.46","45.76"
"09","007","00","001","01x5","0004","773","706","67","21","794","1543","0","51.46","45.76"
"09","007","00","002","0000","0000","1050","888","162","53","1103","2125","2430","51.91","41.79"
"09","007","00","002","02x1","0000","770","640","130","45","815","1515","0","53.8","42.24"
"09","007","00","002","02x1","0005","770","640","130","45","815","1515","0","53.8","42.24"
"09","007","00","002","02x4","0000","280","248","32","8","288","610","0","47.21","40.66"
"09","007","00","002","02x4","0006","280","248","32","8","288","610","0","47.21","40.66"
"09","007","00","003","0000","0000","732","620","112","45","777","1481","1627","52.46","41.86"
"09","007","00","003","03x1","0000","318","270","48","17","335","698","0","47.99","38.68"
"09","007","00","003","03x1","0007","318","270","48","17","335","698","0","47.99","38.68"
"09","007","00","003","03x4","0000","414","350","64","28","442","783","0","56.45","44.7"
"09","007","00","003","03x4","0008","414","350","64","28","442","783","0","56.45","44.7"
"09","007","00","004","0000","0000","563","497","66","18","581","1138","1348","51.05","43.67"
"09","007","00","004","04x1","0000","563","497","66","18","581","1138","0","51.05","43.67"
"09","007","00","004","04x1","0009","563","497","66","18","581","1138","0","51.05","43.67"
