"prv_code","city_code","area_code","dept_code","li_code","tbox_no","valid_ticket","agree_ticket","disagree_ticket","invalid_ticket","vote_ticket","votable_population","population","vote_to_votable","agree_to_votable"
"00","000","00","000","0000","0000","8071920","3951677","4120243","73273","8145193","19825468","23470633","41.08","19.93"
"63","000","00","000","0000","0000","1005769","539747","466022","8674","1014443","2155416","2562738","47.06","25.04"
"63","000","00","010","0000","0000","79896","44533","35363","662","80558","162964","196890","49.43","27.33"
"63","000","00","010","0002","0000","2011","1119","892","21","2032","4467","0","45.49","25.05"
"63","000","00","010","0002","0001","532","291","241","4","536","1074","0","49.91","27.09"
"63","000","00","010","0002","0002","493","269","224","7","500","1138","0","43.94","23.64"
"63","000","00","010","0002","0003","427","238","189","4","431","1083","0","39.80","21.98"
"63","000","00","010","0002","0004","559","321","238","6","565","1172","0","48.21","27.39"
"63","000","00","010","0003","0000","3395","1778","1617","19","3414","6468","0","52.78","27.49"
"63","000","00","010","0003","0005","675","358","317","4","679","1294","0","52.47","27.67"
"63","000","00","010","0003","0006","726","424","302","6","732","1334","0","54.87","31.78"
"63","000","00","010","0003","0007","663","342","321","1","664","1290","0","51.47","26.51"
"63","000","00","010","0003","0008","654","324","330","4","658","1215","0","54.16","26.67"
"63","000","00","010","0003","0009","677","330","347","4","681","1335","0","51.01","24.72"
"63","000","00","010","0004","0000","2933","1693","1240","16","2949","5723","0","51.53","29.58"
"63","000","00","010","0004","0010","600","322","278","4","604","1071","0","56.40","30.07"
"63","000","00","010","0004","0011","571","360","211","1","572","1149","0","49.78","31.33"
"63","000","00","010","0004","0012","565","304","261","0","565","1092","0","51.74","27.84"
"63","000","00","010","0004","0013","585","353","232","8","593","1142","0","51.93","30.91"
"63","000","00","010","0004","0014","612","354","258","3","615","1269","0","48.46","27.90"
"63","000","00","010","0005","0000","1996","1066","930","9","2005","3881","0","51.66","27.47"
"63","000","00","010","0005","0015","680","392","288","4","684","1319","0","51.86","29.72"
"63","000","00","010","0005","0016","664","343","321","1","665","1305","0","50.96","26.28"
"63","000","00","010","0005","0017","652","331","321","4","656","1257","0","52.19","26.33"
"63","000","00","010","0006","0000","2168","1197","971","21","2189","4281","0","51.13","27.96"
"63","000","00","010","0006","0018","508","282","226","6","514","1036","0","49.61","27.22"
"63","000","00","010","0006","0019","632","366","266","5","637","1203","0","52.95","30.42"
"63","000","00","010","0006","0020","484","243","241","6","490","969","0","50.57","25.08"
"63","000","00","010","0006","0021","544","306","238","4","548","1073","0","51.07","28.52"
"63","000","00","010","0007","0000","2049","1134","915","18","2067","4135","0","49.99","27.42"
"63","000","00","010","0007","0022","513","301","212","3","516","1031","0","50.05","29.19"
"63","000","00","010","0007","0023","527","292","235","6","533","1074","0","49.63","27.19"
"63","000","00","010","0007","0024","487","262","225","3","490","1013","0","48.37","25.86"
"63","000","00","010","0007","0025","522","279","243","6","528","1017","0","51.92","27.43"
"63","000","00","010","0008","0000","1883","1167","716","17","1900","3884","0","48.92","30.05"
"63","000","00","010","0008","0026","608","349","259","5","613","1239","0","49.48","28.17"
"63","000","00","010","0008","0027","622","405","217","7","629","1276","0","49.29","31.74"
"63","000","00","010","0008","0028","653","413","240","5","658","1369","0","48.06","30.17"
"63","000","00","010","0009","0000","1787","930","857","18","1805","3540","0","50.99","26.27"
"63","000","00","010","0009","0029","620","308","312","6","626","1176","0","53.23","26.19"
"63","000","00","010","0009","0030","586","323","263","8","594","1155","0","51.43","27.97"
"63","000","00","010","0009","0031","581","299","282","4","585","1209","0","48.39","24.73"
"63","000","00","010","0010","0000","1784","997","787","10","1794","3553","0","50.49","28.06"
"63","000","00","010","0010","0032","581","306","275","5","586","1167","0","50.21","26.22"
"63","000","00","010","0010","0033","660","374","286","4","664","1266","0","52.45","29.54"
"63","000","00","010","0010","0034","543","317","226","1","544","1120","0","48.57","28.30"
"63","000","00","010","0011","0000","3042","1741","1301","19","3061","6051","0","50.59","28.77"
"63","000","00","010","0011","0035","555","330","225","2","557","1044","0","53.35","31.61"
"63","000","00","010","0011","0036","507","268","239","4","511","1011","0","50.54","26.51"
"63","000","00","010","0011","0037","484","272","212","5","489","998","0","49.00","27.25"
"63","000","00","010","0011","0038","464","249","215","2","466","1000","0","46.60","24.90"
"63","000","00","010","0011","0039","514","336","178","4","518","989","0","52.38","33.97"
"63","000","00","010","0011","0040","518","286","232","2","520","1009","0","51.54","28.34"
"63","000","00","010","0012","0000","4277","2847","1430","24","4301","8377","0","51.34","33.99"
"63","000","00","010","0012","0041","633","507","126","2","635","1163","0","54.60","43.59"
"63","000","00","010","0012","0042","680","371","309","7","687","1294","0","53.09","28.67"
"63","000","00","010","0012","0043","610","354","256","2","612","1190","0","51.43","29.75"
"63","000","00","010","0012","0044","536","363","173","4","540","1164","0","46.39","31.19"
"63","000","00","010","0012","0045","620","489","131","3","623","1230","0","50.65","39.76"
"63","000","00","010","0012","0046","597","398","199","4","601","1192","0","50.42","33.39"
"63","000","00","010","0012","0047","601","365","236","2","603","1144","0","52.71","31.91"
"63","000","00","010","0013","0000","1170","599","571","11","1181","2184","0","54.08","27.43"
"63","000","00","010","0013","0048","587","331","256","3","590","1114","0","52.96","29.71"
"63","000","00","010","0013","0049","583","268","315","8","591","1070","0","55.23","25.05"
"63","000","00","010","0014","0000","1778","924","854","9","1787","3518","0","50.80","26.26"
"63","000","00","010","0014","0050","569","283","286","1","570","1140","0","50.00","24.82"
"63","000","00","010","0014","0051","611","335","276","1","612","1233","0","49.64","27.17"
"63","000","00","010","0014","0052","598","306","292","7","605","1145","0","52.84","26.72"
"63","000","00","010","0015","0000","2639","1493","1146","29","2668","5140","0","51.91","29.05"
"63","000","00","010","0015","0053","700","409","291","9","709","1332","0","53.23","30.71"
"63","000","00","010","0015","0054","640","408","232","9","649","1241","0","52.30","32.88"
"63","000","00","010","0015","0055","599","275","324","4","603","1169","0","51.58","23.52"
"63","000","00","010","0015","0056","700","401","299","7","707","1398","0","50.57","28.68"
"63","000","00","010","0016","0000","3785","1903","1882","30","3815","7351","0","51.90","25.89"
"63","000","00","010","0016","0057","567","303","264","5","572","1182","0","48.39","25.63"
"63","000","00","010","0016","0058","600","299","301","2","602","1153","0","52.21","25.93"
"63","000","00","010","0016","0059","633","337","296","6","639","1235","0","51.74","27.29"
"63","000","00","010","0016","0060","672","346","326","6","678","1246","0","54.41","27.77"
"63","000","00","010","0016","0061","642","292","350","7","649","1260","0","51.51","23.17"
"63","000","00","010","0016","0062","671","326","345","4","675","1275","0","52.94","25.57"
"63","000","00","010","0017","0000","2827","1684","1143","25","2852","5381","0","53.00","31.30"
"63","000","00","010","0017","0063","765","524","241","10","775","1412","0","54.89","37.11"
"63","000","00","010","0017","0064","650","347","303","2","652","1334","0","48.88","26.01"
"63","000","00","010","0017","0065","710","418","292","8","718","1327","0","54.11","31.50"
"63","000","00","010","0017","0066","702","395","307","5","707","1308","0","54.05","30.20"
"63","000","00","010","0018","0000","2742","1312","1430","20","2762","7162","0","38.56","18.32"
"63","000","00","010","0018","0085","583","303","280","5","588","1242","0","47.34","24.40"
"63","000","00","010","0018","0086","478","205","273","4","482","1045","0","46.12","19.62"
"63","000","00","010","0018","0087","529","232","297","1","530","1248","0","42.47","18.59"
"63","000","00","010","0018","0088","646","308","338","5","651","1381","0","47.14","22.30"
"63","000","00","010","0018","0089","506","264","242","5","511","2246","0","22.75","11.75"
"63","000","00","010","0019","0000","3314","1714","1600","33","3347","7230","0","46.29","23.71"
"63","000","00","010","0019","0070","673","357","316","7","680","1479","0","45.98","24.14"
"63","000","00","010","0019","0071","579","321","258","8","587","1242","0","47.26","25.85"
"63","000","00","010","0019","0072","593","298","295","7","600","1301","0","46.12","22.91"
"63","000","00","010","0019","0073","827","431","396","9","836","1709","0","48.92","25.22"
"63","000","00","010","0019","0074","642","307","335","2","644","1499","0","42.96","20.48"
"63","000","00","010","0020","0000","2273","1423","850","22","2295","4616","0","49.72","30.83"
"63","000","00","010","0020","0075","537","392","145","6","543","1135","0","47.84","34.54"
"63","000","00","010","0020","0076","561","339","222","4","565","1202","0","47.00","28.20"
"63","000","00","010","0020","0077","661","364","297","6","667","1190","0","56.05","30.59"
"63","000","00","010","0020","0078","514","328","186","6","520","1089","0","47.75","30.12"
"63","000","00","010","0021","0000","3970","2992","978","49","4019","7730","0","51.99","38.71"
"63","000","00","010","0021","0079","654","454","200","8","662","1274","0","51.96","35.64"
"63","000","00","010","0021","0080","760","655","105","12","772","1336","0","57.78","49.03"
"63","000","00","010","0021","0081","572","389","183","9","581","1124","0","51.69","34.61"
"63","000","00","010","0021","0082","573","475","98","7","580","1152","0","50.35","41.23"
"63","000","00","010","0021","0083","703","460","243","5","708","1386","0","51.08","33.19"
"63","000","00","010","0021","0084","708","559","149","8","716","1458","0","49.11","38.34"
"63","000","00","010","0022","0000","3376","1838","1538","21","3397","6959","0","48.81","26.41"
"63","000","00","010","0022","0090","579","288","291","3","582","1290","0","45.12","22.33"
"63","000","00","010","0022","0091","581","308","273","3","584","1152","0","50.69","26.74"
"63","000","00","010","0022","0092","535","276","259","6","541","1080","0","50.09","25.56"
"63","000","00","010","0022","0093","557","319","238","2","559","1185","0","47.17","26.92"
"63","000","00","010","0022","0094","542","300","242","3","545","1091","0","49.95","27.50"
"63","000","00","010","0022","0095","582","347","235","4","586","1161","0","50.47","29.89"
"63","000","00","010","0024","0000","3083","1570","1513","33","3116","6657","0","46.81","23.58"
"63","000","00","010","0024","0096","588","309","279","7","595","1353","0","43.98","22.84"
"63","000","00","010","0024","0097","676","340","336","9","685","1344","0","50.97","25.30"
"63","000","00","010","0024","0098","606","316","290","10","616","1291","0","47.71","24.48"
"63","000","00","010","0024","0099","635","305","330","3","638","1327","0","48.08","22.98"
"63","000","00","010","0024","0100","578","300","278","4","582","1342","0","43.37","22.35"
"63","000","00","010","0025","0000","2636","1522","1114","24","2660","5286","0","50.32","28.79"
"63","000","00","010","0025","0101","710","416","294","5","715","1345","0","53.16","30.93"
"63","000","00","010","0025","0102","651","382","269","7","658","1348","0","48.81","28.34"
"63","000","00","010","0025","0103","720","426","294","7","727","1417","0","51.31","30.06"
"63","000","00","010","0025","0104","555","298","257","5","560","1176","0","47.62","25.34"
"63","000","00","010","0026","0000","3468","1765","1703","23","3491","7611","0","45.87","23.19"
"63","000","00","010","0026","0105","508","273","235","1","509","1110","0","45.86","24.59"
"63","000","00","010","0026","0106","609","271","338","5","614","1318","0","46.59","20.56"
"63","000","00","010","0026","0107","557","300","257","3","560","1278","0","43.82","23.47"
"63","000","00","010","0026","0108","628","359","269","6","634","1385","0","45.78","25.92"
"63","000","00","010","0026","0109","639","279","360","3","642","1282","0","50.08","21.76"
"63","000","00","010","0026","0110","527","283","244","5","532","1238","0","42.97","22.86"
"63","000","00","010","0027","0000","1567","830","737","23","1590","3317","0","47.93","25.02"
"63","000","00","010","0027","0111","528","288","240","13","541","1207","0","44.82","23.86"
"63","000","00","010","0027","0112","572","292","280","4","576","1209","0","47.64","24.15"
"63","000","00","010","0027","0113","467","250","217","6","473","901","0","52.50","27.75"
"63","000","00","010","0028","0000","1407","684","723","15","1422","2882","0","49.34","23.73"
"63","000","00","010","0028","0114","415","172","243","5","420","924","0","45.45","18.61"
"63","000","00","010","0028","0115","475","244","231","6","481","991","0","48.54","24.62"
"63","000","00","010","0028","0116","517","268","249","4","521","967","0","53.88","27.71"
"63","000","00","010","0029","0000","1484","767","717","6","1490","3234","0","46.07","23.72"
"63","000","00","010","0029","0117","537","286","251","2","539","1128","0","47.78","25.35"
"63","000","00","010","0029","0118","474","247","227","4","478","1081","0","44.22","22.85"
"63","000","00","010","0029","0119","473","234","239","0","473","1025","0","46.15","22.83"
"63","000","00","010","0030","0000","2881","1494","1387","31","2912","5590","0","52.09","26.73"
"63","000","00","010","0030","0120","742","368","374","5","747","1466","0","50.95","25.10"
"63","000","00","010","0030","0121","765","386","379","12","777","1487","0","52.25","25.96"
"63","000","00","010","0030","0122","614","312","302","4","618","1178","0","52.46","26.49"
"63","000","00","010","0030","0123","760","428","332","10","770","1459","0","52.78","29.34"
"63","000","00","010","0031","0000","1332","769","563","10","1342","2642","0","50.79","29.11"
"63","000","00","010","0031","0124","715","403","312","3","718","1420","0","50.56","28.38"
"63","000","00","010","0031","0125","617","366","251","7","624","1222","0","51.06","29.95"
"63","000","00","010","0032","0000","1809","1026","783","14","1823","3714","0","49.08","27.63"
"63","000","00","010","0032","0126","643","392","251","9","652","1338","0","48.73","29.30"
"63","000","00","010","0032","0127","604","299","305","2","606","1284","0","47.20","23.29"
"63","000","00","010","0032","0128","562","335","227","3","565","1092","0","51.74","30.68"
"63","000","00","010","0033","0000","2508","1263","1245","22","2530","5206","0","48.60","24.26"
"63","000","00","010","0033","0129","616","265","351","9","625","1367","0","45.72","19.39"
"63","000","00","010","0033","0130","640","328","312","9","649","1199","0","54.13","27.36"
"63","000","00","010","0033","0131","627","342","285","4","631","1310","0","48.17","26.11"
"63","000","00","010","0033","0132","625","328","297","0","625","1330","0","46.99","24.66"
"63","000","00","010","0034","0000","1056","548","508","9","1065","2147","0","49.60","25.52"
"63","000","00","010","0034","0133","582","308","274","2","584","1185","0","49.28","25.99"
"63","000","00","010","0034","0134","474","240","234","7","481","962","0","50.00","24.95"
"63","000","00","010","0035","0000","1466","744","722","11","1477","3047","0","48.47","24.42"
"63","000","00","010","0035","0067","539","271","268","1","540","1065","0","50.70","25.45"
"63","000","00","010","0035","0068","451","233","218","5","456","933","0","48.87","24.97"
"63","000","00","010","0035","0069","476","240","236","5","481","1049","0","45.85","22.88"
"63","000","00","020","0000","0000","84259","47678","36581","740","84999","181747","210936","46.77","26.23"
"63","000","00","020","0001","0000","2109","1489","620","19","2128","4958","0","42.92","30.03"
"63","000","00","020","0001","0135","551","386","165","8","559","1035","0","54.01","37.29"
"63","000","00","020","0001","0136","537","381","156","7","544","2128","0","25.56","17.90"
"63","000","00","020","0001","0137","544","412","132","3","547","940","0","58.19","43.83"
"63","000","00","020","0001","0138","477","310","167","1","478","855","0","55.91","36.26"
"63","000","00","020","0002","0000","1967","1226","741","14","1981","3767","0","52.59","32.55"
"63","000","00","020","0002","0139","669","423","246","3","672","1261","0","53.29","33.54"
"63","000","00","020","0002","0140","663","414","249","6","669","1247","0","53.65","33.20"
"63","000","00","020","0002","0141","635","389","246","5","640","1259","0","50.83","30.90"
"63","000","00","020","0003","0000","1004","619","385","15","1019","2224","0","45.82","27.83"
"63","000","00","020","0003","0142","388","249","139","8","396","934","0","42.40","26.66"
"63","000","00","020","0003","0143","616","370","246","7","623","1290","0","48.29","28.68"
"63","000","00","020","0004","0000","1296","750","546","9","1305","2903","0","44.95","25.84"
"63","000","00","020","0004","0144","386","215","171","3","389","847","0","45.93","25.38"
"63","000","00","020","0004","0145","441","263","178","2","443","971","0","45.62","27.09"
"63","000","00","020","0004","0146","469","272","197","4","473","1085","0","43.59","25.07"
"63","000","00","020","0005","0000","1340","817","523","8","1348","2732","0","49.34","29.90"
"63","000","00","020","0005","0147","455","299","156","5","460","958","0","48.02","31.21"
"63","000","00","020","0005","0148","424","249","175","3","427","858","0","49.77","29.02"
"63","000","00","020","0005","0149","461","269","192","0","461","916","0","50.33","29.37"
"63","000","00","020","0006","0000","2175","1213","962","27","2202","4753","0","46.33","25.52"
"63","000","00","020","0006","0150","456","289","167","3","459","1056","0","43.47","27.37"
"63","000","00","020","0006","0151","606","352","254","6","612","1267","0","48.30","27.78"
"63","000","00","020","0006","0152","531","262","269","13","544","1082","0","50.28","24.21"
"63","000","00","020","0006","0153","582","310","272","5","587","1348","0","43.55","23.00"
"63","000","00","020","0007","0000","1987","1123","864","15","2002","4357","0","45.95","25.77"
"63","000","00","020","0007","0154","451","260","191","3","454","1002","0","45.31","25.95"
"63","000","00","020","0007","0155","575","344","231","3","578","1226","0","47.15","28.06"
"63","000","00","020","0007","0156","475","258","217","5","480","1108","0","43.32","23.29"
"63","000","00","020","0007","0157","486","261","225","4","490","1021","0","47.99","25.56"
"63","000","00","020","0008","0000","3059","1780","1279","22","3081","6335","0","48.63","28.10"
"63","000","00","020","0008","0158","539","317","222","7","546","1156","0","47.23","27.42"
"63","000","00","020","0008","0159","501","289","212","4","505","1055","0","47.87","27.39"
"63","000","00","020","0008","0160","508","303","205","1","509","1047","0","48.62","28.94"
"63","000","00","020","0008","0161","592","357","235","6","598","1113","0","53.73","32.08"
"63","000","00","020","0008","0162","490","296","194","0","490","1045","0","46.89","28.33"
"63","000","00","020","0008","0163","429","218","211","4","433","919","0","47.12","23.72"
"63","000","00","020","0009","0000","3911","2186","1725","33","3944","8511","0","46.34","25.68"
"63","000","00","020","0009","0164","633","299","334","5","638","1345","0","47.43","22.23"
"63","000","00","020","0009","0165","595","316","279","10","605","1242","0","48.71","25.44"
"63","000","00","020","0009","0166","542","305","237","2","544","1058","0","51.42","28.83"
"63","000","00","020","0009","0167","478","288","190","4","482","993","0","48.54","29.00"
"63","000","00","020","0009","0168","537","337","200","5","542","1156","0","46.89","29.15"
"63","000","00","020","0009","0169","523","304","219","2","525","1333","0","39.38","22.81"
"63","000","00","020","0009","0170","603","337","266","5","608","1384","0","43.93","24.35"
"63","000","00","020","0010","0000","1417","727","690","15","1432","3102","0","46.16","23.44"
"63","000","00","020","0010","0171","543","277","266","9","552","1129","0","48.89","24.53"
"63","000","00","020","0010","0172","390","211","179","4","394","918","0","42.92","22.98"
"63","000","00","020","0010","0173","484","239","245","2","486","1055","0","46.07","22.65"
"63","000","00","020","0011","0000","2018","1025","993","22","2040","4266","0","47.82","24.03"
"63","000","00","020","0011","0174","477","230","247","9","486","1085","0","44.79","21.20"
"63","000","00","020","0011","0175","530","264","266","3","533","1087","0","49.03","24.29"
"63","000","00","020","0011","0176","494","268","226","6","500","1026","0","48.73","26.12"
"63","000","00","020","0011","0177","517","263","254","4","521","1068","0","48.78","24.63"
"63","000","00","020","0012","0000","1481","805","676","7","1488","3106","0","47.91","25.92"
"63","000","00","020","0012","0178","470","253","217","0","470","1046","0","44.93","24.19"
"63","000","00","020","0012","0179","452","245","207","4","456","997","0","45.74","24.57"
"63","000","00","020","0012","0180","559","307","252","3","562","1063","0","52.87","28.88"
"63","000","00","020","0013","0000","1945","917","1028","16","1961","4081","0","48.05","22.47"
"63","000","00","020","0013","0181","475","229","246","3","478","960","0","49.79","23.85"
"63","000","00","020","0013","0182","538","246","292","2","540","1055","0","51.18","23.32"
"63","000","00","020","0013","0183","429","215","214","5","434","938","0","46.27","22.92"
"63","000","00","020","0013","0184","503","227","276","6","509","1128","0","45.12","20.12"
"63","000","00","020","0014","0000","1416","589","827","6","1422","3370","0","42.20","17.48"
"63","000","00","020","0014","0185","452","193","259","2","454","1114","0","40.75","17.32"
"63","000","00","020","0014","0186","421","183","238","4","425","1013","0","41.95","18.07"
"63","000","00","020","0014","0187","543","213","330","0","543","1243","0","43.68","17.14"
"63","000","00","020","0015","0000","1556","802","754","18","1574","3629","0","43.37","22.10"
"63","000","00","020","0015","0188","545","287","258","4","549","1203","0","45.64","23.86"
"63","000","00","020","0015","0189","453","262","191","8","461","1156","0","39.88","22.66"
"63","000","00","020","0015","0190","558","253","305","6","564","1270","0","44.41","19.92"
"63","000","00","020","0016","0000","2322","1135","1187","27","2349","4754","0","49.41","23.87"
"63","000","00","020","0016","0191","549","239","310","7","556","1135","0","48.99","21.06"
"63","000","00","020","0016","0192","589","275","314","6","595","1166","0","51.03","23.58"
"63","000","00","020","0016","0193","602","346","256","8","610","1203","0","50.71","28.76"
"63","000","00","020","0016","0194","582","275","307","6","588","1250","0","47.04","22.00"
"63","000","00","020","0017","0000","2119","1236","883","25","2144","4535","0","47.28","27.25"
"63","000","00","020","0017","0195","490","280","210","4","494","980","0","50.41","28.57"
"63","000","00","020","0017","0196","584","324","260","7","591","1180","0","50.08","27.46"
"63","000","00","020","0017","0197","521","319","202","8","529","1177","0","44.94","27.10"
"63","000","00","020","0017","0198","524","313","211","6","530","1198","0","44.24","26.13"
"63","000","00","020","0018","0000","1914","986","928","33","1947","4223","0","46.10","23.35"
"63","000","00","020","0018","0199","416","224","192","5","421","971","0","43.36","23.07"
"63","000","00","020","0018","0200","556","298","258","11","567","1165","0","48.67","25.58"
"63","000","00","020","0018","0201","506","250","256","8","514","1060","0","48.49","23.58"
"63","000","00","020","0018","0202","436","214","222","9","445","1027","0","43.33","20.84"
"63","000","00","020","0019","0000","1723","1104","619","22","1745","3723","0","46.87","29.65"
"63","000","00","020","0019","0203","420","280","140","4","424","1003","0","42.27","27.92"
"63","000","00","020","0019","0204","608","406","202","7","615","1334","0","46.10","30.43"
"63","000","00","020","0019","0205","695","418","277","11","706","1386","0","50.94","30.16"
"63","000","00","020","0020","0000","2834","1609","1225","12","2846","6147","0","46.30","26.18"
"63","000","00","020","0020","0206","447","243","204","2","449","1019","0","44.06","23.85"
"63","000","00","020","0020","0207","525","286","239","4","529","1121","0","47.19","25.51"
"63","000","00","020","0020","0208","438","246","192","0","438","965","0","45.39","25.49"
"63","000","00","020","0020","0209","513","309","204","1","514","1040","0","49.42","29.71"
"63","000","00","020","0020","0210","484","278","206","4","488","963","0","50.67","28.87"
"63","000","00","020","0020","0211","427","247","180","1","428","1039","0","41.19","23.77"
"63","000","00","020","0021","0000","873","483","390","6","879","1924","0","45.69","25.10"
"63","000","00","020","0021","0212","448","249","199","3","451","969","0","46.54","25.70"
"63","000","00","020","0021","0213","425","234","191","3","428","955","0","44.82","24.50"
"63","000","00","020","0022","0000","2531","1420","1111","15","2546","5536","0","45.99","25.65"
"63","000","00","020","0022","0214","429","219","210","4","433","1114","0","38.87","19.66"
"63","000","00","020","0022","0215","519","330","189","1","520","1067","0","48.73","30.93"
"63","000","00","020","0022","0216","493","267","226","2","495","1114","0","44.43","23.97"
"63","000","00","020","0022","0217","571","306","265","5","576","1133","0","50.84","27.01"
"63","000","00","020","0022","0218","519","298","221","3","522","1108","0","47.11","26.90"
"63","000","00","020","0023","0000","1953","997","956","12","1965","4245","0","46.29","23.49"
"63","000","00","020","0023","0219","470","242","228","2","472","1053","0","44.82","22.98"
"63","000","00","020","0023","0220","506","272","234","3","509","1041","0","48.90","26.13"
"63","000","00","020","0023","0221","457","234","223","4","461","1018","0","45.28","22.99"
"63","000","00","020","0023","0222","520","249","271","3","523","1133","0","46.16","21.98"
"63","000","00","020","0024","0000","1872","992","880","17","1889","3791","0","49.83","26.17"
"63","000","00","020","0024","0223","506","288","218","5","511","1004","0","50.90","28.69"
"63","000","00","020","0024","0224","410","201","209","2","412","836","0","49.28","24.04"
"63","000","00","020","0024","0225","436","229","207","7","443","874","0","50.69","26.20"
"63","000","00","020","0024","0226","520","274","246","3","523","1077","0","48.56","25.44"
"63","000","00","020","0025","0000","3058","1532","1526","27","3085","6724","0","45.88","22.78"
"63","000","00","020","0025","0227","488","256","232","6","494","1065","0","46.38","24.04"
"63","000","00","020","0025","0228","527","238","289","7","534","1152","0","46.35","20.66"
"63","000","00","020","0025","0229","476","256","220","1","477","1056","0","45.17","24.24"
"63","000","00","020","0025","0230","477","255","222","2","479","1047","0","45.75","24.36"
"63","000","00","020","0025","0231","534","249","285","4","538","1204","0","44.68","20.68"
"63","000","00","020","0025","0232","556","278","278","7","563","1200","0","46.92","23.17"
"63","000","00","020","0026","0000","2464","1240","1224","24","2488","5177","0","48.06","23.95"
"63","000","00","020","0026","0233","501","267","234","6","507","1073","0","47.25","24.88"
"63","000","00","020","0026","0234","573","266","307","3","576","1158","0","49.74","22.97"
"63","000","00","020","0026","0235","477","258","219","4","481","1006","0","47.81","25.65"
"63","000","00","020","0026","0236","416","199","217","2","418","937","0","44.61","21.24"
"63","000","00","020","0026","0237","497","250","247","9","506","1003","0","50.45","24.93"
"63","000","00","020","0027","0000","1513","803","710","15","1528","3445","0","44.35","23.31"
"63","000","00","020","0027","0238","447","237","210","7","454","1115","0","40.72","21.26"
"63","000","00","020","0027","0239","526","280","246","4","530","1151","0","46.05","24.33"
"63","000","00","020","0027","0240","540","286","254","4","544","1179","0","46.14","24.26"
"63","000","00","020","0028","0000","2045","1235","810","17","2062","4324","0","47.69","28.56"
"63","000","00","020","0028","0241","580","289","291","9","589","1168","0","50.43","24.74"
"63","000","00","020","0028","0242","518","313","205","2","520","1014","0","51.28","30.87"
"63","000","00","020","0028","0243","454","292","162","4","458","1042","0","43.95","28.02"
"63","000","00","020","0028","0244","493","341","152","2","495","1100","0","45.00","31.00"
"63","000","00","020","0029","0000","2548","1524","1024","19","2567","5572","0","46.07","27.35"
"63","000","00","020","0029","0245","462","286","176","2","464","1049","0","44.23","27.26"
"63","000","00","020","0029","0246","465","258","207","5","470","1036","0","45.37","24.90"
"63","000","00","020","0029","0247","529","318","211","4","533","1187","0","44.90","26.79"
"63","000","00","020","0029","0248","535","325","210","2","537","1064","0","50.47","30.55"
"63","000","00","020","0029","0249","557","337","220","6","563","1236","0","45.55","27.27"
"63","000","00","020","0030","0000","3541","2101","1440","34","3575","7503","0","47.65","28.00"
"63","000","00","020","0030","0250","536","304","232","4","540","1069","0","50.51","28.44"
"63","000","00","020","0030","0251","555","338","217","3","558","1083","0","51.52","31.21"
"63","000","00","020","0030","0252","532","324","208","5","537","1107","0","48.51","29.27"
"63","000","00","020","0030","0253","508","295","213","2","510","1093","0","46.66","26.99"
"63","000","00","020","0030","0254","494","264","230","7","501","1110","0","45.14","23.78"
"63","000","00","020","0030","0255","444","300","144","9","453","988","0","45.85","30.36"
"63","000","00","020","0030","0256","472","276","196","4","476","1053","0","45.20","26.21"
"63","000","00","020","0031","0000","2010","1201","809","21","2031","4453","0","45.61","26.97"
"63","000","00","020","0031","0257","515","316","199","10","525","1140","0","46.05","27.72"
"63","000","00","020","0031","0258","516","316","200","3","519","1157","0","44.86","27.31"
"63","000","00","020","0031","0259","497","295","202","2","499","1084","0","46.03","27.21"
"63","000","00","020","0031","0260","482","274","208","6","488","1072","0","45.52","25.56"
"63","000","00","020","0032","0000","2667","1682","985","23","2690","5784","0","46.51","29.08"
"63","000","00","020","0032","0261","579","397","182","6","585","1135","0","51.54","34.98"
"63","000","00","020","0032","0262","572","347","225","6","578","1144","0","50.52","30.33"
"63","000","00","020","0032","0263","479","280","199","2","481","1202","0","40.02","23.29"
"63","000","00","020","0032","0264","407","260","147","5","412","1005","0","41.00","25.87"
"63","000","00","020","0032","0265","630","398","232","4","634","1298","0","48.84","30.66"
"63","000","00","020","0033","0000","2740","1577","1163","17","2757","6519","0","42.29","24.19"
"63","000","00","020","0033","0266","355","200","155","1","356","861","0","41.35","23.23"
"63","000","00","020","0033","0267","441","256","185","0","441","1055","0","41.80","24.27"
"63","000","00","020","0033","0268","521","326","195","5","526","1206","0","43.62","27.03"
"63","000","00","020","0033","0269","453","249","204","3","456","1101","0","41.42","22.62"
"63","000","00","020","0033","0270","525","285","240","6","531","1261","0","42.11","22.60"
"63","000","00","020","0033","0271","445","261","184","2","447","1035","0","43.19","25.22"
"63","000","00","020","0034","0000","1916","1108","808","14","1930","3961","0","48.73","27.97"
"63","000","00","020","0034","0272","484","253","231","5","489","1027","0","47.61","24.63"
"63","000","00","020","0034","0273","449","286","163","1","450","996","0","45.18","28.71"
"63","000","00","020","0034","0274","522","270","252","4","526","1050","0","50.10","25.71"
"63","000","00","020","0034","0275","461","299","162","4","465","888","0","52.36","33.67"
"63","000","00","020","0035","0000","1479","876","603","9","1488","3292","0","45.20","26.61"
"63","000","00","020","0035","0276","442","261","181","3","445","1039","0","42.83","25.12"
"63","000","00","020","0035","0277","529","287","242","0","529","1122","0","47.15","25.58"
"63","000","00","020","0035","0278","508","328","180","6","514","1131","0","45.45","29.00"
"63","000","00","020","0036","0000","2939","1753","1186","15","2954","6033","0","48.96","29.06"
"63","000","00","020","0036","0279","630","346","284","5","635","1185","0","53.59","29.20"
"63","000","00","020","0036","0280","592","363","229","3","595","1151","0","51.69","31.54"
"63","000","00","020","0036","0281","602","355","247","0","602","1332","0","45.20","26.65"
"63","000","00","020","0036","0282","542","361","181","3","545","1113","0","48.97","32.43"
"63","000","00","020","0036","0283","573","328","245","4","577","1252","0","46.09","26.20"
"63","000","00","020","0037","0000","1322","728","594","15","1337","2713","0","49.28","26.83"
"63","000","00","020","0037","0284","446","259","187","4","450","849","0","53.00","30.51"
"63","000","00","020","0037","0285","459","221","238","7","466","948","0","49.16","23.31"
"63","000","00","020","0037","0286","417","248","169","4","421","916","0","45.96","27.07"
"63","000","00","020","0038","0000","1557","919","638","11","1568","3427","0","45.75","26.82"
"63","000","00","020","0038","0287","446","249","197","4","450","1169","0","38.49","21.30"
"63","000","00","020","0038","0288","545","309","236","5","550","1118","0","49.19","27.64"
"63","000","00","020","0038","0289","566","361","205","2","568","1140","0","49.82","31.67"
"63","000","00","020","0039","0000","2915","1707","1208","32","2947","5973","0","49.34","28.58"
"63","000","00","020","0039","0290","577","336","241","7","584","1196","0","48.83","28.09"
"63","000","00","020","0039","0291","599","352","247","4","603","1254","0","48.09","28.07"
"63","000","00","020","0039","0292","490","283","207","8","498","1025","0","48.59","27.61"
"63","000","00","020","0039","0293","618","377","241","7","625","1262","0","49.52","29.87"
"63","000","00","020","0039","0294","631","359","272","6","637","1236","0","51.54","29.05"
"63","000","00","020","0040","0000","1992","1175","817","14","2006","4141","0","48.44","28.37"
"63","000","00","020","0040","0295","536","322","214","5","541","1141","0","47.41","28.22"
"63","000","00","020","0040","0296","447","271","176","2","449","921","0","48.75","29.42"
"63","000","00","020","0040","0297","555","346","209","5","560","1111","0","50.41","31.14"
"63","000","00","020","0040","0298","454","236","218","2","456","968","0","47.11","24.38"
"63","000","00","020","0041","0000","731","487","244","18","749","1734","0","43.19","28.09"
"63","000","00","020","0041","0299","418","251","167","11","429","984","0","43.60","25.51"
"63","000","00","020","0041","0300","313","236","77","7","320","750","0","42.67","31.47"
"63","000","00","030","0000","0000","117133","67786","49347","989","118122","242869","296546","48.64","27.91"
"63","000","00","030","0001","0000","2295","1438","857","13","2308","4632","0","49.83","31.04"
"63","000","00","030","0001","0301","531","307","224","5","536","1147","0","46.73","26.77"
"63","000","00","030","0001","0302","511","314","197","3","514","1124","0","45.73","27.94"
"63","000","00","030","0001","0303","618","397","221","2","620","1156","0","53.63","34.34"
"63","000","00","030","0001","0304","635","420","215","3","638","1205","0","52.95","34.85"
"63","000","00","030","0002","0000","2174","1162","1012","11","2185","4304","0","50.77","27.00"
"63","000","00","030","0002","0305","734","390","344","2","736","1462","0","50.34","26.68"
"63","000","00","030","0002","0306","627","308","319","6","633","1294","0","48.92","23.80"
"63","000","00","030","0002","0307","813","464","349","3","816","1548","0","52.71","29.97"
"63","000","00","030","0003","0000","2632","1558","1074","14","2646","5471","0","48.36","28.48"
"63","000","00","030","0003","0308","727","441","286","1","728","1325","0","54.94","33.28"
"63","000","00","030","0003","0309","555","321","234","4","559","1250","0","44.72","25.68"
"63","000","00","030","0003","0310","686","391","295","5","691","1501","0","46.04","26.05"
"63","000","00","030","0003","0311","664","405","259","4","668","1395","0","47.89","29.03"
"63","000","00","030","0004","0000","3233","1758","1475","19","3252","6608","0","49.21","26.60"
"63","000","00","030","0004","0312","565","292","273","1","566","1171","0","48.33","24.94"
"63","000","00","030","0004","0313","618","316","302","5","623","1230","0","50.65","25.69"
"63","000","00","030","0004","0314","692","333","359","3","695","1442","0","48.20","23.09"
"63","000","00","030","0004","0315","647","404","243","4","651","1332","0","48.87","30.33"
"63","000","00","030","0004","0316","711","413","298","6","717","1433","0","50.03","28.82"
"63","000","00","030","0005","0000","1914","1032","882","13","1927","4212","0","45.75","24.50"
"63","000","00","030","0005","0317","509","262","247","6","515","1096","0","46.99","23.91"
"63","000","00","030","0005","0318","500","257","243","1","501","1118","0","44.81","22.99"
"63","000","00","030","0005","0319","491","284","207","4","495","1060","0","46.70","26.79"
"63","000","00","030","0005","0320","414","229","185","2","416","938","0","44.35","24.41"
"63","000","00","030","0006","0000","2463","1655","808","15","2478","4707","0","52.64","35.16"
"63","000","00","030","0006","0321","455","350","105","2","457","917","0","49.84","38.17"
"63","000","00","030","0006","0322","650","523","127","7","657","1232","0","53.33","42.45"
"63","000","00","030","0006","0323","671","442","229","3","674","1294","0","52.09","34.16"
"63","000","00","030","0006","0324","687","340","347","3","690","1264","0","54.59","26.90"
"63","000","00","030","0007","0000","2717","1488","1229","18","2735","5704","0","47.95","26.09"
"63","000","00","030","0007","0325","720","394","326","5","725","1514","0","47.89","26.02"
"63","000","00","030","0007","0326","686","370","316","5","691","1390","0","49.71","26.62"
"63","000","00","030","0007","0327","761","423","338","4","765","1556","0","49.16","27.19"
"63","000","00","030","0007","0328","550","301","249","4","554","1244","0","44.53","24.20"
"63","000","00","030","0008","0000","1357","696","661","12","1369","2713","0","50.46","25.65"
"63","000","00","030","0008","0329","628","326","302","4","632","1229","0","51.42","26.53"
"63","000","00","030","0008","0330","729","370","359","8","737","1484","0","49.66","24.93"
"63","000","00","030","0009","0000","1668","876","792","17","1685","3427","0","49.17","25.56"
"63","000","00","030","0009","0331","547","293","254","3","550","1148","0","47.91","25.52"
"63","000","00","030","0009","0332","600","320","280","5","605","1179","0","51.31","27.14"
"63","000","00","030","0009","0333","521","263","258","9","530","1100","0","48.18","23.91"
"63","000","00","030","0010","0000","2847","1589","1258","25","2872","6211","0","46.24","25.58"
"63","000","00","030","0010","0334","500","301","199","2","502","1198","0","41.90","25.13"
"63","000","00","030","0010","0335","669","367","302","2","671","1375","0","48.80","26.69"
"63","000","00","030","0010","0336","593","312","281","7","600","1218","0","49.26","25.62"
"63","000","00","030","0010","0337","536","292","244","7","543","1217","0","44.62","23.99"
"63","000","00","030","0010","0338","549","317","232","7","556","1203","0","46.22","26.35"
"63","000","00","030","0011","0000","2355","1378","977","22","2377","4608","0","51.58","29.90"
"63","000","00","030","0011","0339","494","272","222","3","497","1053","0","47.20","25.83"
"63","000","00","030","0011","0340","655","367","288","8","663","1248","0","53.13","29.41"
"63","000","00","030","0011","0341","662","361","301","8","670","1254","0","53.43","28.79"
"63","000","00","030","0011","0342","544","378","166","3","547","1053","0","51.95","35.90"
"63","000","00","030","0012","0000","1910","1036","874","17","1927","4046","0","47.63","25.61"
"63","000","00","030","0012","0343","603","319","284","4","607","1305","0","46.51","24.44"
"63","000","00","030","0012","0344","687","367","320","7","694","1392","0","49.86","26.36"
"63","000","00","030","0012","0345","620","350","270","6","626","1349","0","46.40","25.95"
"63","000","00","030","0013","0000","1792","1001","791","16","1808","3495","0","51.73","28.64"
"63","000","00","030","0013","0346","569","311","258","6","575","1134","0","50.71","27.43"
"63","000","00","030","0013","0347","629","353","276","6","635","1241","0","51.17","28.44"
"63","000","00","030","0013","0348","594","337","257","4","598","1120","0","53.39","30.09"
"63","000","00","030","0014","0000","2899","1634","1265","13","2912","6074","0","47.94","26.90"
"63","000","00","030","0014","0349","592","323","269","1","593","1185","0","50.04","27.26"
"63","000","00","030","0014","0350","577","373","204","4","581","1226","0","47.39","30.42"
"63","000","00","030","0014","0351","609","353","256","2","611","1198","0","51.00","29.47"
"63","000","00","030","0014","0352","560","294","266","3","563","1228","0","45.85","23.94"
"63","000","00","030","0014","0353","561","291","270","3","564","1237","0","45.59","23.52"
"63","000","00","030","0015","0000","2437","1331","1106","22","2459","6710","0","36.65","19.84"
"63","000","00","030","0015","0354","517","291","226","5","522","2719","0","19.20","10.70"
"63","000","00","030","0015","0355","599","312","287","2","601","1259","0","47.74","24.78"
"63","000","00","030","0015","0356","636","338","298","5","641","1287","0","49.81","26.26"
"63","000","00","030","0015","0357","685","390","295","10","695","1445","0","48.10","26.99"
"63","000","00","030","0016","0000","2355","1367","988","17","2372","4806","0","49.35","28.44"
"63","000","00","030","0016","0358","519","338","181","6","525","1049","0","50.05","32.22"
"63","000","00","030","0016","0359","676","383","293","3","679","1290","0","52.64","29.69"
"63","000","00","030","0016","0360","567","327","240","1","568","1202","0","47.25","27.20"
"63","000","00","030","0016","0361","593","319","274","7","600","1265","0","47.43","25.22"
"63","000","00","030","0017","0000","2372","1284","1088","23","2395","5061","0","47.32","25.37"
"63","000","00","030","0017","0362","585","319","266","8","593","1302","0","45.55","24.50"
"63","000","00","030","0017","0363","576","323","253","4","580","1259","0","46.07","25.66"
"63","000","00","030","0017","0364","622","341","281","4","626","1317","0","47.53","25.89"
"63","000","00","030","0017","0365","589","301","288","7","596","1183","0","50.38","25.44"
"63","000","00","030","0018","0000","1433","833","600","8","1441","2977","0","48.40","27.98"
"63","000","00","030","0018","0366","465","258","207","2","467","963","0","48.49","26.79"
"63","000","00","030","0018","0367","487","298","189","2","489","965","0","50.67","30.88"
"63","000","00","030","0018","0368","481","277","204","4","485","1049","0","46.23","26.41"
"63","000","00","030","0019","0000","1472","831","641","14","1486","2987","0","49.75","27.82"
"63","000","00","030","0019","0369","744","437","307","9","753","1480","0","50.88","29.53"
"63","000","00","030","0019","0370","728","394","334","5","733","1507","0","48.64","26.14"
"63","000","00","030","0020","0000","1495","921","574","17","1512","3004","0","50.33","30.66"
"63","000","00","030","0020","0371","760","484","276","12","772","1491","0","51.78","32.46"
"63","000","00","030","0020","0372","735","437","298","5","740","1513","0","48.91","28.88"
"63","000","00","030","0021","0000","2361","1403","958","18","2379","4627","0","51.42","30.32"
"63","000","00","030","0021","0373","501","302","199","5","506","1046","0","48.37","28.87"
"63","000","00","030","0021","0374","617","390","227","2","619","1115","0","55.52","34.98"
"63","000","00","030","0021","0375","617","350","267","4","621","1231","0","50.45","28.43"
"63","000","00","030","0021","0376","626","361","265","7","633","1235","0","51.26","29.23"
"63","000","00","030","0022","0000","2698","1583","1115","26","2724","5613","0","48.53","28.20"
"63","000","00","030","0022","0377","586","357","229","9","595","1322","0","45.01","27.00"
"63","000","00","030","0022","0378","738","436","302","10","748","1477","0","50.64","29.52"
"63","000","00","030","0022","0379","644","363","281","4","648","1373","0","47.20","26.44"
"63","000","00","030","0022","0380","730","427","303","3","733","1441","0","50.87","29.63"
"63","000","00","030","0023","0000","2891","1982","909","26","2917","5527","0","52.78","35.86"
"63","000","00","030","0023","0381","698","436","262","6","704","1329","0","52.97","32.81"
"63","000","00","030","0023","0382","691","469","222","7","698","1388","0","50.29","33.79"
"63","000","00","030","0023","0383","747","501","246","7","754","1411","0","53.44","35.51"
"63","000","00","030","0023","0384","755","576","179","6","761","1399","0","54.40","41.17"
"63","000","00","030","0026","0000","1473","841","632","12","1485","2947","0","50.39","28.54"
"63","000","00","030","0026","0385","762","419","343","7","769","1551","0","49.58","27.01"
"63","000","00","030","0026","0386","711","422","289","5","716","1396","0","51.29","30.23"
"63","000","00","030","0027","0000","1991","1099","892","24","2015","3937","0","51.18","27.91"
"63","000","00","030","0027","0387","733","416","317","7","740","1446","0","51.18","28.77"
"63","000","00","030","0027","0388","746","393","353","8","754","1365","0","55.24","28.79"
"63","000","00","030","0027","0389","512","290","222","9","521","1126","0","46.27","25.75"
"63","000","00","030","0028","0000","2760","1630","1130","22","2782","5409","0","51.43","30.13"
"63","000","00","030","0028","0390","712","412","300","6","718","1374","0","52.26","29.99"
"63","000","00","030","0028","0391","707","428","279","5","712","1398","0","50.93","30.62"
"63","000","00","030","0028","0392","674","399","275","6","680","1316","0","51.67","30.32"
"63","000","00","030","0028","0393","667","391","276","5","672","1321","0","50.87","29.60"
"63","000","00","030","0029","0000","1878","1108","770","14","1892","4245","0","44.57","26.10"
"63","000","00","030","0029","0394","639","360","279","2","641","1423","0","45.05","25.30"
"63","000","00","030","0029","0395","573","324","249","7","580","1399","0","41.46","23.16"
"63","000","00","030","0029","0396","666","424","242","5","671","1423","0","47.15","29.80"
"63","000","00","030","0030","0000","2074","1235","839","11","2085","4455","0","46.80","27.72"
"63","000","00","030","0030","0397","512","311","201","2","514","1155","0","44.50","26.93"
"63","000","00","030","0030","0398","520","314","206","2","522","1055","0","49.48","29.76"
"63","000","00","030","0030","0399","536","313","223","4","540","1149","0","47.00","27.24"
"63","000","00","030","0030","0400","506","297","209","3","509","1096","0","46.44","27.10"
"63","000","00","030","0031","0000","2481","1256","1225","23","2504","5249","0","47.70","23.93"
"63","000","00","030","0031","0401","619","306","313","3","622","1288","0","48.29","23.76"
"63","000","00","030","0031","0402","669","361","308","7","676","1358","0","49.78","26.58"
"63","000","00","030","0031","0403","631","314","317","7","638","1347","0","47.36","23.31"
"63","000","00","030","0031","0404","562","275","287","6","568","1256","0","45.22","21.89"
"63","000","00","030","0032","0000","2185","1224","961","25","2210","4590","0","48.15","26.67"
"63","000","00","030","0032","0405","529","315","214","7","536","1089","0","49.22","28.93"
"63","000","00","030","0032","0406","502","257","245","7","509","1011","0","50.35","25.42"
"63","000","00","030","0032","0407","572","319","253","5","577","1284","0","44.94","24.84"
"63","000","00","030","0032","0408","582","333","249","6","588","1206","0","48.76","27.61"
"63","000","00","030","0033","0000","1629","917","712","21","1650","3527","0","46.78","26.00"
"63","000","00","030","0033","0409","533","303","230","9","542","1261","0","42.98","24.03"
"63","000","00","030","0033","0410","573","326","247","7","580","1202","0","48.25","27.12"
"63","000","00","030","0033","0411","523","288","235","5","528","1064","0","49.62","27.07"
"63","000","00","030","0034","0000","1870","1163","707","16","1886","3732","0","50.54","31.16"
"63","000","00","030","0034","0412","568","354","214","4","572","1154","0","49.57","30.68"
"63","000","00","030","0034","0413","682","462","220","4","686","1375","0","49.89","33.60"
"63","000","00","030","0034","0414","620","347","273","8","628","1203","0","52.20","28.84"
"63","000","00","030","0035","0000","1786","1066","720","18","1804","3699","0","48.77","28.82"
"63","000","00","030","0035","0415","590","336","254","5","595","1240","0","47.98","27.10"
"63","000","00","030","0035","0416","601","385","216","6","607","1244","0","48.79","30.95"
"63","000","00","030","0035","0417","595","345","250","7","602","1215","0","49.55","28.40"
"63","000","00","030","0036","0000","2400","1480","920","24","2424","4899","0","49.48","30.21"
"63","000","00","030","0036","0418","673","387","286","3","676","1323","0","51.10","29.25"
"63","000","00","030","0036","0419","541","318","223","5","546","1103","0","49.50","28.83"
"63","000","00","030","0036","0420","632","416","216","11","643","1320","0","48.71","31.52"
"63","000","00","030","0036","0421","554","359","195","5","559","1153","0","48.48","31.14"
"63","000","00","030","0037","0000","3140","2270","870","21","3161","5848","0","54.05","38.82"
"63","000","00","030","0037","0422","632","522","110","5","637","1157","0","55.06","45.12"
"63","000","00","030","0037","0423","594","422","172","2","596","1064","0","56.02","39.66"
"63","000","00","030","0037","0424","608","429","179","5","613","1133","0","54.10","37.86"
"63","000","00","030","0037","0425","680","450","230","5","685","1271","0","53.89","35.41"
"63","000","00","030","0037","0426","626","447","179","4","630","1223","0","51.51","36.55"
"63","000","00","030","0038","0000","1554","885","669","8","1562","3137","0","49.79","28.21"
"63","000","00","030","0038","0427","720","382","338","2","722","1433","0","50.38","26.66"
"63","000","00","030","0038","0428","394","236","158","1","395","752","0","52.53","31.38"
"63","000","00","030","0038","0429","440","267","173","5","445","952","0","46.74","28.05"
"63","000","00","030","0039","0000","875","535","340","8","883","1729","0","51.07","30.94"
"63","000","00","030","0039","0430","436","270","166","2","438","900","0","48.67","30.00"
"63","000","00","030","0039","0431","439","265","174","6","445","829","0","53.68","31.97"
"63","000","00","030","0040","0000","3683","2094","1589","28","3711","7435","0","49.91","28.16"
"63","000","00","030","0040","0432","639","370","269","3","642","1325","0","48.45","27.92"
"63","000","00","030","0040","0433","664","387","277","5","669","1272","0","52.59","30.42"
"63","000","00","030","0040","0434","560","321","239","3","563","1129","0","49.87","28.43"
"63","000","00","030","0040","0435","594","350","244","3","597","1265","0","47.19","27.67"
"63","000","00","030","0040","0436","619","324","295","10","629","1228","0","51.22","26.38"
"63","000","00","030","0040","0437","607","342","265","4","611","1216","0","50.25","28.13"
"63","000","00","030","0041","0000","1845","1002","843","15","1860","3529","0","52.71","28.39"
"63","000","00","030","0041","0438","611","325","286","8","619","1232","0","50.24","26.38"
"63","000","00","030","0041","0439","581","312","269","5","586","1083","0","54.11","28.81"
"63","000","00","030","0041","0440","653","365","288","2","655","1214","0","53.95","30.07"
"63","000","00","030","0043","0000","3641","2104","1537","35","3676","6961","0","52.81","30.23"
"63","000","00","030","0043","0441","790","439","351","7","797","1475","0","54.03","29.76"
"63","000","00","030","0043","0442","703","428","275","10","713","1387","0","51.41","30.86"
"63","000","00","030","0043","0443","707","405","302","8","715","1364","0","52.42","29.69"
"63","000","00","030","0043","0444","709","419","290","5","714","1407","0","50.75","29.78"
"63","000","00","030","0043","0445","732","413","319","5","737","1328","0","55.50","31.10"
"63","000","00","030","0044","0000","2334","1375","959","25","2359","4904","0","48.10","28.04"
"63","000","00","030","0044","0446","556","348","208","9","565","1238","0","45.64","28.11"
"63","000","00","030","0044","0447","594","356","238","7","601","1191","0","50.46","29.89"
"63","000","00","030","0044","0448","580","334","246","3","583","1232","0","47.32","27.11"
"63","000","00","030","0044","0449","604","337","267","6","610","1243","0","49.07","27.11"
"63","000","00","030","0046","0000","2090","1179","911","29","2119","4683","0","45.25","25.18"
"63","000","00","030","0046","0450","559","340","219","6","565","1277","0","44.24","26.62"
"63","000","00","030","0046","0451","500","267","233","5","505","1094","0","46.16","24.41"
"63","000","00","030","0046","0452","486","261","225","9","495","1019","0","48.58","25.61"
"63","000","00","030","0046","0453","545","311","234","9","554","1293","0","42.85","24.05"
"63","000","00","030","0047","0000","3199","1822","1377","35","3234","6467","0","50.01","28.17"
"63","000","00","030","0047","0454","672","363","309","6","678","1403","0","48.33","25.87"
"63","000","00","030","0047","0455","619","369","250","4","623","1308","0","47.63","28.21"
"63","000","00","030","0047","0456","632","368","264","7","639","1228","0","52.04","29.97"
"63","000","00","030","0047","0457","651","362","289","9","660","1247","0","52.93","29.03"
"63","000","00","030","0047","0458","625","360","265","9","634","1281","0","49.49","28.10"
"63","000","00","030","0048","0000","1874","1166","708","21","1895","3938","0","48.12","29.61"
"63","000","00","030","0048","0459","619","382","237","10","629","1357","0","46.35","28.15"
"63","000","00","030","0048","0460","623","383","240","8","631","1244","0","50.72","30.79"
"63","000","00","030","0048","0461","632","401","231","3","635","1337","0","47.49","29.99"
"63","000","00","030","0049","0000","1822","1044","778","10","1832","4048","0","45.26","25.79"
"63","000","00","030","0049","0462","607","339","268","6","613","1380","0","44.42","24.57"
"63","000","00","030","0049","0463","625","364","261","3","628","1304","0","48.16","27.91"
"63","000","00","030","0049","0464","590","341","249","1","591","1364","0","43.33","25.00"
"63","000","00","030","0050","0000","2265","1247","1018","24","2289","5023","0","45.57","24.83"
"63","000","00","030","0050","0465","506","275","231","4","510","1200","0","42.50","22.92"
"63","000","00","030","0050","0466","593","318","275","8","601","1336","0","44.99","23.80"
"63","000","00","030","0050","0467","565","323","242","6","571","1233","0","46.31","26.20"
"63","000","00","030","0050","0468","601","331","270","6","607","1254","0","48.41","26.40"
"63","000","00","030","0051","0000","2361","1310","1051","14","2375","5100","0","46.57","25.69"
"63","000","00","030","0051","0469","562","295","267","3","565","1255","0","45.02","23.51"
"63","000","00","030","0051","0470","663","356","307","1","664","1308","0","50.76","27.22"
"63","000","00","030","0051","0471","550","330","220","7","557","1232","0","45.21","26.79"
"63","000","00","030","0051","0472","586","329","257","3","589","1305","0","45.13","25.21"
"63","000","00","030","0052","0000","1766","1039","727","15","1781","3818","0","46.65","27.21"
"63","000","00","030","0052","0473","631","377","254","6","637","1303","0","48.89","28.93"
"63","000","00","030","0052","0474","578","352","226","5","583","1280","0","45.55","27.50"
"63","000","00","030","0052","0475","557","310","247","4","561","1235","0","45.43","25.10"
"63","000","00","030","0053","0000","2343","1290","1053","19","2362","4922","0","47.99","26.21"
"63","000","00","030","0053","0476","585","324","261","8","593","1205","0","49.21","26.89"
"63","000","00","030","0053","0477","554","329","225","5","559","1247","0","44.83","26.38"
"63","000","00","030","0053","0478","630","321","309","1","631","1201","0","52.54","26.73"
"63","000","00","030","0053","0479","574","316","258","5","579","1269","0","45.63","24.90"
"63","000","00","030","0054","0000","1577","920","657","10","1587","3473","0","45.70","26.49"
"63","000","00","030","0054","0480","552","310","242","2","554","1241","0","44.64","24.98"
"63","000","00","030","0054","0481","482","315","167","4","486","1142","0","42.56","27.58"
"63","000","00","030","0054","0482","543","295","248","4","547","1090","0","50.18","27.06"
"63","000","00","030","0055","0000","2446","1326","1120","12","2458","5221","0","47.08","25.40"
"63","000","00","030","0055","0483","568","291","277","1","569","1255","0","45.34","23.19"
"63","000","00","030","0055","0484","601","343","258","3","604","1275","0","47.37","26.90"
"63","000","00","030","0055","0485","657","373","284","5","662","1322","0","50.08","28.21"
"63","000","00","030","0055","0486","620","319","301","3","623","1369","0","45.51","23.30"
"63","000","00","030","0056","0000","3058","1742","1316","38","3096","6249","0","49.54","27.88"
"63","000","00","030","0056","0487","725","447","278","11","736","1392","0","52.87","32.11"
"63","000","00","030","0056","0488","557","285","272","1","558","1217","0","45.85","23.42"
"63","000","00","030","0056","0489","565","323","242","11","576","1233","0","46.72","26.20"
"63","000","00","030","0056","0490","579","340","239","8","587","1199","0","48.96","28.36"
"63","000","00","030","0056","0491","632","347","285","7","639","1208","0","52.90","28.73"
"63","000","00","030","0057","0000","963","581","382","16","979","2171","0","45.09","26.76"
"63","000","00","030","0057","0492","363","230","133","5","368","866","0","42.49","26.56"
"63","000","00","030","0057","0493","246","147","99","5","251","604","0","41.56","24.34"
"63","000","00","030","0057","0494","354","204","150","6","360","701","0","51.36","29.10"
"63","000","00","040","0000","0000","86322","43325","42997","726","87048","188193","219840","46.25","23.02"
"63","000","00","040","0001","0000","1268","623","645","14","1282","2806","0","45.69","22.20"
"63","000","00","040","0001","0495","657","333","324","6","663","1509","0","43.94","22.07"
"63","000","00","040","0001","0496","611","290","321","8","619","1297","0","47.73","22.36"
"63","000","00","040","0002","0000","1849","944","905","13","1862","4541","0","41.00","20.79"
"63","000","00","040","0002","0497","627","331","296","5","632","1571","0","40.23","21.07"
"63","000","00","040","0002","0498","623","313","310","5","628","1540","0","40.78","20.32"
"63","000","00","040","0002","0499","599","300","299","3","602","1430","0","42.10","20.98"
"63","000","00","040","0003","0000","1376","699","677","11","1387","3136","0","44.23","22.29"
"63","000","00","040","0003","0500","690","354","336","2","692","1538","0","44.99","23.02"
"63","000","00","040","0003","0501","686","345","341","9","695","1598","0","43.49","21.59"
"63","000","00","040","0004","0000","1827","876","951","10","1837","3798","0","48.37","23.06"
"63","000","00","040","0004","0502","609","258","351","0","609","1279","0","47.62","20.17"
"63","000","00","040","0004","0503","555","287","268","6","561","1123","0","49.96","25.56"
"63","000","00","040","0004","0504","663","331","332","4","667","1396","0","47.78","23.71"
"63","000","00","040","0005","0000","1007","538","469","7","1014","2307","0","43.95","23.32"
"63","000","00","040","0005","0505","438","220","218","3","441","1020","0","43.24","21.57"
"63","000","00","040","0005","0506","569","318","251","4","573","1287","0","44.52","24.71"
"63","000","00","040","0006","0000","2497","1236","1261","21","2518","5902","0","42.66","20.94"
"63","000","00","040","0006","0507","484","238","246","5","489","1110","0","44.05","21.44"
"63","000","00","040","0006","0508","536","257","279","3","539","1186","0","45.45","21.67"
"63","000","00","040","0006","0509","460","235","225","4","464","1142","0","40.63","20.58"
"63","000","00","040","0006","0510","437","243","194","5","442","1169","0","37.81","20.79"
"63","000","00","040","0006","0511","580","263","317","4","584","1295","0","45.10","20.31"
"63","000","00","040","0007","0000","1459","783","676","14","1473","3728","0","39.51","21.00"
"63","000","00","040","0007","0512","510","255","255","5","515","1263","0","40.78","20.19"
"63","000","00","040","0007","0513","504","256","248","3","507","1204","0","42.11","21.26"
"63","000","00","040","0007","0514","445","272","173","6","451","1261","0","35.77","21.57"
"63","000","00","040","0008","0000","2721","1223","1498","15","2736","5936","0","46.09","20.60"
"63","000","00","040","0008","0515","717","292","425","5","722","1470","0","49.12","19.86"
"63","000","00","040","0008","0516","707","341","366","1","708","1533","0","46.18","22.24"
"63","000","00","040","0008","0517","670","278","392","5","675","1503","0","44.91","18.50"
"63","000","00","040","0008","0518","627","312","315","4","631","1430","0","44.13","21.82"
"63","000","00","040","0009","0000","1488","703","785","10","1498","3471","0","43.16","20.25"
"63","000","00","040","0009","0519","481","229","252","8","489","1125","0","43.47","20.36"
"63","000","00","040","0009","0520","581","262","319","1","582","1195","0","48.70","21.92"
"63","000","00","040","0009","0521","426","212","214","1","427","1151","0","37.10","18.42"
"63","000","00","040","0010","0000","1778","884","894","16","1794","4310","0","41.62","20.51"
"63","000","00","040","0010","0522","501","220","281","4","505","1124","0","44.93","19.57"
"63","000","00","040","0010","0523","484","232","252","4","488","1202","0","40.60","19.30"
"63","000","00","040","0010","0524","449","245","204","4","453","1056","0","42.90","23.20"
"63","000","00","040","0010","0525","344","187","157","4","348","928","0","37.50","20.15"
"63","000","00","040","0011","0000","1940","1032","908","19","1959","4704","0","41.65","21.94"
"63","000","00","040","0011","0526","463","249","214","3","466","1208","0","38.58","20.61"
"63","000","00","040","0011","0527","444","245","199","9","453","1030","0","43.98","23.79"
"63","000","00","040","0011","0528","528","273","255","4","532","1227","0","43.36","22.25"
"63","000","00","040","0011","0529","505","265","240","3","508","1239","0","41.00","21.39"
"63","000","00","040","0012","0000","1556","736","820","8","1564","3587","0","43.60","20.52"
"63","000","00","040","0012","0530","472","219","253","0","472","1136","0","41.55","19.28"
"63","000","00","040","0012","0531","601","278","323","6","607","1288","0","47.13","21.58"
"63","000","00","040","0012","0532","483","239","244","2","485","1163","0","41.70","20.55"
"63","000","00","040","0013","0000","1550","1190","360","23","1573","3095","0","50.82","38.45"
"63","000","00","040","0013","0536","494","386","108","6","500","984","0","50.81","39.23"
"63","000","00","040","0013","0537","473","327","146","8","481","1081","0","44.50","30.25"
"63","000","00","040","0013","0538","583","477","106","9","592","1030","0","57.48","46.31"
"63","000","00","040","0014","0000","3700","2130","1570","31","3731","7456","0","50.04","28.57"
"63","000","00","040","0014","0539","674","368","306","5","679","1332","0","50.98","27.63"
"63","000","00","040","0014","0540","580","353","227","5","585","1154","0","50.69","30.59"
"63","000","00","040","0014","0541","590","325","265","6","596","1188","0","50.17","27.36"
"63","000","00","040","0014","0542","702","406","296","6","708","1363","0","51.94","29.79"
"63","000","00","040","0014","0543","500","307","193","3","503","1075","0","46.79","28.56"
"63","000","00","040","0014","0544","654","371","283","6","660","1344","0","49.11","27.60"
"63","000","00","040","0015","0000","2483","1303","1180","22","2505","5305","0","47.22","24.56"
"63","000","00","040","0015","0545","693","350","343","7","700","1379","0","50.76","25.38"
"63","000","00","040","0015","0546","678","329","349","4","682","1402","0","48.64","23.47"
"63","000","00","040","0015","0547","623","344","279","6","629","1329","0","47.33","25.88"
"63","000","00","040","0015","0548","489","280","209","5","494","1195","0","41.34","23.43"
"63","000","00","040","0016","0000","3822","2060","1762","29","3851","7732","0","49.81","26.64"
"63","000","00","040","0016","0549","618","343","275","8","626","1314","0","47.64","26.10"
"63","000","00","040","0016","0550","720","395","325","3","723","1494","0","48.39","26.44"
"63","000","00","040","0016","0551","802","425","377","8","810","1607","0","50.40","26.45"
"63","000","00","040","0016","0552","804","430","374","6","810","1612","0","50.25","26.67"
"63","000","00","040","0016","0553","878","467","411","4","882","1705","0","51.73","27.39"
"63","000","00","040","0017","0000","413","146","267","3","416","904","0","46.02","16.15"
"63","000","00","040","0017","0577","413","146","267","3","416","904","0","46.02","16.15"
"63","000","00","040","0018","0000","1948","868","1080","14","1962","4399","0","44.60","19.73"
"63","000","00","040","0018","0561","641","282","359","4","645","1516","0","42.55","18.60"
"63","000","00","040","0018","0562","665","274","391","4","669","1441","0","46.43","19.01"
"63","000","00","040","0018","0563","642","312","330","6","648","1442","0","44.94","21.64"
"63","000","00","040","0019","0000","1997","928","1069","20","2017","4267","0","47.27","21.75"
"63","000","00","040","0019","0533","616","306","310","7","623","1447","0","43.05","21.15"
"63","000","00","040","0019","0534","761","343","418","6","767","1498","0","51.20","22.90"
"63","000","00","040","0019","0535","620","279","341","7","627","1322","0","47.43","21.10"
"63","000","00","040","0020","0000","2107","888","1219","18","2125","4414","0","48.14","20.12"
"63","000","00","040","0020","0564","747","274","473","4","751","1503","0","49.97","18.23"
"63","000","00","040","0020","0565","678","290","388","7","685","1424","0","48.10","20.37"
"63","000","00","040","0020","0566","682","324","358","7","689","1487","0","46.33","21.79"
"63","000","00","040","0021","0000","2557","1178","1379","29","2586","5384","0","48.03","21.88"
"63","000","00","040","0021","0567","552","221","331","8","560","1281","0","43.72","17.25"
"63","000","00","040","0021","0568","708","316","392","2","710","1432","0","49.58","22.07"
"63","000","00","040","0021","0569","671","328","343","8","679","1363","0","49.82","24.06"
"63","000","00","040","0021","0570","626","313","313","11","637","1308","0","48.70","23.93"
"63","000","00","040","0022","0000","1849","853","996","20","1869","4061","0","46.02","21.00"
"63","000","00","040","0022","0571","581","295","286","7","588","1207","0","48.72","24.44"
"63","000","00","040","0022","0572","612","250","362","8","620","1373","0","45.16","18.21"
"63","000","00","040","0022","0573","656","308","348","5","661","1481","0","44.63","20.80"
"63","000","00","040","0023","0000","1953","860","1093","19","1972","4318","0","45.67","19.92"
"63","000","00","040","0023","0574","685","292","393","6","691","1537","0","44.96","19.00"
"63","000","00","040","0023","0575","642","292","350","6","648","1382","0","46.89","21.13"
"63","000","00","040","0023","0576","626","276","350","7","633","1399","0","45.25","19.73"
"63","000","00","040","0024","0000","2331","1171","1160","23","2354","6616","0","35.58","17.70"
"63","000","00","040","0024","0578","505","233","272","4","509","1006","0","50.60","23.16"
"63","000","00","040","0024","0579","538","279","259","2","540","1144","0","47.20","24.39"
"63","000","00","040","0024","0580","621","312","309","6","627","1278","0","49.06","24.41"
"63","000","00","040","0024","0581","667","347","320","11","678","3188","0","21.27","10.88"
"63","000","00","040","0025","0000","3075","1400","1675","21","3096","6794","0","45.57","20.61"
"63","000","00","040","0025","0582","638","285","353","0","638","1305","0","48.89","21.84"
"63","000","00","040","0025","0583","690","315","375","2","692","1544","0","44.82","20.40"
"63","000","00","040","0025","0584","550","248","302","5","555","1265","0","43.87","19.60"
"63","000","00","040","0025","0585","585","265","320","6","591","1329","0","44.47","19.94"
"63","000","00","040","0025","0586","612","287","325","8","620","1351","0","45.89","21.24"
"63","000","00","040","0026","0000","1585","697","888","16","1601","3692","0","43.36","18.88"
"63","000","00","040","0026","0587","601","291","310","5","606","1322","0","45.84","22.01"
"63","000","00","040","0026","0588","425","179","246","5","430","1118","0","38.46","16.01"
"63","000","00","040","0026","0589","559","227","332","6","565","1252","0","45.13","18.13"
"63","000","00","040","0027","0000","3076","1430","1646","26","3102","6421","0","48.31","22.27"
"63","000","00","040","0027","0590","624","294","330","3","627","1340","0","46.79","21.94"
"63","000","00","040","0027","0591","618","299","319","7","625","1214","0","51.48","24.63"
"63","000","00","040","0027","0592","599","271","328","1","600","1275","0","47.06","21.25"
"63","000","00","040","0027","0593","643","297","346","11","654","1317","0","49.66","22.55"
"63","000","00","040","0027","0594","592","269","323","4","596","1275","0","46.75","21.10"
"63","000","00","040","0028","0000","2846","1444","1402","25","2871","5828","0","49.26","24.78"
"63","000","00","040","0028","0595","798","403","395","9","807","1584","0","50.95","25.44"
"63","000","00","040","0028","0596","683","359","324","3","686","1403","0","48.90","25.59"
"63","000","00","040","0028","0597","667","307","360","3","670","1364","0","49.12","22.51"
"63","000","00","040","0028","0598","698","375","323","10","708","1477","0","47.94","25.39"
"63","000","00","040","0029","0000","3107","1438","1669","21","3128","6371","0","49.10","22.57"
"63","000","00","040","0029","0599","619","323","296","8","627","1279","0","49.02","25.25"
"63","000","00","040","0029","0600","576","268","308","3","579","1280","0","45.23","20.94"
"63","000","00","040","0029","0601","654","258","396","2","656","1302","0","50.38","19.82"
"63","000","00","040","0029","0602","631","269","362","5","636","1232","0","51.62","21.83"
"63","000","00","040","0029","0603","627","320","307","3","630","1278","0","49.30","25.04"
"63","000","00","040","0030","0000","2267","963","1304","16","2283","4719","0","48.38","20.41"
"63","000","00","040","0030","0604","739","369","370","7","746","1540","0","48.44","23.96"
"63","000","00","040","0030","0605","797","311","486","5","802","1590","0","50.44","19.56"
"63","000","00","040","0030","0606","731","283","448","4","735","1589","0","46.26","17.81"
"63","000","00","040","0031","0000","2193","992","1201","10","2203","4380","0","50.30","22.65"
"63","000","00","040","0031","0607","747","337","410","7","754","1512","0","49.87","22.29"
"63","000","00","040","0031","0608","757","332","425","3","760","1451","0","52.38","22.88"
"63","000","00","040","0031","0609","689","323","366","0","689","1417","0","48.62","22.79"
"63","000","00","040","0032","0000","2159","1037","1122","12","2171","4589","0","47.31","22.60"
"63","000","00","040","0032","0610","748","348","400","8","756","1593","0","47.46","21.85"
"63","000","00","040","0032","0611","716","364","352","0","716","1514","0","47.29","24.04"
"63","000","00","040","0032","0612","695","325","370","4","699","1482","0","47.17","21.93"
"63","000","00","040","0033","0000","1466","726","740","6","1472","3031","0","48.56","23.95"
"63","000","00","040","0033","0613","548","289","259","1","549","1128","0","48.67","25.62"
"63","000","00","040","0033","0614","488","235","253","4","492","1012","0","48.62","23.22"
"63","000","00","040","0033","0615","430","202","228","1","431","891","0","48.37","22.67"
"63","000","00","040","0034","0000","2070","1085","985","19","2089","4892","0","42.70","22.18"
"63","000","00","040","0034","0616","546","286","260","4","550","1292","0","42.57","22.14"
"63","000","00","040","0034","0617","539","299","240","7","546","1233","0","44.28","24.25"
"63","000","00","040","0034","0618","470","243","227","4","474","1138","0","41.65","21.35"
"63","000","00","040","0034","0619","515","257","258","4","519","1229","0","42.23","20.91"
"63","000","00","040","0035","0000","2238","1539","699","19","2257","4278","0","52.76","35.97"
"63","000","00","040","0035","0620","514","320","194","2","516","1020","0","50.59","31.37"
"63","000","00","040","0035","0621","559","357","202","4","563","1085","0","51.89","32.90"
"63","000","00","040","0035","0622","583","424","159","4","587","1025","0","57.27","41.37"
"63","000","00","040","0035","0623","582","438","144","9","591","1148","0","51.48","38.15"
"63","000","00","040","0036","0000","1863","881","982","12","1875","3885","0","48.26","22.68"
"63","000","00","040","0036","0624","620","298","322","1","621","1310","0","47.40","22.75"
"63","000","00","040","0036","0625","598","278","320","6","604","1240","0","48.71","22.42"
"63","000","00","040","0036","0626","645","305","340","5","650","1335","0","48.69","22.85"
"63","000","00","040","0037","0000","1310","695","615","11","1321","2772","0","47.66","25.07"
"63","000","00","040","0037","0627","414","234","180","3","417","920","0","45.33","25.43"
"63","000","00","040","0037","0628","420","213","207","7","427","894","0","47.76","23.83"
"63","000","00","040","0037","0629","476","248","228","1","477","958","0","49.79","25.89"
"63","000","00","040","0038","0000","1208","576","632","12","1220","2553","0","47.79","22.56"
"63","000","00","040","0038","0630","648","321","327","9","657","1354","0","48.52","23.71"
"63","000","00","040","0038","0631","560","255","305","3","563","1199","0","46.96","21.27"
"63","000","00","040","0039","0000","2489","1196","1293","21","2510","5215","0","48.13","22.93"
"63","000","00","040","0039","0632","617","278","339","9","626","1296","0","48.30","21.45"
"63","000","00","040","0039","0633","588","253","335","3","591","1294","0","45.67","19.55"
"63","000","00","040","0039","0634","599","314","285","4","603","1271","0","47.44","24.70"
"63","000","00","040","0039","0635","685","351","334","5","690","1354","0","50.96","25.92"
"63","000","00","040","0040","0000","1932","1131","801","26","1958","4000","0","48.95","28.28"
"63","000","00","040","0040","0636","645","382","263","6","651","1383","0","47.07","27.62"
"63","000","00","040","0040","0637","677","360","317","15","692","1372","0","50.44","26.24"
"63","000","00","040","0040","0638","610","389","221","5","615","1245","0","49.40","31.24"
"63","000","00","040","0041","0000","2882","1588","1294","35","2917","6417","0","45.46","24.75"
"63","000","00","040","0041","0554","483","247","236","6","489","1014","0","48.22","24.36"
"63","000","00","040","0041","0555","585","336","249","3","588","1269","0","46.34","26.48"
"63","000","00","040","0041","0556","534","294","240","8","542","1261","0","42.98","23.31"
"63","000","00","040","0041","0557","653","340","313","10","663","1449","0","45.76","23.46"
"63","000","00","040","0041","0558","627","371","256","8","635","1424","0","44.59","26.05"
"63","000","00","040","0042","0000","1080","655","425","9","1089","2179","0","49.98","30.06"
"63","000","00","040","0042","0559","592","383","209","3","595","1185","0","50.21","32.32"
"63","000","00","040","0042","0560","488","272","216","6","494","994","0","49.70","27.36"
"63","000","00","050","0000","0000","59203","33267","25936","478","59681","123767","153172","48.22","26.88"
"63","000","00","050","0001","0000","1194","613","581","12","1206","2569","0","46.94","23.86"
"63","000","00","050","0001","0720","416","231","185","7","423","837","0","50.54","27.60"
"63","000","00","050","0001","0721","428","214","214","4","432","920","0","46.96","23.26"
"63","000","00","050","0001","0722","350","168","182","1","351","812","0","43.23","20.69"
"63","000","00","050","0002","0000","895","609","286","5","900","2107","0","42.71","28.90"
"63","000","00","050","0002","0723","494","362","132","3","497","1034","0","48.07","35.01"
"63","000","00","050","0002","0724","401","247","154","2","403","1073","0","37.56","23.02"
"63","000","00","050","0003","0000","1111","600","511","9","1120","2181","0","51.35","27.51"
"63","000","00","050","0003","0725","629","335","294","7","636","1183","0","53.76","28.32"
"63","000","00","050","0003","0726","482","265","217","2","484","998","0","48.50","26.55"
"63","000","00","050","0004","0000","1890","1146","744","16","1906","4011","0","47.52","28.57"
"63","000","00","050","0004","0727","454","232","222","3","457","981","0","46.59","23.65"
"63","000","00","050","0004","0728","429","275","154","5","434","985","0","44.06","27.92"
"63","000","00","050","0004","0729","527","359","168","6","533","1136","0","46.92","31.60"
"63","000","00","050","0004","0730","480","280","200","2","482","909","0","53.03","30.80"
"63","000","00","050","0005","0000","1943","1158","785","14","1957","3802","0","51.47","30.46"
"63","000","00","050","0005","0731","518","299","219","6","524","990","0","52.93","30.20"
"63","000","00","050","0005","0732","458","261","197","5","463","940","0","49.26","27.77"
"63","000","00","050","0005","0733","538","350","188","1","539","989","0","54.50","35.39"
"63","000","00","050","0005","0734","429","248","181","2","431","883","0","48.81","28.09"
"63","000","00","050","0006","0000","2684","1465","1219","24","2708","5155","0","52.53","28.42"
"63","000","00","050","0006","0735","560","327","233","6","566","1073","0","52.75","30.48"
"63","000","00","050","0006","0736","534","295","239","7","541","1025","0","52.78","28.78"
"63","000","00","050","0006","0737","491","249","242","4","495","960","0","51.56","25.94"
"63","000","00","050","0006","0738","534","292","242","2","536","1025","0","52.29","28.49"
"63","000","00","050","0006","0739","565","302","263","5","570","1072","0","53.17","28.17"
"63","000","00","050","0007","0000","2491","1368","1123","16","2507","4893","0","51.24","27.96"
"63","000","00","050","0007","0740","647","389","258","4","651","1195","0","54.48","32.55"
"63","000","00","050","0007","0741","638","368","270","0","638","1283","0","49.73","28.68"
"63","000","00","050","0007","0742","581","292","289","2","583","1159","0","50.30","25.19"
"63","000","00","050","0007","0743","625","319","306","10","635","1256","0","50.56","25.40"
"63","000","00","050","0008","0000","1305","751","554","8","1313","2775","0","47.32","27.06"
"63","000","00","050","0008","0744","389","226","163","0","389","873","0","44.56","25.89"
"63","000","00","050","0008","0745","423","214","209","4","427","900","0","47.44","23.78"
"63","000","00","050","0008","0746","493","311","182","4","497","1002","0","49.60","31.04"
"63","000","00","050","0009","0000","2365","1343","1022","21","2386","4773","0","49.99","28.14"
"63","000","00","050","0009","0747","607","335","272","7","614","1259","0","48.77","26.61"
"63","000","00","050","0009","0748","689","404","285","6","695","1414","0","49.15","28.57"
"63","000","00","050","0009","0749","495","264","231","2","497","1022","0","48.63","25.83"
"63","000","00","050","0009","0750","574","340","234","6","580","1078","0","53.80","31.54"
"63","000","00","050","0010","0000","1764","1005","759","14","1778","3653","0","48.67","27.51"
"63","000","00","050","0010","0751","621","368","253","5","626","1300","0","48.15","28.31"
"63","000","00","050","0010","0752","558","312","246","3","561","1136","0","49.38","27.46"
"63","000","00","050","0010","0753","585","325","260","6","591","1217","0","48.56","26.71"
"63","000","00","050","0011","0000","2464","1299","1165","30","2494","5214","0","47.83","24.91"
"63","000","00","050","0011","0639","491","247","244","6","497","1113","0","44.65","22.19"
"63","000","00","050","0011","0640","491","268","223","5","496","1048","0","47.33","25.57"
"63","000","00","050","0011","0641","454","234","220","2","456","986","0","46.25","23.73"
"63","000","00","050","0011","0642","480","274","206","9","489","974","0","50.21","28.13"
"63","000","00","050","0011","0643","548","276","272","8","556","1093","0","50.87","25.25"
"63","000","00","050","0012","0000","1985","1117","868","13","1998","4177","0","47.83","26.74"
"63","000","00","050","0012","0644","587","324","263","4","591","1112","0","53.15","29.14"
"63","000","00","050","0012","0645","474","240","234","2","476","1050","0","45.33","22.86"
"63","000","00","050","0012","0646","498","317","181","5","503","1061","0","47.41","29.88"
"63","000","00","050","0012","0647","426","236","190","2","428","954","0","44.86","24.74"
"63","000","00","050","0013","0000","1334","714","620","8","1342","2906","0","46.18","24.57"
"63","000","00","050","0013","0648","496","271","225","4","500","995","0","50.25","27.24"
"63","000","00","050","0013","0649","433","221","212","4","437","987","0","44.28","22.39"
"63","000","00","050","0013","0650","405","222","183","0","405","924","0","43.83","24.03"
"63","000","00","050","0014","0000","2331","1357","974","29","2360","5486","0","43.02","24.74"
"63","000","00","050","0014","0651","491","296","195","4","495","1183","0","41.84","25.02"
"63","000","00","050","0014","0652","485","303","182","8","493","1210","0","40.74","25.04"
"63","000","00","050","0014","0653","475","266","209","9","484","1041","0","46.49","25.55"
"63","000","00","050","0014","0654","380","232","148","3","383","894","0","42.84","25.95"
"63","000","00","050","0014","0655","500","260","240","5","505","1158","0","43.61","22.45"
"63","000","00","050","0015","0000","1590","827","763","11","1601","3475","0","46.07","23.80"
"63","000","00","050","0015","0656","511","279","232","7","518","1169","0","44.31","23.87"
"63","000","00","050","0015","0657","552","284","268","3","555","1189","0","46.68","23.89"
"63","000","00","050","0015","0658","527","264","263","1","528","1117","0","47.27","23.63"
"63","000","00","050","0016","0000","1232","658","574","8","1240","2583","0","48.01","25.47"
"63","000","00","050","0016","0659","400","179","221","3","403","837","0","48.15","21.39"
"63","000","00","050","0016","0660","419","264","155","1","420","897","0","46.82","29.43"
"63","000","00","050","0016","0661","413","215","198","4","417","849","0","49.12","25.32"
"63","000","00","050","0017","0000","1120","684","436","11","1131","2153","0","52.53","31.77"
"63","000","00","050","0017","0662","595","369","226","5","600","1091","0","55.00","33.82"
"63","000","00","050","0017","0663","525","315","210","6","531","1062","0","50.00","29.66"
"63","000","00","050","0018","0000","1352","807","545","10","1362","2662","0","51.16","30.32"
"63","000","00","050","0018","0664","508","286","222","4","512","997","0","51.35","28.69"
"63","000","00","050","0018","0665","433","283","150","2","435","825","0","52.73","34.30"
"63","000","00","050","0018","0666","411","238","173","4","415","840","0","49.40","28.33"
"63","000","00","050","0019","0000","4413","2499","1914","28","4441","8918","0","49.80","28.02"
"63","000","00","050","0019","0667","609","346","263","2","611","1313","0","46.53","26.35"
"63","000","00","050","0019","0668","580","333","247","7","587","1213","0","48.39","27.45"
"63","000","00","050","0019","0669","730","400","330","1","731","1369","0","53.40","29.22"
"63","000","00","050","0019","0670","664","389","275","2","666","1276","0","52.19","30.49"
"63","000","00","050","0019","0671","638","373","265","3","641","1239","0","51.74","30.10"
"63","000","00","050","0019","0672","573","303","270","6","579","1172","0","49.40","25.85"
"63","000","00","050","0019","0673","619","355","264","7","626","1336","0","46.86","26.57"
"63","000","00","050","0020","0000","2024","1101","923","22","2046","4216","0","48.53","26.11"
"63","000","00","050","0020","0674","477","255","222","4","481","1020","0","47.16","25.00"
"63","000","00","050","0020","0675","498","298","200","7","505","1068","0","47.28","27.90"
"63","000","00","050","0020","0676","523","285","238","5","528","1060","0","49.81","26.89"
"63","000","00","050","0020","0677","526","263","263","6","532","1068","0","49.81","24.63"
"63","000","00","050","0021","0000","3279","2037","1242","23","3302","6851","0","48.20","29.73"
"63","000","00","050","0021","0678","524","304","220","5","529","1112","0","47.57","27.34"
"63","000","00","050","0021","0679","551","328","223","4","555","1175","0","47.23","27.91"
"63","000","00","050","0021","0680","565","343","222","2","567","1173","0","48.34","29.24"
"63","000","00","050","0021","0681","554","330","224","2","556","1188","0","46.80","27.78"
"63","000","00","050","0021","0682","558","390","168","2","560","1089","0","51.42","35.81"
"63","000","00","050","0021","0683","527","342","185","8","535","1114","0","48.03","30.70"
"63","000","00","050","0022","0000","564","333","231","3","567","1240","0","45.73","26.85"
"63","000","00","050","0022","0684","564","333","231","3","567","1240","0","45.73","26.85"
"63","000","00","050","0023","0000","1408","751","657","6","1414","3153","0","44.85","23.82"
"63","000","00","050","0023","0685","378","219","159","2","380","887","0","42.84","24.69"
"63","000","00","050","0023","0686","509","255","254","2","511","1077","0","47.45","23.68"
"63","000","00","050","0023","0687","521","277","244","2","523","1189","0","43.99","23.30"
"63","000","00","050","0024","0000","1072","590","482","9","1081","2719","0","39.76","21.70"
"63","000","00","050","0024","0688","337","192","145","3","340","901","0","37.74","21.31"
"63","000","00","050","0024","0689","372","200","172","5","377","856","0","44.04","23.36"
"63","000","00","050","0024","0690","363","198","165","1","364","962","0","37.84","20.58"
"63","000","00","050","0025","0000","1287","658","629","11","1298","2626","0","49.43","25.06"
"63","000","00","050","0025","0691","461","221","240","8","469","896","0","52.34","24.67"
"63","000","00","050","0025","0692","396","217","179","1","397","860","0","46.16","25.23"
"63","000","00","050","0025","0693","430","220","210","2","432","870","0","49.66","25.29"
"63","000","00","050","0026","0000","1909","1065","844","16","1925","4871","0","39.52","21.86"
"63","000","00","050","0026","0694","559","310","249","5","564","1140","0","49.47","27.19"
"63","000","00","050","0026","0695","420","271","149","4","424","1775","0","23.89","15.27"
"63","000","00","050","0026","0696","458","245","213","4","462","1002","0","46.11","24.45"
"63","000","00","050","0026","0697","472","239","233","3","475","954","0","49.79","25.05"
"63","000","00","050","0027","0000","1930","1009","921","11","1941","3689","0","52.62","27.35"
"63","000","00","050","0027","0698","461","242","219","1","462","863","0","53.53","28.04"
"63","000","00","050","0027","0699","502","234","268","5","507","988","0","51.32","23.68"
"63","000","00","050","0027","0700","531","287","244","5","536","974","0","55.03","29.47"
"63","000","00","050","0027","0701","436","246","190","0","436","864","0","50.46","28.47"
"63","000","00","050","0028","0000","1504","909","595","16","1520","3113","0","48.83","29.20"
"63","000","00","050","0028","0702","499","282","217","4","503","1047","0","48.04","26.93"
"63","000","00","050","0028","0703","499","304","195","5","504","1005","0","50.15","30.25"
"63","000","00","050","0028","0704","506","323","183","7","513","1061","0","48.35","30.44"
"63","000","00","050","0029","0000","2300","1263","1037","16","2316","4517","0","51.27","27.96"
"63","000","00","050","0029","0705","591","342","249","5","596","1216","0","49.01","28.13"
"63","000","00","050","0029","0706","607","333","274","3","610","1188","0","51.35","28.03"
"63","000","00","050","0029","0707","471","253","218","4","475","930","0","51.08","27.20"
"63","000","00","050","0029","0708","631","335","296","4","635","1183","0","53.68","28.32"
"63","000","00","050","0030","0000","3074","1688","1386","27","3101","6282","0","49.36","26.87"
"63","000","00","050","0030","0709","682","370","312","4","686","1389","0","49.39","26.64"
"63","000","00","050","0030","0710","568","316","252","4","572","1238","0","46.20","25.53"
"63","000","00","050","0030","0711","683","374","309","6","689","1381","0","49.89","27.08"
"63","000","00","050","0030","0712","531","296","235","2","533","1050","0","50.76","28.19"
"63","000","00","050","0030","0713","610","332","278","11","621","1224","0","50.74","27.12"
"63","000","00","050","0031","0000","3389","1843","1546","31","3420","6997","0","48.88","26.34"
"63","000","00","050","0031","0714","497","289","208","4","501","1095","0","45.75","26.39"
"63","000","00","050","0031","0715","565","280","285","6","571","1158","0","49.31","24.18"
"63","000","00","050","0031","0716","567","319","248","7","574","1170","0","49.06","27.26"
"63","000","00","050","0031","0717","572","286","286","3","575","1096","0","52.46","26.09"
"63","000","00","050","0031","0718","537","307","230","2","539","1168","0","46.15","26.28"
"63","000","00","050","0031","0719","651","362","289","9","660","1310","0","50.38","27.63"
"63","000","00","060","0000","0000","47318","20091","27227","366","47684","103815","122719","45.93","19.35"
"63","000","00","060","0001","0000","1142","499","643","7","1149","2534","0","45.34","19.69"
"63","000","00","060","0001","0754","531","218","313","5","536","1207","0","44.41","18.06"
"63","000","00","060","0001","0755","611","281","330","2","613","1327","0","46.19","21.18"
"63","000","00","060","0002","0000","1217","517","700","13","1230","2790","0","44.09","18.53"
"63","000","00","060","0002","0756","493","208","285","3","496","1018","0","48.72","20.43"
"63","000","00","060","0002","0757","432","160","272","2","434","997","0","43.53","16.05"
"63","000","00","060","0002","0758","292","149","143","8","300","775","0","38.71","19.23"
"63","000","00","060","0003","0000","1742","754","988","14","1756","3999","0","43.91","18.85"
"63","000","00","060","0003","0759","582","250","332","7","589","1366","0","43.12","18.30"
"63","000","00","060","0003","0760","569","226","343","7","576","1269","0","45.39","17.81"
"63","000","00","060","0003","0761","591","278","313","0","591","1364","0","43.33","20.38"
"63","000","00","060","0004","0000","1422","578","844","27","1449","3039","0","47.68","19.02"
"63","000","00","060","0004","0762","453","192","261","7","460","969","0","47.47","19.81"
"63","000","00","060","0004","0763","463","191","272","9","472","926","0","50.97","20.63"
"63","000","00","060","0004","0764","506","195","311","11","517","1144","0","45.19","17.05"
"63","000","00","060","0005","0000","2041","823","1218","12","2053","4399","0","46.67","18.71"
"63","000","00","060","0005","0765","546","238","308","1","547","1146","0","47.73","20.77"
"63","000","00","060","0005","0766","407","159","248","1","408","970","0","42.06","16.39"
"63","000","00","060","0005","0767","515","192","323","5","520","1166","0","44.60","16.47"
"63","000","00","060","0005","0768","573","234","339","5","578","1117","0","51.75","20.95"
"63","000","00","060","0006","0000","1801","810","991","12","1813","3812","0","47.56","21.25"
"63","000","00","060","0006","0769","595","320","275","1","596","1254","0","47.53","25.52"
"63","000","00","060","0006","0770","592","243","349","4","596","1307","0","45.60","18.59"
"63","000","00","060","0006","0771","614","247","367","7","621","1251","0","49.64","19.74"
"63","000","00","060","0007","0000","2182","983","1199","15","2197","4940","0","44.47","19.90"
"63","000","00","060","0007","0772","560","267","293","4","564","1235","0","45.67","21.62"
"63","000","00","060","0007","0773","503","213","290","2","505","1165","0","43.35","18.28"
"63","000","00","060","0007","0774","560","245","315","4","564","1243","0","45.37","19.71"
"63","000","00","060","0007","0775","559","258","301","5","564","1297","0","43.48","19.89"
"63","000","00","060","0008","0000","1952","846","1106","10","1962","4161","0","47.15","20.33"
"63","000","00","060","0008","0776","462","198","264","3","465","974","0","47.74","20.33"
"63","000","00","060","0008","0777","516","243","273","3","519","1129","0","45.97","21.52"
"63","000","00","060","0008","0778","464","191","273","2","466","942","0","49.47","20.28"
"63","000","00","060","0008","0779","510","214","296","2","512","1116","0","45.88","19.18"
"63","000","00","060","0009","0000","1814","694","1120","17","1831","3943","0","46.44","17.60"
"63","000","00","060","0009","0780","641","241","400","3","644","1338","0","48.13","18.01"
"63","000","00","060","0009","0781","572","242","330","4","576","1299","0","44.34","18.63"
"63","000","00","060","0009","0782","601","211","390","10","611","1306","0","46.78","16.16"
"63","000","00","060","0010","0000","1593","703","890","10","1603","3592","0","44.63","19.57"
"63","000","00","060","0010","0783","455","211","244","1","456","1082","0","42.14","19.50"
"63","000","00","060","0010","0784","567","276","291","2","569","1214","0","46.87","22.73"
"63","000","00","060","0010","0785","571","216","355","7","578","1296","0","44.60","16.67"
"63","000","00","060","0011","0000","3423","1494","1929","31","3454","7671","0","45.03","19.48"
"63","000","00","060","0011","0786","568","213","355","4","572","1340","0","42.69","15.90"
"63","000","00","060","0011","0787","541","245","296","3","544","1168","0","46.58","20.98"
"63","000","00","060","0011","0788","548","249","299","2","550","1259","0","43.69","19.78"
"63","000","00","060","0011","0789","669","282","387","7","676","1337","0","50.56","21.09"
"63","000","00","060","0011","0790","588","255","333","7","595","1357","0","43.85","18.79"
"63","000","00","060","0011","0791","509","250","259","8","517","1210","0","42.73","20.66"
"63","000","00","060","0012","0000","1542","645","897","9","1551","3376","0","45.94","19.11"
"63","000","00","060","0012","0792","555","221","334","3","558","1128","0","49.47","19.59"
"63","000","00","060","0012","0793","487","204","283","1","488","1097","0","44.48","18.60"
"63","000","00","060","0012","0794","500","220","280","5","505","1151","0","43.87","19.11"
"63","000","00","060","0013","0000","2478","1122","1356","25","2503","5223","0","47.92","21.48"
"63","000","00","060","0013","0795","613","267","346","6","619","1338","0","46.26","19.96"
"63","000","00","060","0013","0796","641","277","364","9","650","1305","0","49.81","21.23"
"63","000","00","060","0013","0797","630","291","339","7","637","1320","0","48.26","22.05"
"63","000","00","060","0013","0798","594","287","307","3","597","1260","0","47.38","22.78"
"63","000","00","060","0014","0000","983","387","596","8","991","2231","0","44.42","17.35"
"63","000","00","060","0014","0799","458","180","278","2","460","1080","0","42.59","16.67"
"63","000","00","060","0014","0800","525","207","318","6","531","1151","0","46.13","17.98"
"63","000","00","060","0015","0000","1414","572","842","9","1423","2898","0","49.10","19.74"
"63","000","00","060","0015","0801","629","251","378","6","635","1316","0","48.25","19.07"
"63","000","00","060","0015","0802","785","321","464","3","788","1582","0","49.81","20.29"
"63","000","00","060","0016","0000","1948","870","1078","20","1968","4213","0","46.71","20.65"
"63","000","00","060","0016","0803","485","215","270","6","491","1013","0","48.47","21.22"
"63","000","00","060","0016","0804","549","257","292","7","556","1206","0","46.10","21.31"
"63","000","00","060","0016","0805","441","202","239","3","444","935","0","47.49","21.60"
"63","000","00","060","0016","0806","473","196","277","4","477","1059","0","45.04","18.51"
"63","000","00","060","0017","0000","997","374","623","9","1006","2305","0","43.64","16.23"
"63","000","00","060","0017","0807","545","208","337","5","550","1166","0","47.17","17.84"
"63","000","00","060","0017","0808","452","166","286","4","456","1139","0","40.04","14.57"
"63","000","00","060","0018","0000","1904","830","1074","13","1917","3894","0","49.23","21.31"
"63","000","00","060","0018","0809","630","277","353","2","632","1280","0","49.38","21.64"
"63","000","00","060","0018","0810","623","277","346","7","630","1272","0","49.53","21.78"
"63","000","00","060","0018","0811","651","276","375","4","655","1342","0","48.81","20.57"
"63","000","00","060","0019","0000","1425","551","874","9","1434","4063","0","35.29","13.56"
"63","000","00","060","0019","0812","471","184","287","3","474","959","0","49.43","19.19"
"63","000","00","060","0019","0813","461","190","271","5","466","2117","0","22.01","8.97"
"63","000","00","060","0019","0814","493","177","316","1","494","987","0","50.05","17.93"
"63","000","00","060","0020","0000","1808","732","1076","15","1823","4057","0","44.93","18.04"
"63","000","00","060","0020","0815","350","108","242","5","355","1012","0","35.08","10.67"
"63","000","00","060","0020","0816","461","198","263","2","463","1027","0","45.08","19.28"
"63","000","00","060","0020","0817","482","186","296","4","486","1062","0","45.76","17.51"
"63","000","00","060","0020","0818","515","240","275","4","519","956","0","54.29","25.10"
"63","000","00","060","0021","0000","2601","1042","1559","16","2617","5537","0","47.26","18.82"
"63","000","00","060","0021","0819","513","184","329","3","516","1115","0","46.28","16.50"
"63","000","00","060","0021","0820","549","247","302","2","551","1099","0","50.14","22.47"
"63","000","00","060","0021","0821","534","208","326","3","537","1120","0","47.95","18.57"
"63","000","00","060","0021","0822","528","207","321","5","533","1167","0","45.67","17.74"
"63","000","00","060","0021","0823","477","196","281","3","480","1036","0","46.33","18.92"
"63","000","00","060","0022","0000","3184","1361","1823","23","3207","6748","0","47.53","20.17"
"63","000","00","060","0022","0824","454","195","259","5","459","1011","0","45.40","19.29"
"63","000","00","060","0022","0825","439","165","274","3","442","974","0","45.38","16.94"
"63","000","00","060","0022","0826","569","275","294","4","573","1101","0","52.04","24.98"
"63","000","00","060","0022","0827","585","280","305","2","587","1235","0","47.53","22.67"
"63","000","00","060","0022","0828","603","252","351","5","608","1276","0","47.65","19.75"
"63","000","00","060","0022","0829","534","194","340","4","538","1151","0","46.74","16.85"
"63","000","00","060","0024","0000","2157","866","1291","16","2173","4953","0","43.87","17.48"
"63","000","00","060","0024","0830","520","196","324","2","522","1265","0","41.26","15.49"
"63","000","00","060","0024","0831","591","236","355","5","596","1345","0","44.31","17.55"
"63","000","00","060","0024","0832","494","210","284","3","497","1162","0","42.77","18.07"
"63","000","00","060","0024","0833","552","224","328","6","558","1181","0","47.25","18.97"
"63","000","00","060","0025","0000","2688","1283","1405","11","2699","5666","0","47.64","22.64"
"63","000","00","060","0025","0834","469","209","260","2","471","1080","0","43.61","19.35"
"63","000","00","060","0025","0835","562","278","284","3","565","1144","0","49.39","24.30"
"63","000","00","060","0025","0836","575","301","274","3","578","1122","0","51.52","26.83"
"63","000","00","060","0025","0837","537","268","269","2","539","1138","0","47.36","23.55"
"63","000","00","060","0025","0838","545","227","318","1","546","1182","0","46.19","19.20"
"63","000","00","060","0026","0000","1860","755","1105","15","1875","3771","0","49.72","20.02"
"63","000","00","060","0026","0839","633","237","396","7","640","1310","0","48.85","18.09"
"63","000","00","060","0026","0840","643","271","372","4","647","1300","0","49.77","20.85"
"63","000","00","060","0026","0841","584","247","337","4","588","1161","0","50.65","21.27"
"63","000","00","070","0000","0000","71368","36142","35226","721","72089","157078","179485","45.89","23.01"
"63","000","00","070","0001","0000","1956","1087","869","21","1977","4638","0","42.63","23.44"
"63","000","00","070","0001","0842","527","286","241","5","532","1159","0","45.90","24.68"
"63","000","00","070","0001","0843","485","312","173","9","494","1153","0","42.84","27.06"
"63","000","00","070","0001","0844","478","238","240","2","480","1195","0","40.17","19.92"
"63","000","00","070","0001","0845","466","251","215","5","471","1131","0","41.64","22.19"
"63","000","00","070","0002","0000","1119","592","527","15","1134","2831","0","40.06","20.91"
"63","000","00","070","0002","0846","398","206","192","5","403","906","0","44.48","22.74"
"63","000","00","070","0002","0847","390","189","201","4","394","972","0","40.53","19.44"
"63","000","00","070","0002","0848","331","197","134","6","337","953","0","35.36","20.67"
"63","000","00","070","0003","0000","1343","731","612","10","1353","3187","0","42.45","22.94"
"63","000","00","070","0003","0849","477","291","186","5","482","1096","0","43.98","26.55"
"63","000","00","070","0003","0850","460","239","221","2","462","1114","0","41.47","21.45"
"63","000","00","070","0003","0851","406","201","205","3","409","977","0","41.86","20.57"
"63","000","00","070","0004","0000","2699","1354","1345","37","2736","5920","0","46.22","22.87"
"63","000","00","070","0004","0852","535","247","288","6","541","1156","0","46.80","21.37"
"63","000","00","070","0004","0853","534","255","279","9","543","1157","0","46.93","22.04"
"63","000","00","070","0004","0854","564","293","271","7","571","1252","0","45.61","23.40"
"63","000","00","070","0004","0855","644","336","308","9","653","1423","0","45.89","23.61"
"63","000","00","070","0004","0856","422","223","199","6","428","932","0","45.92","23.93"
"63","000","00","070","0005","0000","2512","1149","1363","18","2530","5356","0","47.24","21.45"
"63","000","00","070","0005","0857","555","228","327","4","559","1295","0","43.17","17.61"
"63","000","00","070","0005","0858","592","276","316","4","596","1255","0","47.49","21.99"
"63","000","00","070","0005","0859","642","340","302","5","647","1383","0","46.78","24.58"
"63","000","00","070","0005","0860","723","305","418","5","728","1423","0","51.16","21.43"
"63","000","00","070","0006","0000","2258","1056","1202","14","2272","5124","0","44.34","20.61"
"63","000","00","070","0006","0861","601","310","291","2","603","1318","0","45.75","23.52"
"63","000","00","070","0006","0862","606","279","327","6","612","1329","0","46.05","20.99"
"63","000","00","070","0006","0863","500","209","291","4","504","1198","0","42.07","17.45"
"63","000","00","070","0006","0864","551","258","293","2","553","1279","0","43.24","20.17"
"63","000","00","070","0007","0000","1965","834","1131","25","1990","4299","0","46.29","19.40"
"63","000","00","070","0007","0865","464","194","270","4","468","1100","0","42.55","17.64"
"63","000","00","070","0007","0866","565","261","304","6","571","1170","0","48.80","22.31"
"63","000","00","070","0007","0867","431","183","248","9","440","1008","0","43.65","18.15"
"63","000","00","070","0007","0868","505","196","309","6","511","1021","0","50.05","19.20"
"63","000","00","070","0008","0000","1566","704","862","10","1576","3366","0","46.82","20.92"
"63","000","00","070","0008","0869","534","248","286","4","538","1219","0","44.13","20.34"
"63","000","00","070","0008","0870","500","230","270","3","503","985","0","51.07","23.35"
"63","000","00","070","0008","0871","532","226","306","3","535","1162","0","46.04","19.45"
"63","000","00","070","0009","0000","2025","1006","1019","14","2039","4094","0","49.80","24.57"
"63","000","00","070","0009","0872","624","313","311","2","626","1188","0","52.69","26.35"
"63","000","00","070","0009","0873","513","274","239","2","515","1001","0","51.45","27.37"
"63","000","00","070","0009","0874","465","212","253","4","469","1041","0","45.05","20.37"
"63","000","00","070","0009","0875","423","207","216","6","429","864","0","49.65","23.96"
"63","000","00","070","0010","0000","1916","852","1064","20","1936","5354","0","36.16","15.91"
"63","000","00","070","0010","0876","557","236","321","4","561","2607","0","21.52","9.05"
"63","000","00","070","0010","0877","436","197","239","3","439","868","0","50.58","22.70"
"63","000","00","070","0010","0878","461","211","250","5","466","944","0","49.36","22.35"
"63","000","00","070","0010","0879","462","208","254","8","470","935","0","50.27","22.25"
"63","000","00","070","0011","0000","2820","1249","1571","24","2844","6064","0","46.90","20.60"
"63","000","00","070","0011","0897","432","178","254","3","435","994","0","43.76","17.91"
"63","000","00","070","0011","0898","594","251","343","3","597","1188","0","50.25","21.13"
"63","000","00","070","0011","0899","497","212","285","2","499","1047","0","47.66","20.25"
"63","000","00","070","0011","0900","654","281","373","11","665","1424","0","46.70","19.73"
"63","000","00","070","0011","0901","643","327","316","5","648","1411","0","45.92","23.18"
"63","000","00","070","0012","0000","1771","825","946","21","1792","3864","0","46.38","21.35"
"63","000","00","070","0012","0902","597","268","329","4","601","1315","0","45.70","20.38"
"63","000","00","070","0012","0903","614","282","332","10","624","1349","0","46.26","20.90"
"63","000","00","070","0012","0904","560","275","285","7","567","1200","0","47.25","22.92"
"63","000","00","070","0013","0000","1527","1178","349","14","1541","2993","0","51.49","39.36"
"63","000","00","070","0013","0960","384","234","150","5","389","946","0","41.12","24.74"
"63","000","00","070","0013","0961","518","416","102","5","523","925","0","56.54","44.97"
"63","000","00","070","0013","0962","625","528","97","4","629","1122","0","56.06","47.06"
"63","000","00","070","0014","0000","3759","2774","985","50","3809","7108","0","53.59","39.03"
"63","000","00","070","0014","0963","650","527","123","11","661","1152","0","57.38","45.75"
"63","000","00","070","0014","0964","629","471","158","10","639","1127","0","56.70","41.79"
"63","000","00","070","0014","0965","596","397","199","10","606","1181","0","51.31","33.62"
"63","000","00","070","0014","0966","644","484","160","14","658","1233","0","53.37","39.25"
"63","000","00","070","0014","0967","603","461","142","2","605","1179","0","51.31","39.10"
"63","000","00","070","0014","0968","637","434","203","3","640","1236","0","51.78","35.11"
"63","000","00","070","0015","0000","2195","1000","1195","26","2221","4679","0","47.47","21.37"
"63","000","00","070","0015","0890","537","204","333","11","548","1159","0","47.28","17.60"
"63","000","00","070","0015","0891","548","257","291","1","549","1147","0","47.86","22.41"
"63","000","00","070","0015","0892","541","280","261","9","550","1261","0","43.62","22.20"
"63","000","00","070","0015","0893","569","259","310","5","574","1112","0","51.62","23.29"
"63","000","00","070","0016","0000","2481","969","1512","28","2509","5752","0","43.62","16.85"
"63","000","00","070","0016","0905","541","189","352","4","545","1294","0","42.12","14.61"
"63","000","00","070","0016","0906","462","179","283","8","470","1064","0","44.17","16.82"
"63","000","00","070","0016","0907","549","220","329","4","553","1172","0","47.18","18.77"
"63","000","00","070","0016","0908","473","202","271","5","478","1041","0","45.92","19.40"
"63","000","00","070","0016","0909","456","179","277","7","463","1181","0","39.20","15.16"
"63","000","00","070","0017","0000","1514","773","741","15","1529","3698","0","41.35","20.90"
"63","000","00","070","0017","0894","517","254","263","2","519","1181","0","43.95","21.51"
"63","000","00","070","0017","0895","513","282","231","3","516","1248","0","41.35","22.60"
"63","000","00","070","0017","0896","484","237","247","10","494","1269","0","38.93","18.68"
"63","000","00","070","0018","0000","3195","1493","1702","23","3218","7226","0","44.53","20.66"
"63","000","00","070","0018","0884","458","239","219","4","462","1190","0","38.82","20.08"
"63","000","00","070","0018","0885","571","251","320","2","573","1256","0","45.62","19.98"
"63","000","00","070","0018","0886","542","239","303","1","543","1146","0","47.38","20.86"
"63","000","00","070","0018","0887","629","303","326","5","634","1231","0","51.50","24.61"
"63","000","00","070","0018","0888","578","249","329","7","585","1275","0","45.88","19.53"
"63","000","00","070","0018","0889","417","212","205","4","421","1128","0","37.32","18.79"
"63","000","00","070","0019","0000","1898","799","1099","19","1917","4403","0","43.54","18.15"
"63","000","00","070","0019","0880","426","182","244","4","430","1013","0","42.45","17.97"
"63","000","00","070","0019","0881","533","226","307","5","538","1167","0","46.10","19.37"
"63","000","00","070","0019","0882","475","208","267","7","482","1092","0","44.14","19.05"
"63","000","00","070","0019","0883","464","183","281","3","467","1131","0","41.29","16.18"
"63","000","00","070","0020","0000","1450","650","800","13","1463","3103","0","47.15","20.95"
"63","000","00","070","0020","0918","445","208","237","4","449","996","0","45.08","20.88"
"63","000","00","070","0020","0919","488","214","274","5","493","1033","0","47.73","20.72"
"63","000","00","070","0020","0920","517","228","289","4","521","1074","0","48.51","21.23"
"63","000","00","070","0021","0000","2221","1355","866","22","2243","5228","0","42.90","25.92"
"63","000","00","070","0021","0969","451","248","203","5","456","1160","0","39.31","21.38"
"63","000","00","070","0021","0970","377","211","166","6","383","948","0","40.40","22.26"
"63","000","00","070","0021","0971","373","209","164","5","378","955","0","39.58","21.88"
"63","000","00","070","0021","0972","506","308","198","2","508","1146","0","44.33","26.88"
"63","000","00","070","0021","0973","514","379","135","4","518","1019","0","50.83","37.19"
"63","000","00","070","0022","0000","1753","771","982","10","1763","3813","0","46.24","20.22"
"63","000","00","070","0022","0921","575","236","339","5","580","1320","0","43.94","17.88"
"63","000","00","070","0022","0922","581","283","298","3","584","1197","0","48.79","23.64"
"63","000","00","070","0022","0923","597","252","345","2","599","1296","0","46.22","19.44"
"63","000","00","070","0023","0000","1308","520","788","16","1324","2802","0","47.25","18.56"
"63","000","00","070","0023","0928","611","262","349","9","620","1359","0","45.62","19.28"
"63","000","00","070","0023","0929","697","258","439","7","704","1443","0","48.79","17.88"
"63","000","00","070","0024","0000","2294","1010","1284","24","2318","5570","0","41.62","18.13"
"63","000","00","070","0024","0910","521","210","311","4","525","1117","0","47.00","18.80"
"63","000","00","070","0024","0911","469","205","264","5","474","1190","0","39.83","17.23"
"63","000","00","070","0024","0912","343","156","187","9","352","944","0","37.29","16.53"
"63","000","00","070","0024","0913","428","204","224","1","429","1119","0","38.34","18.23"
"63","000","00","070","0024","0914","533","235","298","5","538","1200","0","44.83","19.58"
"63","000","00","070","0025","0000","2098","967","1131","20","2118","4714","0","44.93","20.51"
"63","000","00","070","0025","0924","581","275","306","7","588","1197","0","49.12","22.97"
"63","000","00","070","0025","0925","555","269","286","3","558","1234","0","45.22","21.80"
"63","000","00","070","0025","0926","497","219","278","4","501","1197","0","41.85","18.30"
"63","000","00","070","0025","0927","465","204","261","6","471","1086","0","43.37","18.78"
"63","000","00","070","0026","0000","1690","824","866","17","1707","3631","0","47.01","22.69"
"63","000","00","070","0026","0915","513","255","258","5","518","1119","0","46.29","22.79"
"63","000","00","070","0026","0916","611","255","356","4","615","1335","0","46.07","19.10"
"63","000","00","070","0026","0917","566","314","252","8","574","1177","0","48.77","26.68"
"63","000","00","070","0027","0000","1336","633","703","10","1346","2752","0","48.91","23.00"
"63","000","00","070","0027","0937","498","222","276","1","499","1024","0","48.73","21.68"
"63","000","00","070","0027","0938","407","177","230","5","412","853","0","48.30","20.75"
"63","000","00","070","0027","0939","431","234","197","4","435","875","0","49.71","26.74"
"63","000","00","070","0028","0000","1771","792","979","15","1786","3985","0","44.82","19.87"
"63","000","00","070","0028","0934","631","295","336","5","636","1313","0","48.44","22.47"
"63","000","00","070","0028","0935","606","256","350","6","612","1357","0","45.10","18.87"
"63","000","00","070","0028","0936","534","241","293","4","538","1315","0","40.91","18.33"
"63","000","00","070","0029","0000","1482","661","821","21","1503","3075","0","48.88","21.50"
"63","000","00","070","0029","0940","503","220","283","5","508","1014","0","50.10","21.70"
"63","000","00","070","0029","0941","486","213","273","9","495","1011","0","48.96","21.07"
"63","000","00","070","0029","0942","493","228","265","7","500","1050","0","47.62","21.71"
"63","000","00","070","0030","0000","1944","946","998","19","1963","4233","0","46.37","22.35"
"63","000","00","070","0030","0930","465","207","258","6","471","1048","0","44.94","19.75"
"63","000","00","070","0030","0931","495","241","254","5","500","1159","0","43.14","20.79"
"63","000","00","070","0030","0932","471","238","233","3","474","1008","0","47.02","23.61"
"63","000","00","070","0030","0933","513","260","253","5","518","1018","0","50.88","25.54"
"63","000","00","070","0031","0000","1739","756","983","20","1759","3911","0","44.98","19.33"
"63","000","00","070","0031","0948","562","241","321","8","570","1243","0","45.86","19.39"
"63","000","00","070","0031","0949","642","303","339","6","648","1354","0","47.86","22.38"
"63","000","00","070","0031","0950","535","212","323","6","541","1314","0","41.17","16.13"
"63","000","00","070","0032","0000","2449","1095","1354","23","2472","5226","0","47.30","20.95"
"63","000","00","070","0032","0943","570","241","329","3","573","1147","0","49.96","21.01"
"63","000","00","070","0032","0944","408","196","212","11","419","944","0","44.39","20.76"
"63","000","00","070","0032","0945","521","227","294","3","524","1100","0","47.64","20.64"
"63","000","00","070","0032","0946","529","220","309","3","532","1124","0","47.33","19.57"
"63","000","00","070","0032","0947","421","211","210","3","424","911","0","46.54","23.16"
"63","000","00","070","0033","0000","2557","1632","925","27","2584","5167","0","50.01","31.59"
"63","000","00","070","0033","0951","426","232","194","4","430","990","0","43.43","23.43"
"63","000","00","070","0033","0952","508","290","218","2","510","998","0","51.10","29.06"
"63","000","00","070","0033","0953","656","521","135","9","665","1213","0","54.82","42.95"
"63","000","00","070","0033","0954","530","352","178","7","537","998","0","53.81","35.27"
"63","000","00","070","0033","0955","437","237","200","5","442","968","0","45.66","24.48"
"63","000","00","070","0034","0000","1958","1322","636","22","1980","4179","0","47.38","31.63"
"63","000","00","070","0034","0956","542","403","139","3","545","1034","0","52.71","38.97"
"63","000","00","070","0034","0957","543","394","149","3","546","1091","0","50.05","36.11"
"63","000","00","070","0034","0958","433","250","183","10","443","1038","0","42.68","24.08"
"63","000","00","070","0034","0959","440","275","165","6","446","1016","0","43.90","27.07"
"63","000","00","070","0035","0000","1459","935","524","25","1484","3097","0","47.92","30.19"
"63","000","00","070","0035","0974","495","313","182","11","506","1043","0","48.51","30.01"
"63","000","00","070","0035","0975","481","296","185","4","485","1019","0","47.60","29.05"
"63","000","00","070","0035","0976","483","326","157","10","493","1035","0","47.63","31.50"
"63","000","00","070","0036","0000","1340","848","492","13","1353","2636","0","51.33","32.17"
"63","000","00","070","0036","0977","681","451","230","7","688","1313","0","52.40","34.35"
"63","000","00","070","0036","0978","659","397","262","6","665","1323","0","50.26","30.01"
"63","000","00","080","0000","0000","106506","66088","40418","936","107442","222227","264975","48.35","29.74"
"63","000","00","080","0001","0000","2895","1584","1311","19","2914","6344","0","45.93","24.97"
"63","000","00","080","0001","0979","593","279","314","4","597","1316","0","45.36","21.20"
"63","000","00","080","0001","0980","546","319","227","6","552","1204","0","45.85","26.50"
"63","000","00","080","0001","0981","564","305","259","4","568","1204","0","47.18","25.33"
"63","000","00","080","0001","0982","669","391","278","5","674","1421","0","47.43","27.52"
"63","000","00","080","0001","0983","523","290","233","0","523","1199","0","43.62","24.19"
"63","000","00","080","0002","0000","2827","1820","1007","13","2840","5987","0","47.44","30.40"
"63","000","00","080","0002","0984","734","477","257","5","739","1547","0","47.77","30.83"
"63","000","00","080","0002","0985","688","448","240","2","690","1500","0","46.00","29.87"
"63","000","00","080","0002","0986","670","438","232","4","674","1417","0","47.57","30.91"
"63","000","00","080","0002","0987","735","457","278","2","737","1523","0","48.39","30.01"
"63","000","00","080","0003","0000","2060","1173","887","9","2069","4219","0","49.04","27.80"
"63","000","00","080","0003","0988","709","406","303","2","711","1438","0","49.44","28.23"
"63","000","00","080","0003","0989","684","409","275","6","690","1374","0","50.22","29.77"
"63","000","00","080","0003","0990","667","358","309","1","668","1407","0","47.48","25.44"
"63","000","00","080","0004","0000","2632","1521","1111","25","2657","5431","0","48.92","28.01"
"63","000","00","080","0004","0991","620","364","256","6","626","1361","0","46.00","26.75"
"63","000","00","080","0004","0992","661","386","275","5","666","1352","0","49.26","28.55"
"63","000","00","080","0004","0993","673","397","276","7","680","1376","0","49.42","28.85"
"63","000","00","080","0004","0994","678","374","304","7","685","1342","0","51.04","27.87"
"63","000","00","080","0005","0000","2344","1430","914","23","2367","4675","0","50.63","30.59"
"63","000","00","080","0005","0995","568","358","210","4","572","1193","0","47.95","30.01"
"63","000","00","080","0005","0996","582","338","244","6","588","1239","0","47.46","27.28"
"63","000","00","080","0005","0997","642","389","253","8","650","1251","0","51.96","31.10"
"63","000","00","080","0005","0998","552","345","207","5","557","992","0","56.15","34.78"
"63","000","00","080","0006","0000","2367","1474","893","18","2385","4768","0","50.02","30.91"
"63","000","00","080","0006","0999","577","363","214","1","578","1168","0","49.49","31.08"
"63","000","00","080","0006","1000","519","334","185","5","524","1136","0","46.13","29.40"
"63","000","00","080","0006","1001","653","408","245","2","655","1238","0","52.91","32.96"
"63","000","00","080","0006","1002","618","369","249","10","628","1226","0","51.22","30.10"
"63","000","00","080","0007","0000","2322","1402","920","17","2339","4621","0","50.62","30.34"
"63","000","00","080","0007","1003","529","296","233","3","532","1098","0","48.45","26.96"
"63","000","00","080","0007","1004","583","345","238","4","587","1252","0","46.88","27.56"
"63","000","00","080","0007","1005","590","353","237","3","593","1157","0","51.25","30.51"
"63","000","00","080","0007","1006","620","408","212","7","627","1114","0","56.28","36.62"
"63","000","00","080","0008","0000","1864","1060","804","20","1884","3814","0","49.40","27.79"
"63","000","00","080","0008","1007","647","351","296","9","656","1284","0","51.09","27.34"
"63","000","00","080","0008","1008","599","355","244","5","604","1246","0","48.48","28.49"
"63","000","00","080","0008","1009","618","354","264","6","624","1284","0","48.60","27.57"
"63","000","00","080","0009","0000","3016","1880","1136","23","3039","6067","0","50.09","30.99"
"63","000","00","080","0009","1010","628","423","205","7","635","1284","0","49.45","32.94"
"63","000","00","080","0009","1011","601","383","218","3","604","1222","0","49.43","31.34"
"63","000","00","080","0009","1012","566","358","208","5","571","1170","0","48.80","30.60"
"63","000","00","080","0009","1013","604","337","267","2","606","1169","0","51.84","28.83"
"63","000","00","080","0009","1014","617","379","238","6","623","1222","0","50.98","31.01"
"63","000","00","080","0010","0000","2244","1321","923","30","2274","4515","0","50.37","29.26"
"63","000","00","080","0010","1015","524","285","239","10","534","1128","0","47.34","25.27"
"63","000","00","080","0010","1016","533","318","215","6","539","1099","0","49.04","28.94"
"63","000","00","080","0010","1017","618","357","261","6","624","1136","0","54.93","31.43"
"63","000","00","080","0010","1018","569","361","208","8","577","1152","0","50.09","31.34"
"63","000","00","080","0011","0000","1438","1022","416","20","1458","2826","0","51.59","36.16"
"63","000","00","080","0011","1019","706","459","247","12","718","1431","0","50.17","32.08"
"63","000","00","080","0011","1020","732","563","169","8","740","1395","0","53.05","40.36"
"63","000","00","080","0012","0000","1941","1175","766","16","1957","3978","0","49.20","29.54"
"63","000","00","080","0012","1021","570","326","244","10","580","1231","0","47.12","26.48"
"63","000","00","080","0012","1022","632","377","255","2","634","1338","0","47.38","28.18"
"63","000","00","080","0012","1023","739","472","267","4","743","1409","0","52.73","33.50"
"63","000","00","080","0013","0000","2120","1319","801","33","2153","4213","0","51.10","31.31"
"63","000","00","080","0013","1024","701","405","296","11","712","1453","0","49.00","27.87"
"63","000","00","080","0013","1025","672","436","236","12","684","1408","0","48.58","30.97"
"63","000","00","080","0013","1026","747","478","269","10","757","1352","0","55.99","35.36"
"63","000","00","080","0014","0000","1458","908","550","16","1474","3144","0","46.88","28.88"
"63","000","00","080","0014","1030","729","421","308","6","735","1655","0","44.41","25.44"
"63","000","00","080","0014","1031","729","487","242","10","739","1489","0","49.63","32.71"
"63","000","00","080","0015","0000","3106","2022","1084","25","3131","6323","0","49.52","31.98"
"63","000","00","080","0015","1032","670","435","235","6","676","1334","0","50.67","32.61"
"63","000","00","080","0015","1033","650","437","213","4","654","1261","0","51.86","34.66"
"63","000","00","080","0015","1034","591","365","226","4","595","1245","0","47.79","29.32"
"63","000","00","080","0015","1035","612","410","202","6","618","1236","0","50.00","33.17"
"63","000","00","080","0015","1036","583","375","208","5","588","1247","0","47.15","30.07"
"63","000","00","080","0016","0000","2405","1523","882","25","2430","5161","0","47.08","29.51"
"63","000","00","080","0016","1037","686","409","277","7","693","1505","0","46.05","27.18"
"63","000","00","080","0016","1038","680","432","248","7","687","1421","0","48.35","30.40"
"63","000","00","080","0016","1039","541","362","179","6","547","1260","0","43.41","28.73"
"63","000","00","080","0016","1040","498","320","178","5","503","975","0","51.59","32.82"
"63","000","00","080","0017","0000","2265","1518","747","19","2284","4630","0","49.33","32.79"
"63","000","00","080","0017","1041","601","406","195","4","605","1158","0","52.25","35.06"
"63","000","00","080","0017","1042","523","359","164","7","530","1110","0","47.75","32.34"
"63","000","00","080","0017","1043","489","327","162","4","493","1053","0","46.82","31.05"
"63","000","00","080","0017","1044","652","426","226","4","656","1309","0","50.11","32.54"
"63","000","00","080","0018","0000","2896","1880","1016","22","2918","5698","0","51.21","32.99"
"63","000","00","080","0018","1045","790","481","309","7","797","1581","0","50.41","30.42"
"63","000","00","080","0018","1046","650","441","209","5","655","1365","0","47.99","32.31"
"63","000","00","080","0018","1047","769","512","257","3","772","1429","0","54.02","35.83"
"63","000","00","080","0018","1048","687","446","241","7","694","1323","0","52.46","33.71"
"63","000","00","080","0019","0000","2297","1322","975","15","2312","4637","0","49.86","28.51"
"63","000","00","080","0019","1049","557","340","217","4","561","1106","0","50.72","30.74"
"63","000","00","080","0019","1050","554","319","235","5","559","1149","0","48.65","27.76"
"63","000","00","080","0019","1051","595","319","276","3","598","1208","0","49.50","26.41"
"63","000","00","080","0019","1052","591","344","247","3","594","1174","0","50.60","29.30"
"63","000","00","080","0020","0000","3245","2156","1089","31","3276","7009","0","46.74","30.76"
"63","000","00","080","0020","1053","530","363","167","3","533","1202","0","44.34","30.20"
"63","000","00","080","0020","1054","571","384","187","5","576","1206","0","47.76","31.84"
"63","000","00","080","0020","1055","578","374","204","5","583","1199","0","48.62","31.19"
"63","000","00","080","0020","1056","523","351","172","10","533","1095","0","48.68","32.05"
"63","000","00","080","0020","1057","510","341","169","6","516","1155","0","44.68","29.52"
"63","000","00","080","0020","1058","533","343","190","2","535","1152","0","46.44","29.77"
"63","000","00","080","0021","0000","1732","1069","663","19","1751","3527","0","49.65","30.31"
"63","000","00","080","0021","1059","555","362","193","5","560","1080","0","51.85","33.52"
"63","000","00","080","0021","1060","616","365","251","7","623","1199","0","51.96","30.44"
"63","000","00","080","0021","1061","561","342","219","7","568","1248","0","45.51","27.40"
"63","000","00","080","0022","0000","2719","1714","1005","18","2737","5643","0","48.50","30.37"
"63","000","00","080","0022","1062","591","403","188","4","595","1370","0","43.43","29.42"
"63","000","00","080","0022","1063","653","415","238","3","656","1407","0","46.62","29.50"
"63","000","00","080","0022","1064","731","419","312","3","734","1410","0","52.06","29.72"
"63","000","00","080","0022","1065","744","477","267","8","752","1456","0","51.65","32.76"
"63","000","00","080","0023","0000","2911","1935","976","28","2939","5797","0","50.70","33.38"
"63","000","00","080","0023","1066","574","369","205","8","582","1112","0","52.34","33.18"
"63","000","00","080","0023","1067","554","379","175","5","559","1128","0","49.56","33.60"
"63","000","00","080","0023","1068","572","374","198","5","577","1090","0","52.94","34.31"
"63","000","00","080","0023","1069","586","390","196","6","592","1183","0","50.04","32.97"
"63","000","00","080","0023","1070","625","423","202","4","629","1284","0","48.99","32.94"
"63","000","00","080","0024","0000","3793","2422","1371","41","3834","7631","0","50.24","31.74"
"63","000","00","080","0024","1071","622","353","269","10","632","1336","0","47.31","26.42"
"63","000","00","080","0024","1072","697","438","259","8","705","1268","0","55.60","34.54"
"63","000","00","080","0024","1073","631","441","190","5","636","1264","0","50.32","34.89"
"63","000","00","080","0024","1074","618","386","232","8","626","1283","0","48.79","30.09"
"63","000","00","080","0024","1075","640","440","200","7","647","1286","0","50.31","34.21"
"63","000","00","080","0024","1076","585","364","221","3","588","1194","0","49.25","30.49"
"63","000","00","080","0025","0000","1532","946","586","20","1552","3738","0","41.52","25.31"
"63","000","00","080","0025","1077","651","383","268","9","660","1661","0","39.74","23.06"
"63","000","00","080","0025","1078","588","373","215","8","596","1309","0","45.53","28.50"
"63","000","00","080","0025","1079","293","190","103","3","296","768","0","38.54","24.74"
"63","000","00","080","0026","0000","2797","1765","1032","18","2815","5826","0","48.32","30.30"
"63","000","00","080","0026","1080","687","393","294","2","689","1449","0","47.55","27.12"
"63","000","00","080","0026","1081","612","394","218","6","618","1429","0","43.25","27.57"
"63","000","00","080","0026","1082","777","504","273","1","778","1481","0","52.53","34.03"
"63","000","00","080","0026","1083","721","474","247","9","730","1467","0","49.76","32.31"
"63","000","00","080","0027","0000","3839","2563","1276","39","3878","7776","0","49.87","32.96"
"63","000","00","080","0027","1084","633","396","237","6","639","1263","0","50.59","31.35"
"63","000","00","080","0027","1085","663","433","230","12","675","1371","0","49.23","31.58"
"63","000","00","080","0027","1086","650","436","214","5","655","1330","0","49.25","32.78"
"63","000","00","080","0027","1087","559","390","169","5","564","1191","0","47.36","32.75"
"63","000","00","080","0027","1088","654","425","229","2","656","1255","0","52.27","33.86"
"63","000","00","080","0027","1089","680","483","197","9","689","1366","0","50.44","35.36"
"63","000","00","080","0028","0000","3456","1974","1482","32","3488","8867","0","39.34","22.26"
"63","000","00","080","0028","1090","617","366","251","4","621","2449","0","25.36","14.94"
"63","000","00","080","0028","1091","539","299","240","3","542","1226","0","44.21","24.39"
"63","000","00","080","0028","1092","513","293","220","8","521","1233","0","42.25","23.76"
"63","000","00","080","0028","1093","538","315","223","5","543","1307","0","41.55","24.10"
"63","000","00","080","0028","1094","609","349","260","8","617","1305","0","47.28","26.74"
"63","000","00","080","0028","1095","640","352","288","4","644","1347","0","47.81","26.13"
"63","000","00","080","0029","0000","2982","1769","1213","23","3005","6234","0","48.20","28.38"
"63","000","00","080","0029","1096","545","325","220","7","552","1142","0","48.34","28.46"
"63","000","00","080","0029","1097","590","343","247","3","593","1276","0","46.47","26.88"
"63","000","00","080","0029","1098","565","324","241","1","566","1165","0","48.58","27.81"
"63","000","00","080","0029","1099","542","328","214","6","548","1255","0","43.67","26.14"
"63","000","00","080","0029","1100","740","449","291","6","746","1396","0","53.44","32.16"
"63","000","00","080","0030","0000","3279","2105","1174","32","3311","7099","0","46.64","29.65"
"63","000","00","080","0030","1104","690","455","235","8","698","1464","0","47.68","31.08"
"63","000","00","080","0030","1105","635","395","240","8","643","1347","0","47.74","29.32"
"63","000","00","080","0030","1106","643","411","232","4","647","1404","0","46.08","29.27"
"63","000","00","080","0030","1107","651","391","260","7","658","1520","0","43.29","25.72"
"63","000","00","080","0030","1108","660","453","207","5","665","1364","0","48.75","33.21"
"63","000","00","080","0031","0000","2295","1478","817","17","2312","4662","0","49.59","31.70"
"63","000","00","080","0031","1109","567","348","219","8","575","1198","0","48.00","29.05"
"63","000","00","080","0031","1110","600","403","197","3","603","1136","0","53.08","35.48"
"63","000","00","080","0031","1111","545","324","221","2","547","1145","0","47.77","28.30"
"63","000","00","080","0031","1112","583","403","180","4","587","1183","0","49.62","34.07"
"63","000","00","080","0032","0000","2248","1348","900","18","2266","4648","0","48.75","29.00"
"63","000","00","080","0032","1117","521","316","205","7","528","1066","0","49.53","29.64"
"63","000","00","080","0032","1118","524","300","224","3","527","1143","0","46.11","26.25"
"63","000","00","080","0032","1119","623","366","257","5","628","1286","0","48.83","28.46"
"63","000","00","080","0032","1120","580","366","214","3","583","1153","0","50.56","31.74"
"63","000","00","080","0033","0000","3206","2045","1161","21","3227","6704","0","48.14","30.50"
"63","000","00","080","0033","1124","703","416","287","3","706","1412","0","50.00","29.46"
"63","000","00","080","0033","1125","581","369","212","1","582","1275","0","45.65","28.94"
"63","000","00","080","0033","1126","658","428","230","3","661","1427","0","46.32","29.99"
"63","000","00","080","0033","1127","711","474","237","7","718","1370","0","52.41","34.60"
"63","000","00","080","0033","1128","553","358","195","7","560","1220","0","45.90","29.34"
"63","000","00","080","0034","0000","2360","1414","946","16","2376","5050","0","47.05","28.00"
"63","000","00","080","0034","1134","503","251","252","5","508","1059","0","47.97","23.70"
"63","000","00","080","0034","1135","467","268","199","3","470","1018","0","46.17","26.33"
"63","000","00","080","0034","1136","452","286","166","1","453","989","0","45.80","28.92"
"63","000","00","080","0034","1137","426","301","125","3","429","994","0","43.16","30.28"
"63","000","00","080","0034","1138","512","308","204","4","516","990","0","52.12","31.11"
"63","000","00","080","0035","0000","3503","2089","1414","32","3535","7045","0","50.18","29.65"
"63","000","00","080","0035","1139","750","455","295","6","756","1437","0","52.61","31.66"
"63","000","00","080","0035","1140","724","438","286","7","731","1456","0","50.21","30.08"
"63","000","00","080","0035","1141","762","478","284","4","766","1462","0","52.39","32.69"
"63","000","00","080","0035","1142","679","389","290","8","687","1346","0","51.04","28.90"
"63","000","00","080","0035","1143","588","329","259","7","595","1344","0","44.27","24.48"
"63","000","00","080","0036","0000","1529","852","677","16","1545","3435","0","44.98","24.80"
"63","000","00","080","0036","1149","591","351","240","7","598","1267","0","47.20","27.70"
"63","000","00","080","0036","1150","608","379","229","5","613","1342","0","45.68","28.24"
"63","000","00","080","0036","1151","330","122","208","4","334","826","0","40.44","14.77"
"63","000","00","080","0037","0000","346","146","200","3","349","778","0","44.86","18.77"
"63","000","00","080","0037","1152","346","146","200","3","349","778","0","44.86","18.77"
"63","000","00","080","0038","0000","1895","1276","619","19","1914","3647","0","52.48","34.99"
"63","000","00","080","0038","1101","576","388","188","12","588","1060","0","55.47","36.60"
"63","000","00","080","0038","1102","690","455","235","2","692","1389","0","49.82","32.76"
"63","000","00","080","0038","1103","629","433","196","5","634","1198","0","52.92","36.14"
"63","000","00","080","0039","0000","2819","1757","1062","23","2842","6271","0","45.32","28.02"
"63","000","00","080","0039","1129","616","361","255","5","621","1252","0","49.60","28.83"
"63","000","00","080","0039","1130","575","365","210","8","583","1384","0","42.12","26.37"
"63","000","00","080","0039","1131","541","337","204","4","545","1208","0","45.12","27.90"
"63","000","00","080","0039","1132","513","333","180","3","516","1254","0","41.15","26.56"
"63","000","00","080","0039","1133","574","361","213","3","577","1173","0","49.19","30.78"
"63","000","00","080","0040","0000","3014","1849","1165","28","3042","6269","0","48.52","29.49"
"63","000","00","080","0040","1144","485","294","191","5","490","1042","0","47.02","28.21"
"63","000","00","080","0040","1145","568","337","231","5","573","1185","0","48.35","28.44"
"63","000","00","080","0040","1146","612","352","260","8","620","1305","0","47.51","26.97"
"63","000","00","080","0040","1147","672","415","257","3","675","1356","0","49.78","30.60"
"63","000","00","080","0040","1148","677","451","226","7","684","1381","0","49.53","32.66"
"63","000","00","080","0041","0000","2451","1449","1002","29","2480","5223","0","47.48","27.74"
"63","000","00","080","0041","1113","746","450","296","7","753","1534","0","49.09","29.34"
"63","000","00","080","0041","1114","548","314","234","8","556","1183","0","47.00","26.54"
"63","000","00","080","0041","1115","584","337","247","6","590","1252","0","47.12","26.92"
"63","000","00","080","0041","1116","573","348","225","8","581","1254","0","46.33","27.75"
"63","000","00","080","0042","0000","2147","1508","639","15","2162","4301","0","50.27","35.06"
"63","000","00","080","0042","1027","668","441","227","7","675","1359","0","49.67","32.45"
"63","000","00","080","0042","1028","749","523","226","2","751","1500","0","50.07","34.87"
"63","000","00","080","0042","1029","730","544","186","6","736","1442","0","51.04","37.73"
"63","000","00","080","0043","0000","1911","1105","806","10","1921","3996","0","48.07","27.65"
"63","000","00","080","0043","1121","615","365","250","5","620","1276","0","48.59","28.61"
"63","000","00","080","0043","1122","659","371","288","5","664","1354","0","49.04","27.40"
"63","000","00","080","0043","1123","637","369","268","0","637","1366","0","46.63","27.01"
"63","000","00","090","0000","0000","44527","24327","20200","352","44879","99364","117188","45.17","24.48"
"63","000","00","090","0001","0000","2175","1165","1010","8","2183","5637","0","38.73","20.67"
"63","000","00","090","0001","1153","428","195","233","2","430","1105","0","38.91","17.65"
"63","000","00","090","0001","1154","611","340","271","2","613","1427","0","42.96","23.83"
"63","000","00","090","0001","1155","541","298","243","2","543","1292","0","42.03","23.07"
"63","000","00","090","0001","1156","595","332","263","2","597","1813","0","32.93","18.31"
"63","000","00","090","0002","0000","1238","597","641","8","1246","3127","0","39.85","19.09"
"63","000","00","090","0002","1157","432","168","264","1","433","1028","0","42.12","16.34"
"63","000","00","090","0002","1158","438","238","200","2","440","1121","0","39.25","21.23"
"63","000","00","090","0002","1159","368","191","177","5","373","978","0","38.14","19.53"
"63","000","00","090","0003","0000","1477","742","735","11","1488","3300","0","45.09","22.48"
"63","000","00","090","0003","1165","463","247","216","3","466","989","0","47.12","24.97"
"63","000","00","090","0003","1166","529","255","274","3","532","1169","0","45.51","21.81"
"63","000","00","090","0003","1167","485","240","245","5","490","1142","0","42.91","21.02"
"63","000","00","090","0004","0000","2702","1489","1213","17","2719","6452","0","42.14","23.08"
"63","000","00","090","0004","1160","534","253","281","3","537","1291","0","41.60","19.60"
"63","000","00","090","0004","1161","500","285","215","3","503","1313","0","38.31","21.71"
"63","000","00","090","0004","1162","538","283","255","3","541","1293","0","41.84","21.89"
"63","000","00","090","0004","1163","549","325","224","5","554","1266","0","43.76","25.67"
"63","000","00","090","0004","1164","581","343","238","3","584","1289","0","45.31","26.61"
"63","000","00","090","0005","0000","2593","1353","1240","16","2609","6152","0","42.41","21.99"
"63","000","00","090","0005","1184","437","209","228","2","439","1238","0","35.46","16.88"
"63","000","00","090","0005","1185","584","327","257","2","586","1340","0","43.73","24.40"
"63","000","00","090","0005","1186","513","238","275","6","519","1184","0","43.83","20.10"
"63","000","00","090","0005","1187","548","306","242","3","551","1271","0","43.35","24.08"
"63","000","00","090","0005","1188","511","273","238","3","514","1119","0","45.93","24.40"
"63","000","00","090","0006","0000","1457","824","633","6","1463","3170","0","46.15","25.99"
"63","000","00","090","0006","1208","530","302","228","3","533","1126","0","47.34","26.82"
"63","000","00","090","0006","1209","502","283","219","1","503","1086","0","46.32","26.06"
"63","000","00","090","0006","1210","425","239","186","2","427","958","0","44.57","24.95"
"63","000","00","090","0007","0000","2305","1340","965","27","2332","4785","0","48.74","28.00"
"63","000","00","090","0007","1193","546","302","244","8","554","1204","0","46.01","25.08"
"63","000","00","090","0007","1194","496","303","193","3","499","1063","0","46.94","28.50"
"63","000","00","090","0007","1195","635","357","278","12","647","1280","0","50.55","27.89"
"63","000","00","090","0007","1196","628","378","250","4","632","1238","0","51.05","30.53"
"63","000","00","090","0008","0000","1782","789","993","20","1802","4037","0","44.64","19.54"
"63","000","00","090","0008","1197","597","264","333","4","601","1305","0","46.05","20.23"
"63","000","00","090","0008","1198","615","284","331","5","620","1374","0","45.12","20.67"
"63","000","00","090","0008","1199","570","241","329","11","581","1358","0","42.78","17.75"
"63","000","00","090","0009","0000","1854","917","937","18","1872","4075","0","45.94","22.50"
"63","000","00","090","0009","1200","636","282","354","6","642","1445","0","44.43","19.52"
"63","000","00","090","0009","1201","608","320","288","5","613","1314","0","46.65","24.35"
"63","000","00","090","0009","1202","610","315","295","7","617","1316","0","46.88","23.94"
"63","000","00","090","0010","0000","2697","1423","1274","25","2722","5716","0","47.62","24.90"
"63","000","00","090","0010","1203","499","261","238","5","504","1052","0","47.91","24.81"
"63","000","00","090","0010","1204","579","318","261","6","585","1198","0","48.83","26.54"
"63","000","00","090","0010","1205","573","322","251","4","577","1211","0","47.65","26.59"
"63","000","00","090","0010","1206","518","260","258","5","523","1106","0","47.29","23.51"
"63","000","00","090","0010","1207","528","262","266","5","533","1149","0","46.39","22.80"
"63","000","00","090","0011","0000","3046","1847","1199","20","3066","6413","0","47.81","28.80"
"63","000","00","090","0011","1224","625","361","264","5","630","1402","0","44.94","25.75"
"63","000","00","090","0011","1225","660","414","246","6","666","1396","0","47.71","29.66"
"63","000","00","090","0011","1226","568","326","242","1","569","1139","0","49.96","28.62"
"63","000","00","090","0011","1227","643","414","229","4","647","1224","0","52.86","33.82"
"63","000","00","090","0011","1228","550","332","218","4","554","1252","0","44.25","26.52"
"63","000","00","090","0012","0000","1894","1095","799","10","1904","3623","0","52.55","30.22"
"63","000","00","090","0012","1214","548","307","241","3","551","1133","0","48.63","27.10"
"63","000","00","090","0012","1215","675","342","333","5","680","1209","0","56.24","28.29"
"63","000","00","090","0012","1216","671","446","225","2","673","1281","0","52.54","34.82"
"63","000","00","090","0013","0000","1860","998","862","11","1871","3885","0","48.16","25.69"
"63","000","00","090","0013","1217","625","334","291","8","633","1340","0","47.24","24.93"
"63","000","00","090","0013","1218","592","337","255","2","594","1248","0","47.60","27.00"
"63","000","00","090","0013","1219","643","327","316","1","644","1297","0","49.65","25.21"
"63","000","00","090","0014","0000","1998","1019","979","18","2016","4544","0","44.37","22.43"
"63","000","00","090","0014","1220","461","240","221","1","462","1138","0","40.60","21.09"
"63","000","00","090","0014","1221","495","247","248","2","497","1141","0","43.56","21.65"
"63","000","00","090","0014","1222","511","263","248","5","516","1103","0","46.78","23.84"
"63","000","00","090","0014","1223","531","269","262","10","541","1162","0","46.56","23.15"
"63","000","00","090","0015","0000","2007","1112","895","17","2024","4274","0","47.36","26.02"
"63","000","00","090","0015","1211","702","429","273","2","704","1411","0","49.89","30.40"
"63","000","00","090","0015","1212","672","332","340","6","678","1488","0","45.56","22.31"
"63","000","00","090","0015","1213","633","351","282","9","642","1375","0","46.69","25.53"
"63","000","00","090","0016","0000","3011","1547","1464","29","3040","7580","0","40.11","20.41"
"63","000","00","090","0016","1178","480","221","259","8","488","1349","0","36.17","16.38"
"63","000","00","090","0016","1179","473","207","266","4","477","1297","0","36.78","15.96"
"63","000","00","090","0016","1180","509","274","235","5","514","1221","0","42.10","22.44"
"63","000","00","090","0016","1181","498","272","226","3","501","1185","0","42.28","22.95"
"63","000","00","090","0016","1182","483","271","212","4","487","1220","0","39.92","22.21"
"63","000","00","090","0016","1183","568","302","266","5","573","1308","0","43.81","23.09"
"63","000","00","090","0017","0000","3574","1888","1686","39","3613","7890","0","45.79","23.93"
"63","000","00","090","0017","1168","563","282","281","8","571","1435","0","39.79","19.65"
"63","000","00","090","0017","1169","596","307","289","8","604","1256","0","48.09","24.44"
"63","000","00","090","0017","1170","609","295","314","4","613","1279","0","47.93","23.06"
"63","000","00","090","0017","1171","645","348","297","7","652","1369","0","47.63","25.42"
"63","000","00","090","0017","1172","562","302","260","7","569","1331","0","42.75","22.69"
"63","000","00","090","0017","1173","599","354","245","5","604","1220","0","49.51","29.02"
"63","000","00","090","0018","0000","2390","1447","943","21","2411","5386","0","44.76","26.87"
"63","000","00","090","0018","1174","582","309","273","5","587","1395","0","42.08","22.15"
"63","000","00","090","0018","1175","698","499","199","6","704","1324","0","53.17","37.69"
"63","000","00","090","0018","1176","464","228","236","3","467","1266","0","36.89","18.01"
"63","000","00","090","0018","1177","646","411","235","7","653","1401","0","46.61","29.34"
"63","000","00","090","0019","0000","2361","1497","864","18","2379","4777","0","49.80","31.34"
"63","000","00","090","0019","1229","562","367","195","2","564","1114","0","50.63","32.94"
"63","000","00","090","0019","1230","509","306","203","3","512","994","0","51.51","30.78"
"63","000","00","090","0019","1231","710","457","253","8","718","1323","0","54.27","34.54"
"63","000","00","090","0019","1232","580","367","213","5","585","1346","0","43.46","27.27"
"63","000","00","090","0020","0000","2106","1238","868","13","2119","4541","0","46.66","27.26"
"63","000","00","090","0020","1189","477","263","214","6","483","1166","0","41.42","22.56"
"63","000","00","090","0020","1190","497","290","207","2","499","1122","0","44.47","25.85"
"63","000","00","090","0020","1191","568","339","229","3","571","1123","0","50.85","30.19"
"63","000","00","090","0020","1192","564","346","218","2","566","1130","0","50.09","30.62"
"63","000","00","100","0000","0000","107195","59494","47701","910","108105","232305","279598","46.54","25.61"
"63","000","00","100","0001","0000","2890","1474","1416","25","2915","6163","0","47.30","23.92"
"63","000","00","100","0001","1233","553","271","282","6","559","1205","0","46.39","22.49"
"63","000","00","100","0001","1234","527","269","258","5","532","1156","0","46.02","23.27"
"63","000","00","100","0001","1235","587","273","314","4","591","1251","0","47.24","21.82"
"63","000","00","100","0001","1236","587","324","263","7","594","1233","0","48.18","26.28"
"63","000","00","100","0001","1237","636","337","299","3","639","1318","0","48.48","25.57"
"63","000","00","100","0002","0000","3972","2242","1730","39","4011","8190","0","48.97","27.37"
"63","000","00","100","0002","1238","663","333","330","7","670","1315","0","50.95","25.32"
"63","000","00","100","0002","1239","717","403","314","8","725","1418","0","51.13","28.42"
"63","000","00","100","0002","1240","650","356","294","11","661","1367","0","48.35","26.04"
"63","000","00","100","0002","1241","644","339","305","5","649","1495","0","43.41","22.68"
"63","000","00","100","0002","1242","636","347","289","3","639","1324","0","48.26","26.21"
"63","000","00","100","0002","1243","662","464","198","5","667","1271","0","52.48","36.51"
"63","000","00","100","0003","0000","2752","1514","1238","28","2780","5644","0","49.26","26.82"
"63","000","00","100","0003","1244","635","340","295","10","645","1333","0","48.39","25.51"
"63","000","00","100","0003","1245","698","409","289","6","704","1414","0","49.79","28.93"
"63","000","00","100","0003","1246","689","345","344","6","695","1371","0","50.69","25.16"
"63","000","00","100","0003","1247","730","420","310","6","736","1526","0","48.23","27.52"
"63","000","00","100","0005","0000","2467","1325","1142","14","2481","5115","0","48.50","25.90"
"63","000","00","100","0005","1248","658","356","302","1","659","1302","0","50.61","27.34"
"63","000","00","100","0005","1249","613","341","272","4","617","1255","0","49.16","27.17"
"63","000","00","100","0005","1250","620","305","315","5","625","1331","0","46.96","22.92"
"63","000","00","100","0005","1251","576","323","253","4","580","1227","0","47.27","26.32"
"63","000","00","100","0006","0000","2130","1106","1024","12","2142","4642","0","46.14","23.83"
"63","000","00","100","0006","1252","699","367","332","0","699","1561","0","44.78","23.51"
"63","000","00","100","0006","1253","748","391","357","5","753","1528","0","49.28","25.59"
"63","000","00","100","0006","1254","683","348","335","7","690","1553","0","44.43","22.41"
"63","000","00","100","0007","0000","3754","2041","1713","37","3791","7960","0","47.63","25.64"
"63","000","00","100","0007","1255","540","285","255","7","547","1289","0","42.44","22.11"
"63","000","00","100","0007","1256","673","345","328","10","683","1435","0","47.60","24.04"
"63","000","00","100","0007","1257","568","316","252","0","568","1246","0","45.59","25.36"
"63","000","00","100","0007","1258","797","434","363","3","800","1553","0","51.51","27.95"
"63","000","00","100","0007","1259","602","343","259","7","609","1202","0","50.67","28.54"
"63","000","00","100","0007","1260","574","318","256","10","584","1235","0","47.29","25.75"
"63","000","00","100","0008","0000","3550","1901","1649","32","3582","7644","0","46.86","24.87"
"63","000","00","100","0008","1261","697","406","291","5","702","1480","0","47.43","27.43"
"63","000","00","100","0008","1262","739","417","322","10","749","1596","0","46.93","26.13"
"63","000","00","100","0008","1263","690","369","321","4","694","1459","0","47.57","25.29"
"63","000","00","100","0008","1264","708","354","354","10","718","1554","0","46.20","22.78"
"63","000","00","100","0008","1265","716","355","361","3","719","1555","0","46.24","22.83"
"63","000","00","100","0009","0000","2605","1477","1128","18","2623","5561","0","47.17","26.56"
"63","000","00","100","0009","1266","624","352","272","6","630","1287","0","48.95","27.35"
"63","000","00","100","0009","1267","557","302","255","3","560","1295","0","43.24","23.32"
"63","000","00","100","0009","1268","681","405","276","3","684","1402","0","48.79","28.89"
"63","000","00","100","0009","1269","743","418","325","6","749","1577","0","47.50","26.51"
"63","000","00","100","0010","0000","3668","2220","1448","23","3691","7099","0","51.99","31.27"
"63","000","00","100","0010","1270","876","499","377","5","881","1633","0","53.95","30.56"
"63","000","00","100","0010","1271","806","506","300","5","811","1559","0","52.02","32.46"
"63","000","00","100","0010","1272","783","441","342","4","787","1433","0","54.92","30.77"
"63","000","00","100","0010","1273","668","445","223","5","673","1356","0","49.63","32.82"
"63","000","00","100","0010","1274","535","329","206","4","539","1118","0","48.21","29.43"
"63","000","00","100","0011","0000","3329","1729","1600","31","3360","6865","0","48.94","25.19"
"63","000","00","100","0011","1275","693","355","338","9","702","1486","0","47.24","23.89"
"63","000","00","100","0011","1276","649","338","311","0","649","1325","0","48.98","25.51"
"63","000","00","100","0011","1277","732","407","325","9","741","1371","0","54.05","29.69"
"63","000","00","100","0011","1278","597","295","302","7","604","1350","0","44.74","21.85"
"63","000","00","100","0011","1279","658","334","324","6","664","1333","0","49.81","25.06"
"63","000","00","100","0012","0000","2214","1238","976","17","2231","4641","0","48.07","26.68"
"63","000","00","100","0012","1280","729","407","322","6","735","1586","0","46.34","25.66"
"63","000","00","100","0012","1281","758","420","338","8","766","1515","0","50.56","27.72"
"63","000","00","100","0012","1282","727","411","316","3","730","1540","0","47.40","26.69"
"63","000","00","100","0013","0000","2130","1175","955","14","2144","4647","0","46.14","25.29"
"63","000","00","100","0013","1283","760","448","312","6","766","1629","0","47.02","27.50"
"63","000","00","100","0013","1284","654","343","311","0","654","1452","0","45.04","23.62"
"63","000","00","100","0013","1285","716","384","332","8","724","1566","0","46.23","24.52"
"63","000","00","100","0014","0000","2845","1516","1329","26","2871","5790","0","49.59","26.18"
"63","000","00","100","0014","1286","700","362","338","7","707","1430","0","49.44","25.31"
"63","000","00","100","0014","1287","776","451","325","6","782","1500","0","52.13","30.07"
"63","000","00","100","0014","1288","622","325","297","5","627","1374","0","45.63","23.65"
"63","000","00","100","0014","1289","747","378","369","8","755","1486","0","50.81","25.44"
"63","000","00","100","0015","0000","2905","1625","1280","24","2929","6061","0","48.33","26.81"
"63","000","00","100","0015","1290","177","52","125","0","177","430","0","41.16","12.09"
"63","000","00","100","0015","1291","781","426","355","2","783","1593","0","49.15","26.74"
"63","000","00","100","0015","1292","689","404","285","8","697","1366","0","51.02","29.58"
"63","000","00","100","0015","1293","685","426","259","6","691","1337","0","51.68","31.86"
"63","000","00","100","0015","1294","573","317","256","8","581","1335","0","43.52","23.75"
"63","000","00","100","0016","0000","2359","1464","895","22","2381","4880","0","48.79","30.00"
"63","000","00","100","0016","1295","630","355","275","7","637","1313","0","48.51","27.04"
"63","000","00","100","0016","1296","533","337","196","7","540","1077","0","50.14","31.29"
"63","000","00","100","0016","1297","558","383","175","4","562","1185","0","47.43","32.32"
"63","000","00","100","0016","1298","638","389","249","4","642","1305","0","49.20","29.81"
"63","000","00","100","0017","0000","3534","2015","1519","26","3560","7269","0","48.98","27.72"
"63","000","00","100","0017","1299","728","439","289","5","733","1532","0","47.85","28.66"
"63","000","00","100","0017","1300","741","420","321","7","748","1525","0","49.05","27.54"
"63","000","00","100","0017","1301","763","463","300","9","772","1585","0","48.71","29.21"
"63","000","00","100","0017","1302","624","311","313","3","627","1234","0","50.81","25.20"
"63","000","00","100","0017","1303","678","382","296","2","680","1393","0","48.82","27.42"
"63","000","00","100","0018","0000","2682","1615","1067","27","2709","5983","0","45.28","26.99"
"63","000","00","100","0018","1304","713","426","287","9","722","1509","0","47.85","28.23"
"63","000","00","100","0018","1305","580","361","219","4","584","1443","0","40.47","25.02"
"63","000","00","100","0018","1306","732","426","306","7","739","1526","0","48.43","27.92"
"63","000","00","100","0018","1307","657","402","255","7","664","1505","0","44.12","26.71"
"63","000","00","100","0019","0000","3378","1836","1542","35","3413","7104","0","48.04","25.84"
"63","000","00","100","0019","1308","695","370","325","10","705","1517","0","46.47","24.39"
"63","000","00","100","0019","1309","579","308","271","7","586","1306","0","44.87","23.58"
"63","000","00","100","0019","1310","645","324","321","4","649","1407","0","46.13","23.03"
"63","000","00","100","0019","1311","704","397","307","10","714","1372","0","52.04","28.94"
"63","000","00","100","0019","1312","755","437","318","4","759","1502","0","50.53","29.09"
"63","000","00","100","0020","0000","3414","2201","1213","36","3450","6596","0","52.30","33.37"
"63","000","00","100","0020","1313","753","510","243","10","763","1503","0","50.77","33.93"
"63","000","00","100","0020","1314","688","434","254","7","695","1333","0","52.14","32.56"
"63","000","00","100","0020","1315","664","418","246","7","671","1279","0","52.46","32.68"
"63","000","00","100","0020","1316","619","337","282","6","625","1206","0","51.82","27.94"
"63","000","00","100","0020","1317","690","502","188","6","696","1275","0","54.59","39.37"
"63","000","00","100","0021","0000","1945","1227","718","18","1963","3925","0","50.01","31.26"
"63","000","00","100","0021","1318","696","397","299","5","701","1448","0","48.41","27.42"
"63","000","00","100","0021","1319","618","409","209","5","623","1209","0","51.53","33.83"
"63","000","00","100","0021","1320","631","421","210","8","639","1268","0","50.39","33.20"
"63","000","00","100","0022","0000","3427","1813","1614","29","3456","8758","0","39.46","20.70"
"63","000","00","100","0022","1321","612","301","311","2","614","1473","0","41.68","20.43"
"63","000","00","100","0022","1322","595","352","243","9","604","1453","0","41.57","24.23"
"63","000","00","100","0022","1323","570","289","281","4","574","1433","0","40.06","20.17"
"63","000","00","100","0022","1324","560","272","288","3","563","1490","0","37.79","18.26"
"63","000","00","100","0022","1325","548","314","234","5","553","1433","0","38.59","21.91"
"63","000","00","100","0022","1326","542","285","257","6","548","1476","0","37.13","19.31"
"63","000","00","100","0023","0000","2957","1591","1366","19","2976","6861","0","43.38","23.19"
"63","000","00","100","0023","1327","613","323","290","4","617","1436","0","42.97","22.49"
"63","000","00","100","0023","1328","529","276","253","5","534","1243","0","42.96","22.20"
"63","000","00","100","0023","1329","604","325","279","5","609","1411","0","43.16","23.03"
"63","000","00","100","0023","1330","566","333","233","2","568","1354","0","41.95","24.59"
"63","000","00","100","0023","1331","645","334","311","3","648","1417","0","45.73","23.57"
"63","000","00","100","0024","0000","2898","1549","1349","25","2923","6927","0","42.20","22.36"
"63","000","00","100","0024","1332","565","306","259","7","572","1409","0","40.60","21.72"
"63","000","00","100","0024","1333","654","353","301","8","662","1556","0","42.54","22.69"
"63","000","00","100","0024","1334","560","282","278","3","563","1272","0","44.26","22.17"
"63","000","00","100","0024","1335","597","305","292","1","598","1420","0","42.11","21.48"
"63","000","00","100","0024","1336","522","303","219","6","528","1270","0","41.57","23.86"
"63","000","00","100","0025","0000","1796","985","811","14","1810","4037","0","44.84","24.40"
"63","000","00","100","0025","1337","564","293","271","2","566","1161","0","48.75","25.24"
"63","000","00","100","0025","1338","454","273","181","4","458","1129","0","40.57","24.18"
"63","000","00","100","0025","1339","492","301","191","5","497","1004","0","49.50","29.98"
"63","000","00","100","0025","1340","286","118","168","3","289","743","0","38.90","15.88"
"63","000","00","100","0026","0000","3312","1659","1653","28","3340","7466","0","44.74","22.22"
"63","000","00","100","0026","1341","616","241","375","7","623","1450","0","42.97","16.62"
"63","000","00","100","0026","1342","712","352","360","9","721","1617","0","44.59","21.77"
"63","000","00","100","0026","1343","634","263","371","4","638","1380","0","46.23","19.06"
"63","000","00","100","0026","1344","658","402","256","4","662","1440","0","45.97","27.92"
"63","000","00","100","0026","1345","692","401","291","4","696","1579","0","44.08","25.40"
"63","000","00","100","0027","0000","2942","1527","1415","27","2969","6099","0","48.68","25.04"
"63","000","00","100","0027","1346","629","268","361","5","634","1416","0","44.77","18.93"
"63","000","00","100","0027","1347","750","381","369","4","754","1483","0","50.84","25.69"
"63","000","00","100","0027","1348","725","418","307","10","735","1542","0","47.67","27.11"
"63","000","00","100","0027","1349","838","460","378","8","846","1658","0","51.03","27.74"
"63","000","00","100","0028","0000","1448","796","652","7","1455","3369","0","43.19","23.63"
"63","000","00","100","0028","1350","628","284","344","3","631","1424","0","44.31","19.94"
"63","000","00","100","0028","1351","540","332","208","2","542","1307","0","41.47","25.40"
"63","000","00","100","0028","1352","280","180","100","2","282","638","0","44.20","28.21"
"63","000","00","100","0029","0000","2737","1508","1229","17","2754","7424","0","37.10","20.31"
"63","000","00","100","0029","1353","656","352","304","4","660","1516","0","43.54","23.22"
"63","000","00","100","0029","1354","736","453","283","5","741","2870","0","25.82","15.78"
"63","000","00","100","0029","1355","645","367","278","6","651","1489","0","43.72","24.65"
"63","000","00","100","0029","1356","700","336","364","2","702","1549","0","45.32","21.69"
"63","000","00","100","0030","0000","2109","1084","1025","17","2126","4537","0","46.86","23.89"
"63","000","00","100","0030","1357","724","381","343","4","728","1553","0","46.88","24.53"
"63","000","00","100","0030","1358","709","337","372","6","715","1512","0","47.29","22.29"
"63","000","00","100","0030","1359","676","366","310","7","683","1472","0","46.40","24.86"
"63","000","00","100","0031","0000","2867","1527","1340","26","2893","6387","0","45.30","23.91"
"63","000","00","100","0031","1360","472","235","237","2","474","1117","0","42.44","21.04"
"63","000","00","100","0031","1361","554","307","247","5","559","1208","0","46.27","25.41"
"63","000","00","100","0031","1362","545","274","271","7","552","1224","0","45.10","22.39"
"63","000","00","100","0031","1363","665","379","286","5","670","1403","0","47.75","27.01"
"63","000","00","100","0031","1364","631","332","299","7","638","1435","0","44.46","23.14"
"63","000","00","100","0032","0000","2584","1530","1054","31","2615","5366","0","48.73","28.51"
"63","000","00","100","0032","1365","672","382","290","8","680","1397","0","48.68","27.34"
"63","000","00","100","0032","1366","628","389","239","6","634","1334","0","47.53","29.16"
"63","000","00","100","0032","1367","657","397","260","11","668","1346","0","49.63","29.49"
"63","000","00","100","0032","1368","627","362","265","6","633","1289","0","49.11","28.08"
"63","000","00","100","0033","0000","1956","1083","873","11","1967","4591","0","42.84","23.59"
"63","000","00","100","0033","1369","715","390","325","3","718","1624","0","44.21","24.01"
"63","000","00","100","0033","1370","659","364","295","3","662","1594","0","41.53","22.84"
"63","000","00","100","0033","1371","582","329","253","5","587","1373","0","42.75","23.96"
"63","000","00","100","0034","0000","3787","2193","1594","40","3827","8128","0","47.08","26.98"
"63","000","00","100","0034","1372","734","403","331","4","738","1635","0","45.14","24.65"
"63","000","00","100","0034","1373","761","448","313","9","770","1627","0","47.33","27.54"
"63","000","00","100","0034","1374","769","425","344","9","778","1611","0","48.29","26.38"
"63","000","00","100","0034","1375","777","461","316","10","787","1595","0","49.34","28.90"
"63","000","00","100","0034","1376","746","456","290","8","754","1660","0","45.42","27.47"
"63","000","00","100","0035","0000","3345","1934","1411","22","3367","7322","0","45.98","26.41"
"63","000","00","100","0035","1377","565","334","231","2","567","1223","0","46.36","27.31"
"63","000","00","100","0035","1378","617","359","258","4","621","1384","0","44.87","25.94"
"63","000","00","100","0035","1379","670","377","293","3","673","1436","0","46.87","26.25"
"63","000","00","100","0035","1380","738","402","336","8","746","1683","0","44.33","23.89"
"63","000","00","100","0035","1381","755","462","293","5","760","1596","0","47.62","28.95"
"63","000","00","100","0036","0000","1988","1050","938","15","2003","4501","0","44.50","23.33"
"63","000","00","100","0036","1382","689","358","331","6","695","1469","0","47.31","24.37"
"63","000","00","100","0036","1383","654","323","331","3","657","1596","0","41.17","20.24"
"63","000","00","100","0036","1384","645","369","276","6","651","1436","0","45.33","25.70"
"63","000","00","100","0037","0000","391","168","223","5","396","1126","0","35.17","14.92"
"63","000","00","100","0037","1385","391","168","223","5","396","1126","0","35.17","14.92"
"63","000","00","100","0038","0000","2291","1106","1185","16","2307","4994","0","46.20","22.15"
"63","000","00","100","0038","1386","640","292","348","7","647","1342","0","48.21","21.76"
"63","000","00","100","0038","1387","536","269","267","3","539","1196","0","45.07","22.49"
"63","000","00","100","0038","1388","578","267","311","3","581","1330","0","43.68","20.08"
"63","000","00","100","0038","1389","537","278","259","3","540","1126","0","47.96","24.69"
"63","000","00","100","0039","0000","3693","2180","1513","33","3726","7959","0","46.81","27.39"
"63","000","00","100","0039","1390","707","436","271","6","713","1516","0","47.03","28.76"
"63","000","00","100","0039","1391","777","433","344","9","786","1553","0","50.61","27.88"
"63","000","00","100","0039","1392","771","466","305","7","778","1683","0","46.23","27.69"
"63","000","00","100","0039","1393","762","448","314","8","770","1670","0","46.11","26.83"
"63","000","00","100","0039","1394","676","397","279","3","679","1537","0","44.18","25.83"
"63","000","00","100","0040","0000","2144","1270","874","24","2168","4674","0","46.38","27.17"
"63","000","00","100","0040","1395","721","432","289","13","734","1493","0","49.16","28.94"
"63","000","00","100","0040","1396","693","406","287","7","700","1531","0","45.72","26.52"
"63","000","00","100","0040","1397","730","432","298","4","734","1650","0","44.48","26.18"
"63","000","00","110","0000","0000","107913","50628","57285","968","108881","233253","274056","46.68","21.71"
"63","000","00","110","0001","0000","1545","647","898","16","1561","3285","0","47.52","19.70"
"63","000","00","110","0001","1398","513","195","318","5","518","1145","0","45.24","17.03"
"63","000","00","110","0001","1399","473","182","291","3","476","997","0","47.74","18.25"
"63","000","00","110","0001","1400","559","270","289","8","567","1143","0","49.61","23.62"
"63","000","00","110","0002","0000","1231","646","585","16","1247","2736","0","45.58","23.61"
"63","000","00","110","0002","1401","534","268","266","7","541","1227","0","44.09","21.84"
"63","000","00","110","0002","1402","697","378","319","9","706","1509","0","46.79","25.05"
"63","000","00","110","0003","0000","1133","568","565","17","1150","2482","0","46.33","22.88"
"63","000","00","110","0003","1403","447","250","197","8","455","1123","0","40.52","22.26"
"63","000","00","110","0003","1404","686","318","368","9","695","1359","0","51.14","23.40"
"63","000","00","110","0004","0000","1835","974","861","13","1848","5079","0","36.39","19.18"
"63","000","00","110","0004","1405","474","229","245","4","478","964","0","49.59","23.76"
"63","000","00","110","0004","1406","448","235","213","3","451","961","0","46.93","24.45"
"63","000","00","110","0004","1407","524","306","218","2","526","1044","0","50.38","29.31"
"63","000","00","110","0004","1408","389","204","185","4","393","2110","0","18.63","9.67"
"63","000","00","110","0005","0000","3375","1791","1584","24","3399","6507","0","52.24","27.52"
"63","000","00","110","0005","1409","606","363","243","5","611","1213","0","50.37","29.93"
"63","000","00","110","0005","1410","619","408","211","6","625","1222","0","51.15","33.39"
"63","000","00","110","0005","1411","604","314","290","4","608","1142","0","53.24","27.50"
"63","000","00","110","0005","1412","716","317","399","4","720","1421","0","50.67","22.31"
"63","000","00","110","0005","1413","830","389","441","5","835","1509","0","55.33","25.78"
"63","000","00","110","0006","0000","2593","1246","1347","24","2617","5295","0","49.42","23.53"
"63","000","00","110","0006","1414","600","334","266","5","605","1181","0","51.23","28.28"
"63","000","00","110","0006","1415","547","267","280","5","552","1241","0","44.48","21.51"
"63","000","00","110","0006","1416","777","361","416","7","784","1494","0","52.48","24.16"
"63","000","00","110","0006","1417","669","284","385","7","676","1379","0","49.02","20.59"
"63","000","00","110","0007","0000","3185","1530","1655","26","3211","6549","0","49.03","23.36"
"63","000","00","110","0007","1418","517","215","302","9","526","1118","0","47.05","19.23"
"63","000","00","110","0007","1419","678","300","378","3","681","1338","0","50.90","22.42"
"63","000","00","110","0007","1420","665","348","317","2","667","1387","0","48.09","25.09"
"63","000","00","110","0007","1421","753","383","370","9","762","1462","0","52.12","26.20"
"63","000","00","110","0007","1422","572","284","288","3","575","1244","0","46.22","22.83"
"63","000","00","110","0008","0000","2954","1257","1697","20","2974","6846","0","43.44","18.36"
"63","000","00","110","0008","1423","585","259","326","3","588","1350","0","43.56","19.19"
"63","000","00","110","0008","1424","551","219","332","7","558","1399","0","39.89","15.65"
"63","000","00","110","0008","1425","612","282","330","3","615","1422","0","43.25","19.83"
"63","000","00","110","0008","1426","556","216","340","3","559","1276","0","43.81","16.93"
"63","000","00","110","0008","1427","650","281","369","4","654","1399","0","46.75","20.09"
"63","000","00","110","0009","0000","2641","1144","1497","16","2657","5673","0","46.84","20.17"
"63","000","00","110","0009","1428","590","245","345","2","592","1346","0","43.98","18.20"
"63","000","00","110","0009","1429","636","276","360","2","638","1335","0","47.79","20.67"
"63","000","00","110","0009","1430","742","355","387","8","750","1489","0","50.37","23.84"
"63","000","00","110","0009","1431","673","268","405","4","677","1503","0","45.04","17.83"
"63","000","00","110","0010","0000","1735","729","1006","15","1750","3851","0","45.44","18.93"
"63","000","00","110","0010","1432","617","273","344","4","621","1349","0","46.03","20.24"
"63","000","00","110","0010","1433","626","244","382","6","632","1374","0","46.00","17.76"
"63","000","00","110","0010","1434","492","212","280","5","497","1128","0","44.06","18.79"
"63","000","00","110","0011","0000","2782","1195","1587","24","2806","5841","0","48.04","20.46"
"63","000","00","110","0011","1435","677","287","390","5","682","1459","0","46.74","19.67"
"63","000","00","110","0011","1436","696","286","410","8","704","1436","0","49.03","19.92"
"63","000","00","110","0011","1437","725","318","407","7","732","1493","0","49.03","21.30"
"63","000","00","110","0011","1438","684","304","380","4","688","1453","0","47.35","20.92"
"63","000","00","110","0012","0000","2187","1118","1069","15","2202","4783","0","46.04","23.37"
"63","000","00","110","0012","1439","499","263","236","4","503","1111","0","45.27","23.67"
"63","000","00","110","0012","1440","615","294","321","4","619","1342","0","46.13","21.91"
"63","000","00","110","0012","1441","543","278","265","3","546","1150","0","47.48","24.17"
"63","000","00","110","0012","1442","530","283","247","4","534","1180","0","45.25","23.98"
"63","000","00","110","0013","0000","2256","1020","1236","22","2278","5342","0","42.64","19.09"
"63","000","00","110","0013","1443","538","267","271","1","539","1252","0","43.05","21.33"
"63","000","00","110","0013","1444","478","205","273","5","483","1235","0","39.11","16.60"
"63","000","00","110","0013","1445","556","251","305","8","564","1422","0","39.66","17.65"
"63","000","00","110","0013","1446","684","297","387","8","692","1433","0","48.29","20.73"
"63","000","00","110","0014","0000","1987","948","1039","17","2004","4156","0","48.22","22.81"
"63","000","00","110","0014","1447","642","356","286","3","645","1373","0","46.98","25.93"
"63","000","00","110","0014","1448","651","290","361","10","661","1421","0","46.52","20.41"
"63","000","00","110","0014","1449","694","302","392","4","698","1362","0","51.25","22.17"
"63","000","00","110","0015","0000","2168","863","1305","26","2194","4679","0","46.89","18.44"
"63","000","00","110","0015","1450","546","208","338","4","550","1152","0","47.74","18.06"
"63","000","00","110","0015","1451","566","247","319","6","572","1210","0","47.27","20.41"
"63","000","00","110","0015","1452","611","253","358","9","620","1300","0","47.69","19.46"
"63","000","00","110","0015","1453","445","155","290","7","452","1017","0","44.44","15.24"
"63","000","00","110","0016","0000","2240","895","1345","22","2262","5082","0","44.51","17.61"
"63","000","00","110","0016","1454","573","247","326","9","582","1288","0","45.19","19.18"
"63","000","00","110","0016","1455","485","175","310","0","485","1182","0","41.03","14.81"
"63","000","00","110","0016","1456","603","226","377","8","611","1306","0","46.78","17.30"
"63","000","00","110","0016","1457","579","247","332","5","584","1306","0","44.72","18.91"
"63","000","00","110","0017","0000","2899","1336","1563","32","2931","6264","0","46.79","21.33"
"63","000","00","110","0017","1458","525","201","324","7","532","1195","0","44.52","16.82"
"63","000","00","110","0017","1459","591","240","351","5","596","1310","0","45.50","18.32"
"63","000","00","110","0017","1460","575","224","351","7","582","1274","0","45.68","17.58"
"63","000","00","110","0017","1461","567","362","205","8","575","1164","0","49.40","31.10"
"63","000","00","110","0017","1462","641","309","332","5","646","1321","0","48.90","23.39"
"63","000","00","110","0018","0000","1606","681","925","8","1614","3514","0","45.93","19.38"
"63","000","00","110","0018","1463","491","221","270","2","493","1063","0","46.38","20.79"
"63","000","00","110","0018","1464","575","240","335","3","578","1233","0","46.88","19.46"
"63","000","00","110","0018","1465","540","220","320","3","543","1218","0","44.58","18.06"
"63","000","00","110","0019","0000","2429","951","1478","15","2444","5517","0","44.30","17.24"
"63","000","00","110","0019","1466","604","252","352","3","607","1280","0","47.42","19.69"
"63","000","00","110","0019","1467","624","197","427","4","628","1437","0","43.70","13.71"
"63","000","00","110","0019","1468","610","300","310","5","615","1425","0","43.16","21.05"
"63","000","00","110","0019","1469","591","202","389","3","594","1375","0","43.20","14.69"
"63","000","00","110","0020","0000","3260","1269","1991","30","3290","7737","0","42.52","16.40"
"63","000","00","110","0020","1470","600","237","363","4","604","1295","0","46.64","18.30"
"63","000","00","110","0020","1471","495","169","326","10","505","1204","0","41.94","14.04"
"63","000","00","110","0020","1472","518","222","296","2","520","1262","0","41.20","17.59"
"63","000","00","110","0020","1473","613","219","394","4","617","1445","0","42.70","15.16"
"63","000","00","110","0020","1474","505","229","276","6","511","1281","0","39.89","17.88"
"63","000","00","110","0020","1475","529","193","336","4","533","1250","0","42.64","15.44"
"63","000","00","110","0021","0000","2767","1011","1756","25","2792","6210","0","44.96","16.28"
"63","000","00","110","0021","1476","484","198","286","1","485","1078","0","44.99","18.37"
"63","000","00","110","0021","1477","476","152","324","7","483","1148","0","42.07","13.24"
"63","000","00","110","0021","1478","612","211","401","3","615","1372","0","44.83","15.38"
"63","000","00","110","0021","1479","595","223","372","11","606","1360","0","44.56","16.40"
"63","000","00","110","0021","1480","600","227","373","3","603","1252","0","48.16","18.13"
"63","000","00","110","0022","0000","2676","1023","1653","33","2709","6117","0","44.29","16.72"
"63","000","00","110","0022","1481","514","199","315","7","521","1222","0","42.64","16.28"
"63","000","00","110","0022","1482","520","205","315","3","523","1213","0","43.12","16.90"
"63","000","00","110","0022","1483","565","228","337","9","574","1242","0","46.22","18.36"
"63","000","00","110","0022","1484","516","182","334","7","523","1153","0","45.36","15.78"
"63","000","00","110","0022","1485","561","209","352","7","568","1287","0","44.13","16.24"
"63","000","00","110","0023","0000","1901","481","1420","15","1916","4416","0","43.39","10.89"
"63","000","00","110","0023","1486","600","151","449","5","605","1415","0","42.76","10.67"
"63","000","00","110","0023","1487","636","160","476","5","641","1459","0","43.93","10.97"
"63","000","00","110","0023","1488","665","170","495","5","670","1542","0","43.45","11.02"
"63","000","00","110","0024","0000","2265","651","1614","26","2291","5424","0","42.24","12.00"
"63","000","00","110","0024","1489","476","144","332","6","482","1135","0","42.47","12.69"
"63","000","00","110","0024","1490","655","161","494","9","664","1550","0","42.84","10.39"
"63","000","00","110","0024","1491","556","162","394","3","559","1340","0","41.72","12.09"
"63","000","00","110","0024","1492","578","184","394","8","586","1399","0","41.89","13.15"
"63","000","00","110","0025","0000","1338","736","602","7","1345","2895","0","46.46","25.42"
"63","000","00","110","0025","1493","632","326","306","6","638","1446","0","44.12","22.54"
"63","000","00","110","0025","1494","706","410","296","1","707","1449","0","48.79","28.30"
"63","000","00","110","0026","0000","3098","1616","1482","24","3122","6048","0","51.62","26.72"
"63","000","00","110","0026","1495","679","359","320","5","684","1313","0","52.09","27.34"
"63","000","00","110","0026","1496","599","329","270","7","606","1205","0","50.29","27.30"
"63","000","00","110","0026","1497","681","357","324","2","683","1337","0","51.08","26.70"
"63","000","00","110","0026","1498","627","339","288","6","633","1209","0","52.36","28.04"
"63","000","00","110","0026","1499","512","232","280","4","516","984","0","52.44","23.58"
"63","000","00","110","0027","0000","1864","908","956","13","1877","3773","0","49.75","24.07"
"63","000","00","110","0027","1500","735","370","365","2","737","1315","0","56.05","28.14"
"63","000","00","110","0027","1501","539","271","268","6","545","1227","0","44.42","22.09"
"63","000","00","110","0027","1502","590","267","323","5","595","1231","0","48.33","21.69"
"63","000","00","110","0028","0000","2292","1071","1221","12","2304","4821","0","47.79","22.22"
"63","000","00","110","0028","1503","566","255","311","3","569","1220","0","46.64","20.90"
"63","000","00","110","0028","1504","532","233","299","3","535","1178","0","45.42","19.78"
"63","000","00","110","0028","1505","620","300","320","3","623","1283","0","48.56","23.38"
"63","000","00","110","0028","1506","574","283","291","3","577","1140","0","50.61","24.82"
"63","000","00","110","0029","0000","2136","1196","940","17","2153","4319","0","49.85","27.69"
"63","000","00","110","0029","1507","717","355","362","8","725","1478","0","49.05","24.02"
"63","000","00","110","0029","1508","666","319","347","3","669","1352","0","49.48","23.59"
"63","000","00","110","0029","1509","753","522","231","6","759","1489","0","50.97","35.06"
"63","000","00","110","0030","0000","2250","1400","850","23","2273","4739","0","47.96","29.54"
"63","000","00","110","0030","1510","575","391","184","8","583","1216","0","47.94","32.15"
"63","000","00","110","0030","1511","533","322","211","3","536","1133","0","47.31","28.42"
"63","000","00","110","0030","1512","602","377","225","9","611","1243","0","49.16","30.33"
"63","000","00","110","0030","1513","540","310","230","3","543","1147","0","47.34","27.03"
"63","000","00","110","0031","0000","3157","1578","1579","31","3188","6439","0","49.51","24.51"
"63","000","00","110","0031","1514","666","311","355","7","673","1360","0","49.49","22.87"
"63","000","00","110","0031","1515","673","357","316","8","681","1391","0","48.96","25.66"
"63","000","00","110","0031","1516","640","359","281","4","644","1291","0","49.88","27.81"
"63","000","00","110","0031","1517","564","272","292","5","569","1149","0","49.52","23.67"
"63","000","00","110","0031","1518","614","279","335","7","621","1248","0","49.76","22.36"
"63","000","00","110","0032","0000","2094","1192","902","26","2120","4371","0","48.50","27.27"
"63","000","00","110","0032","1519","701","448","253","2","703","1466","0","47.95","30.56"
"63","000","00","110","0032","1520","678","349","329","16","694","1391","0","49.89","25.09"
"63","000","00","110","0032","1521","715","395","320","8","723","1514","0","47.75","26.09"
"63","000","00","110","0033","0000","2347","1189","1158","17","2364","4881","0","48.43","24.36"
"63","000","00","110","0033","1522","598","313","285","3","601","1260","0","47.70","24.84"
"63","000","00","110","0033","1523","566","289","277","2","568","1229","0","46.22","23.52"
"63","000","00","110","0033","1524","581","281","300","11","592","1211","0","48.89","23.20"
"63","000","00","110","0033","1525","602","306","296","1","603","1181","0","51.06","25.91"
"63","000","00","110","0034","0000","3431","1702","1729","35","3466","7425","0","46.68","22.92"
"63","000","00","110","0034","1526","532","269","263","3","535","1202","0","44.51","22.38"
"63","000","00","110","0034","1527","551","263","288","7","558","1207","0","46.23","21.79"
"63","000","00","110","0034","1528","543","263","280","8","551","1160","0","47.50","22.67"
"63","000","00","110","0034","1529","672","306","366","8","680","1347","0","50.48","22.72"
"63","000","00","110","0034","1530","597","323","274","3","600","1373","0","43.70","23.53"
"63","000","00","110","0034","1531","536","278","258","6","542","1136","0","47.71","24.47"
"63","000","00","110","0035","0000","2681","1306","1375","18","2699","5452","0","49.50","23.95"
"63","000","00","110","0035","1532","655","343","312","4","659","1391","0","47.38","24.66"
"63","000","00","110","0035","1533","738","342","396","6","744","1458","0","51.03","23.46"
"63","000","00","110","0035","1534","731","350","381","4","735","1472","0","49.93","23.78"
"63","000","00","110","0035","1535","557","271","286","4","561","1131","0","49.60","23.96"
"63","000","00","110","0036","0000","2419","1247","1172","29","2448","5286","0","46.31","23.59"
"63","000","00","110","0036","1536","708","352","356","10","718","1502","0","47.80","23.44"
"63","000","00","110","0036","1537","555","262","293","6","561","1245","0","45.06","21.04"
"63","000","00","110","0036","1538","598","322","276","6","604","1256","0","48.09","25.64"
"63","000","00","110","0036","1539","558","311","247","7","565","1283","0","44.04","24.24"
"63","000","00","110","0037","0000","2118","990","1128","9","2127","4413","0","48.20","22.43"
"63","000","00","110","0037","1540","792","356","436","6","798","1727","0","46.21","20.61"
"63","000","00","110","0037","1541","638","320","318","3","641","1262","0","50.79","25.36"
"63","000","00","110","0037","1542","688","314","374","0","688","1424","0","48.31","22.05"
"63","000","00","110","0038","0000","2071","1040","1031","14","2085","4299","0","48.50","24.19"
"63","000","00","110","0038","1543","700","354","346","3","703","1450","0","48.48","24.41"
"63","000","00","110","0038","1544","629","322","307","4","633","1323","0","47.85","24.34"
"63","000","00","110","0038","1545","742","364","378","7","749","1526","0","49.08","23.85"
"63","000","00","110","0039","0000","3002","1550","1452","33","3035","6370","0","47.65","24.33"
"63","000","00","110","0039","1546","625","329","296","7","632","1302","0","48.54","25.27"
"63","000","00","110","0039","1547","580","298","282","6","586","1185","0","49.45","25.15"
"63","000","00","110","0039","1548","591","307","284","3","594","1220","0","48.69","25.16"
"63","000","00","110","0039","1549","612","328","284","5","617","1300","0","47.46","25.23"
"63","000","00","110","0039","1550","594","288","306","12","606","1363","0","44.46","21.13"
"63","000","00","110","0040","0000","2795","1477","1318","34","2829","5880","0","48.11","25.12"
"63","000","00","110","0040","1551","686","364","322","6","692","1489","0","46.47","24.45"
"63","000","00","110","0040","1552","690","398","292","11","701","1472","0","47.62","27.04"
"63","000","00","110","0040","1553","694","348","346","11","705","1415","0","49.82","24.59"
"63","000","00","110","0040","1554","725","367","358","6","731","1504","0","48.60","24.40"
"63","000","00","110","0041","0000","3533","1792","1741","30","3563","7345","0","48.51","24.40"
"63","000","00","110","0041","1555","757","349","408","4","761","1592","0","47.80","21.92"
"63","000","00","110","0041","1556","679","374","305","6","685","1461","0","46.89","25.60"
"63","000","00","110","0041","1557","702","383","319","8","710","1480","0","47.97","25.88"
"63","000","00","110","0041","1558","764","353","411","8","772","1542","0","50.06","22.89"
"63","000","00","110","0041","1559","631","333","298","4","635","1270","0","50.00","26.22"
"63","000","00","110","0042","0000","2687","1418","1269","25","2712","5559","0","48.79","25.51"
"63","000","00","110","0042","1560","598","276","322","6","604","1191","0","50.71","23.17"
"63","000","00","110","0042","1561","687","379","308","5","692","1444","0","47.92","26.25"
"63","000","00","110","0042","1562","735","389","346","10","745","1485","0","50.17","26.20"
"63","000","00","110","0042","1563","667","374","293","4","671","1439","0","46.63","25.99"
"63","000","00","110","0043","0000","520","202","318","5","525","1083","0","48.48","18.65"
"63","000","00","110","0043","1564","520","202","318","5","525","1083","0","48.48","18.65"
"63","000","00","110","0044","0000","497","168","329","7","504","1228","0","41.04","13.68"
"63","000","00","110","0044","1565","497","168","329","7","504","1228","0","41.04","13.68"
"63","000","00","110","0045","0000","794","318","476","8","802","1668","0","48.08","19.06"
"63","000","00","110","0045","1566","393","157","236","4","397","840","0","47.26","18.69"
"63","000","00","110","0045","1567","401","161","240","4","405","828","0","48.91","19.44"
"63","000","00","110","0046","0000","1105","519","586","21","1126","2666","0","42.24","19.47"
"63","000","00","110","0046","1568","394","132","262","9","403","936","0","43.06","14.10"
"63","000","00","110","0046","1569","370","191","179","6","376","909","0","41.36","21.01"
"63","000","00","110","0046","1570","341","196","145","6","347","821","0","42.27","23.87"
"63","000","00","110","0047","0000","559","244","315","3","562","1421","0","39.55","17.17"
"63","000","00","110","0047","1571","327","139","188","2","329","889","0","37.01","15.64"
"63","000","00","110","0047","1572","232","105","127","1","233","532","0","43.80","19.74"
"63","000","00","110","0048","0000","548","154","394","7","555","1306","0","42.50","11.79"
"63","000","00","110","0048","1573","548","154","394","7","555","1306","0","42.50","11.79"
"63","000","00","110","0049","0000","567","239","328","5","572","1328","0","43.07","18.00"
"63","000","00","110","0049","1574","567","239","328","5","572","1328","0","43.07","18.00"
"63","000","00","110","0050","0000","1198","796","402","11","1209","2345","0","51.56","33.94"
"63","000","00","110","0050","1575","576","394","182","6","582","1144","0","50.87","34.44"
"63","000","00","110","0050","1576","622","402","220","5","627","1201","0","52.21","33.47"
"63","000","00","110","0051","0000","1162","606","556","7","1169","2508","0","46.61","24.16"
"63","000","00","110","0051","1577","626","336","290","5","631","1396","0","45.20","24.07"
"63","000","00","110","0051","1578","536","270","266","2","538","1112","0","48.38","24.28"
"63","000","00","120","0000","0000","94129","46388","47741","826","94955","207834","247333","45.69","22.32"
"63","000","00","120","0001","0000","1843","838","1005","16","1859","3704","0","50.19","22.62"
"63","000","00","120","0001","1579","599","282","317","6","605","1229","0","49.23","22.95"
"63","000","00","120","0001","1580","629","267","362","6","635","1241","0","51.17","21.51"
"63","000","00","120","0001","1581","615","289","326","4","619","1234","0","50.16","23.42"
"63","000","00","120","0002","0000","1701","755","946","14","1715","3685","0","46.54","20.49"
"63","000","00","120","0002","1582","526","243","283","3","529","1148","0","46.08","21.17"
"63","000","00","120","0002","1583","590","249","341","6","596","1285","0","46.38","19.38"
"63","000","00","120","0002","1584","585","263","322","5","590","1252","0","47.12","21.01"
"63","000","00","120","0003","0000","2138","976","1162","17","2155","4492","0","47.97","21.73"
"63","000","00","120","0003","1585","590","255","335","6","596","1166","0","51.11","21.87"
"63","000","00","120","0003","1586","675","314","361","0","675","1369","0","49.31","22.94"
"63","000","00","120","0003","1587","369","191","178","8","377","854","0","44.15","22.37"
"63","000","00","120","0003","1588","504","216","288","3","507","1103","0","45.97","19.58"
"63","000","00","120","0004","0000","2882","1413","1469","36","2918","5935","0","49.17","23.81"
"63","000","00","120","0004","1589","611","294","317","6","617","1227","0","50.29","23.96"
"63","000","00","120","0004","1590","555","276","279","12","567","1156","0","49.05","23.88"
"63","000","00","120","0004","1591","589","302","287","6","595","1220","0","48.77","24.75"
"63","000","00","120","0004","1592","577","291","286","5","582","1174","0","49.57","24.79"
"63","000","00","120","0004","1593","550","250","300","7","557","1158","0","48.10","21.59"
"63","000","00","120","0005","0000","2601","1324","1277","25","2626","6019","0","43.63","22.00"
"63","000","00","120","0005","1594","476","196","280","6","482","1256","0","38.38","15.61"
"63","000","00","120","0005","1595","495","273","222","8","503","1244","0","40.43","21.95"
"63","000","00","120","0005","1596","539","245","294","4","543","1181","0","45.98","20.75"
"63","000","00","120","0005","1597","535","285","250","3","538","1135","0","47.40","25.11"
"63","000","00","120","0005","1598","556","325","231","4","560","1203","0","46.55","27.02"
"63","000","00","120","0006","0000","3128","1573","1555","17","3145","6221","0","50.55","25.29"
"63","000","00","120","0006","1599","598","316","282","3","601","1323","0","45.43","23.89"
"63","000","00","120","0006","1600","689","325","364","3","692","1328","0","52.11","24.47"
"63","000","00","120","0006","1601","705","377","328","4","709","1358","0","52.21","27.76"
"63","000","00","120","0006","1602","604","263","341","5","609","1143","0","53.28","23.01"
"63","000","00","120","0006","1603","532","292","240","2","534","1069","0","49.95","27.32"
"63","000","00","120","0007","0000","3047","1538","1509","26","3073","6632","0","46.34","23.19"
"63","000","00","120","0007","1604","638","299","339","5","643","1376","0","46.73","21.73"
"63","000","00","120","0007","1605","562","282","280","9","571","1255","0","45.50","22.47"
"63","000","00","120","0007","1606","623","335","288","4","627","1414","0","44.34","23.69"
"63","000","00","120","0007","1607","650","332","318","4","654","1290","0","50.70","25.74"
"63","000","00","120","0007","1608","574","290","284","4","578","1297","0","44.56","22.36"
"63","000","00","120","0008","0000","2986","1557","1429","18","3004","6389","0","47.02","24.37"
"63","000","00","120","0008","1609","597","347","250","3","600","1231","0","48.74","28.19"
"63","000","00","120","0008","1610","611","307","304","3","614","1349","0","45.52","22.76"
"63","000","00","120","0008","1611","508","288","220","4","512","1200","0","42.67","24.00"
"63","000","00","120","0008","1612","653","287","366","5","658","1331","0","49.44","21.56"
"63","000","00","120","0008","1613","617","328","289","3","620","1278","0","48.51","25.67"
"63","000","00","120","0009","0000","3715","1816","1899","25","3740","7885","0","47.43","23.03"
"63","000","00","120","0009","1614","542","265","277","4","546","1137","0","48.02","23.31"
"63","000","00","120","0009","1615","608","278","330","2","610","1257","0","48.53","22.12"
"63","000","00","120","0009","1616","670","337","333","4","674","1461","0","46.13","23.07"
"63","000","00","120","0009","1617","682","344","338","6","688","1474","0","46.68","23.34"
"63","000","00","120","0009","1618","568","273","295","2","570","1285","0","44.36","21.25"
"63","000","00","120","0009","1619","645","319","326","7","652","1271","0","51.30","25.10"
"63","000","00","120","0010","0000","3250","1756","1494","31","3281","6840","0","47.97","25.67"
"63","000","00","120","0010","1620","610","321","289","5","615","1296","0","47.45","24.77"
"63","000","00","120","0010","1621","626","344","282","6","632","1270","0","49.76","27.09"
"63","000","00","120","0010","1622","663","401","262","6","669","1477","0","45.29","27.15"
"63","000","00","120","0010","1623","709","342","367","11","720","1482","0","48.58","23.08"
"63","000","00","120","0010","1624","642","348","294","3","645","1315","0","49.05","26.46"
"63","000","00","120","0011","0000","1985","1014","971","20","2005","4020","0","49.88","25.22"
"63","000","00","120","0011","1625","734","399","335","8","742","1451","0","51.14","27.50"
"63","000","00","120","0011","1626","676","318","358","4","680","1385","0","49.10","22.96"
"63","000","00","120","0011","1627","575","297","278","8","583","1184","0","49.24","25.08"
"63","000","00","120","0012","0000","1895","1051","844","15","1910","3773","0","50.62","27.86"
"63","000","00","120","0012","1628","537","289","248","6","543","1073","0","50.61","26.93"
"63","000","00","120","0012","1629","649","375","274","5","654","1206","0","54.23","31.09"
"63","000","00","120","0012","1630","709","387","322","4","713","1494","0","47.72","25.90"
"63","000","00","120","0013","0000","2599","1422","1177","20","2619","5623","0","46.58","25.29"
"63","000","00","120","0013","1631","590","330","260","6","596","1285","0","46.38","25.68"
"63","000","00","120","0013","1632","423","210","213","2","425","860","0","49.42","24.42"
"63","000","00","120","0013","1633","548","293","255","4","552","1247","0","44.27","23.50"
"63","000","00","120","0013","1634","511","292","219","3","514","1181","0","43.52","24.72"
"63","000","00","120","0013","1635","527","297","230","5","532","1050","0","50.67","28.29"
"63","000","00","120","0014","0000","2003","879","1124","13","2016","4216","0","47.82","20.85"
"63","000","00","120","0014","1636","633","260","373","4","637","1400","0","45.50","18.57"
"63","000","00","120","0014","1637","665","295","370","3","668","1403","0","47.61","21.03"
"63","000","00","120","0014","1638","705","324","381","6","711","1413","0","50.32","22.93"
"63","000","00","120","0015","0000","1840","777","1063","12","1852","3960","0","46.77","19.62"
"63","000","00","120","0015","1639","622","269","353","5","627","1330","0","47.14","20.23"
"63","000","00","120","0015","1640","615","261","354","3","618","1325","0","46.64","19.70"
"63","000","00","120","0015","1641","603","247","356","4","607","1305","0","46.51","18.93"
"63","000","00","120","0016","0000","2095","1014","1081","14","2109","4612","0","45.73","21.99"
"63","000","00","120","0016","1642","574","289","285","7","581","1188","0","48.91","24.33"
"63","000","00","120","0016","1643","553","256","297","1","554","1158","0","47.84","22.11"
"63","000","00","120","0016","1644","515","238","277","5","520","1172","0","44.37","20.31"
"63","000","00","120","0016","1645","453","231","222","1","454","1094","0","41.50","21.12"
"63","000","00","120","0017","0000","3619","1723","1896","33","3652","7578","0","48.19","22.74"
"63","000","00","120","0017","1646","566","324","242","6","572","1233","0","46.39","26.28"
"63","000","00","120","0017","1647","618","292","326","2","620","1268","0","48.90","23.03"
"63","000","00","120","0017","1648","645","302","343","7","652","1345","0","48.48","22.45"
"63","000","00","120","0017","1649","576","259","317","6","582","1219","0","47.74","21.25"
"63","000","00","120","0017","1650","636","287","349","7","643","1292","0","49.77","22.21"
"63","000","00","120","0017","1651","578","259","319","5","583","1221","0","47.75","21.21"
"63","000","00","120","0018","0000","2149","1048","1101","10","2159","4729","0","45.65","22.16"
"63","000","00","120","0018","1652","591","286","305","1","592","1214","0","48.76","23.56"
"63","000","00","120","0018","1653","458","184","274","3","461","1114","0","41.38","16.52"
"63","000","00","120","0018","1654","464","218","246","2","466","1079","0","43.19","20.20"
"63","000","00","120","0018","1655","636","360","276","4","640","1322","0","48.41","27.23"
"63","000","00","120","0019","0000","932","334","598","9","941","1949","0","48.28","17.14"
"63","000","00","120","0019","1656","452","151","301","2","454","957","0","47.44","15.78"
"63","000","00","120","0019","1657","480","183","297","7","487","992","0","49.09","18.45"
"63","000","00","120","0020","0000","4446","2156","2290","33","4479","9427","0","47.51","22.87"
"63","000","00","120","0020","1658","798","378","420","7","805","1771","0","45.45","21.34"
"63","000","00","120","0020","1659","555","256","299","2","557","1186","0","46.96","21.59"
"63","000","00","120","0020","1660","625","317","308","5","630","1272","0","49.53","24.92"
"63","000","00","120","0020","1661","655","322","333","5","660","1418","0","46.54","22.71"
"63","000","00","120","0020","1662","567","288","279","6","573","1265","0","45.30","22.77"
"63","000","00","120","0020","1663","645","316","329","7","652","1273","0","51.22","24.82"
"63","000","00","120","0020","1664","601","279","322","1","602","1242","0","48.47","22.46"
"63","000","00","120","0021","0000","3371","1598","1773","40","3411","8533","0","39.97","18.73"
"63","000","00","120","0021","1665","425","191","234","5","430","2283","0","18.83","8.37"
"63","000","00","120","0021","1666","597","247","350","7","604","1292","0","46.75","19.12"
"63","000","00","120","0021","1667","744","351","393","10","754","1545","0","48.80","22.72"
"63","000","00","120","0021","1668","598","259","339","11","609","1335","0","45.62","19.40"
"63","000","00","120","0021","1669","492","222","270","3","495","1064","0","46.52","20.86"
"63","000","00","120","0021","1670","515","328","187","4","519","1014","0","51.18","32.35"
"63","000","00","120","0022","0000","3076","1396","1680","27","3103","7167","0","43.30","19.48"
"63","000","00","120","0022","1671","474","254","220","6","480","1163","0","41.27","21.84"
"63","000","00","120","0022","1672","584","247","337","5","589","1265","0","46.56","19.53"
"63","000","00","120","0022","1673","476","220","256","2","478","1052","0","45.44","20.91"
"63","000","00","120","0022","1674","465","198","267","4","469","1097","0","42.75","18.05"
"63","000","00","120","0022","1675","520","230","290","5","525","1265","0","41.50","18.18"
"63","000","00","120","0022","1676","557","247","310","5","562","1325","0","42.42","18.64"
"63","000","00","120","0023","0000","2202","1038","1164","27","2229","5324","0","41.87","19.50"
"63","000","00","120","0023","1677","589","242","347","12","601","1350","0","44.52","17.93"
"63","000","00","120","0023","1678","532","242","290","6","538","1246","0","43.18","19.42"
"63","000","00","120","0023","1679","544","263","281","6","550","1293","0","42.54","20.34"
"63","000","00","120","0023","1680","537","291","246","3","540","1435","0","37.63","20.28"
"63","000","00","120","0024","0000","2166","918","1248","23","2189","4700","0","46.57","19.53"
"63","000","00","120","0024","1681","548","227","321","5","553","1300","0","42.54","17.46"
"63","000","00","120","0024","1682","587","220","367","5","592","1275","0","46.43","17.25"
"63","000","00","120","0024","1683","423","182","241","5","428","918","0","46.62","19.83"
"63","000","00","120","0024","1684","608","289","319","8","616","1207","0","51.04","23.94"
"63","000","00","120","0025","0000","2611","1246","1365","22","2633","5643","0","46.66","22.08"
"63","000","00","120","0025","1685","488","213","275","3","491","1084","0","45.30","19.65"
"63","000","00","120","0025","1686","444","189","255","4","448","933","0","48.02","20.26"
"63","000","00","120","0025","1687","564","264","300","10","574","1158","0","49.57","22.80"
"63","000","00","120","0025","1688","541","272","269","2","543","1251","0","43.41","21.74"
"63","000","00","120","0025","1689","574","308","266","3","577","1217","0","47.41","25.31"
"63","000","00","120","0026","0000","1020","553","467","7","1027","2679","0","38.34","20.64"
"63","000","00","120","0026","1690","503","299","204","4","507","1300","0","39.00","23.00"
"63","000","00","120","0026","1691","517","254","263","3","520","1379","0","37.71","18.42"
"63","000","00","120","0027","0000","2351","1238","1113","20","2371","5695","0","41.63","21.74"
"63","000","00","120","0027","1692","477","264","213","3","480","1114","0","43.09","23.70"
"63","000","00","120","0027","1693","501","256","245","6","507","1136","0","44.63","22.54"
"63","000","00","120","0027","1694","460","234","226","5","465","1159","0","40.12","20.19"
"63","000","00","120","0027","1695","431","237","194","2","433","1124","0","38.52","21.09"
"63","000","00","120","0027","1696","482","247","235","4","486","1162","0","41.82","21.26"
"63","000","00","120","0028","0000","1535","703","832","12","1547","3547","0","43.61","19.82"
"63","000","00","120","0028","1697","425","180","245","2","427","970","0","44.02","18.56"
"63","000","00","120","0028","1698","534","257","277","3","537","1280","0","41.95","20.08"
"63","000","00","120","0028","1699","576","266","310","7","583","1297","0","44.95","20.51"
"63","000","00","120","0029","0000","2683","1398","1285","29","2712","5783","0","46.90","24.17"
"63","000","00","120","0029","1700","565","270","295","8","573","1337","0","42.86","20.19"
"63","000","00","120","0029","1701","684","426","258","5","689","1459","0","47.22","29.20"
"63","000","00","120","0029","1702","766","392","374","5","771","1538","0","50.13","25.49"
"63","000","00","120","0029","1703","668","310","358","11","679","1449","0","46.86","21.39"
"63","000","00","120","0030","0000","2077","1063","1014","19","2096","4233","0","49.52","25.11"
"63","000","00","120","0030","1704","507","274","233","6","513","1063","0","48.26","25.78"
"63","000","00","120","0030","1705","721","363","358","5","726","1506","0","48.21","24.10"
"63","000","00","120","0030","1706","849","426","423","8","857","1664","0","51.50","25.60"
"63","000","00","120","0031","0000","2254","1180","1074","14","2268","5189","0","43.71","22.74"
"63","000","00","120","0031","1707","557","299","258","3","560","1297","0","43.18","23.05"
"63","000","00","120","0031","1708","500","243","257","5","505","1225","0","41.22","19.84"
"63","000","00","120","0031","1709","599","311","288","3","602","1308","0","46.02","23.78"
"63","000","00","120","0031","1710","598","327","271","3","601","1359","0","44.22","24.06"
"63","000","00","120","0032","0000","1228","660","568","20","1248","2834","0","44.04","23.29"
"63","000","00","120","0032","1711","549","291","258","14","563","1393","0","40.42","20.89"
"63","000","00","120","0032","1712","679","369","310","6","685","1441","0","47.54","25.61"
"63","000","00","120","0033","0000","1706","1154","552","13","1719","3518","0","48.86","32.80"
"63","000","00","120","0033","1713","550","375","175","1","551","1093","0","50.41","34.31"
"63","000","00","120","0033","1714","504","351","153","6","510","1073","0","47.53","32.71"
"63","000","00","120","0033","1715","652","428","224","6","658","1352","0","48.67","31.66"
"63","000","00","120","0034","0000","1487","772","715","12","1499","3811","0","39.33","20.26"
"63","000","00","120","0034","1716","502","287","215","6","508","1297","0","39.17","22.13"
"63","000","00","120","0034","1717","523","254","269","2","525","1322","0","39.71","19.21"
"63","000","00","120","0034","1718","462","231","231","4","466","1192","0","39.09","19.38"
"63","000","00","120","0035","0000","2062","1193","869","17","2079","4730","0","43.95","25.22"
"63","000","00","120","0035","1719","569","373","196","2","571","1178","0","48.47","31.66"
"63","000","00","120","0035","1720","496","285","211","5","501","1117","0","44.85","25.51"
"63","000","00","120","0035","1724","486","271","215","3","489","1179","0","41.48","22.99"
"63","000","00","120","0035","1725","511","264","247","7","518","1256","0","41.24","21.02"
"63","000","00","120","0036","0000","2391","1096","1295","21","2412","5227","0","46.15","20.97"
"63","000","00","120","0036","1721","517","202","315","5","522","1260","0","41.43","16.03"
"63","000","00","120","0036","1722","594","275","319","6","600","1373","0","43.70","20.03"
"63","000","00","120","0036","1723","617","310","307","4","621","1237","0","50.20","25.06"
"63","000","00","120","0036","1726","663","309","354","6","669","1357","0","49.30","22.77"
"63","000","00","120","0037","0000","2739","1250","1489","17","2756","6316","0","43.64","19.79"
"63","000","00","120","0037","1727","469","161","308","2","471","1120","0","42.05","14.38"
"63","000","00","120","0037","1728","533","218","315","5","538","1260","0","42.70","17.30"
"63","000","00","120","0037","1729","544","284","260","4","548","1301","0","42.12","21.83"
"63","000","00","120","0037","1730","592","282","310","5","597","1288","0","46.35","21.89"
"63","000","00","120","0037","1731","601","305","296","1","602","1347","0","44.69","22.64"
"63","000","00","120","0038","0000","4188","2068","2120","56","4244","9738","0","43.58","21.24"
"63","000","00","120","0038","1732","553","278","275","3","556","1326","0","41.93","20.97"
"63","000","00","120","0038","1733","590","315","275","2","592","1185","0","49.96","26.58"
"63","000","00","120","0038","1734","515","271","244","7","522","1165","0","44.81","23.26"
"63","000","00","120","0038","1735","466","232","234","4","470","1183","0","39.73","19.61"
"63","000","00","120","0038","1736","546","242","304","5","551","1190","0","46.30","20.34"
"63","000","00","120","0038","1737","525","237","288","7","532","1188","0","44.78","19.95"
"63","000","00","120","0038","1738","530","263","267","21","551","1286","0","42.85","20.45"
"63","000","00","120","0038","1739","463","230","233","7","470","1215","0","38.68","18.93"
"63","000","00","120","0039","0000","820","345","475","10","830","2119","0","39.17","16.28"
"63","000","00","120","0039","1740","261","112","149","3","264","534","0","49.44","20.97"
"63","000","00","120","0039","1741","559","233","326","7","566","1585","0","35.71","14.70"
"63","000","00","120","0040","0000","580","265","315","9","589","1446","0","40.73","18.33"
"63","000","00","120","0040","1742","298","133","165","4","302","780","0","38.72","17.05"
"63","000","00","120","0040","1743","282","132","150","5","287","666","0","43.09","19.82"
"63","000","00","120","0041","0000","412","147","265","4","416","1087","0","38.27","13.52"
"63","000","00","120","0041","1744","412","147","265","4","416","1087","0","38.27","13.52"
"63","000","00","120","0042","0000","316","143","173","3","319","826","0","38.62","17.31"
"63","000","00","120","0042","1745","316","143","173","3","319","826","0","38.62","17.31"
"65","000","00","000","0000","0000","1444060","730469","713591","12291","1456351","3427162","4021398","42.49","21.31"
"65","000","00","010","0000","0000","203009","96508","106501","1682","204691","466918","555551","43.84","20.67"
"65","000","00","010","0001","0000","702","391","311","3","705","1395","0","50.54","28.03"
"65","000","00","010","0001","0974","702","391","311","3","705","1395","0","50.54","28.03"
"65","000","00","010","0002","0000","559","273","286","3","562","1228","0","45.77","22.23"
"65","000","00","010","0002","0975","559","273","286","3","562","1228","0","45.77","22.23"
"65","000","00","010","0003","0000","420","207","213","3","423","838","0","50.48","24.70"
"65","000","00","010","0003","0976","420","207","213","3","423","838","0","50.48","24.70"
"65","000","00","010","0004","0000","466","190","276","6","472","1026","0","46.00","18.52"
"65","000","00","010","0004","0977","466","190","276","6","472","1026","0","46.00","18.52"
"65","000","00","010","0005","0000","831","497","334","4","835","1648","0","50.67","30.16"
"65","000","00","010","0005","0978","452","250","202","1","453","926","0","48.92","27.00"
"65","000","00","010","0005","0979","379","247","132","3","382","722","0","52.91","34.21"
"65","000","00","010","0006","0000","1910","940","970","20","1930","4525","0","42.65","20.77"
"65","000","00","010","0006","0980","565","270","295","6","571","1322","0","43.19","20.42"
"65","000","00","010","0006","0981","423","195","228","3","426","1007","0","42.30","19.36"
"65","000","00","010","0006","0982","427","209","218","6","433","961","0","45.06","21.75"
"65","000","00","010","0006","0983","495","266","229","5","500","1235","0","40.49","21.54"
"65","000","00","010","0007","0000","1140","553","587","11","1151","2846","0","40.44","19.43"
"65","000","00","010","0007","0984","624","301","323","5","629","1503","0","41.85","20.03"
"65","000","00","010","0007","0985","516","252","264","6","522","1343","0","38.87","18.76"
"65","000","00","010","0008","0000","2471","1200","1271","20","2491","8998","0","27.68","13.34"
"65","000","00","010","0008","0986","875","436","439","8","883","5431","0","16.26","8.03"
"65","000","00","010","0008","0987","591","295","296","7","598","1305","0","45.82","22.61"
"65","000","00","010","0008","0988","530","254","276","4","534","1157","0","46.15","21.95"
"65","000","00","010","0008","0989","475","215","260","1","476","1105","0","43.08","19.46"
"65","000","00","010","0009","0000","1726","768","958","20","1746","3907","0","44.69","19.66"
"65","000","00","010","0009","0990","667","294","373","9","676","1519","0","44.50","19.35"
"65","000","00","010","0009","0991","465","207","258","5","470","1105","0","42.53","18.73"
"65","000","00","010","0009","0992","594","267","327","6","600","1283","0","46.77","20.81"
"65","000","00","010","0010","0000","1875","877","998","14","1889","4691","0","40.27","18.70"
"65","000","00","010","0010","0995","828","380","448","5","833","2219","0","37.54","17.12"
"65","000","00","010","0010","0996","507","244","263","4","511","1273","0","40.14","19.17"
"65","000","00","010","0010","0997","540","253","287","5","545","1199","0","45.45","21.10"
"65","000","00","010","0011","0000","2340","1345","995","11","2351","4425","0","53.13","30.40"
"65","000","00","010","0011","0998","592","352","240","5","597","1091","0","54.72","32.26"
"65","000","00","010","0011","0999","587","323","264","3","590","1059","0","55.71","30.50"
"65","000","00","010","0011","1000","625","343","282","1","626","1200","0","52.17","28.58"
"65","000","00","010","0011","1001","536","327","209","2","538","1075","0","50.05","30.42"
"65","000","00","010","0012","0000","1153","518","635","7","1160","2471","0","46.94","20.96"
"65","000","00","010","0012","1002","596","279","317","3","599","1253","0","47.81","22.27"
"65","000","00","010","0012","1003","557","239","318","4","561","1218","0","46.06","19.62"
"65","000","00","010","0013","0000","1106","580","526","8","1114","2357","0","47.26","24.61"
"65","000","00","010","0013","1004","492","215","277","2","494","1117","0","44.23","19.25"
"65","000","00","010","0013","1005","614","365","249","6","620","1240","0","50.00","29.44"
"65","000","00","010","0014","0000","1796","1271","525","12","1808","3349","0","53.99","37.95"
"65","000","00","010","0014","1008","751","568","183","5","756","1332","0","56.76","42.64"
"65","000","00","010","0014","1009","556","430","126","4","560","977","0","57.32","44.01"
"65","000","00","010","0014","1010","489","273","216","3","492","1040","0","47.31","26.25"
"65","000","00","010","0015","0000","1227","616","611","8","1235","2463","0","50.14","25.01"
"65","000","00","010","0015","1011","566","268","298","4","570","1231","0","46.30","21.77"
"65","000","00","010","0015","1012","661","348","313","4","665","1232","0","53.98","28.25"
"65","000","00","010","0016","0000","1459","640","819","11","1470","3446","0","42.66","18.57"
"65","000","00","010","0016","1016","441","207","234","2","443","1041","0","42.56","19.88"
"65","000","00","010","0016","1017","477","206","271","5","482","1169","0","41.23","17.62"
"65","000","00","010","0016","1018","541","227","314","4","545","1236","0","44.09","18.37"
"65","000","00","010","0017","0000","1696","753","943","16","1712","4107","0","41.68","18.33"
"65","000","00","010","0017","1019","462","211","251","4","466","1149","0","40.56","18.36"
"65","000","00","010","0017","1020","376","152","224","5","381","983","0","38.76","15.46"
"65","000","00","010","0017","1021","324","137","187","4","328","795","0","41.26","17.23"
"65","000","00","010","0017","1022","534","253","281","3","537","1180","0","45.51","21.44"
"65","000","00","010","0018","0000","1143","592","551","8","1151","2304","0","49.96","25.69"
"65","000","00","010","0018","1023","571","299","272","3","574","1106","0","51.90","27.03"
"65","000","00","010","0018","1024","572","293","279","5","577","1198","0","48.16","24.46"
"65","000","00","010","0019","0000","1430","597","833","13","1443","3109","0","46.41","19.20"
"65","000","00","010","0019","1027","460","189","271","2","462","999","0","46.25","18.92"
"65","000","00","010","0019","1028","428","186","242","6","434","976","0","44.47","19.06"
"65","000","00","010","0019","1029","542","222","320","5","547","1134","0","48.24","19.58"
"65","000","00","010","0020","0000","1799","912","887","12","1811","3542","0","51.13","25.75"
"65","000","00","010","0020","1030","581","323","258","2","583","1124","0","51.87","28.74"
"65","000","00","010","0020","1031","600","289","311","5","605","1177","0","51.40","24.55"
"65","000","00","010","0020","1032","618","300","318","5","623","1241","0","50.20","24.17"
"65","000","00","010","0021","0000","1463","618","845","14","1477","3318","0","44.51","18.63"
"65","000","00","010","0021","1033","484","209","275","6","490","1048","0","46.76","19.94"
"65","000","00","010","0021","1034","594","248","346","2","596","1280","0","46.56","19.38"
"65","000","00","010","0021","1035","385","161","224","6","391","990","0","39.49","16.26"
"65","000","00","010","0022","0000","1669","818","851","10","1679","3648","0","46.03","22.42"
"65","000","00","010","0022","1036","506","259","247","6","512","1103","0","46.42","23.48"
"65","000","00","010","0022","1037","566","257","309","2","568","1266","0","44.87","20.30"
"65","000","00","010","0022","1038","597","302","295","2","599","1279","0","46.83","23.61"
"65","000","00","010","0023","0000","1408","612","796","8","1416","3487","0","40.61","17.55"
"65","000","00","010","0023","1039","485","213","272","3","488","1158","0","42.14","18.39"
"65","000","00","010","0023","1040","523","229","294","3","526","1235","0","42.59","18.54"
"65","000","00","010","0023","1041","400","170","230","2","402","1094","0","36.75","15.54"
"65","000","00","010","0024","0000","1867","1314","553","10","1877","3605","0","52.07","36.45"
"65","000","00","010","0024","1044","559","380","179","5","564","1094","0","51.55","34.73"
"65","000","00","010","0024","1045","759","587","172","2","761","1407","0","54.09","41.72"
"65","000","00","010","0024","1046","549","347","202","3","552","1104","0","50.00","31.43"
"65","000","00","010","0025","0000","1031","483","548","12","1043","2364","0","44.12","20.43"
"65","000","00","010","0025","1049","571","282","289","8","579","1280","0","45.23","22.03"
"65","000","00","010","0025","1050","460","201","259","4","464","1084","0","42.80","18.54"
"65","000","00","010","0026","0000","1079","534","545","14","1093","2555","0","42.78","20.90"
"65","000","00","010","0026","1051","517","273","244","9","526","1280","0","41.09","21.33"
"65","000","00","010","0026","1052","562","261","301","5","567","1275","0","44.47","20.47"
"65","000","00","010","0027","0000","933","404","529","6","939","1865","0","50.35","21.66"
"65","000","00","010","0027","1053","428","185","243","4","432","847","0","51.00","21.84"
"65","000","00","010","0027","1054","505","219","286","2","507","1018","0","49.80","21.51"
"65","000","00","010","0028","0000","2818","1394","1424","21","2839","6159","0","46.10","22.63"
"65","000","00","010","0028","1055","712","348","364","6","718","1626","0","44.16","21.40"
"65","000","00","010","0028","1056","608","271","337","3","611","1285","0","47.55","21.09"
"65","000","00","010","0028","1057","782","368","414","9","791","1678","0","47.14","21.93"
"65","000","00","010","0028","1058","716","407","309","3","719","1570","0","45.80","25.92"
"65","000","00","010","0029","0000","1935","790","1145","8","1943","4582","0","42.41","17.24"
"65","000","00","010","0029","1059","703","282","421","2","705","1580","0","44.62","17.85"
"65","000","00","010","0029","1060","520","227","293","3","523","1255","0","41.67","18.09"
"65","000","00","010","0029","1061","712","281","431","3","715","1747","0","40.93","16.08"
"65","000","00","010","0030","0000","1981","826","1155","14","1995","4774","0","41.79","17.30"
"65","000","00","010","0030","1062","677","297","380","6","683","1576","0","43.34","18.85"
"65","000","00","010","0030","1063","672","282","390","5","677","1611","0","42.02","17.50"
"65","000","00","010","0030","1064","632","247","385","3","635","1587","0","40.01","15.56"
"65","000","00","010","0031","0000","2428","1054","1374","16","2444","5675","0","43.07","18.57"
"65","000","00","010","0031","1065","451","190","261","5","456","1051","0","43.39","18.08"
"65","000","00","010","0031","1066","966","464","502","6","972","2203","0","44.12","21.06"
"65","000","00","010","0031","1067","392","156","236","3","395","1046","0","37.76","14.91"
"65","000","00","010","0031","1068","619","244","375","2","621","1375","0","45.16","17.75"
"65","000","00","010","0032","0000","1454","742","712","13","1467","3287","0","44.63","22.57"
"65","000","00","010","0032","1069","753","434","319","3","756","1671","0","45.24","25.97"
"65","000","00","010","0032","1070","701","308","393","10","711","1616","0","44.00","19.06"
"65","000","00","010","0033","0000","1990","962","1028","12","2002","4715","0","42.46","20.40"
"65","000","00","010","0033","1073","727","322","405","6","733","1735","0","42.25","18.56"
"65","000","00","010","0033","1074","555","223","332","3","558","1238","0","45.07","18.01"
"65","000","00","010","0033","1075","708","417","291","3","711","1742","0","40.82","23.94"
"65","000","00","010","0034","0000","1128","416","712","12","1140","2555","0","44.62","16.28"
"65","000","00","010","0034","1076","602","211","391","7","609","1351","0","45.08","15.62"
"65","000","00","010","0034","1077","526","205","321","5","531","1204","0","44.10","17.03"
"65","000","00","010","0035","0000","3171","1417","1754","18","3189","7107","0","44.87","19.94"
"65","000","00","010","0035","1078","762","258","504","5","767","1719","0","44.62","15.01"
"65","000","00","010","0035","1079","700","286","414","2","702","1678","0","41.84","17.04"
"65","000","00","010","0035","1080","835","440","395","7","842","1830","0","46.01","24.04"
"65","000","00","010","0035","1081","874","433","441","4","878","1880","0","46.70","23.03"
"65","000","00","010","0036","0000","1502","601","901","10","1512","3275","0","46.17","18.35"
"65","000","00","010","0036","1085","522","183","339","2","524","1100","0","47.64","16.64"
"65","000","00","010","0036","1086","499","204","295","6","505","1137","0","44.42","17.94"
"65","000","00","010","0036","1087","481","214","267","2","483","1038","0","46.53","20.62"
"65","000","00","010","0037","0000","2768","1404","1364","19","2787","6174","0","45.14","22.74"
"65","000","00","010","0037","1088","627","278","349","4","631","1601","0","39.41","17.36"
"65","000","00","010","0037","1089","683","328","355","3","686","1597","0","42.96","20.54"
"65","000","00","010","0037","1090","689","382","307","6","695","1462","0","47.54","26.13"
"65","000","00","010","0037","1091","769","416","353","6","775","1514","0","51.19","27.48"
"65","000","00","010","0038","0000","1128","418","710","8","1136","2666","0","42.61","15.68"
"65","000","00","010","0038","1095","332","129","203","4","336","818","0","41.08","15.77"
"65","000","00","010","0038","1096","369","123","246","1","370","819","0","45.18","15.02"
"65","000","00","010","0038","1097","427","166","261","3","430","1029","0","41.79","16.13"
"65","000","00","010","0039","0000","1827","791","1036","16","1843","4242","0","43.45","18.65"
"65","000","00","010","0039","1098","386","165","221","5","391","949","0","41.20","17.39"
"65","000","00","010","0039","1099","424","187","237","2","426","1051","0","40.53","17.79"
"65","000","00","010","0039","1100","399","178","221","7","406","985","0","41.22","18.07"
"65","000","00","010","0039","1101","618","261","357","2","620","1257","0","49.32","20.76"
"65","000","00","010","0040","0000","1296","543","753","12","1308","2962","0","44.16","18.33"
"65","000","00","010","0040","1102","562","222","340","4","566","1343","0","42.14","16.53"
"65","000","00","010","0040","1103","734","321","413","8","742","1619","0","45.83","19.83"
"65","000","00","010","0041","0000","1776","807","969","20","1796","4168","0","43.09","19.36"
"65","000","00","010","0041","1104","483","205","278","7","490","1164","0","42.10","17.61"
"65","000","00","010","0041","1105","619","295","324","7","626","1372","0","45.63","21.50"
"65","000","00","010","0041","1106","674","307","367","6","680","1632","0","41.67","18.81"
"65","000","00","010","0042","0000","1907","830","1077","13","1920","4391","0","43.73","18.90"
"65","000","00","010","0042","1107","624","252","372","5","629","1451","0","43.35","17.37"
"65","000","00","010","0042","1108","619","255","364","2","621","1462","0","42.48","17.44"
"65","000","00","010","0042","1109","664","323","341","6","670","1478","0","45.33","21.85"
"65","000","00","010","0043","0000","1430","615","815","14","1444","3044","0","47.44","20.20"
"65","000","00","010","0043","1112","727","294","433","8","735","1579","0","46.55","18.62"
"65","000","00","010","0043","1113","703","321","382","6","709","1465","0","48.40","21.91"
"65","000","00","010","0044","0000","4155","2084","2071","36","4191","9043","0","46.35","23.05"
"65","000","00","010","0044","1116","730","364","366","4","734","1597","0","45.96","22.79"
"65","000","00","010","0044","1117","697","299","398","11","708","1434","0","49.37","20.85"
"65","000","00","010","0044","1118","749","400","349","7","756","1661","0","45.51","24.08"
"65","000","00","010","0044","1119","729","384","345","6","735","1583","0","46.43","24.26"
"65","000","00","010","0044","1120","608","313","295","2","610","1403","0","43.48","22.31"
"65","000","00","010","0044","1121","642","324","318","6","648","1365","0","47.47","23.74"
"65","000","00","010","0045","0000","920","355","565","8","928","2150","0","43.16","16.51"
"65","000","00","010","0045","1122","459","166","293","6","465","1076","0","43.22","15.43"
"65","000","00","010","0045","1123","461","189","272","2","463","1074","0","43.11","17.60"
"65","000","00","010","0046","0000","1563","709","854","8","1571","3515","0","44.69","20.17"
"65","000","00","010","0046","1126","579","255","324","3","582","1245","0","46.75","20.48"
"65","000","00","010","0046","1127","442","212","230","2","444","1011","0","43.92","20.97"
"65","000","00","010","0046","1128","542","242","300","3","545","1259","0","43.29","19.22"
"65","000","00","010","0047","0000","1124","458","666","7","1131","2638","0","42.87","17.36"
"65","000","00","010","0047","1129","504","213","291","2","506","1235","0","40.97","17.25"
"65","000","00","010","0047","1130","620","245","375","5","625","1403","0","44.55","17.46"
"65","000","00","010","0048","0000","2077","852","1225","18","2095","5414","0","38.70","15.74"
"65","000","00","010","0048","1131","604","256","348","7","611","1703","0","35.88","15.03"
"65","000","00","010","0048","1132","710","270","440","6","716","1874","0","38.21","14.41"
"65","000","00","010","0048","1133","763","326","437","5","768","1837","0","41.81","17.75"
"65","000","00","010","0049","0000","535","262","273","4","539","1221","0","44.14","21.46"
"65","000","00","010","0049","1134","535","262","273","4","539","1221","0","44.14","21.46"
"65","000","00","010","0050","0000","2288","1014","1274","16","2304","5318","0","43.32","19.07"
"65","000","00","010","0050","1135","648","297","351","5","653","1533","0","42.60","19.37"
"65","000","00","010","0050","1136","537","244","293","8","545","1222","0","44.60","19.97"
"65","000","00","010","0050","1137","539","228","311","3","542","1337","0","40.54","17.05"
"65","000","00","010","0050","1138","564","245","319","0","564","1226","0","46.00","19.98"
"65","000","00","010","0051","0000","1801","824","977","13","1814","3920","0","46.28","21.02"
"65","000","00","010","0051","1139","708","321","387","4","712","1489","0","47.82","21.56"
"65","000","00","010","0051","1140","453","206","247","2","455","926","0","49.14","22.25"
"65","000","00","010","0051","1141","640","297","343","7","647","1505","0","42.99","19.73"
"65","000","00","010","0052","0000","1678","697","981","22","1700","3731","0","45.56","18.68"
"65","000","00","010","0052","1142","403","138","265","5","408","907","0","44.98","15.21"
"65","000","00","010","0052","1143","551","242","309","4","555","1187","0","46.76","20.39"
"65","000","00","010","0052","1144","724","317","407","13","737","1637","0","45.02","19.36"
"65","000","00","010","0053","0000","1286","548","738","9","1295","2939","0","44.06","18.65"
"65","000","00","010","0053","1145","654","282","372","8","662","1435","0","46.13","19.65"
"65","000","00","010","0053","1146","632","266","366","1","633","1504","0","42.09","17.69"
"65","000","00","010","0054","0000","2388","1073","1315","19","2407","5578","0","43.15","19.24"
"65","000","00","010","0054","1147","594","284","310","5","599","1539","0","38.92","18.45"
"65","000","00","010","0054","1148","860","365","495","4","864","1872","0","46.15","19.50"
"65","000","00","010","0054","1149","689","333","356","6","695","1626","0","42.74","20.48"
"65","000","00","010","0054","1150","245","91","154","4","249","541","0","46.03","16.82"
"65","000","00","010","0055","0000","1192","516","676","10","1202","2572","0","46.73","20.06"
"65","000","00","010","0055","1153","668","305","363","5","673","1465","0","45.94","20.82"
"65","000","00","010","0055","1154","524","211","313","5","529","1107","0","47.79","19.06"
"65","000","00","010","0056","0000","1314","686","628","11","1325","2920","0","45.38","23.49"
"65","000","00","010","0056","1155","655","386","269","6","661","1382","0","47.83","27.93"
"65","000","00","010","0056","1156","659","300","359","5","664","1538","0","43.17","19.51"
"65","000","00","010","0057","0000","2942","1419","1523","21","2963","6417","0","46.17","22.11"
"65","000","00","010","0057","1159","476","213","263","4","480","1110","0","43.24","19.19"
"65","000","00","010","0057","1160","524","246","278","1","525","1169","0","44.91","21.04"
"65","000","00","010","0057","1161","511","206","305","4","515","1221","0","42.18","16.87"
"65","000","00","010","0057","1162","353","154","199","2","355","860","0","41.28","17.91"
"65","000","00","010","0057","1163","1078","600","478","10","1088","2057","0","52.89","29.17"
"65","000","00","010","0058","0000","1084","425","659","9","1093","2522","0","43.34","16.85"
"65","000","00","010","0058","1164","614","240","374","4","618","1441","0","42.89","16.66"
"65","000","00","010","0058","1165","470","185","285","5","475","1081","0","43.94","17.11"
"65","000","00","010","0059","0000","1886","852","1034","14","1900","4586","0","41.43","18.58"
"65","000","00","010","0059","1168","806","422","384","6","812","1920","0","42.29","21.98"
"65","000","00","010","0059","1169","507","199","308","5","512","1299","0","39.41","15.32"
"65","000","00","010","0059","1170","573","231","342","3","576","1367","0","42.14","16.90"
"65","000","00","010","0060","0000","1127","519","608","10","1137","2444","0","46.52","21.24"
"65","000","00","010","0060","1171","570","262","308","6","576","1272","0","45.28","20.60"
"65","000","00","010","0060","1172","557","257","300","4","561","1172","0","47.87","21.93"
"65","000","00","010","0061","0000","1797","799","998","9","1806","3765","0","47.97","21.22"
"65","000","00","010","0061","1173","548","230","318","2","550","1210","0","45.45","19.01"
"65","000","00","010","0061","1174","592","233","359","1","593","1284","0","46.18","18.15"
"65","000","00","010","0061","1175","657","336","321","6","663","1271","0","52.16","26.44"
"65","000","00","010","0062","0000","1328","548","780","9","1337","3069","0","43.56","17.86"
"65","000","00","010","0062","1178","589","239","350","3","592","1417","0","41.78","16.87"
"65","000","00","010","0062","1179","739","309","430","6","745","1652","0","45.10","18.70"
"65","000","00","010","0063","0000","1581","685","896","13","1594","3525","0","45.22","19.43"
"65","000","00","010","0063","1180","787","323","464","4","791","1759","0","44.97","18.36"
"65","000","00","010","0063","1181","794","362","432","9","803","1766","0","45.47","20.50"
"65","000","00","010","0064","0000","1224","567","657","13","1237","3031","0","40.81","18.71"
"65","000","00","010","0064","1182","317","162","155","3","320","866","0","36.95","18.71"
"65","000","00","010","0064","1183","411","194","217","5","416","1055","0","39.43","18.39"
"65","000","00","010","0064","1184","496","211","285","5","501","1110","0","45.14","19.01"
"65","000","00","010","0065","0000","3228","1734","1494","23","3251","7123","0","45.64","24.34"
"65","000","00","010","0065","1185","736","421","315","9","745","1713","0","43.49","24.58"
"65","000","00","010","0065","1186","860","389","471","4","864","1836","0","47.06","21.19"
"65","000","00","010","0065","1187","751","413","338","5","756","1721","0","43.93","24.00"
"65","000","00","010","0065","1188","881","511","370","5","886","1853","0","47.81","27.58"
"65","000","00","010","0066","0000","1346","593","753","5","1351","3179","0","42.50","18.65"
"65","000","00","010","0066","1189","431","187","244","1","432","1016","0","42.52","18.41"
"65","000","00","010","0066","1190","463","191","272","2","465","1056","0","44.03","18.09"
"65","000","00","010","0066","1191","452","215","237","2","454","1107","0","41.01","19.42"
"65","000","00","010","0067","0000","1020","478","542","6","1026","2350","0","43.66","20.34"
"65","000","00","010","0067","1192","503","227","276","2","505","1193","0","42.33","19.03"
"65","000","00","010","0067","1193","517","251","266","4","521","1157","0","45.03","21.69"
"65","000","00","010","0068","0000","1765","727","1038","21","1786","3895","0","45.85","18.66"
"65","000","00","010","0068","1194","543","222","321","7","550","1202","0","45.76","18.47"
"65","000","00","010","0068","1195","672","313","359","8","680","1442","0","47.16","21.71"
"65","000","00","010","0068","1196","550","192","358","6","556","1251","0","44.44","15.35"
"65","000","00","010","0069","0000","1754","830","924","12","1766","3802","0","46.45","21.83"
"65","000","00","010","0069","1199","723","355","368","7","730","1581","0","46.17","22.45"
"65","000","00","010","0069","1200","557","254","303","2","559","1159","0","48.23","21.92"
"65","000","00","010","0069","1201","474","221","253","3","477","1062","0","44.92","20.81"
"65","000","00","010","0070","0000","2005","1118","887","17","2022","4141","0","48.83","27.00"
"65","000","00","010","0070","1204","739","387","352","10","749","1450","0","51.66","26.69"
"65","000","00","010","0070","1205","671","392","279","4","675","1381","0","48.88","28.39"
"65","000","00","010","0070","1206","595","339","256","3","598","1310","0","45.65","25.88"
"65","000","00","010","0071","0000","1462","821","641","14","1476","3382","0","43.64","24.28"
"65","000","00","010","0071","1207","774","434","340","5","779","1824","0","42.71","23.79"
"65","000","00","010","0071","1208","688","387","301","9","697","1558","0","44.74","24.84"
"65","000","00","010","0072","0000","1758","865","893","18","1776","3878","0","45.80","22.31"
"65","000","00","010","0072","1209","630","336","294","8","638","1477","0","43.20","22.75"
"65","000","00","010","0072","1210","617","291","326","5","622","1314","0","47.34","22.15"
"65","000","00","010","0072","1211","511","238","273","5","516","1087","0","47.47","21.90"
"65","000","00","010","0073","0000","1432","726","706","23","1455","3111","0","46.77","23.34"
"65","000","00","010","0073","1212","593","324","269","8","601","1383","0","43.46","23.43"
"65","000","00","010","0073","1213","839","402","437","15","854","1728","0","49.42","23.26"
"65","000","00","010","0074","0000","2036","959","1077","11","2047","4371","0","46.83","21.94"
"65","000","00","010","0074","1216","547","256","291","2","549","1178","0","46.60","21.73"
"65","000","00","010","0074","1217","711","344","367","2","713","1384","0","51.52","24.86"
"65","000","00","010","0074","1218","778","359","419","7","785","1809","0","43.39","19.85"
"65","000","00","010","0075","0000","1291","658","633","11","1302","3021","0","43.10","21.78"
"65","000","00","010","0075","1219","657","356","301","8","665","1528","0","43.52","23.30"
"65","000","00","010","0075","1220","634","302","332","3","637","1493","0","42.67","20.23"
"65","000","00","010","0076","0000","1512","741","771","5","1517","3064","0","49.51","24.18"
"65","000","00","010","0076","1221","776","389","387","3","779","1517","0","51.35","25.64"
"65","000","00","010","0076","1222","736","352","384","2","738","1547","0","47.71","22.75"
"65","000","00","010","0077","0000","1549","780","769","28","1577","3320","0","47.50","23.49"
"65","000","00","010","0077","1223","928","481","447","16","944","2020","0","46.73","23.81"
"65","000","00","010","0077","1224","621","299","322","12","633","1300","0","48.69","23.00"
"65","000","00","010","0078","0000","2627","1311","1316","23","2650","5909","0","44.85","22.19"
"65","000","00","010","0078","1225","792","405","387","8","800","1602","0","49.94","25.28"
"65","000","00","010","0078","1226","608","319","289","8","616","1482","0","41.57","21.52"
"65","000","00","010","0078","1227","607","292","315","5","612","1359","0","45.03","21.49"
"65","000","00","010","0078","1228","620","295","325","2","622","1466","0","42.43","20.12"
"65","000","00","010","0079","0000","1805","927","878","10","1815","4094","0","44.33","22.64"
"65","000","00","010","0079","1229","579","306","273","0","579","1426","0","40.60","21.46"
"65","000","00","010","0079","1230","622","329","293","6","628","1285","0","48.87","25.60"
"65","000","00","010","0079","1231","604","292","312","4","608","1383","0","43.96","21.11"
"65","000","00","010","0080","0000","3121","1549","1572","25","3146","7469","0","42.12","20.74"
"65","000","00","010","0080","1232","598","276","322","9","607","1527","0","39.75","18.07"
"65","000","00","010","0080","1233","616","305","311","1","617","1488","0","41.47","20.50"
"65","000","00","010","0080","1234","627","300","327","6","633","1488","0","42.54","20.16"
"65","000","00","010","0080","1235","624","311","313","3","627","1377","0","45.53","22.59"
"65","000","00","010","0080","1236","656","357","299","6","662","1589","0","41.66","22.47"
"65","000","00","010","0081","0000","1235","721","514","12","1247","2702","0","46.15","26.68"
"65","000","00","010","0081","1237","430","286","144","6","436","871","0","50.06","32.84"
"65","000","00","010","0081","1238","398","220","178","4","402","895","0","44.92","24.58"
"65","000","00","010","0081","1239","407","215","192","2","409","936","0","43.70","22.97"
"65","000","00","010","0082","0000","1402","821","581","13","1415","3281","0","43.13","25.02"
"65","000","00","010","0082","1240","798","477","321","6","804","1785","0","45.04","26.72"
"65","000","00","010","0082","1241","604","344","260","7","611","1496","0","40.84","22.99"
"65","000","00","010","0083","0000","1339","627","712","13","1352","3505","0","38.57","17.89"
"65","000","00","010","0083","1242","700","309","391","6","706","1743","0","40.50","17.73"
"65","000","00","010","0083","1243","639","318","321","7","646","1762","0","36.66","18.05"
"65","000","00","010","0084","0000","1704","857","847","20","1724","3734","0","46.17","22.95"
"65","000","00","010","0084","1247","576","279","297","4","580","1307","0","44.38","21.35"
"65","000","00","010","0084","1248","474","211","263","5","479","1112","0","43.08","18.97"
"65","000","00","010","0084","1249","654","367","287","11","665","1315","0","50.57","27.91"
"65","000","00","010","0085","0000","1040","481","559","9","1049","2257","0","46.48","21.31"
"65","000","00","010","0085","1250","523","258","265","3","526","1047","0","50.24","24.64"
"65","000","00","010","0085","1251","517","223","294","6","523","1210","0","43.22","18.43"
"65","000","00","010","0086","0000","2453","1223","1230","20","2473","6150","0","40.21","19.89"
"65","000","00","010","0086","1254","641","300","341","7","648","1816","0","35.68","16.52"
"65","000","00","010","0086","1255","405","177","228","4","409","961","0","42.56","18.42"
"65","000","00","010","0086","1256","714","338","376","4","718","1737","0","41.34","19.46"
"65","000","00","010","0086","1257","693","408","285","5","698","1636","0","42.67","24.94"
"65","000","00","010","0087","0000","3357","1859","1498","15","3372","6979","0","48.32","26.64"
"65","000","00","010","0087","1258","570","346","224","2","572","1139","0","50.22","30.38"
"65","000","00","010","0087","1259","727","396","331","5","732","1431","0","51.15","27.67"
"65","000","00","010","0087","1260","604","361","243","2","606","1356","0","44.69","26.62"
"65","000","00","010","0087","1261","689","331","358","3","692","1595","0","43.39","20.75"
"65","000","00","010","0087","1262","767","425","342","3","770","1458","0","52.81","29.15"
"65","000","00","010","0088","0000","1597","789","808","16","1613","3812","0","42.31","20.70"
"65","000","00","010","0088","1263","542","281","261","3","545","1346","0","40.49","20.88"
"65","000","00","010","0088","1264","485","235","250","7","492","1082","0","45.47","21.72"
"65","000","00","010","0088","1265","570","273","297","6","576","1384","0","41.62","19.73"
"65","000","00","010","0089","0000","1354","538","816","12","1366","3334","0","40.97","16.14"
"65","000","00","010","0089","1266","496","190","306","5","501","1218","0","41.13","15.60"
"65","000","00","010","0089","1267","409","163","246","4","413","1110","0","37.21","14.68"
"65","000","00","010","0089","1268","449","185","264","3","452","1006","0","44.93","18.39"
"65","000","00","010","0090","0000","1917","793","1124","21","1938","4625","0","41.90","17.15"
"65","000","00","010","0090","1269","602","250","352","10","612","1391","0","44.00","17.97"
"65","000","00","010","0090","1270","658","281","377","6","664","1542","0","43.06","18.22"
"65","000","00","010","0090","1271","657","262","395","5","662","1692","0","39.13","15.48"
"65","000","00","010","0091","0000","1438","611","827","6","1444","3700","0","39.03","16.51"
"65","000","00","010","0091","1272","452","183","269","3","455","1108","0","41.06","16.52"
"65","000","00","010","0091","1273","398","179","219","1","399","1087","0","36.71","16.47"
"65","000","00","010","0091","1274","588","249","339","2","590","1505","0","39.20","16.54"
"65","000","00","010","0092","0000","2503","1348","1155","22","2525","6074","0","41.57","22.19"
"65","000","00","010","0092","1278","438","188","250","6","444","1069","0","41.53","17.59"
"65","000","00","010","0092","1279","403","190","213","3","406","1003","0","40.48","18.94"
"65","000","00","010","0092","1280","420","208","212","6","426","1085","0","39.26","19.17"
"65","000","00","010","0092","1281","504","317","187","4","508","1216","0","41.78","26.07"
"65","000","00","010","0092","1282","738","445","293","3","741","1701","0","43.56","26.16"
"65","000","00","010","0093","0000","431","253","178","8","439","873","0","50.29","28.98"
"65","000","00","010","0093","1283","195","151","44","3","198","382","0","51.83","39.53"
"65","000","00","010","0093","1284","236","102","134","5","241","491","0","49.08","20.77"
"65","000","00","010","0094","0000","1477","677","800","7","1484","3466","0","42.82","19.53"
"65","000","00","010","0094","1285","467","219","248","2","469","1171","0","40.05","18.70"
"65","000","00","010","0094","1286","539","252","287","3","542","1184","0","45.78","21.28"
"65","000","00","010","0094","1287","471","206","265","2","473","1111","0","42.57","18.54"
"65","000","00","010","0095","0000","2645","1460","1185","23","2668","6234","0","42.80","23.42"
"65","000","00","010","0095","1288","426","252","174","5","431","966","0","44.62","26.09"
"65","000","00","010","0095","1289","475","180","295","4","479","1178","0","40.66","15.28"
"65","000","00","010","0095","1290","806","480","326","8","814","1919","0","42.42","25.01"
"65","000","00","010","0095","1291","938","548","390","6","944","2171","0","43.48","25.24"
"65","000","00","010","0096","0000","1780","759","1021","18","1798","4615","0","38.96","16.45"
"65","000","00","010","0096","1292","268","112","156","2","270","725","0","37.24","15.45"
"65","000","00","010","0096","1293","488","210","278","8","496","1306","0","37.98","16.08"
"65","000","00","010","0096","1294","473","211","262","1","474","1259","0","37.65","16.76"
"65","000","00","010","0096","1295","551","226","325","7","558","1325","0","42.11","17.06"
"65","000","00","010","0097","0000","1067","445","622","20","1087","2464","0","44.12","18.06"
"65","000","00","010","0097","1296","508","210","298","8","516","1161","0","44.44","18.09"
"65","000","00","010","0097","1297","559","235","324","12","571","1303","0","43.82","18.04"
"65","000","00","010","0098","0000","3332","1575","1757","36","3368","8523","0","39.52","18.48"
"65","000","00","010","0098","1298","489","213","276","10","499","1302","0","38.33","16.36"
"65","000","00","010","0098","1299","558","246","312","5","563","1449","0","38.85","16.98"
"65","000","00","010","0098","1300","522","252","270","3","525","1428","0","36.76","17.65"
"65","000","00","010","0098","1301","530","279","251","4","534","1493","0","35.77","18.69"
"65","000","00","010","0098","1302","652","313","339","6","658","1492","0","44.10","20.98"
"65","000","00","010","0098","1303","581","272","309","8","589","1359","0","43.34","20.01"
"65","000","00","010","0099","0000","2015","912","1103","19","2034","5148","0","39.51","17.72"
"65","000","00","010","0099","1308","670","301","369","8","678","1647","0","41.17","18.28"
"65","000","00","010","0099","1309","740","350","390","8","748","1803","0","41.49","19.41"
"65","000","00","010","0099","1310","605","261","344","3","608","1698","0","35.81","15.37"
"65","000","00","010","0100","0000","1292","613","679","15","1307","3079","0","42.45","19.91"
"65","000","00","010","0100","1319","620","290","330","8","628","1509","0","41.62","19.22"
"65","000","00","010","0100","1320","672","323","349","7","679","1570","0","43.25","20.57"
"65","000","00","010","0101","0000","1027","506","521","10","1037","2397","0","43.26","21.11"
"65","000","00","010","0101","0993","417","192","225","2","419","1000","0","41.90","19.20"
"65","000","00","010","0101","0994","610","314","296","8","618","1397","0","44.24","22.48"
"65","000","00","010","0102","0000","1652","727","925","18","1670","3742","0","44.63","19.43"
"65","000","00","010","0102","1013","485","215","270","5","490","1193","0","41.07","18.02"
"65","000","00","010","0102","1014","626","275","351","7","633","1380","0","45.87","19.93"
"65","000","00","010","0102","1015","541","237","304","6","547","1169","0","46.79","20.27"
"65","000","00","010","0103","0000","1191","593","598","5","1196","2692","0","44.43","22.03"
"65","000","00","010","0103","1042","665","340","325","2","667","1508","0","44.23","22.55"
"65","000","00","010","0103","1043","526","253","273","3","529","1184","0","44.68","21.37"
"65","000","00","010","0104","0000","1330","579","751","12","1342","2948","0","45.52","19.64"
"65","000","00","010","0104","1071","651","274","377","9","660","1482","0","44.53","18.49"
"65","000","00","010","0104","1072","679","305","374","3","682","1466","0","46.52","20.80"
"65","000","00","010","0105","0000","1291","560","731","7","1298","3027","0","42.88","18.50"
"65","000","00","010","0105","1092","415","171","244","3","418","1020","0","40.98","16.76"
"65","000","00","010","0105","1093","396","153","243","2","398","938","0","42.43","16.31"
"65","000","00","010","0105","1094","480","236","244","2","482","1069","0","45.09","22.08"
"65","000","00","010","0106","0000","1134","479","655","8","1142","2449","0","46.63","19.56"
"65","000","00","010","0106","1114","606","261","345","3","609","1286","0","47.36","20.30"
"65","000","00","010","0106","1115","528","218","310","5","533","1163","0","45.83","18.74"
"65","000","00","010","0107","0000","1005","491","514","6","1011","2040","0","49.56","24.07"
"65","000","00","010","0107","1151","480","206","274","3","483","1012","0","47.73","20.36"
"65","000","00","010","0107","1152","525","285","240","3","528","1028","0","51.36","27.72"
"65","000","00","010","0108","0000","1225","557","668","12","1237","2595","0","47.67","21.46"
"65","000","00","010","0108","1166","657","297","360","3","660","1481","0","44.56","20.05"
"65","000","00","010","0108","1167","568","260","308","9","577","1114","0","51.80","23.34"
"65","000","00","010","0109","0000","903","405","498","7","910","1940","0","46.91","20.88"
"65","000","00","010","0109","1197","426","169","257","3","429","946","0","45.35","17.86"
"65","000","00","010","0109","1198","477","236","241","4","481","994","0","48.39","23.74"
"65","000","00","010","0110","0000","1532","793","739","17","1549","3280","0","47.23","24.18"
"65","000","00","010","0110","1214","788","394","394","12","800","1610","0","49.69","24.47"
"65","000","00","010","0110","1215","744","399","345","5","749","1670","0","44.85","23.89"
"65","000","00","010","0111","0000","821","414","407","8","829","1789","0","46.34","23.14"
"65","000","00","010","0111","1252","467","245","222","5","472","968","0","48.76","25.31"
"65","000","00","010","0111","1253","354","169","185","3","357","821","0","43.48","20.58"
"65","000","00","010","0112","0000","1476","688","788","16","1492","3718","0","40.13","18.50"
"65","000","00","010","0112","1321","527","235","292","7","534","1358","0","39.32","17.30"
"65","000","00","010","0112","1322","374","170","204","1","375","935","0","40.11","18.18"
"65","000","00","010","0112","1323","575","283","292","8","583","1425","0","40.91","19.86"
"65","000","00","010","0113","0000","2167","1015","1152","23","2190","6055","0","36.17","16.76"
"65","000","00","010","0113","1304","576","250","326","5","581","1576","0","36.87","15.86"
"65","000","00","010","0113","1305","530","238","292","6","536","1426","0","37.59","16.69"
"65","000","00","010","0113","1306","547","271","276","4","551","1445","0","38.13","18.75"
"65","000","00","010","0113","1307","514","256","258","8","522","1608","0","32.46","15.92"
"65","000","00","010","0114","0000","1031","559","472","6","1037","2287","0","45.34","24.44"
"65","000","00","010","0114","1006","542","293","249","1","543","1267","0","42.86","23.13"
"65","000","00","010","0114","1007","489","266","223","5","494","1020","0","48.43","26.08"
"65","000","00","010","0115","0000","836","426","410","3","839","1772","0","47.35","24.04"
"65","000","00","010","0115","1025","466","240","226","2","468","996","0","46.99","24.10"
"65","000","00","010","0115","1026","370","186","184","1","371","776","0","47.81","23.97"
"65","000","00","010","0116","0000","1123","480","643","11","1134","2400","0","47.25","20.00"
"65","000","00","010","0116","1047","611","280","331","7","618","1257","0","49.16","22.28"
"65","000","00","010","0116","1048","512","200","312","4","516","1143","0","45.14","17.50"
"65","000","00","010","0117","0000","1236","472","764","11","1247","2973","0","41.94","15.88"
"65","000","00","010","0117","1082","453","179","274","2","455","1084","0","41.97","16.51"
"65","000","00","010","0117","1083","364","130","234","3","367","865","0","42.43","15.03"
"65","000","00","010","0117","1084","419","163","256","6","425","1024","0","41.50","15.92"
"65","000","00","010","0118","0000","952","421","531","17","969","2012","0","48.16","20.92"
"65","000","00","010","0118","1110","520","235","285","11","531","1114","0","47.67","21.10"
"65","000","00","010","0118","1111","432","186","246","6","438","898","0","48.78","20.71"
"65","000","00","010","0119","0000","1496","598","898","15","1511","3479","0","43.43","17.19"
"65","000","00","010","0119","1124","693","263","430","7","700","1651","0","42.40","15.93"
"65","000","00","010","0119","1125","803","335","468","8","811","1828","0","44.37","18.33"
"65","000","00","010","0120","0000","1435","638","797","15","1450","3379","0","42.91","18.88"
"65","000","00","010","0120","1157","626","269","357","9","635","1481","0","42.88","18.16"
"65","000","00","010","0120","1158","809","369","440","6","815","1898","0","42.94","19.44"
"65","000","00","010","0121","0000","1664","815","849","16","1680","3540","0","47.46","23.02"
"65","000","00","010","0121","1176","988","495","493","8","996","2040","0","48.82","24.26"
"65","000","00","010","0121","1177","676","320","356","8","684","1500","0","45.60","21.33"
"65","000","00","010","0122","0000","826","350","476","11","837","2026","0","41.31","17.28"
"65","000","00","010","0122","1202","373","157","216","7","380","970","0","39.18","16.19"
"65","000","00","010","0122","1203","453","193","260","4","457","1056","0","43.28","18.28"
"65","000","00","010","0123","0000","1584","729","855","11","1595","3585","0","44.49","20.33"
"65","000","00","010","0123","1244","532","248","284","3","535","1241","0","43.11","19.98"
"65","000","00","010","0123","1245","523","238","285","7","530","1170","0","45.30","20.34"
"65","000","00","010","0123","1246","529","243","286","1","530","1174","0","45.14","20.70"
"65","000","00","010","0124","0000","4710","2345","2365","36","4746","12217","0","38.85","19.19"
"65","000","00","010","0124","1311","624","311","313","6","630","1619","0","38.91","19.21"
"65","000","00","010","0124","1312","650","282","368","4","654","1640","0","39.88","17.20"
"65","000","00","010","0124","1313","548","262","286","2","550","1507","0","36.50","17.39"
"65","000","00","010","0124","1314","666","322","344","3","669","1576","0","42.45","20.43"
"65","000","00","010","0124","1315","637","332","305","8","645","1628","0","39.62","20.39"
"65","000","00","010","0124","1316","616","335","281","5","621","1622","0","38.29","20.65"
"65","000","00","010","0124","1317","547","289","258","4","551","1400","0","39.36","20.64"
"65","000","00","010","0124","1318","422","212","210","4","426","1225","0","34.78","17.31"
"65","000","00","010","0125","0000","1249","495","754","11","1260","3210","0","39.25","15.42"
"65","000","00","010","0125","1275","619","270","349","7","626","1572","0","39.82","17.18"
"65","000","00","010","0125","1276","630","225","405","4","634","1638","0","38.71","13.74"
"65","000","00","010","0126","0000","496","189","307","4","500","1091","0","45.83","17.32"
"65","000","00","010","0126","1277","496","189","307","4","500","1091","0","45.83","17.32"
"65","000","00","020","0000","0000","141979","60580","81399","1209","143188","330362","383135","43.34","18.34"
"65","000","00","020","0001","0000","2041","855","1186","14","2055","4726","0","43.48","18.09"
"65","000","00","020","0001","0729","602","267","335","4","606","1466","0","41.34","18.21"
"65","000","00","020","0001","0730","379","139","240","2","381","834","0","45.68","16.67"
"65","000","00","020","0001","0731","549","218","331","6","555","1279","0","43.39","17.04"
"65","000","00","020","0001","0732","511","231","280","2","513","1147","0","44.73","20.14"
"65","000","00","020","0002","0000","565","225","340","9","574","1436","0","39.97","15.67"
"65","000","00","020","0002","0736","565","225","340","9","574","1436","0","39.97","15.67"
"65","000","00","020","0003","0000","963","357","606","6","969","2322","0","41.73","15.37"
"65","000","00","020","0003","0737","517","203","314","5","522","1257","0","41.53","16.15"
"65","000","00","020","0003","0738","446","154","292","1","447","1065","0","41.97","14.46"
"65","000","00","020","0004","0000","445","266","179","3","448","904","0","49.56","29.42"
"65","000","00","020","0004","0739","445","266","179","3","448","904","0","49.56","29.42"
"65","000","00","020","0005","0000","1651","660","991","14","1665","3568","0","46.66","18.50"
"65","000","00","020","0005","0742","935","414","521","10","945","1978","0","47.78","20.93"
"65","000","00","020","0005","0743","716","246","470","4","720","1590","0","45.28","15.47"
"65","000","00","020","0006","0000","175","58","117","3","178","351","0","50.71","16.52"
"65","000","00","020","0006","0744","175","58","117","3","178","351","0","50.71","16.52"
"65","000","00","020","0007","0000","2614","1253","1361","15","2629","5671","0","46.36","22.09"
"65","000","00","020","0007","0745","476","217","259","3","479","1008","0","47.52","21.53"
"65","000","00","020","0007","0746","494","203","291","4","498","1139","0","43.72","17.82"
"65","000","00","020","0007","0747","807","390","417","4","811","1729","0","46.91","22.56"
"65","000","00","020","0007","0748","837","443","394","4","841","1795","0","46.85","24.68"
"65","000","00","020","0008","0000","2168","988","1180","16","2184","4889","0","44.67","20.21"
"65","000","00","020","0008","0749","612","276","336","4","616","1341","0","45.94","20.58"
"65","000","00","020","0008","0750","576","266","310","6","582","1263","0","46.08","21.06"
"65","000","00","020","0008","0751","499","213","286","2","501","1131","0","44.30","18.83"
"65","000","00","020","0008","0752","481","233","248","4","485","1154","0","42.03","20.19"
"65","000","00","020","0009","0000","1323","551","772","7","1330","3007","0","44.23","18.32"
"65","000","00","020","0009","0755","682","266","416","3","685","1549","0","44.22","17.17"
"65","000","00","020","0009","0756","641","285","356","4","645","1458","0","44.24","19.55"
"65","000","00","020","0010","0000","2493","1203","1290","27","2520","8822","0","28.56","13.64"
"65","000","00","020","0010","0757","679","285","394","7","686","4754","0","14.43","5.99"
"65","000","00","020","0010","0758","522","253","269","8","530","1199","0","44.20","21.10"
"65","000","00","020","0010","0759","685","330","355","7","692","1456","0","47.53","22.66"
"65","000","00","020","0010","0760","607","335","272","5","612","1413","0","43.31","23.71"
"65","000","00","020","0011","0000","831","351","480","4","835","1860","0","44.89","18.87"
"65","000","00","020","0011","0761","462","205","257","3","465","1008","0","46.13","20.34"
"65","000","00","020","0011","0762","369","146","223","1","370","852","0","43.43","17.14"
"65","000","00","020","0012","0000","1505","673","832","9","1514","3239","0","46.74","20.78"
"65","000","00","020","0012","0763","678","311","367","4","682","1486","0","45.90","20.93"
"65","000","00","020","0012","0764","827","362","465","5","832","1753","0","47.46","20.65"
"65","000","00","020","0013","0000","1892","852","1040","17","1909","3937","0","48.49","21.64"
"65","000","00","020","0013","0765","579","254","325","6","585","1296","0","45.14","19.60"
"65","000","00","020","0013","0766","642","285","357","5","647","1403","0","46.12","20.31"
"65","000","00","020","0013","0767","671","313","358","6","677","1238","0","54.68","25.28"
"65","000","00","020","0014","0000","2726","1211","1515","19","2745","5711","0","48.07","21.20"
"65","000","00","020","0014","0768","921","417","504","6","927","1945","0","47.66","21.44"
"65","000","00","020","0014","0769","457","205","252","3","460","983","0","46.80","20.85"
"65","000","00","020","0014","0770","641","274","367","3","644","1409","0","45.71","19.45"
"65","000","00","020","0014","0771","707","315","392","7","714","1374","0","51.97","22.93"
"65","000","00","020","0015","0000","1542","642","900","11","1553","3667","0","42.35","17.51"
"65","000","00","020","0015","0772","534","228","306","2","536","1203","0","44.56","18.95"
"65","000","00","020","0015","0773","511","224","287","5","516","1239","0","41.65","18.08"
"65","000","00","020","0015","0774","497","190","307","4","501","1225","0","40.90","15.51"
"65","000","00","020","0016","0000","1463","608","855","17","1480","3107","0","47.63","19.57"
"65","000","00","020","0016","0775","673","286","387","8","681","1475","0","46.17","19.39"
"65","000","00","020","0016","0776","790","322","468","9","799","1632","0","48.96","19.73"
"65","000","00","020","0017","0000","2425","909","1516","26","2451","5458","0","44.91","16.65"
"65","000","00","020","0017","0777","593","216","377","8","601","1304","0","46.09","16.56"
"65","000","00","020","0017","0778","625","273","352","4","629","1262","0","49.84","21.63"
"65","000","00","020","0017","0779","615","207","408","6","621","1438","0","43.18","14.39"
"65","000","00","020","0017","0780","592","213","379","8","600","1454","0","41.27","14.65"
"65","000","00","020","0018","0000","2418","1035","1383","23","2441","5517","0","44.25","18.76"
"65","000","00","020","0018","0781","803","342","461","12","815","1689","0","48.25","20.25"
"65","000","00","020","0018","0782","884","405","479","6","890","2006","0","44.37","20.19"
"65","000","00","020","0018","0783","731","288","443","5","736","1822","0","40.40","15.81"
"65","000","00","020","0019","0000","1185","480","705","12","1197","2877","0","41.61","16.68"
"65","000","00","020","0019","0784","574","236","338","5","579","1432","0","40.43","16.48"
"65","000","00","020","0019","0785","611","244","367","7","618","1445","0","42.77","16.89"
"65","000","00","020","0020","0000","2794","1322","1472","20","2814","6525","0","43.13","20.26"
"65","000","00","020","0020","0786","607","310","297","5","612","1439","0","42.53","21.54"
"65","000","00","020","0020","0787","706","369","337","1","707","1694","0","41.74","21.78"
"65","000","00","020","0020","0788","723","314","409","9","732","1743","0","42.00","18.01"
"65","000","00","020","0020","0789","758","329","429","5","763","1649","0","46.27","19.95"
"65","000","00","020","0021","0000","1090","575","515","4","1094","2380","0","45.97","24.16"
"65","000","00","020","0021","0790","558","298","260","1","559","1186","0","47.13","25.13"
"65","000","00","020","0021","0791","532","277","255","3","535","1194","0","44.81","23.20"
"65","000","00","020","0022","0000","488","219","269","6","494","1288","0","38.35","17.00"
"65","000","00","020","0022","0792","488","219","269","6","494","1288","0","38.35","17.00"
"65","000","00","020","0023","0000","694","327","367","4","698","1582","0","44.12","20.67"
"65","000","00","020","0023","0793","694","327","367","4","698","1582","0","44.12","20.67"
"65","000","00","020","0024","0000","899","393","506","6","905","1982","0","45.66","19.83"
"65","000","00","020","0024","0794","506","215","291","3","509","1072","0","47.48","20.06"
"65","000","00","020","0024","0795","393","178","215","3","396","910","0","43.52","19.56"
"65","000","00","020","0025","0000","733","353","380","9","742","1664","0","44.59","21.21"
"65","000","00","020","0025","0796","733","353","380","9","742","1664","0","44.59","21.21"
"65","000","00","020","0026","0000","595","270","325","6","601","1261","0","47.66","21.41"
"65","000","00","020","0026","0797","595","270","325","6","601","1261","0","47.66","21.41"
"65","000","00","020","0027","0000","536","253","283","5","541","1289","0","41.97","19.63"
"65","000","00","020","0027","0798","536","253","283","5","541","1289","0","41.97","19.63"
"65","000","00","020","0028","0000","769","346","423","1","770","1819","0","42.33","19.02"
"65","000","00","020","0028","0799","769","346","423","1","770","1819","0","42.33","19.02"
"65","000","00","020","0029","0000","504","243","261","3","507","1130","0","44.87","21.50"
"65","000","00","020","0029","0800","504","243","261","3","507","1130","0","44.87","21.50"
"65","000","00","020","0030","0000","611","290","321","9","620","1363","0","45.49","21.28"
"65","000","00","020","0030","0801","611","290","321","9","620","1363","0","45.49","21.28"
"65","000","00","020","0031","0000","634","335","299","6","640","1483","0","43.16","22.59"
"65","000","00","020","0031","0802","634","335","299","6","640","1483","0","43.16","22.59"
"65","000","00","020","0032","0000","723","305","418","7","730","1785","0","40.90","17.09"
"65","000","00","020","0032","0803","347","148","199","4","351","879","0","39.93","16.84"
"65","000","00","020","0032","0804","376","157","219","3","379","906","0","41.83","17.33"
"65","000","00","020","0033","0000","710","317","393","9","719","1629","0","44.14","19.46"
"65","000","00","020","0033","0805","710","317","393","9","719","1629","0","44.14","19.46"
"65","000","00","020","0034","0000","513","227","286","3","516","1175","0","43.91","19.32"
"65","000","00","020","0034","0806","513","227","286","3","516","1175","0","43.91","19.32"
"65","000","00","020","0035","0000","537","245","292","5","542","1315","0","41.22","18.63"
"65","000","00","020","0035","0807","537","245","292","5","542","1315","0","41.22","18.63"
"65","000","00","020","0036","0000","610","277","333","6","616","1391","0","44.28","19.91"
"65","000","00","020","0036","0808","610","277","333","6","616","1391","0","44.28","19.91"
"65","000","00","020","0037","0000","558","274","284","0","558","1098","0","50.82","24.95"
"65","000","00","020","0037","0809","558","274","284","0","558","1098","0","50.82","24.95"
"65","000","00","020","0038","0000","926","452","474","4","930","2035","0","45.70","22.21"
"65","000","00","020","0038","0810","499","230","269","2","501","1070","0","46.82","21.50"
"65","000","00","020","0038","0811","427","222","205","2","429","965","0","44.46","23.01"
"65","000","00","020","0039","0000","1694","776","918","16","1710","3628","0","47.13","21.39"
"65","000","00","020","0039","0812","872","389","483","9","881","1889","0","46.64","20.59"
"65","000","00","020","0039","0813","822","387","435","7","829","1739","0","47.67","22.25"
"65","000","00","020","0040","0000","608","286","322","4","612","1275","0","48.00","22.43"
"65","000","00","020","0040","0814","608","286","322","4","612","1275","0","48.00","22.43"
"65","000","00","020","0041","0000","1084","476","608","9","1093","2448","0","44.65","19.44"
"65","000","00","020","0041","0815","609","264","345","8","617","1373","0","44.94","19.23"
"65","000","00","020","0041","0816","475","212","263","1","476","1075","0","44.28","19.72"
"65","000","00","020","0042","0000","1003","414","589","8","1011","2453","0","41.21","16.88"
"65","000","00","020","0042","0817","471","199","272","3","474","1172","0","40.44","16.98"
"65","000","00","020","0042","0818","532","215","317","5","537","1281","0","41.92","16.78"
"65","000","00","020","0043","0000","1141","576","565","8","1149","2406","0","47.76","23.94"
"65","000","00","020","0043","0819","537","266","271","7","544","1199","0","45.37","22.19"
"65","000","00","020","0043","0820","604","310","294","1","605","1207","0","50.12","25.68"
"65","000","00","020","0044","0000","1317","580","737","14","1331","3178","0","41.88","18.25"
"65","000","00","020","0044","0821","650","274","376","7","657","1629","0","40.33","16.82"
"65","000","00","020","0044","0822","667","306","361","7","674","1549","0","43.51","19.75"
"65","000","00","020","0045","0000","1650","621","1029","12","1662","3797","0","43.77","16.36"
"65","000","00","020","0045","0823","503","183","320","2","505","1145","0","44.10","15.98"
"65","000","00","020","0045","0824","606","213","393","5","611","1376","0","44.40","15.48"
"65","000","00","020","0045","0825","541","225","316","5","546","1276","0","42.79","17.63"
"65","000","00","020","0046","0000","645","233","412","7","652","1352","0","48.22","17.23"
"65","000","00","020","0046","0826","645","233","412","7","652","1352","0","48.22","17.23"
"65","000","00","020","0047","0000","464","197","267","3","467","1030","0","45.34","19.13"
"65","000","00","020","0047","0827","464","197","267","3","467","1030","0","45.34","19.13"
"65","000","00","020","0048","0000","773","324","449","9","782","1597","0","48.97","20.29"
"65","000","00","020","0048","0828","773","324","449","9","782","1597","0","48.97","20.29"
"65","000","00","020","0049","0000","802","371","431","5","807","1771","0","45.57","20.95"
"65","000","00","020","0049","0829","802","371","431","5","807","1771","0","45.57","20.95"
"65","000","00","020","0050","0000","698","272","426","5","703","1652","0","42.55","16.46"
"65","000","00","020","0050","0830","698","272","426","5","703","1652","0","42.55","16.46"
"65","000","00","020","0051","0000","957","416","541","3","960","2007","0","47.83","20.73"
"65","000","00","020","0051","0831","500","209","291","0","500","1046","0","47.80","19.98"
"65","000","00","020","0051","0832","457","207","250","3","460","961","0","47.87","21.54"
"65","000","00","020","0052","0000","686","268","418","5","691","1674","0","41.28","16.01"
"65","000","00","020","0052","0833","686","268","418","5","691","1674","0","41.28","16.01"
"65","000","00","020","0053","0000","397","204","193","2","399","855","0","46.67","23.86"
"65","000","00","020","0053","0834","397","204","193","2","399","855","0","46.67","23.86"
"65","000","00","020","0054","0000","629","292","337","13","642","1344","0","47.77","21.73"
"65","000","00","020","0054","0835","629","292","337","13","642","1344","0","47.77","21.73"
"65","000","00","020","0055","0000","680","285","395","4","684","1672","0","40.91","17.05"
"65","000","00","020","0055","0836","439","187","252","2","441","1007","0","43.79","18.57"
"65","000","00","020","0055","0837","241","98","143","2","243","665","0","36.54","14.74"
"65","000","00","020","0056","0000","822","349","473","5","827","1939","0","42.65","18.00"
"65","000","00","020","0056","0838","336","139","197","3","339","927","0","36.57","14.99"
"65","000","00","020","0056","0839","486","210","276","2","488","1012","0","48.22","20.75"
"65","000","00","020","0057","0000","885","383","502","7","892","2070","0","43.09","18.50"
"65","000","00","020","0057","0840","475","213","262","3","478","1035","0","46.18","20.58"
"65","000","00","020","0057","0841","410","170","240","4","414","1035","0","40.00","16.43"
"65","000","00","020","0058","0000","348","140","208","5","353","813","0","43.42","17.22"
"65","000","00","020","0058","0842","348","140","208","5","353","813","0","43.42","17.22"
"65","000","00","020","0059","0000","653","295","358","17","670","1385","0","48.38","21.30"
"65","000","00","020","0059","0843","653","295","358","17","670","1385","0","48.38","21.30"
"65","000","00","020","0060","0000","354","171","183","4","358","770","0","46.49","22.21"
"65","000","00","020","0060","0844","354","171","183","4","358","770","0","46.49","22.21"
"65","000","00","020","0061","0000","944","438","506","9","953","2229","0","42.75","19.65"
"65","000","00","020","0061","0845","453","186","267","3","456","1090","0","41.83","17.06"
"65","000","00","020","0061","0846","491","252","239","6","497","1139","0","43.63","22.12"
"65","000","00","020","0062","0000","818","341","477","10","828","1876","0","44.14","18.18"
"65","000","00","020","0062","0847","384","152","232","6","390","897","0","43.48","16.95"
"65","000","00","020","0062","0848","434","189","245","4","438","979","0","44.74","19.31"
"65","000","00","020","0063","0000","846","360","486","10","856","2003","0","42.74","17.97"
"65","000","00","020","0063","0849","499","200","299","5","504","1101","0","45.78","18.17"
"65","000","00","020","0063","0850","347","160","187","5","352","902","0","39.02","17.74"
"65","000","00","020","0064","0000","588","250","338","9","597","1436","0","41.57","17.41"
"65","000","00","020","0064","0851","588","250","338","9","597","1436","0","41.57","17.41"
"65","000","00","020","0065","0000","464","216","248","9","473","1039","0","45.52","20.79"
"65","000","00","020","0065","0852","464","216","248","9","473","1039","0","45.52","20.79"
"65","000","00","020","0066","0000","818","395","423","11","829","1775","0","46.70","22.25"
"65","000","00","020","0066","0853","349","148","201","8","357","850","0","42.00","17.41"
"65","000","00","020","0066","0854","469","247","222","3","472","925","0","51.03","26.70"
"65","000","00","020","0067","0000","802","324","478","11","813","2123","0","38.29","15.26"
"65","000","00","020","0067","0855","393","154","239","7","400","1062","0","37.66","14.50"
"65","000","00","020","0067","0856","409","170","239","4","413","1061","0","38.93","16.02"
"65","000","00","020","0068","0000","1270","549","721","7","1277","2926","0","43.64","18.76"
"65","000","00","020","0068","0857","602","256","346","2","604","1390","0","43.45","18.42"
"65","000","00","020","0068","0858","668","293","375","5","673","1536","0","43.82","19.08"
"65","000","00","020","0069","0000","684","375","309","3","687","1678","0","40.94","22.35"
"65","000","00","020","0069","0859","684","375","309","3","687","1678","0","40.94","22.35"
"65","000","00","020","0070","0000","470","201","269","4","474","1136","0","41.73","17.69"
"65","000","00","020","0070","0860","470","201","269","4","474","1136","0","41.73","17.69"
"65","000","00","020","0071","0000","723","291","432","6","729","1549","0","47.06","18.79"
"65","000","00","020","0071","0861","723","291","432","6","729","1549","0","47.06","18.79"
"65","000","00","020","0072","0000","1003","437","566","8","1011","2410","0","41.95","18.13"
"65","000","00","020","0072","0862","459","215","244","0","459","1160","0","39.57","18.53"
"65","000","00","020","0072","0863","544","222","322","8","552","1250","0","44.16","17.76"
"65","000","00","020","0073","0000","1176","463","713","19","1195","2698","0","44.29","17.16"
"65","000","00","020","0073","0864","568","224","344","13","581","1325","0","43.85","16.91"
"65","000","00","020","0073","0865","608","239","369","6","614","1373","0","44.72","17.41"
"65","000","00","020","0074","0000","717","332","385","9","726","1802","0","40.29","18.42"
"65","000","00","020","0074","0866","717","332","385","9","726","1802","0","40.29","18.42"
"65","000","00","020","0075","0000","813","317","496","5","818","1889","0","43.30","16.78"
"65","000","00","020","0075","0867","417","167","250","3","420","923","0","45.50","18.09"
"65","000","00","020","0075","0868","396","150","246","2","398","966","0","41.20","15.53"
"65","000","00","020","0076","0000","1785","733","1052","10","1795","4172","0","43.02","17.57"
"65","000","00","020","0076","0869","614","255","359","7","621","1498","0","41.46","17.02"
"65","000","00","020","0076","0870","604","239","365","3","607","1418","0","42.81","16.85"
"65","000","00","020","0076","0871","567","239","328","0","567","1256","0","45.14","19.03"
"65","000","00","020","0077","0000","1460","614","846","11","1471","3336","0","44.09","18.41"
"65","000","00","020","0077","0872","696","289","407","3","699","1597","0","43.77","18.10"
"65","000","00","020","0077","0873","764","325","439","8","772","1739","0","44.39","18.69"
"65","000","00","020","0078","0000","2036","795","1241","19","2055","4936","0","41.63","16.11"
"65","000","00","020","0078","0874","460","150","310","4","464","1238","0","37.48","12.12"
"65","000","00","020","0078","0875","530","219","311","5","535","1141","0","46.89","19.19"
"65","000","00","020","0078","0876","525","226","299","6","531","1230","0","43.17","18.37"
"65","000","00","020","0078","0877","521","200","321","4","525","1327","0","39.56","15.07"
"65","000","00","020","0079","0000","890","374","516","12","902","2027","0","44.50","18.45"
"65","000","00","020","0079","0878","481","210","271","6","487","1086","0","44.84","19.34"
"65","000","00","020","0079","0879","409","164","245","6","415","941","0","44.10","17.43"
"65","000","00","020","0080","0000","716","293","423","6","722","1631","0","44.27","17.96"
"65","000","00","020","0080","0880","716","293","423","6","722","1631","0","44.27","17.96"
"65","000","00","020","0081","0000","933","393","540","14","947","2145","0","44.15","18.32"
"65","000","00","020","0081","0881","427","177","250","6","433","1031","0","42.00","17.17"
"65","000","00","020","0081","0882","506","216","290","8","514","1114","0","46.14","19.39"
"65","000","00","020","0082","0000","1545","601","944","9","1554","3509","0","44.29","17.13"
"65","000","00","020","0082","0883","557","215","342","4","561","1208","0","46.44","17.80"
"65","000","00","020","0082","0884","457","190","267","2","459","1013","0","45.31","18.76"
"65","000","00","020","0082","0885","531","196","335","3","534","1288","0","41.46","15.22"
"65","000","00","020","0083","0000","1468","668","800","8","1476","3088","0","47.80","21.63"
"65","000","00","020","0083","0886","707","318","389","4","711","1550","0","45.87","20.52"
"65","000","00","020","0083","0887","761","350","411","4","765","1538","0","49.74","22.76"
"65","000","00","020","0084","0000","1173","487","686","12","1185","2545","0","46.56","19.14"
"65","000","00","020","0084","0888","661","254","407","9","670","1327","0","50.49","19.14"
"65","000","00","020","0084","0889","512","233","279","3","515","1218","0","42.28","19.13"
"65","000","00","020","0085","0000","1121","465","656","8","1129","2674","0","42.22","17.39"
"65","000","00","020","0085","0890","670","272","398","6","676","1583","0","42.70","17.18"
"65","000","00","020","0085","0891","451","193","258","2","453","1091","0","41.52","17.69"
"65","000","00","020","0086","0000","1502","617","885","5","1507","3267","0","46.13","18.89"
"65","000","00","020","0086","0892","744","305","439","3","747","1597","0","46.78","19.10"
"65","000","00","020","0086","0893","758","312","446","2","760","1670","0","45.51","18.68"
"65","000","00","020","0087","0000","1810","704","1106","16","1826","4360","0","41.88","16.15"
"65","000","00","020","0087","0896","614","266","348","7","621","1511","0","41.10","17.60"
"65","000","00","020","0087","0897","536","175","361","4","540","1298","0","41.60","13.48"
"65","000","00","020","0087","0898","660","263","397","5","665","1551","0","42.88","16.96"
"65","000","00","020","0088","0000","1235","478","757","16","1251","2861","0","43.73","16.71"
"65","000","00","020","0088","0904","578","231","347","9","587","1397","0","42.02","16.54"
"65","000","00","020","0088","0905","657","247","410","7","664","1464","0","45.36","16.87"
"65","000","00","020","0089","0000","2049","826","1223","16","2065","4596","0","44.93","17.97"
"65","000","00","020","0089","0913","624","232","392","3","627","1373","0","45.67","16.90"
"65","000","00","020","0089","0914","706","286","420","6","712","1633","0","43.60","17.51"
"65","000","00","020","0089","0915","719","308","411","7","726","1590","0","45.66","19.37"
"65","000","00","020","0090","0000","1903","676","1227","6","1909","4710","0","40.53","14.35"
"65","000","00","020","0090","0916","633","220","413","0","633","1574","0","40.22","13.98"
"65","000","00","020","0090","0917","631","224","407","4","635","1628","0","39.00","13.76"
"65","000","00","020","0090","0918","639","232","407","2","641","1508","0","42.51","15.38"
"65","000","00","020","0091","0000","1513","611","902","13","1526","3553","0","42.95","17.20"
"65","000","00","020","0091","0908","777","334","443","9","786","1917","0","41.00","17.42"
"65","000","00","020","0091","0909","736","277","459","4","740","1636","0","45.23","16.93"
"65","000","00","020","0092","0000","976","353","623","8","984","2263","0","43.48","15.60"
"65","000","00","020","0092","0899","523","217","306","2","525","1157","0","45.38","18.76"
"65","000","00","020","0092","0900","453","136","317","6","459","1106","0","41.50","12.30"
"65","000","00","020","0093","0000","3386","1404","1982","33","3419","7625","0","44.84","18.41"
"65","000","00","020","0093","0922","552","220","332","7","559","1166","0","47.94","18.87"
"65","000","00","020","0093","0923","716","269","447","11","727","1543","0","47.12","17.43"
"65","000","00","020","0093","0924","684","304","380","4","688","1585","0","43.41","19.18"
"65","000","00","020","0093","0925","675","283","392","5","680","1598","0","42.55","17.71"
"65","000","00","020","0093","0926","759","328","431","6","765","1733","0","44.14","18.93"
"65","000","00","020","0094","0000","1620","652","968","14","1634","3940","0","41.47","16.55"
"65","000","00","020","0094","0927","529","195","334","7","536","1289","0","41.58","15.13"
"65","000","00","020","0094","0928","554","223","331","4","558","1371","0","40.70","16.27"
"65","000","00","020","0094","0929","537","234","303","3","540","1280","0","42.19","18.28"
"65","000","00","020","0095","0000","1604","669","935","21","1625","3874","0","41.95","17.27"
"65","000","00","020","0095","0930","531","225","306","5","536","1267","0","42.30","17.76"
"65","000","00","020","0095","0931","560","231","329","8","568","1281","0","44.34","18.03"
"65","000","00","020","0095","0932","513","213","300","8","521","1326","0","39.29","16.06"
"65","000","00","020","0096","0000","1350","569","781","11","1361","3407","0","39.95","16.70"
"65","000","00","020","0096","0933","430","171","259","4","434","1035","0","41.93","16.52"
"65","000","00","020","0096","0934","347","136","211","2","349","986","0","35.40","13.79"
"65","000","00","020","0096","0935","573","262","311","5","578","1386","0","41.70","18.90"
"65","000","00","020","0097","0000","1018","450","568","10","1028","2802","0","36.69","16.06"
"65","000","00","020","0097","0936","523","229","294","9","532","1500","0","35.47","15.27"
"65","000","00","020","0097","0937","495","221","274","1","496","1302","0","38.10","16.97"
"65","000","00","020","0098","0000","860","296","564","9","869","1998","0","43.49","14.81"
"65","000","00","020","0098","0938","358","117","241","3","361","821","0","43.97","14.25"
"65","000","00","020","0098","0939","502","179","323","6","508","1177","0","43.16","15.21"
"65","000","00","020","0099","0000","933","367","566","10","943","2046","0","46.09","17.94"
"65","000","00","020","0099","0940","504","177","327","6","510","1032","0","49.42","17.15"
"65","000","00","020","0099","0941","429","190","239","4","433","1014","0","42.70","18.74"
"65","000","00","020","0100","0000","909","324","585","7","916","2029","0","45.15","15.97"
"65","000","00","020","0100","0942","409","135","274","2","411","933","0","44.05","14.47"
"65","000","00","020","0100","0943","500","189","311","5","505","1096","0","46.08","17.24"
"65","000","00","020","0101","0000","1387","534","853","15","1402","3070","0","45.67","17.39"
"65","000","00","020","0101","0944","629","247","382","6","635","1451","0","43.76","17.02"
"65","000","00","020","0101","0945","758","287","471","9","767","1619","0","47.37","17.73"
"65","000","00","020","0102","0000","929","377","552","8","937","2229","0","42.04","16.91"
"65","000","00","020","0102","0946","433","159","274","5","438","1050","0","41.71","15.14"
"65","000","00","020","0102","0947","496","218","278","3","499","1179","0","42.32","18.49"
"65","000","00","020","0103","0000","1828","733","1095","17","1845","4356","0","42.36","16.83"
"65","000","00","020","0103","0948","532","210","322","2","534","1287","0","41.49","16.32"
"65","000","00","020","0103","0949","633","240","393","8","641","1507","0","42.53","15.93"
"65","000","00","020","0103","0950","663","283","380","7","670","1562","0","42.89","18.12"
"65","000","00","020","0104","0000","1928","746","1182","15","1943","4540","0","42.80","16.43"
"65","000","00","020","0104","0958","558","219","339","4","562","1334","0","42.13","16.42"
"65","000","00","020","0104","0959","649","232","417","7","656","1653","0","39.69","14.04"
"65","000","00","020","0104","0960","721","295","426","4","725","1553","0","46.68","19.00"
"65","000","00","020","0105","0000","2469","1178","1291","14","2483","5713","0","43.46","20.62"
"65","000","00","020","0105","0953","723","295","428","7","730","1790","0","40.78","16.48"
"65","000","00","020","0105","0954","880","419","461","4","884","1886","0","46.87","22.22"
"65","000","00","020","0105","0955","866","464","402","3","869","2037","0","42.66","22.78"
"65","000","00","020","0106","0000","1143","495","648","12","1155","2882","0","40.08","17.18"
"65","000","00","020","0106","0951","548","245","303","5","553","1373","0","40.28","17.84"
"65","000","00","020","0106","0952","595","250","345","7","602","1509","0","39.89","16.57"
"65","000","00","020","0107","0000","685","275","410","1","686","1839","0","37.30","14.95"
"65","000","00","020","0107","0956","317","118","199","1","318","872","0","36.47","13.53"
"65","000","00","020","0107","0957","368","157","211","0","368","967","0","38.06","16.24"
"65","000","00","020","0108","0000","3119","1502","1617","23","3142","7294","0","43.08","20.59"
"65","000","00","020","0108","0961","447","202","245","5","452","1028","0","43.97","19.65"
"65","000","00","020","0108","0962","496","183","313","3","499","1240","0","40.24","14.76"
"65","000","00","020","0108","0963","561","273","288","10","571","1339","0","42.64","20.39"
"65","000","00","020","0108","0964","715","357","358","3","718","1724","0","41.65","20.71"
"65","000","00","020","0108","0965","900","487","413","2","902","1963","0","45.95","24.81"
"65","000","00","020","0109","0000","819","361","458","6","825","1740","0","47.41","20.75"
"65","000","00","020","0109","0740","415","198","217","2","417","936","0","44.55","21.15"
"65","000","00","020","0109","0741","404","163","241","4","408","804","0","50.75","20.27"
"65","000","00","020","0110","0000","1796","761","1035","11","1807","4013","0","45.03","18.96"
"65","000","00","020","0110","0733","627","231","396","1","628","1344","0","46.73","17.19"
"65","000","00","020","0110","0734","659","348","311","7","666","1389","0","47.95","25.05"
"65","000","00","020","0110","0735","510","182","328","3","513","1280","0","40.08","14.22"
"65","000","00","020","0111","0000","1561","732","829","17","1578","3686","0","42.81","19.86"
"65","000","00","020","0111","0753","787","351","436","9","796","1821","0","43.71","19.28"
"65","000","00","020","0111","0754","774","381","393","8","782","1865","0","41.93","20.43"
"65","000","00","020","0112","0000","1038","448","590","5","1043","2539","0","41.08","17.64"
"65","000","00","020","0112","0906","596","280","316","4","600","1332","0","45.05","21.02"
"65","000","00","020","0112","0907","442","168","274","1","443","1207","0","36.70","13.92"
"65","000","00","020","0113","0000","2245","834","1411","18","2263","5046","0","44.85","16.53"
"65","000","00","020","0113","0901","716","293","423","3","719","1748","0","41.13","16.76"
"65","000","00","020","0113","0902","637","232","405","5","642","1520","0","42.24","15.26"
"65","000","00","020","0113","0903","892","309","583","10","902","1778","0","50.73","17.38"
"65","000","00","020","0114","0000","1669","641","1028","8","1677","4437","0","37.80","14.45"
"65","000","00","020","0114","0919","530","207","323","5","535","1355","0","39.48","15.28"
"65","000","00","020","0114","0920","594","238","356","2","596","1620","0","36.79","14.69"
"65","000","00","020","0114","0921","545","196","349","1","546","1462","0","37.35","13.41"
"65","000","00","020","0115","0000","2065","781","1284","20","2085","5061","0","41.20","15.43"
"65","000","00","020","0115","0910","632","245","387","6","638","1589","0","40.15","15.42"
"65","000","00","020","0115","0911","727","287","440","6","733","1744","0","42.03","16.46"
"65","000","00","020","0115","0912","706","249","457","8","714","1728","0","41.32","14.41"
"65","000","00","020","0116","0000","1345","556","789","14","1359","2994","0","45.39","18.57"
"65","000","00","020","0116","0894","618","258","360","4","622","1325","0","46.94","19.47"
"65","000","00","020","0116","0895","727","298","429","10","737","1669","0","44.16","17.86"
"65","000","00","020","0117","0000","1358","524","834","8","1366","3293","0","41.48","15.91"
"65","000","00","020","0117","0966","658","233","425","6","664","1597","0","41.58","14.59"
"65","000","00","020","0117","0967","700","291","409","2","702","1696","0","41.39","17.16"
"65","000","00","020","0118","0000","1681","727","954","21","1702","3764","0","45.22","19.31"
"65","000","00","020","0118","0968","490","180","310","8","498","1063","0","46.85","16.93"
"65","000","00","020","0118","0969","614","259","355","10","624","1337","0","46.67","19.37"
"65","000","00","020","0118","0970","577","288","289","3","580","1364","0","42.52","21.11"
"65","000","00","020","0119","0000","1344","538","806","12","1356","3524","0","38.48","15.27"
"65","000","00","020","0119","0971","328","119","209","1","329","862","0","38.17","13.81"
"65","000","00","020","0119","0972","577","244","333","7","584","1521","0","38.40","16.04"
"65","000","00","020","0119","0973","439","175","264","4","443","1141","0","38.83","15.34"
"65","000","00","030","0000","0000","161914","93039","68875","1457","163371","355238","408654","45.99","26.19"
"65","000","00","030","0001","0000","2695","1426","1269","18","2713","6550","0","41.42","21.77"
"65","000","00","030","0001","1324","741","340","401","6","747","1906","0","39.19","17.84"
"65","000","00","030","0001","1325","681","397","284","5","686","1627","0","42.16","24.40"
"65","000","00","030","0001","1326","508","254","254","0","508","1165","0","43.61","21.80"
"65","000","00","030","0001","1327","765","435","330","7","772","1852","0","41.68","23.49"
"65","000","00","030","0002","0000","3639","2026","1613","27","3666","7974","0","45.97","25.41"
"65","000","00","030","0002","1376","659","284","375","5","664","1660","0","40.00","17.11"
"65","000","00","030","0002","1377","800","406","394","11","811","1796","0","45.16","22.61"
"65","000","00","030","0002","1378","563","329","234","1","564","1304","0","43.25","25.23"
"65","000","00","030","0002","1379","899","569","330","5","904","1889","0","47.86","30.12"
"65","000","00","030","0002","1380","718","438","280","5","723","1325","0","54.57","33.06"
"65","000","00","030","0003","0000","1705","852","853","18","1723","3796","0","45.39","22.44"
"65","000","00","030","0003","1381","558","260","298","8","566","1146","0","49.39","22.69"
"65","000","00","030","0003","1382","526","280","246","3","529","1242","0","42.59","22.54"
"65","000","00","030","0003","1383","621","312","309","7","628","1408","0","44.60","22.16"
"65","000","00","030","0004","0000","1415","745","670","3","1418","3469","0","40.88","21.48"
"65","000","00","030","0004","1384","461","258","203","0","461","1181","0","39.03","21.85"
"65","000","00","030","0004","1385","403","204","199","1","404","1003","0","40.28","20.34"
"65","000","00","030","0004","1386","551","283","268","2","553","1285","0","43.04","22.02"
"65","000","00","030","0005","0000","1354","687","667","13","1367","3452","0","39.60","19.90"
"65","000","00","030","0005","1387","690","351","339","7","697","1732","0","40.24","20.27"
"65","000","00","030","0005","1388","664","336","328","6","670","1720","0","38.95","19.53"
"65","000","00","030","0006","0000","1556","992","564","12","1568","3096","0","50.65","32.04"
"65","000","00","030","0006","1389","456","349","107","5","461","816","0","56.50","42.77"
"65","000","00","030","0006","1390","488","316","172","5","493","959","0","51.41","32.95"
"65","000","00","030","0006","1391","612","327","285","2","614","1321","0","46.48","24.75"
"65","000","00","030","0007","0000","1029","692","337","5","1034","2171","0","47.63","31.87"
"65","000","00","030","0007","1328","479","286","193","5","484","994","0","48.69","28.77"
"65","000","00","030","0007","1329","550","406","144","0","550","1177","0","46.73","34.49"
"65","000","00","030","0008","0000","2722","1632","1090","17","2739","5682","0","48.20","28.72"
"65","000","00","030","0008","1330","798","466","332","6","804","1659","0","48.46","28.09"
"65","000","00","030","0008","1331","581","419","162","5","586","1087","0","53.91","38.55"
"65","000","00","030","0008","1332","755","390","365","2","757","1672","0","45.28","23.33"
"65","000","00","030","0008","1333","588","357","231","4","592","1264","0","46.84","28.24"
"65","000","00","030","0009","0000","2528","1371","1157","16","2544","5265","0","48.32","26.04"
"65","000","00","030","0009","1334","930","539","391","7","937","1894","0","49.47","28.46"
"65","000","00","030","0009","1335","761","391","370","3","764","1629","0","46.90","24.00"
"65","000","00","030","0009","1336","837","441","396","6","843","1742","0","48.39","25.32"
"65","000","00","030","0010","0000","1509","810","699","14","1523","3312","0","45.98","24.46"
"65","000","00","030","0010","1342","821","425","396","6","827","1733","0","47.72","24.52"
"65","000","00","030","0010","1343","688","385","303","8","696","1579","0","44.08","24.38"
"65","000","00","030","0011","0000","1574","890","684","8","1582","3410","0","46.39","26.10"
"65","000","00","030","0011","1344","909","518","391","6","915","1936","0","47.26","26.76"
"65","000","00","030","0011","1345","665","372","293","2","667","1474","0","45.25","25.24"
"65","000","00","030","0012","0000","1806","962","844","11","1817","3887","0","46.75","24.75"
"65","000","00","030","0012","1346","577","287","290","5","582","1234","0","47.16","23.26"
"65","000","00","030","0012","1347","562","316","246","2","564","1224","0","46.08","25.82"
"65","000","00","030","0012","1348","667","359","308","4","671","1429","0","46.96","25.12"
"65","000","00","030","0013","0000","1685","853","832","16","1701","3709","0","45.86","23.00"
"65","000","00","030","0013","1349","843","467","376","8","851","1918","0","44.37","24.35"
"65","000","00","030","0013","1350","842","386","456","8","850","1791","0","47.46","21.55"
"65","000","00","030","0014","0000","1790","952","838","14","1804","3832","0","47.08","24.84"
"65","000","00","030","0014","1351","534","303","231","5","539","1144","0","47.12","26.49"
"65","000","00","030","0014","1352","631","331","300","3","634","1371","0","46.24","24.14"
"65","000","00","030","0014","1353","625","318","307","6","631","1317","0","47.91","24.15"
"65","000","00","030","0015","0000","1878","1040","838","12","1890","3903","0","48.42","26.65"
"65","000","00","030","0015","1354","720","464","256","3","723","1368","0","52.85","33.92"
"65","000","00","030","0015","1355","590","309","281","1","591","1286","0","45.96","24.03"
"65","000","00","030","0015","1356","568","267","301","8","576","1249","0","46.12","21.38"
"65","000","00","030","0016","0000","2132","1100","1032","16","2148","4460","0","48.16","24.66"
"65","000","00","030","0016","1357","642","331","311","3","645","1356","0","47.57","24.41"
"65","000","00","030","0016","1358","590","333","257","2","592","1266","0","46.76","26.30"
"65","000","00","030","0016","1359","900","436","464","11","911","1838","0","49.56","23.72"
"65","000","00","030","0017","0000","2074","1102","972","16","2090","4916","0","42.51","22.42"
"65","000","00","030","0017","1360","693","337","356","6","699","1767","0","39.56","19.07"
"65","000","00","030","0017","1361","712","421","291","5","717","1655","0","43.32","25.44"
"65","000","00","030","0017","1362","669","344","325","5","674","1494","0","45.11","23.03"
"65","000","00","030","0018","0000","1488","815","673","15","1503","3253","0","46.20","25.05"
"65","000","00","030","0018","1363","436","244","192","3","439","974","0","45.07","25.05"
"65","000","00","030","0018","1364","520","262","258","10","530","1123","0","47.20","23.33"
"65","000","00","030","0018","1365","532","309","223","2","534","1156","0","46.19","26.73"
"65","000","00","030","0019","0000","2092","1166","926","29","2121","4420","0","47.99","26.38"
"65","000","00","030","0019","1366","789","469","320","13","802","1761","0","45.54","26.63"
"65","000","00","030","0019","1367","814","420","394","12","826","1554","0","53.15","27.03"
"65","000","00","030","0019","1368","489","277","212","4","493","1105","0","44.62","25.07"
"65","000","00","030","0020","0000","1678","1086","592","19","1697","3265","0","51.98","33.26"
"65","000","00","030","0020","1534","706","437","269","5","711","1463","0","48.60","29.87"
"65","000","00","030","0020","1535","458","290","168","5","463","839","0","55.18","34.56"
"65","000","00","030","0020","1536","514","359","155","9","523","963","0","54.31","37.28"
"65","000","00","030","0021","0000","1407","810","597","10","1417","2767","0","51.21","29.27"
"65","000","00","030","0021","1537","656","351","305","6","662","1337","0","49.51","26.25"
"65","000","00","030","0021","1538","751","459","292","4","755","1430","0","52.80","32.10"
"65","000","00","030","0022","0000","2697","1747","950","30","2727","5289","0","51.56","33.03"
"65","000","00","030","0022","1542","938","611","327","18","956","1844","0","51.84","33.13"
"65","000","00","030","0022","1543","880","560","320","7","887","1796","0","49.39","31.18"
"65","000","00","030","0022","1544","879","576","303","5","884","1649","0","53.61","34.93"
"65","000","00","030","0023","0000","2084","1363","721","13","2097","3903","0","53.73","34.92"
"65","000","00","030","0023","1545","707","460","247","5","712","1335","0","53.33","34.46"
"65","000","00","030","0023","1546","624","425","199","7","631","1230","0","51.30","34.55"
"65","000","00","030","0023","1547","753","478","275","1","754","1338","0","56.35","35.72"
"65","000","00","030","0024","0000","1451","803","648","18","1469","3171","0","46.33","25.32"
"65","000","00","030","0024","1548","568","322","246","11","579","1159","0","49.96","27.78"
"65","000","00","030","0024","1549","332","202","130","1","333","811","0","41.06","24.91"
"65","000","00","030","0024","1550","551","279","272","6","557","1201","0","46.38","23.23"
"65","000","00","030","0025","0000","3304","1992","1312","27","3331","7115","0","46.82","28.00"
"65","000","00","030","0025","1369","831","495","336","4","835","1768","0","47.23","28.00"
"65","000","00","030","0025","1370","897","510","387","10","907","1899","0","47.76","26.86"
"65","000","00","030","0025","1371","735","457","278","6","741","1633","0","45.38","27.99"
"65","000","00","030","0025","1372","841","530","311","7","848","1815","0","46.72","29.20"
"65","000","00","030","0026","0000","2151","1293","858","21","2172","4499","0","48.28","28.74"
"65","000","00","030","0026","1373","697","411","286","7","704","1494","0","47.12","27.51"
"65","000","00","030","0026","1374","535","302","233","8","543","1184","0","45.86","25.51"
"65","000","00","030","0026","1375","919","580","339","6","925","1821","0","50.80","31.85"
"65","000","00","030","0027","0000","1862","1136","726","10","1872","4018","0","46.59","28.27"
"65","000","00","030","0027","1551","609","368","241","3","612","1308","0","46.79","28.13"
"65","000","00","030","0027","1552","586","346","240","3","589","1346","0","43.76","25.71"
"65","000","00","030","0027","1553","667","422","245","4","671","1364","0","49.19","30.94"
"65","000","00","030","0028","0000","1438","840","598","13","1451","3062","0","47.39","27.43"
"65","000","00","030","0028","1554","701","393","308","6","707","1456","0","48.56","26.99"
"65","000","00","030","0028","1555","737","447","290","7","744","1606","0","46.33","27.83"
"65","000","00","030","0029","0000","2065","1228","837","17","2082","4298","0","48.44","28.57"
"65","000","00","030","0029","1558","683","399","284","9","692","1501","0","46.10","26.58"
"65","000","00","030","0029","1559","611","360","251","0","611","1280","0","47.73","28.13"
"65","000","00","030","0029","1560","771","469","302","8","779","1517","0","51.35","30.92"
"65","000","00","030","0030","0000","2775","1781","994","22","2797","5620","0","49.77","31.69"
"65","000","00","030","0030","1561","848","560","288","8","856","1667","0","51.35","33.59"
"65","000","00","030","0030","1562","873","562","311","2","875","1914","0","45.72","29.36"
"65","000","00","030","0030","1563","422","252","170","6","428","887","0","48.25","28.41"
"65","000","00","030","0030","1564","632","407","225","6","638","1152","0","55.38","35.33"
"65","000","00","030","0031","0000","2120","1457","663","23","2143","4436","0","48.31","32.84"
"65","000","00","030","0031","1565","746","534","212","6","752","1473","0","51.05","36.25"
"65","000","00","030","0031","1566","695","496","199","5","700","1543","0","45.37","32.15"
"65","000","00","030","0031","1567","679","427","252","12","691","1420","0","48.66","30.07"
"65","000","00","030","0032","0000","2032","1284","748","20","2052","4318","0","47.52","29.74"
"65","000","00","030","0032","1568","535","353","182","9","544","1116","0","48.75","31.63"
"65","000","00","030","0032","1569","788","479","309","5","793","1668","0","47.54","28.72"
"65","000","00","030","0032","1570","709","452","257","6","715","1534","0","46.61","29.47"
"65","000","00","030","0033","0000","1305","814","491","11","1316","2931","0","44.90","27.77"
"65","000","00","030","0033","1576","642","399","243","8","650","1467","0","44.31","27.20"
"65","000","00","030","0033","1577","663","415","248","3","666","1464","0","45.49","28.35"
"65","000","00","030","0034","0000","1250","833","417","13","1263","2614","0","48.32","31.87"
"65","000","00","030","0034","1399","557","372","185","4","561","1215","0","46.17","30.62"
"65","000","00","030","0034","1400","693","461","232","9","702","1399","0","50.18","32.95"
"65","000","00","030","0035","0000","2726","1760","966","31","2757","6686","0","41.24","26.32"
"65","000","00","030","0035","1401","577","390","187","2","579","1448","0","39.99","26.93"
"65","000","00","030","0035","1402","671","441","230","5","676","1563","0","43.25","28.21"
"65","000","00","030","0035","1403","836","525","311","15","851","1947","0","43.71","26.96"
"65","000","00","030","0035","1404","642","404","238","9","651","1728","0","37.67","23.38"
"65","000","00","030","0036","0000","1793","1367","426","17","1810","3818","0","47.41","35.80"
"65","000","00","030","0036","1405","544","455","89","7","551","1132","0","48.67","40.19"
"65","000","00","030","0036","1406","569","373","196","2","571","1346","0","42.42","27.71"
"65","000","00","030","0036","1407","680","539","141","8","688","1340","0","51.34","40.22"
"65","000","00","030","0037","0000","2005","1305","700","18","2023","4482","0","45.14","29.12"
"65","000","00","030","0037","1408","690","439","251","8","698","1589","0","43.93","27.63"
"65","000","00","030","0037","1409","703","487","216","6","709","1540","0","46.04","31.62"
"65","000","00","030","0037","1410","612","379","233","4","616","1353","0","45.53","28.01"
"65","000","00","030","0038","0000","1707","1119","588","20","1727","4171","0","41.40","26.83"
"65","000","00","030","0038","1411","666","417","249","7","673","1583","0","42.51","26.34"
"65","000","00","030","0038","1412","473","311","162","7","480","1235","0","38.87","25.18"
"65","000","00","030","0038","1413","568","391","177","6","574","1353","0","42.42","28.90"
"65","000","00","030","0039","0000","1909","1257","652","25","1934","3856","0","50.16","32.60"
"65","000","00","030","0039","1414","696","448","248","7","703","1374","0","51.16","32.61"
"65","000","00","030","0039","1415","636","417","219","9","645","1307","0","49.35","31.91"
"65","000","00","030","0039","1416","577","392","185","9","586","1175","0","49.87","33.36"
"65","000","00","030","0040","0000","1242","774","468","16","1258","2778","0","45.28","27.86"
"65","000","00","030","0040","1419","583","365","218","10","593","1303","0","45.51","28.01"
"65","000","00","030","0040","1420","659","409","250","6","665","1475","0","45.08","27.73"
"65","000","00","030","0041","0000","142","63","79","0","142","310","0","45.81","20.32"
"65","000","00","030","0041","1423","142","63","79","0","142","310","0","45.81","20.32"
"65","000","00","030","0042","0000","1890","1152","738","26","1916","4421","0","43.34","26.06"
"65","000","00","030","0042","1424","590","352","238","5","595","1407","0","42.29","25.02"
"65","000","00","030","0042","1425","661","415","246","9","670","1499","0","44.70","27.69"
"65","000","00","030","0042","1426","639","385","254","12","651","1515","0","42.97","25.41"
"65","000","00","030","0043","0000","967","548","419","8","975","2183","0","44.66","25.10"
"65","000","00","030","0043","1427","648","374","274","5","653","1416","0","46.12","26.41"
"65","000","00","030","0043","1428","319","174","145","3","322","767","0","41.98","22.69"
"65","000","00","030","0044","0000","1623","908","715","9","1632","6944","0","23.50","13.08"
"65","000","00","030","0044","1432","601","337","264","6","607","4669","0","13.00","7.22"
"65","000","00","030","0044","1433","487","258","229","1","488","1164","0","41.92","22.16"
"65","000","00","030","0044","1434","535","313","222","2","537","1111","0","48.33","28.17"
"65","000","00","030","0045","0000","2071","1232","839","18","2089","4423","0","47.23","27.85"
"65","000","00","030","0045","1441","780","542","238","7","787","1561","0","50.42","34.72"
"65","000","00","030","0045","1442","693","349","344","8","701","1526","0","45.94","22.87"
"65","000","00","030","0045","1443","598","341","257","3","601","1336","0","44.99","25.52"
"65","000","00","030","0046","0000","1905","1133","772","20","1925","3949","0","48.75","28.69"
"65","000","00","030","0046","1444","538","333","205","8","546","1030","0","53.01","32.33"
"65","000","00","030","0046","1445","786","428","358","6","792","1704","0","46.48","25.12"
"65","000","00","030","0046","1446","581","372","209","6","587","1215","0","48.31","30.62"
"65","000","00","030","0047","0000","2384","1494","890","27","2411","4885","0","49.36","30.58"
"65","000","00","030","0047","1447","559","347","212","6","565","1167","0","48.41","29.73"
"65","000","00","030","0047","1448","827","529","298","7","834","1779","0","46.88","29.74"
"65","000","00","030","0047","1449","555","346","209","4","559","959","0","58.29","36.08"
"65","000","00","030","0047","1450","443","272","171","10","453","980","0","46.22","27.76"
"65","000","00","030","0048","0000","1546","922","624","13","1559","3210","0","48.57","28.72"
"65","000","00","030","0048","1451","755","448","307","7","762","1579","0","48.26","28.37"
"65","000","00","030","0048","1452","791","474","317","6","797","1631","0","48.87","29.06"
"65","000","00","030","0049","0000","2372","1494","878","29","2401","5145","0","46.67","29.04"
"65","000","00","030","0049","1453","883","583","300","11","894","1905","0","46.93","30.60"
"65","000","00","030","0049","1454","731","450","281","9","740","1566","0","47.25","28.74"
"65","000","00","030","0049","1455","758","461","297","9","767","1674","0","45.82","27.54"
"65","000","00","030","0050","0000","2193","1355","838","26","2219","4350","0","51.01","31.15"
"65","000","00","030","0050","1456","443","274","169","6","449","898","0","50.00","30.51"
"65","000","00","030","0050","1457","633","433","200","6","639","1199","0","53.29","36.11"
"65","000","00","030","0050","1458","638","367","271","9","647","1298","0","49.85","28.27"
"65","000","00","030","0050","1459","479","281","198","5","484","955","0","50.68","29.42"
"65","000","00","030","0051","0000","1608","886","722","25","1633","3381","0","48.30","26.21"
"65","000","00","030","0051","1460","933","471","462","12","945","1932","0","48.91","24.38"
"65","000","00","030","0051","1461","675","415","260","13","688","1449","0","47.48","28.64"
"65","000","00","030","0052","0000","2114","1159","955","19","2133","4740","0","45.00","24.45"
"65","000","00","030","0052","1462","721","368","353","6","727","1540","0","47.21","23.90"
"65","000","00","030","0052","1463","625","367","258","9","634","1506","0","42.10","24.37"
"65","000","00","030","0052","1464","768","424","344","4","772","1694","0","45.57","25.03"
"65","000","00","030","0053","0000","949","578","371","9","958","1986","0","48.24","29.10"
"65","000","00","030","0053","1465","470","293","177","6","476","995","0","47.84","29.45"
"65","000","00","030","0053","1466","479","285","194","3","482","991","0","48.64","28.76"
"65","000","00","030","0054","0000","278","125","153","3","281","699","0","40.20","17.88"
"65","000","00","030","0054","1467","278","125","153","3","281","699","0","40.20","17.88"
"65","000","00","030","0055","0000","3447","1881","1566","31","3478","7243","0","48.02","25.97"
"65","000","00","030","0055","1468","642","284","358","5","647","1509","0","42.88","18.82"
"65","000","00","030","0055","1469","551","296","255","4","555","1168","0","47.52","25.34"
"65","000","00","030","0055","1470","569","361","208","7","576","1214","0","47.45","29.74"
"65","000","00","030","0055","1471","534","340","194","3","537","1077","0","49.86","31.57"
"65","000","00","030","0055","1472","319","168","151","2","321","626","0","51.28","26.84"
"65","000","00","030","0055","1473","832","432","400","10","842","1649","0","51.06","26.20"
"65","000","00","030","0056","0000","1082","471","611","6","1088","2221","0","48.99","21.21"
"65","000","00","030","0056","1474","524","230","294","2","526","1072","0","49.07","21.46"
"65","000","00","030","0056","1475","558","241","317","4","562","1149","0","48.91","20.97"
"65","000","00","030","0057","0000","2431","1222","1209","23","2454","5500","0","44.62","22.22"
"65","000","00","030","0057","1476","594","286","308","3","597","1288","0","46.35","22.20"
"65","000","00","030","0057","1477","686","322","364","10","696","1586","0","43.88","20.30"
"65","000","00","030","0057","1478","639","336","303","8","647","1446","0","44.74","23.24"
"65","000","00","030","0057","1479","512","278","234","2","514","1180","0","43.56","23.56"
"65","000","00","030","0058","0000","1115","575","540","6","1121","2534","0","44.24","22.69"
"65","000","00","030","0058","1480","649","345","304","0","649","1501","0","43.24","22.98"
"65","000","00","030","0058","1481","466","230","236","6","472","1033","0","45.69","22.27"
"65","000","00","030","0059","0000","2040","980","1060","19","2059","4552","0","45.23","21.53"
"65","000","00","030","0059","1482","626","313","313","5","631","1472","0","42.87","21.26"
"65","000","00","030","0059","1483","673","291","382","6","679","1531","0","44.35","19.01"
"65","000","00","030","0059","1484","741","376","365","8","749","1549","0","48.35","24.27"
"65","000","00","030","0060","0000","1471","731","740","15","1486","3544","0","41.93","20.63"
"65","000","00","030","0060","1485","695","361","334","7","702","1717","0","40.89","21.03"
"65","000","00","030","0060","1486","776","370","406","8","784","1827","0","42.91","20.25"
"65","000","00","030","0061","0000","1973","1007","966","16","1989","4463","0","44.57","22.56"
"65","000","00","030","0061","1487","643","316","327","6","649","1392","0","46.62","22.70"
"65","000","00","030","0061","1488","673","355","318","7","680","1478","0","46.01","24.02"
"65","000","00","030","0061","1489","657","336","321","3","660","1593","0","41.43","21.09"
"65","000","00","030","0062","0000","1710","818","892","9","1719","4026","0","42.70","20.32"
"65","000","00","030","0062","1490","559","245","314","5","564","1213","0","46.50","20.20"
"65","000","00","030","0062","1491","608","329","279","3","611","1502","0","40.68","21.90"
"65","000","00","030","0062","1492","543","244","299","1","544","1311","0","41.50","18.61"
"65","000","00","030","0063","0000","983","565","418","5","988","2090","0","47.27","27.03"
"65","000","00","030","0063","1493","509","265","244","3","512","1121","0","45.67","23.64"
"65","000","00","030","0063","1494","474","300","174","2","476","969","0","49.12","30.96"
"65","000","00","030","0064","0000","1836","887","949","7","1843","3932","0","46.87","22.56"
"65","000","00","030","0064","1495","618","290","328","2","620","1246","0","49.76","23.27"
"65","000","00","030","0064","1496","589","306","283","4","593","1309","0","45.30","23.38"
"65","000","00","030","0064","1497","629","291","338","1","630","1377","0","45.75","21.13"
"65","000","00","030","0065","0000","1308","662","646","6","1314","2811","0","46.74","23.55"
"65","000","00","030","0065","1498","624","311","313","2","626","1324","0","47.28","23.49"
"65","000","00","030","0065","1499","684","351","333","4","688","1487","0","46.27","23.60"
"65","000","00","030","0066","0000","1859","876","983","12","1871","4374","0","42.78","20.03"
"65","000","00","030","0066","1500","630","314","316","8","638","1485","0","42.96","21.14"
"65","000","00","030","0066","1501","636","271","365","1","637","1525","0","41.77","17.77"
"65","000","00","030","0066","1502","593","291","302","3","596","1364","0","43.70","21.33"
"65","000","00","030","0067","0000","1830","975","855","12","1842","4038","0","45.62","24.15"
"65","000","00","030","0067","1503","630","325","305","3","633","1378","0","45.94","23.58"
"65","000","00","030","0067","1504","594","271","323","4","598","1441","0","41.50","18.81"
"65","000","00","030","0067","1505","606","379","227","5","611","1219","0","50.12","31.09"
"65","000","00","030","0068","0000","1751","901","850","23","1774","3746","0","47.36","24.05"
"65","000","00","030","0068","1506","831","432","399","13","844","1768","0","47.74","24.43"
"65","000","00","030","0068","1507","546","261","285","3","549","1137","0","48.28","22.96"
"65","000","00","030","0068","1508","374","208","166","7","381","841","0","45.30","24.73"
"65","000","00","030","0069","0000","1591","861","730","17","1608","3413","0","47.11","25.23"
"65","000","00","030","0069","1509","698","360","338","8","706","1505","0","46.91","23.92"
"65","000","00","030","0069","1510","893","501","392","9","902","1908","0","47.27","26.26"
"65","000","00","030","0070","0000","1949","1322","627","25","1974","3950","0","49.97","33.47"
"65","000","00","030","0070","1511","647","416","231","10","657","1394","0","47.13","29.84"
"65","000","00","030","0070","1512","557","317","240","8","565","1177","0","48.00","26.93"
"65","000","00","030","0070","1513","745","589","156","7","752","1379","0","54.53","42.71"
"65","000","00","030","0071","0000","1433","672","761","15","1448","3434","0","42.17","19.57"
"65","000","00","030","0071","1514","460","196","264","7","467","1043","0","44.77","18.79"
"65","000","00","030","0071","1515","464","215","249","4","468","1185","0","39.49","18.14"
"65","000","00","030","0071","1516","509","261","248","4","513","1206","0","42.54","21.64"
"65","000","00","030","0072","0000","1469","954","515","13","1482","3329","0","44.52","28.66"
"65","000","00","030","0072","1573","492","305","187","7","499","1122","0","44.47","27.18"
"65","000","00","030","0072","1574","492","315","177","4","496","1152","0","43.06","27.34"
"65","000","00","030","0072","1575","485","334","151","2","487","1055","0","46.16","31.66"
"65","000","00","030","0073","0000","2819","1657","1162","23","2842","5696","0","49.89","29.09"
"65","000","00","030","0073","1339","972","605","367","9","981","1975","0","49.67","30.63"
"65","000","00","030","0073","1340","859","503","356","8","867","1730","0","50.12","29.08"
"65","000","00","030","0073","1341","988","549","439","6","994","1991","0","49.92","27.57"
"65","000","00","030","0074","0000","865","543","322","11","876","1721","0","50.90","31.55"
"65","000","00","030","0074","1533","865","543","322","11","876","1721","0","50.90","31.55"
"65","000","00","030","0075","0000","1974","1223","751","33","2007","3886","0","51.65","31.47"
"65","000","00","030","0075","1539","566","365","201","9","575","1086","0","52.95","33.61"
"65","000","00","030","0075","1540","740","434","306","14","754","1443","0","52.25","30.08"
"65","000","00","030","0075","1541","668","424","244","10","678","1357","0","49.96","31.25"
"65","000","00","030","0076","0000","1197","678","519","8","1205","2405","0","50.10","28.19"
"65","000","00","030","0076","1556","648","350","298","6","654","1325","0","49.36","26.42"
"65","000","00","030","0076","1557","549","328","221","2","551","1080","0","51.02","30.37"
"65","000","00","030","0077","0000","1014","650","364","6","1020","2226","0","45.82","29.20"
"65","000","00","030","0077","1571","449","317","132","3","452","1062","0","42.56","29.85"
"65","000","00","030","0077","1572","565","333","232","3","568","1164","0","48.80","28.61"
"65","000","00","030","0078","0000","1249","769","480","21","1270","2756","0","46.08","27.90"
"65","000","00","030","0078","1417","627","355","272","10","637","1417","0","44.95","25.05"
"65","000","00","030","0078","1418","622","414","208","11","633","1339","0","47.27","30.92"
"65","000","00","030","0079","0000","939","554","385","8","947","1883","0","50.29","29.42"
"65","000","00","030","0079","1421","421","251","170","3","424","859","0","49.36","29.22"
"65","000","00","030","0079","1422","518","303","215","5","523","1024","0","51.07","29.59"
"65","000","00","030","0080","0000","1670","1075","595","22","1692","3773","0","44.84","28.49"
"65","000","00","030","0080","1429","626","388","238","6","632","1367","0","46.23","28.38"
"65","000","00","030","0080","1430","587","393","194","8","595","1399","0","42.53","28.09"
"65","000","00","030","0080","1431","457","294","163","8","465","1007","0","46.18","29.20"
"65","000","00","030","0081","0000","2656","1605","1051","13","2669","5825","0","45.82","27.55"
"65","000","00","030","0081","1435","660","393","267","4","664","1461","0","45.45","26.90"
"65","000","00","030","0081","1436","675","438","237","4","679","1506","0","45.09","29.08"
"65","000","00","030","0081","1437","626","355","271","3","629","1436","0","43.80","24.72"
"65","000","00","030","0081","1438","695","419","276","2","697","1422","0","49.02","29.47"
"65","000","00","030","0082","0000","1195","749","446","3","1198","2623","0","45.67","28.56"
"65","000","00","030","0082","1439","639","406","233","2","641","1345","0","47.66","30.19"
"65","000","00","030","0082","1440","556","343","213","1","557","1278","0","43.58","26.84"
"65","000","00","030","0083","0000","999","497","502","9","1008","2395","0","42.09","20.75"
"65","000","00","030","0083","1392","442","208","234","7","449","1007","0","44.59","20.66"
"65","000","00","030","0083","1393","557","289","268","2","559","1388","0","40.27","20.82"
"65","000","00","030","0084","0000","2042","1104","938","19","2061","4326","0","47.64","25.52"
"65","000","00","030","0084","1394","659","352","307","4","663","1428","0","46.43","24.65"
"65","000","00","030","0084","1395","617","280","337","6","623","1216","0","51.23","23.03"
"65","000","00","030","0084","1396","766","472","294","9","775","1682","0","46.08","28.06"
"65","000","00","030","0085","0000","1559","830","729","12","1571","3643","0","43.12","22.78"
"65","000","00","030","0085","1517","557","310","247","6","563","1304","0","43.17","23.77"
"65","000","00","030","0085","1518","426","214","212","0","426","1032","0","41.28","20.74"
"65","000","00","030","0085","1519","576","306","270","6","582","1307","0","44.53","23.41"
"65","000","00","030","0086","0000","1485","710","775","18","1503","3432","0","43.79","20.69"
"65","000","00","030","0086","1520","754","348","406","10","764","1751","0","43.63","19.87"
"65","000","00","030","0086","1521","731","362","369","8","739","1681","0","43.96","21.53"
"65","000","00","030","0087","0000","1174","609","565","10","1184","2486","0","47.63","24.50"
"65","000","00","030","0087","1522","572","295","277","4","576","1178","0","48.90","25.04"
"65","000","00","030","0087","1523","602","314","288","6","608","1308","0","46.48","24.01"
"65","000","00","030","0088","0000","1351","661","690","20","1371","3236","0","42.37","20.43"
"65","000","00","030","0088","1524","623","303","320","9","632","1443","0","43.80","21.00"
"65","000","00","030","0088","1525","728","358","370","11","739","1793","0","41.22","19.97"
"65","000","00","030","0089","0000","1510","739","771","7","1517","3862","0","39.28","19.14"
"65","000","00","030","0089","1526","441","215","226","0","441","1199","0","36.78","17.93"
"65","000","00","030","0089","1527","530","258","272","4","534","1339","0","39.88","19.27"
"65","000","00","030","0089","1528","539","266","273","3","542","1324","0","40.94","20.09"
"65","000","00","030","0090","0000","1451","695","756","18","1469","2946","0","49.86","23.59"
"65","000","00","030","0090","1529","734","324","410","14","748","1578","0","47.40","20.53"
"65","000","00","030","0090","1530","717","371","346","4","721","1368","0","52.70","27.12"
"65","000","00","030","0091","0000","1315","624","691","14","1329","2987","0","44.49","20.89"
"65","000","00","030","0091","1531","545","245","300","4","549","1233","0","44.53","19.87"
"65","000","00","030","0091","1532","770","379","391","10","780","1754","0","44.47","21.61"
"65","000","00","030","0092","0000","1288","834","454","10","1298","3087","0","42.05","27.02"
"65","000","00","030","0092","1397","671","436","235","4","675","1642","0","41.11","26.55"
"65","000","00","030","0092","1398","617","398","219","6","623","1445","0","43.11","27.54"
"65","000","00","030","0093","0000","1170","662","508","6","1176","2564","0","45.87","25.82"
"65","000","00","030","0093","1337","552","280","272","4","556","1190","0","46.72","23.53"
"65","000","00","030","0093","1338","618","382","236","2","620","1374","0","45.12","27.80"
"65","000","00","040","0000","0000","89074","54690","34384","719","89793","186020","217795","48.27","29.40"
"65","000","00","040","0001","0000","1365","805","560","14","1379","2917","0","47.27","27.60"
"65","000","00","040","0001","1588","694","394","300","10","704","1488","0","47.31","26.48"
"65","000","00","040","0001","1589","671","411","260","4","675","1429","0","47.24","28.76"
"65","000","00","040","0002","0000","1184","745","439","16","1200","2476","0","48.47","30.09"
"65","000","00","040","0002","1706","578","358","220","4","582","1187","0","49.03","30.16"
"65","000","00","040","0002","1707","606","387","219","12","618","1289","0","47.94","30.02"
"65","000","00","040","0003","0000","1563","986","577","13","1576","4502","0","35.01","21.90"
"65","000","00","040","0003","1597","772","492","280","10","782","1554","0","50.32","31.66"
"65","000","00","040","0003","1598","791","494","297","3","794","2948","0","26.93","16.76"
"65","000","00","040","0004","0000","1343","860","483","8","1351","2581","0","52.34","33.32"
"65","000","00","040","0004","1599","604","390","214","2","606","1196","0","50.67","32.61"
"65","000","00","040","0004","1600","739","470","269","6","745","1385","0","53.79","33.94"
"65","000","00","040","0005","0000","1233","748","485","9","1242","2419","0","51.34","30.92"
"65","000","00","040","0005","1704","632","392","240","5","637","1192","0","53.44","32.89"
"65","000","00","040","0005","1705","601","356","245","4","605","1227","0","49.31","29.01"
"65","000","00","040","0006","0000","1470","871","599","17","1487","2938","0","50.61","29.65"
"65","000","00","040","0006","1607","774","464","310","9","783","1501","0","52.17","30.91"
"65","000","00","040","0006","1608","696","407","289","8","704","1437","0","48.99","28.32"
"65","000","00","040","0007","0000","1244","759","485","5","1249","2396","0","52.13","31.68"
"65","000","00","040","0007","1609","654","418","236","2","656","1231","0","53.29","33.96"
"65","000","00","040","0007","1610","590","341","249","3","593","1165","0","50.90","29.27"
"65","000","00","040","0008","0000","1066","677","389","7","1073","2525","0","42.50","26.81"
"65","000","00","040","0008","1645","528","342","186","5","533","1230","0","43.33","27.80"
"65","000","00","040","0008","1646","538","335","203","2","540","1295","0","41.70","25.87"
"65","000","00","040","0009","0000","409","332","77","7","416","876","0","47.49","37.90"
"65","000","00","040","0009","1702","409","332","77","7","416","876","0","47.49","37.90"
"65","000","00","040","0010","0000","346","279","67","6","352","704","0","50.00","39.63"
"65","000","00","040","0010","1703","346","279","67","6","352","704","0","50.00","39.63"
"65","000","00","040","0011","0000","1978","1190","788","19","1997","4085","0","48.89","29.13"
"65","000","00","040","0011","1616","730","445","285","9","739","1460","0","50.62","30.48"
"65","000","00","040","0011","1617","641","392","249","4","645","1244","0","51.85","31.51"
"65","000","00","040","0011","1618","607","353","254","6","613","1381","0","44.39","25.56"
"65","000","00","040","0012","0000","1710","941","769","12","1722","3437","0","50.10","27.38"
"65","000","00","040","0012","1629","861","460","401","6","867","1708","0","50.76","26.93"
"65","000","00","040","0012","1630","849","481","368","6","855","1729","0","49.45","27.82"
"65","000","00","040","0013","0000","3057","1803","1254","21","3078","6137","0","50.15","29.38"
"65","000","00","040","0013","1686","746","389","357","5","751","1585","0","47.38","24.54"
"65","000","00","040","0013","1687","781","469","312","4","785","1539","0","51.01","30.47"
"65","000","00","040","0013","1688","790","479","311","4","794","1494","0","53.15","32.06"
"65","000","00","040","0013","1689","740","466","274","8","748","1519","0","49.24","30.68"
"65","000","00","040","0014","0000","2123","1210","913","16","2139","4473","0","47.82","27.05"
"65","000","00","040","0014","1683","745","437","308","5","750","1518","0","49.41","28.79"
"65","000","00","040","0014","1684","699","398","301","9","708","1477","0","47.94","26.95"
"65","000","00","040","0014","1685","679","375","304","2","681","1478","0","46.08","25.37"
"65","000","00","040","0015","0000","1876","1179","697","11","1887","3634","0","51.93","32.44"
"65","000","00","040","0015","1661","639","390","249","6","645","1213","0","53.17","32.15"
"65","000","00","040","0015","1662","547","336","211","2","549","1102","0","49.82","30.49"
"65","000","00","040","0015","1663","690","453","237","3","693","1319","0","52.54","34.34"
"65","000","00","040","0016","0000","1940","1210","730","16","1956","3986","0","49.07","30.36"
"65","000","00","040","0016","1622","629","412","217","8","637","1279","0","49.80","32.21"
"65","000","00","040","0016","1623","659","390","269","7","666","1308","0","50.92","29.82"
"65","000","00","040","0016","1624","652","408","244","1","653","1399","0","46.68","29.16"
"65","000","00","040","0017","0000","1835","1123","712","14","1849","3852","0","48.00","29.15"
"65","000","00","040","0017","1619","649","407","242","5","654","1325","0","49.36","30.72"
"65","000","00","040","0017","1620","709","450","259","4","713","1462","0","48.77","30.78"
"65","000","00","040","0017","1621","477","266","211","5","482","1065","0","45.26","24.98"
"65","000","00","040","0018","0000","1312","789","523","12","1324","2760","0","47.97","28.59"
"65","000","00","040","0018","1591","603","367","236","4","607","1248","0","48.64","29.41"
"65","000","00","040","0018","1592","709","422","287","8","717","1512","0","47.42","27.91"
"65","000","00","040","0019","0000","490","246","244","4","494","1091","0","45.28","22.55"
"65","000","00","040","0019","1590","490","246","244","4","494","1091","0","45.28","22.55"
"65","000","00","040","0020","0000","1521","844","677","13","1534","3358","0","45.68","25.13"
"65","000","00","040","0020","1625","763","465","298","7","770","1653","0","46.58","28.13"
"65","000","00","040","0020","1626","758","379","379","6","764","1705","0","44.81","22.23"
"65","000","00","040","0021","0000","1196","687","509","12","1208","2545","0","47.47","26.99"
"65","000","00","040","0021","1627","589","331","258","5","594","1259","0","47.18","26.29"
"65","000","00","040","0021","1628","607","356","251","7","614","1286","0","47.74","27.68"
"65","000","00","040","0022","0000","782","456","326","6","788","1702","0","46.30","26.79"
"65","000","00","040","0022","1712","371","225","146","5","376","855","0","43.98","26.32"
"65","000","00","040","0022","1713","411","231","180","1","412","847","0","48.64","27.27"
"65","000","00","040","0023","0000","1500","977","523","13","1513","3222","0","46.96","30.32"
"65","000","00","040","0023","1582","781","508","273","8","789","1691","0","46.66","30.04"
"65","000","00","040","0023","1583","719","469","250","5","724","1531","0","47.29","30.63"
"65","000","00","040","0024","0000","1768","1094","674","11","1779","3413","0","52.12","32.05"
"65","000","00","040","0024","1671","901","587","314","6","907","1726","0","52.55","34.01"
"65","000","00","040","0024","1672","867","507","360","5","872","1687","0","51.69","30.05"
"65","000","00","040","0025","0000","1666","1029","637","14","1680","3354","0","50.09","30.68"
"65","000","00","040","0025","1673","563","340","223","2","565","1124","0","50.27","30.25"
"65","000","00","040","0025","1674","547","330","217","7","554","1124","0","49.29","29.36"
"65","000","00","040","0025","1675","556","359","197","5","561","1106","0","50.72","32.46"
"65","000","00","040","0026","0000","1795","1099","696","9","1804","3469","0","52.00","31.68"
"65","000","00","040","0026","1666","615","396","219","5","620","1158","0","53.54","34.20"
"65","000","00","040","0026","1667","547","352","195","2","549","1137","0","48.28","30.96"
"65","000","00","040","0026","1668","633","351","282","2","635","1174","0","54.09","29.90"
"65","000","00","040","0027","0000","1276","751","525","6","1282","2623","0","48.88","28.63"
"65","000","00","040","0027","1669","615","362","253","2","617","1297","0","47.57","27.91"
"65","000","00","040","0027","1670","661","389","272","4","665","1326","0","50.15","29.34"
"65","000","00","040","0028","0000","1383","885","498","10","1393","2995","0","46.51","29.55"
"65","000","00","040","0028","1716","761","491","270","4","765","1605","0","47.66","30.59"
"65","000","00","040","0028","1717","622","394","228","6","628","1390","0","45.18","28.35"
"65","000","00","040","0029","0000","1121","670","451","13","1134","2205","0","51.43","30.39"
"65","000","00","040","0029","1714","598","368","230","7","605","1216","0","49.75","30.26"
"65","000","00","040","0029","1715","523","302","221","6","529","989","0","53.49","30.54"
"65","000","00","040","0030","0000","1980","1314","666","15","1995","3956","0","50.43","33.22"
"65","000","00","040","0030","1653","676","448","228","9","685","1326","0","51.66","33.79"
"65","000","00","040","0030","1654","629","412","217","1","630","1326","0","47.51","31.07"
"65","000","00","040","0030","1655","675","454","221","5","680","1304","0","52.15","34.82"
"65","000","00","040","0031","0000","2003","1323","680","25","2028","4105","0","49.40","32.23"
"65","000","00","040","0031","1649","475","326","149","4","479","989","0","48.43","32.96"
"65","000","00","040","0031","1650","505","335","170","6","511","997","0","51.25","33.60"
"65","000","00","040","0031","1651","549","366","183","12","561","1118","0","50.18","32.74"
"65","000","00","040","0031","1652","474","296","178","3","477","1001","0","47.65","29.57"
"65","000","00","040","0032","0000","1155","709","446","9","1164","2298","0","50.65","30.85"
"65","000","00","040","0032","1659","583","347","236","5","588","1158","0","50.78","29.97"
"65","000","00","040","0032","1660","572","362","210","4","576","1140","0","50.53","31.75"
"65","000","00","040","0033","0000","2032","1152","880","16","2048","4115","0","49.77","28.00"
"65","000","00","040","0033","1680","615","377","238","7","622","1309","0","47.52","28.80"
"65","000","00","040","0033","1681","693","389","304","2","695","1348","0","51.56","28.86"
"65","000","00","040","0033","1682","724","386","338","7","731","1458","0","50.14","26.47"
"65","000","00","040","0034","0000","1509","905","604","9","1518","3433","0","44.22","26.36"
"65","000","00","040","0034","1638","767","454","313","5","772","1669","0","46.26","27.20"
"65","000","00","040","0034","1639","742","451","291","4","746","1764","0","42.29","25.57"
"65","000","00","040","0035","0000","2057","1318","739","15","2072","4047","0","51.20","32.57"
"65","000","00","040","0035","1642","664","434","230","5","669","1297","0","51.58","33.46"
"65","000","00","040","0035","1643","754","492","262","7","761","1430","0","53.22","34.41"
"65","000","00","040","0035","1644","639","392","247","3","642","1320","0","48.64","29.70"
"65","000","00","040","0036","0000","716","449","267","2","718","1527","0","47.02","29.40"
"65","000","00","040","0036","1578","716","449","267","2","718","1527","0","47.02","29.40"
"65","000","00","040","0037","0000","1036","663","373","12","1048","2119","0","49.46","31.29"
"65","000","00","040","0037","1580","505","314","191","9","514","1041","0","49.38","30.16"
"65","000","00","040","0037","1581","531","349","182","3","534","1078","0","49.54","32.37"
"65","000","00","040","0038","0000","2202","1394","808","15","2217","4495","0","49.32","31.01"
"65","000","00","040","0038","1601","739","463","276","6","745","1473","0","50.58","31.43"
"65","000","00","040","0038","1602","682","450","232","4","686","1437","0","47.74","31.32"
"65","000","00","040","0038","1603","781","481","300","5","786","1585","0","49.59","30.35"
"65","000","00","040","0039","0000","1931","1264","667","23","1954","3718","0","52.56","34.00"
"65","000","00","040","0039","1604","675","433","242","8","683","1293","0","52.82","33.49"
"65","000","00","040","0039","1605","633","432","201","7","640","1201","0","53.29","35.97"
"65","000","00","040","0039","1606","623","399","224","8","631","1224","0","51.55","32.60"
"65","000","00","040","0040","0000","1220","746","474","15","1235","2845","0","43.41","26.22"
"65","000","00","040","0040","1647","616","384","232","7","623","1470","0","42.38","26.12"
"65","000","00","040","0040","1648","604","362","242","8","612","1375","0","44.51","26.33"
"65","000","00","040","0041","0000","384","287","97","4","388","809","0","47.96","35.48"
"65","000","00","040","0041","1701","384","287","97","4","388","809","0","47.96","35.48"
"65","000","00","040","0042","0000","444","324","120","3","447","907","0","49.28","35.72"
"65","000","00","040","0042","1700","444","324","120","3","447","907","0","49.28","35.72"
"65","000","00","040","0043","0000","913","580","333","7","920","1894","0","48.57","30.62"
"65","000","00","040","0043","1676","913","580","333","7","920","1894","0","48.57","30.62"
"65","000","00","040","0044","0000","1943","1173","770","16","1959","4232","0","46.29","27.72"
"65","000","00","040","0044","1677","707","400","307","6","713","1472","0","48.44","27.17"
"65","000","00","040","0044","1678","601","362","239","4","605","1293","0","46.79","28.00"
"65","000","00","040","0044","1679","635","411","224","6","641","1467","0","43.69","28.02"
"65","000","00","040","0045","0000","1013","613","400","10","1023","1996","0","51.25","30.71"
"65","000","00","040","0045","1718","534","318","216","4","538","1030","0","52.23","30.87"
"65","000","00","040","0045","1719","479","295","184","6","485","966","0","50.21","30.54"
"65","000","00","040","0046","0000","1912","1138","774","18","1930","3972","0","48.59","28.65"
"65","000","00","040","0046","1697","641","375","266","7","648","1347","0","48.11","27.84"
"65","000","00","040","0046","1698","614","354","260","7","621","1339","0","46.38","26.44"
"65","000","00","040","0046","1699","657","409","248","4","661","1286","0","51.40","31.80"
"65","000","00","040","0047","0000","2099","1267","832","18","2117","4293","0","49.31","29.51"
"65","000","00","040","0047","1613","760","448","312","7","767","1595","0","48.09","28.09"
"65","000","00","040","0047","1614","601","375","226","8","609","1193","0","51.05","31.43"
"65","000","00","040","0047","1615","738","444","294","3","741","1505","0","49.24","29.50"
"65","000","00","040","0048","0000","1324","787","537","10","1334","2797","0","47.69","28.14"
"65","000","00","040","0048","1611","624","385","239","5","629","1365","0","46.08","28.21"
"65","000","00","040","0048","1612","700","402","298","5","705","1432","0","49.23","28.07"
"65","000","00","040","0049","0000","1611","931","680","9","1620","3428","0","47.26","27.16"
"65","000","00","040","0049","1635","498","289","209","3","501","1082","0","46.30","26.71"
"65","000","00","040","0049","1636","536","316","220","3","539","1133","0","47.57","27.89"
"65","000","00","040","0049","1637","577","326","251","3","580","1213","0","47.82","26.88"
"65","000","00","040","0050","0000","1075","676","399","10","1085","2304","0","47.09","29.34"
"65","000","00","040","0050","1631","609","387","222","6","615","1240","0","49.60","31.21"
"65","000","00","040","0050","1632","466","289","177","4","470","1064","0","44.17","27.16"
"65","000","00","040","0051","0000","1523","1007","516","11","1534","3036","0","50.53","33.17"
"65","000","00","040","0051","1586","775","506","269","2","777","1504","0","51.66","33.64"
"65","000","00","040","0051","1587","748","501","247","9","757","1532","0","49.41","32.70"
"65","000","00","040","0052","0000","466","314","152","3","469","1031","0","45.49","30.46"
"65","000","00","040","0052","1579","466","314","152","3","469","1031","0","45.49","30.46"
"65","000","00","040","0053","0000","930","569","361","12","942","1963","0","47.99","28.99"
"65","000","00","040","0053","1595","506","298","208","5","511","1061","0","48.16","28.09"
"65","000","00","040","0053","1596","424","271","153","7","431","902","0","47.78","30.04"
"65","000","00","040","0054","0000","1286","817","469","14","1300","2764","0","47.03","29.56"
"65","000","00","040","0054","1593","625","395","230","2","627","1360","0","46.10","29.04"
"65","000","00","040","0054","1594","661","422","239","12","673","1404","0","47.93","30.06"
"65","000","00","040","0055","0000","1497","992","505","11","1508","3259","0","46.27","30.44"
"65","000","00","040","0055","1584","809","523","286","6","815","1714","0","47.55","30.51"
"65","000","00","040","0055","1585","688","469","219","5","693","1545","0","44.85","30.36"
"65","000","00","040","0056","0000","1643","1028","615","9","1652","3607","0","45.80","28.50"
"65","000","00","040","0056","1656","494","306","188","1","495","1158","0","42.75","26.42"
"65","000","00","040","0056","1657","538","346","192","6","544","1206","0","45.11","28.69"
"65","000","00","040","0056","1658","611","376","235","2","613","1243","0","49.32","30.25"
"65","000","00","040","0057","0000","1154","684","470","12","1166","2350","0","49.62","29.11"
"65","000","00","040","0057","1708","677","411","266","7","684","1355","0","50.48","30.33"
"65","000","00","040","0057","1709","477","273","204","5","482","995","0","48.44","27.44"
"65","000","00","040","0058","0000","900","483","417","8","908","1783","0","50.93","27.09"
"65","000","00","040","0058","1710","418","213","205","6","424","831","0","51.02","25.63"
"65","000","00","040","0058","1711","482","270","212","2","484","952","0","50.84","28.36"
"65","000","00","040","0059","0000","1155","687","468","12","1167","2527","0","46.18","27.19"
"65","000","00","040","0059","1640","546","330","216","6","552","1274","0","43.33","25.90"
"65","000","00","040","0059","1641","609","357","252","6","615","1253","0","49.08","28.49"
"65","000","00","040","0060","0000","1273","768","505","6","1279","2627","0","48.69","29.23"
"65","000","00","040","0060","1633","631","387","244","3","634","1349","0","47.00","28.69"
"65","000","00","040","0060","1634","642","381","261","3","645","1278","0","50.47","29.81"
"65","000","00","040","0061","0000","984","545","439","6","990","2095","0","47.26","26.01"
"65","000","00","040","0061","1664","494","282","212","3","497","1049","0","47.38","26.88"
"65","000","00","040","0061","1665","490","263","227","3","493","1046","0","47.13","25.14"
"65","000","00","040","0062","0000","4152","2538","1614","20","4172","9013","0","46.29","28.16"
"65","000","00","040","0062","1690","506","264","242","2","508","1184","0","42.91","22.30"
"65","000","00","040","0062","1691","621","371","250","3","624","1333","0","46.81","27.83"
"65","000","00","040","0062","1692","622","370","252","6","628","1296","0","48.46","28.55"
"65","000","00","040","0062","1693","524","329","195","2","526","1192","0","44.13","27.60"
"65","000","00","040","0062","1694","591","387","204","1","592","1303","0","45.43","29.70"
"65","000","00","040","0062","1695","701","459","242","3","704","1460","0","48.22","31.44"
"65","000","00","040","0062","1696","587","358","229","3","590","1245","0","47.39","28.76"
"65","000","00","050","0000","0000","144975","65171","79804","1142","146117","352098","422668","41.50","18.51"
"65","000","00","050","0001","0000","2123","937","1186","13","2136","4736","0","45.10","19.78"
"65","000","00","050","0001","0346","501","191","310","2","503","1101","0","45.69","17.35"
"65","000","00","050","0001","0347","577","251","326","3","580","1256","0","46.18","19.98"
"65","000","00","050","0001","0348","508","259","249","4","512","1099","0","46.59","23.57"
"65","000","00","050","0001","0349","537","236","301","4","541","1280","0","42.27","18.44"
"65","000","00","050","0002","0000","3588","1642","1946","26","3614","8383","0","43.11","19.59"
"65","000","00","050","0002","0373","577","191","386","3","580","1343","0","43.19","14.22"
"65","000","00","050","0002","0374","625","299","326","2","627","1470","0","42.65","20.34"
"65","000","00","050","0002","0375","575","301","274","5","580","1320","0","43.94","22.80"
"65","000","00","050","0002","0376","630","309","321","6","636","1495","0","42.54","20.67"
"65","000","00","050","0002","0377","549","253","296","4","553","1295","0","42.70","19.54"
"65","000","00","050","0002","0378","632","289","343","6","638","1460","0","43.70","19.79"
"65","000","00","050","0003","0000","555","253","302","8","563","1293","0","43.54","19.57"
"65","000","00","050","0003","0507","555","253","302","8","563","1293","0","43.54","19.57"
"65","000","00","050","0004","0000","1858","814","1044","14","1872","3916","0","47.80","20.79"
"65","000","00","050","0004","0350","587","235","352","7","594","1166","0","50.94","20.15"
"65","000","00","050","0004","0351","514","198","316","0","514","1165","0","44.12","17.00"
"65","000","00","050","0004","0352","757","381","376","7","764","1585","0","48.20","24.04"
"65","000","00","050","0005","0000","2016","964","1052","15","2031","4570","0","44.44","21.09"
"65","000","00","050","0005","0379","677","358","319","7","684","1438","0","47.57","24.90"
"65","000","00","050","0005","0380","570","269","301","3","573","1327","0","43.18","20.27"
"65","000","00","050","0005","0381","769","337","432","5","774","1805","0","42.88","18.67"
"65","000","00","050","0006","0000","1355","571","784","14","1369","3237","0","42.29","17.64"
"65","000","00","050","0006","0504","440","214","226","9","449","1112","0","40.38","19.24"
"65","000","00","050","0006","0505","447","175","272","2","449","1005","0","44.68","17.41"
"65","000","00","050","0006","0506","468","182","286","3","471","1120","0","42.05","16.25"
"65","000","00","050","0007","0000","2054","944","1110","17","2071","4625","0","44.78","20.41"
"65","000","00","050","0007","0356","786","376","410","4","790","1825","0","43.29","20.60"
"65","000","00","050","0007","0357","655","287","368","7","662","1384","0","47.83","20.74"
"65","000","00","050","0007","0358","613","281","332","6","619","1416","0","43.71","19.84"
"65","000","00","050","0008","0000","1739","782","957","12","1751","3906","0","44.83","20.02"
"65","000","00","050","0008","0436","586","270","316","3","589","1353","0","43.53","19.96"
"65","000","00","050","0008","0437","577","255","322","4","581","1320","0","44.02","19.32"
"65","000","00","050","0008","0438","576","257","319","5","581","1233","0","47.12","20.84"
"65","000","00","050","0009","0000","2786","1197","1589","18","2804","6314","0","44.41","18.96"
"65","000","00","050","0009","0562","451","169","282","2","453","1093","0","41.45","15.46"
"65","000","00","050","0009","0563","551","237","314","6","557","1334","0","41.75","17.77"
"65","000","00","050","0009","0564","594","241","353","3","597","1185","0","50.38","20.34"
"65","000","00","050","0009","0565","606","286","320","4","610","1356","0","44.99","21.09"
"65","000","00","050","0009","0566","584","264","320","3","587","1346","0","43.61","19.61"
"65","000","00","050","0010","0000","903","387","516","8","911","1879","0","48.48","20.60"
"65","000","00","050","0010","0359","455","208","247","5","460","941","0","48.88","22.10"
"65","000","00","050","0010","0360","448","179","269","3","451","938","0","48.08","19.08"
"65","000","00","050","0011","0000","2331","1051","1280","17","2348","5211","0","45.06","20.17"
"65","000","00","050","0011","0432","570","245","325","3","573","1177","0","48.68","20.82"
"65","000","00","050","0011","0433","532","218","314","6","538","1320","0","40.76","16.52"
"65","000","00","050","0011","0434","476","235","241","3","479","1176","0","40.73","19.98"
"65","000","00","050","0011","0435","753","353","400","5","758","1538","0","49.28","22.95"
"65","000","00","050","0012","0000","1023","420","603","7","1030","2744","0","37.54","15.31"
"65","000","00","050","0012","0581","488","217","271","2","490","1415","0","34.63","15.34"
"65","000","00","050","0012","0582","535","203","332","5","540","1329","0","40.63","15.27"
"65","000","00","050","0013","0000","1408","746","662","12","1420","2917","0","48.68","25.57"
"65","000","00","050","0013","0363","464","216","248","6","470","973","0","48.30","22.20"
"65","000","00","050","0013","0364","506","291","215","3","509","1021","0","49.85","28.50"
"65","000","00","050","0013","0365","438","239","199","3","441","923","0","47.78","25.89"
"65","000","00","050","0014","0000","1823","821","1002","11","1834","4028","0","45.53","20.38"
"65","000","00","050","0014","0443","642","304","338","5","647","1337","0","48.39","22.74"
"65","000","00","050","0014","0444","582","250","332","2","584","1343","0","43.48","18.62"
"65","000","00","050","0014","0445","599","267","332","4","603","1348","0","44.73","19.81"
"65","000","00","050","0015","0000","4304","1986","2318","34","4338","10595","0","40.94","18.74"
"65","000","00","050","0015","0611","487","192","295","2","489","1147","0","42.63","16.74"
"65","000","00","050","0015","0612","521","215","306","2","523","1127","0","46.41","19.08"
"65","000","00","050","0015","0613","649","292","357","12","661","1552","0","42.59","18.81"
"65","000","00","050","0015","0614","455","194","261","3","458","1069","0","42.84","18.15"
"65","000","00","050","0015","0615","426","189","237","3","429","1167","0","36.76","16.20"
"65","000","00","050","0015","0616","594","328","266","1","595","1407","0","42.29","23.31"
"65","000","00","050","0015","0617","581","317","264","5","586","1548","0","37.86","20.48"
"65","000","00","050","0015","0618","591","259","332","6","597","1578","0","37.83","16.41"
"65","000","00","050","0016","0000","1299","614","685","7","1306","5142","0","25.40","11.94"
"65","000","00","050","0016","0366","499","249","250","2","501","1100","0","45.55","22.64"
"65","000","00","050","0016","0367","800","365","435","5","805","4042","0","19.92","9.03"
"65","000","00","050","0017","0000","1568","595","973","15","1583","3896","0","40.63","15.27"
"65","000","00","050","0017","0446","523","200","323","4","527","1258","0","41.89","15.90"
"65","000","00","050","0017","0447","546","206","340","6","552","1393","0","39.63","14.79"
"65","000","00","050","0017","0448","499","189","310","5","504","1245","0","40.48","15.18"
"65","000","00","050","0018","0000","2028","807","1221","19","2047","5058","0","40.47","15.95"
"65","000","00","050","0018","0510","552","257","295","4","556","1328","0","41.87","19.35"
"65","000","00","050","0018","0511","560","198","362","6","566","1160","0","48.79","17.07"
"65","000","00","050","0018","0512","475","178","297","7","482","1287","0","37.45","13.83"
"65","000","00","050","0018","0513","441","174","267","2","443","1283","0","34.53","13.56"
"65","000","00","050","0019","0000","730","377","353","10","740","1553","0","47.65","24.28"
"65","000","00","050","0019","0368","730","377","353","10","740","1553","0","47.65","24.28"
"65","000","00","050","0020","0000","760","292","468","5","765","1903","0","40.20","15.34"
"65","000","00","050","0020","0469","382","136","246","0","382","967","0","39.50","14.06"
"65","000","00","050","0020","0470","378","156","222","5","383","936","0","40.92","16.67"
"65","000","00","050","0021","0000","2404","974","1430","19","2423","6057","0","40.00","16.08"
"65","000","00","050","0021","0544","586","252","334","7","593","1490","0","39.80","16.91"
"65","000","00","050","0021","0545","630","241","389","6","636","1596","0","39.85","15.10"
"65","000","00","050","0021","0546","598","224","374","4","602","1471","0","40.92","15.23"
"65","000","00","050","0021","0547","590","257","333","2","592","1500","0","39.47","17.13"
"65","000","00","050","0022","0000","667","287","380","6","673","1547","0","43.50","18.55"
"65","000","00","050","0022","0369","667","287","380","6","673","1547","0","43.50","18.55"
"65","000","00","050","0023","0000","2326","1006","1320","24","2350","5390","0","43.60","18.66"
"65","000","00","050","0023","0471","538","224","314","6","544","1365","0","39.85","16.41"
"65","000","00","050","0023","0472","543","236","307","7","550","1369","0","40.18","17.24"
"65","000","00","050","0023","0473","643","288","355","9","652","1420","0","45.92","20.28"
"65","000","00","050","0023","0474","602","258","344","2","604","1236","0","48.87","20.87"
"65","000","00","050","0024","0000","855","372","483","10","865","2056","0","42.07","18.09"
"65","000","00","050","0024","0550","410","169","241","5","415","1010","0","41.09","16.73"
"65","000","00","050","0024","0551","445","203","242","5","450","1046","0","43.02","19.41"
"65","000","00","050","0025","0000","1987","837","1150","19","2006","4652","0","43.12","17.99"
"65","000","00","050","0025","0423","520","210","310","3","523","1163","0","44.97","18.06"
"65","000","00","050","0025","0424","483","200","283","8","491","1132","0","43.37","17.67"
"65","000","00","050","0025","0425","477","194","283","1","478","1173","0","40.75","16.54"
"65","000","00","050","0025","0426","507","233","274","7","514","1184","0","43.41","19.68"
"65","000","00","050","0026","0000","841","525","316","8","849","1674","0","50.72","31.36"
"65","000","00","050","0026","0439","392","208","184","5","397","811","0","48.95","25.65"
"65","000","00","050","0026","0440","449","317","132","3","452","863","0","52.38","36.73"
"65","000","00","050","0027","0000","1772","762","1010","19","1791","4664","0","38.40","16.34"
"65","000","00","050","0027","0570","400","172","228","4","404","1146","0","35.25","15.01"
"65","000","00","050","0027","0571","449","172","277","4","453","1091","0","41.52","15.77"
"65","000","00","050","0027","0572","459","199","260","6","465","1206","0","38.56","16.50"
"65","000","00","050","0027","0573","464","219","245","5","469","1221","0","38.41","17.94"
"65","000","00","050","0028","0000","937","353","584","9","946","2389","0","39.60","14.78"
"65","000","00","050","0028","0413","422","154","268","5","427","1153","0","37.03","13.36"
"65","000","00","050","0028","0414","515","199","316","4","519","1236","0","41.99","16.10"
"65","000","00","050","0029","0000","1049","512","537","2","1051","2305","0","45.60","22.21"
"65","000","00","050","0029","0441","542","279","263","1","543","1141","0","47.59","24.45"
"65","000","00","050","0029","0442","507","233","274","1","508","1164","0","43.64","20.02"
"65","000","00","050","0030","0000","1878","827","1051","19","1897","4652","0","40.78","17.78"
"65","000","00","050","0030","0400","435","197","238","4","439","1157","0","37.94","17.03"
"65","000","00","050","0030","0401","423","164","259","4","427","1032","0","41.38","15.89"
"65","000","00","050","0030","0402","513","209","304","3","516","1277","0","40.41","16.37"
"65","000","00","050","0030","0403","507","257","250","8","515","1186","0","43.42","21.67"
"65","000","00","050","0031","0000","1879","895","984","15","1894","4324","0","43.80","20.70"
"65","000","00","050","0031","0501","654","305","349","7","661","1478","0","44.72","20.64"
"65","000","00","050","0031","0502","638","309","329","3","641","1439","0","44.54","21.47"
"65","000","00","050","0031","0503","587","281","306","5","592","1407","0","42.08","19.97"
"65","000","00","050","0032","0000","1961","916","1045","26","1987","5143","0","38.64","17.81"
"65","000","00","050","0032","0586","434","174","260","6","440","1301","0","33.82","13.37"
"65","000","00","050","0032","0587","561","295","266","4","565","1355","0","41.70","21.77"
"65","000","00","050","0032","0588","484","196","288","10","494","1212","0","40.76","16.17"
"65","000","00","050","0032","0589","482","251","231","6","488","1275","0","38.27","19.69"
"65","000","00","050","0033","0000","1722","651","1071","16","1738","4178","0","41.60","15.58"
"65","000","00","050","0033","0391","489","186","303","5","494","1314","0","37.60","14.16"
"65","000","00","050","0033","0392","543","189","354","6","549","1354","0","40.55","13.96"
"65","000","00","050","0033","0393","690","276","414","5","695","1510","0","46.03","18.28"
"65","000","00","050","0034","0000","1249","526","723","9","1258","3266","0","38.52","16.11"
"65","000","00","050","0034","0495","339","153","186","3","342","982","0","34.83","15.58"
"65","000","00","050","0034","0496","442","200","242","3","445","1154","0","38.56","17.33"
"65","000","00","050","0034","0497","468","173","295","3","471","1130","0","41.68","15.31"
"65","000","00","050","0035","0000","1006","366","640","8","1014","2666","0","38.03","13.73"
"65","000","00","050","0035","0593","538","195","343","5","543","1348","0","40.28","14.47"
"65","000","00","050","0035","0594","468","171","297","3","471","1318","0","35.74","12.97"
"65","000","00","050","0036","0000","1485","603","882","11","1496","3422","0","43.72","17.62"
"65","000","00","050","0036","0370","447","141","306","1","448","1050","0","42.67","13.43"
"65","000","00","050","0036","0371","440","179","261","4","444","1037","0","42.82","17.26"
"65","000","00","050","0036","0372","598","283","315","6","604","1335","0","45.24","21.20"
"65","000","00","050","0037","0000","1487","598","889","10","1497","3451","0","43.38","17.33"
"65","000","00","050","0037","0455","472","173","299","2","474","1202","0","39.43","14.39"
"65","000","00","050","0037","0456","514","201","313","6","520","1157","0","44.94","17.37"
"65","000","00","050","0037","0457","501","224","277","2","503","1092","0","46.06","20.51"
"65","000","00","050","0038","0000","2236","989","1247","17","2253","6136","0","36.72","16.12"
"65","000","00","050","0038","0606","422","191","231","3","425","1263","0","33.65","15.12"
"65","000","00","050","0038","0607","450","192","258","5","455","1198","0","37.98","16.03"
"65","000","00","050","0038","0608","458","211","247","4","462","1292","0","35.76","16.33"
"65","000","00","050","0038","0609","373","130","243","2","375","1161","0","32.30","11.20"
"65","000","00","050","0038","0610","533","265","268","3","536","1222","0","43.86","21.69"
"65","000","00","050","0039","0000","1625","700","925","14","1639","3692","0","44.39","18.96"
"65","000","00","050","0039","0427","567","273","294","5","572","1210","0","47.27","22.56"
"65","000","00","050","0039","0428","514","196","318","8","522","1220","0","42.79","16.07"
"65","000","00","050","0039","0429","544","231","313","1","545","1262","0","43.19","18.30"
"65","000","00","050","0040","0000","774","348","426","1","775","1701","0","45.56","20.46"
"65","000","00","050","0040","0516","262","142","120","0","262","631","0","41.52","22.50"
"65","000","00","050","0040","0517","512","206","306","1","513","1070","0","47.94","19.25"
"65","000","00","050","0041","0000","1344","647","697","11","1355","3835","0","35.33","16.87"
"65","000","00","050","0041","0601","475","240","235","3","478","1327","0","36.02","18.09"
"65","000","00","050","0041","0602","447","210","237","5","452","1264","0","35.76","16.61"
"65","000","00","050","0041","0603","422","197","225","3","425","1244","0","34.16","15.84"
"65","000","00","050","0042","0000","844","346","498","6","850","2341","0","36.31","14.78"
"65","000","00","050","0042","0421","417","182","235","3","420","1134","0","37.04","16.05"
"65","000","00","050","0042","0422","427","164","263","3","430","1207","0","35.63","13.59"
"65","000","00","050","0043","0000","2912","1406","1506","26","2938","7720","0","38.06","18.21"
"65","000","00","050","0043","0518","527","233","294","1","528","1368","0","38.60","17.03"
"65","000","00","050","0043","0519","496","246","250","2","498","1377","0","36.17","17.86"
"65","000","00","050","0043","0520","514","226","288","5","519","1377","0","37.69","16.41"
"65","000","00","050","0043","0521","489","206","283","3","492","1260","0","39.05","16.35"
"65","000","00","050","0043","0522","492","278","214","13","505","1301","0","38.82","21.37"
"65","000","00","050","0043","0523","394","217","177","2","396","1037","0","38.19","20.93"
"65","000","00","050","0044","0000","1428","620","808","11","1439","4165","0","34.55","14.89"
"65","000","00","050","0044","0595","458","189","269","4","462","1390","0","33.24","13.60"
"65","000","00","050","0044","0596","480","211","269","2","482","1377","0","35.00","15.32"
"65","000","00","050","0044","0597","490","220","270","5","495","1398","0","35.41","15.74"
"65","000","00","050","0045","0000","1894","769","1125","30","1924","4667","0","41.23","16.48"
"65","000","00","050","0045","0417","534","226","308","7","541","1208","0","44.78","18.71"
"65","000","00","050","0045","0418","528","206","322","10","538","1241","0","43.35","16.60"
"65","000","00","050","0045","0419","466","182","284","7","473","1211","0","39.06","15.03"
"65","000","00","050","0045","0420","366","155","211","6","372","1007","0","36.94","15.39"
"65","000","00","050","0046","0000","1502","640","862","11","1513","4014","0","37.69","15.94"
"65","000","00","050","0046","0524","478","196","282","5","483","1300","0","37.15","15.08"
"65","000","00","050","0046","0525","492","225","267","3","495","1405","0","35.23","16.01"
"65","000","00","050","0046","0526","532","219","313","3","535","1309","0","40.87","16.73"
"65","000","00","050","0047","0000","1496","527","969","9","1505","3807","0","39.53","13.84"
"65","000","00","050","0047","0394","490","174","316","3","493","1264","0","39.00","13.77"
"65","000","00","050","0047","0395","477","170","307","3","480","1242","0","38.65","13.69"
"65","000","00","050","0047","0396","529","183","346","3","532","1301","0","40.89","14.07"
"65","000","00","050","0048","0000","3806","1906","1900","24","3830","9790","0","39.12","19.47"
"65","000","00","050","0048","0529","688","369","319","2","690","1613","0","42.78","22.88"
"65","000","00","050","0048","0530","592","312","280","7","599","1416","0","42.30","22.03"
"65","000","00","050","0048","0531","473","233","240","2","475","1379","0","34.45","16.90"
"65","000","00","050","0048","0532","523","256","267","3","526","1398","0","37.63","18.31"
"65","000","00","050","0048","0533","533","252","281","4","537","1322","0","40.62","19.06"
"65","000","00","050","0048","0534","501","241","260","3","504","1349","0","37.36","17.87"
"65","000","00","050","0048","0535","496","243","253","3","499","1313","0","38.00","18.51"
"65","000","00","050","0049","0000","866","343","523","6","872","2188","0","39.85","15.68"
"65","000","00","050","0049","0415","401","165","236","4","405","1043","0","38.83","15.82"
"65","000","00","050","0049","0416","465","178","287","2","467","1145","0","40.79","15.55"
"65","000","00","050","0050","0000","3414","1634","1780","24","3438","8555","0","40.19","19.10"
"65","000","00","050","0050","0538","597","253","344","7","604","1441","0","41.92","17.56"
"65","000","00","050","0050","0539","590","323","267","2","592","1445","0","40.97","22.35"
"65","000","00","050","0050","0540","534","221","313","3","537","1433","0","37.47","15.42"
"65","000","00","050","0050","0541","579","266","313","5","584","1467","0","39.81","18.13"
"65","000","00","050","0050","0542","551","294","257","5","556","1413","0","39.35","20.81"
"65","000","00","050","0050","0543","563","277","286","2","565","1356","0","41.67","20.43"
"65","000","00","050","0051","0000","1128","495","633","7","1135","2558","0","44.37","19.35"
"65","000","00","050","0051","0430","539","225","314","4","543","1229","0","44.18","18.31"
"65","000","00","050","0051","0431","589","270","319","3","592","1329","0","44.54","20.32"
"65","000","00","050","0052","0000","1709","763","946","15","1724","4343","0","39.70","17.57"
"65","000","00","050","0052","0492","624","267","357","6","630","1641","0","38.39","16.27"
"65","000","00","050","0052","0493","682","325","357","6","688","1673","0","41.12","19.43"
"65","000","00","050","0052","0494","403","171","232","3","406","1029","0","39.46","16.62"
"65","000","00","050","0053","0000","4535","2104","2431","33","4568","11108","0","41.12","18.94"
"65","000","00","050","0053","0485","955","487","468","4","959","2419","0","39.64","20.13"
"65","000","00","050","0053","0486","431","172","259","3","434","1169","0","37.13","14.71"
"65","000","00","050","0053","0487","514","232","282","2","516","1314","0","39.27","17.66"
"65","000","00","050","0053","0488","715","333","382","7","722","1625","0","44.43","20.49"
"65","000","00","050","0053","0489","612","286","326","4","616","1424","0","43.26","20.08"
"65","000","00","050","0053","0490","624","280","344","7","631","1491","0","42.32","18.78"
"65","000","00","050","0053","0491","684","314","370","6","690","1666","0","41.42","18.85"
"65","000","00","050","0054","0000","3019","1297","1722","19","3038","7280","0","41.73","17.82"
"65","000","00","050","0054","0475","607","265","342","2","609","1481","0","41.12","17.89"
"65","000","00","050","0054","0476","613","228","385","5","618","1414","0","43.71","16.12"
"65","000","00","050","0054","0477","603","266","337","7","610","1463","0","41.70","18.18"
"65","000","00","050","0054","0478","630","291","339","1","631","1448","0","43.58","20.10"
"65","000","00","050","0054","0479","566","247","319","4","570","1474","0","38.67","16.76"
"65","000","00","050","0055","0000","1464","614","850","18","1482","4090","0","36.23","15.01"
"65","000","00","050","0055","0567","485","197","288","3","488","1399","0","34.88","14.08"
"65","000","00","050","0055","0568","479","200","279","10","489","1304","0","37.50","15.34"
"65","000","00","050","0055","0569","500","217","283","5","505","1387","0","36.41","15.65"
"65","000","00","050","0056","0000","950","425","525","8","958","2178","0","43.99","19.51"
"65","000","00","050","0056","0560","467","236","231","7","474","1097","0","43.21","21.51"
"65","000","00","050","0056","0561","483","189","294","1","484","1081","0","44.77","17.48"
"65","000","00","050","0057","0000","1344","578","766","14","1358","3219","0","42.19","17.96"
"65","000","00","050","0057","0449","381","133","248","5","386","1064","0","36.28","12.50"
"65","000","00","050","0057","0450","537","240","297","3","540","1165","0","46.35","20.60"
"65","000","00","050","0057","0451","426","205","221","6","432","990","0","43.64","20.71"
"65","000","00","050","0058","0000","1194","426","768","10","1204","3118","0","38.61","13.66"
"65","000","00","050","0058","0452","425","146","279","3","428","1098","0","38.98","13.30"
"65","000","00","050","0058","0453","367","144","223","1","368","1004","0","36.65","14.34"
"65","000","00","050","0058","0454","402","136","266","6","408","1016","0","40.16","13.39"
"65","000","00","050","0059","0000","1857","865","992","18","1875","4308","0","43.52","20.08"
"65","000","00","050","0059","0498","608","279","329","12","620","1497","0","41.42","18.64"
"65","000","00","050","0059","0499","627","263","364","3","630","1366","0","46.12","19.25"
"65","000","00","050","0059","0500","622","323","299","3","625","1445","0","43.25","22.35"
"65","000","00","050","0060","0000","2097","1065","1032","14","2111","4287","0","49.24","24.84"
"65","000","00","050","0060","0353","701","391","310","7","708","1469","0","48.20","26.62"
"65","000","00","050","0060","0354","720","349","371","5","725","1480","0","48.99","23.58"
"65","000","00","050","0060","0355","676","325","351","2","678","1338","0","50.67","24.29"
"65","000","00","050","0061","0000","1275","461","814","6","1281","3271","0","39.16","14.09"
"65","000","00","050","0061","0410","421","150","271","1","422","1076","0","39.22","13.94"
"65","000","00","050","0061","0411","423","154","269","1","424","1060","0","40.00","14.53"
"65","000","00","050","0061","0412","431","157","274","4","435","1135","0","38.33","13.83"
"65","000","00","050","0062","0000","2471","1153","1318","15","2486","5316","0","46.76","21.69"
"65","000","00","050","0062","0465","627","304","323","4","631","1367","0","46.16","22.24"
"65","000","00","050","0062","0466","557","248","309","3","560","1240","0","45.16","20.00"
"65","000","00","050","0062","0467","622","293","329","4","626","1381","0","45.33","21.22"
"65","000","00","050","0062","0468","665","308","357","4","669","1328","0","50.38","23.19"
"65","000","00","050","0063","0000","1373","611","762","9","1382","3181","0","43.45","19.21"
"65","000","00","050","0063","0407","408","158","250","4","412","1004","0","41.04","15.74"
"65","000","00","050","0063","0408","454","191","263","4","458","1044","0","43.87","18.30"
"65","000","00","050","0063","0409","511","262","249","1","512","1133","0","45.19","23.12"
"65","000","00","050","0064","0000","2970","1414","1556","13","2983","7008","0","42.57","20.18"
"65","000","00","050","0064","0386","815","355","460","3","818","1912","0","42.78","18.57"
"65","000","00","050","0064","0387","495","242","253","0","495","1275","0","38.82","18.98"
"65","000","00","050","0064","0388","655","344","311","1","656","1417","0","46.29","24.28"
"65","000","00","050","0064","0389","510","234","276","7","517","1211","0","42.69","19.32"
"65","000","00","050","0064","0390","495","239","256","2","497","1193","0","41.66","20.03"
"65","000","00","050","0065","0000","1432","712","720","16","1448","2960","0","48.92","24.05"
"65","000","00","050","0065","0361","707","356","351","10","717","1451","0","49.41","24.53"
"65","000","00","050","0065","0362","725","356","369","6","731","1509","0","48.44","23.59"
"65","000","00","050","0066","0000","1274","559","715","10","1284","3234","0","39.70","17.29"
"65","000","00","050","0066","0557","422","207","215","6","428","1024","0","41.80","20.21"
"65","000","00","050","0066","0558","402","160","242","4","406","1046","0","38.81","15.30"
"65","000","00","050","0066","0559","450","192","258","0","450","1164","0","38.66","16.49"
"65","000","00","050","0067","0000","774","331","443","8","782","2075","0","37.69","15.95"
"65","000","00","050","0067","0548","380","141","239","2","382","1079","0","35.40","13.07"
"65","000","00","050","0067","0549","394","190","204","6","400","996","0","40.16","19.08"
"65","000","00","050","0068","0000","997","425","572","7","1004","2274","0","44.15","18.69"
"65","000","00","050","0068","0514","442","187","255","1","443","1141","0","38.83","16.39"
"65","000","00","050","0068","0515","555","238","317","6","561","1133","0","49.51","21.01"
"65","000","00","050","0069","0000","1278","589","689","10","1288","2720","0","47.35","21.65"
"65","000","00","050","0069","0555","610","281","329","4","614","1352","0","45.41","20.78"
"65","000","00","050","0069","0556","668","308","360","6","674","1368","0","49.27","22.51"
"65","000","00","050","0070","0000","2309","1017","1292","19","2328","5875","0","39.63","17.31"
"65","000","00","050","0070","0574","570","250","320","2","572","1453","0","39.37","17.21"
"65","000","00","050","0070","0575","563","255","308","4","567","1462","0","38.78","17.44"
"65","000","00","050","0070","0576","579","251","328","5","584","1460","0","40.00","17.19"
"65","000","00","050","0070","0577","597","261","336","8","605","1500","0","40.33","17.40"
"65","000","00","050","0071","0000","1615","697","918","7","1622","4416","0","36.73","15.78"
"65","000","00","050","0071","0583","538","217","321","3","541","1454","0","37.21","14.92"
"65","000","00","050","0071","0584","583","250","333","2","585","1517","0","38.56","16.48"
"65","000","00","050","0071","0585","494","230","264","2","496","1445","0","34.33","15.92"
"65","000","00","050","0072","0000","2278","974","1304","20","2298","5247","0","43.80","18.56"
"65","000","00","050","0072","0382","548","239","309","6","554","1319","0","42.00","18.12"
"65","000","00","050","0072","0383","632","248","384","6","638","1326","0","48.11","18.70"
"65","000","00","050","0072","0384","528","206","322","2","530","1238","0","42.81","16.64"
"65","000","00","050","0072","0385","570","281","289","6","576","1364","0","42.23","20.60"
"65","000","00","050","0073","0000","1349","613","736","9","1358","3272","0","41.50","18.73"
"65","000","00","050","0073","0404","465","213","252","1","466","1161","0","40.14","18.35"
"65","000","00","050","0073","0405","394","157","237","4","398","983","0","40.49","15.97"
"65","000","00","050","0073","0406","490","243","247","4","494","1128","0","43.79","21.54"
"65","000","00","050","0074","0000","1660","802","858","15","1675","3858","0","43.42","20.79"
"65","000","00","050","0074","0397","540","278","262","7","547","1233","0","44.36","22.55"
"65","000","00","050","0074","0398","556","238","318","1","557","1361","0","40.93","17.49"
"65","000","00","050","0074","0399","564","286","278","7","571","1264","0","45.17","22.63"
"65","000","00","050","0075","0000","3261","1670","1591","19","3280","7749","0","42.33","21.55"
"65","000","00","050","0075","0480","705","380","325","3","708","1510","0","46.89","25.17"
"65","000","00","050","0075","0481","633","331","302","2","635","1529","0","41.53","21.65"
"65","000","00","050","0075","0482","674","336","338","5","679","1635","0","41.53","20.55"
"65","000","00","050","0075","0483","642","318","324","5","647","1641","0","39.43","19.38"
"65","000","00","050","0075","0484","607","305","302","4","611","1434","0","42.61","21.27"
"65","000","00","050","0076","0000","4173","2146","2027","26","4199","9967","0","42.13","21.53"
"65","000","00","050","0076","0458","729","340","389","6","735","1697","0","43.31","20.04"
"65","000","00","050","0076","0459","573","262","311","5","578","1418","0","40.76","18.48"
"65","000","00","050","0076","0460","646","348","298","3","649","1434","0","45.26","24.27"
"65","000","00","050","0076","0461","568","318","250","2","570","1397","0","40.80","22.76"
"65","000","00","050","0076","0462","548","285","263","5","553","1274","0","43.41","22.37"
"65","000","00","050","0076","0463","570","286","284","4","574","1387","0","41.38","20.62"
"65","000","00","050","0076","0464","539","307","232","1","540","1360","0","39.71","22.57"
"65","000","00","050","0077","0000","957","445","512","15","972","2206","0","44.06","20.17"
"65","000","00","050","0077","0508","458","222","236","7","465","1079","0","43.10","20.57"
"65","000","00","050","0077","0509","499","223","276","8","507","1127","0","44.99","19.79"
"65","000","00","050","0078","0000","1453","686","767","7","1460","3404","0","42.89","20.15"
"65","000","00","050","0078","0552","489","203","286","1","490","1153","0","42.50","17.61"
"65","000","00","050","0078","0553","468","245","223","1","469","1058","0","44.33","23.16"
"65","000","00","050","0078","0554","496","238","258","5","501","1193","0","41.99","19.95"
"65","000","00","050","0079","0000","798","399","399","5","803","1990","0","40.35","20.05"
"65","000","00","050","0079","0536","429","218","211","3","432","1076","0","40.15","20.26"
"65","000","00","050","0079","0537","369","181","188","2","371","914","0","40.59","19.80"
"65","000","00","050","0080","0000","858","398","460","4","862","2133","0","40.41","18.66"
"65","000","00","050","0080","0527","432","216","216","4","436","1098","0","39.71","19.67"
"65","000","00","050","0080","0528","426","182","244","0","426","1035","0","41.16","17.58"
"65","000","00","050","0081","0000","1335","592","743","5","1340","3307","0","40.52","17.90"
"65","000","00","050","0081","0578","438","205","233","2","440","1043","0","42.19","19.65"
"65","000","00","050","0081","0579","480","220","260","2","482","1181","0","40.81","18.63"
"65","000","00","050","0081","0580","417","167","250","1","418","1083","0","38.60","15.42"
"65","000","00","050","0082","0000","1534","721","813","15","1549","3548","0","43.66","20.32"
"65","000","00","050","0082","0590","487","216","271","4","491","1179","0","41.65","18.32"
"65","000","00","050","0082","0591","473","252","221","4","477","1029","0","46.36","24.49"
"65","000","00","050","0082","0592","574","253","321","7","581","1340","0","43.36","18.88"
"65","000","00","050","0083","0000","1458","688","770","16","1474","3815","0","38.64","18.03"
"65","000","00","050","0083","0598","460","210","250","2","462","1268","0","36.44","16.56"
"65","000","00","050","0083","0599","510","228","282","5","515","1266","0","40.68","18.01"
"65","000","00","050","0083","0600","488","250","238","9","497","1281","0","38.80","19.52"
"65","000","00","050","0084","0000","899","351","548","8","907","2430","0","37.33","14.44"
"65","000","00","050","0084","0604","493","194","299","4","497","1231","0","40.37","15.76"
"65","000","00","050","0084","0605","406","157","249","4","410","1199","0","34.20","13.09"
"65","000","00","060","0000","0000","122741","77239","45502","1049","123790","265823","301768","46.57","29.06"
"65","000","00","060","0001","0000","1409","966","443","14","1423","2846","0","50.00","33.94"
"65","000","00","060","0001","2178","741","501","240","5","746","1426","0","52.31","35.13"
"65","000","00","060","0001","2179","668","465","203","9","677","1420","0","47.68","32.75"
"65","000","00","060","0002","0000","1688","1105","583","11","1699","3541","0","47.98","31.21"
"65","000","00","060","0002","2180","628","437","191","2","630","1329","0","47.40","32.88"
"65","000","00","060","0002","2181","492","312","180","4","496","1034","0","47.97","30.17"
"65","000","00","060","0002","2182","568","356","212","5","573","1178","0","48.64","30.22"
"65","000","00","060","0003","0000","1600","985","615","7","1607","3306","0","48.61","29.79"
"65","000","00","060","0003","2183","491","305","186","3","494","1047","0","47.18","29.13"
"65","000","00","060","0003","2184","586","358","228","2","588","1153","0","51.00","31.05"
"65","000","00","060","0003","2185","523","322","201","2","525","1106","0","47.47","29.11"
"65","000","00","060","0004","0000","1832","1138","694","20","1852","3497","0","52.96","32.54"
"65","000","00","060","0004","2186","525","300","225","6","531","1015","0","52.32","29.56"
"65","000","00","060","0004","2187","660","419","241","9","669","1251","0","53.48","33.49"
"65","000","00","060","0004","2188","647","419","228","5","652","1231","0","52.97","34.04"
"65","000","00","060","0005","0000","2489","1625","864","18","2507","4908","0","51.08","33.11"
"65","000","00","060","0005","2189","548","359","189","5","553","1117","0","49.51","32.14"
"65","000","00","060","0005","2190","674","455","219","4","678","1239","0","54.72","36.72"
"65","000","00","060","0005","2191","671","427","244","7","678","1293","0","52.44","33.02"
"65","000","00","060","0005","2192","596","384","212","2","598","1259","0","47.50","30.50"
"65","000","00","060","0006","0000","2528","1602","926","28","2556","4879","0","52.39","32.83"
"65","000","00","060","0006","2195","907","598","309","9","916","1685","0","54.36","35.49"
"65","000","00","060","0006","2196","555","384","171","4","559","1109","0","50.41","34.63"
"65","000","00","060","0006","2197","540","326","214","4","544","1027","0","52.97","31.74"
"65","000","00","060","0006","2198","526","294","232","11","537","1058","0","50.76","27.79"
"65","000","00","060","0007","0000","2455","1631","824","28","2483","4940","0","50.26","33.02"
"65","000","00","060","0007","2204","655","411","244","4","659","1268","0","51.97","32.41"
"65","000","00","060","0007","2205","566","389","177","9","575","1229","0","46.79","31.65"
"65","000","00","060","0007","2206","617","419","198","5","622","1196","0","52.01","35.03"
"65","000","00","060","0007","2207","617","412","205","10","627","1247","0","50.28","33.04"
"65","000","00","060","0008","0000","2995","1766","1229","22","3017","6086","0","49.57","29.02"
"65","000","00","060","0008","2208","453","290","163","2","455","971","0","46.86","29.87"
"65","000","00","060","0008","2209","1238","759","479","9","1247","2367","0","52.68","32.07"
"65","000","00","060","0008","2210","593","315","278","3","596","1283","0","46.45","24.55"
"65","000","00","060","0008","2211","711","402","309","8","719","1465","0","49.08","27.44"
"65","000","00","060","0009","0000","1075","738","337","8","1083","2525","0","42.89","29.23"
"65","000","00","060","0009","2212","553","362","191","2","555","1355","0","40.96","26.72"
"65","000","00","060","0009","2213","522","376","146","6","528","1170","0","45.13","32.14"
"65","000","00","060","0010","0000","1412","1160","252","13","1425","2477","0","57.53","46.83"
"65","000","00","060","0010","2214","733","615","118","8","741","1250","0","59.28","49.20"
"65","000","00","060","0010","2215","679","545","134","5","684","1227","0","55.75","44.42"
"65","000","00","060","0011","0000","1277","842","435","11","1288","2805","0","45.92","30.02"
"65","000","00","060","0011","2216","431","263","168","3","434","882","0","49.21","29.82"
"65","000","00","060","0011","2217","439","292","147","5","444","1009","0","44.00","28.94"
"65","000","00","060","0011","2218","407","287","120","3","410","914","0","44.86","31.40"
"65","000","00","060","0012","0000","576","343","233","7","583","1541","0","37.83","22.26"
"65","000","00","060","0012","2221","576","343","233","7","583","1541","0","37.83","22.26"
"65","000","00","060","0013","0000","1277","648","629","11","1288","2878","0","44.75","22.52"
"65","000","00","060","0013","2222","654","343","311","6","660","1460","0","45.21","23.49"
"65","000","00","060","0013","2223","623","305","318","5","628","1418","0","44.29","21.51"
"65","000","00","060","0014","0000","3373","2064","1309","23","3396","8098","0","41.94","25.49"
"65","000","00","060","0014","2224","645","420","225","3","648","1338","0","48.43","31.39"
"65","000","00","060","0014","2225","551","352","199","6","557","1317","0","42.29","26.73"
"65","000","00","060","0014","2226","441","225","216","1","442","1268","0","34.86","17.74"
"65","000","00","060","0014","2227","535","311","224","5","540","1382","0","39.07","22.50"
"65","000","00","060","0014","2228","578","345","233","3","581","1401","0","41.47","24.63"
"65","000","00","060","0014","2229","623","411","212","5","628","1392","0","45.11","29.53"
"65","000","00","060","0015","0000","1993","1120","873","10","2003","4606","0","43.49","24.32"
"65","000","00","060","0015","2235","506","300","206","2","508","1107","0","45.89","27.10"
"65","000","00","060","0015","2236","516","296","220","4","520","1192","0","43.62","24.83"
"65","000","00","060","0015","2237","445","235","210","1","446","1126","0","39.61","20.87"
"65","000","00","060","0015","2238","526","289","237","3","529","1181","0","44.79","24.47"
"65","000","00","060","0016","0000","4955","3063","1892","41","4996","11616","0","43.01","26.37"
"65","000","00","060","0016","2246","546","320","226","7","553","1259","0","43.92","25.42"
"65","000","00","060","0016","2247","544","307","237","1","545","1277","0","42.68","24.04"
"65","000","00","060","0016","2248","554","351","203","4","558","1322","0","42.21","26.55"
"65","000","00","060","0016","2249","550","336","214","2","552","1299","0","42.49","25.87"
"65","000","00","060","0016","2250","535","326","209","8","543","1242","0","43.72","26.25"
"65","000","00","060","0016","2251","531","351","180","3","534","1242","0","43.00","28.26"
"65","000","00","060","0016","2252","510","318","192","4","514","1307","0","39.33","24.33"
"65","000","00","060","0016","2253","592","386","206","2","594","1310","0","45.34","29.47"
"65","000","00","060","0016","2254","593","368","225","10","603","1358","0","44.40","27.10"
"65","000","00","060","0017","0000","2216","1226","990","22","2238","5492","0","40.75","22.32"
"65","000","00","060","0017","2259","573","320","253","4","577","1324","0","43.58","24.17"
"65","000","00","060","0017","2260","566","325","241","6","572","1328","0","43.07","24.47"
"65","000","00","060","0017","2261","590","322","268","9","599","1461","0","41.00","22.04"
"65","000","00","060","0017","2262","487","259","228","3","490","1379","0","35.53","18.78"
"65","000","00","060","0018","0000","2111","1166","945","22","2133","5146","0","41.45","22.66"
"65","000","00","060","0018","2271","519","279","240","5","524","1359","0","38.56","20.53"
"65","000","00","060","0018","2272","450","237","213","4","454","1145","0","39.65","20.70"
"65","000","00","060","0018","2273","623","388","235","7","630","1442","0","43.69","26.91"
"65","000","00","060","0018","2274","519","262","257","6","525","1200","0","43.75","21.83"
"65","000","00","060","0019","0000","1986","1040","946","14","2000","5288","0","37.82","19.67"
"65","000","00","060","0019","2283","510","255","255","2","512","1438","0","35.61","17.73"
"65","000","00","060","0019","2284","466","237","229","4","470","1232","0","38.15","19.24"
"65","000","00","060","0019","2285","524","281","243","4","528","1307","0","40.40","21.50"
"65","000","00","060","0019","2286","486","267","219","4","490","1311","0","37.38","20.37"
"65","000","00","060","0020","0000","2369","1533","836","14","2383","5383","0","44.27","28.48"
"65","000","00","060","0020","2287","512","312","200","1","513","1151","0","44.57","27.11"
"65","000","00","060","0020","2288","576","381","195","5","581","1311","0","44.32","29.06"
"65","000","00","060","0020","2289","559","357","202","7","566","1291","0","43.84","27.65"
"65","000","00","060","0020","2290","722","483","239","1","723","1630","0","44.36","29.63"
"65","000","00","060","0021","0000","379","98","281","3","382","928","0","41.16","10.56"
"65","000","00","060","0021","2295","379","98","281","3","382","928","0","41.16","10.56"
"65","000","00","060","0022","0000","2081","1273","808","17","2098","4705","0","44.59","27.06"
"65","000","00","060","0022","2302","480","306","174","4","484","1147","0","42.20","26.68"
"65","000","00","060","0022","2303","537","312","225","2","539","1274","0","42.31","24.49"
"65","000","00","060","0022","2304","489","272","217","8","497","1173","0","42.37","23.19"
"65","000","00","060","0022","2305","575","383","192","3","578","1111","0","52.03","34.47"
"65","000","00","060","0023","0000","1971","1200","771","15","1986","4714","0","42.13","25.46"
"65","000","00","060","0023","2306","600","373","227","4","604","1449","0","41.68","25.74"
"65","000","00","060","0023","2307","820","528","292","6","826","1912","0","43.20","27.62"
"65","000","00","060","0023","2308","551","299","252","5","556","1353","0","41.09","22.10"
"65","000","00","060","0024","0000","249","97","152","6","255","726","0","35.12","13.36"
"65","000","00","060","0024","2309","249","97","152","6","255","726","0","35.12","13.36"
"65","000","00","060","0025","0000","1384","712","672","14","1398","2813","0","49.70","25.31"
"65","000","00","060","0025","2310","280","126","154","3","283","562","0","50.36","22.42"
"65","000","00","060","0025","2311","397","206","191","4","401","879","0","45.62","23.44"
"65","000","00","060","0025","2312","499","285","214","6","505","927","0","54.48","30.74"
"65","000","00","060","0025","2313","208","95","113","1","209","445","0","46.97","21.35"
"65","000","00","060","0026","0000","942","460","482","9","951","2253","0","42.21","20.42"
"65","000","00","060","0026","2314","484","208","276","4","488","1100","0","44.36","18.91"
"65","000","00","060","0026","2315","458","252","206","5","463","1153","0","40.16","21.86"
"65","000","00","060","0027","0000","634","295","339","6","640","1598","0","40.05","18.46"
"65","000","00","060","0027","2316","634","295","339","6","640","1598","0","40.05","18.46"
"65","000","00","060","0028","0000","494","178","316","10","504","1264","0","39.87","14.08"
"65","000","00","060","0028","2317","494","178","316","10","504","1264","0","39.87","14.08"
"65","000","00","060","0029","0000","512","197","315","4","516","1196","0","43.14","16.47"
"65","000","00","060","0029","2318","146","32","114","3","149","431","0","34.57","7.42"
"65","000","00","060","0029","2319","366","165","201","1","367","765","0","47.97","21.57"
"65","000","00","060","0030","0000","2061","1213","848","20","2081","4825","0","43.13","25.14"
"65","000","00","060","0030","2298","603","342","261","8","611","1361","0","44.89","25.13"
"65","000","00","060","0030","2299","488","285","203","5","493","1168","0","42.21","24.40"
"65","000","00","060","0030","2300","441","280","161","4","445","1029","0","43.25","27.21"
"65","000","00","060","0030","2301","529","306","223","3","532","1267","0","41.99","24.15"
"65","000","00","060","0031","0000","754","385","369","6","760","1629","0","46.65","23.63"
"65","000","00","060","0031","2105","754","385","369","6","760","1629","0","46.65","23.63"
"65","000","00","060","0032","0000","1077","666","411","6","1083","2137","0","50.68","31.17"
"65","000","00","060","0032","2106","483","319","164","1","484","858","0","56.41","37.18"
"65","000","00","060","0032","2107","594","347","247","5","599","1279","0","46.83","27.13"
"65","000","00","060","0033","0000","1023","600","423","14","1037","2320","0","44.70","25.86"
"65","000","00","060","0033","2108","468","257","211","9","477","1098","0","43.44","23.41"
"65","000","00","060","0033","2109","555","343","212","5","560","1222","0","45.83","28.07"
"65","000","00","060","0034","0000","731","481","250","9","740","1575","0","46.98","30.54"
"65","000","00","060","0034","2110","731","481","250","9","740","1575","0","46.98","30.54"
"65","000","00","060","0035","0000","413","193","220","4","417","782","0","53.32","24.68"
"65","000","00","060","0035","2111","413","193","220","4","417","782","0","53.32","24.68"
"65","000","00","060","0036","0000","1132","613","519","5","1137","2230","0","50.99","27.49"
"65","000","00","060","0036","2112","632","319","313","2","634","1280","0","49.53","24.92"
"65","000","00","060","0036","2113","500","294","206","3","503","950","0","52.95","30.95"
"65","000","00","060","0037","0000","2408","1614","794","17","2425","6858","0","35.36","23.53"
"65","000","00","060","0037","2114","593","399","194","6","599","1221","0","49.06","32.68"
"65","000","00","060","0037","2115","715","493","222","4","719","3419","0","21.03","14.42"
"65","000","00","060","0037","2116","662","454","208","5","667","1257","0","53.06","36.12"
"65","000","00","060","0037","2117","438","268","170","2","440","961","0","45.79","27.89"
"65","000","00","060","0038","0000","2619","1705","914","29","2648","5204","0","50.88","32.76"
"65","000","00","060","0038","2118","424","273","151","7","431","898","0","48.00","30.40"
"65","000","00","060","0038","2119","921","689","232","10","931","1598","0","58.26","43.12"
"65","000","00","060","0038","2120","635","366","269","3","638","1327","0","48.08","27.58"
"65","000","00","060","0038","2121","639","377","262","9","648","1381","0","46.92","27.30"
"65","000","00","060","0039","0000","1085","642","443","7","1092","2418","0","45.16","26.55"
"65","000","00","060","0039","2122","547","338","209","3","550","1223","0","44.97","27.64"
"65","000","00","060","0039","2123","538","304","234","4","542","1195","0","45.36","25.44"
"65","000","00","060","0040","0000","3680","2426","1254","32","3712","8055","0","46.08","30.12"
"65","000","00","060","0040","2124","541","328","213","5","546","1251","0","43.65","26.22"
"65","000","00","060","0040","2125","634","393","241","8","642","1271","0","50.51","30.92"
"65","000","00","060","0040","2126","639","395","244","5","644","1432","0","44.97","27.58"
"65","000","00","060","0040","2127","678","480","198","6","684","1477","0","46.31","32.50"
"65","000","00","060","0040","2128","617","411","206","4","621","1382","0","44.93","29.74"
"65","000","00","060","0040","2129","571","419","152","4","575","1242","0","46.30","33.74"
"65","000","00","060","0041","0000","3336","2135","1201","21","3357","6910","0","48.58","30.90"
"65","000","00","060","0041","2130","528","350","178","5","533","1119","0","47.63","31.28"
"65","000","00","060","0041","2131","601","374","227","4","605","1189","0","50.88","31.46"
"65","000","00","060","0041","2132","520","324","196","1","521","1134","0","45.94","28.57"
"65","000","00","060","0041","2133","540","337","203","3","543","1106","0","49.10","30.47"
"65","000","00","060","0041","2134","605","428","177","4","609","1192","0","51.09","35.91"
"65","000","00","060","0041","2135","542","322","220","4","546","1170","0","46.67","27.52"
"65","000","00","060","0042","0000","1748","1183","565","15","1763","3647","0","48.34","32.44"
"65","000","00","060","0042","2138","570","386","184","5","575","1114","0","51.62","34.65"
"65","000","00","060","0042","2139","226","151","75","3","229","507","0","45.17","29.78"
"65","000","00","060","0042","2140","446","296","150","2","448","938","0","47.76","31.56"
"65","000","00","060","0042","2141","506","350","156","5","511","1088","0","46.97","32.17"
"65","000","00","060","0043","0000","1157","747","410","2","1159","2185","0","53.04","34.19"
"65","000","00","060","0043","2142","625","419","206","0","625","1105","0","56.56","37.92"
"65","000","00","060","0043","2143","532","328","204","2","534","1080","0","49.44","30.37"
"65","000","00","060","0044","0000","2620","1712","908","25","2645","5458","0","48.46","31.37"
"65","000","00","060","0044","2144","721","442","279","8","729","1416","0","51.48","31.21"
"65","000","00","060","0044","2145","607","373","234","6","613","1353","0","45.31","27.57"
"65","000","00","060","0044","2146","715","483","232","6","721","1336","0","53.97","36.15"
"65","000","00","060","0044","2147","577","414","163","5","582","1353","0","43.02","30.60"
"65","000","00","060","0045","0000","1876","1299","577","16","1892","3832","0","49.37","33.90"
"65","000","00","060","0045","2148","623","432","191","4","627","1247","0","50.28","34.64"
"65","000","00","060","0045","2149","604","414","190","6","610","1201","0","50.79","34.47"
"65","000","00","060","0045","2150","649","453","196","6","655","1384","0","47.33","32.73"
"65","000","00","060","0046","0000","925","624","301","10","935","1791","0","52.21","34.84"
"65","000","00","060","0046","2151","474","312","162","4","478","919","0","52.01","33.95"
"65","000","00","060","0046","2152","451","312","139","6","457","872","0","52.41","35.78"
"65","000","00","060","0047","0000","1644","1104","540","18","1662","3376","0","49.23","32.70"
"65","000","00","060","0047","2155","406","278","128","8","414","922","0","44.90","30.15"
"65","000","00","060","0047","2156","538","361","177","6","544","1082","0","50.28","33.36"
"65","000","00","060","0047","2157","700","465","235","4","704","1372","0","51.31","33.89"
"65","000","00","060","0048","0000","1413","886","527","7","1420","2847","0","49.88","31.12"
"65","000","00","060","0048","2158","726","448","278","3","729","1420","0","51.34","31.55"
"65","000","00","060","0048","2159","687","438","249","4","691","1427","0","48.42","30.69"
"65","000","00","060","0049","0000","1567","983","584","21","1588","3469","0","45.78","28.34"
"65","000","00","060","0049","2160","495","319","176","5","500","1183","0","42.27","26.97"
"65","000","00","060","0049","2161","629","407","222","8","637","1283","0","49.65","31.72"
"65","000","00","060","0049","2162","443","257","186","8","451","1003","0","44.97","25.62"
"65","000","00","060","0050","0000","1682","1094","588","11","1693","3294","0","51.40","33.21"
"65","000","00","060","0050","2163","581","381","200","4","585","1113","0","52.56","34.23"
"65","000","00","060","0050","2164","508","331","177","6","514","1035","0","49.66","31.98"
"65","000","00","060","0050","2165","593","382","211","1","594","1146","0","51.83","33.33"
"65","000","00","060","0051","0000","1839","1326","513","9","1848","3726","0","49.60","35.59"
"65","000","00","060","0051","2166","706","514","192","3","709","1277","0","55.52","40.25"
"65","000","00","060","0051","2167","616","445","171","3","619","1282","0","48.28","34.71"
"65","000","00","060","0051","2168","517","367","150","3","520","1167","0","44.56","31.45"
"65","000","00","060","0052","0000","2324","1643","681","19","2343","4191","0","55.91","39.20"
"65","000","00","060","0052","2169","468","339","129","6","474","872","0","54.36","38.88"
"65","000","00","060","0052","2170","1071","745","326","6","1077","1924","0","55.98","38.72"
"65","000","00","060","0052","2171","785","559","226","7","792","1395","0","56.77","40.07"
"65","000","00","060","0053","0000","550","353","197","12","562","1240","0","45.32","28.47"
"65","000","00","060","0053","2172","249","163","86","5","254","573","0","44.33","28.45"
"65","000","00","060","0053","2173","301","190","111","7","308","667","0","46.18","28.49"
"65","000","00","060","0054","0000","2871","1919","952","17","2888","5278","0","54.72","36.36"
"65","000","00","060","0054","2174","780","511","269","4","784","1436","0","54.60","35.58"
"65","000","00","060","0054","2175","638","443","195","5","643","1195","0","53.81","37.07"
"65","000","00","060","0054","2176","765","506","259","5","770","1403","0","54.88","36.07"
"65","000","00","060","0054","2177","688","459","229","3","691","1244","0","55.55","36.90"
"65","000","00","060","0055","0000","1471","1007","464","3","1474","3130","0","47.09","32.17"
"65","000","00","060","0055","2266","803","540","263","2","805","1707","0","47.16","31.63"
"65","000","00","060","0055","2267","668","467","201","1","669","1423","0","47.01","32.82"
"65","000","00","060","0056","0000","3095","1846","1249","29","3124","7029","0","44.44","26.26"
"65","000","00","060","0056","2230","781","480","301","7","788","1612","0","48.88","29.78"
"65","000","00","060","0056","2231","582","334","248","5","587","1376","0","42.66","24.27"
"65","000","00","060","0056","2232","599","351","248","7","606","1368","0","44.30","25.66"
"65","000","00","060","0056","2233","589","366","223","6","595","1328","0","44.80","27.56"
"65","000","00","060","0056","2234","544","315","229","4","548","1345","0","40.74","23.42"
"65","000","00","060","0057","0000","2023","1402","621","27","2050","4302","0","47.65","32.59"
"65","000","00","060","0057","2291","574","410","164","9","583","1226","0","47.55","33.44"
"65","000","00","060","0057","2292","572","410","162","8","580","1283","0","45.21","31.96"
"65","000","00","060","0057","2293","494","333","161","6","500","1032","0","48.45","32.27"
"65","000","00","060","0057","2294","383","249","134","4","387","761","0","50.85","32.72"
"65","000","00","060","0058","0000","3227","2070","1157","21","3248","6458","0","50.29","32.05"
"65","000","00","060","0058","2199","745","519","226","5","750","1341","0","55.93","38.70"
"65","000","00","060","0058","2200","599","305","294","6","605","1330","0","45.49","22.93"
"65","000","00","060","0058","2201","340","192","148","1","341","889","0","38.36","21.60"
"65","000","00","060","0058","2202","770","539","231","2","772","1413","0","54.64","38.15"
"65","000","00","060","0058","2203","773","515","258","7","780","1485","0","52.53","34.68"
"65","000","00","060","0059","0000","1657","1100","557","16","1673","3305","0","50.62","33.28"
"65","000","00","060","0059","2268","588","367","221","8","596","1133","0","52.60","32.39"
"65","000","00","060","0059","2269","582","408","174","7","589","1178","0","50.00","34.63"
"65","000","00","060","0059","2270","487","325","162","1","488","994","0","49.09","32.70"
"65","000","00","060","0060","0000","4469","3029","1440","37","4506","10096","0","44.63","30.00"
"65","000","00","060","0060","2275","674","423","251","2","676","1451","0","46.59","29.15"
"65","000","00","060","0060","2276","543","364","179","0","543","1170","0","46.41","31.11"
"65","000","00","060","0060","2277","521","351","170","6","527","1235","0","42.67","28.42"
"65","000","00","060","0060","2278","503","374","129","2","505","1262","0","40.02","29.64"
"65","000","00","060","0060","2279","447","312","135","8","455","1030","0","44.17","30.29"
"65","000","00","060","0060","2280","415","286","129","4","419","1123","0","37.31","25.47"
"65","000","00","060","0060","2281","620","398","222","7","627","1161","0","54.01","34.28"
"65","000","00","060","0060","2282","746","521","225","8","754","1664","0","45.31","31.31"
"65","000","00","060","0061","0000","1384","953","431","14","1398","2786","0","50.18","34.21"
"65","000","00","060","0061","2153","680","467","213","8","688","1436","0","47.91","32.52"
"65","000","00","060","0061","2154","704","486","218","6","710","1350","0","52.59","36.00"
"65","000","00","060","0062","0000","1194","737","457","8","1202","2930","0","41.02","25.15"
"65","000","00","060","0062","2193","556","312","244","3","559","1430","0","39.09","21.82"
"65","000","00","060","0062","2194","638","425","213","5","643","1500","0","42.87","28.33"
"65","000","00","060","0063","0000","1135","692","443","13","1148","2466","0","46.55","28.06"
"65","000","00","060","0063","2219","565","343","222","6","571","1244","0","45.90","27.57"
"65","000","00","060","0063","2220","570","349","221","7","577","1222","0","47.22","28.56"
"65","000","00","060","0064","0000","2255","1422","833","24","2279","4853","0","46.96","29.30"
"65","000","00","060","0064","2255","524","335","189","5","529","1202","0","44.01","27.87"
"65","000","00","060","0064","2256","526","321","205","7","533","1151","0","46.31","27.89"
"65","000","00","060","0064","2257","630","420","210","6","636","1313","0","48.44","31.99"
"65","000","00","060","0064","2258","575","346","229","6","581","1187","0","48.95","29.15"
"65","000","00","060","0065","0000","1224","795","429","11","1235","2304","0","53.60","34.51"
"65","000","00","060","0065","2136","629","397","232","5","634","1178","0","53.82","33.70"
"65","000","00","060","0065","2137","595","398","197","6","601","1126","0","53.37","35.35"
"65","000","00","060","0066","0000","1656","1071","585","16","1672","3718","0","44.97","28.81"
"65","000","00","060","0066","2239","564","387","177","5","569","1296","0","43.90","29.86"
"65","000","00","060","0066","2240","584","377","207","7","591","1276","0","46.32","29.55"
"65","000","00","060","0066","2241","508","307","201","4","512","1146","0","44.68","26.79"
"65","000","00","060","0067","0000","2183","1281","902","23","2206","4949","0","44.57","25.88"
"65","000","00","060","0067","2242","513","315","198","4","517","1278","0","40.45","24.65"
"65","000","00","060","0067","2243","620","378","242","3","623","1230","0","50.65","30.73"
"65","000","00","060","0067","2244","557","327","230","12","569","1299","0","43.80","25.17"
"65","000","00","060","0067","2245","493","261","232","4","497","1142","0","43.52","22.85"
"65","000","00","060","0068","0000","1668","1205","463","11","1679","3614","0","46.46","33.34"
"65","000","00","060","0068","2263","334","242","92","4","338","799","0","42.30","30.29"
"65","000","00","060","0068","2264","613","436","177","5","618","1213","0","50.95","35.94"
"65","000","00","060","0068","2265","721","527","194","2","723","1602","0","45.13","32.90"
"65","000","00","060","0069","0000","1303","812","491","16","1319","2551","0","51.71","31.83"
"65","000","00","060","0069","2296","541","335","206","8","549","1042","0","52.69","32.15"
"65","000","00","060","0069","2297","762","477","285","8","770","1509","0","51.03","31.61"
"65","000","00","070","0000","0000","61515","28158","33357","508","62023","152907","182668","40.56","18.42"
"65","000","00","070","0001","0000","1390","556","834","11","1401","3594","0","38.98","15.47"
"65","000","00","070","0001","1726","676","268","408","6","682","1939","0","35.17","13.82"
"65","000","00","070","0001","1727","714","288","426","5","719","1655","0","43.44","17.40"
"65","000","00","070","0002","0000","1336","647","689","17","1353","3437","0","39.37","18.82"
"65","000","00","070","0002","1723","419","182","237","3","422","1105","0","38.19","16.47"
"65","000","00","070","0002","1724","409","194","215","9","418","1093","0","38.24","17.75"
"65","000","00","070","0002","1725","508","271","237","5","513","1239","0","41.40","21.87"
"65","000","00","070","0003","0000","1566","686","880","14","1580","4203","0","37.59","16.32"
"65","000","00","070","0003","1720","436","207","229","2","438","1189","0","36.84","17.41"
"65","000","00","070","0003","1721","515","233","282","3","518","1351","0","38.34","17.25"
"65","000","00","070","0003","1722","615","246","369","9","624","1663","0","37.52","14.79"
"65","000","00","070","0004","0000","1330","522","808","14","1344","3354","0","40.07","15.56"
"65","000","00","070","0004","1749","455","186","269","4","459","1041","0","44.09","17.87"
"65","000","00","070","0004","1750","428","155","273","6","434","1133","0","38.31","13.68"
"65","000","00","070","0004","1751","447","181","266","4","451","1180","0","38.22","15.34"
"65","000","00","070","0005","0000","2357","1061","1296","17","2374","5473","0","43.38","19.39"
"65","000","00","070","0005","1745","629","259","370","4","633","1476","0","42.89","17.55"
"65","000","00","070","0005","1746","688","342","346","7","695","1500","0","46.33","22.80"
"65","000","00","070","0005","1747","604","285","319","5","609","1443","0","42.20","19.75"
"65","000","00","070","0005","1748","436","175","261","1","437","1054","0","41.46","16.60"
"65","000","00","070","0006","0000","1552","669","883","12","1564","4463","0","35.04","14.99"
"65","000","00","070","0006","1739","540","188","352","3","543","2105","0","25.80","8.93"
"65","000","00","070","0006","1740","393","197","196","4","397","870","0","45.63","22.64"
"65","000","00","070","0006","1741","619","284","335","5","624","1488","0","41.94","19.09"
"65","000","00","070","0007","0000","1545","591","954","16","1561","4406","0","35.43","13.41"
"65","000","00","070","0007","1730","573","207","366","6","579","1428","0","40.55","14.50"
"65","000","00","070","0007","1731","504","188","316","5","509","1439","0","35.37","13.06"
"65","000","00","070","0007","1732","468","196","272","5","473","1539","0","30.73","12.74"
"65","000","00","070","0008","0000","1491","731","760","10","1501","3190","0","47.05","22.92"
"65","000","00","070","0008","1758","396","208","188","2","398","883","0","45.07","23.56"
"65","000","00","070","0008","1759","647","307","340","2","649","1314","0","49.39","23.36"
"65","000","00","070","0008","1760","448","216","232","6","454","993","0","45.72","21.75"
"65","000","00","070","0009","0000","2100","1007","1093","13","2113","4496","0","47.00","22.40"
"65","000","00","070","0009","1763","667","331","336","5","672","1381","0","48.66","23.97"
"65","000","00","070","0009","1764","752","361","391","2","754","1580","0","47.72","22.85"
"65","000","00","070","0009","1765","681","315","366","6","687","1535","0","44.76","20.52"
"65","000","00","070","0010","0000","1629","731","898","7","1636","3699","0","44.23","19.76"
"65","000","00","070","0010","1773","515","195","320","3","518","1189","0","43.57","16.40"
"65","000","00","070","0010","1774","581","283","298","1","582","1306","0","44.56","21.67"
"65","000","00","070","0010","1775","533","253","280","3","536","1204","0","44.52","21.01"
"65","000","00","070","0011","0000","1220","631","589","8","1228","2937","0","41.81","21.48"
"65","000","00","070","0011","1769","696","360","336","3","699","1698","0","41.17","21.20"
"65","000","00","070","0011","1770","524","271","253","5","529","1239","0","42.70","21.87"
"65","000","00","070","0012","0000","588","231","357","3","591","1506","0","39.24","15.34"
"65","000","00","070","0012","1776","588","231","357","3","591","1506","0","39.24","15.34"
"65","000","00","070","0013","0000","445","222","223","1","446","1073","0","41.57","20.69"
"65","000","00","070","0013","1777","445","222","223","1","446","1073","0","41.57","20.69"
"65","000","00","070","0014","0000","1312","654","658","11","1323","3130","0","42.27","20.89"
"65","000","00","070","0014","1792","676","345","331","4","680","1495","0","45.48","23.08"
"65","000","00","070","0014","1793","636","309","327","7","643","1635","0","39.33","18.90"
"65","000","00","070","0015","0000","1339","556","783","15","1354","3345","0","40.48","16.62"
"65","000","00","070","0015","1782","505","234","271","1","506","1218","0","41.54","19.21"
"65","000","00","070","0015","1783","423","176","247","4","427","1087","0","39.28","16.19"
"65","000","00","070","0015","1784","411","146","265","10","421","1040","0","40.48","14.04"
"65","000","00","070","0016","0000","1555","624","931","12","1567","4373","0","35.83","14.27"
"65","000","00","070","0016","1789","547","203","344","5","552","1502","0","36.75","13.52"
"65","000","00","070","0016","1790","520","219","301","2","522","1432","0","36.45","15.29"
"65","000","00","070","0016","1791","488","202","286","5","493","1439","0","34.26","14.04"
"65","000","00","070","0017","0000","1820","815","1005","13","1833","4657","0","39.36","17.50"
"65","000","00","070","0017","1779","641","308","333","3","644","1718","0","37.49","17.93"
"65","000","00","070","0017","1780","587","227","360","7","594","1506","0","39.44","15.07"
"65","000","00","070","0017","1781","592","280","312","3","595","1433","0","41.52","19.54"
"65","000","00","070","0018","0000","1099","484","615","13","1112","2876","0","38.66","16.83"
"65","000","00","070","0018","1805","650","281","369","4","654","1634","0","40.02","17.20"
"65","000","00","070","0018","1806","449","203","246","9","458","1242","0","36.88","16.34"
"65","000","00","070","0019","0000","1991","920","1071","9","2000","5229","0","38.25","17.59"
"65","000","00","070","0019","1801","497","220","277","3","500","1284","0","38.94","17.13"
"65","000","00","070","0019","1802","449","205","244","0","449","1236","0","36.33","16.59"
"65","000","00","070","0019","1803","480","230","250","2","482","1378","0","34.98","16.69"
"65","000","00","070","0019","1804","565","265","300","4","569","1331","0","42.75","19.91"
"65","000","00","070","0020","0000","1766","775","991","24","1790","4435","0","40.36","17.47"
"65","000","00","070","0020","1798","767","304","463","6","773","1881","0","41.10","16.16"
"65","000","00","070","0020","1799","647","292","355","13","660","1685","0","39.17","17.33"
"65","000","00","070","0020","1800","352","179","173","5","357","869","0","41.08","20.60"
"65","000","00","070","0021","0000","628","284","344","6","634","1769","0","35.84","16.05"
"65","000","00","070","0021","1814","628","284","344","6","634","1769","0","35.84","16.05"
"65","000","00","070","0022","0000","603","186","417","2","605","1494","0","40.50","12.45"
"65","000","00","070","0022","1828","603","186","417","2","605","1494","0","40.50","12.45"
"65","000","00","070","0023","0000","635","230","405","12","647","1602","0","40.39","14.36"
"65","000","00","070","0023","1820","635","230","405","12","647","1602","0","40.39","14.36"
"65","000","00","070","0024","0000","5260","2932","2328","34","5294","12321","0","42.97","23.80"
"65","000","00","070","0024","1821","727","340","387","3","730","1661","0","43.95","20.47"
"65","000","00","070","0024","1822","703","376","327","2","705","1589","0","44.37","23.66"
"65","000","00","070","0024","1823","864","487","377","6","870","1818","0","47.85","26.79"
"65","000","00","070","0024","1824","805","463","342","6","811","1807","0","44.88","25.62"
"65","000","00","070","0024","1825","784","491","293","2","786","1741","0","45.15","28.20"
"65","000","00","070","0024","1826","705","403","302","6","711","1890","0","37.62","21.32"
"65","000","00","070","0024","1827","672","372","300","9","681","1815","0","37.52","20.50"
"65","000","00","070","0025","0000","788","265","523","8","796","1967","0","40.47","13.47"
"65","000","00","070","0025","1829","358","127","231","4","362","926","0","39.09","13.71"
"65","000","00","070","0025","1830","430","138","292","4","434","1041","0","41.69","13.26"
"65","000","00","070","0026","0000","3496","1922","1574","25","3521","8030","0","43.85","23.94"
"65","000","00","070","0026","1815","556","215","341","6","562","1414","0","39.75","15.21"
"65","000","00","070","0026","1816","728","405","323","6","734","1769","0","41.49","22.89"
"65","000","00","070","0026","1817","779","444","335","5","784","1718","0","45.63","25.84"
"65","000","00","070","0026","1818","835","478","357","5","840","1722","0","48.78","27.76"
"65","000","00","070","0026","1819","598","380","218","3","601","1407","0","42.71","27.01"
"65","000","00","070","0027","0000","429","207","222","1","430","853","0","50.41","24.27"
"65","000","00","070","0027","1778","429","207","222","1","430","853","0","50.41","24.27"
"65","000","00","070","0028","0000","1535","717","818","8","1543","3833","0","40.26","18.71"
"65","000","00","070","0028","1752","579","279","300","0","579","1521","0","38.07","18.34"
"65","000","00","070","0028","1753","483","223","260","5","488","1147","0","42.55","19.44"
"65","000","00","070","0028","1754","473","215","258","3","476","1165","0","40.86","18.45"
"65","000","00","070","0029","0000","1328","628","700","12","1340","3184","0","42.09","19.72"
"65","000","00","070","0029","1766","395","214","181","3","398","1021","0","38.98","20.96"
"65","000","00","070","0029","1767","520","232","288","7","527","1182","0","44.59","19.63"
"65","000","00","070","0029","1768","413","182","231","2","415","981","0","42.30","18.55"
"65","000","00","070","0030","0000","1500","703","797","22","1522","3145","0","48.39","22.35"
"65","000","00","070","0030","1761","734","351","383","13","747","1619","0","46.14","21.68"
"65","000","00","070","0030","1762","766","352","414","9","775","1526","0","50.79","23.07"
"65","000","00","070","0031","0000","1359","578","781","9","1368","3600","0","38.00","16.06"
"65","000","00","070","0031","1733","462","194","268","4","466","1168","0","39.90","16.61"
"65","000","00","070","0031","1734","435","184","251","2","437","1301","0","33.59","14.14"
"65","000","00","070","0031","1735","462","200","262","3","465","1131","0","41.11","17.68"
"65","000","00","070","0032","0000","1467","621","846","19","1486","3906","0","38.04","15.90"
"65","000","00","070","0032","1736","451","197","254","6","457","1224","0","37.34","16.09"
"65","000","00","070","0032","1737","536","218","318","7","543","1374","0","39.52","15.87"
"65","000","00","070","0032","1738","480","206","274","6","486","1308","0","37.16","15.75"
"65","000","00","070","0033","0000","1825","758","1067","10","1835","5086","0","36.08","14.90"
"65","000","00","070","0033","1785","406","178","228","2","408","1134","0","35.98","15.70"
"65","000","00","070","0033","1786","399","198","201","3","402","1201","0","33.47","16.49"
"65","000","00","070","0033","1787","460","179","281","3","463","1264","0","36.63","14.16"
"65","000","00","070","0033","1788","560","203","357","2","562","1487","0","37.79","13.65"
"65","000","00","070","0034","0000","1833","846","987","28","1861","4401","0","42.29","19.22"
"65","000","00","070","0034","1742","597","267","330","8","605","1397","0","43.31","19.11"
"65","000","00","070","0034","1743","616","279","337","14","630","1455","0","43.30","19.18"
"65","000","00","070","0034","1744","620","300","320","6","626","1549","0","40.41","19.37"
"65","000","00","070","0035","0000","1878","828","1050","13","1891","5096","0","37.11","16.25"
"65","000","00","070","0035","1807","428","174","254","3","431","1320","0","32.65","13.18"
"65","000","00","070","0035","1808","602","239","363","4","606","1594","0","38.02","14.99"
"65","000","00","070","0035","1809","407","215","192","2","409","1062","0","38.51","20.24"
"65","000","00","070","0035","1810","441","200","241","4","445","1120","0","39.73","17.86"
"65","000","00","070","0036","0000","1838","794","1044","19","1857","4640","0","40.02","17.11"
"65","000","00","070","0036","1811","647","279","368","5","652","1604","0","40.65","17.39"
"65","000","00","070","0036","1812","628","288","340","6","634","1501","0","42.24","19.19"
"65","000","00","070","0036","1813","563","227","336","8","571","1535","0","37.20","14.79"
"65","000","00","070","0037","0000","1249","596","653","9","1258","2790","0","45.09","21.36"
"65","000","00","070","0037","1771","648","294","354","3","651","1461","0","44.56","20.12"
"65","000","00","070","0037","1772","601","302","299","6","607","1329","0","45.67","22.72"
"65","000","00","070","0038","0000","1108","541","567","9","1117","3019","0","37.00","17.92"
"65","000","00","070","0038","1794","567","272","295","4","571","1594","0","35.82","17.06"
"65","000","00","070","0038","1795","541","269","272","5","546","1425","0","38.32","18.88"
"65","000","00","070","0039","0000","860","382","478","4","864","2412","0","35.82","15.84"
"65","000","00","070","0039","1796","413","203","210","2","415","1168","0","35.53","17.38"
"65","000","00","070","0039","1797","447","179","268","2","449","1244","0","36.09","14.39"
"65","000","00","070","0040","0000","1033","490","543","11","1044","2578","0","40.50","19.01"
"65","000","00","070","0040","1755","513","237","276","4","517","1260","0","41.03","18.81"
"65","000","00","070","0040","1756","520","253","267","7","527","1318","0","39.98","19.20"
"65","000","00","070","0041","0000","612","201","411","2","614","1430","0","42.94","14.06"
"65","000","00","070","0041","1757","612","201","411","2","614","1430","0","42.94","14.06"
"65","000","00","070","0042","0000","820","336","484","5","825","1875","0","44.00","17.92"
"65","000","00","070","0042","1728","293","114","179","4","297","737","0","40.30","15.47"
"65","000","00","070","0042","1729","527","222","305","1","528","1138","0","46.40","19.51"
"65","000","00","080","0000","0000","28943","13431","15512","239","29182","73981","88131","39.45","18.15"
"65","000","00","080","0001","0000","442","198","244","4","446","946","0","47.15","20.93"
"65","000","00","080","0001","1832","442","198","244","4","446","946","0","47.15","20.93"
"65","000","00","080","0002","0000","864","421","443","3","867","1968","0","44.05","21.39"
"65","000","00","080","0002","1836","450","220","230","1","451","978","0","46.11","22.49"
"65","000","00","080","0002","1837","414","201","213","2","416","990","0","42.02","20.30"
"65","000","00","080","0003","0000","2135","971","1164","14","2149","4997","0","43.01","19.43"
"65","000","00","080","0003","1839","758","336","422","7","765","1745","0","43.84","19.26"
"65","000","00","080","0003","1840","696","320","376","4","700","1634","0","42.84","19.58"
"65","000","00","080","0003","1841","681","315","366","3","684","1618","0","42.27","19.47"
"65","000","00","080","0004","0000","1478","782","696","17","1495","3748","0","39.89","20.86"
"65","000","00","080","0004","1833","437","231","206","6","443","967","0","45.81","23.89"
"65","000","00","080","0004","1834","503","260","243","3","506","1447","0","34.97","17.97"
"65","000","00","080","0004","1835","538","291","247","8","546","1334","0","40.93","21.81"
"65","000","00","080","0005","0000","465","210","255","3","468","940","0","49.79","22.34"
"65","000","00","080","0005","1838","465","210","255","3","468","940","0","49.79","22.34"
"65","000","00","080","0006","0000","241","106","135","0","241","518","0","46.53","20.46"
"65","000","00","080","0006","1831","241","106","135","0","241","518","0","46.53","20.46"
"65","000","00","080","0007","0000","637","271","366","1","638","1386","0","46.03","19.55"
"65","000","00","080","0007","1860","637","271","366","1","638","1386","0","46.03","19.55"
"65","000","00","080","0008","0000","2837","1330","1507","27","2864","7317","0","39.14","18.18"
"65","000","00","080","0008","1861","534","263","271","6","540","1292","0","41.80","20.36"
"65","000","00","080","0008","1862","527","263","264","4","531","1341","0","39.60","19.61"
"65","000","00","080","0008","1863","446","199","247","2","448","1229","0","36.45","16.19"
"65","000","00","080","0008","1864","449","221","228","5","454","1334","0","34.03","16.57"
"65","000","00","080","0008","1865","450","195","255","4","454","1027","0","44.21","18.99"
"65","000","00","080","0008","1866","431","189","242","6","437","1094","0","39.95","17.28"
"65","000","00","080","0009","0000","1318","551","767","11","1329","3154","0","42.14","17.47"
"65","000","00","080","0009","1857","391","193","198","2","393","884","0","44.46","21.83"
"65","000","00","080","0009","1858","590","224","366","7","597","1324","0","45.09","16.92"
"65","000","00","080","0009","1859","337","134","203","2","339","946","0","35.84","14.16"
"65","000","00","080","0010","0000","2945","1342","1603","26","2971","7755","0","38.31","17.30"
"65","000","00","080","0010","1852","681","316","365","3","684","1700","0","40.24","18.59"
"65","000","00","080","0010","1853","685","308","377","6","691","1670","0","41.38","18.44"
"65","000","00","080","0010","1854","515","253","262","2","517","1471","0","35.15","17.20"
"65","000","00","080","0010","1855","493","222","271","7","500","1295","0","38.61","17.14"
"65","000","00","080","0010","1856","571","243","328","8","579","1619","0","35.76","15.01"
"65","000","00","080","0011","0000","2662","1197","1465","17","2679","7334","0","36.53","16.32"
"65","000","00","080","0011","1847","533","225","308","1","534","1635","0","32.66","13.76"
"65","000","00","080","0011","1848","565","276","289","4","569","1547","0","36.78","17.84"
"65","000","00","080","0011","1849","467","216","251","2","469","1284","0","36.53","16.82"
"65","000","00","080","0011","1850","477","209","268","1","478","1279","0","37.37","16.34"
"65","000","00","080","0011","1851","620","271","349","9","629","1589","0","39.58","17.05"
"65","000","00","080","0012","0000","378","167","211","3","381","836","0","45.57","19.98"
"65","000","00","080","0012","1846","378","167","211","3","381","836","0","45.57","19.98"
"65","000","00","080","0013","0000","150","59","91","0","150","250","0","60.00","23.60"
"65","000","00","080","0013","1886","150","59","91","0","150","250","0","60.00","23.60"
"65","000","00","080","0014","0000","1874","917","957","16","1890","4527","0","41.75","20.26"
"65","000","00","080","0014","1879","583","270","313","5","588","1478","0","39.78","18.27"
"65","000","00","080","0014","1880","716","360","356","5","721","1698","0","42.46","21.20"
"65","000","00","080","0014","1881","575","287","288","6","581","1351","0","43.01","21.24"
"65","000","00","080","0015","0000","1749","830","919","23","1772","4996","0","35.47","16.61"
"65","000","00","080","0015","1873","521","254","267","6","527","1466","0","35.95","17.33"
"65","000","00","080","0015","1874","597","294","303","14","611","1714","0","35.65","17.15"
"65","000","00","080","0015","1875","631","282","349","3","634","1816","0","34.91","15.53"
"65","000","00","080","0016","0000","1475","691","784","12","1487","3896","0","38.17","17.74"
"65","000","00","080","0016","1876","521","240","281","4","525","1338","0","39.24","17.94"
"65","000","00","080","0016","1877","518","259","259","4","522","1282","0","40.72","20.20"
"65","000","00","080","0016","1878","436","192","244","4","440","1276","0","34.48","15.05"
"65","000","00","080","0017","0000","1709","854","855","19","1728","4275","0","40.42","19.98"
"65","000","00","080","0017","1867","614","333","281","5","619","1529","0","40.48","21.78"
"65","000","00","080","0017","1868","617","299","318","8","625","1496","0","41.78","19.99"
"65","000","00","080","0017","1869","478","222","256","6","484","1250","0","38.72","17.76"
"65","000","00","080","0018","0000","1825","881","944","15","1840","5088","0","36.16","17.32"
"65","000","00","080","0018","1882","525","234","291","5","530","1346","0","39.38","17.38"
"65","000","00","080","0018","1883","473","213","260","5","478","1250","0","38.24","17.04"
"65","000","00","080","0018","1884","483","268","215","1","484","1298","0","37.29","20.65"
"65","000","00","080","0018","1885","344","166","178","4","348","1194","0","29.15","13.90"
"65","000","00","080","0019","0000","1448","630","818","12","1460","3878","0","37.65","16.25"
"65","000","00","080","0019","1870","566","241","325","6","572","1510","0","37.88","15.96"
"65","000","00","080","0019","1871","446","200","246","3","449","1143","0","39.28","17.50"
"65","000","00","080","0019","1872","436","189","247","3","439","1225","0","35.84","15.43"
"65","000","00","080","0020","0000","2311","1023","1288","16","2327","6172","0","37.70","16.57"
"65","000","00","080","0020","1842","615","269","346","5","620","1544","0","40.16","17.42"
"65","000","00","080","0020","1843","578","246","332","2","580","1538","0","37.71","15.99"
"65","000","00","080","0020","1844","527","232","295","4","531","1496","0","35.49","15.51"
"65","000","00","080","0020","1845","591","276","315","5","596","1594","0","37.39","17.31"
"65","000","00","090","0000","0000","36209","18159","18050","322","36531","96164","116549","37.99","18.88"
"65","000","00","090","0001","0000","161","68","93","3","164","285","0","57.54","23.86"
"65","000","00","090","0001","2033","161","68","93","3","164","285","0","57.54","23.86"
"65","000","00","090","0002","0000","228","104","124","2","230","575","0","40.00","18.09"
"65","000","00","090","0002","2034","228","104","124","2","230","575","0","40.00","18.09"
"65","000","00","090","0003","0000","1355","679","676","10","1365","3542","0","38.54","19.17"
"65","000","00","090","0003","2035","391","192","199","1","392","991","0","39.56","19.37"
"65","000","00","090","0003","2036","477","258","219","4","481","1214","0","39.62","21.25"
"65","000","00","090","0003","2037","487","229","258","5","492","1337","0","36.80","17.13"
"65","000","00","090","0004","0000","1064","574","490","10","1074","3013","0","35.65","19.05"
"65","000","00","090","0004","2038","519","291","228","6","525","1465","0","35.84","19.86"
"65","000","00","090","0004","2039","545","283","262","4","549","1548","0","35.47","18.28"
"65","000","00","090","0005","0000","366","125","241","2","368","1027","0","35.83","12.17"
"65","000","00","090","0005","2040","366","125","241","2","368","1027","0","35.83","12.17"
"65","000","00","090","0006","0000","2546","1166","1380","29","2575","6463","0","39.84","18.04"
"65","000","00","090","0006","2041","535","242","293","8","543","1332","0","40.77","18.17"
"65","000","00","090","0006","2042","419","189","230","0","419","1094","0","38.30","17.28"
"65","000","00","090","0006","2043","510","248","262","6","516","1310","0","39.39","18.93"
"65","000","00","090","0006","2044","485","195","290","5","490","1218","0","40.23","16.01"
"65","000","00","090","0006","2045","597","292","305","10","607","1509","0","40.23","19.35"
"65","000","00","090","0007","0000","1922","959","963","12","1934","5237","0","36.93","18.31"
"65","000","00","090","0007","2069","494","237","257","4","498","1421","0","35.05","16.68"
"65","000","00","090","0007","2070","442","214","228","4","446","1229","0","36.29","17.41"
"65","000","00","090","0007","2071","481","243","238","2","483","1251","0","38.61","19.42"
"65","000","00","090","0007","2072","505","265","240","2","507","1336","0","37.95","19.84"
"65","000","00","090","0008","0000","3067","1473","1594","34","3101","8816","0","35.17","16.71"
"65","000","00","090","0008","2046","503","227","276","9","512","1461","0","35.04","15.54"
"65","000","00","090","0008","2047","452","215","237","6","458","1340","0","34.18","16.04"
"65","000","00","090","0008","2048","517","261","256","4","521","1432","0","36.38","18.23"
"65","000","00","090","0008","2049","549","252","297","8","557","1547","0","36.01","16.29"
"65","000","00","090","0008","2050","460","208","252","2","462","1420","0","32.54","14.65"
"65","000","00","090","0008","2051","586","310","276","5","591","1616","0","36.57","19.18"
"65","000","00","090","0009","0000","3089","1601","1488","40","3129","8410","0","37.21","19.04"
"65","000","00","090","0009","2052","482","196","286","4","486","1558","0","31.19","12.58"
"65","000","00","090","0009","2053","604","313","291","12","616","1793","0","34.36","17.46"
"65","000","00","090","0009","2054","662","347","315","10","672","1768","0","38.01","19.63"
"65","000","00","090","0009","2055","635","358","277","7","642","1584","0","40.53","22.60"
"65","000","00","090","0009","2056","706","387","319","7","713","1707","0","41.77","22.67"
"65","000","00","090","0010","0000","1348","722","626","9","1357","3676","0","36.92","19.64"
"65","000","00","090","0010","2084","363","174","189","3","366","1155","0","31.69","15.06"
"65","000","00","090","0010","2085","420","196","224","5","425","1163","0","36.54","16.85"
"65","000","00","090","0010","2086","565","352","213","1","566","1358","0","41.68","25.92"
"65","000","00","090","0011","0000","843","454","389","9","852","2111","0","40.36","21.51"
"65","000","00","090","0011","2087","417","222","195","4","421","1100","0","38.27","20.18"
"65","000","00","090","0011","2088","426","232","194","5","431","1011","0","42.63","22.95"
"65","000","00","090","0012","0000","379","154","225","7","386","1045","0","36.94","14.74"
"65","000","00","090","0012","2089","379","154","225","7","386","1045","0","36.94","14.74"
"65","000","00","090","0013","0000","176","71","105","4","180","486","0","37.04","14.61"
"65","000","00","090","0013","2090","176","71","105","4","180","486","0","37.04","14.61"
"65","000","00","090","0014","0000","232","116","116","4","236","794","0","29.72","14.61"
"65","000","00","090","0014","2091","232","116","116","4","236","794","0","29.72","14.61"
"65","000","00","090","0015","0000","279","92","187","3","282","632","0","44.62","14.56"
"65","000","00","090","0015","2092","279","92","187","3","282","632","0","44.62","14.56"
"65","000","00","090","0016","0000","216","75","141","2","218","683","0","31.92","10.98"
"65","000","00","090","0016","2093","216","75","141","2","218","683","0","31.92","10.98"
"65","000","00","090","0017","0000","872","363","509","7","879","2123","0","41.40","17.10"
"65","000","00","090","0017","2097","293","120","173","3","296","772","0","38.34","15.54"
"65","000","00","090","0017","2098","579","243","336","4","583","1351","0","43.15","17.99"
"65","000","00","090","0018","0000","587","242","345","7","594","1375","0","43.20","17.60"
"65","000","00","090","0018","2096","587","242","345","7","594","1375","0","43.20","17.60"
"65","000","00","090","0019","0000","986","467","519","10","996","2733","0","36.44","17.09"
"65","000","00","090","0019","2099","513","251","262","8","521","1397","0","37.29","17.97"
"65","000","00","090","0019","2100","473","216","257","2","475","1336","0","35.55","16.17"
"65","000","00","090","0020","0000","396","150","246","4","400","860","0","46.51","17.44"
"65","000","00","090","0020","2101","396","150","246","4","400","860","0","46.51","17.44"
"65","000","00","090","0021","0000","449","157","292","8","457","1294","0","35.32","12.13"
"65","000","00","090","0021","2104","449","157","292","8","457","1294","0","35.32","12.13"
"65","000","00","090","0022","0000","643","249","394","1","644","1870","0","34.44","13.32"
"65","000","00","090","0022","2102","250","71","179","1","251","732","0","34.29","9.70"
"65","000","00","090","0022","2103","393","178","215","0","393","1138","0","34.53","15.64"
"65","000","00","090","0023","0000","2006","895","1111","11","2017","6055","0","33.31","14.78"
"65","000","00","090","0023","2077","534","232","302","2","536","1521","0","35.24","15.25"
"65","000","00","090","0023","2078","510","238","272","4","514","1464","0","35.11","16.26"
"65","000","00","090","0023","2079","551","236","315","2","553","1548","0","35.72","15.25"
"65","000","00","090","0023","2080","411","189","222","3","414","1522","0","27.20","12.42"
"65","000","00","090","0024","0000","2323","1176","1147","22","2345","6654","0","35.24","17.67"
"65","000","00","090","0024","2073","544","243","301","2","546","1619","0","33.72","15.01"
"65","000","00","090","0024","2074","531","286","245","7","538","1739","0","30.94","16.45"
"65","000","00","090","0024","2075","536","283","253","9","545","1559","0","34.96","18.15"
"65","000","00","090","0024","2076","712","364","348","4","716","1737","0","41.22","20.96"
"65","000","00","090","0025","0000","1585","730","855","14","1599","4616","0","34.64","15.81"
"65","000","00","090","0025","2081","540","247","293","3","543","1567","0","34.65","15.76"
"65","000","00","090","0025","2082","519","269","250","6","525","1541","0","34.07","17.46"
"65","000","00","090","0025","2083","526","214","312","5","531","1508","0","35.21","14.19"
"65","000","00","090","0026","0000","1205","663","542","9","1214","3228","0","37.61","20.54"
"65","000","00","090","0026","2094","607","349","258","6","613","1596","0","38.41","21.87"
"65","000","00","090","0026","2095","598","314","284","3","601","1632","0","36.83","19.24"
"65","000","00","090","0027","0000","5483","3252","2231","33","5516","12581","0","43.84","25.85"
"65","000","00","090","0027","2061","660","356","304","4","664","1644","0","40.39","21.65"
"65","000","00","090","0027","2062","572","328","244","4","576","1487","0","38.74","22.06"
"65","000","00","090","0027","2063","801","493","308","4","805","1798","0","44.77","27.42"
"65","000","00","090","0027","2064","792","456","336","9","801","1605","0","49.91","28.41"
"65","000","00","090","0027","2065","649","393","256","1","650","1549","0","41.96","25.37"
"65","000","00","090","0027","2066","694","426","268","1","695","1533","0","45.34","27.79"
"65","000","00","090","0027","2067","659","431","228","2","661","1495","0","44.21","28.83"
"65","000","00","090","0027","2068","656","369","287","8","664","1470","0","45.17","25.10"
"65","000","00","090","0028","0000","2403","1382","1021","16","2419","5980","0","40.45","23.11"
"65","000","00","090","0028","2057","666","389","277","5","671","1602","0","41.89","24.28"
"65","000","00","090","0028","2058","685","397","288","5","690","1523","0","45.31","26.07"
"65","000","00","090","0028","2059","576","325","251","2","578","1410","0","40.99","23.05"
"65","000","00","090","0028","2060","476","271","205","4","480","1445","0","33.22","18.75"
"65","000","00","100","0000","0000","63314","33780","29534","506","63820","158577","184450","40.25","21.30"
"65","000","00","100","0001","0000","194","68","126","3","197","557","0","35.37","12.21"
"65","000","00","100","0001","0032","194","68","126","3","197","557","0","35.37","12.21"
"65","000","00","100","0002","0000","321","123","198","6","327","994","0","32.90","12.37"
"65","000","00","100","0002","0033","321","123","198","6","327","994","0","32.90","12.37"
"65","000","00","100","0003","0000","476","227","249","8","484","1447","0","33.45","15.69"
"65","000","00","100","0003","0034","476","227","249","8","484","1447","0","33.45","15.69"
"65","000","00","100","0004","0000","568","262","306","6","574","1510","0","38.01","17.35"
"65","000","00","100","0004","0035","568","262","306","6","574","1510","0","38.01","17.35"
"65","000","00","100","0005","0000","342","174","168","0","342","973","0","35.15","17.88"
"65","000","00","100","0005","0036","342","174","168","0","342","973","0","35.15","17.88"
"65","000","00","100","0006","0000","805","397","408","8","813","2422","0","33.57","16.39"
"65","000","00","100","0006","0038","397","194","203","5","402","1117","0","35.99","17.37"
"65","000","00","100","0006","0039","408","203","205","3","411","1305","0","31.49","15.56"
"65","000","00","100","0007","0000","323","163","160","7","330","803","0","41.10","20.30"
"65","000","00","100","0007","0037","323","163","160","7","330","803","0","41.10","20.30"
"65","000","00","100","0008","0000","6104","3545","2559","39","6143","17538","0","35.03","20.21"
"65","000","00","100","0008","0071","852","499","353","6","858","2045","0","41.96","24.40"
"65","000","00","100","0008","0072","592","360","232","7","599","2304","0","26.00","15.63"
"65","000","00","100","0008","0073","472","261","211","2","474","1275","0","37.18","20.47"
"65","000","00","100","0008","0074","555","294","261","4","559","1448","0","38.60","20.30"
"65","000","00","100","0008","0075","677","389","288","3","680","2254","0","30.17","17.26"
"65","000","00","100","0008","0076","619","356","263","5","624","1883","0","33.14","18.91"
"65","000","00","100","0008","0077","564","312","252","0","564","1442","0","39.11","21.64"
"65","000","00","100","0008","0078","881","531","350","5","886","2402","0","36.89","22.11"
"65","000","00","100","0008","0079","892","543","349","7","899","2485","0","36.18","21.85"
"65","000","00","100","0009","0000","580","279","301","3","583","1616","0","36.08","17.26"
"65","000","00","100","0009","0080","580","279","301","3","583","1616","0","36.08","17.26"
"65","000","00","100","0010","0000","2532","1404","1128","15","2547","6573","0","38.75","21.36"
"65","000","00","100","0010","0090","519","266","253","7","526","1383","0","38.03","19.23"
"65","000","00","100","0010","0091","692","423","269","3","695","1742","0","39.90","24.28"
"65","000","00","100","0010","0092","592","320","272","4","596","1575","0","37.84","20.32"
"65","000","00","100","0010","0093","729","395","334","1","730","1873","0","38.97","21.09"
"65","000","00","100","0011","0000","1981","950","1031","23","2004","5098","0","39.31","18.63"
"65","000","00","100","0011","0081","549","251","298","4","553","1445","0","38.27","17.37"
"65","000","00","100","0011","0082","467","244","223","4","471","1149","0","40.99","21.24"
"65","000","00","100","0011","0083","466","212","254","5","471","1207","0","39.02","17.56"
"65","000","00","100","0011","0084","499","243","256","10","509","1297","0","39.24","18.74"
"65","000","00","100","0012","0000","3658","2061","1597","28","3686","9067","0","40.65","22.73"
"65","000","00","100","0012","0106","749","412","337","4","753","1908","0","39.47","21.59"
"65","000","00","100","0012","0107","513","259","254","2","515","1358","0","37.92","19.07"
"65","000","00","100","0012","0108","949","538","411","8","957","2153","0","44.45","24.99"
"65","000","00","100","0012","0109","740","430","310","5","745","1837","0","40.56","23.41"
"65","000","00","100","0012","0110","707","422","285","9","716","1811","0","39.54","23.30"
"65","000","00","100","0013","0000","742","284","458","9","751","1974","0","38.04","14.39"
"65","000","00","100","0013","0040","422","183","239","5","427","1136","0","37.59","16.11"
"65","000","00","100","0013","0041","320","101","219","4","324","838","0","38.66","12.05"
"65","000","00","100","0014","0000","404","150","254","2","406","1054","0","38.52","14.23"
"65","000","00","100","0014","0042","404","150","254","2","406","1054","0","38.52","14.23"
"65","000","00","100","0015","0000","543","262","281","11","554","1361","0","40.71","19.25"
"65","000","00","100","0015","0043","543","262","281","11","554","1361","0","40.71","19.25"
"65","000","00","100","0016","0000","541","268","273","7","548","1263","0","43.39","21.22"
"65","000","00","100","0016","0044","541","268","273","7","548","1263","0","43.39","21.22"
"65","000","00","100","0017","0000","3084","1767","1317","26","3110","6369","0","48.83","27.74"
"65","000","00","100","0017","0045","873","496","377","11","884","1797","0","49.19","27.60"
"65","000","00","100","0017","0046","507","265","242","1","508","1021","0","49.76","25.95"
"65","000","00","100","0017","0047","487","291","196","5","492","1016","0","48.43","28.64"
"65","000","00","100","0017","0048","628","360","268","3","631","1241","0","50.85","29.01"
"65","000","00","100","0017","0049","589","355","234","6","595","1294","0","45.98","27.43"
"65","000","00","100","0018","0000","2571","1392","1179","19","2590","5639","0","45.93","24.69"
"65","000","00","100","0018","0050","539","273","266","3","542","1302","0","41.63","20.97"
"65","000","00","100","0018","0051","640","376","264","5","645","1240","0","52.02","30.32"
"65","000","00","100","0018","0052","639","332","307","8","647","1418","0","45.63","23.41"
"65","000","00","100","0018","0053","753","411","342","3","756","1679","0","45.03","24.48"
"65","000","00","100","0019","0000","2763","1443","1320","10","2773","6465","0","42.89","22.32"
"65","000","00","100","0019","0057","780","402","378","4","784","1819","0","43.10","22.10"
"65","000","00","100","0019","0058","563","251","312","3","566","1252","0","45.21","20.05"
"65","000","00","100","0019","0059","690","349","341","2","692","1570","0","44.08","22.23"
"65","000","00","100","0019","0060","730","441","289","1","731","1824","0","40.08","24.18"
"65","000","00","100","0020","0000","2574","1418","1156","20","2594","6014","0","43.13","23.58"
"65","000","00","100","0020","0061","632","327","305","3","635","1474","0","43.08","22.18"
"65","000","00","100","0020","0062","666","363","303","4","670","1626","0","41.21","22.32"
"65","000","00","100","0020","0063","537","324","213","6","543","1327","0","40.92","24.42"
"65","000","00","100","0020","0064","739","404","335","7","746","1587","0","47.01","25.46"
"65","000","00","100","0021","0000","4073","2340","1733","29","4102","10029","0","40.90","23.33"
"65","000","00","100","0021","0065","743","464","279","5","748","1824","0","41.01","25.44"
"65","000","00","100","0021","0066","788","424","364","5","793","1862","0","42.59","22.77"
"65","000","00","100","0021","0067","676","416","260","5","681","1788","0","38.09","23.27"
"65","000","00","100","0021","0068","700","337","363","4","704","1653","0","42.59","20.39"
"65","000","00","100","0021","0069","623","373","250","7","630","1381","0","45.62","27.01"
"65","000","00","100","0021","0070","543","326","217","3","546","1521","0","35.90","21.43"
"65","000","00","100","0022","0000","2298","1257","1041","15","2313","5542","0","41.74","22.68"
"65","000","00","100","0022","0111","551","328","223","5","556","1280","0","43.44","25.63"
"65","000","00","100","0022","0112","410","229","181","4","414","981","0","42.20","23.34"
"65","000","00","100","0022","0113","557","282","275","4","561","1209","0","46.40","23.33"
"65","000","00","100","0022","0114","342","188","154","1","343","958","0","35.80","19.62"
"65","000","00","100","0022","0115","438","230","208","1","439","1114","0","39.41","20.65"
"65","000","00","100","0023","0000","1392","672","720","20","1412","3650","0","38.68","18.41"
"65","000","00","100","0023","0123","463","212","251","5","468","1305","0","35.86","16.25"
"65","000","00","100","0023","0124","487","237","250","7","494","1284","0","38.47","18.46"
"65","000","00","100","0023","0125","442","223","219","8","450","1061","0","42.41","21.02"
"65","000","00","100","0024","0000","611","285","326","6","617","1326","0","46.53","21.49"
"65","000","00","100","0024","0126","611","285","326","6","617","1326","0","46.53","21.49"
"65","000","00","100","0025","0000","418","182","236","7","425","1068","0","39.79","17.04"
"65","000","00","100","0025","0127","418","182","236","7","425","1068","0","39.79","17.04"
"65","000","00","100","0026","0000","306","126","180","4","310","682","0","45.45","18.48"
"65","000","00","100","0026","0128","306","126","180","4","310","682","0","45.45","18.48"
"65","000","00","100","0027","0000","518","245","273","4","522","1339","0","38.98","18.30"
"65","000","00","100","0027","0129","518","245","273","4","522","1339","0","38.98","18.30"
"65","000","00","100","0028","0000","398","186","212","2","400","804","0","49.75","23.13"
"65","000","00","100","0028","0130","398","186","212","2","400","804","0","49.75","23.13"
"65","000","00","100","0029","0000","317","142","175","6","323","624","0","51.76","22.76"
"65","000","00","100","0029","0131","317","142","175","6","323","624","0","51.76","22.76"
"65","000","00","100","0030","0000","185","89","96","1","186","396","0","46.97","22.47"
"65","000","00","100","0030","0132","185","89","96","1","186","396","0","46.97","22.47"
"65","000","00","100","0031","0000","669","372","297","3","672","1587","0","42.34","23.44"
"65","000","00","100","0031","0133","669","372","297","3","672","1587","0","42.34","23.44"
"65","000","00","100","0032","0000","2042","1124","918","20","2062","4932","0","41.81","22.79"
"65","000","00","100","0032","0134","673","392","281","3","676","1590","0","42.52","24.65"
"65","000","00","100","0032","0135","777","407","370","14","791","1743","0","45.38","23.35"
"65","000","00","100","0032","0136","592","325","267","3","595","1599","0","37.21","20.33"
"65","000","00","100","0033","0000","1590","857","733","9","1599","4158","0","38.46","20.61"
"65","000","00","100","0033","0137","605","306","299","2","607","1668","0","36.39","18.35"
"65","000","00","100","0033","0138","567","282","285","5","572","1410","0","40.57","20.00"
"65","000","00","100","0033","0139","418","269","149","2","420","1080","0","38.89","24.91"
"65","000","00","100","0034","0000","1353","610","743","10","1363","3658","0","37.26","16.68"
"65","000","00","100","0034","0094","475","226","249","5","480","1250","0","38.40","18.08"
"65","000","00","100","0034","0095","359","151","208","1","360","1050","0","34.29","14.38"
"65","000","00","100","0034","0096","519","233","286","4","523","1358","0","38.51","17.16"
"65","000","00","100","0035","0000","2936","1526","1410","24","2960","7974","0","37.12","19.14"
"65","000","00","100","0035","0097","587","270","317","3","590","1563","0","37.75","17.27"
"65","000","00","100","0035","0098","562","293","269","6","568","1551","0","36.62","18.89"
"65","000","00","100","0035","0099","507","286","221","3","510","1485","0","34.34","19.26"
"65","000","00","100","0035","0100","376","213","163","3","379","927","0","40.88","22.98"
"65","000","00","100","0035","0101","417","186","231","4","421","1200","0","35.08","15.50"
"65","000","00","100","0035","0102","487","278","209","5","492","1248","0","39.42","22.28"
"65","000","00","100","0036","0000","1764","917","847","10","1774","4269","0","41.56","21.48"
"65","000","00","100","0036","0103","628","293","335","3","631","1450","0","43.52","20.21"
"65","000","00","100","0036","0104","541","298","243","4","545","1384","0","39.38","21.53"
"65","000","00","100","0036","0105","595","326","269","3","598","1435","0","41.67","22.72"
"65","000","00","100","0037","0000","1644","936","708","12","1656","4169","0","39.72","22.45"
"65","000","00","100","0037","0087","613","329","284","4","617","1519","0","40.62","21.66"
"65","000","00","100","0037","0088","547","335","212","4","551","1402","0","39.30","23.89"
"65","000","00","100","0037","0089","484","272","212","4","488","1248","0","39.10","21.79"
"65","000","00","100","0038","0000","961","520","441","5","966","2486","0","38.86","20.92"
"65","000","00","100","0038","0085","512","267","245","4","516","1279","0","40.34","20.88"
"65","000","00","100","0038","0086","449","253","196","1","450","1207","0","37.28","20.96"
"65","000","00","100","0039","0000","1925","974","951","16","1941","4221","0","45.98","23.08"
"65","000","00","100","0039","0054","553","251","302","8","561","1200","0","46.75","20.92"
"65","000","00","100","0039","0055","738","378","360","5","743","1527","0","48.66","24.75"
"65","000","00","100","0039","0056","634","345","289","3","637","1494","0","42.64","23.09"
"65","000","00","100","0040","0000","1414","695","719","14","1428","3477","0","41.07","19.99"
"65","000","00","100","0040","0116","386","186","200","5","391","1022","0","38.26","18.20"
"65","000","00","100","0040","0117","532","254","278","5","537","1289","0","41.66","19.71"
"65","000","00","100","0040","0118","496","255","241","4","500","1166","0","42.88","21.87"
"65","000","00","100","0041","0000","1573","866","707","11","1584","4251","0","37.26","20.37"
"65","000","00","100","0041","0119","319","194","125","3","322","948","0","33.97","20.46"
"65","000","00","100","0041","0120","504","260","244","5","509","1141","0","44.61","22.79"
"65","000","00","100","0041","0121","369","192","177","0","369","1062","0","34.75","18.08"
"65","000","00","100","0041","0122","381","220","161","3","384","1100","0","34.91","20.00"
"65","000","00","100","0042","0000","3821","2222","1599","28","3849","9198","0","41.85","24.16"
"65","000","00","100","0042","0140","643","360","283","7","650","1432","0","45.39","25.14"
"65","000","00","100","0042","0141","592","277","315","4","596","1387","0","42.97","19.97"
"65","000","00","100","0042","0142","741","390","351","5","746","2001","0","37.28","19.49"
"65","000","00","100","0042","0143","592","354","238","4","596","1432","0","41.62","24.72"
"65","000","00","100","0042","0144","728","493","235","5","733","1809","0","40.52","27.25"
"65","000","00","100","0042","0145","525","348","177","3","528","1137","0","46.44","30.61"
"65","000","00","110","0000","0000","75027","41046","33981","652","75679","179909","205551","42.07","22.81"
"65","000","00","110","0001","0000","529","289","240","3","532","1238","0","42.97","23.34"
"65","000","00","110","0001","2501","529","289","240","3","532","1238","0","42.97","23.34"
"65","000","00","110","0002","0000","449","204","245","3","452","980","0","46.12","20.82"
"65","000","00","110","0002","2502","449","204","245","3","452","980","0","46.12","20.82"
"65","000","00","110","0003","0000","1864","1092","772","16","1880","4239","0","44.35","25.76"
"65","000","00","110","0003","2503","583","342","241","6","589","1387","0","42.47","24.66"
"65","000","00","110","0003","2504","682","405","277","6","688","1409","0","48.83","28.74"
"65","000","00","110","0003","2505","599","345","254","4","603","1443","0","41.79","23.91"
"65","000","00","110","0004","0000","146","71","75","1","147","320","0","45.94","22.19"
"65","000","00","110","0004","2508","146","71","75","1","147","320","0","45.94","22.19"
"65","000","00","110","0005","0000","1246","661","585","8","1254","2889","0","43.41","22.88"
"65","000","00","110","0005","2544","681","372","309","1","682","1525","0","44.72","24.39"
"65","000","00","110","0005","2545","565","289","276","7","572","1364","0","41.94","21.19"
"65","000","00","110","0006","0000","1409","702","707","17","1426","4888","0","29.17","14.36"
"65","000","00","110","0006","2516","282","143","139","6","288","1897","0","15.18","7.54"
"65","000","00","110","0006","2517","594","289","305","7","601","1577","0","38.11","18.33"
"65","000","00","110","0006","2518","533","270","263","4","537","1414","0","37.98","19.09"
"65","000","00","110","0007","0000","1962","1015","947","11","1973","4758","0","41.47","21.33"
"65","000","00","110","0007","2509","690","350","340","5","695","1562","0","44.49","22.41"
"65","000","00","110","0007","2510","645","325","320","3","648","1629","0","39.78","19.95"
"65","000","00","110","0007","2511","627","340","287","3","630","1567","0","40.20","21.70"
"65","000","00","110","0008","0000","3167","1811","1356","24","3191","6286","0","50.76","28.81"
"65","000","00","110","0008","2522","691","387","304","5","696","1459","0","47.70","26.53"
"65","000","00","110","0008","2523","775","449","326","3","778","1586","0","49.05","28.31"
"65","000","00","110","0008","2524","854","494","360","6","860","1666","0","51.62","29.65"
"65","000","00","110","0008","2525","847","481","366","10","857","1575","0","54.41","30.54"
"65","000","00","110","0009","0000","1375","688","687","16","1391","3956","0","35.16","17.39"
"65","000","00","110","0009","2535","491","239","252","5","496","1359","0","36.50","17.59"
"65","000","00","110","0009","2536","449","231","218","5","454","1362","0","33.33","16.96"
"65","000","00","110","0009","2537","435","218","217","6","441","1235","0","35.71","17.65"
"65","000","00","110","0010","0000","633","291","342","6","639","1489","0","42.91","19.54"
"65","000","00","110","0010","2549","633","291","342","6","639","1489","0","42.91","19.54"
"65","000","00","110","0011","0000","544","274","270","7","551","1494","0","36.88","18.34"
"65","000","00","110","0011","2550","544","274","270","7","551","1494","0","36.88","18.34"
"65","000","00","110","0012","0000","1665","821","844","23","1688","4194","0","40.25","19.58"
"65","000","00","110","0012","2552","525","227","298","6","531","1297","0","40.94","17.50"
"65","000","00","110","0012","2553","621","329","292","10","631","1623","0","38.88","20.27"
"65","000","00","110","0012","2554","519","265","254","7","526","1274","0","41.29","20.80"
"65","000","00","110","0013","0000","934","441","493","6","940","2101","0","44.74","20.99"
"65","000","00","110","0013","2557","555","250","305","3","558","1310","0","42.60","19.08"
"65","000","00","110","0013","2558","379","191","188","3","382","791","0","48.29","24.15"
"65","000","00","110","0014","0000","2113","1093","1020","17","2130","5478","0","38.88","19.95"
"65","000","00","110","0014","2559","501","299","202","5","506","1245","0","40.64","24.02"
"65","000","00","110","0014","2560","508","247","261","2","510","1316","0","38.75","18.77"
"65","000","00","110","0014","2561","560","276","284","5","565","1603","0","35.25","17.22"
"65","000","00","110","0014","2562","544","271","273","5","549","1314","0","41.78","20.62"
"65","000","00","110","0015","0000","1598","850","748","10","1608","4648","0","34.60","18.29"
"65","000","00","110","0015","2563","425","230","195","4","429","1486","0","28.87","15.48"
"65","000","00","110","0015","2564","541","262","279","5","546","1553","0","35.16","16.87"
"65","000","00","110","0015","2565","632","358","274","1","633","1609","0","39.34","22.25"
"65","000","00","110","0016","0000","625","329","296","8","633","1479","0","42.80","22.24"
"65","000","00","110","0016","2566","625","329","296","8","633","1479","0","42.80","22.24"
"65","000","00","110","0017","0000","339","145","194","3","342","921","0","37.13","15.74"
"65","000","00","110","0017","2567","339","145","194","3","342","921","0","37.13","15.74"
"65","000","00","110","0018","0000","768","373","395","8","776","1990","0","38.99","18.74"
"65","000","00","110","0018","2575","768","373","395","8","776","1990","0","38.99","18.74"
"65","000","00","110","0019","0000","1721","805","916","14","1735","4527","0","38.33","17.78"
"65","000","00","110","0019","2569","661","301","360","1","662","1665","0","39.76","18.08"
"65","000","00","110","0019","2570","514","244","270","6","520","1472","0","35.33","16.58"
"65","000","00","110","0019","2571","546","260","286","7","553","1390","0","39.78","18.71"
"65","000","00","110","0020","0000","2415","1288","1127","15","2430","5282","0","46.01","24.38"
"65","000","00","110","0020","2609","659","381","278","4","663","1484","0","44.68","25.67"
"65","000","00","110","0020","2610","665","372","293","1","666","1313","0","50.72","28.33"
"65","000","00","110","0020","2611","601","285","316","8","609","1313","0","46.38","21.71"
"65","000","00","110","0020","2612","490","250","240","2","492","1172","0","41.98","21.33"
"65","000","00","110","0021","0000","1597","849","748","20","1617","3974","0","40.69","21.36"
"65","000","00","110","0021","2532","523","281","242","9","532","1227","0","43.36","22.90"
"65","000","00","110","0021","2533","536","258","278","7","543","1399","0","38.81","18.44"
"65","000","00","110","0021","2534","538","310","228","4","542","1348","0","40.21","23.00"
"65","000","00","110","0022","0000","1828","989","839","22","1850","4272","0","43.31","23.15"
"65","000","00","110","0022","2616","629","346","283","7","636","1457","0","43.65","23.75"
"65","000","00","110","0022","2617","572","317","255","8","580","1380","0","42.03","22.97"
"65","000","00","110","0022","2618","627","326","301","7","634","1435","0","44.18","22.72"
"65","000","00","110","0023","0000","216","106","110","2","218","542","0","40.22","19.56"
"65","000","00","110","0023","2551","216","106","110","2","218","542","0","40.22","19.56"
"65","000","00","110","0024","0000","1548","865","683","12","1560","3388","0","46.04","25.53"
"65","000","00","110","0024","2619","737","409","328","2","739","1745","0","42.35","23.44"
"65","000","00","110","0024","2620","811","456","355","10","821","1643","0","49.97","27.75"
"65","000","00","110","0025","0000","1320","809","511","18","1338","2728","0","49.05","29.66"
"65","000","00","110","0025","2621","605","408","197","8","613","1312","0","46.72","31.10"
"65","000","00","110","0025","2622","715","401","314","10","725","1416","0","51.20","28.32"
"65","000","00","110","0026","0000","2727","1387","1340","25","2752","7130","0","38.60","19.45"
"65","000","00","110","0026","2587","537","260","277","8","545","1408","0","38.71","18.47"
"65","000","00","110","0026","2588","500","246","254","7","507","1368","0","37.06","17.98"
"65","000","00","110","0026","2589","536","279","257","0","536","1460","0","36.71","19.11"
"65","000","00","110","0026","2590","552","276","276","7","559","1386","0","40.33","19.91"
"65","000","00","110","0026","2591","602","326","276","3","605","1508","0","40.12","21.62"
"65","000","00","110","0027","0000","2476","1451","1025","24","2500","5589","0","44.73","25.96"
"65","000","00","110","0027","2599","632","327","305","8","640","1388","0","46.11","23.56"
"65","000","00","110","0027","2600","555","310","245","3","558","1396","0","39.97","22.21"
"65","000","00","110","0027","2601","648","374","274","11","659","1429","0","46.12","26.17"
"65","000","00","110","0027","2602","641","440","201","2","643","1376","0","46.73","31.98"
"65","000","00","110","0028","0000","738","404","334","9","747","1675","0","44.60","24.12"
"65","000","00","110","0028","2500","738","404","334","9","747","1675","0","44.60","24.12"
"65","000","00","110","0029","0000","2447","1378","1069","13","2460","6767","0","36.35","20.36"
"65","000","00","110","0029","2581","633","328","305","2","635","1700","0","37.35","19.29"
"65","000","00","110","0029","2582","614","364","250","1","615","1655","0","37.16","21.99"
"65","000","00","110","0029","2583","653","368","285","4","657","1720","0","38.20","21.40"
"65","000","00","110","0029","2584","547","318","229","6","553","1692","0","32.68","18.79"
"65","000","00","110","0030","0000","2942","1661","1281","15","2957","7500","0","39.43","22.15"
"65","000","00","110","0030","2576","551","300","251","3","554","1416","0","39.12","21.19"
"65","000","00","110","0030","2577","588","326","262","3","591","1547","0","38.20","21.07"
"65","000","00","110","0030","2578","584","362","222","1","585","1512","0","38.69","23.94"
"65","000","00","110","0030","2579","600","312","288","4","604","1468","0","41.14","21.25"
"65","000","00","110","0030","2580","619","361","258","4","623","1557","0","40.01","23.19"
"65","000","00","110","0031","0000","2149","1165","984","16","2165","5118","0","42.30","22.76"
"65","000","00","110","0031","2526","716","384","332","6","722","1683","0","42.90","22.82"
"65","000","00","110","0031","2527","648","326","322","5","653","1716","0","38.05","19.00"
"65","000","00","110","0031","2528","785","455","330","5","790","1719","0","45.96","26.47"
"65","000","00","110","0032","0000","1726","912","814","13","1739","4130","0","42.11","22.08"
"65","000","00","110","0032","2529","576","265","311","5","581","1534","0","37.87","17.28"
"65","000","00","110","0032","2530","655","366","289","3","658","1554","0","42.34","23.55"
"65","000","00","110","0032","2531","495","281","214","5","500","1042","0","47.98","26.97"
"65","000","00","110","0033","0000","1931","1010","921","21","1952","4841","0","40.32","20.86"
"65","000","00","110","0033","2572","633","340","293","3","636","1600","0","39.75","21.25"
"65","000","00","110","0033","2573","645","350","295","11","656","1660","0","39.52","21.08"
"65","000","00","110","0033","2574","653","320","333","7","660","1581","0","41.75","20.24"
"65","000","00","110","0034","0000","1132","580","552","11","1143","2985","0","38.29","19.43"
"65","000","00","110","0034","2592","609","290","319","7","616","1514","0","40.69","19.15"
"65","000","00","110","0034","2593","523","290","233","4","527","1471","0","35.83","19.71"
"65","000","00","110","0035","0000","1270","717","553","5","1275","2904","0","43.90","24.69"
"65","000","00","110","0035","2594","659","398","261","1","660","1423","0","46.38","27.97"
"65","000","00","110","0035","2595","611","319","292","4","615","1481","0","41.53","21.54"
"65","000","00","110","0036","0000","1873","992","881","13","1886","4716","0","39.99","21.03"
"65","000","00","110","0036","2596","614","340","274","2","616","1564","0","39.39","21.74"
"65","000","00","110","0036","2597","589","303","286","5","594","1493","0","39.79","20.29"
"65","000","00","110","0036","2598","670","349","321","6","676","1659","0","40.75","21.04"
"65","000","00","110","0037","0000","1634","1043","591","15","1649","3115","0","52.94","33.48"
"65","000","00","110","0037","2613","739","486","253","9","748","1475","0","50.71","32.95"
"65","000","00","110","0037","2614","895","557","338","6","901","1640","0","54.94","33.96"
"65","000","00","110","0038","0000","513","204","309","4","517","1145","0","45.15","17.82"
"65","000","00","110","0038","2615","513","204","309","4","517","1145","0","45.15","17.82"
"65","000","00","110","0039","0000","2074","1189","885","18","2092","4238","0","49.36","28.06"
"65","000","00","110","0039","2623","577","284","293","10","587","1209","0","48.55","23.49"
"65","000","00","110","0039","2624","531","314","217","3","534","1080","0","49.44","29.07"
"65","000","00","110","0039","2625","966","591","375","5","971","1949","0","49.82","30.32"
"65","000","00","110","0040","0000","894","545","349","6","900","2598","0","34.64","20.98"
"65","000","00","110","0040","2585","493","306","187","2","495","1428","0","34.66","21.43"
"65","000","00","110","0040","2586","401","239","162","4","405","1170","0","34.62","20.43"
"65","000","00","110","0041","0000","1086","587","499","7","1093","2552","0","42.83","23.00"
"65","000","00","110","0041","2506","534","270","264","4","538","1262","0","42.63","21.39"
"65","000","00","110","0041","2507","552","317","235","3","555","1290","0","43.02","24.57"
"65","000","00","110","0042","0000","1920","1022","898","20","1940","4444","0","43.65","23.00"
"65","000","00","110","0042","2538","697","368","329","7","704","1693","0","41.58","21.74"
"65","000","00","110","0042","2539","659","314","345","10","669","1577","0","42.42","19.91"
"65","000","00","110","0042","2540","564","340","224","3","567","1174","0","48.30","28.96"
"65","000","00","110","0043","0000","2732","1663","1069","32","2764","6020","0","45.91","27.62"
"65","000","00","110","0043","2605","703","446","257","10","713","1571","0","45.39","28.39"
"65","000","00","110","0043","2606","709","426","283","4","713","1458","0","48.90","29.22"
"65","000","00","110","0043","2607","642","374","268","8","650","1568","0","41.45","23.85"
"65","000","00","110","0043","2608","678","417","261","10","688","1423","0","48.35","29.30"
"65","000","00","110","0044","0000","453","266","187","8","461","872","0","52.87","30.50"
"65","000","00","110","0044","2568","453","266","187","8","461","872","0","52.87","30.50"
"65","000","00","110","0045","0000","2265","1211","1054","19","2284","5639","0","40.50","21.48"
"65","000","00","110","0045","2512","525","285","240","5","530","1345","0","39.41","21.19"
"65","000","00","110","0045","2513","598","333","265","6","604","1426","0","42.36","23.35"
"65","000","00","110","0045","2514","578","314","264","6","584","1437","0","40.64","21.85"
"65","000","00","110","0045","2515","564","279","285","2","566","1431","0","39.55","19.50"
"65","000","00","110","0046","0000","1679","948","731","10","1689","3952","0","42.74","23.99"
"65","000","00","110","0046","2519","536","275","261","3","539","1277","0","42.21","21.53"
"65","000","00","110","0046","2520","540","298","242","3","543","1304","0","41.64","22.85"
"65","000","00","110","0046","2521","603","375","228","4","607","1371","0","44.27","27.35"
"65","000","00","110","0047","0000","2126","1248","878","18","2144","4633","0","46.28","26.94"
"65","000","00","110","0047","2546","807","450","357","7","814","1663","0","48.95","27.06"
"65","000","00","110","0047","2547","753","468","285","4","757","1703","0","44.45","27.48"
"65","000","00","110","0047","2548","566","330","236","7","573","1267","0","45.22","26.05"
"65","000","00","110","0048","0000","1846","1092","754","15","1861","4091","0","45.49","26.69"
"65","000","00","110","0048","2541","609","331","278","6","615","1270","0","48.43","26.06"
"65","000","00","110","0048","2542","613","377","236","3","616","1351","0","45.60","27.91"
"65","000","00","110","0048","2543","624","384","240","6","630","1470","0","42.86","26.12"
"65","000","00","110","0049","0000","1353","889","464","14","1367","2514","0","54.38","35.36"
"65","000","00","110","0049","2603","596","386","210","9","605","1154","0","52.43","33.45"
"65","000","00","110","0049","2604","757","503","254","5","762","1360","0","56.03","36.99"
"65","000","00","110","0050","0000","1030","621","409","11","1041","2680","0","38.84","23.17"
"65","000","00","110","0050","2555","779","511","268","9","788","1988","0","39.64","25.70"
"65","000","00","110","0050","2556","251","110","141","2","253","692","0","36.56","15.90"
"65","000","00","120","0000","0000","11950","6251","5699","142","12092","34231","38764","35.32","18.26"
"65","000","00","120","0001","0000","304","167","137","2","306","728","0","42.03","22.94"
"65","000","00","120","0001","2379","304","167","137","2","306","728","0","42.03","22.94"
"65","000","00","120","0002","0000","777","431","346","14","791","1862","0","42.48","23.15"
"65","000","00","120","0002","2380","446","237","209","12","458","1044","0","43.87","22.70"
"65","000","00","120","0002","2381","331","194","137","2","333","818","0","40.71","23.72"
"65","000","00","120","0003","0000","464","261","203","4","468","1203","0","38.90","21.70"
"65","000","00","120","0003","2382","464","261","203","4","468","1203","0","38.90","21.70"
"65","000","00","120","0004","0000","590","317","273","5","595","1573","0","37.83","20.15"
"65","000","00","120","0004","2384","328","184","144","2","330","861","0","38.33","21.37"
"65","000","00","120","0004","2385","262","133","129","3","265","712","0","37.22","18.68"
"65","000","00","120","0005","0000","481","294","187","4","485","1281","0","37.86","22.95"
"65","000","00","120","0005","2386","481","294","187","4","485","1281","0","37.86","22.95"
"65","000","00","120","0006","0000","218","129","89","4","222","598","0","37.12","21.57"
"65","000","00","120","0006","2383","218","129","89","4","222","598","0","37.12","21.57"
"65","000","00","120","0007","0000","1295","634","661","13","1308","3539","0","36.96","17.91"
"65","000","00","120","0007","2387","534","262","272","3","537","1534","0","35.01","17.08"
"65","000","00","120","0007","2388","371","188","183","3","374","945","0","39.58","19.89"
"65","000","00","120","0007","2389","390","184","206","7","397","1060","0","37.45","17.36"
"65","000","00","120","0008","0000","365","157","208","6","371","1041","0","35.64","15.08"
"65","000","00","120","0008","2394","365","157","208","6","371","1041","0","35.64","15.08"
"65","000","00","120","0009","0000","567","282","285","2","569","1589","0","35.81","17.75"
"65","000","00","120","0009","2392","343","161","182","0","343","954","0","35.95","16.88"
"65","000","00","120","0009","2393","224","121","103","2","226","635","0","35.59","19.06"
"65","000","00","120","0010","0000","465","241","224","7","472","1272","0","37.11","18.95"
"65","000","00","120","0010","2404","240","136","104","2","242","666","0","36.34","20.42"
"65","000","00","120","0010","2405","225","105","120","5","230","606","0","37.95","17.33"
"65","000","00","120","0011","0000","559","313","246","7","566","1680","0","33.69","18.63"
"65","000","00","120","0011","2399","306","151","155","4","310","815","0","38.04","18.53"
"65","000","00","120","0011","2400","253","162","91","3","256","865","0","29.60","18.73"
"65","000","00","120","0012","0000","985","519","466","5","990","2918","0","33.93","17.79"
"65","000","00","120","0012","2401","260","145","115","1","261","758","0","34.43","19.13"
"65","000","00","120","0012","2402","379","211","168","3","382","1137","0","33.60","18.56"
"65","000","00","120","0012","2403","346","163","183","1","347","1023","0","33.92","15.93"
"65","000","00","120","0013","0000","658","303","355","12","670","1891","0","35.43","16.02"
"65","000","00","120","0013","2406","369","181","188","5","374","1054","0","35.48","17.17"
"65","000","00","120","0013","2407","289","122","167","7","296","837","0","35.36","14.58"
"65","000","00","120","0014","0000","142","57","85","0","142","434","0","32.72","13.13"
"65","000","00","120","0014","2396","142","57","85","0","142","434","0","32.72","13.13"
"65","000","00","120","0015","0000","91","35","56","3","94","241","0","39.00","14.52"
"65","000","00","120","0015","2397","91","35","56","3","94","241","0","39.00","14.52"
"65","000","00","120","0016","0000","116","40","76","3","119","264","0","45.08","15.15"
"65","000","00","120","0016","2395","116","40","76","3","119","264","0","45.08","15.15"
"65","000","00","120","0017","0000","73","38","35","0","73","138","0","52.90","27.54"
"65","000","00","120","0017","2398","73","38","35","0","73","138","0","52.90","27.54"
"65","000","00","120","0018","0000","180","84","96","3","183","417","0","43.88","20.14"
"65","000","00","120","0018","2408","180","84","96","3","183","417","0","43.88","20.14"
"65","000","00","120","0019","0000","128","61","67","0","128","408","0","31.37","14.95"
"65","000","00","120","0019","2409","128","61","67","0","128","408","0","31.37","14.95"
"65","000","00","120","0020","0000","114","53","61","2","116","296","0","39.19","17.91"
"65","000","00","120","0020","2410","114","53","61","2","116","296","0","39.19","17.91"
"65","000","00","120","0021","0000","69","41","28","2","71","164","0","43.29","25.00"
"65","000","00","120","0021","2411","69","41","28","2","71","164","0","43.29","25.00"
"65","000","00","120","0022","0000","119","56","63","1","120","326","0","36.81","17.18"
"65","000","00","120","0022","2412","119","56","63","1","120","326","0","36.81","17.18"
"65","000","00","120","0023","0000","105","54","51","4","109","339","0","32.15","15.93"
"65","000","00","120","0023","2415","105","54","51","4","109","339","0","32.15","15.93"
"65","000","00","120","0024","0000","74","48","26","0","74","164","0","45.12","29.27"
"65","000","00","120","0024","2413","74","48","26","0","74","164","0","45.12","29.27"
"65","000","00","120","0025","0000","81","41","40","1","82","186","0","44.09","22.04"
"65","000","00","120","0025","2414","81","41","40","1","82","186","0","44.09","22.04"
"65","000","00","120","0026","0000","110","67","43","0","110","321","0","34.27","20.87"
"65","000","00","120","0026","2416","110","67","43","0","110","321","0","34.27","20.87"
"65","000","00","120","0027","0000","78","34","44","2","80","286","0","27.97","11.89"
"65","000","00","120","0027","2418","78","34","44","2","80","286","0","27.97","11.89"
"65","000","00","120","0028","0000","167","102","65","3","170","459","0","37.04","22.22"
"65","000","00","120","0028","2417","167","102","65","3","170","459","0","37.04","22.22"
"65","000","00","120","0029","0000","333","199","134","5","338","1241","0","27.24","16.04"
"65","000","00","120","0029","2421","333","199","134","5","338","1241","0","27.24","16.04"
"65","000","00","120","0030","0000","590","315","275","6","596","1905","0","31.29","16.54"
"65","000","00","120","0030","2422","339","171","168","3","342","979","0","34.93","17.47"
"65","000","00","120","0030","2423","251","144","107","3","254","926","0","27.43","15.55"
"65","000","00","120","0031","0000","364","220","144","3","367","1290","0","28.45","17.05"
"65","000","00","120","0031","2424","364","220","144","3","367","1290","0","28.45","17.05"
"65","000","00","120","0032","0000","118","49","69","2","120","264","0","45.45","18.56"
"65","000","00","120","0032","2419","118","49","69","2","120","264","0","45.45","18.56"
"65","000","00","120","0033","0000","262","110","152","8","270","853","0","31.65","12.90"
"65","000","00","120","0033","2420","262","110","152","8","270","853","0","31.65","12.90"
"65","000","00","120","0034","0000","908","499","409","9","917","3060","0","29.97","16.31"
"65","000","00","120","0034","2390","462","254","208","3","465","1454","0","31.98","17.47"
"65","000","00","120","0034","2391","446","245","201","6","452","1606","0","28.14","15.26"
"65","000","00","130","0000","0000","80713","39203","41510","715","81428","203012","238020","40.11","19.31"
"65","000","00","130","0001","0000","1290","615","675","7","1297","5065","0","25.61","12.14"
"65","000","00","130","0001","1912","435","198","237","4","439","2800","0","15.68","7.07"
"65","000","00","130","0001","1913","452","217","235","2","454","1215","0","37.37","17.86"
"65","000","00","130","0001","1914","403","200","203","1","404","1050","0","38.48","19.05"
"65","000","00","130","0002","0000","742","378","364","11","753","1838","0","40.97","20.57"
"65","000","00","130","0002","1915","380","192","188","7","387","952","0","40.65","20.17"
"65","000","00","130","0002","1916","362","186","176","4","366","886","0","41.31","20.99"
"65","000","00","130","0003","0000","2587","1363","1224","16","2603","6368","0","40.88","21.40"
"65","000","00","130","0003","1922","623","312","311","4","627","1619","0","38.73","19.27"
"65","000","00","130","0003","1923","645","333","312","7","652","1625","0","40.12","20.49"
"65","000","00","130","0003","1924","653","346","307","1","654","1521","0","43.00","22.75"
"65","000","00","130","0003","1925","666","372","294","4","670","1603","0","41.80","23.21"
"65","000","00","130","0004","0000","1841","903","938","21","1862","4879","0","38.16","18.51"
"65","000","00","130","0004","1908","516","247","269","8","524","1322","0","39.64","18.68"
"65","000","00","130","0004","1909","438","197","241","6","444","1209","0","36.72","16.29"
"65","000","00","130","0004","1910","459","281","178","3","462","1171","0","39.45","24.00"
"65","000","00","130","0004","1911","428","178","250","4","432","1177","0","36.70","15.12"
"65","000","00","130","0005","0000","988","742","246","10","998","1844","0","54.12","40.24"
"65","000","00","130","0005","1917","452","330","122","6","458","895","0","51.17","36.87"
"65","000","00","130","0005","1918","536","412","124","4","540","949","0","56.90","43.41"
"65","000","00","130","0006","0000","1714","778","936","22","1736","4107","0","42.27","18.94"
"65","000","00","130","0006","1934","579","243","336","9","588","1365","0","43.08","17.80"
"65","000","00","130","0006","1935","504","272","232","5","509","1374","0","37.05","19.80"
"65","000","00","130","0006","1936","631","263","368","8","639","1368","0","46.71","19.23"
"65","000","00","130","0007","0000","2376","1078","1298","17","2393","5788","0","41.34","18.62"
"65","000","00","130","0007","1930","675","331","344","7","682","1558","0","43.77","21.25"
"65","000","00","130","0007","1931","623","290","333","5","628","1488","0","42.20","19.49"
"65","000","00","130","0007","1932","564","240","324","4","568","1477","0","38.46","16.25"
"65","000","00","130","0007","1933","514","217","297","1","515","1265","0","40.71","17.15"
"65","000","00","130","0008","0000","1605","706","899","17","1622","3999","0","40.56","17.65"
"65","000","00","130","0008","1941","464","212","252","8","472","1247","0","37.85","17.00"
"65","000","00","130","0008","1942","667","298","369","5","672","1652","0","40.68","18.04"
"65","000","00","130","0008","1943","474","196","278","4","478","1100","0","43.45","17.82"
"65","000","00","130","0009","0000","1323","657","666","14","1337","3209","0","41.66","20.47"
"65","000","00","130","0009","1972","465","222","243","6","471","1130","0","41.68","19.65"
"65","000","00","130","0009","1973","411","215","196","3","414","1017","0","40.71","21.14"
"65","000","00","130","0009","1974","447","220","227","5","452","1062","0","42.56","20.72"
"65","000","00","130","0010","0000","3178","1601","1577","15","3193","7337","0","43.52","21.82"
"65","000","00","130","0010","1954","635","286","349","3","638","1545","0","41.29","18.51"
"65","000","00","130","0010","1955","583","278","305","2","585","1409","0","41.52","19.73"
"65","000","00","130","0010","1956","652","305","347","1","653","1506","0","43.36","20.25"
"65","000","00","130","0010","1957","665","362","303","7","672","1470","0","45.71","24.63"
"65","000","00","130","0010","1958","643","370","273","2","645","1407","0","45.84","26.30"
"65","000","00","130","0011","0000","1077","429","648","8","1085","2741","0","39.58","15.65"
"65","000","00","130","0011","1944","529","209","320","6","535","1322","0","40.47","15.81"
"65","000","00","130","0011","1945","548","220","328","2","550","1419","0","38.76","15.50"
"65","000","00","130","0012","0000","2808","1319","1489","20","2828","7167","0","39.46","18.40"
"65","000","00","130","0012","1990","443","210","233","2","445","1261","0","35.29","16.65"
"65","000","00","130","0012","1991","533","261","272","5","538","1314","0","40.94","19.86"
"65","000","00","130","0012","1992","601","297","304","6","607","1512","0","40.15","19.64"
"65","000","00","130","0012","1993","645","286","359","4","649","1553","0","41.79","18.42"
"65","000","00","130","0012","1994","586","265","321","3","589","1527","0","38.57","17.35"
"65","000","00","130","0013","0000","1972","891","1081","29","2001","5572","0","35.91","15.99"
"65","000","00","130","0013","1979","494","202","292","8","502","1292","0","38.85","15.63"
"65","000","00","130","0013","1980","468","187","281","10","478","1483","0","32.23","12.61"
"65","000","00","130","0013","1981","505","223","282","3","508","1411","0","36.00","15.80"
"65","000","00","130","0013","1982","505","279","226","8","513","1386","0","37.01","20.13"
"65","000","00","130","0014","0000","1487","795","692","17","1504","3780","0","39.79","21.03"
"65","000","00","130","0014","1995","486","232","254","8","494","1228","0","40.23","18.89"
"65","000","00","130","0014","1996","446","234","212","5","451","1228","0","36.73","19.06"
"65","000","00","130","0014","1997","555","329","226","4","559","1324","0","42.22","24.85"
"65","000","00","130","0015","0000","578","251","327","5","583","1455","0","40.07","17.25"
"65","000","00","130","0015","1983","578","251","327","5","583","1455","0","40.07","17.25"
"65","000","00","130","0016","0000","2431","1235","1196","24","2455","6034","0","40.69","20.47"
"65","000","00","130","0016","1984","549","261","288","4","553","1479","0","37.39","17.65"
"65","000","00","130","0016","1985","626","326","300","5","631","1492","0","42.29","21.85"
"65","000","00","130","0016","1986","635","333","302","7","642","1565","0","41.02","21.28"
"65","000","00","130","0016","1987","621","315","306","8","629","1498","0","41.99","21.03"
"65","000","00","130","0017","0000","2370","1082","1288","25","2395","6492","0","36.89","16.67"
"65","000","00","130","0017","2008","561","261","300","2","563","1314","0","42.85","19.86"
"65","000","00","130","0017","2009","442","196","246","6","448","1306","0","34.30","15.01"
"65","000","00","130","0017","2010","390","190","200","6","396","1144","0","34.62","16.61"
"65","000","00","130","0017","2011","471","204","267","7","478","1267","0","37.73","16.10"
"65","000","00","130","0017","2012","506","231","275","4","510","1461","0","34.91","15.81"
"65","000","00","130","0018","0000","2476","1105","1371","21","2497","6188","0","40.35","17.86"
"65","000","00","130","0018","2022","576","260","316","3","579","1463","0","39.58","17.77"
"65","000","00","130","0018","2023","720","316","404","10","730","1610","0","45.34","19.63"
"65","000","00","130","0018","2024","577","278","299","3","580","1540","0","37.66","18.05"
"65","000","00","130","0018","2025","603","251","352","5","608","1575","0","38.60","15.94"
"65","000","00","130","0019","0000","1738","752","986","15","1753","4348","0","40.32","17.30"
"65","000","00","130","0019","2001","587","253","334","7","594","1312","0","45.27","19.28"
"65","000","00","130","0019","2002","561","278","283","5","566","1509","0","37.51","18.42"
"65","000","00","130","0019","2003","590","221","369","3","593","1527","0","38.83","14.47"
"65","000","00","130","0020","0000","1854","874","980","19","1873","4345","0","43.11","20.12"
"65","000","00","130","0020","1904","498","220","278","7","505","1220","0","41.39","18.03"
"65","000","00","130","0020","1905","559","243","316","7","566","1201","0","47.13","20.23"
"65","000","00","130","0020","1906","381","216","165","4","385","968","0","39.77","22.31"
"65","000","00","130","0020","1907","416","195","221","1","417","956","0","43.62","20.40"
"65","000","00","130","0021","0000","2680","1334","1346","27","2707","7273","0","37.22","18.34"
"65","000","00","130","0021","1899","503","229","274","12","515","1510","0","34.11","15.17"
"65","000","00","130","0021","1900","567","271","296","5","572","1484","0","38.54","18.26"
"65","000","00","130","0021","1901","482","207","275","3","485","1399","0","34.67","14.80"
"65","000","00","130","0021","1902","554","324","230","1","555","1357","0","40.90","23.88"
"65","000","00","130","0021","1903","574","303","271","6","580","1523","0","38.08","19.89"
"65","000","00","130","0022","0000","1733","790","943","22","1755","4244","0","41.35","18.61"
"65","000","00","130","0022","1896","540","228","312","6","546","1326","0","41.18","17.19"
"65","000","00","130","0022","1897","513","250","263","4","517","1329","0","38.90","18.81"
"65","000","00","130","0022","1898","680","312","368","12","692","1589","0","43.55","19.63"
"65","000","00","130","0023","0000","1716","846","870","27","1743","4447","0","39.19","19.02"
"65","000","00","130","0023","1893","570","279","291","6","576","1408","0","40.91","19.82"
"65","000","00","130","0023","1894","563","316","247","13","576","1556","0","37.02","20.31"
"65","000","00","130","0023","1895","583","251","332","8","591","1483","0","39.85","16.93"
"65","000","00","130","0024","0000","1796","877","919","20","1816","4672","0","38.87","18.77"
"65","000","00","130","0024","1890","479","229","250","8","487","1377","0","35.37","16.63"
"65","000","00","130","0024","1891","611","298","313","5","616","1638","0","37.61","18.19"
"65","000","00","130","0024","1892","706","350","356","7","713","1657","0","43.03","21.12"
"65","000","00","130","0025","0000","1153","726","427","9","1162","2561","0","45.37","28.35"
"65","000","00","130","0025","1888","566","343","223","5","571","1299","0","43.96","26.40"
"65","000","00","130","0025","1889","587","383","204","4","591","1262","0","46.83","30.35"
"65","000","00","130","0026","0000","569","213","356","5","574","1476","0","38.89","14.43"
"65","000","00","130","0026","1887","569","213","356","5","574","1476","0","38.89","14.43"
"65","000","00","130","0027","0000","1835","898","937","22","1857","4491","0","41.35","20.00"
"65","000","00","130","0027","1961","626","316","310","11","637","1559","0","40.86","20.27"
"65","000","00","130","0027","1962","583","230","353","5","588","1402","0","41.94","16.41"
"65","000","00","130","0027","1963","626","352","274","6","632","1530","0","41.31","23.01"
"65","000","00","130","0028","0000","2207","1138","1069","18","2225","4980","0","44.68","22.85"
"65","000","00","130","0028","1949","730","374","356","4","734","1695","0","43.30","22.06"
"65","000","00","130","0028","1950","756","427","329","7","763","1605","0","47.54","26.60"
"65","000","00","130","0028","1951","721","337","384","7","728","1680","0","43.33","20.06"
"65","000","00","130","0029","0000","1271","588","683","15","1286","3076","0","41.81","19.12"
"65","000","00","130","0029","1964","679","313","366","10","689","1574","0","43.77","19.89"
"65","000","00","130","0029","1965","592","275","317","5","597","1502","0","39.75","18.31"
"65","000","00","130","0030","0000","1525","718","807","9","1534","3907","0","39.26","18.38"
"65","000","00","130","0030","2016","513","249","264","4","517","1249","0","41.39","19.94"
"65","000","00","130","0030","2017","526","228","298","4","530","1314","0","40.33","17.35"
"65","000","00","130","0030","2018","486","241","245","1","487","1344","0","36.24","17.93"
"65","000","00","130","0031","0000","1821","840","981","9","1830","4353","0","42.04","19.30"
"65","000","00","130","0031","2026","631","278","353","2","633","1363","0","46.44","20.40"
"65","000","00","130","0031","2027","603","256","347","5","608","1489","0","40.83","17.19"
"65","000","00","130","0031","2028","587","306","281","2","589","1501","0","39.24","20.39"
"65","000","00","130","0032","0000","1164","563","601","14","1178","2751","0","42.82","20.47"
"65","000","00","130","0032","1977","591","300","291","8","599","1387","0","43.19","21.63"
"65","000","00","130","0032","1978","573","263","310","6","579","1364","0","42.45","19.28"
"65","000","00","130","0033","0000","1939","950","989","15","1954","4879","0","40.05","19.47"
"65","000","00","130","0033","1926","520","241","279","6","526","1264","0","41.61","19.07"
"65","000","00","130","0033","1927","399","185","214","2","401","1131","0","35.46","16.36"
"65","000","00","130","0033","1928","554","296","258","4","558","1306","0","42.73","22.66"
"65","000","00","130","0033","1929","466","228","238","3","469","1178","0","39.81","19.35"
"65","000","00","130","0034","0000","1438","625","813","11","1449","3854","0","37.60","16.22"
"65","000","00","130","0034","2013","443","212","231","5","448","1198","0","37.40","17.70"
"65","000","00","130","0034","2014","576","230","346","3","579","1443","0","40.12","15.94"
"65","000","00","130","0034","2015","419","183","236","3","422","1213","0","34.79","15.09"
"65","000","00","130","0035","0000","1628","791","837","14","1642","3997","0","41.08","19.79"
"65","000","00","130","0035","1946","455","207","248","3","458","1239","0","36.97","16.71"
"65","000","00","130","0035","1947","508","223","285","2","510","1314","0","38.81","16.97"
"65","000","00","130","0035","1948","665","361","304","9","674","1444","0","46.68","25.00"
"65","000","00","130","0036","0000","1981","872","1109","12","1993","4880","0","40.84","17.87"
"65","000","00","130","0036","1937","476","172","304","3","479","1117","0","42.88","15.40"
"65","000","00","130","0036","1938","503","229","274","1","504","1290","0","39.07","17.75"
"65","000","00","130","0036","1939","539","244","295","1","540","1342","0","40.24","18.18"
"65","000","00","130","0036","1940","463","227","236","7","470","1131","0","41.56","20.07"
"65","000","00","130","0037","0000","1445","738","707","6","1451","3873","0","37.46","19.05"
"65","000","00","130","0037","1919","489","237","252","6","495","1302","0","38.02","18.20"
"65","000","00","130","0037","1920","484","239","245","0","484","1333","0","36.31","17.93"
"65","000","00","130","0037","1921","472","262","210","0","472","1238","0","38.13","21.16"
"65","000","00","130","0038","0000","1814","869","945","16","1830","4972","0","36.81","17.48"
"65","000","00","130","0038","1998","465","235","230","5","470","1384","0","33.96","16.98"
"65","000","00","130","0038","1999","556","249","307","6","562","1556","0","36.12","16.00"
"65","000","00","130","0038","2000","793","385","408","5","798","2032","0","39.27","18.95"
"65","000","00","130","0039","0000","1292","546","746","10","1302","2895","0","44.97","18.86"
"65","000","00","130","0039","1952","574","262","312","4","578","1341","0","43.10","19.54"
"65","000","00","130","0039","1953","718","284","434","6","724","1554","0","46.59","18.28"
"65","000","00","130","0040","0000","2360","1123","1237","19","2379","5897","0","40.34","19.04"
"65","000","00","130","0040","2029","648","303","345","4","652","1527","0","42.70","19.84"
"65","000","00","130","0040","2030","535","255","280","5","540","1350","0","40.00","18.89"
"65","000","00","130","0040","2031","599","266","333","3","602","1493","0","40.32","17.82"
"65","000","00","130","0040","2032","578","299","279","7","585","1527","0","38.31","19.58"
"65","000","00","130","0041","0000","1216","641","575","8","1224","2851","0","42.93","22.48"
"65","000","00","130","0041","1975","633","334","299","4","637","1508","0","42.24","22.15"
"65","000","00","130","0041","1976","583","307","276","4","587","1343","0","43.71","22.86"
"65","000","00","130","0042","0000","1877","963","914","15","1892","4214","0","44.90","22.85"
"65","000","00","130","0042","1969","617","345","272","6","623","1431","0","43.54","24.11"
"65","000","00","130","0042","1970","611","292","319","0","611","1299","0","47.04","22.48"
"65","000","00","130","0042","1971","649","326","323","9","658","1484","0","44.34","21.97"
"65","000","00","130","0043","0000","2203","1152","1051","18","2221","5145","0","43.17","22.39"
"65","000","00","130","0043","1966","705","361","344","6","711","1689","0","42.10","21.37"
"65","000","00","130","0043","1967","702","350","352","8","710","1671","0","42.49","20.95"
"65","000","00","130","0043","1968","796","441","355","4","800","1785","0","44.82","24.71"
"65","000","00","130","0044","0000","1244","622","622","10","1254","3049","0","41.13","20.40"
"65","000","00","130","0044","1959","647","330","317","4","651","1592","0","40.89","20.73"
"65","000","00","130","0044","1960","597","292","305","6","603","1457","0","41.39","20.04"
"65","000","00","130","0045","0000","1079","504","575","4","1083","2621","0","41.32","19.23"
"65","000","00","130","0045","1988","620","289","331","2","622","1353","0","45.97","21.36"
"65","000","00","130","0045","1989","459","215","244","2","461","1268","0","36.36","16.96"
"65","000","00","130","0046","0000","1994","1125","869","16","2010","5390","0","37.29","20.87"
"65","000","00","130","0046","2004","467","269","198","3","470","1290","0","36.43","20.85"
"65","000","00","130","0046","2005","532","318","214","5","537","1377","0","39.00","23.09"
"65","000","00","130","0046","2006","497","271","226","4","501","1344","0","37.28","20.16"
"65","000","00","130","0046","2007","498","267","231","4","502","1379","0","36.40","19.36"
"65","000","00","130","0047","0000","1298","597","701","11","1309","3708","0","35.30","16.10"
"65","000","00","130","0047","2019","476","256","220","3","479","1358","0","35.27","18.85"
"65","000","00","130","0047","2020","374","177","197","3","377","1143","0","32.98","15.49"
"65","000","00","130","0047","2021","448","164","284","5","453","1207","0","37.53","13.59"
"65","000","00","140","0000","0000","67562","27934","39628","594","68156","170282","202131","40.03","16.40"
"65","000","00","140","0001","0000","4822","2225","2597","39","4861","11581","0","41.97","19.21"
"65","000","00","140","0001","0647","631","315","316","3","634","1574","0","40.28","20.01"
"65","000","00","140","0001","0648","766","358","408","7","773","1667","0","46.37","21.48"
"65","000","00","140","0001","0649","617","243","374","6","623","1537","0","40.53","15.81"
"65","000","00","140","0001","0650","833","399","434","2","835","1816","0","45.98","21.97"
"65","000","00","140","0001","0651","616","270","346","4","620","1588","0","39.04","17.00"
"65","000","00","140","0001","0652","713","341","372","9","722","1735","0","41.61","19.65"
"65","000","00","140","0001","0653","646","299","347","8","654","1664","0","39.30","17.97"
"65","000","00","140","0002","0000","2048","871","1177","16","2064","5216","0","39.57","16.70"
"65","000","00","140","0002","0638","565","268","297","5","570","1369","0","41.64","19.58"
"65","000","00","140","0002","0639","569","216","353","3","572","1342","0","42.62","16.10"
"65","000","00","140","0002","0640","452","180","272","3","455","1240","0","36.69","14.52"
"65","000","00","140","0002","0641","462","207","255","5","467","1265","0","36.92","16.36"
"65","000","00","140","0003","0000","1457","591","866","11","1468","3615","0","40.61","16.35"
"65","000","00","140","0003","0625","490","185","305","3","493","1311","0","37.60","14.11"
"65","000","00","140","0003","0626","600","243","357","6","606","1490","0","40.67","16.31"
"65","000","00","140","0003","0627","367","163","204","2","369","814","0","45.33","20.02"
"65","000","00","140","0004","0000","1919","789","1130","14","1933","4716","0","40.99","16.73"
"65","000","00","140","0004","0619","696","279","417","3","699","1591","0","43.93","17.54"
"65","000","00","140","0004","0620","614","244","370","5","619","1492","0","41.49","16.35"
"65","000","00","140","0004","0621","609","266","343","6","615","1633","0","37.66","16.29"
"65","000","00","140","0005","0000","1277","542","735","14","1291","3348","0","38.56","16.19"
"65","000","00","140","0005","0725","612","260","352","7","619","1636","0","37.84","15.89"
"65","000","00","140","0005","0726","665","282","383","7","672","1712","0","39.25","16.47"
"65","000","00","140","0006","0000","3648","1501","2147","33","3681","9167","0","40.15","16.37"
"65","000","00","140","0006","0715","765","332","433","12","777","1811","0","42.90","18.33"
"65","000","00","140","0006","0716","660","261","399","7","667","1803","0","36.99","14.48"
"65","000","00","140","0006","0717","763","282","481","4","767","1882","0","40.75","14.98"
"65","000","00","140","0006","0718","683","295","388","6","689","1805","0","38.17","16.34"
"65","000","00","140","0006","0719","777","331","446","4","781","1866","0","41.85","17.74"
"65","000","00","140","0007","0000","2459","1133","1326","18","2477","5872","0","42.18","19.29"
"65","000","00","140","0007","0671","666","338","328","5","671","1522","0","44.09","22.21"
"65","000","00","140","0007","0672","740","338","402","6","746","1714","0","43.52","19.72"
"65","000","00","140","0007","0673","435","178","257","2","437","1073","0","40.73","16.59"
"65","000","00","140","0007","0674","618","279","339","5","623","1563","0","39.86","17.85"
"65","000","00","140","0008","0000","1940","828","1112","16","1956","4812","0","40.65","17.21"
"65","000","00","140","0008","0685","710","297","413","7","717","1735","0","41.33","17.12"
"65","000","00","140","0008","0686","631","300","331","7","638","1573","0","40.56","19.07"
"65","000","00","140","0008","0687","599","231","368","2","601","1504","0","39.96","15.36"
"65","000","00","140","0009","0000","2244","1043","1201","15","2259","5571","0","40.55","18.72"
"65","000","00","140","0009","0688","516","221","295","3","519","1321","0","39.29","16.73"
"65","000","00","140","0009","0689","535","236","299","6","541","1380","0","39.20","17.10"
"65","000","00","140","0009","0690","507","229","278","4","511","1378","0","37.08","16.62"
"65","000","00","140","0009","0691","686","357","329","2","688","1492","0","46.11","23.93"
"65","000","00","140","0010","0000","1234","473","761","8","1242","2798","0","44.39","16.90"
"65","000","00","140","0010","0692","556","192","364","2","558","1306","0","42.73","14.70"
"65","000","00","140","0010","0693","678","281","397","6","684","1492","0","45.84","18.83"
"65","000","00","140","0011","0000","1294","532","762","17","1311","2888","0","45.39","18.42"
"65","000","00","140","0011","0706","693","298","395","9","702","1549","0","45.32","19.24"
"65","000","00","140","0011","0707","601","234","367","8","609","1339","0","45.48","17.48"
"65","000","00","140","0012","0000","943","402","541","9","952","2322","0","41.00","17.31"
"65","000","00","140","0012","0704","455","192","263","6","461","1151","0","40.05","16.68"
"65","000","00","140","0012","0705","488","210","278","3","491","1171","0","41.93","17.93"
"65","000","00","140","0013","0000","736","301","435","3","739","1885","0","39.20","15.97"
"65","000","00","140","0013","0694","736","301","435","3","739","1885","0","39.20","15.97"
"65","000","00","140","0014","0000","1183","494","689","7","1190","2972","0","40.04","16.62"
"65","000","00","140","0014","0700","541","243","298","2","543","1321","0","41.11","18.40"
"65","000","00","140","0014","0701","642","251","391","5","647","1651","0","39.19","15.20"
"65","000","00","140","0015","0000","1916","777","1139","22","1938","5162","0","37.54","15.05"
"65","000","00","140","0015","0654","582","230","352","4","586","1648","0","35.56","13.96"
"65","000","00","140","0015","0655","663","270","393","8","671","1726","0","38.88","15.64"
"65","000","00","140","0015","0656","671","277","394","10","681","1788","0","38.09","15.49"
"65","000","00","140","0016","0000","2141","925","1216","15","2156","5439","0","39.64","17.01"
"65","000","00","140","0016","0657","733","312","421","4","737","1869","0","39.43","16.69"
"65","000","00","140","0016","0658","683","298","385","5","688","1773","0","38.80","16.81"
"65","000","00","140","0016","0659","725","315","410","6","731","1797","0","40.68","17.53"
"65","000","00","140","0017","0000","2247","900","1347","24","2271","5948","0","38.18","15.13"
"65","000","00","140","0017","0664","503","190","313","3","506","1370","0","36.93","13.87"
"65","000","00","140","0017","0665","537","189","348","0","537","1452","0","36.98","13.02"
"65","000","00","140","0017","0666","576","241","335","15","591","1547","0","38.20","15.58"
"65","000","00","140","0017","0667","631","280","351","6","637","1579","0","40.34","17.73"
"65","000","00","140","0018","0000","1399","529","870","12","1411","3564","0","39.59","14.84"
"65","000","00","140","0018","0675","732","288","444","6","738","1798","0","41.05","16.02"
"65","000","00","140","0018","0676","667","241","426","6","673","1766","0","38.11","13.65"
"65","000","00","140","0019","0000","2204","967","1237","12","2216","5243","0","42.27","18.44"
"65","000","00","140","0019","0677","588","229","359","5","593","1439","0","41.21","15.91"
"65","000","00","140","0019","0678","558","235","323","3","561","1396","0","40.19","16.83"
"65","000","00","140","0019","0679","604","279","325","4","608","1362","0","44.64","20.48"
"65","000","00","140","0019","0680","454","224","230","0","454","1046","0","43.40","21.41"
"65","000","00","140","0020","0000","1355","481","874","10","1365","3166","0","43.11","15.19"
"65","000","00","140","0020","0681","673","243","430","5","678","1558","0","43.52","15.60"
"65","000","00","140","0020","0682","682","238","444","5","687","1608","0","42.72","14.80"
"65","000","00","140","0021","0000","3219","1284","1935","32","3251","8441","0","38.51","15.21"
"65","000","00","140","0021","0710","678","307","371","7","685","1706","0","40.15","18.00"
"65","000","00","140","0021","0711","584","227","357","6","590","1564","0","37.72","14.51"
"65","000","00","140","0021","0712","673","255","418","13","686","1798","0","38.15","14.18"
"65","000","00","140","0021","0713","660","229","431","2","662","1759","0","37.64","13.02"
"65","000","00","140","0021","0714","624","266","358","4","628","1614","0","38.91","16.48"
"65","000","00","140","0022","0000","1891","741","1150","13","1904","4663","0","40.83","15.89"
"65","000","00","140","0022","0720","656","249","407","4","660","1503","0","43.91","16.57"
"65","000","00","140","0022","0721","653","233","420","4","657","1644","0","39.96","14.17"
"65","000","00","140","0022","0722","582","259","323","5","587","1516","0","38.72","17.08"
"65","000","00","140","0023","0000","1022","409","613","11","1033","2855","0","36.18","14.33"
"65","000","00","140","0023","0645","460","190","270","3","463","1338","0","34.60","14.20"
"65","000","00","140","0023","0646","562","219","343","8","570","1517","0","37.57","14.44"
"65","000","00","140","0024","0000","1857","785","1072","13","1870","4834","0","38.68","16.24"
"65","000","00","140","0024","0631","618","247","371","3","621","1559","0","39.83","15.84"
"65","000","00","140","0024","0632","605","243","362","4","609","1595","0","38.18","15.24"
"65","000","00","140","0024","0633","634","295","339","6","640","1680","0","38.10","17.56"
"65","000","00","140","0025","0000","1255","488","767","10","1265","2975","0","42.52","16.40"
"65","000","00","140","0025","0636","636","210","426","5","641","1539","0","41.65","13.65"
"65","000","00","140","0025","0637","619","278","341","5","624","1436","0","43.45","19.36"
"65","000","00","140","0026","0000","1231","495","736","19","1250","2688","0","46.50","18.42"
"65","000","00","140","0026","0702","643","270","373","10","653","1327","0","49.21","20.35"
"65","000","00","140","0026","0703","588","225","363","9","597","1361","0","43.86","16.53"
"65","000","00","140","0027","0000","1966","784","1182","17","1983","4838","0","40.99","16.21"
"65","000","00","140","0027","0695","677","264","413","4","681","1714","0","39.73","15.40"
"65","000","00","140","0027","0696","668","286","382","8","676","1566","0","43.17","18.26"
"65","000","00","140","0027","0697","621","234","387","5","626","1558","0","40.18","15.02"
"65","000","00","140","0028","0000","1586","678","908","21","1607","4916","0","32.69","13.79"
"65","000","00","140","0028","0698","829","398","431","9","838","3136","0","26.72","12.69"
"65","000","00","140","0028","0699","757","280","477","12","769","1780","0","43.20","15.73"
"65","000","00","140","0029","0000","1706","696","1010","17","1723","4262","0","40.43","16.33"
"65","000","00","140","0029","0622","511","206","305","7","518","1319","0","39.27","15.62"
"65","000","00","140","0029","0623","563","194","369","4","567","1381","0","41.06","14.05"
"65","000","00","140","0029","0624","632","296","336","6","638","1562","0","40.85","18.95"
"65","000","00","140","0030","0000","1324","567","757","14","1338","3431","0","39.00","16.53"
"65","000","00","140","0030","0727","598","251","347","5","603","1560","0","38.65","16.09"
"65","000","00","140","0030","0728","726","316","410","9","735","1871","0","39.28","16.89"
"65","000","00","140","0031","0000","1621","594","1027","14","1635","4622","0","35.37","12.85"
"65","000","00","140","0031","0642","494","186","308","4","498","1537","0","32.40","12.10"
"65","000","00","140","0031","0643","574","197","377","5","579","1498","0","38.65","13.15"
"65","000","00","140","0031","0644","553","211","342","5","558","1587","0","35.16","13.30"
"65","000","00","140","0032","0000","1012","442","570","8","1020","2400","0","42.50","18.42"
"65","000","00","140","0032","0708","610","274","336","5","615","1483","0","41.47","18.48"
"65","000","00","140","0032","0709","402","168","234","3","405","917","0","44.17","18.32"
"65","000","00","140","0033","0000","876","303","573","5","881","2171","0","40.58","13.96"
"65","000","00","140","0033","0723","441","165","276","4","445","1183","0","37.62","13.95"
"65","000","00","140","0033","0724","435","138","297","1","436","988","0","44.13","13.97"
"65","000","00","140","0034","0000","1213","494","719","10","1223","2886","0","42.38","17.12"
"65","000","00","140","0034","0683","676","273","403","5","681","1655","0","41.15","16.50"
"65","000","00","140","0034","0684","537","221","316","5","542","1231","0","44.03","17.95"
"65","000","00","140","0035","0000","1840","693","1147","15","1855","4625","0","40.11","14.98"
"65","000","00","140","0035","0628","566","199","367","2","568","1367","0","41.55","14.56"
"65","000","00","140","0035","0629","695","298","397","11","706","1659","0","42.56","17.96"
"65","000","00","140","0035","0630","579","196","383","2","581","1599","0","36.34","12.26"
"65","000","00","140","0036","0000","1474","565","909","20","1494","3685","0","40.54","15.33"
"65","000","00","140","0036","0634","777","313","464","9","786","1897","0","41.43","16.50"
"65","000","00","140","0036","0635","697","252","445","11","708","1788","0","39.60","14.09"
"65","000","00","140","0037","0000","2589","1052","1537","27","2616","6695","0","39.07","15.71"
"65","000","00","140","0037","0660","620","274","346","5","625","1637","0","38.18","16.74"
"65","000","00","140","0037","0661","658","264","394","9","667","1729","0","38.58","15.27"
"65","000","00","140","0037","0662","677","280","397","9","686","1761","0","38.96","15.90"
"65","000","00","140","0037","0663","634","234","400","4","638","1568","0","40.69","14.92"
"65","000","00","140","0038","0000","1414","560","854","13","1427","4010","0","35.59","13.97"
"65","000","00","140","0038","0668","435","191","244","6","441","1382","0","31.91","13.82"
"65","000","00","140","0038","0669","517","191","326","2","519","1316","0","39.44","14.51"
"65","000","00","140","0038","0670","462","178","284","5","467","1312","0","35.59","13.57"
"65","000","00","150","0000","0000","30112","13471","16641","241","30353","76657","90027","39.60","17.57"
"65","000","00","150","0001","0000","1739","597","1142","12","1751","4197","0","41.72","14.22"
"65","000","00","150","0001","0243","572","188","384","4","576","1398","0","41.20","13.45"
"65","000","00","150","0001","0244","555","217","338","3","558","1495","0","37.32","14.52"
"65","000","00","150","0001","0245","612","192","420","5","617","1304","0","47.32","14.72"
"65","000","00","150","0002","0000","488","126","362","4","492","1073","0","45.85","11.74"
"65","000","00","150","0002","0246","488","126","362","4","492","1073","0","45.85","11.74"
"65","000","00","150","0003","0000","1486","592","894","10","1496","3475","0","43.05","17.04"
"65","000","00","150","0003","0248","695","273","422","5","700","1616","0","43.32","16.89"
"65","000","00","150","0003","0249","598","259","339","3","601","1381","0","43.52","18.75"
"65","000","00","150","0003","0250","193","60","133","2","195","478","0","40.79","12.55"
"65","000","00","150","0004","0000","495","148","347","4","499","1260","0","39.60","11.75"
"65","000","00","150","0004","0247","495","148","347","4","499","1260","0","39.60","11.75"
"65","000","00","150","0005","0000","1974","760","1214","17","1991","5457","0","36.49","13.93"
"65","000","00","150","0005","0255","550","199","351","2","552","1534","0","35.98","12.97"
"65","000","00","150","0005","0256","598","236","362","6","604","1546","0","39.07","15.27"
"65","000","00","150","0005","0257","382","143","239","2","384","1182","0","32.49","12.10"
"65","000","00","150","0005","0258","444","182","262","7","451","1195","0","37.74","15.23"
"65","000","00","150","0006","0000","2413","946","1467","16","2429","6462","0","37.59","14.64"
"65","000","00","150","0006","0259","685","337","348","3","688","2035","0","33.81","16.56"
"65","000","00","150","0006","0260","585","195","390","5","590","1499","0","39.36","13.01"
"65","000","00","150","0006","0261","550","192","358","3","553","1426","0","38.78","13.46"
"65","000","00","150","0006","0262","593","222","371","5","598","1502","0","39.81","14.78"
"65","000","00","150","0007","0000","525","143","382","2","527","1245","0","42.33","11.49"
"65","000","00","150","0007","0269","525","143","382","2","527","1245","0","42.33","11.49"
"65","000","00","150","0008","0000","1389","617","772","14","1403","3885","0","36.11","15.88"
"65","000","00","150","0008","0276","472","237","235","4","476","1638","0","29.06","14.47"
"65","000","00","150","0008","0277","486","230","256","8","494","1191","0","41.48","19.31"
"65","000","00","150","0008","0278","431","150","281","2","433","1056","0","41.00","14.20"
"65","000","00","150","0009","0000","1240","546","694","9","1249","3097","0","40.33","17.63"
"65","000","00","150","0009","0270","611","283","328","4","615","1519","0","40.49","18.63"
"65","000","00","150","0009","0271","629","263","366","5","634","1578","0","40.18","16.67"
"65","000","00","150","0010","0000","1951","962","989","17","1968","4718","0","41.71","20.39"
"65","000","00","150","0010","0279","606","317","289","4","610","1591","0","38.34","19.92"
"65","000","00","150","0010","0280","622","300","322","4","626","1475","0","42.44","20.34"
"65","000","00","150","0010","0281","723","345","378","9","732","1652","0","44.31","20.88"
"65","000","00","150","0011","0000","1048","862","186","11","1059","2315","0","45.75","37.24"
"65","000","00","150","0011","0294","530","432","98","6","536","1133","0","47.31","38.13"
"65","000","00","150","0011","0295","518","430","88","5","523","1182","0","44.25","36.38"
"65","000","00","150","0012","0000","1245","891","354","15","1260","2648","0","47.58","33.65"
"65","000","00","150","0012","0292","701","472","229","7","708","1418","0","49.93","33.29"
"65","000","00","150","0012","0293","544","419","125","8","552","1230","0","44.88","34.07"
"65","000","00","150","0013","0000","1555","789","766","13","1568","3948","0","39.72","19.98"
"65","000","00","150","0013","0289","517","269","248","4","521","1439","0","36.21","18.69"
"65","000","00","150","0013","0290","561","294","267","4","565","1324","0","42.67","22.21"
"65","000","00","150","0013","0291","477","226","251","5","482","1185","0","40.68","19.07"
"65","000","00","150","0014","0000","1112","442","670","8","1120","3009","0","37.22","14.69"
"65","000","00","150","0014","0253","529","220","309","6","535","1530","0","34.97","14.38"
"65","000","00","150","0014","0254","583","222","361","2","585","1479","0","39.55","15.01"
"65","000","00","150","0015","0000","1356","692","664","18","1374","3460","0","39.71","20.00"
"65","000","00","150","0015","0272","666","336","330","12","678","1737","0","39.03","19.34"
"65","000","00","150","0015","0273","690","356","334","6","696","1723","0","40.39","20.66"
"65","000","00","150","0016","0000","1492","579","913","10","1502","3661","0","41.03","15.82"
"65","000","00","150","0016","0251","758","294","464","6","764","1876","0","40.72","15.67"
"65","000","00","150","0016","0252","734","285","449","4","738","1785","0","41.34","15.97"
"65","000","00","150","0017","0000","1303","610","693","8","1311","3192","0","41.07","19.11"
"65","000","00","150","0017","0274","567","265","302","4","571","1480","0","38.58","17.91"
"65","000","00","150","0017","0275","736","345","391","4","740","1712","0","43.22","20.15"
"65","000","00","150","0018","0000","3539","1580","1959","22","3561","9533","0","37.35","16.57"
"65","000","00","150","0018","0263","414","212","202","1","415","1230","0","33.74","17.24"
"65","000","00","150","0018","0264","401","204","197","4","405","1151","0","35.19","17.72"
"65","000","00","150","0018","0265","696","341","355","3","699","1879","0","37.20","18.15"
"65","000","00","150","0018","0266","599","241","358","6","605","1635","0","37.00","14.74"
"65","000","00","150","0018","0267","721","323","398","1","722","1808","0","39.93","17.87"
"65","000","00","150","0018","0268","708","259","449","7","715","1830","0","39.07","14.15"
"65","000","00","150","0019","0000","2739","1154","1585","23","2762","7004","0","39.43","16.48"
"65","000","00","150","0019","0284","546","223","323","3","549","1436","0","38.23","15.53"
"65","000","00","150","0019","0285","500","186","314","3","503","1317","0","38.19","14.12"
"65","000","00","150","0019","0286","549","251","298","8","557","1359","0","40.99","18.47"
"65","000","00","150","0019","0287","572","241","331","7","579","1483","0","39.04","16.25"
"65","000","00","150","0019","0288","572","253","319","2","574","1409","0","40.74","17.96"
"65","000","00","150","0020","0000","1023","435","588","8","1031","3018","0","34.16","14.41"
"65","000","00","150","0020","0282","507","195","312","5","512","1440","0","35.56","13.54"
"65","000","00","150","0020","0283","516","240","276","3","519","1578","0","32.89","15.21"
"65","000","00","160","0000","0000","26251","12619","13632","191","26442","64477","77862","41.01","19.57"
"65","000","00","160","0001","0000","325","128","197","3","328","822","0","39.90","15.57"
"65","000","00","160","0001","0296","228","84","144","3","231","646","0","35.76","13.00"
"65","000","00","160","0001","0297","97","44","53","0","97","176","0","55.11","25.00"
"65","000","00","160","0002","0000","1226","601","625","6","1232","3030","0","40.66","19.83"
"65","000","00","160","0002","0298","613","286","327","4","617","1445","0","42.70","19.79"
"65","000","00","160","0002","0299","613","315","298","2","615","1585","0","38.80","19.87"
"65","000","00","160","0003","0000","2247","1075","1172","10","2257","5956","0","37.89","18.05"
"65","000","00","160","0003","0300","619","326","293","4","623","1689","0","36.89","19.30"
"65","000","00","160","0003","0301","659","281","378","3","662","1784","0","37.11","15.75"
"65","000","00","160","0003","0302","428","239","189","1","429","1197","0","35.84","19.97"
"65","000","00","160","0003","0303","541","229","312","2","543","1286","0","42.22","17.81"
"65","000","00","160","0004","0000","986","455","531","17","1003","2521","0","39.79","18.05"
"65","000","00","160","0004","0304","486","238","248","9","495","1254","0","39.47","18.98"
"65","000","00","160","0004","0305","500","217","283","8","508","1267","0","40.09","17.13"
"65","000","00","160","0005","0000","1544","751","793","12","1556","3870","0","40.21","19.41"
"65","000","00","160","0005","0308","505","266","239","7","512","1283","0","39.91","20.73"
"65","000","00","160","0005","0309","481","229","252","0","481","1254","0","38.36","18.26"
"65","000","00","160","0005","0310","558","256","302","5","563","1333","0","42.24","19.20"
"65","000","00","160","0006","0000","1510","765","745","13","1523","3617","0","42.11","21.15"
"65","000","00","160","0006","0311","557","314","243","4","561","1312","0","42.76","23.93"
"65","000","00","160","0006","0312","540","259","281","7","547","1221","0","44.80","21.21"
"65","000","00","160","0006","0313","413","192","221","2","415","1084","0","38.28","17.71"
"65","000","00","160","0007","0000","1675","764","911","7","1682","4172","0","40.32","18.31"
"65","000","00","160","0007","0322","595","253","342","1","596","1404","0","42.45","18.02"
"65","000","00","160","0007","0323","537","231","306","6","543","1446","0","37.55","15.98"
"65","000","00","160","0007","0324","543","280","263","0","543","1322","0","41.07","21.18"
"65","000","00","160","0008","0000","1449","718","731","9","1458","3385","0","43.07","21.21"
"65","000","00","160","0008","0330","474","220","254","2","476","1277","0","37.27","17.23"
"65","000","00","160","0008","0331","475","237","238","2","477","1076","0","44.33","22.03"
"65","000","00","160","0008","0332","500","261","239","5","505","1032","0","48.93","25.29"
"65","000","00","160","0009","0000","1575","747","828","4","1579","3571","0","44.22","20.92"
"65","000","00","160","0009","0337","528","253","275","0","528","1227","0","43.03","20.62"
"65","000","00","160","0009","0338","605","283","322","1","606","1329","0","45.60","21.29"
"65","000","00","160","0009","0339","442","211","231","3","445","1015","0","43.84","20.79"
"65","000","00","160","0010","0000","1814","866","948","18","1832","4404","0","41.60","19.66"
"65","000","00","160","0010","0343","568","312","256","6","574","1387","0","41.38","22.49"
"65","000","00","160","0010","0344","571","261","310","8","579","1367","0","42.36","19.09"
"65","000","00","160","0010","0345","675","293","382","4","679","1650","0","41.15","17.76"
"65","000","00","160","0011","0000","1376","588","788","12","1388","3234","0","42.92","18.18"
"65","000","00","160","0011","0314","452","222","230","4","456","1085","0","42.03","20.46"
"65","000","00","160","0011","0315","468","194","274","2","470","1108","0","42.42","17.51"
"65","000","00","160","0011","0316","456","172","284","6","462","1041","0","44.38","16.52"
"65","000","00","160","0012","0000","2889","1379","1510","19","2908","7169","0","40.56","19.24"
"65","000","00","160","0012","0325","605","287","318","6","611","1520","0","40.20","18.88"
"65","000","00","160","0012","0326","639","262","377","4","643","1565","0","41.09","16.74"
"65","000","00","160","0012","0327","485","226","259","4","489","1310","0","37.33","17.25"
"65","000","00","160","0012","0328","582","307","275","3","585","1577","0","37.10","19.47"
"65","000","00","160","0012","0329","578","297","281","2","580","1197","0","48.45","24.81"
"65","000","00","160","0013","0000","771","382","389","2","773","1857","0","41.63","20.57"
"65","000","00","160","0013","0333","371","203","168","1","372","954","0","38.99","21.28"
"65","000","00","160","0013","0334","400","179","221","1","401","903","0","44.41","19.82"
"65","000","00","160","0014","0000","1148","524","624","9","1157","2868","0","40.34","18.27"
"65","000","00","160","0014","0335","561","253","308","4","565","1396","0","40.47","18.12"
"65","000","00","160","0014","0336","587","271","316","5","592","1472","0","40.22","18.41"
"65","000","00","160","0015","0000","1533","775","758","11","1544","3300","0","46.79","23.48"
"65","000","00","160","0015","0340","567","293","274","3","570","1110","0","51.35","26.40"
"65","000","00","160","0015","0341","476","258","218","3","479","1150","0","41.65","22.43"
"65","000","00","160","0015","0342","490","224","266","5","495","1040","0","47.60","21.54"
"65","000","00","160","0016","0000","1255","636","619","14","1269","3114","0","40.75","20.42"
"65","000","00","160","0016","0306","585","289","296","8","593","1513","0","39.19","19.10"
"65","000","00","160","0016","0307","670","347","323","6","676","1601","0","42.22","21.67"
"65","000","00","160","0017","0000","2928","1465","1463","25","2953","7587","0","38.92","19.31"
"65","000","00","160","0017","0317","538","278","260","6","544","1571","0","34.63","17.70"
"65","000","00","160","0017","0318","605","304","301","5","610","1584","0","38.51","19.19"
"65","000","00","160","0017","0319","725","374","351","6","731","1661","0","44.01","22.52"
"65","000","00","160","0017","0320","564","272","292","5","569","1479","0","38.47","18.39"
"65","000","00","160","0017","0321","496","237","259","3","499","1292","0","38.62","18.34"
"65","000","00","170","0000","0000","39428","21106","18322","308","39736","97167","123095","40.89","21.72"
"65","000","00","170","0001","0000","1226","530","696","13","1239","3528","0","35.12","15.02"
"65","000","00","170","0001","0167","387","161","226","6","393","1217","0","32.29","13.23"
"65","000","00","170","0001","0168","355","166","189","4","359","1114","0","32.23","14.90"
"65","000","00","170","0001","0169","484","203","281","3","487","1197","0","40.69","16.96"
"65","000","00","170","0002","0000","1732","844","888","15","1747","4811","0","36.31","17.54"
"65","000","00","170","0002","0170","508","264","244","6","514","1383","0","37.17","19.09"
"65","000","00","170","0002","0171","403","197","206","1","404","1157","0","34.92","17.03"
"65","000","00","170","0002","0172","419","195","224","5","424","1197","0","35.42","16.29"
"65","000","00","170","0002","0173","402","188","214","3","405","1074","0","37.71","17.50"
"65","000","00","170","0003","0000","3757","1966","1791","25","3782","9419","0","40.15","20.87"
"65","000","00","170","0003","0174","452","193","259","7","459","1292","0","35.53","14.94"
"65","000","00","170","0003","0175","386","199","187","3","389","1337","0","29.09","14.88"
"65","000","00","170","0003","0176","519","261","258","3","522","1367","0","38.19","19.09"
"65","000","00","170","0003","0177","636","357","279","4","640","1385","0","46.21","25.78"
"65","000","00","170","0003","0178","620","340","280","4","624","1351","0","46.19","25.17"
"65","000","00","170","0003","0179","565","291","274","2","567","1282","0","44.23","22.70"
"65","000","00","170","0003","0180","579","325","254","2","581","1405","0","41.35","23.13"
"65","000","00","170","0004","0000","1652","739","913","16","1668","3771","0","44.23","19.60"
"65","000","00","170","0004","0181","630","273","357","7","637","1345","0","47.36","20.30"
"65","000","00","170","0004","0182","421","155","266","8","429","1162","0","36.92","13.34"
"65","000","00","170","0004","0183","601","311","290","1","602","1264","0","47.63","24.60"
"65","000","00","170","0005","0000","1552","718","834","12","1564","4170","0","37.51","17.22"
"65","000","00","170","0005","0184","505","230","275","4","509","1348","0","37.76","17.06"
"65","000","00","170","0005","0185","455","248","207","5","460","1373","0","33.50","18.06"
"65","000","00","170","0005","0186","592","240","352","3","595","1449","0","41.06","16.56"
"65","000","00","170","0006","0000","616","235","381","7","623","1384","0","45.01","16.98"
"65","000","00","170","0006","0187","616","235","381","7","623","1384","0","45.01","16.98"
"65","000","00","170","0007","0000","8372","4822","3550","50","8422","20700","0","40.69","23.29"
"65","000","00","170","0007","0188","445","277","168","2","447","1181","0","37.85","23.45"
"65","000","00","170","0007","0189","450","277","173","2","452","1225","0","36.90","22.61"
"65","000","00","170","0007","0190","517","301","216","1","518","1363","0","38.00","22.08"
"65","000","00","170","0007","0191","555","342","213","3","558","1362","0","40.97","25.11"
"65","000","00","170","0007","0192","469","284","185","2","471","1228","0","38.36","23.13"
"65","000","00","170","0007","0193","506","308","198","2","508","1165","0","43.61","26.44"
"65","000","00","170","0007","0194","551","344","207","4","555","1168","0","47.52","29.45"
"65","000","00","170","0007","0195","644","370","274","5","649","1433","0","45.29","25.82"
"65","000","00","170","0007","0196","557","327","230","1","558","1194","0","46.73","27.39"
"65","000","00","170","0007","0197","512","308","204","1","513","1245","0","41.20","24.74"
"65","000","00","170","0007","0198","546","254","292","2","548","1353","0","40.50","18.77"
"65","000","00","170","0007","0199","472","225","247","4","476","1097","0","43.39","20.51"
"65","000","00","170","0007","0200","560","315","245","3","563","1447","0","38.91","21.77"
"65","000","00","170","0007","0201","505","281","224","5","510","1384","0","36.85","20.30"
"65","000","00","170","0007","0202","548","309","239","6","554","1421","0","38.99","21.75"
"65","000","00","170","0007","0203","535","300","235","7","542","1434","0","37.80","20.92"
"65","000","00","170","0008","0000","8639","4930","3709","68","8707","20299","0","42.89","24.29"
"65","000","00","170","0008","0204","542","286","256","1","543","1444","0","37.60","19.81"
"65","000","00","170","0008","0205","631","343","288","5","636","1365","0","46.59","25.13"
"65","000","00","170","0008","0206","503","228","275","10","513","1343","0","38.20","16.98"
"65","000","00","170","0008","0207","556","354","202","1","557","1258","0","44.28","28.14"
"65","000","00","170","0008","0208","568","315","253","8","576","1264","0","45.57","24.92"
"65","000","00","170","0008","0209","553","332","221","6","559","1274","0","43.88","26.06"
"65","000","00","170","0008","0210","622","357","265","1","623","1312","0","47.48","27.21"
"65","000","00","170","0008","0211","647","382","265","5","652","1413","0","46.14","27.03"
"65","000","00","170","0008","0212","557","317","240","4","561","1254","0","44.74","25.28"
"65","000","00","170","0008","0213","580","365","215","4","584","1351","0","43.23","27.02"
"65","000","00","170","0008","0214","542","306","236","3","545","1365","0","39.93","22.42"
"65","000","00","170","0008","0215","651","381","270","6","657","1702","0","38.60","22.39"
"65","000","00","170","0008","0216","593","316","277","6","599","1356","0","44.17","23.30"
"65","000","00","170","0008","0217","577","354","223","6","583","1379","0","42.28","25.67"
"65","000","00","170","0008","0218","517","294","223","2","519","1219","0","42.58","24.12"
"65","000","00","170","0009","0000","2730","1508","1222","20","2750","6489","0","42.38","23.24"
"65","000","00","170","0009","0230","521","284","237","5","526","1189","0","44.24","23.89"
"65","000","00","170","0009","0231","599","332","267","2","601","1262","0","47.62","26.31"
"65","000","00","170","0009","0232","489","288","201","3","492","1253","0","39.27","22.98"
"65","000","00","170","0009","0233","592","311","281","5","597","1315","0","45.40","23.65"
"65","000","00","170","0009","0234","529","293","236","5","534","1470","0","36.33","19.93"
"65","000","00","170","0010","0000","356","106","250","4","360","1010","0","35.64","10.50"
"65","000","00","170","0010","0238","356","106","250","4","360","1010","0","35.64","10.50"
"65","000","00","170","0011","0000","447","199","248","10","457","1229","0","37.18","16.19"
"65","000","00","170","0011","0239","447","199","248","10","457","1229","0","37.18","16.19"
"65","000","00","170","0012","0000","396","144","252","5","401","911","0","44.02","15.81"
"65","000","00","170","0012","0240","396","144","252","5","401","911","0","44.02","15.81"
"65","000","00","170","0013","0000","263","101","162","0","263","763","0","34.47","13.24"
"65","000","00","170","0013","0241","263","101","162","0","263","763","0","34.47","13.24"
"65","000","00","170","0014","0000","463","158","305","3","466","1461","0","31.90","10.81"
"65","000","00","170","0014","0242","463","158","305","3","466","1461","0","31.90","10.81"
"65","000","00","170","0015","0000","2520","1463","1057","15","2535","6006","0","42.21","24.36"
"65","000","00","170","0015","0219","408","227","181","5","413","1099","0","37.58","20.66"
"65","000","00","170","0015","0220","486","293","193","2","488","1157","0","42.18","25.32"
"65","000","00","170","0015","0221","453","271","182","5","458","1191","0","38.46","22.75"
"65","000","00","170","0015","0222","552","331","221","1","553","1190","0","46.47","27.82"
"65","000","00","170","0015","0223","621","341","280","2","623","1369","0","45.51","24.91"
"65","000","00","170","0016","0000","3150","1838","1312","29","3179","7589","0","41.89","24.22"
"65","000","00","170","0016","0224","569","343","226","4","573","1355","0","42.29","25.31"
"65","000","00","170","0016","0225","423","230","193","5","428","1140","0","37.54","20.18"
"65","000","00","170","0016","0226","478","295","183","7","485","1207","0","40.18","24.44"
"65","000","00","170","0016","0227","517","307","210","3","520","1233","0","42.17","24.90"
"65","000","00","170","0016","0228","584","341","243","5","589","1404","0","41.95","24.29"
"65","000","00","170","0016","0229","579","322","257","5","584","1250","0","46.72","25.76"
"65","000","00","170","0017","0000","1557","805","752","16","1573","3627","0","43.37","22.19"
"65","000","00","170","0017","0235","513","269","244","3","516","1308","0","39.45","20.57"
"65","000","00","170","0017","0236","500","257","243","3","503","1126","0","44.67","22.82"
"65","000","00","170","0017","0237","544","279","265","10","554","1193","0","46.44","23.39"
"65","000","00","180","0000","0000","9004","4778","4226","67","9071","20901","23730","43.40","22.86"
"65","000","00","180","0001","0000","1327","648","679","10","1337","3097","0","43.17","20.92"
"65","000","00","180","0001","2326","617","282","335","6","623","1536","0","40.56","18.36"
"65","000","00","180","0001","2327","710","366","344","4","714","1561","0","45.74","23.45"
"65","000","00","180","0002","0000","958","475","483","6","964","2316","0","41.62","20.51"
"65","000","00","180","0002","2320","449","207","242","1","450","1157","0","38.89","17.89"
"65","000","00","180","0002","2321","509","268","241","5","514","1159","0","44.35","23.12"
"65","000","00","180","0003","0000","1145","592","553","8","1153","2749","0","41.94","21.54"
"65","000","00","180","0003","2324","589","309","280","5","594","1376","0","43.17","22.46"
"65","000","00","180","0003","2325","556","283","273","3","559","1373","0","40.71","20.61"
"65","000","00","180","0004","0000","901","501","400","9","910","1926","0","47.25","26.01"
"65","000","00","180","0004","2332","343","144","199","6","349","765","0","45.62","18.82"
"65","000","00","180","0004","2333","558","357","201","3","561","1161","0","48.32","30.75"
"65","000","00","180","0005","0000","236","111","125","2","238","558","0","42.65","19.89"
"65","000","00","180","0005","2336","236","111","125","2","238","558","0","42.65","19.89"
"65","000","00","180","0006","0000","2431","1349","1082","16","2447","5654","0","43.28","23.86"
"65","000","00","180","0006","2328","615","340","275","6","621","1458","0","42.59","23.32"
"65","000","00","180","0006","2329","626","367","259","7","633","1402","0","45.15","26.18"
"65","000","00","180","0006","2330","554","311","243","2","556","1334","0","41.68","23.31"
"65","000","00","180","0006","2331","636","331","305","1","637","1460","0","43.63","22.67"
"65","000","00","180","0007","0000","1044","527","517","7","1051","2486","0","42.28","21.20"
"65","000","00","180","0007","2322","436","199","237","4","440","1063","0","41.39","18.72"
"65","000","00","180","0007","2323","608","328","280","3","611","1423","0","42.94","23.05"
"65","000","00","180","0008","0000","962","575","387","9","971","2115","0","45.91","27.19"
"65","000","00","180","0008","2334","618","382","236","5","623","1380","0","45.14","27.68"
"65","000","00","180","0008","2335","344","193","151","4","348","735","0","47.35","26.26"
"65","000","00","190","0000","0000","2606","1023","1583","26","2632","6790","7487","38.76","15.07"
"65","000","00","190","0001","0000","143","55","88","0","143","365","0","39.18","15.07"
"65","000","00","190","0001","2337","143","55","88","0","143","365","0","39.18","15.07"
"65","000","00","190","0002","0000","292","152","140","1","293","798","0","36.72","19.05"
"65","000","00","190","0002","2338","292","152","140","1","293","798","0","36.72","19.05"
"65","000","00","190","0003","0000","237","96","141","3","240","668","0","35.93","14.37"
"65","000","00","190","0003","2343","237","96","141","3","240","668","0","35.93","14.37"
"65","000","00","190","0004","0000","243","86","157","2","245","607","0","40.36","14.17"
"65","000","00","190","0004","2339","243","86","157","2","245","607","0","40.36","14.17"
"65","000","00","190","0005","0000","103","44","59","3","106","296","0","35.81","14.86"
"65","000","00","190","0005","2340","103","44","59","3","106","296","0","35.81","14.86"
"65","000","00","190","0006","0000","185","85","100","0","185","387","0","47.80","21.96"
"65","000","00","190","0006","2341","134","64","70","0","134","291","0","46.05","21.99"
"65","000","00","190","0006","2342","51","21","30","0","51","96","0","53.13","21.88"
"65","000","00","190","0007","0000","200","77","123","5","205","589","0","34.80","13.07"
"65","000","00","190","0007","2346","200","77","123","5","205","589","0","34.80","13.07"
"65","000","00","190","0008","0000","248","99","149","3","251","717","0","35.01","13.81"
"65","000","00","190","0008","2345","248","99","149","3","251","717","0","35.01","13.81"
"65","000","00","190","0009","0000","106","34","72","1","107","261","0","41.00","13.03"
"65","000","00","190","0009","2347","106","34","72","1","107","261","0","41.00","13.03"
"65","000","00","190","0010","0000","124","62","62","0","124","302","0","41.06","20.53"
"65","000","00","190","0010","2344","124","62","62","0","124","302","0","41.06","20.53"
"65","000","00","190","0011","0000","314","99","215","5","319","809","0","39.43","12.24"
"65","000","00","190","0011","2348","314","99","215","5","319","809","0","39.43","12.24"
"65","000","00","190","0012","0000","411","134","277","3","414","991","0","41.78","13.52"
"65","000","00","190","0012","2349","411","134","277","3","414","991","0","41.78","13.52"
"65","000","00","200","0000","0000","2202","829","1373","22","2224","6057","6670","36.72","13.69"
"65","000","00","200","0001","0000","323","145","178","4","327","853","0","38.34","17.00"
"65","000","00","200","0001","2354","221","93","128","1","222","583","0","38.08","15.95"
"65","000","00","200","0001","2355","102","52","50","3","105","270","0","38.89","19.26"
"65","000","00","200","0002","0000","500","204","296","2","502","1290","0","38.91","15.81"
"65","000","00","200","0002","2350","500","204","296","2","502","1290","0","38.91","15.81"
"65","000","00","200","0003","0000","439","134","305","5","444","1167","0","38.05","11.48"
"65","000","00","200","0003","2352","439","134","305","5","444","1167","0","38.05","11.48"
"65","000","00","200","0004","0000","135","45","90","4","139","420","0","33.10","10.71"
"65","000","00","200","0004","2353","135","45","90","4","139","420","0","33.10","10.71"
"65","000","00","200","0005","0000","280","128","152","4","284","836","0","33.97","15.31"
"65","000","00","200","0005","2356","111","29","82","1","112","350","0","32.00","8.29"
"65","000","00","200","0005","2357","169","99","70","3","172","486","0","35.39","20.37"
"65","000","00","200","0006","0000","211","81","130","1","212","631","0","33.60","12.84"
"65","000","00","200","0006","2351","211","81","130","1","212","631","0","33.60","12.84"
"65","000","00","200","0007","0000","314","92","222","2","316","860","0","36.74","10.70"
"65","000","00","200","0007","2358","162","50","112","0","162","402","0","40.30","12.44"
"65","000","00","200","0007","2359","152","42","110","2","154","458","0","33.62","9.17"
"65","000","00","210","0000","0000","6775","3495","3280","80","6855","19927","22460","34.40","17.54"
"65","000","00","210","0001","0000","106","31","75","1","107","311","0","34.41","9.97"
"65","000","00","210","0001","0011","106","31","75","1","107","311","0","34.41","9.97"
"65","000","00","210","0002","0000","1555","818","737","12","1567","4787","0","32.73","17.09"
"65","000","00","210","0002","0012","399","224","175","5","404","1228","0","32.90","18.24"
"65","000","00","210","0002","0013","429","229","200","3","432","1228","0","35.18","18.65"
"65","000","00","210","0002","0014","394","201","193","2","396","1250","0","31.68","16.08"
"65","000","00","210","0002","0015","333","164","169","2","335","1081","0","30.99","15.17"
"65","000","00","210","0003","0000","381","201","180","3","384","1113","0","34.50","18.06"
"65","000","00","210","0003","0016","381","201","180","3","384","1113","0","34.50","18.06"
"65","000","00","210","0004","0000","272","134","138","4","276","776","0","35.57","17.27"
"65","000","00","210","0004","0017","272","134","138","4","276","776","0","35.57","17.27"
"65","000","00","210","0005","0000","1895","1018","877","25","1920","6124","0","31.35","16.62"
"65","000","00","210","0005","0018","411","216","195","5","416","1267","0","32.83","17.05"
"65","000","00","210","0005","0019","403","206","197","5","408","1324","0","30.82","15.56"
"65","000","00","210","0005","0020","373","210","163","4","377","1174","0","32.11","17.89"
"65","000","00","210","0005","0021","346","175","171","7","353","1207","0","29.25","14.50"
"65","000","00","210","0005","0022","362","211","151","4","366","1152","0","31.77","18.32"
"65","000","00","210","0006","0000","277","146","131","2","279","604","0","46.19","24.17"
"65","000","00","210","0006","0023","277","146","131","2","279","604","0","46.19","24.17"
"65","000","00","210","0007","0000","158","89","69","4","162","477","0","33.96","18.66"
"65","000","00","210","0007","0024","158","89","69","4","162","477","0","33.96","18.66"
"65","000","00","210","0008","0000","281","132","149","4","285","661","0","43.12","19.97"
"65","000","00","210","0008","0025","281","132","149","4","285","661","0","43.12","19.97"
"65","000","00","210","0009","0000","774","461","313","6","780","2030","0","38.42","22.71"
"65","000","00","210","0009","0026","316","170","146","2","318","862","0","36.89","19.72"
"65","000","00","210","0009","0027","458","291","167","4","462","1168","0","39.55","24.91"
"65","000","00","210","0010","0000","298","155","143","6","304","762","0","39.90","20.34"
"65","000","00","210","0010","0028","298","155","143","6","304","762","0","39.90","20.34"
"65","000","00","210","0011","0000","153","58","95","5","158","532","0","29.70","10.90"
"65","000","00","210","0011","0029","153","58","95","5","158","532","0","29.70","10.90"
"65","000","00","210","0012","0000","191","78","113","1","192","580","0","33.10","13.45"
"65","000","00","210","0012","0030","191","78","113","1","192","580","0","33.10","13.45"
"65","000","00","210","0013","0000","434","174","260","7","441","1170","0","37.69","14.87"
"65","000","00","210","0013","0031","434","174","260","7","441","1170","0","37.69","14.87"
"65","000","00","220","0000","0000","3206","1664","1542","43","3249","10089","11303","32.20","16.49"
"65","000","00","220","0001","0000","337","152","185","5","342","1087","0","31.46","13.98"
"65","000","00","220","0001","0001","337","152","185","5","342","1087","0","31.46","13.98"
"65","000","00","220","0002","0000","481","247","234","7","488","1316","0","37.08","18.77"
"65","000","00","220","0002","0002","481","247","234","7","488","1316","0","37.08","18.77"
"65","000","00","220","0003","0000","627","316","311","9","636","2052","0","30.99","15.40"
"65","000","00","220","0003","0003","317","164","153","4","321","876","0","36.64","18.72"
"65","000","00","220","0003","0004","310","152","158","5","315","1176","0","26.79","12.93"
"65","000","00","220","0004","0000","266","141","125","4","270","867","0","31.14","16.26"
"65","000","00","220","0004","0005","266","141","125","4","270","867","0","31.14","16.26"
"65","000","00","220","0005","0000","516","301","215","9","525","1496","0","35.09","20.12"
"65","000","00","220","0005","0006","516","301","215","9","525","1496","0","35.09","20.12"
"65","000","00","220","0006","0000","426","224","202","7","433","1452","0","29.82","15.43"
"65","000","00","220","0006","0007","426","224","202","7","433","1452","0","29.82","15.43"
"65","000","00","220","0007","0000","100","51","49","0","100","315","0","31.75","16.19"
"65","000","00","220","0007","0008","100","51","49","0","100","315","0","31.75","16.19"
"65","000","00","220","0008","0000","194","92","102","0","194","589","0","32.94","15.62"
"65","000","00","220","0008","0009","194","92","102","0","194","589","0","32.94","15.62"
"65","000","00","220","0009","0000","259","140","119","2","261","915","0","28.52","15.30"
"65","000","00","220","0009","0010","259","140","119","2","261","915","0","28.52","15.30"
"65","000","00","230","0000","0000","12727","6043","6684","99","12826","34221","39799","37.48","17.66"
"65","000","00","230","0001","0000","2778","1374","1404","23","2801","6740","0","41.56","20.39"
"65","000","00","230","0001","0146","712","297","415","7","719","1851","0","38.84","16.05"
"65","000","00","230","0001","0147","715","394","321","6","721","1727","0","41.75","22.81"
"65","000","00","230","0001","0148","610","302","308","4","614","1504","0","40.82","20.08"
"65","000","00","230","0001","0149","741","381","360","6","747","1658","0","45.05","22.98"
"65","000","00","230","0002","0000","1191","595","596","7","1198","3256","0","36.79","18.27"
"65","000","00","230","0002","0150","617","298","319","4","621","1748","0","35.53","17.05"
"65","000","00","230","0002","0151","574","297","277","3","577","1508","0","38.26","19.69"
"65","000","00","230","0003","0000","1209","554","655","5","1214","3091","0","39.28","17.92"
"65","000","00","230","0003","0152","680","312","368","3","683","1611","0","42.40","19.37"
"65","000","00","230","0003","0153","529","242","287","2","531","1480","0","35.88","16.35"
"65","000","00","230","0004","0000","1417","648","769","9","1426","3745","0","38.08","17.30"
"65","000","00","230","0004","0154","627","255","372","2","629","1770","0","35.54","14.41"
"65","000","00","230","0004","0155","790","393","397","7","797","1975","0","40.35","19.90"
"65","000","00","230","0005","0000","779","375","404","8","787","2139","0","36.79","17.53"
"65","000","00","230","0005","0156","779","375","404","8","787","2139","0","36.79","17.53"
"65","000","00","230","0006","0000","2324","1062","1262","17","2341","6501","0","36.01","16.34"
"65","000","00","230","0006","0157","582","256","326","6","588","1568","0","37.50","16.33"
"65","000","00","230","0006","0158","603","281","322","4","607","1630","0","37.24","17.24"
"65","000","00","230","0006","0159","595","264","331","2","597","1656","0","36.05","15.94"
"65","000","00","230","0006","0160","544","261","283","5","549","1647","0","33.33","15.85"
"65","000","00","230","0007","0000","1463","697","766","15","1478","4113","0","35.93","16.95"
"65","000","00","230","0007","0161","531","266","265","4","535","1388","0","38.54","19.16"
"65","000","00","230","0007","0162","440","213","227","3","443","1380","0","32.10","15.43"
"65","000","00","230","0007","0163","492","218","274","8","500","1345","0","37.17","16.21"
"65","000","00","230","0008","0000","562","260","302","3","565","1639","0","34.47","15.86"
"65","000","00","230","0008","0164","562","260","302","3","565","1639","0","34.47","15.86"
"65","000","00","230","0009","0000","510","238","272","5","515","1521","0","33.86","15.65"
"65","000","00","230","0009","0165","510","238","272","5","515","1521","0","33.86","15.65"
"65","000","00","230","0010","0000","494","240","254","7","501","1476","0","33.94","16.26"
"65","000","00","230","0010","0166","494","240","254","7","501","1476","0","33.94","16.26"
"65","000","00","240","0000","0000","1451","680","771","22","1473","4076","4354","36.14","16.68"
"65","000","00","240","0001","0000","133","54","79","1","134","361","0","37.12","14.96"
"65","000","00","240","0001","2367","133","54","79","1","134","361","0","37.12","14.96"
"65","000","00","240","0002","0000","85","51","34","0","85","226","0","37.61","22.57"
"65","000","00","240","0002","2368","85","51","34","0","85","226","0","37.61","22.57"
"65","000","00","240","0003","0000","96","43","53","1","97","229","0","42.36","18.78"
"65","000","00","240","0003","2369","96","43","53","1","97","229","0","42.36","18.78"
"65","000","00","240","0004","0000","159","55","104","2","161","417","0","38.61","13.19"
"65","000","00","240","0004","2370","159","55","104","2","161","417","0","38.61","13.19"
"65","000","00","240","0005","0000","102","64","38","0","102","247","0","41.30","25.91"
"65","000","00","240","0005","2371","102","64","38","0","102","247","0","41.30","25.91"
"65","000","00","240","0006","0000","178","85","93","2","180","586","0","30.72","14.51"
"65","000","00","240","0006","2372","178","85","93","2","180","586","0","30.72","14.51"
"65","000","00","240","0007","0000","157","76","81","3","160","406","0","39.41","18.72"
"65","000","00","240","0007","2373","157","76","81","3","160","406","0","39.41","18.72"
"65","000","00","240","0008","0000","58","25","33","0","58","154","0","37.66","16.23"
"65","000","00","240","0008","2375","58","25","33","0","58","154","0","37.66","16.23"
"65","000","00","240","0009","0000","120","57","63","4","124","337","0","36.80","16.91"
"65","000","00","240","0009","2376","120","57","63","4","124","337","0","36.80","16.91"
"65","000","00","240","0010","0000","72","31","41","0","72","164","0","43.90","18.90"
"65","000","00","240","0010","2378","72","31","41","0","72","164","0","43.90","18.90"
"65","000","00","240","0011","0000","251","119","132","9","260","798","0","32.58","14.91"
"65","000","00","240","0011","2374","251","119","132","9","260","798","0","32.58","14.91"
"65","000","00","240","0012","0000","40","20","20","0","40","151","0","26.49","13.25"
"65","000","00","240","0012","2377","40","20","20","0","40","151","0","26.49","13.25"
"65","000","00","250","0000","0000","2686","1285","1401","50","2736","7605","8307","35.98","16.90"
"65","000","00","250","0001","0000","177","105","72","2","179","444","0","40.32","23.65"
"65","000","00","250","0001","2425","177","105","72","2","179","444","0","40.32","23.65"
"65","000","00","250","0002","0000","132","59","73","2","134","363","0","36.91","16.25"
"65","000","00","250","0002","2437","132","59","73","2","134","363","0","36.91","16.25"
"65","000","00","250","0003","0000","295","166","129","9","304","713","0","42.64","23.28"
"65","000","00","250","0003","2426","120","74","46","2","122","268","0","45.52","27.61"
"65","000","00","250","0003","2427","175","92","83","7","182","445","0","40.90","20.67"
"65","000","00","250","0004","0000","230","102","128","4","234","678","0","34.51","15.04"
"65","000","00","250","0004","2438","108","36","72","1","109","337","0","32.34","10.68"
"65","000","00","250","0004","2439","122","66","56","3","125","341","0","36.66","19.35"
"65","000","00","250","0005","0000","122","52","70","2","124","345","0","35.94","15.07"
"65","000","00","250","0005","2428","122","52","70","2","124","345","0","35.94","15.07"
"65","000","00","250","0006","0000","490","225","265","12","502","1416","0","35.45","15.89"
"65","000","00","250","0006","2429","277","122","155","5","282","800","0","35.25","15.25"
"65","000","00","250","0006","2430","213","103","110","7","220","616","0","35.71","16.72"
"65","000","00","250","0007","0000","107","51","56","1","108","319","0","33.86","15.99"
"65","000","00","250","0007","2431","107","51","56","1","108","319","0","33.86","15.99"
"65","000","00","250","0008","0000","332","179","153","0","332","860","0","38.60","20.81"
"65","000","00","250","0008","2432","216","112","104","0","216","602","0","35.88","18.60"
"65","000","00","250","0008","2433","116","67","49","0","116","258","0","44.96","25.97"
"65","000","00","250","0009","0000","203","75","128","8","211","593","0","35.58","12.65"
"65","000","00","250","0009","2434","203","75","128","8","211","593","0","35.58","12.65"
"65","000","00","250","0010","0000","161","77","84","2","163","394","0","41.37","19.54"
"65","000","00","250","0010","2435","161","77","84","2","163","394","0","41.37","19.54"
"65","000","00","250","0011","0000","109","35","74","0","109","351","0","31.05","9.97"
"65","000","00","250","0011","2436","109","35","74","0","109","351","0","31.05","9.97"
"65","000","00","250","0012","0000","328","159","169","8","336","1129","0","29.76","14.08"
"65","000","00","250","0012","2440","328","159","169","8","336","1129","0","29.76","14.08"
"65","000","00","260","0000","0000","4143","1268","2875","63","4206","10765","11658","39.07","11.78"
"65","000","00","260","0001","0000","316","138","178","4","320","823","0","38.88","16.77"
"65","000","00","260","0001","2441","316","138","178","4","320","823","0","38.88","16.77"
"65","000","00","260","0002","0000","159","52","107","3","162","462","0","35.06","11.26"
"65","000","00","260","0002","2443","159","52","107","3","162","462","0","35.06","11.26"
"65","000","00","260","0003","0000","240","83","157","6","246","631","0","38.99","13.15"
"65","000","00","260","0003","2444","120","37","83","2","122","341","0","35.78","10.85"
"65","000","00","260","0003","2445","120","46","74","4","124","290","0","42.76","15.86"
"65","000","00","260","0004","0000","146","46","100","2","148","398","0","37.19","11.56"
"65","000","00","260","0004","2442","146","46","100","2","148","398","0","37.19","11.56"
"65","000","00","260","0005","0000","279","69","210","5","284","630","0","45.08","10.95"
"65","000","00","260","0005","2450","279","69","210","5","284","630","0","45.08","10.95"
"65","000","00","260","0006","0000","588","226","362","7","595","1599","0","37.21","14.13"
"65","000","00","260","0006","2448","290","123","167","3","293","776","0","37.76","15.85"
"65","000","00","260","0006","2449","298","103","195","4","302","823","0","36.70","12.52"
"65","000","00","260","0007","0000","730","233","497","11","741","1652","0","44.85","14.10"
"65","000","00","260","0007","2453","317","113","204","4","321","725","0","44.28","15.59"
"65","000","00","260","0007","2454","413","120","293","7","420","927","0","45.31","12.94"
"65","000","00","260","0008","0000","732","148","584","17","749","1987","0","37.70","7.45"
"65","000","00","260","0008","2451","387","87","300","14","401","1072","0","37.41","8.12"
"65","000","00","260","0008","2452","345","61","284","3","348","915","0","38.03","6.67"
"65","000","00","260","0009","0000","321","94","227","0","321","886","0","36.23","10.61"
"65","000","00","260","0009","2446","171","59","112","0","171","495","0","34.55","11.92"
"65","000","00","260","0009","2447","150","35","115","0","150","391","0","38.36","8.95"
"65","000","00","260","0010","0000","292","95","197","7","299","716","0","41.76","13.27"
"65","000","00","260","0010","2455","174","53","121","2","176","391","0","45.01","13.55"
"65","000","00","260","0010","2456","118","42","76","5","123","325","0","37.85","12.92"
"65","000","00","260","0011","0000","340","84","256","1","341","981","0","34.76","8.56"
"65","000","00","260","0011","2457","181","44","137","0","181","490","0","36.94","8.98"
"65","000","00","260","0011","2458","159","40","119","1","160","491","0","32.59","8.15"
"65","000","00","270","0000","0000","6511","2895","3616","67","6578","18573","20926","35.42","15.59"
"65","000","00","270","0001","0000","190","107","83","1","191","456","0","41.89","23.46"
"65","000","00","270","0001","2459","190","107","83","1","191","456","0","41.89","23.46"
"65","000","00","270","0002","0000","241","119","122","5","246","712","0","34.55","16.71"
"65","000","00","270","0002","2460","241","119","122","5","246","712","0","34.55","16.71"
"65","000","00","270","0003","0000","193","82","111","2","195","502","0","38.84","16.33"
"65","000","00","270","0003","2461","193","82","111","2","195","502","0","38.84","16.33"
"65","000","00","270","0004","0000","624","210","414","6","630","1719","0","36.65","12.22"
"65","000","00","270","0004","2462","282","94","188","1","283","802","0","35.29","11.72"
"65","000","00","270","0004","2463","342","116","226","5","347","917","0","37.84","12.65"
"65","000","00","270","0005","0000","1306","633","673","14","1320","3777","0","34.95","16.76"
"65","000","00","270","0005","2470","452","181","271","9","461","1241","0","37.15","14.59"
"65","000","00","270","0005","2471","408","198","210","2","410","1229","0","33.36","16.11"
"65","000","00","270","0005","2472","446","254","192","3","449","1307","0","34.35","19.43"
"65","000","00","270","0006","0000","602","296","306","3","605","1641","0","36.87","18.04"
"65","000","00","270","0006","2468","319","163","156","2","321","783","0","41.00","20.82"
"65","000","00","270","0006","2469","283","133","150","1","284","858","0","33.10","15.50"
"65","000","00","270","0007","0000","403","162","241","3","406","1182","0","34.35","13.71"
"65","000","00","270","0007","2473","403","162","241","3","406","1182","0","34.35","13.71"
"65","000","00","270","0008","0000","121","57","64","2","123","377","0","32.63","15.12"
"65","000","00","270","0008","2474","121","57","64","2","123","377","0","32.63","15.12"
"65","000","00","270","0009","0000","239","89","150","5","244","643","0","37.95","13.84"
"65","000","00","270","0009","2475","239","89","150","5","244","643","0","37.95","13.84"
"65","000","00","270","0010","0000","234","94","140","3","237","619","0","38.29","15.19"
"65","000","00","270","0010","2476","234","94","140","3","237","619","0","38.29","15.19"
"65","000","00","270","0011","0000","252","111","141","2","254","801","0","31.71","13.86"
"65","000","00","270","0011","2478","252","111","141","2","254","801","0","31.71","13.86"
"65","000","00","270","0012","0000","164","54","110","2","166","443","0","37.47","12.19"
"65","000","00","270","0012","2477","164","54","110","2","166","443","0","37.47","12.19"
"65","000","00","270","0013","0000","72","31","41","1","73","177","0","41.24","17.51"
"65","000","00","270","0013","2479","72","31","41","1","73","177","0","41.24","17.51"
"65","000","00","270","0014","0000","177","70","107","5","182","570","0","31.93","12.28"
"65","000","00","270","0014","2480","177","70","107","5","182","570","0","31.93","12.28"
"65","000","00","270","0015","0000","1693","780","913","13","1706","4954","0","34.44","15.74"
"65","000","00","270","0015","2464","442","188","254","2","444","1183","0","37.53","15.89"
"65","000","00","270","0015","2465","503","241","262","4","507","1352","0","37.50","17.83"
"65","000","00","270","0015","2466","405","184","221","4","409","1269","0","32.23","14.50"
"65","000","00","270","0015","2467","343","167","176","3","346","1150","0","30.09","14.52"
"65","000","00","280","0000","0000","6344","3097","3247","58","6402","19074","21542","33.56","16.24"
"65","000","00","280","0001","0000","1475","753","722","10","1485","4232","0","35.09","17.79"
"65","000","00","280","0001","2481","352","202","150","1","353","1004","0","35.16","20.12"
"65","000","00","280","0001","2482","289","144","145","3","292","903","0","32.34","15.95"
"65","000","00","280","0001","2483","361","183","178","2","363","937","0","38.74","19.53"
"65","000","00","280","0001","2484","473","224","249","4","477","1388","0","34.37","16.14"
"65","000","00","280","0002","0000","764","385","379","5","769","2548","0","30.18","15.11"
"65","000","00","280","0002","2487","365","197","168","2","367","1229","0","29.86","16.03"
"65","000","00","280","0002","2488","399","188","211","3","402","1319","0","30.48","14.25"
"65","000","00","280","0003","0000","1021","474","547","10","1031","3153","0","32.70","15.03"
"65","000","00","280","0003","2489","277","124","153","5","282","838","0","33.65","14.80"
"65","000","00","280","0003","2490","248","117","131","0","248","799","0","31.04","14.64"
"65","000","00","280","0003","2491","496","233","263","5","501","1516","0","33.05","15.37"
"65","000","00","280","0004","0000","949","477","472","10","959","2681","0","35.77","17.79"
"65","000","00","280","0004","2492","327","155","172","5","332","951","0","34.91","16.30"
"65","000","00","280","0004","2493","349","155","194","5","354","893","0","39.64","17.36"
"65","000","00","280","0004","2494","273","167","106","0","273","837","0","32.62","19.95"
"65","000","00","280","0005","0000","183","91","92","2","185","574","0","32.23","15.85"
"65","000","00","280","0005","2495","183","91","92","2","185","574","0","32.23","15.85"
"65","000","00","280","0006","0000","323","128","195","7","330","966","0","34.16","13.25"
"65","000","00","280","0006","2496","323","128","195","7","330","966","0","34.16","13.25"
"65","000","00","280","0007","0000","201","71","130","3","204","659","0","30.96","10.77"
"65","000","00","280","0007","2497","201","71","130","3","204","659","0","30.96","10.77"
"65","000","00","280","0008","0000","147","50","97","1","148","403","0","36.72","12.41"
"65","000","00","280","0008","2498","147","50","97","1","148","403","0","36.72","12.41"
"65","000","00","280","0009","0000","355","170","185","4","359","1107","0","32.43","15.36"
"65","000","00","280","0009","2499","355","170","185","4","359","1107","0","32.43","15.36"
"65","000","00","280","0010","0000","926","498","428","6","932","2751","0","33.88","18.10"
"65","000","00","280","0010","2485","474","272","202","4","478","1411","0","33.88","19.28"
"65","000","00","280","0010","2486","452","226","226","2","454","1340","0","33.88","16.87"
"65","000","00","290","0000","0000","1689","1027","662","18","1707","5261","6343","32.45","19.52"
"65","000","00","290","0001","0000","779","478","301","7","786","2348","0","33.48","20.36"
"65","000","00","290","0001","2362","446","255","191","3","449","1186","0","37.86","21.50"
"65","000","00","290","0001","2363","333","223","110","4","337","1162","0","29.00","19.19"
"65","000","00","290","0002","0000","534","331","203","4","538","1572","0","34.22","21.06"
"65","000","00","290","0002","2360","349","186","163","4","353","938","0","37.63","19.83"
"65","000","00","290","0002","2361","185","145","40","0","185","634","0","29.18","22.87"
"65","000","00","290","0003","0000","153","119","34","5","158","606","0","26.07","19.64"
"65","000","00","290","0003","2366","153","119","34","5","158","606","0","26.07","19.64"
"65","000","00","290","0004","0000","156","73","83","1","157","504","0","31.15","14.48"
"65","000","00","290","0004","2365","156","73","83","1","157","504","0","31.15","14.48"
"65","000","00","290","0005","0000","67","26","41","1","68","231","0","29.44","11.26"
"65","000","00","290","0005","2364","67","26","41","1","68","231","0","29.44","11.26"
"68","000","00","000","0000","0000","741985","394314","347671","6189","748174","1869908","2272459","40.01","21.09"
"68","000","00","010","0000","0000","154109","79361","74748","1156","155265","375012","458824","41.40","21.16"
"68","000","00","010","0001","0000","484","236","248","3","487","1024","0","47.56","23.05"
"68","000","00","010","0001","0036","484","236","248","3","487","1024","0","47.56","23.05"
"68","000","00","010","0002","0000","688","339","349","7","695","1396","0","49.79","24.28"
"68","000","00","010","0002","0038","688","339","349","7","695","1396","0","49.79","24.28"
"68","000","00","010","0003","0000","623","298","325","4","627","1628","0","38.51","18.30"
"68","000","00","010","0003","0047","623","298","325","4","627","1628","0","38.51","18.30"
"68","000","00","010","0004","0000","2537","1212","1325","22","2559","6940","0","36.87","17.46"
"68","000","00","010","0004","0001","550","258","292","8","558","1515","0","36.83","17.03"
"68","000","00","010","0004","0002","388","206","182","0","388","1110","0","34.95","18.56"
"68","000","00","010","0004","0003","469","221","248","6","475","1357","0","35.00","16.29"
"68","000","00","010","0004","0004","599","267","332","5","604","1422","0","42.48","18.78"
"68","000","00","010","0004","0005","531","260","271","3","534","1536","0","34.77","16.93"
"68","000","00","010","0005","0000","1367","757","610","10","1377","3581","0","38.45","21.14"
"68","000","00","010","0005","0219","696","408","288","5","701","1850","0","37.89","22.05"
"68","000","00","010","0005","0220","671","349","322","5","676","1731","0","39.05","20.16"
"68","000","00","010","0006","0000","3772","2182","1590","24","3796","9791","0","38.77","22.29"
"68","000","00","010","0006","0233","613","333","280","5","618","1612","0","38.34","20.66"
"68","000","00","010","0006","0234","584","336","248","4","588","1483","0","39.65","22.66"
"68","000","00","010","0006","0235","607","337","270","3","610","1694","0","36.01","19.89"
"68","000","00","010","0006","0236","675","387","288","3","678","1728","0","39.24","22.40"
"68","000","00","010","0006","0237","689","417","272","5","694","1709","0","40.61","24.40"
"68","000","00","010","0006","0238","604","372","232","4","608","1565","0","38.85","23.77"
"68","000","00","010","0007","0000","467","162","305","4","471","1005","0","46.87","16.12"
"68","000","00","010","0007","0048","467","162","305","4","471","1005","0","46.87","16.12"
"68","000","00","010","0008","0000","682","338","344","4","686","1649","0","41.60","20.50"
"68","000","00","010","0008","0040","682","338","344","4","686","1649","0","41.60","20.50"
"68","000","00","010","0009","0000","744","310","434","8","752","1820","0","41.32","17.03"
"68","000","00","010","0009","0041","744","310","434","8","752","1820","0","41.32","17.03"
"68","000","00","010","0010","0000","2595","1161","1434","20","2615","6542","0","39.97","17.75"
"68","000","00","010","0010","0215","848","395","453","6","854","2211","0","38.63","17.87"
"68","000","00","010","0010","0216","614","279","335","6","620","1496","0","41.44","18.65"
"68","000","00","010","0010","0217","571","289","282","6","577","1496","0","38.57","19.32"
"68","000","00","010","0010","0218","562","198","364","2","564","1339","0","42.12","14.79"
"68","000","00","010","0011","0000","2063","856","1207","23","2086","4520","0","46.15","18.94"
"68","000","00","010","0011","0131","629","303","326","10","639","1382","0","46.24","21.92"
"68","000","00","010","0011","0132","676","293","383","6","682","1577","0","43.25","18.58"
"68","000","00","010","0011","0133","758","260","498","7","765","1561","0","49.01","16.66"
"68","000","00","010","0012","0000","1876","841","1035","15","1891","4602","0","41.09","18.27"
"68","000","00","010","0012","0152","632","276","356","3","635","1668","0","38.07","16.55"
"68","000","00","010","0012","0153","629","288","341","5","634","1533","0","41.36","18.79"
"68","000","00","010","0012","0154","615","277","338","7","622","1401","0","44.40","19.77"
"68","000","00","010","0013","0000","1361","708","653","7","1368","3019","0","45.31","23.45"
"68","000","00","010","0013","0222","651","347","304","3","654","1512","0","43.25","22.95"
"68","000","00","010","0013","0223","710","361","349","4","714","1507","0","47.38","23.95"
"68","000","00","010","0014","0000","809","368","441","8","817","1896","0","43.09","19.41"
"68","000","00","010","0014","0221","809","368","441","8","817","1896","0","43.09","19.41"
"68","000","00","010","0015","0000","391","144","247","3","394","924","0","42.64","15.58"
"68","000","00","010","0015","0239","391","144","247","3","394","924","0","42.64","15.58"
"68","000","00","010","0016","0000","1485","642","843","8","1493","3527","0","42.33","18.20"
"68","000","00","010","0016","0155","695","278","417","3","698","1701","0","41.03","16.34"
"68","000","00","010","0016","0156","790","364","426","5","795","1826","0","43.54","19.93"
"68","000","00","010","0017","0000","976","370","606","10","986","2382","0","41.39","15.53"
"68","000","00","010","0017","0122","543","232","311","6","549","1327","0","41.37","17.48"
"68","000","00","010","0017","0123","433","138","295","4","437","1055","0","41.42","13.08"
"68","000","00","010","0018","0000","1333","531","802","12","1345","3082","0","43.64","17.23"
"68","000","00","010","0018","0148","816","322","494","10","826","2001","0","41.28","16.09"
"68","000","00","010","0018","0149","517","209","308","2","519","1081","0","48.01","19.33"
"68","000","00","010","0019","0000","640","303","337","4","644","1626","0","39.61","18.63"
"68","000","00","010","0019","0045","640","303","337","4","644","1626","0","39.61","18.63"
"68","000","00","010","0020","0000","615","258","357","7","622","1307","0","47.59","19.74"
"68","000","00","010","0020","0031","615","258","357","7","622","1307","0","47.59","19.74"
"68","000","00","010","0021","0000","379","142","237","5","384","778","0","49.36","18.25"
"68","000","00","010","0021","0037","379","142","237","5","384","778","0","49.36","18.25"
"68","000","00","010","0022","0000","4192","2323","1869","42","4234","9814","0","43.14","23.67"
"68","000","00","010","0022","0177","664","357","307","6","670","1694","0","39.55","21.07"
"68","000","00","010","0022","0178","755","428","327","2","757","1619","0","46.76","26.44"
"68","000","00","010","0022","0179","749","412","337","11","760","1575","0","48.25","26.16"
"68","000","00","010","0022","0180","715","386","329","12","727","1803","0","40.32","21.41"
"68","000","00","010","0022","0181","627","338","289","3","630","1462","0","43.09","23.12"
"68","000","00","010","0022","0182","682","402","280","8","690","1661","0","41.54","24.20"
"68","000","00","010","0023","0000","2880","1561","1319","17","2897","6789","0","42.67","22.99"
"68","000","00","010","0023","0054","687","366","321","4","691","1687","0","40.96","21.70"
"68","000","00","010","0023","0055","775","422","353","5","780","1721","0","45.32","24.52"
"68","000","00","010","0023","0056","645","344","301","4","649","1644","0","39.48","20.92"
"68","000","00","010","0023","0057","773","429","344","4","777","1737","0","44.73","24.70"
"68","000","00","010","0024","0000","2450","1225","1225","15","2465","6329","0","38.95","19.36"
"68","000","00","010","0024","0173","613","278","335","4","617","1665","0","37.06","16.70"
"68","000","00","010","0024","0174","595","349","246","3","598","1549","0","38.61","22.53"
"68","000","00","010","0024","0175","610","257","353","4","614","1518","0","40.45","16.93"
"68","000","00","010","0024","0176","632","341","291","4","636","1597","0","39.82","21.35"
"68","000","00","010","0025","0000","634","320","314","4","638","1430","0","44.62","22.38"
"68","000","00","010","0025","0046","634","320","314","4","638","1430","0","44.62","22.38"
"68","000","00","010","0026","0000","2470","1253","1217","30","2500","5908","0","42.32","21.21"
"68","000","00","010","0026","0049","863","423","440","9","872","2055","0","42.43","20.58"
"68","000","00","010","0026","0050","418","214","204","8","426","996","0","42.77","21.49"
"68","000","00","010","0026","0051","457","227","230","10","467","1063","0","43.93","21.35"
"68","000","00","010","0026","0052","732","389","343","3","735","1794","0","40.97","21.68"
"68","000","00","010","0027","0000","609","237","372","6","615","1365","0","45.05","17.36"
"68","000","00","010","0027","0053","609","237","372","6","615","1365","0","45.05","17.36"
"68","000","00","010","0028","0000","2063","960","1103","17","2080","4880","0","42.62","19.67"
"68","000","00","010","0028","0092","644","266","378","7","651","1424","0","45.72","18.68"
"68","000","00","010","0028","0093","457","217","240","4","461","1203","0","38.32","18.04"
"68","000","00","010","0028","0094","518","261","257","4","522","1137","0","45.91","22.96"
"68","000","00","010","0028","0095","444","216","228","2","446","1116","0","39.96","19.35"
"68","000","00","010","0029","0000","2260","1103","1157","17","2277","5722","0","39.79","19.28"
"68","000","00","010","0029","0065","546","219","327","5","551","1135","0","48.55","19.30"
"68","000","00","010","0029","0066","438","211","227","3","441","1231","0","35.82","17.14"
"68","000","00","010","0029","0067","809","373","436","7","816","1962","0","41.59","19.01"
"68","000","00","010","0029","0068","467","300","167","2","469","1394","0","33.64","21.52"
"68","000","00","010","0030","0000","2879","1519","1360","12","2891","6550","0","44.14","23.19"
"68","000","00","010","0030","0061","762","420","342","4","766","1565","0","48.95","26.84"
"68","000","00","010","0030","0062","670","335","335","1","671","1569","0","42.77","21.35"
"68","000","00","010","0030","0063","804","413","391","6","810","1914","0","42.32","21.58"
"68","000","00","010","0030","0064","643","351","292","1","644","1502","0","42.88","23.37"
"68","000","00","010","0031","0000","730","302","428","3","733","1710","0","42.87","17.66"
"68","000","00","010","0031","0039","730","302","428","3","733","1710","0","42.87","17.66"
"68","000","00","010","0032","0000","2630","1335","1295","20","2650","6053","0","43.78","22.06"
"68","000","00","010","0032","0016","663","292","371","2","665","1416","0","46.96","20.62"
"68","000","00","010","0032","0017","595","287","308","10","605","1425","0","42.46","20.14"
"68","000","00","010","0032","0018","640","322","318","4","644","1556","0","41.39","20.69"
"68","000","00","010","0032","0019","732","434","298","4","736","1656","0","44.44","26.21"
"68","000","00","010","0033","0000","2646","1336","1310","24","2670","5943","0","44.93","22.48"
"68","000","00","010","0033","0023","665","334","331","5","670","1409","0","47.55","23.70"
"68","000","00","010","0033","0024","750","376","374","6","756","1576","0","47.97","23.86"
"68","000","00","010","0033","0025","662","332","330","5","667","1515","0","44.03","21.91"
"68","000","00","010","0033","0026","569","294","275","8","577","1443","0","39.99","20.37"
"68","000","00","010","0034","0000","2135","938","1197","15","2150","4548","0","47.27","20.62"
"68","000","00","010","0034","0042","650","271","379","7","657","1579","0","41.61","17.16"
"68","000","00","010","0034","0043","729","316","413","2","731","1467","0","49.83","21.54"
"68","000","00","010","0034","0044","756","351","405","6","762","1502","0","50.73","23.37"
"68","000","00","010","0035","0000","1290","689","601","14","1304","3479","0","37.48","19.80"
"68","000","00","010","0035","0099","413","189","224","7","420","1135","0","37.00","16.65"
"68","000","00","010","0035","0100","451","277","174","2","453","1170","0","38.72","23.68"
"68","000","00","010","0035","0101","426","223","203","5","431","1174","0","36.71","18.99"
"68","000","00","010","0036","0000","2321","1334","987","24","2345","5803","0","40.41","22.99"
"68","000","00","010","0036","0106","592","336","256","4","596","1414","0","42.15","23.76"
"68","000","00","010","0036","0107","580","333","247","7","587","1557","0","37.70","21.39"
"68","000","00","010","0036","0108","609","359","250","9","618","1519","0","40.68","23.63"
"68","000","00","010","0036","0109","540","306","234","4","544","1313","0","41.43","23.31"
"68","000","00","010","0037","0000","1801","963","838","18","1819","3846","0","47.30","25.04"
"68","000","00","010","0037","0212","526","294","232","6","532","1124","0","47.33","26.16"
"68","000","00","010","0037","0213","602","310","292","4","606","1346","0","45.02","23.03"
"68","000","00","010","0037","0214","673","359","314","8","681","1376","0","49.49","26.09"
"68","000","00","010","0038","0000","1833","790","1043","14","1847","4213","0","43.84","18.75"
"68","000","00","010","0038","0224","545","234","311","5","550","1272","0","43.24","18.40"
"68","000","00","010","0038","0225","641","253","388","7","648","1458","0","44.44","17.35"
"68","000","00","010","0038","0226","647","303","344","2","649","1483","0","43.76","20.43"
"68","000","00","010","0039","0000","894","396","498","10","904","1970","0","45.89","20.10"
"68","000","00","010","0039","0231","495","211","284","4","499","1010","0","49.41","20.89"
"68","000","00","010","0039","0232","399","185","214","6","405","960","0","42.19","19.27"
"68","000","00","010","0040","0000","2463","1115","1348","13","2476","5681","0","43.58","19.63"
"68","000","00","010","0040","0032","581","254","327","6","587","1321","0","44.44","19.23"
"68","000","00","010","0040","0033","612","264","348","3","615","1458","0","42.18","18.11"
"68","000","00","010","0040","0034","706","290","416","4","710","1543","0","46.01","18.79"
"68","000","00","010","0040","0035","564","307","257","0","564","1359","0","41.50","22.59"
"68","000","00","010","0041","0000","2834","1409","1425","16","2850","6243","0","45.65","22.57"
"68","000","00","010","0041","0027","729","379","350","6","735","1654","0","44.44","22.91"
"68","000","00","010","0041","0028","711","352","359","3","714","1620","0","44.07","21.73"
"68","000","00","010","0041","0029","656","334","322","4","660","1478","0","44.65","22.60"
"68","000","00","010","0041","0030","738","344","394","3","741","1491","0","49.70","23.07"
"68","000","00","010","0042","0000","2209","1130","1079","36","2245","5129","0","43.77","22.03"
"68","000","00","010","0042","0012","559","277","282","9","568","1282","0","44.31","21.61"
"68","000","00","010","0042","0013","598","291","307","10","608","1393","0","43.65","20.89"
"68","000","00","010","0042","0014","509","294","215","9","518","1225","0","42.29","24.00"
"68","000","00","010","0042","0015","543","268","275","8","551","1229","0","44.83","21.81"
"68","000","00","010","0043","0000","2042","968","1074","15","2057","4911","0","41.89","19.71"
"68","000","00","010","0043","0009","725","366","359","4","729","1811","0","40.25","20.21"
"68","000","00","010","0043","0010","654","312","342","4","658","1554","0","42.34","20.08"
"68","000","00","010","0043","0011","663","290","373","7","670","1546","0","43.34","18.76"
"68","000","00","010","0044","0000","1756","874","882","10","1766","4122","0","42.84","21.20"
"68","000","00","010","0044","0020","541","288","253","3","544","1284","0","42.37","22.43"
"68","000","00","010","0044","0021","522","256","266","5","527","1373","0","38.38","18.65"
"68","000","00","010","0044","0022","693","330","363","2","695","1465","0","47.44","22.53"
"68","000","00","010","0045","0000","1966","1158","808","16","1982","4162","0","47.62","27.82"
"68","000","00","010","0045","0199","646","385","261","3","649","1412","0","45.96","27.27"
"68","000","00","010","0045","0200","709","415","294","8","717","1371","0","52.30","30.27"
"68","000","00","010","0045","0201","611","358","253","5","616","1379","0","44.67","25.96"
"68","000","00","010","0046","0000","1992","921","1071","10","2002","5398","0","37.09","17.06"
"68","000","00","010","0046","0209","612","279","333","2","614","1776","0","34.57","15.71"
"68","000","00","010","0046","0210","688","315","373","1","689","1801","0","38.26","17.49"
"68","000","00","010","0046","0211","692","327","365","7","699","1821","0","38.39","17.96"
"68","000","00","010","0047","0000","2247","1096","1151","17","2264","6093","0","37.16","17.99"
"68","000","00","010","0047","0227","591","288","303","5","596","1510","0","39.47","19.07"
"68","000","00","010","0047","0228","562","259","303","7","569","1429","0","39.82","18.12"
"68","000","00","010","0047","0229","578","276","302","3","581","1537","0","37.80","17.96"
"68","000","00","010","0047","0230","516","273","243","2","518","1617","0","32.03","16.88"
"68","000","00","010","0048","0000","2777","1309","1468","20","2797","6914","0","40.45","18.93"
"68","000","00","010","0048","0160","537","201","336","3","540","1304","0","41.41","15.41"
"68","000","00","010","0048","0161","472","222","250","1","473","1299","0","36.41","17.09"
"68","000","00","010","0048","0162","568","259","309","6","574","1385","0","41.44","18.70"
"68","000","00","010","0048","0163","607","295","312","3","610","1554","0","39.25","18.98"
"68","000","00","010","0048","0164","593","332","261","7","600","1372","0","43.73","24.20"
"68","000","00","010","0049","0000","2414","1334","1080","12","2426","6089","0","39.84","21.91"
"68","000","00","010","0049","0124","608","292","316","6","614","1473","0","41.68","19.82"
"68","000","00","010","0049","0125","624","335","289","3","627","1457","0","43.03","22.99"
"68","000","00","010","0049","0126","562","347","215","2","564","1674","0","33.69","20.73"
"68","000","00","010","0049","0127","620","360","260","1","621","1485","0","41.82","24.24"
"68","000","00","010","0050","0000","3890","2004","1886","20","3910","9540","0","40.99","21.01"
"68","000","00","010","0050","0134","784","420","364","4","788","1817","0","43.37","23.12"
"68","000","00","010","0050","0135","718","351","367","4","722","1956","0","36.91","17.94"
"68","000","00","010","0050","0136","813","428","385","3","816","1892","0","43.13","22.62"
"68","000","00","010","0050","0137","899","470","429","6","905","2195","0","41.23","21.41"
"68","000","00","010","0050","0138","676","335","341","3","679","1680","0","40.42","19.94"
"68","000","00","010","0051","0000","3711","2158","1553","18","3729","8779","0","42.48","24.58"
"68","000","00","010","0051","0168","714","411","303","4","718","1689","0","42.51","24.33"
"68","000","00","010","0051","0169","793","438","355","4","797","1772","0","44.98","24.72"
"68","000","00","010","0051","0170","683","367","316","1","684","1766","0","38.73","20.78"
"68","000","00","010","0051","0171","775","465","310","8","783","1837","0","42.62","25.31"
"68","000","00","010","0051","0172","746","477","269","1","747","1715","0","43.56","27.81"
"68","000","00","010","0052","0000","1765","867","898","13","1778","3991","0","44.55","21.72"
"68","000","00","010","0052","0090","817","402","415","3","820","1990","0","41.21","20.20"
"68","000","00","010","0052","0091","948","465","483","10","958","2001","0","47.88","23.24"
"68","000","00","010","0053","0000","1636","849","787","18","1654","3653","0","45.28","23.24"
"68","000","00","010","0053","0096","540","297","243","5","545","1225","0","44.49","24.24"
"68","000","00","010","0053","0097","596","295","301","7","603","1294","0","46.60","22.80"
"68","000","00","010","0053","0098","500","257","243","6","506","1134","0","44.62","22.66"
"68","000","00","010","0054","0000","1607","845","762","13","1620","3883","0","41.72","21.76"
"68","000","00","010","0054","0083","578","296","282","5","583","1263","0","46.16","23.44"
"68","000","00","010","0054","0084","480","242","238","4","484","1258","0","38.47","19.24"
"68","000","00","010","0054","0085","549","307","242","4","553","1362","0","40.60","22.54"
"68","000","00","010","0055","0000","2670","1388","1282","27","2697","6452","0","41.80","21.51"
"68","000","00","010","0055","0086","662","360","302","6","668","1637","0","40.81","21.99"
"68","000","00","010","0055","0087","598","321","277","3","601","1439","0","41.77","22.31"
"68","000","00","010","0055","0088","746","295","451","10","756","1571","0","48.12","18.78"
"68","000","00","010","0055","0089","664","412","252","8","672","1805","0","37.23","22.83"
"68","000","00","010","0056","0000","1822","1093","729","15","1837","4939","0","37.19","22.13"
"68","000","00","010","0056","0110","600","368","232","4","604","1619","0","37.31","22.73"
"68","000","00","010","0056","0111","576","344","232","7","583","1625","0","35.88","21.17"
"68","000","00","010","0056","0112","646","381","265","4","650","1695","0","38.35","22.48"
"68","000","00","010","0057","0000","2395","1392","1003","19","2414","6433","0","37.53","21.64"
"68","000","00","010","0057","0202","575","329","246","5","580","1570","0","36.94","20.96"
"68","000","00","010","0057","0203","566","325","241","7","573","1596","0","35.90","20.36"
"68","000","00","010","0057","0204","634","396","238","6","640","1631","0","39.24","24.28"
"68","000","00","010","0057","0205","620","342","278","1","621","1636","0","37.96","20.90"
"68","000","00","010","0058","0000","3161","1720","1441","18","3179","8491","0","37.44","20.26"
"68","000","00","010","0058","0243","589","326","263","2","591","1547","0","38.20","21.07"
"68","000","00","010","0058","0244","526","266","260","2","528","1359","0","38.85","19.57"
"68","000","00","010","0058","0245","501","254","247","4","505","1427","0","35.39","17.80"
"68","000","00","010","0058","0246","547","316","231","4","551","1709","0","32.24","18.49"
"68","000","00","010","0058","0247","562","320","242","6","568","1318","0","43.10","24.28"
"68","000","00","010","0058","0248","436","238","198","0","436","1131","0","38.55","21.04"
"68","000","00","010","0059","0000","2982","1618","1364","18","3000","9776","0","30.69","16.55"
"68","000","00","010","0059","0117","645","353","292","4","649","1561","0","41.58","22.61"
"68","000","00","010","0059","0118","482","247","235","4","486","3546","0","13.71","6.97"
"68","000","00","010","0059","0119","641","366","275","1","642","1647","0","38.98","22.22"
"68","000","00","010","0059","0120","568","290","278","4","572","1477","0","38.73","19.63"
"68","000","00","010","0059","0121","646","362","284","5","651","1545","0","42.14","23.43"
"68","000","00","010","0060","0000","2099","1129","970","18","2117","5408","0","39.15","20.88"
"68","000","00","010","0060","0102","542","262","280","6","548","1283","0","42.71","20.42"
"68","000","00","010","0060","0103","577","291","286","5","582","1448","0","40.19","20.10"
"68","000","00","010","0060","0104","512","295","217","4","516","1323","0","39.00","22.30"
"68","000","00","010","0060","0105","468","281","187","3","471","1354","0","34.79","20.75"
"68","000","00","010","0061","0000","3229","1750","1479","27","3256","7355","0","44.27","23.79"
"68","000","00","010","0061","0143","760","425","335","6","766","1721","0","44.51","24.69"
"68","000","00","010","0061","0144","589","316","273","8","597","1489","0","40.09","21.22"
"68","000","00","010","0061","0145","598","289","309","8","606","1401","0","43.25","20.63"
"68","000","00","010","0061","0146","603","342","261","3","606","1288","0","47.05","26.55"
"68","000","00","010","0061","0147","679","378","301","2","681","1456","0","46.77","25.96"
"68","000","00","010","0062","0000","2212","1148","1064","14","2226","5612","0","39.67","20.46"
"68","000","00","010","0062","0069","599","310","289","4","603","1319","0","45.72","23.50"
"68","000","00","010","0062","0070","569","286","283","2","571","1436","0","39.76","19.92"
"68","000","00","010","0062","0071","547","278","269","5","552","1426","0","38.71","19.50"
"68","000","00","010","0062","0072","497","274","223","3","500","1431","0","34.94","19.15"
"68","000","00","010","0063","0000","2194","1046","1148","16","2210","4931","0","44.82","21.21"
"68","000","00","010","0063","0157","772","372","400","6","778","1686","0","46.14","22.06"
"68","000","00","010","0063","0158","590","261","329","6","596","1351","0","44.12","19.32"
"68","000","00","010","0063","0159","832","413","419","4","836","1894","0","44.14","21.81"
"68","000","00","010","0064","0000","1958","1064","894","14","1972","4612","0","42.76","23.07"
"68","000","00","010","0064","0058","689","398","291","6","695","1749","0","39.74","22.76"
"68","000","00","010","0064","0059","705","384","321","5","710","1615","0","43.96","23.78"
"68","000","00","010","0064","0060","564","282","282","3","567","1248","0","45.43","22.60"
"68","000","00","010","0065","0000","2024","1144","880","9","2033","4570","0","44.49","25.03"
"68","000","00","010","0065","0073","677","390","287","1","678","1613","0","42.03","24.18"
"68","000","00","010","0065","0074","742","414","328","4","746","1562","0","47.76","26.50"
"68","000","00","010","0065","0075","605","340","265","4","609","1395","0","43.66","24.37"
"68","000","00","010","0066","0000","1825","1074","751","17","1842","4145","0","44.44","25.91"
"68","000","00","010","0066","0076","655","392","263","7","662","1502","0","44.07","26.10"
"68","000","00","010","0066","0077","533","305","228","6","539","1338","0","40.28","22.80"
"68","000","00","010","0066","0078","637","377","260","4","641","1305","0","49.12","28.89"
"68","000","00","010","0067","0000","2105","1044","1061","13","2118","4872","0","43.47","21.43"
"68","000","00","010","0067","0165","717","336","381","5","722","1649","0","43.78","20.38"
"68","000","00","010","0067","0166","713","360","353","7","720","1602","0","44.94","22.47"
"68","000","00","010","0067","0167","675","348","327","1","676","1621","0","41.70","21.47"
"68","000","00","010","0068","0000","2567","1423","1144","18","2585","6169","0","41.90","23.07"
"68","000","00","010","0068","0192","659","357","302","2","661","1510","0","43.77","23.64"
"68","000","00","010","0068","0193","720","410","310","6","726","1652","0","43.95","24.82"
"68","000","00","010","0068","0194","649","363","286","6","655","1639","0","39.96","22.15"
"68","000","00","010","0068","0195","539","293","246","4","543","1368","0","39.69","21.42"
"68","000","00","010","0069","0000","1917","1064","853","13","1930","4734","0","40.77","22.48"
"68","000","00","010","0069","0128","622","303","319","6","628","1573","0","39.92","19.26"
"68","000","00","010","0069","0129","659","410","249","3","662","1571","0","42.14","26.10"
"68","000","00","010","0069","0130","636","351","285","4","640","1590","0","40.25","22.08"
"68","000","00","010","0070","0000","2317","1405","912","13","2330","5481","0","42.51","25.63"
"68","000","00","010","0070","0079","506","330","176","2","508","1388","0","36.60","23.78"
"68","000","00","010","0070","0080","540","313","227","2","542","1281","0","42.31","24.43"
"68","000","00","010","0070","0081","589","333","256","6","595","1429","0","41.64","23.30"
"68","000","00","010","0070","0082","682","429","253","3","685","1383","0","49.53","31.02"
"68","000","00","010","0071","0000","2474","1258","1216","15","2489","6540","0","38.06","19.24"
"68","000","00","010","0071","0113","662","354","308","1","663","1601","0","41.41","22.11"
"68","000","00","010","0071","0114","619","283","336","4","623","1641","0","37.96","17.25"
"68","000","00","010","0071","0115","589","280","309","3","592","1685","0","35.13","16.62"
"68","000","00","010","0071","0116","604","341","263","7","611","1613","0","37.88","21.14"
"68","000","00","010","0072","0000","2589","1475","1114","15","2604","6061","0","42.96","24.34"
"68","000","00","010","0072","0139","650","378","272","1","651","1564","0","41.62","24.17"
"68","000","00","010","0072","0140","672","370","302","8","680","1538","0","44.21","24.06"
"68","000","00","010","0072","0141","628","353","275","2","630","1490","0","42.28","23.69"
"68","000","00","010","0072","0142","639","374","265","4","643","1469","0","43.77","25.46"
"68","000","00","010","0073","0000","1446","790","656","12","1458","3179","0","45.86","24.85"
"68","000","00","010","0073","0150","603","332","271","7","610","1412","0","43.20","23.51"
"68","000","00","010","0073","0151","843","458","385","5","848","1767","0","47.99","25.92"
"68","000","00","010","0074","0000","3093","1696","1397","26","3119","8113","0","38.44","20.90"
"68","000","00","010","0074","0187","610","338","272","7","617","1563","0","39.48","21.63"
"68","000","00","010","0074","0188","546","278","268","6","552","1624","0","33.99","17.12"
"68","000","00","010","0074","0189","620","347","273","4","624","1546","0","40.36","22.45"
"68","000","00","010","0074","0190","657","352","305","6","663","1637","0","40.50","21.50"
"68","000","00","010","0074","0191","660","381","279","3","663","1743","0","38.04","21.86"
"68","000","00","010","0075","0000","2262","1189","1073","14","2276","5936","0","38.34","20.03"
"68","000","00","010","0075","0183","521","259","262","2","523","1567","0","33.38","16.53"
"68","000","00","010","0075","0184","630","343","287","4","634","1483","0","42.75","23.13"
"68","000","00","010","0075","0185","590","320","270","5","595","1486","0","40.04","21.53"
"68","000","00","010","0075","0186","521","267","254","3","524","1400","0","37.43","19.07"
"68","000","00","010","0076","0000","1532","820","712","12","1544","3791","0","40.73","21.63"
"68","000","00","010","0076","0196","561","276","285","4","565","1360","0","41.54","20.29"
"68","000","00","010","0076","0197","436","224","212","6","442","1109","0","39.86","20.20"
"68","000","00","010","0076","0198","535","320","215","2","537","1322","0","40.62","24.21"
"68","000","00","010","0077","0000","1492","736","756","11","1503","3881","0","38.73","18.96"
"68","000","00","010","0077","0006","539","256","283","4","543","1445","0","37.58","17.72"
"68","000","00","010","0077","0007","485","230","255","4","489","1245","0","39.28","18.47"
"68","000","00","010","0077","0008","468","250","218","3","471","1191","0","39.55","20.99"
"68","000","00","010","0078","0000","2000","1090","910","17","2017","5006","0","40.29","21.77"
"68","000","00","010","0078","0206","745","393","352","8","753","1727","0","43.60","22.76"
"68","000","00","010","0078","0207","648","361","287","3","651","1658","0","39.26","21.77"
"68","000","00","010","0078","0208","607","336","271","6","613","1621","0","37.82","20.73"
"68","000","00","010","0079","0000","1831","1026","805","8","1839","4546","0","40.45","22.57"
"68","000","00","010","0079","0240","586","335","251","2","588","1367","0","43.01","24.51"
"68","000","00","010","0079","0241","716","381","335","4","720","1804","0","39.91","21.12"
"68","000","00","010","0079","0242","529","310","219","2","531","1375","0","38.62","22.55"
"68","000","00","020","0000","0000","143175","82426","60749","1088","144263","347023","422582","41.57","23.75"
"68","000","00","020","0001","0000","1287","982","305","11","1298","2898","0","44.79","33.89"
"68","000","00","020","0001","0712","656","519","137","6","662","1343","0","49.29","38.64"
"68","000","00","020","0001","0713","631","463","168","5","636","1555","0","40.90","29.77"
"68","000","00","020","0002","0000","2252","1454","798","16","2268","5428","0","41.78","26.79"
"68","000","00","020","0002","0708","682","450","232","5","687","1406","0","48.86","32.01"
"68","000","00","020","0002","0709","479","316","163","1","480","1263","0","38.00","25.02"
"68","000","00","020","0002","0710","559","365","194","5","564","1382","0","40.81","26.41"
"68","000","00","020","0002","0711","532","323","209","5","537","1377","0","39.00","23.46"
"68","000","00","020","0003","0000","1278","818","460","15","1293","3064","0","42.20","26.70"
"68","000","00","020","0003","0755","653","390","263","7","660","1595","0","41.38","24.45"
"68","000","00","020","0003","0756","625","428","197","8","633","1469","0","43.09","29.14"
"68","000","00","020","0004","0000","394","206","188","2","396","914","0","43.33","22.54"
"68","000","00","020","0004","0881","394","206","188","2","396","914","0","43.33","22.54"
"68","000","00","020","0005","0000","913","576","337","11","924","2196","0","42.08","26.23"
"68","000","00","020","0005","0793","449","263","186","6","455","1093","0","41.63","24.06"
"68","000","00","020","0005","0794","464","313","151","5","469","1103","0","42.52","28.38"
"68","000","00","020","0006","0000","1744","1026","718","16","1760","4380","0","40.18","23.42"
"68","000","00","020","0006","0795","637","366","271","9","646","1563","0","41.33","23.42"
"68","000","00","020","0006","0796","526","300","226","3","529","1513","0","34.96","19.83"
"68","000","00","020","0006","0797","581","360","221","4","585","1304","0","44.86","27.61"
"68","000","00","020","0007","0000","2387","1398","989","18","2405","5320","0","45.21","26.28"
"68","000","00","020","0007","0889","642","383","259","6","648","1498","0","43.26","25.57"
"68","000","00","020","0007","0890","463","251","212","2","465","1022","0","45.50","24.56"
"68","000","00","020","0007","0891","630","373","257","5","635","1398","0","45.42","26.68"
"68","000","00","020","0007","0892","652","391","261","5","657","1402","0","46.86","27.89"
"68","000","00","020","0008","0000","2330","1921","409","29","2359","5087","0","46.37","37.76"
"68","000","00","020","0008","0781","585","503","82","7","592","1239","0","47.78","40.60"
"68","000","00","020","0008","0782","591","508","83","6","597","1242","0","48.07","40.90"
"68","000","00","020","0008","0783","632","513","119","9","641","1313","0","48.82","39.07"
"68","000","00","020","0008","0784","522","397","125","7","529","1293","0","40.91","30.70"
"68","000","00","020","0009","0000","1528","1019","509","12","1540","3497","0","44.04","29.14"
"68","000","00","020","0009","0777","740","475","265","6","746","1642","0","45.43","28.93"
"68","000","00","020","0009","0778","788","544","244","6","794","1855","0","42.80","29.33"
"68","000","00","020","0010","0000","1506","1001","505","12","1518","3778","0","40.18","26.50"
"68","000","00","020","0010","0764","595","387","208","6","601","1453","0","41.36","26.63"
"68","000","00","020","0010","0765","326","216","110","2","328","803","0","40.85","26.90"
"68","000","00","020","0010","0766","585","398","187","4","589","1522","0","38.70","26.15"
"68","000","00","020","0011","0000","1785","1016","769","18","1803","4305","0","41.88","23.60"
"68","000","00","020","0011","0696","515","297","218","2","517","1243","0","41.59","23.89"
"68","000","00","020","0011","0697","628","356","272","12","640","1469","0","43.57","24.23"
"68","000","00","020","0011","0698","642","363","279","4","646","1593","0","40.55","22.79"
"68","000","00","020","0012","0000","2208","1371","837","12","2220","5566","0","39.89","24.63"
"68","000","00","020","0012","0714","747","502","245","2","749","1853","0","40.42","27.09"
"68","000","00","020","0012","0715","438","278","160","6","444","1229","0","36.13","22.62"
"68","000","00","020","0012","0716","450","273","177","2","452","1105","0","40.90","24.71"
"68","000","00","020","0012","0717","573","318","255","2","575","1379","0","41.70","23.06"
"68","000","00","020","0013","0000","1294","744","550","7","1301","3006","0","43.28","24.75"
"68","000","00","020","0013","0753","650","380","270","3","653","1507","0","43.33","25.22"
"68","000","00","020","0013","0754","644","364","280","4","648","1499","0","43.23","24.28"
"68","000","00","020","0014","0000","981","524","457","7","988","2310","0","42.77","22.68"
"68","000","00","020","0014","0871","425","202","223","3","428","1114","0","38.42","18.13"
"68","000","00","020","0014","0872","556","322","234","4","560","1196","0","46.82","26.92"
"68","000","00","020","0015","0000","1638","873","765","9","1647","3407","0","48.34","25.62"
"68","000","00","020","0015","0830","668","372","296","2","670","1408","0","47.59","26.42"
"68","000","00","020","0015","0831","500","262","238","4","504","1042","0","48.37","25.14"
"68","000","00","020","0015","0832","470","239","231","3","473","957","0","49.43","24.97"
"68","000","00","020","0016","0000","1619","941","678","11","1630","4240","0","38.44","22.19"
"68","000","00","020","0016","0724","568","326","242","6","574","1395","0","41.15","23.37"
"68","000","00","020","0016","0725","525","294","231","3","528","1420","0","37.18","20.70"
"68","000","00","020","0016","0726","526","321","205","2","528","1425","0","37.05","22.53"
"68","000","00","020","0017","0000","1736","1026","710","12","1748","5599","0","31.22","18.32"
"68","000","00","020","0017","0740","601","352","249","4","605","1175","0","51.49","29.96"
"68","000","00","020","0017","0741","568","330","238","6","574","1204","0","47.67","27.41"
"68","000","00","020","0017","0742","567","344","223","2","569","3220","0","17.67","10.68"
"68","000","00","020","0018","0000","1574","869","705","13","1587","3943","0","40.25","22.04"
"68","000","00","020","0018","0748","511","272","239","6","517","1519","0","34.04","17.91"
"68","000","00","020","0018","0749","587","306","281","4","591","1316","0","44.91","23.25"
"68","000","00","020","0018","0750","476","291","185","3","479","1108","0","43.23","26.26"
"68","000","00","020","0019","0000","1981","1257","724","17","1998","5241","0","38.12","23.98"
"68","000","00","020","0019","0769","559","354","205","2","561","1661","0","33.77","21.31"
"68","000","00","020","0019","0770","683","432","251","9","692","1781","0","38.85","24.26"
"68","000","00","020","0019","0771","739","471","268","6","745","1799","0","41.41","26.18"
"68","000","00","020","0020","0000","1280","757","523","6","1286","3393","0","37.90","22.31"
"68","000","00","020","0020","0767","671","384","287","3","674","1721","0","39.16","22.31"
"68","000","00","020","0020","0768","609","373","236","3","612","1672","0","36.60","22.31"
"68","000","00","020","0021","0000","1484","790","694","11","1495","3315","0","45.10","23.83"
"68","000","00","020","0021","0842","686","362","324","6","692","1653","0","41.86","21.90"
"68","000","00","020","0021","0843","798","428","370","5","803","1662","0","48.32","25.75"
"68","000","00","020","0022","0000","2811","1434","1377","17","2828","6960","0","40.63","20.60"
"68","000","00","020","0022","0909","651","258","393","4","655","1850","0","35.41","13.95"
"68","000","00","020","0022","0910","808","420","388","3","811","1830","0","44.32","22.95"
"68","000","00","020","0022","0911","714","381","333","7","721","1657","0","43.51","22.99"
"68","000","00","020","0022","0912","638","375","263","3","641","1623","0","39.49","23.11"
"68","000","00","020","0023","0000","1003","601","402","7","1010","2660","0","37.97","22.59"
"68","000","00","020","0023","0775","455","262","193","5","460","1295","0","35.52","20.23"
"68","000","00","020","0023","0776","548","339","209","2","550","1365","0","40.29","24.84"
"68","000","00","020","0024","0000","1583","753","830","10","1593","3765","0","42.31","20.00"
"68","000","00","020","0024","0886","523","232","291","7","530","1251","0","42.37","18.55"
"68","000","00","020","0024","0887","514","228","286","1","515","1200","0","42.92","19.00"
"68","000","00","020","0024","0888","546","293","253","2","548","1314","0","41.70","22.30"
"68","000","00","020","0025","0000","1549","848","701","7","1556","3646","0","42.68","23.26"
"68","000","00","020","0025","0833","787","446","341","5","792","1804","0","43.90","24.72"
"68","000","00","020","0025","0834","762","402","360","2","764","1842","0","41.48","21.82"
"68","000","00","020","0026","0000","1561","850","711","7","1568","3654","0","42.91","23.26"
"68","000","00","020","0026","0800","541","241","300","1","542","1182","0","45.85","20.39"
"68","000","00","020","0026","0801","505","282","223","4","509","1242","0","40.98","22.71"
"68","000","00","020","0026","0802","515","327","188","2","517","1230","0","42.03","26.59"
"68","000","00","020","0027","0000","2450","1105","1345","20","2470","6882","0","35.89","16.06"
"68","000","00","020","0027","0824","437","184","253","6","443","1216","0","36.43","15.13"
"68","000","00","020","0027","0825","442","202","240","3","445","1212","0","36.72","16.67"
"68","000","00","020","0027","0826","537","238","299","2","539","1547","0","34.84","15.38"
"68","000","00","020","0027","0827","545","242","303","4","549","1629","0","33.70","14.86"
"68","000","00","020","0027","0828","489","239","250","5","494","1278","0","38.65","18.70"
"68","000","00","020","0028","0000","294","156","138","1","295","674","0","43.77","23.15"
"68","000","00","020","0028","0882","294","156","138","1","295","674","0","43.77","23.15"
"68","000","00","020","0029","0000","1998","1298","700","22","2020","4607","0","43.85","28.17"
"68","000","00","020","0029","0702","690","441","249","6","696","1627","0","42.78","27.11"
"68","000","00","020","0029","0703","660","427","233","9","669","1481","0","45.17","28.83"
"68","000","00","020","0029","0704","648","430","218","7","655","1499","0","43.70","28.69"
"68","000","00","020","0030","0000","1063","703","360","7","1070","2813","0","38.04","24.99"
"68","000","00","020","0030","0759","573","361","212","6","579","1530","0","37.84","23.59"
"68","000","00","020","0030","0760","490","342","148","1","491","1283","0","38.27","26.66"
"68","000","00","020","0031","0000","1502","726","776","13","1515","3634","0","41.69","19.98"
"68","000","00","020","0031","0847","437","157","280","6","443","1095","0","40.46","14.34"
"68","000","00","020","0031","0848","579","291","288","2","581","1340","0","43.36","21.72"
"68","000","00","020","0031","0849","486","278","208","5","491","1199","0","40.95","23.19"
"68","000","00","020","0032","0000","2628","1376","1252","17","2645","6486","0","40.78","21.21"
"68","000","00","020","0032","0867","679","345","334","2","681","1738","0","39.18","19.85"
"68","000","00","020","0032","0868","650","332","318","6","656","1632","0","40.20","20.34"
"68","000","00","020","0032","0869","735","377","358","5","740","1800","0","41.11","20.94"
"68","000","00","020","0032","0870","564","322","242","4","568","1316","0","43.16","24.47"
"68","000","00","020","0033","0000","3481","1962","1519","28","3509","9665","0","36.31","20.30"
"68","000","00","020","0033","0806","575","356","219","3","578","1504","0","38.43","23.67"
"68","000","00","020","0033","0807","554","332","222","7","561","1533","0","36.59","21.66"
"68","000","00","020","0033","0808","674","336","338","7","681","1820","0","37.42","18.46"
"68","000","00","020","0033","0809","588","304","284","1","589","1796","0","32.80","16.93"
"68","000","00","020","0033","0810","556","332","224","7","563","1562","0","36.04","21.25"
"68","000","00","020","0033","0811","534","302","232","3","537","1450","0","37.03","20.83"
"68","000","00","020","0034","0000","3400","1832","1568","21","3421","8837","0","38.71","20.73"
"68","000","00","020","0034","0816","504","264","240","6","510","1257","0","40.57","21.00"
"68","000","00","020","0034","0817","452","250","202","1","453","1221","0","37.10","20.48"
"68","000","00","020","0034","0818","502","255","247","3","505","1255","0","40.24","20.32"
"68","000","00","020","0034","0819","563","331","232","3","566","1522","0","37.19","21.75"
"68","000","00","020","0034","0820","671","339","332","6","677","1765","0","38.36","19.21"
"68","000","00","020","0034","0821","708","393","315","2","710","1817","0","39.08","21.63"
"68","000","00","020","0035","0000","855","402","453","8","863","1888","0","45.71","21.29"
"68","000","00","020","0035","0875","396","174","222","5","401","952","0","42.12","18.28"
"68","000","00","020","0035","0876","459","228","231","3","462","936","0","49.36","24.36"
"68","000","00","020","0036","0000","3161","1711","1450","27","3188","7822","0","40.76","21.87"
"68","000","00","020","0036","0853","508","248","260","2","510","1203","0","42.39","20.62"
"68","000","00","020","0036","0854","415","205","210","1","416","1109","0","37.51","18.49"
"68","000","00","020","0036","0855","564","339","225","8","572","1129","0","50.66","30.03"
"68","000","00","020","0036","0856","515","248","267","5","520","1336","0","38.92","18.56"
"68","000","00","020","0036","0857","585","323","262","7","592","1390","0","42.59","23.24"
"68","000","00","020","0036","0858","574","348","226","4","578","1655","0","34.92","21.03"
"68","000","00","020","0037","0000","1982","1141","841","9","1991","4334","0","45.94","26.33"
"68","000","00","020","0037","0734","655","358","297","1","656","1346","0","48.74","26.60"
"68","000","00","020","0037","0735","681","390","291","4","685","1428","0","47.97","27.31"
"68","000","00","020","0037","0736","646","393","253","4","650","1560","0","41.67","25.19"
"68","000","00","020","0038","0000","703","344","359","4","707","1585","0","44.61","21.70"
"68","000","00","020","0038","0829","703","344","359","4","707","1585","0","44.61","21.70"
"68","000","00","020","0039","0000","2059","1564","495","24","2083","4952","0","42.06","31.58"
"68","000","00","020","0039","0705","655","483","172","12","667","1661","0","40.16","29.08"
"68","000","00","020","0039","0706","688","542","146","5","693","1566","0","44.25","34.61"
"68","000","00","020","0039","0707","716","539","177","7","723","1725","0","41.91","31.25"
"68","000","00","020","0040","0000","450","205","245","1","451","991","0","45.51","20.69"
"68","000","00","020","0040","0884","450","205","245","1","451","991","0","45.51","20.69"
"68","000","00","020","0041","0000","1277","734","543","15","1292","3012","0","42.90","24.37"
"68","000","00","020","0041","0873","622","316","306","8","630","1395","0","45.16","22.65"
"68","000","00","020","0041","0874","655","418","237","7","662","1617","0","40.94","25.85"
"68","000","00","020","0042","0000","1829","1040","789","18","1847","4849","0","38.09","21.45"
"68","000","00","020","0042","0685","644","356","288","3","647","1542","0","41.96","23.09"
"68","000","00","020","0042","0686","560","317","243","9","569","1500","0","37.93","21.13"
"68","000","00","020","0042","0687","625","367","258","6","631","1807","0","34.92","20.31"
"68","000","00","020","0043","0000","3016","1496","1520","21","3037","7935","0","38.27","18.85"
"68","000","00","020","0043","0923","672","292","380","7","679","1535","0","44.23","19.02"
"68","000","00","020","0043","0924","560","287","273","4","564","1413","0","39.92","20.31"
"68","000","00","020","0043","0925","541","244","297","2","543","1432","0","37.92","17.04"
"68","000","00","020","0043","0926","614","326","288","3","617","1715","0","35.98","19.01"
"68","000","00","020","0043","0927","629","347","282","5","634","1840","0","34.46","18.86"
"68","000","00","020","0044","0000","2546","1308","1238","34","2580","6137","0","42.04","21.31"
"68","000","00","020","0044","0899","568","282","286","6","574","1392","0","41.24","20.26"
"68","000","00","020","0044","0900","649","291","358","4","653","1577","0","41.41","18.45"
"68","000","00","020","0044","0901","574","314","260","5","579","1466","0","39.50","21.42"
"68","000","00","020","0044","0902","755","421","334","19","774","1702","0","45.48","24.74"
"68","000","00","020","0045","0000","705","319","386","8","713","1460","0","48.84","21.85"
"68","000","00","020","0045","0885","705","319","386","8","713","1460","0","48.84","21.85"
"68","000","00","020","0046","0000","1712","743","969","13","1725","4196","0","41.11","17.71"
"68","000","00","020","0046","0906","594","229","365","4","598","1413","0","42.32","16.21"
"68","000","00","020","0046","0907","575","193","382","4","579","1297","0","44.64","14.88"
"68","000","00","020","0046","0908","543","321","222","5","548","1486","0","36.88","21.60"
"68","000","00","020","0047","0000","2099","752","1347","21","2120","5631","0","37.65","13.35"
"68","000","00","020","0047","0916","593","228","365","8","601","1509","0","39.83","15.11"
"68","000","00","020","0047","0917","459","167","292","9","468","1374","0","34.06","12.15"
"68","000","00","020","0047","0918","608","201","407","2","610","1589","0","38.39","12.65"
"68","000","00","020","0047","0919","439","156","283","2","441","1159","0","38.05","13.46"
"68","000","00","020","0048","0000","1268","554","714","8","1276","3254","0","39.21","17.03"
"68","000","00","020","0048","0897","624","268","356","3","627","1591","0","39.41","16.84"
"68","000","00","020","0048","0898","644","286","358","5","649","1663","0","39.03","17.20"
"68","000","00","020","0049","0000","1470","493","977","18","1488","3746","0","39.72","13.16"
"68","000","00","020","0049","0920","490","172","318","4","494","1266","0","39.02","13.59"
"68","000","00","020","0049","0921","511","174","337","6","517","1248","0","41.43","13.94"
"68","000","00","020","0049","0922","469","147","322","8","477","1232","0","38.72","11.93"
"68","000","00","020","0050","0000","382","180","202","4","386","827","0","46.67","21.77"
"68","000","00","020","0050","0883","382","180","202","4","386","827","0","46.67","21.77"
"68","000","00","020","0051","0000","2043","866","1177","16","2059","4787","0","43.01","18.09"
"68","000","00","020","0051","0913","699","303","396","6","705","1738","0","40.56","17.43"
"68","000","00","020","0051","0914","598","241","357","1","599","1429","0","41.92","16.86"
"68","000","00","020","0051","0915","746","322","424","9","755","1620","0","46.60","19.88"
"68","000","00","020","0052","0000","2105","1252","853","14","2119","4813","0","44.03","26.01"
"68","000","00","020","0052","0838","547","327","220","6","553","1234","0","44.81","26.50"
"68","000","00","020","0052","0839","539","325","214","2","541","1296","0","41.74","25.08"
"68","000","00","020","0052","0840","539","330","209","4","543","1221","0","44.47","27.03"
"68","000","00","020","0052","0841","480","270","210","2","482","1062","0","45.39","25.42"
"68","000","00","020","0053","0000","1148","680","468","6","1154","2583","0","44.68","26.33"
"68","000","00","020","0053","0732","558","325","233","4","562","1298","0","43.30","25.04"
"68","000","00","020","0053","0733","590","355","235","2","592","1285","0","46.07","27.63"
"68","000","00","020","0054","0000","1223","566","657","10","1233","2700","0","45.67","20.96"
"68","000","00","020","0054","0879","424","168","256","3","427","1018","0","41.94","16.50"
"68","000","00","020","0054","0880","799","398","401","7","806","1682","0","47.92","23.66"
"68","000","00","020","0055","0000","2220","1135","1085","14","2234","5435","0","41.10","20.88"
"68","000","00","020","0055","0893","514","200","314","5","519","1332","0","38.96","15.02"
"68","000","00","020","0055","0894","705","403","302","1","706","1491","0","47.35","27.03"
"68","000","00","020","0055","0895","507","254","253","4","511","1215","0","42.06","20.91"
"68","000","00","020","0055","0896","494","278","216","4","498","1397","0","35.65","19.90"
"68","000","00","020","0056","0000","2228","1249","979","17","2245","5563","0","40.36","22.45"
"68","000","00","020","0056","0812","506","281","225","4","510","1314","0","38.81","21.39"
"68","000","00","020","0056","0813","658","366","292","3","661","1492","0","44.30","24.53"
"68","000","00","020","0056","0814","403","229","174","3","406","1218","0","33.33","18.80"
"68","000","00","020","0056","0815","661","373","288","7","668","1539","0","43.40","24.24"
"68","000","00","020","0057","0000","1867","1102","765","20","1887","4591","0","41.10","24.00"
"68","000","00","020","0057","0803","734","401","333","8","742","1613","0","46.00","24.86"
"68","000","00","020","0057","0804","512","298","214","6","518","1432","0","36.17","20.81"
"68","000","00","020","0057","0805","621","403","218","6","627","1546","0","40.56","26.07"
"68","000","00","020","0058","0000","1213","713","500","10","1223","2834","0","43.15","25.16"
"68","000","00","020","0058","0798","572","314","258","5","577","1349","0","42.77","23.28"
"68","000","00","020","0058","0799","641","399","242","5","646","1485","0","43.50","26.87"
"68","000","00","020","0059","0000","1003","554","449","6","1009","2525","0","39.96","21.94"
"68","000","00","020","0059","0822","458","250","208","4","462","1264","0","36.55","19.78"
"68","000","00","020","0059","0823","545","304","241","2","547","1261","0","43.38","24.11"
"68","000","00","020","0060","0000","1449","825","624","11","1460","3252","0","44.90","25.37"
"68","000","00","020","0060","0727","781","439","342","5","786","1718","0","45.75","25.55"
"68","000","00","020","0060","0728","668","386","282","6","674","1534","0","43.94","25.16"
"68","000","00","020","0061","0000","1690","1048","642","8","1698","3683","0","46.10","28.46"
"68","000","00","020","0061","0729","628","392","236","3","631","1328","0","47.52","29.52"
"68","000","00","020","0061","0730","479","292","187","4","483","1109","0","43.55","26.33"
"68","000","00","020","0061","0731","583","364","219","1","584","1246","0","46.87","29.21"
"68","000","00","020","0062","0000","2037","1134","903","8","2045","4693","0","43.58","24.16"
"68","000","00","020","0062","0688","750","436","314","4","754","1701","0","44.33","25.63"
"68","000","00","020","0062","0689","607","329","278","2","609","1475","0","41.29","22.31"
"68","000","00","020","0062","0690","680","369","311","2","682","1517","0","44.96","24.32"
"68","000","00","020","0063","0000","1425","974","451","9","1434","3713","0","38.62","26.23"
"68","000","00","020","0063","0691","647","455","192","4","651","1627","0","40.01","27.97"
"68","000","00","020","0063","0692","778","519","259","5","783","2086","0","37.54","24.88"
"68","000","00","020","0064","0000","1488","726","762","13","1501","3620","0","41.46","20.06"
"68","000","00","020","0064","0903","448","196","252","4","452","1081","0","41.81","18.13"
"68","000","00","020","0064","0904","433","222","211","4","437","1147","0","38.10","19.35"
"68","000","00","020","0064","0905","607","308","299","5","612","1392","0","43.97","22.13"
"68","000","00","020","0065","0000","1775","1107","668","12","1787","4104","0","43.54","26.97"
"68","000","00","020","0065","0699","570","331","239","2","572","1339","0","42.72","24.72"
"68","000","00","020","0065","0700","616","373","243","4","620","1309","0","47.36","28.50"
"68","000","00","020","0065","0701","589","403","186","6","595","1456","0","40.87","27.68"
"68","000","00","020","0066","0000","1913","1052","861","13","1926","4282","0","44.98","24.57"
"68","000","00","020","0066","0737","640","343","297","5","645","1409","0","45.78","24.34"
"68","000","00","020","0066","0738","606","343","263","2","608","1379","0","44.09","24.87"
"68","000","00","020","0066","0739","667","366","301","6","673","1494","0","45.05","24.50"
"68","000","00","020","0067","0000","1012","784","228","8","1020","2050","0","49.76","38.24"
"68","000","00","020","0067","0751","447","352","95","5","452","960","0","47.08","36.67"
"68","000","00","020","0067","0752","565","432","133","3","568","1090","0","52.11","39.63"
"68","000","00","020","0068","0000","1832","1188","644","14","1846","4761","0","38.77","24.95"
"68","000","00","020","0068","0772","577","355","222","7","584","1506","0","38.78","23.57"
"68","000","00","020","0068","0773","678","445","233","3","681","1746","0","39.00","25.49"
"68","000","00","020","0068","0774","577","388","189","4","581","1509","0","38.50","25.71"
"68","000","00","020","0069","0000","1132","634","498","8","1140","2501","0","45.58","25.35"
"68","000","00","020","0069","0743","483","254","229","3","486","1112","0","43.71","22.84"
"68","000","00","020","0069","0744","649","380","269","5","654","1389","0","47.08","27.36"
"68","000","00","020","0070","0000","1595","868","727","14","1609","3783","0","42.53","22.94"
"68","000","00","020","0070","0745","507","293","214","8","515","1155","0","44.59","25.37"
"68","000","00","020","0070","0746","552","285","267","4","556","1321","0","42.09","21.57"
"68","000","00","020","0070","0747","536","290","246","2","538","1307","0","41.16","22.19"
"68","000","00","020","0071","0000","1485","1043","442","11","1496","3965","0","37.73","26.31"
"68","000","00","020","0071","0761","446","346","100","6","452","1028","0","43.97","33.66"
"68","000","00","020","0071","0762","458","298","160","2","460","1232","0","37.34","24.19"
"68","000","00","020","0071","0763","581","399","182","3","584","1705","0","34.25","23.40"
"68","000","00","020","0072","0000","1843","1218","625","15","1858","4804","0","38.68","25.35"
"68","000","00","020","0072","0718","690","454","236","4","694","1635","0","42.45","27.77"
"68","000","00","020","0072","0719","609","426","183","7","616","1578","0","39.04","27.00"
"68","000","00","020","0072","0720","544","338","206","4","548","1591","0","34.44","21.24"
"68","000","00","020","0073","0000","2447","1330","1117","18","2465","6095","0","40.44","21.82"
"68","000","00","020","0073","0859","659","305","354","4","663","1586","0","41.80","19.23"
"68","000","00","020","0073","0860","642","357","285","6","648","1706","0","37.98","20.93"
"68","000","00","020","0073","0861","521","291","230","2","523","1357","0","38.54","21.44"
"68","000","00","020","0073","0862","625","377","248","6","631","1446","0","43.64","26.07"
"68","000","00","020","0074","0000","2431","1260","1171","15","2446","5469","0","44.72","23.04"
"68","000","00","020","0074","0863","262","115","147","1","263","640","0","41.09","17.97"
"68","000","00","020","0074","0864","737","377","360","4","741","1523","0","48.65","24.75"
"68","000","00","020","0074","0865","708","373","335","4","712","1621","0","43.92","23.01"
"68","000","00","020","0074","0866","724","395","329","6","730","1685","0","43.32","23.44"
"68","000","00","020","0075","0000","1390","858","532","10","1400","3582","0","39.08","23.95"
"68","000","00","020","0075","0757","704","418","286","5","709","1740","0","40.75","24.02"
"68","000","00","020","0075","0758","686","440","246","5","691","1842","0","37.51","23.89"
"68","000","00","020","0076","0000","1359","883","476","12","1371","3555","0","38.57","24.84"
"68","000","00","020","0076","0721","453","282","171","4","457","1220","0","37.46","23.11"
"68","000","00","020","0076","0722","458","316","142","4","462","1102","0","41.92","28.68"
"68","000","00","020","0076","0723","448","285","163","4","452","1233","0","36.66","23.11"
"68","000","00","020","0077","0000","1623","1259","364","17","1640","3413","0","48.05","36.89"
"68","000","00","020","0077","0789","847","747","100","13","860","1711","0","50.26","43.66"
"68","000","00","020","0077","0790","776","512","264","4","780","1702","0","45.83","30.08"
"68","000","00","020","0078","0000","1655","1243","412","12","1667","3620","0","46.05","34.34"
"68","000","00","020","0078","0791","831","618","213","6","837","1830","0","45.74","33.77"
"68","000","00","020","0078","0792","824","625","199","6","830","1790","0","46.37","34.92"
"68","000","00","020","0079","0000","1911","1138","773","14","1925","4454","0","43.22","25.55"
"68","000","00","020","0079","0844","612","346","266","4","616","1393","0","44.22","24.84"
"68","000","00","020","0079","0845","615","399","216","8","623","1526","0","40.83","26.15"
"68","000","00","020","0079","0846","684","393","291","2","686","1535","0","44.69","25.60"
"68","000","00","020","0080","0000","1149","529","620","6","1155","2395","0","48.23","22.09"
"68","000","00","020","0080","0877","569","253","316","1","570","1222","0","46.64","20.70"
"68","000","00","020","0080","0878","580","276","304","5","585","1173","0","49.87","23.53"
"68","000","00","020","0081","0000","1353","874","479","9","1362","3376","0","40.34","25.89"
"68","000","00","020","0081","0779","623","423","200","3","626","1783","0","35.11","23.72"
"68","000","00","020","0081","0780","730","451","279","6","736","1593","0","46.20","28.31"
"68","000","00","020","0082","0000","2015","1333","682","7","2022","4787","0","42.24","27.85"
"68","000","00","020","0082","0693","507","292","215","0","507","1135","0","44.67","25.73"
"68","000","00","020","0082","0694","766","513","253","3","769","1881","0","40.88","27.27"
"68","000","00","020","0082","0695","742","528","214","4","746","1771","0","42.12","29.81"
"68","000","00","020","0083","0000","2301","1475","826","10","2311","5590","0","41.34","26.39"
"68","000","00","020","0083","0785","551","355","196","3","554","1376","0","40.26","25.80"
"68","000","00","020","0083","0786","545","361","184","2","547","1275","0","42.90","28.31"
"68","000","00","020","0083","0787","635","415","220","3","638","1523","0","41.89","27.25"
"68","000","00","020","0083","0788","570","344","226","2","572","1416","0","40.40","24.29"
"68","000","00","020","0084","0000","1703","1005","698","10","1713","3821","0","44.83","26.30"
"68","000","00","020","0084","0835","616","362","254","3","619","1346","0","45.99","26.89"
"68","000","00","020","0084","0836","510","300","210","2","512","1229","0","41.66","24.41"
"68","000","00","020","0084","0837","577","343","234","5","582","1246","0","46.71","27.53"
"68","000","00","020","0085","0000","2076","1322","754","16","2092","4035","0","51.85","32.76"
"68","000","00","020","0085","0850","735","471","264","6","741","1414","0","52.40","33.31"
"68","000","00","020","0085","0851","672","430","242","4","676","1341","0","50.41","32.07"
"68","000","00","020","0085","0852","669","421","248","6","675","1280","0","52.73","32.89"
"68","000","00","030","0000","0000","31095","14792","16303","317","31412","79690","95240","39.42","18.56"
"68","000","00","030","0001","0000","673","251","422","3","676","1435","0","47.11","17.49"
"68","000","00","030","0001","0611","673","251","422","3","676","1435","0","47.11","17.49"
"68","000","00","030","0002","0000","452","145","307","5","457","963","0","47.46","15.06"
"68","000","00","030","0002","0612","452","145","307","5","457","963","0","47.46","15.06"
"68","000","00","030","0003","0000","1823","817","1006","11","1834","4760","0","38.53","17.16"
"68","000","00","030","0003","0616","449","198","251","4","453","1140","0","39.74","17.37"
"68","000","00","030","0003","0617","503","235","268","2","505","1263","0","39.98","18.61"
"68","000","00","030","0003","0618","496","218","278","1","497","1213","0","40.97","17.97"
"68","000","00","030","0003","0619","375","166","209","4","379","1144","0","33.13","14.51"
"68","000","00","030","0004","0000","1999","762","1237","24","2023","5582","0","36.24","13.65"
"68","000","00","030","0004","0620","506","167","339","4","510","1224","0","41.67","13.64"
"68","000","00","030","0004","0621","447","209","238","6","453","1395","0","32.47","14.98"
"68","000","00","030","0004","0622","526","178","348","7","533","1415","0","37.67","12.58"
"68","000","00","030","0004","0623","520","208","312","7","527","1548","0","34.04","13.44"
"68","000","00","030","0005","0000","475","142","333","9","484","1237","0","39.13","11.48"
"68","000","00","030","0005","0624","475","142","333","9","484","1237","0","39.13","11.48"
"68","000","00","030","0006","0000","432","120","312","4","436","964","0","45.23","12.45"
"68","000","00","030","0006","0625","432","120","312","4","436","964","0","45.23","12.45"
"68","000","00","030","0007","0000","1240","440","800","5","1245","3069","0","40.57","14.34"
"68","000","00","030","0007","0629","466","154","312","1","467","1059","0","44.10","14.54"
"68","000","00","030","0007","0630","483","191","292","2","485","1253","0","38.71","15.24"
"68","000","00","030","0007","0631","291","95","196","2","293","757","0","38.71","12.55"
"68","000","00","030","0008","0000","895","296","599","12","907","2222","0","40.82","13.32"
"68","000","00","030","0008","0632","497","195","302","5","502","1271","0","39.50","15.34"
"68","000","00","030","0008","0633","398","101","297","7","405","951","0","42.59","10.62"
"68","000","00","030","0009","0000","348","120","228","5","353","859","0","41.09","13.97"
"68","000","00","030","0009","0634","348","120","228","5","353","859","0","41.09","13.97"
"68","000","00","030","0010","0000","305","111","194","4","309","808","0","38.24","13.74"
"68","000","00","030","0010","0635","305","111","194","4","309","808","0","38.24","13.74"
"68","000","00","030","0011","0000","578","166","412","9","587","1300","0","45.15","12.77"
"68","000","00","030","0011","0626","578","166","412","9","587","1300","0","45.15","12.77"
"68","000","00","030","0012","0000","722","261","461","9","731","1752","0","41.72","14.90"
"68","000","00","030","0012","0627","456","165","291","6","462","1114","0","41.47","14.81"
"68","000","00","030","0012","0628","266","96","170","3","269","638","0","42.16","15.05"
"68","000","00","030","0013","0000","1002","393","609","11","1013","2714","0","37.32","14.48"
"68","000","00","030","0013","0638","565","170","395","7","572","1403","0","40.77","12.12"
"68","000","00","030","0013","0639","437","223","214","4","441","1311","0","33.64","17.01"
"68","000","00","030","0014","0000","674","235","439","6","680","1519","0","44.77","15.47"
"68","000","00","030","0014","0636","364","118","246","3","367","827","0","44.38","14.27"
"68","000","00","030","0014","0637","310","117","193","3","313","692","0","45.23","16.91"
"68","000","00","030","0015","0000","1059","756","303","19","1078","2831","0","38.08","26.70"
"68","000","00","030","0015","0648","550","367","183","10","560","1447","0","38.70","25.36"
"68","000","00","030","0015","0649","509","389","120","9","518","1384","0","37.43","28.11"
"68","000","00","030","0016","0000","1094","908","186","4","1098","2488","0","44.13","36.50"
"68","000","00","030","0016","0646","605","533","72","1","606","1222","0","49.59","43.62"
"68","000","00","030","0016","0647","489","375","114","3","492","1266","0","38.86","29.62"
"68","000","00","030","0017","0000","1780","902","878","13","1793","4490","0","39.93","20.09"
"68","000","00","030","0017","0640","560","244","316","5","565","1488","0","37.97","16.40"
"68","000","00","030","0017","0641","502","279","223","3","505","1271","0","39.73","21.95"
"68","000","00","030","0017","0642","718","379","339","5","723","1731","0","41.77","21.89"
"68","000","00","030","0018","0000","1951","971","980","17","1968","5178","0","38.01","18.75"
"68","000","00","030","0018","0653","543","284","259","6","549","1345","0","40.82","21.12"
"68","000","00","030","0018","0654","484","222","262","6","490","1100","0","44.55","20.18"
"68","000","00","030","0018","0655","518","243","275","3","521","1337","0","38.97","18.18"
"68","000","00","030","0018","0656","406","222","184","2","408","1396","0","29.23","15.90"
"68","000","00","030","0019","0000","1268","706","562","9","1277","3244","0","39.36","21.76"
"68","000","00","030","0019","0657","722","391","331","8","730","1758","0","41.52","22.24"
"68","000","00","030","0019","0658","546","315","231","1","547","1486","0","36.81","21.20"
"68","000","00","030","0020","0000","600","301","299","3","603","1577","0","38.24","19.09"
"68","000","00","030","0020","0668","600","301","299","3","603","1577","0","38.24","19.09"
"68","000","00","030","0021","0000","1784","792","992","23","1807","5101","0","35.42","15.53"
"68","000","00","030","0021","0662","440","163","277","4","444","1174","0","37.82","13.88"
"68","000","00","030","0021","0663","492","197","295","5","497","1320","0","37.65","14.92"
"68","000","00","030","0021","0664","406","186","220","6","412","1290","0","31.94","14.42"
"68","000","00","030","0021","0665","446","246","200","8","454","1317","0","34.47","18.68"
"68","000","00","030","0022","0000","1449","628","821","10","1459","3734","0","39.07","16.82"
"68","000","00","030","0022","0671","463","224","239","8","471","1254","0","37.56","17.86"
"68","000","00","030","0022","0672","456","233","223","1","457","1156","0","39.53","20.16"
"68","000","00","030","0022","0673","530","171","359","1","531","1324","0","40.11","12.92"
"68","000","00","030","0023","0000","919","587","332","22","941","2437","0","38.61","24.09"
"68","000","00","030","0023","0666","425","248","177","13","438","1271","0","34.46","19.51"
"68","000","00","030","0023","0667","494","339","155","9","503","1166","0","43.14","29.07"
"68","000","00","030","0024","0000","1195","803","392","18","1213","3012","0","40.27","26.66"
"68","000","00","030","0024","0669","601","379","222","8","609","1470","0","41.43","25.78"
"68","000","00","030","0024","0670","594","424","170","10","604","1542","0","39.17","27.50"
"68","000","00","030","0025","0000","1848","713","1135","17","1865","4436","0","42.04","16.07"
"68","000","00","030","0025","0613","650","267","383","6","656","1541","0","42.57","17.33"
"68","000","00","030","0025","0614","612","223","389","7","619","1427","0","43.38","15.63"
"68","000","00","030","0025","0615","586","223","363","4","590","1468","0","40.19","15.19"
"68","000","00","030","0026","0000","1472","817","655","15","1487","3897","0","38.16","20.96"
"68","000","00","030","0026","0659","455","244","211","3","458","1378","0","33.24","17.71"
"68","000","00","030","0026","0660","410","250","160","5","415","1040","0","39.90","24.04"
"68","000","00","030","0026","0661","607","323","284","7","614","1479","0","41.51","21.84"
"68","000","00","030","0027","0000","1818","950","868","15","1833","4772","0","38.41","19.91"
"68","000","00","030","0027","0650","676","397","279","5","681","1647","0","41.35","24.10"
"68","000","00","030","0027","0651","568","272","296","6","574","1561","0","36.77","17.42"
"68","000","00","030","0027","0652","574","281","293","4","578","1564","0","36.96","17.97"
"68","000","00","030","0028","0000","1240","699","541","15","1255","3309","0","37.93","21.12"
"68","000","00","030","0028","0643","369","212","157","7","376","977","0","38.49","21.70"
"68","000","00","030","0028","0644","412","227","185","5","417","1074","0","38.83","21.14"
"68","000","00","030","0028","0645","459","260","199","3","462","1258","0","36.72","20.67"
"68","000","00","040","0000","0000","53925","30754","23171","459","54384","144349","176189","37.68","21.31"
"68","000","00","040","0001","0000","1576","938","638","8","1584","3845","0","41.20","24.40"
"68","000","00","040","0001","1104","553","291","262","2","555","1363","0","40.72","21.35"
"68","000","00","040","0001","1105","465","288","177","3","468","1274","0","36.73","22.61"
"68","000","00","040","0001","1106","558","359","199","3","561","1208","0","46.44","29.72"
"68","000","00","040","0002","0000","469","278","191","5","474","1054","0","44.97","26.38"
"68","000","00","040","0002","1107","469","278","191","5","474","1054","0","44.97","26.38"
"68","000","00","040","0003","0000","1092","662","430","8","1100","2595","0","42.39","25.51"
"68","000","00","040","0003","1110","468","272","196","2","470","1252","0","37.54","21.73"
"68","000","00","040","0003","1111","624","390","234","6","630","1343","0","46.91","29.04"
"68","000","00","040","0004","0000","2464","1408","1056","18","2482","7481","0","33.18","18.82"
"68","000","00","040","0004","1112","476","219","257","6","482","2073","0","23.25","10.56"
"68","000","00","040","0004","1113","637","347","290","6","643","1799","0","35.74","19.29"
"68","000","00","040","0004","1114","656","413","243","2","658","1744","0","37.73","23.68"
"68","000","00","040","0004","1115","695","429","266","4","699","1865","0","37.48","23.00"
"68","000","00","040","0005","0000","1134","710","424","10","1144","3148","0","36.34","22.55"
"68","000","00","040","0005","1116","529","356","173","6","535","1572","0","34.03","22.65"
"68","000","00","040","0005","1117","605","354","251","4","609","1576","0","38.64","22.46"
"68","000","00","040","0006","0000","992","459","533","3","995","2934","0","33.91","15.64"
"68","000","00","040","0006","1120","580","244","336","1","581","1761","0","32.99","13.86"
"68","000","00","040","0006","1121","412","215","197","2","414","1173","0","35.29","18.33"
"68","000","00","040","0007","0000","1602","855","747","18","1620","4097","0","39.54","20.87"
"68","000","00","040","0007","1155","570","309","261","12","582","1453","0","40.06","21.27"
"68","000","00","040","0007","1156","470","260","210","3","473","1337","0","35.38","19.45"
"68","000","00","040","0007","1157","562","286","276","3","565","1307","0","43.23","21.88"
"68","000","00","040","0008","0000","972","462","510","10","982","2632","0","37.31","17.55"
"68","000","00","040","0008","1139","445","202","243","5","450","1196","0","37.63","16.89"
"68","000","00","040","0008","1140","527","260","267","5","532","1436","0","37.05","18.11"
"68","000","00","040","0009","0000","796","475","321","6","802","1933","0","41.49","24.57"
"68","000","00","040","0009","1108","379","236","143","3","382","904","0","42.26","26.11"
"68","000","00","040","0009","1109","417","239","178","3","420","1029","0","40.82","23.23"
"68","000","00","040","0010","0000","1430","874","556","14","1444","3487","0","41.41","25.06"
"68","000","00","040","0010","1100","731","441","290","8","739","1782","0","41.47","24.75"
"68","000","00","040","0010","1101","699","433","266","6","705","1705","0","41.35","25.40"
"68","000","00","040","0011","0000","659","331","328","11","670","1355","0","49.45","24.43"
"68","000","00","040","0011","1063","659","331","328","11","670","1355","0","49.45","24.43"
"68","000","00","040","0012","0000","562","401","161","11","573","1396","0","41.05","28.72"
"68","000","00","040","0012","1066","562","401","161","11","573","1396","0","41.05","28.72"
"68","000","00","040","0013","0000","2153","1160","993","18","2171","5757","0","37.71","20.15"
"68","000","00","040","0013","1072","644","316","328","6","650","1648","0","39.44","19.17"
"68","000","00","040","0013","1073","468","253","215","3","471","1349","0","34.91","18.75"
"68","000","00","040","0013","1074","513","287","226","2","515","1460","0","35.27","19.66"
"68","000","00","040","0013","1075","528","304","224","7","535","1300","0","41.15","23.38"
"68","000","00","040","0014","0000","1901","1069","832","16","1917","4609","0","41.59","23.19"
"68","000","00","040","0014","1067","690","415","275","5","695","1679","0","41.39","24.72"
"68","000","00","040","0014","1068","639","406","233","5","644","1487","0","43.31","27.30"
"68","000","00","040","0014","1069","572","248","324","6","578","1443","0","40.06","17.19"
"68","000","00","040","0015","0000","1459","872","587","12","1471","4143","0","35.51","21.05"
"68","000","00","040","0015","1080","523","318","205","5","528","1416","0","37.29","22.46"
"68","000","00","040","0015","1081","486","269","217","4","490","1379","0","35.53","19.51"
"68","000","00","040","0015","1082","450","285","165","3","453","1348","0","33.61","21.14"
"68","000","00","040","0016","0000","1251","775","476","9","1260","3760","0","33.51","20.61"
"68","000","00","040","0016","1141","408","269","139","4","412","1198","0","34.39","22.45"
"68","000","00","040","0016","1142","397","226","171","4","401","1287","0","31.16","17.56"
"68","000","00","040","0016","1143","446","280","166","1","447","1275","0","35.06","21.96"
"68","000","00","040","0017","0000","1374","658","716","13","1387","3518","0","39.43","18.70"
"68","000","00","040","0017","1149","717","323","394","6","723","1721","0","42.01","18.77"
"68","000","00","040","0017","1150","657","335","322","7","664","1797","0","36.95","18.64"
"68","000","00","040","0018","0000","1651","972","679","17","1668","3818","0","43.69","25.46"
"68","000","00","040","0018","1060","512","284","228","8","520","1214","0","42.83","23.39"
"68","000","00","040","0018","1061","623","360","263","5","628","1331","0","47.18","27.05"
"68","000","00","040","0018","1062","516","328","188","4","520","1273","0","40.85","25.77"
"68","000","00","040","0019","0000","1306","820","486","16","1322","3153","0","41.93","26.01"
"68","000","00","040","0019","1064","632","410","222","8","640","1522","0","42.05","26.94"
"68","000","00","040","0019","1065","674","410","264","8","682","1631","0","41.81","25.14"
"68","000","00","040","0020","0000","698","384","314","5","703","1787","0","39.34","21.49"
"68","000","00","040","0020","1125","358","201","157","3","361","929","0","38.86","21.64"
"68","000","00","040","0020","1126","340","183","157","2","342","858","0","39.86","21.33"
"68","000","00","040","0021","0000","1459","795","664","8","1467","3873","0","37.88","20.53"
"68","000","00","040","0021","1122","529","300","229","4","533","1290","0","41.32","23.26"
"68","000","00","040","0021","1123","445","262","183","3","448","1244","0","36.01","21.06"
"68","000","00","040","0021","1124","485","233","252","1","486","1339","0","36.30","17.40"
"68","000","00","040","0022","0000","1052","554","498","18","1070","2859","0","37.43","19.38"
"68","000","00","040","0022","1129","570","305","265","12","582","1616","0","36.01","18.87"
"68","000","00","040","0022","1130","482","249","233","6","488","1243","0","39.26","20.03"
"68","000","00","040","0023","0000","1184","664","520","25","1209","3757","0","32.18","17.67"
"68","000","00","040","0023","1158","427","214","213","8","435","1251","0","34.77","17.11"
"68","000","00","040","0023","1159","378","229","149","11","389","1192","0","32.63","19.21"
"68","000","00","040","0023","1160","379","221","158","6","385","1314","0","29.30","16.82"
"68","000","00","040","0024","0000","971","495","476","6","977","2794","0","34.97","17.72"
"68","000","00","040","0024","1131","458","249","209","2","460","1335","0","34.46","18.65"
"68","000","00","040","0024","1132","513","246","267","4","517","1459","0","35.44","16.86"
"68","000","00","040","0025","0000","1954","1123","831","14","1968","5853","0","33.62","19.19"
"68","000","00","040","0025","1135","574","319","255","4","578","1606","0","35.99","19.86"
"68","000","00","040","0025","1136","510","271","239","3","513","1456","0","35.23","18.61"
"68","000","00","040","0025","1137","439","272","167","1","440","1404","0","31.34","19.37"
"68","000","00","040","0025","1138","431","261","170","6","437","1387","0","31.51","18.82"
"68","000","00","040","0026","0000","1210","715","495","5","1215","2986","0","40.69","23.95"
"68","000","00","040","0026","1102","696","429","267","4","700","1687","0","41.49","25.43"
"68","000","00","040","0026","1103","514","286","228","1","515","1299","0","39.65","22.02"
"68","000","00","040","0027","0000","2752","1586","1166","13","2765","7742","0","35.71","20.49"
"68","000","00","040","0027","1091","548","337","211","3","551","1482","0","37.18","22.74"
"68","000","00","040","0027","1092","591","346","245","3","594","1483","0","40.05","23.33"
"68","000","00","040","0027","1093","513","296","217","1","514","1499","0","34.29","19.75"
"68","000","00","040","0027","1094","606","361","245","3","609","1727","0","35.26","20.90"
"68","000","00","040","0027","1095","494","246","248","3","497","1551","0","32.04","15.86"
"68","000","00","040","0028","0000","1647","1037","610","15","1662","4048","0","41.06","25.62"
"68","000","00","040","0028","1086","421","259","162","4","425","1406","0","30.23","18.42"
"68","000","00","040","0028","1087","627","382","245","4","631","1270","0","49.69","30.08"
"68","000","00","040","0028","1088","599","396","203","7","606","1372","0","44.17","28.86"
"68","000","00","040","0029","0000","1473","914","559","17","1490","3286","0","45.34","27.81"
"68","000","00","040","0029","1096","743","485","258","4","747","1612","0","46.34","30.09"
"68","000","00","040","0029","1097","730","429","301","13","743","1674","0","44.38","25.63"
"68","000","00","040","0030","0000","1326","668","658","18","1344","3311","0","40.59","20.18"
"68","000","00","040","0030","1118","700","337","363","13","713","1669","0","42.72","20.19"
"68","000","00","040","0030","1119","626","331","295","5","631","1642","0","38.43","20.16"
"68","000","00","040","0031","0000","1435","864","571","6","1441","4482","0","32.15","19.28"
"68","000","00","040","0031","1146","473","287","186","3","476","1506","0","31.61","19.06"
"68","000","00","040","0031","1147","488","278","210","2","490","1537","0","31.88","18.09"
"68","000","00","040","0031","1148","474","299","175","1","475","1439","0","33.01","20.78"
"68","000","00","040","0032","0000","1421","754","667","13","1434","3453","0","41.53","21.84"
"68","000","00","040","0032","1153","764","399","365","5","769","1740","0","44.20","22.93"
"68","000","00","040","0032","1154","657","355","302","8","665","1713","0","38.82","20.72"
"68","000","00","040","0033","0000","1420","759","661","9","1429","3233","0","44.20","23.48"
"68","000","00","040","0033","1151","728","429","299","7","735","1620","0","45.37","26.48"
"68","000","00","040","0033","1152","692","330","362","2","694","1613","0","43.03","20.46"
"68","000","00","040","0034","0000","2093","1275","818","11","2104","5934","0","35.46","21.49"
"68","000","00","040","0034","1076","540","360","180","3","543","1488","0","36.49","24.19"
"68","000","00","040","0034","1077","462","275","187","3","465","1445","0","32.18","19.03"
"68","000","00","040","0034","1078","541","275","266","3","544","1510","0","36.03","18.21"
"68","000","00","040","0034","1079","550","365","185","2","552","1491","0","37.02","24.48"
"68","000","00","040","0035","0000","741","445","296","8","749","1966","0","38.10","22.63"
"68","000","00","040","0035","1070","269","153","116","1","270","870","0","31.03","17.59"
"68","000","00","040","0035","1071","472","292","180","7","479","1096","0","43.70","26.64"
"68","000","00","040","0036","0000","1183","719","464","10","1193","3639","0","32.78","19.76"
"68","000","00","040","0036","1083","387","234","153","3","390","1309","0","29.79","17.88"
"68","000","00","040","0036","1084","457","284","173","5","462","1200","0","38.50","23.67"
"68","000","00","040","0036","1085","339","201","138","2","341","1130","0","30.18","17.79"
"68","000","00","040","0037","0000","969","502","467","10","979","2766","0","35.39","18.15"
"68","000","00","040","0037","1144","491","230","261","2","493","1442","0","34.19","15.95"
"68","000","00","040","0037","1145","478","272","206","8","486","1324","0","36.71","20.54"
"68","000","00","040","0038","0000","1024","530","494","9","1033","3030","0","34.09","17.49"
"68","000","00","040","0038","1127","504","226","278","3","507","1453","0","34.89","15.55"
"68","000","00","040","0038","1128","520","304","216","6","526","1577","0","33.35","19.28"
"68","000","00","040","0039","0000","850","524","326","5","855","2486","0","34.39","21.08"
"68","000","00","040","0039","1098","369","231","138","3","372","1277","0","29.13","18.09"
"68","000","00","040","0039","1099","481","293","188","2","483","1209","0","39.95","24.23"
"68","000","00","040","0040","0000","1198","713","485","3","1201","3449","0","34.82","20.67"
"68","000","00","040","0040","1089","640","383","257","1","641","1681","0","38.13","22.78"
"68","000","00","040","0040","1090","558","330","228","2","560","1768","0","31.67","18.67"
"68","000","00","040","0041","0000","1022","555","467","8","1030","2900","0","35.52","19.14"
"68","000","00","040","0041","1133","522","327","195","3","525","1315","0","39.92","24.87"
"68","000","00","040","0041","1134","500","228","272","5","505","1585","0","31.86","14.38"
"68","000","00","050","0000","0000","52638","24795","27843","410","53048","133965","166690","39.60","18.51"
"68","000","00","050","0001","0000","1249","432","817","9","1258","2950","0","42.64","14.64"
"68","000","00","050","0001","0463","675","230","445","4","679","1566","0","43.36","14.69"
"68","000","00","050","0001","0464","574","202","372","5","579","1384","0","41.84","14.60"
"68","000","00","050","0002","0000","1655","597","1058","13","1668","4062","0","41.06","14.70"
"68","000","00","050","0002","0465","590","213","377","5","595","1441","0","41.29","14.78"
"68","000","00","050","0002","0466","535","190","345","7","542","1358","0","39.91","13.99"
"68","000","00","050","0002","0467","530","194","336","1","531","1263","0","42.04","15.36"
"68","000","00","050","0003","0000","1992","842","1150","18","2010","5043","0","39.86","16.70"
"68","000","00","050","0003","0473","654","298","356","6","660","1683","0","39.22","17.71"
"68","000","00","050","0003","0474","447","178","269","3","450","1172","0","38.40","15.19"
"68","000","00","050","0003","0475","437","155","282","2","439","1103","0","39.80","14.05"
"68","000","00","050","0003","0476","454","211","243","7","461","1085","0","42.49","19.45"
"68","000","00","050","0004","0000","1924","939","985","26","1950","4969","0","39.24","18.90"
"68","000","00","050","0004","0482","673","322","351","10","683","1733","0","39.41","18.58"
"68","000","00","050","0004","0483","597","292","305","5","602","1657","0","36.33","17.62"
"68","000","00","050","0004","0484","654","325","329","11","665","1579","0","42.12","20.58"
"68","000","00","050","0006","0000","1576","533","1043","12","1588","4036","0","39.35","13.21"
"68","000","00","050","0006","0486","452","122","330","6","458","1238","0","37.00","9.85"
"68","000","00","050","0006","0487","561","182","379","3","564","1366","0","41.29","13.32"
"68","000","00","050","0006","0488","563","229","334","3","566","1432","0","39.53","15.99"
"68","000","00","050","0007","0000","1535","744","791","14","1549","3675","0","42.15","20.24"
"68","000","00","050","0007","0507","521","244","277","5","526","1152","0","45.66","21.18"
"68","000","00","050","0007","0508","548","243","305","4","552","1361","0","40.56","17.85"
"68","000","00","050","0007","0509","466","257","209","5","471","1162","0","40.53","22.12"
"68","000","00","050","0008","0000","1612","728","884","8","1620","3906","0","41.47","18.64"
"68","000","00","050","0008","0510","567","264","303","5","572","1344","0","42.56","19.64"
"68","000","00","050","0008","0511","468","202","266","1","469","1152","0","40.71","17.53"
"68","000","00","050","0008","0512","577","262","315","2","579","1410","0","41.06","18.58"
"68","000","00","050","0009","0000","1023","539","484","3","1026","2425","0","42.31","22.23"
"68","000","00","050","0009","0519","580","311","269","1","581","1215","0","47.82","25.60"
"68","000","00","050","0009","0520","443","228","215","2","445","1210","0","36.78","18.84"
"68","000","00","050","0010","0000","917","337","580","8","925","2595","0","35.65","12.99"
"68","000","00","050","0010","0542","380","149","231","0","380","1343","0","28.29","11.09"
"68","000","00","050","0010","0543","537","188","349","8","545","1252","0","43.53","15.02"
"68","000","00","050","0011","0000","597","250","347","6","603","1778","0","33.91","14.06"
"68","000","00","050","0011","0544","597","250","347","6","603","1778","0","33.91","14.06"
"68","000","00","050","0012","0000","1311","452","859","16","1327","3579","0","37.08","12.63"
"68","000","00","050","0012","0545","442","168","274","7","449","1192","0","37.67","14.09"
"68","000","00","050","0012","0546","462","148","314","6","468","1218","0","38.42","12.15"
"68","000","00","050","0012","0547","407","136","271","3","410","1169","0","35.07","11.63"
"68","000","00","050","0013","0000","619","151","468","11","630","1486","0","42.40","10.16"
"68","000","00","050","0013","0548","619","151","468","11","630","1486","0","42.40","10.16"
"68","000","00","050","0014","0000","616","173","443","8","624","1673","0","37.30","10.34"
"68","000","00","050","0014","0549","616","173","443","8","624","1673","0","37.30","10.34"
"68","000","00","050","0015","0000","977","353","624","8","985","2501","0","39.38","14.11"
"68","000","00","050","0015","0550","531","187","344","3","534","1310","0","40.76","14.27"
"68","000","00","050","0015","0551","446","166","280","5","451","1191","0","37.87","13.94"
"68","000","00","050","0016","0000","926","455","471","13","939","2969","0","31.63","15.33"
"68","000","00","050","0016","0552","437","220","217","8","445","1485","0","29.97","14.81"
"68","000","00","050","0016","0553","489","235","254","5","494","1484","0","33.29","15.84"
"68","000","00","050","0017","0000","1525","727","798","16","1541","3532","0","43.63","20.58"
"68","000","00","050","0017","0505","833","363","470","8","841","1881","0","44.71","19.30"
"68","000","00","050","0017","0506","692","364","328","8","700","1651","0","42.40","22.05"
"68","000","00","050","0018","0000","2188","1205","983","14","2202","5162","0","42.66","23.34"
"68","000","00","050","0018","0489","486","268","218","3","489","1167","0","41.90","22.96"
"68","000","00","050","0018","0490","635","352","283","8","643","1347","0","47.74","26.13"
"68","000","00","050","0018","0491","518","266","252","2","520","1279","0","40.66","20.80"
"68","000","00","050","0018","0492","549","319","230","1","550","1369","0","40.18","23.30"
"68","000","00","050","0019","0000","859","392","467","10","869","2582","0","33.66","15.18"
"68","000","00","050","0019","0517","422","182","240","8","430","1148","0","37.46","15.85"
"68","000","00","050","0019","0518","437","210","227","2","439","1434","0","30.61","14.64"
"68","000","00","050","0020","0000","1327","619","708","7","1334","3128","0","42.65","19.79"
"68","000","00","050","0020","0513","626","247","379","3","629","1471","0","42.76","16.79"
"68","000","00","050","0020","0516","701","372","329","4","705","1657","0","42.55","22.45"
"68","000","00","050","0021","0000","578","145","433","3","581","1327","0","43.78","10.93"
"68","000","00","050","0021","0485","578","145","433","3","581","1327","0","43.78","10.93"
"68","000","00","050","0022","0000","1430","647","783","10","1440","3516","0","40.96","18.40"
"68","000","00","050","0022","0477","461","196","265","2","463","1181","0","39.20","16.60"
"68","000","00","050","0022","0478","718","329","389","5","723","1717","0","42.11","19.16"
"68","000","00","050","0022","0479","251","122","129","3","254","618","0","41.10","19.74"
"68","000","00","050","0023","0000","1162","467","695","17","1179","2982","0","39.54","15.66"
"68","000","00","050","0023","0480","628","234","394","7","635","1534","0","41.40","15.25"
"68","000","00","050","0023","0481","534","233","301","10","544","1448","0","37.57","16.09"
"68","000","00","050","0024","0000","1276","725","551","14","1290","3360","0","38.39","21.58"
"68","000","00","050","0024","0540","627","310","317","5","632","1645","0","38.42","18.84"
"68","000","00","050","0024","0541","649","415","234","9","658","1715","0","38.37","24.20"
"68","000","00","050","0025","0000","1938","1022","916","17","1955","4886","0","40.01","20.92"
"68","000","00","050","0025","0535","620","306","314","6","626","1506","0","41.57","20.32"
"68","000","00","050","0025","0536","701","417","284","4","705","1732","0","40.70","24.08"
"68","000","00","050","0025","0537","617","299","318","7","624","1648","0","37.86","18.14"
"68","000","00","050","0026","0000","1915","986","929","13","1928","4459","0","43.24","22.11"
"68","000","00","050","0026","0525","712","360","352","3","715","1624","0","44.03","22.17"
"68","000","00","050","0026","0526","640","333","307","4","644","1503","0","42.85","22.16"
"68","000","00","050","0026","0527","563","293","270","6","569","1332","0","42.72","22.00"
"68","000","00","050","0027","0000","1520","777","743","4","1524","3985","0","38.24","19.50"
"68","000","00","050","0027","0501","549","281","268","1","550","1579","0","34.83","17.80"
"68","000","00","050","0027","0502","442","203","239","2","444","1153","0","38.51","17.61"
"68","000","00","050","0027","0503","529","293","236","1","530","1253","0","42.30","23.38"
"68","000","00","050","0028","0000","1966","1123","843","7","1973","5062","0","38.98","22.18"
"68","000","00","050","0028","0493","669","394","275","2","671","1820","0","36.87","21.65"
"68","000","00","050","0028","0494","621","352","269","4","625","1628","0","38.39","21.62"
"68","000","00","050","0028","0495","676","377","299","1","677","1614","0","41.95","23.36"
"68","000","00","050","0029","0000","1354","713","641","5","1359","3442","0","39.48","20.71"
"68","000","00","050","0029","0496","674","360","314","2","676","1683","0","40.17","21.39"
"68","000","00","050","0029","0497","680","353","327","3","683","1759","0","38.83","20.07"
"68","000","00","050","0030","0000","591","280","311","9","600","1633","0","36.74","17.15"
"68","000","00","050","0030","0504","591","280","311","9","600","1633","0","36.74","17.15"
"68","000","00","050","0031","0000","2343","1300","1043","17","2360","5584","0","42.26","23.28"
"68","000","00","050","0031","0531","648","340","308","3","651","1522","0","42.77","22.34"
"68","000","00","050","0031","0532","527","305","222","6","533","1314","0","40.56","23.21"
"68","000","00","050","0031","0533","561","304","257","4","565","1352","0","41.79","22.49"
"68","000","00","050","0031","0534","607","351","256","4","611","1396","0","43.77","25.14"
"68","000","00","050","0032","0000","1756","973","783","14","1770","3690","0","47.97","26.37"
"68","000","00","050","0032","0528","572","320","252","6","578","1190","0","48.57","26.89"
"68","000","00","050","0032","0529","686","394","292","4","690","1245","0","55.42","31.65"
"68","000","00","050","0032","0530","498","259","239","4","502","1255","0","40.00","20.64"
"68","000","00","050","0033","0000","1230","666","564","6","1236","3243","0","38.11","20.54"
"68","000","00","050","0033","0521","663","364","299","3","666","1711","0","38.92","21.27"
"68","000","00","050","0033","0522","567","302","265","3","570","1532","0","37.21","19.71"
"68","000","00","050","0034","0000","1172","522","650","7","1179","3227","0","36.54","16.18"
"68","000","00","050","0034","0523","580","237","343","3","583","1535","0","37.98","15.44"
"68","000","00","050","0034","0524","592","285","307","4","596","1692","0","35.22","16.84"
"68","000","00","050","0035","0000","1234","665","569","6","1240","2793","0","44.40","23.81"
"68","000","00","050","0035","0514","607","326","281","4","611","1423","0","42.94","22.91"
"68","000","00","050","0035","0515","627","339","288","2","629","1370","0","45.91","24.74"
"68","000","00","050","0036","0000","1817","925","892","8","1825","5074","0","35.97","18.23"
"68","000","00","050","0036","0470","602","306","296","3","605","1498","0","40.39","20.43"
"68","000","00","050","0036","0471","583","293","290","2","585","1805","0","32.41","16.23"
"68","000","00","050","0036","0472","632","326","306","3","635","1771","0","35.86","18.41"
"68","000","00","050","0037","0000","1372","676","696","7","1379","3380","0","40.80","20.00"
"68","000","00","050","0037","0468","657","288","369","4","661","1591","0","41.55","18.10"
"68","000","00","050","0037","0469","715","388","327","3","718","1789","0","40.13","21.69"
"68","000","00","050","0038","0000","1283","672","611","7","1290","3296","0","39.14","20.39"
"68","000","00","050","0038","0538","595","309","286","5","600","1597","0","37.57","19.35"
"68","000","00","050","0038","0539","688","363","325","2","690","1699","0","40.61","21.37"
"68","000","00","050","0039","0000","1511","715","796","9","1520","4443","0","34.21","16.09"
"68","000","00","050","0039","0498","496","223","273","1","497","1512","0","32.87","14.75"
"68","000","00","050","0039","0499","575","272","303","6","581","1576","0","36.87","17.26"
"68","000","00","050","0039","0500","440","220","220","2","442","1355","0","32.62","16.24"
"68","000","00","050","0040","0000","762","328","434","10","772","2532","0","30.49","12.95"
"68","000","00","050","0040","0554","364","165","199","3","367","1210","0","30.33","13.64"
"68","000","00","050","0040","0555","398","163","235","7","405","1322","0","30.64","12.33"
"68","000","00","060","0000","0000","27901","12430","15471","242","28143","77353","93663","36.38","16.07"
"68","000","00","060","0001","0000","2342","1047","1295","16","2358","6107","0","38.61","17.14"
"68","000","00","060","0001","0556","618","303","315","5","623","1523","0","40.91","19.89"
"68","000","00","060","0001","0557","531","257","274","2","533","1639","0","32.52","15.68"
"68","000","00","060","0001","0558","554","232","322","3","557","1405","0","39.64","16.51"
"68","000","00","060","0001","0559","639","255","384","6","645","1540","0","41.88","16.56"
"68","000","00","060","0002","0000","2513","1089","1424","24","2537","6972","0","36.39","15.62"
"68","000","00","060","0002","0560","465","186","279","8","473","1233","0","38.36","15.09"
"68","000","00","060","0002","0561","550","255","295","6","556","1503","0","36.99","16.97"
"68","000","00","060","0002","0562","455","194","261","3","458","1312","0","34.91","14.79"
"68","000","00","060","0002","0563","525","240","285","4","529","1462","0","36.18","16.42"
"68","000","00","060","0002","0564","518","214","304","3","521","1462","0","35.64","14.64"
"68","000","00","060","0003","0000","1474","621","853","16","1490","4705","0","31.67","13.20"
"68","000","00","060","0003","0565","490","222","268","4","494","1601","0","30.86","13.87"
"68","000","00","060","0003","0566","473","191","282","6","479","1438","0","33.31","13.28"
"68","000","00","060","0003","0567","511","208","303","6","517","1666","0","31.03","12.48"
"68","000","00","060","0004","0000","642","231","411","4","646","1612","0","40.07","14.33"
"68","000","00","060","0004","0568","642","231","411","4","646","1612","0","40.07","14.33"
"68","000","00","060","0005","0000","4571","2236","2335","34","4605","11610","0","39.66","19.26"
"68","000","00","060","0005","0569","478","192","286","3","481","1434","0","33.54","13.39"
"68","000","00","060","0005","0570","480","215","265","3","483","1352","0","35.72","15.90"
"68","000","00","060","0005","0571","520","259","261","5","525","1488","0","35.28","17.41"
"68","000","00","060","0005","0572","742","285","457","8","750","1630","0","46.01","17.48"
"68","000","00","060","0005","0573","664","347","317","4","668","1450","0","46.07","23.93"
"68","000","00","060","0005","0574","598","350","248","3","601","1462","0","41.11","23.94"
"68","000","00","060","0005","0575","592","342","250","3","595","1443","0","41.23","23.70"
"68","000","00","060","0005","0576","497","246","251","5","502","1351","0","37.16","18.21"
"68","000","00","060","0006","0000","1980","706","1274","18","1998","5222","0","38.26","13.52"
"68","000","00","060","0006","0577","598","187","411","8","606","1412","0","42.92","13.24"
"68","000","00","060","0006","0578","545","183","362","4","549","1417","0","38.74","12.91"
"68","000","00","060","0006","0579","514","181","333","5","519","1488","0","34.88","12.16"
"68","000","00","060","0006","0580","323","155","168","1","324","905","0","35.80","17.13"
"68","000","00","060","0007","0000","2154","910","1244","14","2168","5896","0","36.77","15.43"
"68","000","00","060","0007","0581","532","237","295","4","536","1496","0","35.83","15.84"
"68","000","00","060","0007","0582","508","238","270","1","509","1434","0","35.50","16.60"
"68","000","00","060","0007","0583","568","258","310","3","571","1555","0","36.72","16.59"
"68","000","00","060","0007","0584","546","177","369","6","552","1411","0","39.12","12.54"
"68","000","00","060","0008","0000","650","369","281","12","662","1650","0","40.12","22.36"
"68","000","00","060","0008","0585","650","369","281","12","662","1650","0","40.12","22.36"
"68","000","00","060","0010","0000","1206","501","705","9","1215","2851","0","42.62","17.57"
"68","000","00","060","0010","0586","546","209","337","4","550","1446","0","38.04","14.45"
"68","000","00","060","0010","0587","660","292","368","5","665","1405","0","47.33","20.78"
"68","000","00","060","0011","0000","2485","1137","1348","30","2515","7202","0","34.92","15.79"
"68","000","00","060","0011","0588","530","219","311","9","539","1454","0","37.07","15.06"
"68","000","00","060","0011","0589","511","219","292","8","519","1396","0","37.18","15.69"
"68","000","00","060","0011","0590","502","249","253","4","506","1531","0","33.05","16.26"
"68","000","00","060","0011","0591","513","256","257","5","518","1598","0","32.42","16.02"
"68","000","00","060","0011","0592","429","194","235","4","433","1223","0","35.40","15.86"
"68","000","00","060","0012","0000","1193","565","628","7","1200","3212","0","37.36","17.59"
"68","000","00","060","0012","0593","590","271","319","3","593","1638","0","36.20","16.54"
"68","000","00","060","0012","0594","603","294","309","4","607","1574","0","38.56","18.68"
"68","000","00","060","0013","0000","602","307","295","5","607","1863","0","32.58","16.48"
"68","000","00","060","0013","0595","314","158","156","2","316","904","0","34.96","17.48"
"68","000","00","060","0013","0596","288","149","139","3","291","959","0","30.34","15.54"
"68","000","00","060","0014","0000","878","413","465","10","888","2595","0","34.22","15.92"
"68","000","00","060","0014","0597","363","187","176","5","368","1174","0","31.35","15.93"
"68","000","00","060","0014","0598","515","226","289","5","520","1421","0","36.59","15.90"
"68","000","00","060","0015","0000","818","386","432","4","822","2523","0","32.58","15.30"
"68","000","00","060","0015","0599","440","198","242","1","441","1277","0","34.53","15.51"
"68","000","00","060","0015","0600","378","188","190","3","381","1246","0","30.58","15.09"
"68","000","00","060","0016","0000","949","398","551","5","954","2566","0","37.18","15.51"
"68","000","00","060","0016","0601","445","208","237","3","448","1224","0","36.60","16.99"
"68","000","00","060","0016","0602","504","190","314","2","506","1342","0","37.70","14.16"
"68","000","00","060","0017","0000","753","302","451","9","762","2154","0","35.38","14.02"
"68","000","00","060","0017","0603","389","154","235","4","393","1095","0","35.89","14.06"
"68","000","00","060","0017","0604","364","148","216","5","369","1059","0","34.84","13.98"
"68","000","00","060","0018","0000","957","366","591","13","970","2912","0","33.31","12.57"
"68","000","00","060","0018","0605","509","168","341","6","515","1343","0","38.35","12.51"
"68","000","00","060","0018","0606","448","198","250","7","455","1569","0","29.00","12.62"
"68","000","00","060","0019","0000","1734","846","888","12","1746","5701","0","30.63","14.84"
"68","000","00","060","0019","0607","443","213","230","3","446","1557","0","28.64","13.68"
"68","000","00","060","0019","0608","471","225","246","3","474","1587","0","29.87","14.18"
"68","000","00","060","0019","0609","508","242","266","4","512","1496","0","34.22","16.18"
"68","000","00","060","0019","0610","312","166","146","2","314","1061","0","29.59","15.65"
"68","000","00","070","0000","0000","54090","27573","26517","471","54561","138592","165716","39.37","19.90"
"68","000","00","070","0001","0000","1705","752","953","6","1711","3984","0","42.95","18.88"
"68","000","00","070","0001","0318","553","271","282","2","555","1269","0","43.74","21.36"
"68","000","00","070","0001","0319","493","174","319","2","495","1186","0","41.74","14.67"
"68","000","00","070","0001","0320","659","307","352","2","661","1529","0","43.23","20.08"
"68","000","00","070","0002","0000","2585","1286","1299","20","2605","6579","0","39.60","19.55"
"68","000","00","070","0002","0332","508","273","235","0","508","1129","0","45.00","24.18"
"68","000","00","070","0002","0333","521","262","259","7","528","1252","0","42.17","20.93"
"68","000","00","070","0002","0334","630","260","370","4","634","1480","0","42.84","17.57"
"68","000","00","070","0002","0335","454","259","195","4","458","1378","0","33.24","18.80"
"68","000","00","070","0002","0336","472","232","240","5","477","1340","0","35.60","17.31"
"68","000","00","070","0003","0000","1559","752","807","11","1570","4492","0","34.95","16.74"
"68","000","00","070","0003","0288","352","152","200","5","357","823","0","43.38","18.47"
"68","000","00","070","0003","0289","427","223","204","2","429","1282","0","33.46","17.39"
"68","000","00","070","0003","0290","374","194","180","1","375","1197","0","31.33","16.21"
"68","000","00","070","0003","0291","406","183","223","3","409","1190","0","34.37","15.38"
"68","000","00","070","0004","0000","2221","1107","1114","17","2238","5834","0","38.36","18.97"
"68","000","00","070","0004","0249","581","305","276","4","585","1562","0","37.45","19.53"
"68","000","00","070","0004","0250","570","284","286","5","575","1423","0","40.41","19.96"
"68","000","00","070","0004","0251","556","241","315","8","564","1645","0","34.29","14.65"
"68","000","00","070","0004","0252","514","277","237","0","514","1204","0","42.69","23.01"
"68","000","00","070","0005","0000","1264","589","675","17","1281","3262","0","39.27","18.06"
"68","000","00","070","0005","0270","731","339","392","7","738","1853","0","39.83","18.29"
"68","000","00","070","0005","0271","533","250","283","10","543","1409","0","38.54","17.74"
"68","000","00","070","0006","0000","1960","995","965","15","1975","5439","0","36.31","18.29"
"68","000","00","070","0006","0267","620","294","326","4","624","1732","0","36.03","16.97"
"68","000","00","070","0006","0268","615","295","320","7","622","1922","0","32.36","15.35"
"68","000","00","070","0006","0269","725","406","319","4","729","1785","0","40.84","22.75"
"68","000","00","070","0007","0000","1775","1537","238","26","1801","3606","0","49.94","42.62"
"68","000","00","070","0007","0305","895","781","114","12","907","1738","0","52.19","44.94"
"68","000","00","070","0007","0306","880","756","124","14","894","1868","0","47.86","40.47"
"68","000","00","070","0008","0000","2153","1439","714","30","2183","5179","0","42.15","27.79"
"68","000","00","070","0008","0323","784","667","117","10","794","1616","0","49.13","41.27"
"68","000","00","070","0008","0324","666","431","235","14","680","1717","0","39.60","25.10"
"68","000","00","070","0008","0325","703","341","362","6","709","1846","0","38.41","18.47"
"68","000","00","070","0009","0000","627","291","336","6","633","1298","0","48.77","22.42"
"68","000","00","070","0009","0278","627","291","336","6","633","1298","0","48.77","22.42"
"68","000","00","070","0010","0000","1926","889","1037","10","1936","5523","0","35.05","16.10"
"68","000","00","070","0010","0326","768","365","403","6","774","2261","0","34.23","16.14"
"68","000","00","070","0010","0327","514","226","288","2","516","1546","0","33.38","14.62"
"68","000","00","070","0010","0328","644","298","346","2","646","1716","0","37.65","17.37"
"68","000","00","070","0011","0000","791","325","466","9","800","1874","0","42.69","17.34"
"68","000","00","070","0011","0298","791","325","466","9","800","1874","0","42.69","17.34"
"68","000","00","070","0012","0000","729","300","429","3","732","1975","0","37.06","15.19"
"68","000","00","070","0012","0253","357","163","194","1","358","983","0","36.42","16.58"
"68","000","00","070","0012","0254","372","137","235","2","374","992","0","37.70","13.81"
"68","000","00","070","0013","0000","1798","898","900","14","1812","4708","0","38.49","19.07"
"68","000","00","070","0013","0275","551","319","232","6","557","1612","0","34.55","19.79"
"68","000","00","070","0013","0276","684","317","367","4","688","1651","0","41.67","19.20"
"68","000","00","070","0013","0277","563","262","301","4","567","1445","0","39.24","18.13"
"68","000","00","070","0014","0000","1978","931","1047","22","2000","4790","0","41.75","19.44"
"68","000","00","070","0014","0272","674","318","356","8","682","1651","0","41.31","19.26"
"68","000","00","070","0014","0273","630","288","342","8","638","1480","0","43.11","19.46"
"68","000","00","070","0014","0274","674","325","349","6","680","1659","0","40.99","19.59"
"68","000","00","070","0015","0000","2290","1093","1197","24","2314","5265","0","43.95","20.76"
"68","000","00","070","0015","0307","636","318","318","6","642","1449","0","44.31","21.95"
"68","000","00","070","0015","0308","460","202","258","9","469","1021","0","45.94","19.78"
"68","000","00","070","0015","0309","526","248","278","4","530","1403","0","37.78","17.68"
"68","000","00","070","0015","0310","668","325","343","5","673","1392","0","48.35","23.35"
"68","000","00","070","0016","0000","1513","684","829","13","1526","4034","0","37.83","16.96"
"68","000","00","070","0016","0337","477","200","277","4","481","1222","0","39.36","16.37"
"68","000","00","070","0016","0338","601","288","313","5","606","1491","0","40.64","19.32"
"68","000","00","070","0016","0339","435","196","239","4","439","1321","0","33.23","14.84"
"68","000","00","070","0017","0000","694","225","469","3","697","1760","0","39.60","12.78"
"68","000","00","070","0017","0331","694","225","469","3","697","1760","0","39.60","12.78"
"68","000","00","070","0018","0000","1146","558","588","15","1161","2636","0","44.04","21.17"
"68","000","00","070","0018","0340","713","405","308","10","723","1578","0","45.82","25.67"
"68","000","00","070","0018","0341","433","153","280","5","438","1058","0","41.40","14.46"
"68","000","00","070","0019","0000","1405","679","726","11","1416","4111","0","34.44","16.52"
"68","000","00","070","0019","0255","461","221","240","2","463","1378","0","33.60","16.04"
"68","000","00","070","0019","0256","543","246","297","3","546","1472","0","37.09","16.71"
"68","000","00","070","0019","0257","401","212","189","6","407","1261","0","32.28","16.81"
"68","000","00","070","0020","0000","2733","1364","1369","19","2752","6959","0","39.55","19.60"
"68","000","00","070","0020","0279","716","327","389","8","724","1788","0","40.49","18.29"
"68","000","00","070","0020","0280","672","338","334","3","675","1712","0","39.43","19.74"
"68","000","00","070","0020","0281","710","375","335","3","713","1734","0","41.12","21.63"
"68","000","00","070","0020","0282","635","324","311","5","640","1725","0","37.10","18.78"
"68","000","00","070","0021","0000","914","431","483","4","918","2303","0","39.86","18.71"
"68","000","00","070","0021","0299","418","175","243","0","418","1137","0","36.76","15.39"
"68","000","00","070","0021","0300","496","256","240","4","500","1166","0","42.88","21.96"
"68","000","00","070","0022","0000","1686","858","828","19","1705","5268","0","32.37","16.29"
"68","000","00","070","0022","0292","594","335","259","6","600","1794","0","33.44","18.67"
"68","000","00","070","0022","0293","501","234","267","7","508","1622","0","31.32","14.43"
"68","000","00","070","0022","0294","591","289","302","6","597","1852","0","32.24","15.60"
"68","000","00","070","0023","0000","783","398","385","8","791","1960","0","40.36","20.31"
"68","000","00","070","0023","0321","604","312","292","7","611","1459","0","41.88","21.38"
"68","000","00","070","0023","0322","179","86","93","1","180","501","0","35.93","17.17"
"68","000","00","070","0024","0000","1334","595","739","16","1350","3423","0","39.44","17.38"
"68","000","00","070","0024","0329","793","345","448","8","801","1893","0","42.31","18.23"
"68","000","00","070","0024","0330","541","250","291","8","549","1530","0","35.88","16.34"
"68","000","00","070","0025","0000","2349","1182","1167","25","2374","6098","0","38.93","19.38"
"68","000","00","070","0025","0301","756","350","406","12","768","1934","0","39.71","18.10"
"68","000","00","070","0025","0302","501","250","251","5","506","1362","0","37.15","18.36"
"68","000","00","070","0025","0303","537","289","248","1","538","1420","0","37.89","20.35"
"68","000","00","070","0025","0304","555","293","262","7","562","1382","0","40.67","21.20"
"68","000","00","070","0026","0000","1403","688","715","14","1417","3965","0","35.74","17.35"
"68","000","00","070","0026","0313","456","239","217","5","461","1201","0","38.38","19.90"
"68","000","00","070","0026","0314","342","187","155","5","347","987","0","35.16","18.95"
"68","000","00","070","0026","0315","605","262","343","4","609","1777","0","34.27","14.74"
"68","000","00","070","0027","0000","2040","1059","981","15","2055","5410","0","37.99","19.57"
"68","000","00","070","0027","0258","646","321","325","7","653","1690","0","38.64","18.99"
"68","000","00","070","0027","0259","689","354","335","3","692","1854","0","37.32","19.09"
"68","000","00","070","0027","0260","705","384","321","5","710","1866","0","38.05","20.58"
"68","000","00","070","0028","0000","3528","1767","1761","25","3553","8945","0","39.72","19.75"
"68","000","00","070","0028","0261","560","276","284","2","562","1485","0","37.85","18.59"
"68","000","00","070","0028","0262","567","267","300","3","570","1387","0","41.10","19.25"
"68","000","00","070","0028","0263","654","355","299","4","658","1533","0","42.92","23.16"
"68","000","00","070","0028","0264","682","326","356","7","689","1675","0","41.13","19.46"
"68","000","00","070","0028","0265","520","241","279","4","524","1402","0","37.38","17.19"
"68","000","00","070","0028","0266","545","302","243","5","550","1463","0","37.59","20.64"
"68","000","00","070","0029","0000","1769","828","941","10","1779","4161","0","42.75","19.90"
"68","000","00","070","0029","0295","552","265","287","7","559","1426","0","39.20","18.58"
"68","000","00","070","0029","0296","564","255","309","1","565","1412","0","40.01","18.06"
"68","000","00","070","0029","0297","653","308","345","2","655","1323","0","49.51","23.28"
"68","000","00","070","0030","0000","931","594","337","11","942","3071","0","30.67","19.34"
"68","000","00","070","0030","0311","693","485","208","10","703","1528","0","46.01","31.74"
"68","000","00","070","0030","0312","238","109","129","1","239","1543","0","15.49","7.06"
"68","000","00","070","0031","0000","3130","1753","1377","23","3153","7571","0","41.65","23.15"
"68","000","00","070","0031","0283","606","326","280","4","610","1352","0","45.12","24.11"
"68","000","00","070","0031","0284","771","412","359","7","778","1899","0","40.97","21.70"
"68","000","00","070","0031","0285","513","300","213","6","519","1304","0","39.80","23.01"
"68","000","00","070","0031","0286","539","329","210","3","542","1365","0","39.71","24.10"
"68","000","00","070","0031","0287","701","386","315","3","704","1651","0","42.64","23.38"
"68","000","00","070","0032","0000","1371","726","645","10","1381","3109","0","44.42","23.35"
"68","000","00","070","0032","0316","721","384","337","3","724","1633","0","44.34","23.52"
"68","000","00","070","0032","0317","650","342","308","7","657","1476","0","44.51","23.17"
"68","000","00","080","0000","0000","67659","36206","31453","663","68322","172627","209448","39.58","20.97"
"68","000","00","080","0001","0000","2932","1575","1357","28","2960","9275","0","31.91","16.98"
"68","000","00","080","0001","0342","569","342","227","3","572","1693","0","33.79","20.20"
"68","000","00","080","0001","0343","565","282","283","7","572","1744","0","32.80","16.17"
"68","000","00","080","0001","0344","557","297","260","9","566","1597","0","35.44","18.60"
"68","000","00","080","0001","0345","520","292","228","2","522","1434","0","36.40","20.36"
"68","000","00","080","0001","0346","524","275","249","6","530","1402","0","37.80","19.61"
"68","000","00","080","0001","0347","197","87","110","1","198","1405","0","14.09","6.19"
"68","000","00","080","0002","0000","3369","1782","1587","22","3391","9960","0","34.05","17.89"
"68","000","00","080","0002","0348","598","301","297","5","603","1932","0","31.21","15.58"
"68","000","00","080","0002","0349","612","343","269","2","614","1941","0","31.63","17.67"
"68","000","00","080","0002","0350","661","348","313","8","669","1605","0","41.68","21.68"
"68","000","00","080","0002","0351","458","248","210","4","462","1536","0","30.08","16.15"
"68","000","00","080","0002","0352","567","305","262","2","569","1475","0","38.58","20.68"
"68","000","00","080","0002","0353","473","237","236","1","474","1471","0","32.22","16.11"
"68","000","00","080","0003","0000","1670","938","732","8","1678","4926","0","34.06","19.04"
"68","000","00","080","0003","0354","575","309","266","5","580","1519","0","38.18","20.34"
"68","000","00","080","0003","0355","630","371","259","1","631","1832","0","34.44","20.25"
"68","000","00","080","0003","0356","465","258","207","2","467","1575","0","29.65","16.38"
"68","000","00","080","0004","0000","1321","775","546","33","1354","3178","0","42.61","24.39"
"68","000","00","080","0004","0362","654","369","285","14","668","1582","0","42.23","23.32"
"68","000","00","080","0004","0363","667","406","261","19","686","1596","0","42.98","25.44"
"68","000","00","080","0005","0000","1346","854","492","22","1368","3521","0","38.85","24.25"
"68","000","00","080","0005","0364","693","440","253","11","704","1668","0","42.21","26.38"
"68","000","00","080","0005","0365","653","414","239","11","664","1853","0","35.83","22.34"
"68","000","00","080","0006","0000","1303","880","423","18","1321","3201","0","41.27","27.49"
"68","000","00","080","0006","0366","654","439","215","16","670","1588","0","42.19","27.64"
"68","000","00","080","0006","0367","649","441","208","2","651","1613","0","40.36","27.34"
"68","000","00","080","0007","0000","1268","587","681","8","1276","3233","0","39.47","18.16"
"68","000","00","080","0007","0370","644","302","342","4","648","1665","0","38.92","18.14"
"68","000","00","080","0007","0371","624","285","339","4","628","1568","0","40.05","18.18"
"68","000","00","080","0008","0000","1946","1057","889","19","1965","4536","0","43.32","23.30"
"68","000","00","080","0008","0372","773","449","324","14","787","1740","0","45.23","25.80"
"68","000","00","080","0008","0373","735","395","340","4","739","1776","0","41.61","22.24"
"68","000","00","080","0008","0374","438","213","225","1","439","1020","0","43.04","20.88"
"68","000","00","080","0009","0000","1257","629","628","11","1268","3596","0","35.26","17.49"
"68","000","00","080","0009","0375","635","299","336","8","643","1809","0","35.54","16.53"
"68","000","00","080","0009","0376","622","330","292","3","625","1787","0","34.97","18.47"
"68","000","00","080","0010","0000","823","384","439","13","836","2214","0","37.76","17.34"
"68","000","00","080","0010","0377","385","200","185","8","393","1091","0","36.02","18.33"
"68","000","00","080","0010","0378","438","184","254","5","443","1123","0","39.45","16.38"
"68","000","00","080","0011","0000","923","404","519","8","931","2537","0","36.70","15.92"
"68","000","00","080","0011","0384","476","219","257","1","477","1336","0","35.70","16.39"
"68","000","00","080","0011","0385","447","185","262","7","454","1201","0","37.80","15.40"
"68","000","00","080","0012","0000","1489","705","784","15","1504","3852","0","39.04","18.30"
"68","000","00","080","0012","0388","575","261","314","4","579","1366","0","42.39","19.11"
"68","000","00","080","0012","0389","408","195","213","8","416","1183","0","35.16","16.48"
"68","000","00","080","0012","0390","506","249","257","3","509","1303","0","39.06","19.11"
"68","000","00","080","0013","0000","1261","576","685","18","1279","3101","0","41.24","18.57"
"68","000","00","080","0013","0393","759","339","420","10","769","1902","0","40.43","17.82"
"68","000","00","080","0013","0394","502","237","265","8","510","1199","0","42.54","19.77"
"68","000","00","080","0014","0000","1474","665","809","9","1483","3930","0","37.74","16.92"
"68","000","00","080","0014","0395","588","277","311","2","590","1408","0","41.90","19.67"
"68","000","00","080","0014","0396","469","196","273","3","472","1273","0","37.08","15.40"
"68","000","00","080","0014","0397","417","192","225","4","421","1249","0","33.71","15.37"
"68","000","00","080","0015","0000","1371","623","748","16","1387","3486","0","39.79","17.87"
"68","000","00","080","0015","0405","527","204","323","5","532","1348","0","39.47","15.13"
"68","000","00","080","0015","0406","388","193","195","5","393","1052","0","37.36","18.35"
"68","000","00","080","0015","0407","456","226","230","6","462","1086","0","42.54","20.81"
"68","000","00","080","0016","0000","1512","781","731","10","1522","3792","0","40.14","20.60"
"68","000","00","080","0016","0409","518","275","243","6","524","1312","0","39.94","20.96"
"68","000","00","080","0016","0410","573","256","317","4","577","1356","0","42.55","18.88"
"68","000","00","080","0016","0411","421","250","171","0","421","1124","0","37.46","22.24"
"68","000","00","080","0017","0000","3010","1848","1162","27","3037","7352","0","41.31","25.14"
"68","000","00","080","0017","0418","572","398","174","4","576","1557","0","36.99","25.56"
"68","000","00","080","0017","0419","614","361","253","3","617","1341","0","46.01","26.92"
"68","000","00","080","0017","0420","571","346","225","5","576","1505","0","38.27","22.99"
"68","000","00","080","0017","0421","666","436","230","8","674","1575","0","42.79","27.68"
"68","000","00","080","0017","0422","587","307","280","7","594","1374","0","43.23","22.34"
"68","000","00","080","0018","0000","664","294","370","1","665","1505","0","44.19","19.53"
"68","000","00","080","0018","0431","664","294","370","1","665","1505","0","44.19","19.53"
"68","000","00","080","0019","0000","1425","683","742","12","1437","3312","0","43.39","20.62"
"68","000","00","080","0019","0433","711","295","416","6","717","1634","0","43.88","18.05"
"68","000","00","080","0019","0434","714","388","326","6","720","1678","0","42.91","23.12"
"68","000","00","080","0020","0000","1450","821","629","16","1466","3738","0","39.22","21.96"
"68","000","00","080","0020","0435","435","271","164","7","442","1219","0","36.26","22.23"
"68","000","00","080","0020","0436","500","235","265","7","507","1235","0","41.05","19.03"
"68","000","00","080","0020","0437","515","315","200","2","517","1284","0","40.26","24.53"
"68","000","00","080","0021","0000","713","387","326","7","720","1789","0","40.25","21.63"
"68","000","00","080","0021","0438","713","387","326","7","720","1789","0","40.25","21.63"
"68","000","00","080","0022","0000","2324","1229","1095","12","2336","5181","0","45.09","23.72"
"68","000","00","080","0022","0448","892","523","369","4","896","1752","0","51.14","29.85"
"68","000","00","080","0022","0449","728","357","371","4","732","1769","0","41.38","20.18"
"68","000","00","080","0022","0450","704","349","355","4","708","1660","0","42.65","21.02"
"68","000","00","080","0023","0000","1691","838","853","11","1702","4113","0","41.38","20.37"
"68","000","00","080","0023","0453","513","224","289","3","516","1303","0","39.60","17.19"
"68","000","00","080","0023","0454","554","291","263","6","560","1385","0","40.43","21.01"
"68","000","00","080","0023","0455","624","323","301","2","626","1425","0","43.93","22.67"
"68","000","00","080","0024","0000","1274","703","571","25","1299","3515","0","36.96","20.00"
"68","000","00","080","0024","0425","471","224","247","8","479","1470","0","32.59","15.24"
"68","000","00","080","0024","0426","277","231","46","11","288","624","0","46.15","37.02"
"68","000","00","080","0024","0427","526","248","278","6","532","1421","0","37.44","17.45"
"68","000","00","080","0025","0000","1061","584","477","9","1070","2531","0","42.28","23.07"
"68","000","00","080","0025","0414","560","298","262","4","564","1213","0","46.50","24.57"
"68","000","00","080","0025","0415","501","286","215","5","506","1318","0","38.39","21.70"
"68","000","00","080","0026","0000","1747","821","926","17","1764","4188","0","42.12","19.60"
"68","000","00","080","0026","0400","554","239","315","4","558","1227","0","45.48","19.48"
"68","000","00","080","0026","0401","618","318","300","7","625","1611","0","38.80","19.74"
"68","000","00","080","0026","0402","575","264","311","6","581","1350","0","43.04","19.56"
"68","000","00","080","0027","0000","1795","1126","669","10","1805","4256","0","42.41","26.46"
"68","000","00","080","0027","0439","610","391","219","2","612","1442","0","42.44","27.12"
"68","000","00","080","0027","0440","537","324","213","2","539","1327","0","40.62","24.42"
"68","000","00","080","0027","0441","648","411","237","6","654","1487","0","43.98","27.64"
"68","000","00","080","0028","0000","1576","795","781","13","1589","4161","0","38.19","19.11"
"68","000","00","080","0028","0359","626","308","318","4","630","1601","0","39.35","19.24"
"68","000","00","080","0028","0360","504","236","268","2","506","1234","0","41.00","19.12"
"68","000","00","080","0028","0361","446","251","195","7","453","1326","0","34.16","18.93"
"68","000","00","080","0029","0000","1185","630","555","20","1205","2848","0","42.31","22.12"
"68","000","00","080","0029","0423","571","293","278","15","586","1371","0","42.74","21.37"
"68","000","00","080","0029","0424","614","337","277","5","619","1477","0","41.91","22.82"
"68","000","00","080","0030","0000","1630","890","740","14","1644","4290","0","38.32","20.75"
"68","000","00","080","0030","0445","617","324","293","4","621","1461","0","42.51","22.18"
"68","000","00","080","0030","0446","502","283","219","9","511","1413","0","36.16","20.03"
"68","000","00","080","0030","0447","511","283","228","1","512","1416","0","36.16","19.99"
"68","000","00","080","0031","0000","1342","574","768","8","1350","3074","0","43.92","18.67"
"68","000","00","080","0031","0451","683","262","421","4","687","1546","0","44.44","16.95"
"68","000","00","080","0031","0452","659","312","347","4","663","1528","0","43.39","20.42"
"68","000","00","080","0032","0000","808","356","452","8","816","2030","0","40.20","17.54"
"68","000","00","080","0032","0398","430","188","242","6","436","1003","0","43.47","18.74"
"68","000","00","080","0032","0399","378","168","210","2","380","1027","0","37.00","16.36"
"68","000","00","080","0033","0000","1456","676","780","15","1471","3632","0","40.50","18.61"
"68","000","00","080","0033","0403","731","332","399","7","738","1878","0","39.30","17.68"
"68","000","00","080","0033","0404","725","344","381","8","733","1754","0","41.79","19.61"
"68","000","00","080","0034","0000","606","245","361","4","610","1474","0","41.38","16.62"
"68","000","00","080","0034","0408","606","245","361","4","610","1474","0","41.38","16.62"
"68","000","00","080","0035","0000","556","265","291","6","562","1414","0","39.75","18.74"
"68","000","00","080","0035","0432","556","265","291","6","562","1414","0","39.75","18.74"
"68","000","00","080","0036","0000","840","479","361","13","853","2222","0","38.39","21.56"
"68","000","00","080","0036","0458","429","250","179","11","440","1090","0","40.37","22.94"
"68","000","00","080","0036","0459","411","229","182","2","413","1132","0","36.48","20.23"
"68","000","00","080","0037","0000","766","386","380","9","775","1947","0","39.80","19.83"
"68","000","00","080","0037","0456","426","226","200","7","433","984","0","44.00","22.97"
"68","000","00","080","0037","0457","340","160","180","2","342","963","0","35.51","16.61"
"68","000","00","080","0038","0000","1774","947","827","16","1790","4778","0","37.46","19.82"
"68","000","00","080","0038","0381","670","358","312","8","678","1862","0","36.41","19.23"
"68","000","00","080","0038","0382","579","298","281","8","587","1457","0","40.29","20.45"
"68","000","00","080","0038","0383","525","291","234","0","525","1459","0","35.98","19.95"
"68","000","00","080","0039","0000","1239","656","583","5","1244","3114","0","39.95","21.07"
"68","000","00","080","0039","0391","635","325","310","2","637","1491","0","42.72","21.80"
"68","000","00","080","0039","0392","604","331","273","3","607","1623","0","37.40","20.39"
"68","000","00","080","0040","0000","1125","515","610","8","1133","2788","0","40.64","18.47"
"68","000","00","080","0040","0357","605","256","349","2","607","1554","0","39.06","16.47"
"68","000","00","080","0040","0358","520","259","261","6","526","1234","0","42.63","20.99"
"68","000","00","080","0041","0000","1067","612","455","13","1080","2512","0","42.99","24.36"
"68","000","00","080","0041","0412","517","278","239","7","524","1195","0","43.85","23.26"
"68","000","00","080","0041","0413","550","334","216","6","556","1317","0","42.22","25.36"
"68","000","00","080","0042","0000","1789","1021","768","9","1798","4144","0","43.39","24.64"
"68","000","00","080","0042","0442","576","314","262","2","578","1313","0","44.02","23.91"
"68","000","00","080","0042","0443","650","364","286","3","653","1440","0","45.35","25.28"
"68","000","00","080","0042","0444","563","343","220","4","567","1391","0","40.76","24.66"
"68","000","00","080","0043","0000","1539","860","679","7","1546","3923","0","39.41","21.92"
"68","000","00","080","0043","0460","571","324","247","5","576","1412","0","40.79","22.95"
"68","000","00","080","0043","0461","479","270","209","1","480","1234","0","38.90","21.88"
"68","000","00","080","0043","0462","489","266","223","1","490","1277","0","38.37","20.83"
"68","000","00","080","0044","0000","1202","597","605","10","1212","2667","0","45.44","22.38"
"68","000","00","080","0044","0368","560","241","319","4","564","1302","0","43.32","18.51"
"68","000","00","080","0044","0369","642","356","286","6","648","1365","0","47.47","26.08"
"68","000","00","080","0045","0000","941","744","197","22","963","2166","0","44.46","34.35"
"68","000","00","080","0045","0379","460","369","91","15","475","1151","0","41.27","32.06"
"68","000","00","080","0045","0380","481","375","106","7","488","1015","0","48.08","36.95"
"68","000","00","080","0046","0000","1724","1368","356","37","1761","4338","0","40.59","31.54"
"68","000","00","080","0046","0428","593","455","138","10","603","1490","0","40.47","30.54"
"68","000","00","080","0046","0429","625","537","88","17","642","1550","0","41.42","34.65"
"68","000","00","080","0046","0430","506","376","130","10","516","1298","0","39.75","28.97"
"68","000","00","080","0047","0000","1062","498","564","14","1076","2762","0","38.96","18.03"
"68","000","00","080","0047","0386","506","239","267","9","515","1340","0","38.43","17.84"
"68","000","00","080","0047","0387","556","259","297","5","561","1422","0","39.45","18.21"
"68","000","00","080","0048","0000","1013","543","470","7","1020","2525","0","40.40","21.50"
"68","000","00","080","0048","0416","488","298","190","5","493","1152","0","42.80","25.87"
"68","000","00","080","0048","0417","525","245","280","2","527","1373","0","38.38","17.84"
"68","000","00","090","0000","0000","41214","24662","16552","355","41569","103835","124481","40.03","23.75"
"68","000","00","090","0001","0000","1696","966","730","8","1704","4655","0","36.61","20.75"
"68","000","00","090","0001","1161","597","321","276","2","599","1609","0","37.23","19.95"
"68","000","00","090","0001","1162","518","311","207","2","520","1528","0","34.03","20.35"
"68","000","00","090","0001","1163","581","334","247","4","585","1518","0","38.54","22.00"
"68","000","00","090","0002","0000","2293","1323","970","22","2315","5884","0","39.34","22.48"
"68","000","00","090","0002","1166","740","394","346","5","745","2241","0","33.24","17.58"
"68","000","00","090","0002","1167","420","258","162","2","422","990","0","42.63","26.06"
"68","000","00","090","0002","1168","431","221","210","3","434","1055","0","41.14","20.95"
"68","000","00","090","0002","1169","702","450","252","12","714","1598","0","44.68","28.16"
"68","000","00","090","0003","0000","1492","871","621","10","1502","4416","0","34.01","19.72"
"68","000","00","090","0003","1172","506","255","251","4","510","1476","0","34.55","17.28"
"68","000","00","090","0003","1173","496","301","195","5","501","1595","0","31.41","18.87"
"68","000","00","090","0003","1174","490","315","175","1","491","1345","0","36.51","23.42"
"68","000","00","090","0004","0000","1196","594","602","8","1204","3205","0","37.57","18.53"
"68","000","00","090","0004","1226","637","344","293","4","641","1634","0","39.23","21.05"
"68","000","00","090","0004","1227","559","250","309","4","563","1571","0","35.84","15.91"
"68","000","00","090","0006","0000","1323","751","572","11","1334","3744","0","35.63","20.06"
"68","000","00","090","0006","1178","483","263","220","3","486","1287","0","37.76","20.44"
"68","000","00","090","0006","1179","460","267","193","2","462","1312","0","35.21","20.35"
"68","000","00","090","0006","1180","380","221","159","6","386","1145","0","33.71","19.30"
"68","000","00","090","0007","0000","1580","866","714","9","1589","4226","0","37.60","20.49"
"68","000","00","090","0007","1183","567","291","276","3","570","1419","0","40.17","20.51"
"68","000","00","090","0007","1184","449","253","196","5","454","1307","0","34.74","19.36"
"68","000","00","090","0007","1185","564","322","242","1","565","1500","0","37.67","21.47"
"68","000","00","090","0008","0000","280","94","186","3","283","652","0","43.40","14.42"
"68","000","00","090","0008","1233","280","94","186","3","283","652","0","43.40","14.42"
"68","000","00","090","0009","0000","1721","939","782","6","1727","4406","0","39.20","21.31"
"68","000","00","090","0009","1188","601","300","301","3","604","1769","0","34.14","16.96"
"68","000","00","090","0009","1189","576","308","268","1","577","1335","0","43.22","23.07"
"68","000","00","090","0009","1190","544","331","213","2","546","1302","0","41.94","25.42"
"68","000","00","090","0010","0000","2152","1393","759","11","2163","5430","0","39.83","25.65"
"68","000","00","090","0010","1196","591","368","223","4","595","1390","0","42.81","26.47"
"68","000","00","090","0010","1197","533","344","189","3","536","1343","0","39.91","25.61"
"68","000","00","090","0010","1198","496","330","166","2","498","1340","0","37.16","24.63"
"68","000","00","090","0010","1199","532","351","181","2","534","1357","0","39.35","25.87"
"68","000","00","090","0011","0000","837","423","414","4","841","1835","0","45.83","23.05"
"68","000","00","090","0011","1191","414","211","203","2","416","909","0","45.76","23.21"
"68","000","00","090","0011","1192","423","212","211","2","425","926","0","45.90","22.89"
"68","000","00","090","0012","0000","1620","863","757","23","1643","4539","0","36.20","19.01"
"68","000","00","090","0012","1228","594","279","315","17","611","1583","0","38.60","17.62"
"68","000","00","090","0012","1229","474","234","240","3","477","1395","0","34.19","16.77"
"68","000","00","090","0012","1230","552","350","202","3","555","1561","0","35.55","22.42"
"68","000","00","090","0013","0000","1438","848","590","13","1451","3741","0","38.79","22.67"
"68","000","00","090","0013","1202","568","350","218","8","576","1337","0","43.08","26.18"
"68","000","00","090","0013","1203","445","259","186","4","449","1293","0","34.73","20.03"
"68","000","00","090","0013","1204","425","239","186","1","426","1111","0","38.34","21.51"
"68","000","00","090","0014","0000","1566","976","590","18","1584","4232","0","37.43","23.06"
"68","000","00","090","0014","1210","476","310","166","5","481","1259","0","38.20","24.62"
"68","000","00","090","0014","1211","539","344","195","8","547","1406","0","38.90","24.47"
"68","000","00","090","0014","1212","551","322","229","5","556","1567","0","35.48","20.55"
"68","000","00","090","0015","0000","1564","1066","498","19","1583","3420","0","46.29","31.17"
"68","000","00","090","0015","1215","771","472","299","8","779","1765","0","44.14","26.74"
"68","000","00","090","0015","1216","793","594","199","11","804","1655","0","48.58","35.89"
"68","000","00","090","0016","0000","1185","739","446","9","1194","2574","0","46.39","28.71"
"68","000","00","090","0016","1231","320","134","186","3","323","857","0","37.69","15.64"
"68","000","00","090","0016","1232","865","605","260","6","871","1717","0","50.73","35.24"
"68","000","00","090","0017","0000","606","275","331","8","614","1466","0","41.88","18.76"
"68","000","00","090","0017","1217","606","275","331","8","614","1466","0","41.88","18.76"
"68","000","00","090","0018","0000","1034","572","462","6","1040","2332","0","44.60","24.53"
"68","000","00","090","0018","1218","548","298","250","5","553","1270","0","43.54","23.46"
"68","000","00","090","0018","1219","486","274","212","1","487","1062","0","45.86","25.80"
"68","000","00","090","0019","0000","1448","931","517","12","1460","3072","0","47.53","30.31"
"68","000","00","090","0019","1220","686","413","273","6","692","1581","0","43.77","26.12"
"68","000","00","090","0019","1221","762","518","244","6","768","1491","0","51.51","34.74"
"68","000","00","090","0020","0000","1072","588","484","19","1091","2825","0","38.62","20.81"
"68","000","00","090","0020","1164","486","265","221","14","500","1359","0","36.79","19.50"
"68","000","00","090","0020","1165","586","323","263","5","591","1466","0","40.31","22.03"
"68","000","00","090","0021","0000","1010","522","488","9","1019","2613","0","39.00","19.98"
"68","000","00","090","0021","1170","444","225","219","6","450","1213","0","37.10","18.55"
"68","000","00","090","0021","1171","566","297","269","3","569","1400","0","40.64","21.21"
"68","000","00","090","0022","0000","1967","1401","566","12","1979","4262","0","46.43","32.87"
"68","000","00","090","0022","1175","691","495","196","7","698","1532","0","45.56","32.31"
"68","000","00","090","0022","1176","698","478","220","4","702","1564","0","44.88","30.56"
"68","000","00","090","0022","1177","578","428","150","1","579","1166","0","49.66","36.71"
"68","000","00","090","0023","0000","1278","781","497","14","1292","3487","0","37.05","22.40"
"68","000","00","090","0023","1181","649","384","265","6","655","1677","0","39.06","22.90"
"68","000","00","090","0023","1182","629","397","232","8","637","1810","0","35.19","21.93"
"68","000","00","090","0024","0000","1139","582","557","6","1145","2995","0","38.23","19.43"
"68","000","00","090","0024","1186","528","246","282","2","530","1344","0","39.43","18.30"
"68","000","00","090","0024","1187","611","336","275","4","615","1651","0","37.25","20.35"
"68","000","00","090","0025","0000","1827","1075","752","24","1851","4094","0","45.21","26.26"
"68","000","00","090","0025","1193","668","405","263","12","680","1424","0","47.75","28.44"
"68","000","00","090","0025","1194","455","241","214","5","460","1033","0","44.53","23.33"
"68","000","00","090","0025","1195","704","429","275","7","711","1637","0","43.43","26.21"
"68","000","00","090","0026","0000","1387","912","475","12","1399","3238","0","43.21","28.17"
"68","000","00","090","0026","1200","740","449","291","7","747","1719","0","43.46","26.12"
"68","000","00","090","0026","1201","647","463","184","5","652","1519","0","42.92","30.48"
"68","000","00","090","0027","0000","552","340","212","10","562","1491","0","37.69","22.80"
"68","000","00","090","0027","1205","552","340","212","10","562","1491","0","37.69","22.80"
"68","000","00","090","0028","0000","1471","1021","450","14","1485","3992","0","37.20","25.58"
"68","000","00","090","0028","1207","413","309","104","9","422","1322","0","31.92","23.37"
"68","000","00","090","0028","1208","462","319","143","4","466","1325","0","35.17","24.08"
"68","000","00","090","0028","1209","596","393","203","1","597","1345","0","44.39","29.22"
"68","000","00","090","0029","0000","772","485","287","9","781","2314","0","33.75","20.96"
"68","000","00","090","0029","1213","408","234","174","7","415","1280","0","32.42","18.28"
"68","000","00","090","0029","1214","364","251","113","2","366","1034","0","35.40","24.27"
"68","000","00","090","0030","0000","1783","1255","528","10","1793","3664","0","48.94","34.25"
"68","000","00","090","0030","1222","869","626","243","4","873","1832","0","47.65","34.17"
"68","000","00","090","0030","1223","914","629","285","6","920","1832","0","50.22","34.33"
"68","000","00","090","0031","0000","1442","977","465","11","1453","3448","0","42.14","28.34"
"68","000","00","090","0031","1224","722","490","232","4","726","1776","0","40.88","27.59"
"68","000","00","090","0031","1225","720","487","233","7","727","1672","0","43.48","29.13"
"68","000","00","090","0032","0000","483","233","250","5","488","1583","0","30.83","14.72"
"68","000","00","090","0032","1206","483","233","250","5","488","1583","0","30.83","14.72"
"68","000","00","100","0000","0000","76263","42682","33581","645","76908","187597","228672","41.00","22.75"
"68","000","00","100","0001","0000","1808","968","840","16","1824","4741","0","38.47","20.42"
"68","000","00","100","0001","0996","681","376","305","5","686","1721","0","39.86","21.85"
"68","000","00","100","0001","0997","570","296","274","5","575","1592","0","36.12","18.59"
"68","000","00","100","0001","0998","557","296","261","6","563","1428","0","39.43","20.73"
"68","000","00","100","0002","0000","1901","910","991","18","1919","4288","0","44.75","21.22"
"68","000","00","100","0002","0999","711","309","402","4","715","1682","0","42.51","18.37"
"68","000","00","100","0002","1000","537","235","302","9","546","1318","0","41.43","17.83"
"68","000","00","100","0002","1001","653","366","287","5","658","1288","0","51.09","28.42"
"68","000","00","100","0003","0000","2291","1366","925","11","2302","5412","0","42.54","25.24"
"68","000","00","100","0003","0981","575","351","224","2","577","1290","0","44.73","27.21"
"68","000","00","100","0003","0982","559","339","220","3","562","1357","0","41.41","24.98"
"68","000","00","100","0003","0983","579","331","248","3","582","1407","0","41.36","23.53"
"68","000","00","100","0003","0984","578","345","233","3","581","1358","0","42.78","25.41"
"68","000","00","100","0004","0000","2515","1344","1171","16","2531","5467","0","46.30","24.58"
"68","000","00","100","0004","0971","596","251","345","2","598","1293","0","46.25","19.41"
"68","000","00","100","0004","0972","583","319","264","3","586","1283","0","45.67","24.86"
"68","000","00","100","0004","0973","703","433","270","1","704","1411","0","49.89","30.69"
"68","000","00","100","0004","0974","633","341","292","10","643","1480","0","43.45","23.04"
"68","000","00","100","0005","0000","2054","1165","889","13","2067","5228","0","39.54","22.28"
"68","000","00","100","0005","0988","590","322","268","4","594","1353","0","43.90","23.80"
"68","000","00","100","0005","0989","567","321","246","2","569","1292","0","44.04","24.85"
"68","000","00","100","0005","0990","479","271","208","5","484","1303","0","37.15","20.80"
"68","000","00","100","0005","0991","418","251","167","2","420","1280","0","32.81","19.61"
"68","000","00","100","0006","0000","1670","893","777","15","1685","4332","0","38.90","20.61"
"68","000","00","100","0006","0964","587","306","281","6","593","1437","0","41.27","21.29"
"68","000","00","100","0006","0965","575","293","282","6","581","1466","0","39.63","19.99"
"68","000","00","100","0006","0966","508","294","214","3","511","1429","0","35.76","20.57"
"68","000","00","100","0007","0000","1581","833","748","14","1595","3659","0","43.59","22.77"
"68","000","00","100","0007","1007","464","250","214","3","467","1123","0","41.59","22.26"
"68","000","00","100","0007","1008","547","258","289","5","552","1253","0","44.05","20.59"
"68","000","00","100","0007","1009","570","325","245","6","576","1283","0","44.89","25.33"
"68","000","00","100","0008","0000","2371","1360","1011","19","2390","6520","0","36.66","20.86"
"68","000","00","100","0008","1015","456","258","198","4","460","2312","0","19.90","11.16"
"68","000","00","100","0008","1016","474","261","213","6","480","974","0","49.28","26.80"
"68","000","00","100","0008","1017","749","444","305","6","755","1569","0","48.12","28.30"
"68","000","00","100","0008","1018","692","397","295","3","695","1665","0","41.74","23.84"
"68","000","00","100","0009","0000","1162","595","567","8","1170","2424","0","48.27","24.55"
"68","000","00","100","0009","1002","594","291","303","2","596","1217","0","48.97","23.91"
"68","000","00","100","0009","1003","568","304","264","6","574","1207","0","47.56","25.19"
"68","000","00","100","0010","0000","1576","803","773","12","1588","3911","0","40.60","20.53"
"68","000","00","100","0010","1024","444","208","236","4","448","989","0","45.30","21.03"
"68","000","00","100","0010","1025","579","286","293","6","585","1454","0","40.23","19.67"
"68","000","00","100","0010","1026","553","309","244","2","555","1468","0","37.81","21.05"
"68","000","00","100","0011","0000","1703","883","820","10","1713","3974","0","43.11","22.22"
"68","000","00","100","0011","1029","588","270","318","5","593","1436","0","41.30","18.80"
"68","000","00","100","0011","1030","579","279","300","2","581","1386","0","41.92","20.13"
"68","000","00","100","0011","1031","536","334","202","3","539","1152","0","46.79","28.99"
"68","000","00","100","0012","0000","1671","851","820","17","1688","4457","0","37.87","19.09"
"68","000","00","100","0012","0928","503","236","267","3","506","1464","0","34.56","16.12"
"68","000","00","100","0012","0929","629","305","324","7","636","1551","0","41.01","19.66"
"68","000","00","100","0012","0930","539","310","229","7","546","1442","0","37.86","21.50"
"68","000","00","100","0013","0000","2263","1217","1046","16","2279","5771","0","39.49","21.09"
"68","000","00","100","0013","0933","611","320","291","1","612","1562","0","39.18","20.49"
"68","000","00","100","0013","0934","568","324","244","3","571","1364","0","41.86","23.75"
"68","000","00","100","0013","0935","580","306","274","8","588","1441","0","40.80","21.24"
"68","000","00","100","0013","0936","504","267","237","4","508","1404","0","36.18","19.02"
"68","000","00","100","0014","0000","1894","1187","707","29","1923","4674","0","41.14","25.40"
"68","000","00","100","0014","0956","477","296","181","7","484","1232","0","39.29","24.03"
"68","000","00","100","0014","0957","472","292","180","6","478","1183","0","40.41","24.68"
"68","000","00","100","0014","0958","404","296","108","11","415","1001","0","41.46","29.57"
"68","000","00","100","0014","0959","541","303","238","5","546","1258","0","43.40","24.09"
"68","000","00","100","0015","0000","908","569","339","7","915","2330","0","39.27","24.42"
"68","000","00","100","0015","0948","421","264","157","1","422","1134","0","37.21","23.28"
"68","000","00","100","0015","0949","487","305","182","6","493","1196","0","41.22","25.50"
"68","000","00","100","0016","0000","2113","1198","915","23","2136","5189","0","41.16","23.09"
"68","000","00","100","0016","0952","493","262","231","7","500","1328","0","37.65","19.73"
"68","000","00","100","0016","0953","515","294","221","8","523","1293","0","40.45","22.74"
"68","000","00","100","0016","0954","550","336","214","4","554","1304","0","42.48","25.77"
"68","000","00","100","0016","0955","555","306","249","4","559","1264","0","44.22","24.21"
"68","000","00","100","0017","0000","1116","726","390","13","1129","2791","0","40.45","26.01"
"68","000","00","100","0017","1050","526","343","183","10","536","1344","0","39.88","25.52"
"68","000","00","100","0017","1051","590","383","207","3","593","1447","0","40.98","26.47"
"68","000","00","100","0018","0000","1306","860","446","10","1316","3322","0","39.61","25.89"
"68","000","00","100","0018","1052","689","429","260","5","694","1699","0","40.85","25.25"
"68","000","00","100","0018","1053","617","431","186","5","622","1623","0","38.32","26.56"
"68","000","00","100","0019","0000","1069","787","282","13","1082","2548","0","42.46","30.89"
"68","000","00","100","0019","1057","453","322","131","3","456","1119","0","40.75","28.78"
"68","000","00","100","0019","1058","616","465","151","10","626","1429","0","43.81","32.54"
"68","000","00","100","0020","0000","921","625","296","7","928","1945","0","47.71","32.13"
"68","000","00","100","0020","1055","512","354","158","1","513","1087","0","47.19","32.57"
"68","000","00","100","0020","1056","409","271","138","6","415","858","0","48.37","31.59"
"68","000","00","100","0021","0000","602","438","164","3","605","1318","0","45.90","33.23"
"68","000","00","100","0021","1054","602","438","164","3","605","1318","0","45.90","33.23"
"68","000","00","100","0022","0000","701","542","159","12","713","1650","0","43.21","32.85"
"68","000","00","100","0022","1059","701","542","159","12","713","1650","0","43.21","32.85"
"68","000","00","100","0023","0000","1720","892","828","17","1737","4292","0","40.47","20.78"
"68","000","00","100","0023","1035","567","245","322","4","571","1260","0","45.32","19.44"
"68","000","00","100","0023","1036","642","373","269","7","649","1632","0","39.77","22.86"
"68","000","00","100","0023","1037","511","274","237","6","517","1400","0","36.93","19.57"
"68","000","00","100","0024","0000","2059","973","1086","15","2074","5410","0","38.34","17.99"
"68","000","00","100","0024","1046","408","148","260","2","410","1095","0","37.44","13.52"
"68","000","00","100","0024","1047","607","298","309","6","613","1440","0","42.57","20.69"
"68","000","00","100","0024","1048","522","215","307","4","526","1327","0","39.64","16.20"
"68","000","00","100","0024","1049","522","312","210","3","525","1548","0","33.91","20.16"
"68","000","00","100","0025","0000","1015","670","345","8","1023","2812","0","36.38","23.83"
"68","000","00","100","0025","1041","515","337","178","5","520","1377","0","37.76","24.47"
"68","000","00","100","0025","1042","500","333","167","3","503","1435","0","35.05","23.21"
"68","000","00","100","0026","0000","1592","956","636","24","1616","4358","0","37.08","21.94"
"68","000","00","100","0026","1043","539","328","211","7","546","1522","0","35.87","21.55"
"68","000","00","100","0026","1044","522","303","219","9","531","1471","0","36.10","20.60"
"68","000","00","100","0026","1045","531","325","206","8","539","1365","0","39.49","23.81"
"68","000","00","100","0027","0000","1205","575","630","10","1215","3084","0","39.40","18.64"
"68","000","00","100","0027","0931","559","243","316","6","565","1378","0","41.00","17.63"
"68","000","00","100","0027","0932","646","332","314","4","650","1706","0","38.10","19.46"
"68","000","00","100","0028","0000","2959","1531","1428","16","2975","6850","0","43.43","22.35"
"68","000","00","100","0028","0992","837","421","416","7","844","1785","0","47.28","23.59"
"68","000","00","100","0028","0993","709","346","363","1","710","1619","0","43.85","21.37"
"68","000","00","100","0028","0994","711","364","347","4","715","1672","0","42.76","21.77"
"68","000","00","100","0028","0995","702","400","302","4","706","1774","0","39.80","22.55"
"68","000","00","100","0029","0000","712","392","320","8","720","1755","0","41.03","22.34"
"68","000","00","100","0029","0960","712","392","320","8","720","1755","0","41.03","22.34"
"68","000","00","100","0030","0000","1545","910","635","11","1556","4511","0","34.49","20.17"
"68","000","00","100","0030","0961","570","328","242","2","572","1675","0","34.15","19.58"
"68","000","00","100","0030","0962","505","293","212","7","512","1408","0","36.36","20.81"
"68","000","00","100","0030","0963","470","289","181","2","472","1428","0","33.05","20.24"
"68","000","00","100","0031","0000","1701","841","860","17","1718","3871","0","44.38","21.73"
"68","000","00","100","0031","0975","628","324","304","3","631","1378","0","45.79","23.51"
"68","000","00","100","0031","0976","528","261","267","7","535","1241","0","43.11","21.03"
"68","000","00","100","0031","0977","545","256","289","7","552","1252","0","44.09","20.45"
"68","000","00","100","0032","0000","1439","757","682","10","1449","3429","0","42.26","22.08"
"68","000","00","100","0032","0950","683","323","360","5","688","1650","0","41.70","19.58"
"68","000","00","100","0032","0951","756","434","322","5","761","1779","0","42.78","24.40"
"68","000","00","100","0033","0000","2440","1416","1024","19","2459","6586","0","37.34","21.50"
"68","000","00","100","0033","0937","724","431","293","4","728","1825","0","39.89","23.62"
"68","000","00","100","0033","0938","528","319","209","5","533","1782","0","29.91","17.90"
"68","000","00","100","0033","0939","630","347","283","5","635","1470","0","43.20","23.61"
"68","000","00","100","0033","0940","558","319","239","5","563","1509","0","37.31","21.14"
"68","000","00","100","0034","0000","1533","813","720","8","1541","4222","0","36.50","19.26"
"68","000","00","100","0034","0978","582","302","280","5","587","1459","0","40.23","20.70"
"68","000","00","100","0034","0979","513","284","229","2","515","1402","0","36.73","20.26"
"68","000","00","100","0034","0980","438","227","211","1","439","1361","0","32.26","16.68"
"68","000","00","100","0035","0000","1365","684","681","15","1380","3064","0","45.04","22.32"
"68","000","00","100","0035","1022","664","333","331","5","669","1531","0","43.70","21.75"
"68","000","00","100","0035","1023","701","351","350","10","711","1533","0","46.38","22.90"
"68","000","00","100","0036","0000","1667","860","807","15","1682","3878","0","43.37","22.18"
"68","000","00","100","0036","1032","552","340","212","4","556","1375","0","40.44","24.73"
"68","000","00","100","0036","1033","561","266","295","6","567","1257","0","45.11","21.16"
"68","000","00","100","0036","1034","554","254","300","5","559","1246","0","44.86","20.39"
"68","000","00","100","0037","0000","2251","1239","1012","17","2268","5110","0","44.38","24.25"
"68","000","00","100","0037","1012","794","396","398","7","801","1719","0","46.60","23.04"
"68","000","00","100","0037","1013","805","478","327","4","809","1764","0","45.86","27.10"
"68","000","00","100","0037","1014","652","365","287","6","658","1627","0","40.44","22.43"
"68","000","00","100","0038","0000","1516","995","521","20","1536","4282","0","35.87","23.24"
"68","000","00","100","0038","1038","504","333","171","9","513","1393","0","36.83","23.91"
"68","000","00","100","0038","1039","552","356","196","3","555","1337","0","41.51","26.63"
"68","000","00","100","0038","1040","460","306","154","8","468","1552","0","30.15","19.72"
"68","000","00","100","0039","0000","1265","724","541","10","1275","2823","0","45.16","25.65"
"68","000","00","100","0039","1027","599","334","265","3","602","1345","0","44.76","24.83"
"68","000","00","100","0039","1028","666","390","276","7","673","1478","0","45.53","26.39"
"68","000","00","100","0040","0000","733","350","383","3","736","1551","0","47.45","22.57"
"68","000","00","100","0040","1010","343","168","175","0","343","739","0","46.41","22.73"
"68","000","00","100","0040","1011","390","182","208","3","393","812","0","48.40","22.41"
"68","000","00","100","0041","0000","1728","1032","696","8","1736","3758","0","46.19","27.46"
"68","000","00","100","0041","1004","589","360","229","4","593","1271","0","46.66","28.32"
"68","000","00","100","0041","1005","642","364","278","2","644","1376","0","46.80","26.45"
"68","000","00","100","0041","1006","497","308","189","2","499","1111","0","44.91","27.72"
"68","000","00","100","0042","0000","2191","1174","1017","26","2217","4904","0","45.21","23.94"
"68","000","00","100","0042","0985","773","396","377","9","782","1789","0","43.71","22.14"
"68","000","00","100","0042","0986","633","353","280","7","640","1442","0","44.38","24.48"
"68","000","00","100","0042","0987","785","425","360","10","795","1673","0","47.52","25.40"
"68","000","00","100","0043","0000","2185","1252","933","12","2197","5498","0","39.96","22.77"
"68","000","00","100","0043","0967","533","326","207","5","538","1345","0","40.00","24.24"
"68","000","00","100","0043","0968","593","339","254","4","597","1408","0","42.40","24.08"
"68","000","00","100","0043","0969","522","292","230","1","523","1392","0","37.57","20.98"
"68","000","00","100","0043","0970","537","295","242","2","539","1353","0","39.84","21.80"
"68","000","00","100","0044","0000","1600","997","603","12","1612","3806","0","42.35","26.20"
"68","000","00","100","0044","1019","484","307","177","0","484","1199","0","40.37","25.60"
"68","000","00","100","0044","1020","510","313","197","4","514","1209","0","42.51","25.89"
"68","000","00","100","0044","1021","606","377","229","8","614","1398","0","43.92","26.97"
"68","000","00","100","0045","0000","2027","1069","958","20","2047","5085","0","40.26","21.02"
"68","000","00","100","0045","0941","690","321","369","7","697","1842","0","37.84","17.43"
"68","000","00","100","0045","0942","578","314","264","9","587","1436","0","40.88","21.87"
"68","000","00","100","0045","0943","759","434","325","4","763","1807","0","42.22","24.02"
"68","000","00","100","0046","0000","2619","1460","1159","22","2641","6707","0","39.38","21.77"
"68","000","00","100","0046","0944","650","328","322","2","652","1806","0","36.10","18.16"
"68","000","00","100","0046","0945","634","348","286","9","643","1652","0","38.92","21.07"
"68","000","00","100","0046","0946","666","394","272","4","670","1524","0","43.96","25.85"
"68","000","00","100","0046","0947","669","390","279","7","676","1725","0","39.19","22.61"
"68","000","00","110","0000","0000","16078","7715","8363","151","16229","42036","49237","38.61","18.35"
"68","000","00","110","0001","0000","1142","585","557","6","1148","2883","0","39.82","20.29"
"68","000","00","110","0001","1234","595","316","279","4","599","1446","0","41.42","21.85"
"68","000","00","110","0001","1235","547","269","278","2","549","1437","0","38.20","18.72"
"68","000","00","110","0002","0000","1561","845","716","10","1571","3991","0","39.36","21.17"
"68","000","00","110","0002","1236","499","267","232","2","501","1337","0","37.47","19.97"
"68","000","00","110","0002","1237","486","259","227","3","489","1263","0","38.72","20.51"
"68","000","00","110","0002","1238","576","319","257","5","581","1391","0","41.77","22.93"
"68","000","00","110","0003","0000","538","252","286","5","543","1517","0","35.79","16.61"
"68","000","00","110","0003","1239","538","252","286","5","543","1517","0","35.79","16.61"
"68","000","00","110","0004","0000","1454","748","706","6","1460","4096","0","35.64","18.26"
"68","000","00","110","0004","1240","534","265","269","3","537","1368","0","39.25","19.37"
"68","000","00","110","0004","1241","482","260","222","1","483","1341","0","36.02","19.39"
"68","000","00","110","0004","1242","438","223","215","2","440","1387","0","31.72","16.08"
"68","000","00","110","0005","0000","1722","843","879","14","1736","4467","0","38.86","18.87"
"68","000","00","110","0005","1251","558","300","258","4","562","1581","0","35.55","18.98"
"68","000","00","110","0005","1252","606","297","309","6","612","1424","0","42.98","20.86"
"68","000","00","110","0005","1253","558","246","312","4","562","1462","0","38.44","16.83"
"68","000","00","110","0006","0000","887","444","443","4","891","2563","0","34.76","17.32"
"68","000","00","110","0006","1247","444","219","225","3","447","1263","0","35.39","17.34"
"68","000","00","110","0006","1248","443","225","218","1","444","1300","0","34.15","17.31"
"68","000","00","110","0007","0000","888","390","498","11","899","2292","0","39.22","17.02"
"68","000","00","110","0007","1249","510","249","261","3","513","1252","0","40.97","19.89"
"68","000","00","110","0007","1250","378","141","237","8","386","1040","0","37.12","13.56"
"68","000","00","110","0008","0000","534","225","309","6","540","1356","0","39.82","16.59"
"68","000","00","110","0008","1246","534","225","309","6","540","1356","0","39.82","16.59"
"68","000","00","110","0009","0000","566","265","301","11","577","1466","0","39.36","18.08"
"68","000","00","110","0009","1245","566","265","301","11","577","1466","0","39.36","18.08"
"68","000","00","110","0010","0000","809","339","470","16","825","2076","0","39.74","16.33"
"68","000","00","110","0010","1243","385","164","221","8","393","979","0","40.14","16.75"
"68","000","00","110","0010","1244","424","175","249","8","432","1097","0","39.38","15.95"
"68","000","00","110","0011","0000","310","148","162","0","310","730","0","42.47","20.27"
"68","000","00","110","0011","1264","310","148","162","0","310","730","0","42.47","20.27"
"68","000","00","110","0012","0000","628","301","327","8","636","1727","0","36.83","17.43"
"68","000","00","110","0012","1266","628","301","327","8","636","1727","0","36.83","17.43"
"68","000","00","110","0013","0000","384","205","179","4","388","926","0","41.90","22.14"
"68","000","00","110","0013","1265","384","205","179","4","388","926","0","41.90","22.14"
"68","000","00","110","0014","0000","493","243","250","7","500","1310","0","38.17","18.55"
"68","000","00","110","0014","1267","493","243","250","7","500","1310","0","38.17","18.55"
"68","000","00","110","0015","0000","417","186","231","5","422","1021","0","41.33","18.22"
"68","000","00","110","0015","1263","417","186","231","5","422","1021","0","41.33","18.22"
"68","000","00","110","0016","0000","900","426","474","10","910","2201","0","41.34","19.35"
"68","000","00","110","0016","1261","420","204","216","4","424","1015","0","41.77","20.10"
"68","000","00","110","0016","1262","480","222","258","6","486","1186","0","40.98","18.72"
"68","000","00","110","0017","0000","409","212","197","8","417","1020","0","40.88","20.78"
"68","000","00","110","0017","1260","409","212","197","8","417","1020","0","40.88","20.78"
"68","000","00","110","0018","0000","244","119","125","1","245","639","0","38.34","18.62"
"68","000","00","110","0018","1258","244","119","125","1","245","639","0","38.34","18.62"
"68","000","00","110","0019","0000","335","119","216","3","338","900","0","37.56","13.22"
"68","000","00","110","0019","1257","335","119","216","3","338","900","0","37.56","13.22"
"68","000","00","110","0020","0000","411","183","228","8","419","1072","0","39.09","17.07"
"68","000","00","110","0020","1259","411","183","228","8","419","1072","0","39.09","17.07"
"68","000","00","110","0021","0000","452","232","220","3","455","1098","0","41.44","21.13"
"68","000","00","110","0021","1256","452","232","220","3","455","1098","0","41.44","21.13"
"68","000","00","110","0022","0000","478","194","284","3","481","1294","0","37.17","14.99"
"68","000","00","110","0022","1254","478","194","284","3","481","1294","0","37.17","14.99"
"68","000","00","110","0023","0000","516","211","305","2","518","1391","0","37.24","15.17"
"68","000","00","110","0023","1255","516","211","305","2","518","1391","0","37.24","15.17"
"68","000","00","120","0000","0000","21123","9048","12075","193","21316","57793","69326","36.88","15.66"
"68","000","00","120","0001","0000","993","462","531","10","1003","2767","0","36.25","16.70"
"68","000","00","120","0001","1268","529","253","276","5","534","1359","0","39.29","18.62"
"68","000","00","120","0001","1269","464","209","255","5","469","1408","0","33.31","14.84"
"68","000","00","120","0002","0000","373","185","188","2","375","875","0","42.86","21.14"
"68","000","00","120","0002","1270","373","185","188","2","375","875","0","42.86","21.14"
"68","000","00","120","0003","0000","481","224","257","10","491","1310","0","37.48","17.10"
"68","000","00","120","0003","1271","481","224","257","10","491","1310","0","37.48","17.10"
"68","000","00","120","0004","0000","801","317","484","11","812","1899","0","42.76","16.69"
"68","000","00","120","0004","1272","801","317","484","11","812","1899","0","42.76","16.69"
"68","000","00","120","0005","0000","377","165","212","3","380","912","0","41.67","18.09"
"68","000","00","120","0005","1275","377","165","212","3","380","912","0","41.67","18.09"
"68","000","00","120","0006","0000","813","345","468","9","822","2180","0","37.71","15.83"
"68","000","00","120","0006","1273","456","189","267","2","458","1329","0","34.46","14.22"
"68","000","00","120","0006","1274","357","156","201","7","364","851","0","42.77","18.33"
"68","000","00","120","0007","0000","371","182","189","4","375","854","0","43.91","21.31"
"68","000","00","120","0007","1276","371","182","189","4","375","854","0","43.91","21.31"
"68","000","00","120","0008","0000","297","136","161","3","300","705","0","42.55","19.29"
"68","000","00","120","0008","1277","297","136","161","3","300","705","0","42.55","19.29"
"68","000","00","120","0009","0000","604","262","342","7","611","1831","0","33.37","14.31"
"68","000","00","120","0009","1278","604","262","342","7","611","1831","0","33.37","14.31"
"68","000","00","120","0010","0000","927","392","535","8","935","2633","0","35.51","14.89"
"68","000","00","120","0010","1279","457","193","264","5","462","1278","0","36.15","15.10"
"68","000","00","120","0010","1280","470","199","271","3","473","1355","0","34.91","14.69"
"68","000","00","120","0011","0000","1049","432","617","3","1052","2621","0","40.14","16.48"
"68","000","00","120","0011","1281","516","237","279","1","517","1329","0","38.90","17.83"
"68","000","00","120","0011","1282","533","195","338","2","535","1292","0","41.41","15.09"
"68","000","00","120","0012","0000","1199","446","753","10","1209","3116","0","38.80","14.31"
"68","000","00","120","0012","1283","618","215","403","8","626","1534","0","40.81","14.02"
"68","000","00","120","0012","1284","581","231","350","2","583","1582","0","36.85","14.60"
"68","000","00","120","0013","0000","544","195","349","4","548","1484","0","36.93","13.14"
"68","000","00","120","0013","1285","544","195","349","4","548","1484","0","36.93","13.14"
"68","000","00","120","0014","0000","1920","866","1054","7","1927","4757","0","40.51","18.20"
"68","000","00","120","0014","1286","463","152","311","0","463","1123","0","41.23","13.54"
"68","000","00","120","0014","1287","470","302","168","2","472","1105","0","42.71","27.33"
"68","000","00","120","0014","1288","526","205","321","1","527","1228","0","42.92","16.69"
"68","000","00","120","0014","1289","461","207","254","4","465","1301","0","35.74","15.91"
"68","000","00","120","0015","0000","1483","729","754","9","1492","3918","0","38.08","18.61"
"68","000","00","120","0015","1290","474","217","257","2","476","1271","0","37.45","17.07"
"68","000","00","120","0015","1291","527","263","264","3","530","1468","0","36.10","17.92"
"68","000","00","120","0015","1292","482","249","233","4","486","1179","0","41.22","21.12"
"68","000","00","120","0016","0000","969","421","548","13","982","2458","0","39.95","17.13"
"68","000","00","120","0016","1293","441","183","258","6","447","1102","0","40.56","16.61"
"68","000","00","120","0016","1294","528","238","290","7","535","1356","0","39.45","17.55"
"68","000","00","120","0017","0000","1132","446","686","6","1138","2971","0","38.30","15.01"
"68","000","00","120","0017","1295","615","273","342","4","619","1435","0","43.14","19.02"
"68","000","00","120","0017","1296","517","173","344","2","519","1536","0","33.79","11.26"
"68","000","00","120","0018","0000","921","358","563","9","930","2482","0","37.47","14.42"
"68","000","00","120","0018","1297","474","190","284","4","478","1272","0","37.58","14.94"
"68","000","00","120","0018","1298","447","168","279","5","452","1210","0","37.36","13.88"
"68","000","00","120","0019","0000","338","142","196","7","345","1021","0","33.79","13.91"
"68","000","00","120","0019","1299","338","142","196","7","345","1021","0","33.79","13.91"
"68","000","00","120","0020","0000","777","235","542","7","784","1950","0","40.21","12.05"
"68","000","00","120","0020","1300","358","108","250","7","365","992","0","36.79","10.89"
"68","000","00","120","0020","1301","419","127","292","0","419","958","0","43.74","13.26"
"68","000","00","120","0021","0000","984","384","600","9","993","2935","0","33.83","13.08"
"68","000","00","120","0021","1302","525","195","330","6","531","1462","0","36.32","13.34"
"68","000","00","120","0021","1303","459","189","270","3","462","1473","0","31.36","12.83"
"68","000","00","120","0022","0000","1235","563","672","19","1254","4468","0","28.07","12.60"
"68","000","00","120","0022","1308","440","188","252","2","442","1381","0","32.01","13.61"
"68","000","00","120","0022","1309","398","185","213","6","404","1531","0","26.39","12.08"
"68","000","00","120","0022","1310","397","190","207","11","408","1556","0","26.22","12.21"
"68","000","00","120","0023","0000","651","277","374","7","658","1926","0","34.16","14.38"
"68","000","00","120","0023","1311","331","131","200","4","335","874","0","38.33","14.99"
"68","000","00","120","0023","1312","320","146","174","3","323","1052","0","30.70","13.88"
"68","000","00","120","0024","0000","1884","884","1000","16","1900","5720","0","33.22","15.45"
"68","000","00","120","0024","1304","453","192","261","6","459","1372","0","33.45","13.99"
"68","000","00","120","0024","1305","514","237","277","1","515","1501","0","34.31","15.79"
"68","000","00","120","0024","1306","461","231","230","4","465","1355","0","34.32","17.05"
"68","000","00","120","0024","1307","456","224","232","5","461","1492","0","30.90","15.01"
"68","000","00","130","0000","0000","2715","1870","845","39","2754","10036","12391","27.44","18.63"
"68","000","00","130","0001","0000","666","355","311","15","681","2041","0","33.37","17.39"
"68","000","00","130","0001","0674","349","168","181","10","359","1020","0","35.20","16.47"
"68","000","00","130","0001","0675","317","187","130","5","322","1021","0","31.54","18.32"
"68","000","00","130","0002","0000","434","305","129","5","439","1426","0","30.79","21.39"
"68","000","00","130","0002","0676","434","305","129","5","439","1426","0","30.79","21.39"
"68","000","00","130","0003","0000","218","181","37","5","223","745","0","29.93","24.30"
"68","000","00","130","0003","0678","218","181","37","5","223","745","0","29.93","24.30"
"68","000","00","130","0004","0000","163","133","30","2","165","631","0","26.15","21.08"
"68","000","00","130","0004","0677","163","133","30","2","165","631","0","26.15","21.08"
"68","000","00","130","0005","0000","155","117","38","5","160","660","0","24.24","17.73"
"68","000","00","130","0005","0680","155","117","38","5","160","660","0","24.24","17.73"
"68","000","00","130","0006","0000","129","110","19","1","130","683","0","19.03","16.11"
"68","000","00","130","0006","0683","129","110","19","1","130","683","0","19.03","16.11"
"68","000","00","130","0007","0000","205","167","38","1","206","764","0","26.96","21.86"
"68","000","00","130","0007","0681","205","167","38","1","206","764","0","26.96","21.86"
"68","000","00","130","0008","0000","288","165","123","2","290","1265","0","22.92","13.04"
"68","000","00","130","0008","0684","288","165","123","2","290","1265","0","22.92","13.04"
"68","000","00","130","0009","0000","334","246","88","3","337","1067","0","31.58","23.06"
"68","000","00","130","0009","0679","334","246","88","3","337","1067","0","31.58","23.06"
"68","000","00","130","0010","0000","123","91","32","0","123","754","0","16.31","12.07"
"68","000","00","130","0010","0682","123","91","32","0","123","754","0","16.31","12.07"
"66","000","00","000","0000","0000","975932","488644","487288","8556","984488","2337667","2819081","42.11","20.90"
"66","000","00","010","0000","0000","6022","2825","3197","59","6081","14195","17930","42.84","19.90"
"66","000","00","010","0001","0000","641","268","373","5","646","1436","0","44.99","18.66"
"66","000","00","010","0001","1286","641","268","373","5","646","1436","0","44.99","18.66"
"66","000","00","010","0002","0000","825","385","440","3","828","1946","0","42.55","19.78"
"66","000","00","010","0002","1290","447","204","243","2","449","1121","0","40.05","18.20"
"66","000","00","010","0002","1291","378","181","197","1","379","825","0","45.94","21.94"
"66","000","00","010","0003","0000","680","300","380","7","687","1572","0","43.70","19.08"
"66","000","00","010","0003","1284","324","146","178","4","328","795","0","41.26","18.36"
"66","000","00","010","0003","1285","356","154","202","3","359","777","0","46.20","19.82"
"66","000","00","010","0004","0000","574","270","304","9","583","1353","0","43.09","19.96"
"66","000","00","010","0004","1287","574","270","304","9","583","1353","0","43.09","19.96"
"66","000","00","010","0005","0000","842","406","436","10","852","1913","0","44.54","21.22"
"66","000","00","010","0005","1288","463","227","236","4","467","1012","0","46.15","22.43"
"66","000","00","010","0005","1289","379","179","200","6","385","901","0","42.73","19.87"
"66","000","00","010","0006","0000","705","333","372","9","714","1884","0","37.90","17.68"
"66","000","00","010","0006","1292","407","178","229","6","413","1202","0","34.36","14.81"
"66","000","00","010","0006","1293","298","155","143","3","301","682","0","44.13","22.73"
"66","000","00","010","0007","0000","993","465","528","10","1003","2244","0","44.70","20.72"
"66","000","00","010","0007","1294","470","231","239","2","472","988","0","47.77","23.38"
"66","000","00","010","0007","1295","523","234","289","8","531","1256","0","42.28","18.63"
"66","000","00","010","0008","0000","762","398","364","6","768","1847","0","41.58","21.55"
"66","000","00","010","0008","1296","399","185","214","3","402","960","0","41.88","19.27"
"66","000","00","010","0008","1297","363","213","150","3","366","887","0","41.26","24.01"
"66","000","00","020","0000","0000","28840","13814","15026","264","29104","64617","75468","45.04","21.38"
"66","000","00","020","0001","0000","1167","514","653","9","1176","2974","0","39.54","17.28"
"66","000","00","020","0001","1298","367","146","221","4","371","1174","0","31.60","12.44"
"66","000","00","020","0001","1299","447","220","227","2","449","948","0","47.36","23.21"
"66","000","00","020","0001","1300","353","148","205","3","356","852","0","41.78","17.37"
"66","000","00","020","0002","0000","1426","570","856","17","1443","3053","0","47.26","18.67"
"66","000","00","020","0002","1301","528","224","304","4","532","1073","0","49.58","20.88"
"66","000","00","020","0002","1302","480","193","287","7","487","1098","0","44.35","17.58"
"66","000","00","020","0002","1303","418","153","265","6","424","882","0","48.07","17.35"
"66","000","00","020","0003","0000","1696","654","1042","20","1716","3732","0","45.98","17.52"
"66","000","00","020","0003","1304","587","243","344","10","597","1351","0","44.19","17.99"
"66","000","00","020","0003","1305","535","208","327","5","540","1201","0","44.96","17.32"
"66","000","00","020","0003","1306","574","203","371","5","579","1180","0","49.07","17.20"
"66","000","00","020","0004","0000","1244","537","707","14","1258","2791","0","45.07","19.24"
"66","000","00","020","0004","1307","587","259","328","2","589","1360","0","43.31","19.04"
"66","000","00","020","0004","1308","657","278","379","12","669","1431","0","46.75","19.43"
"66","000","00","020","0005","0000","915","429","486","7","922","1889","0","48.81","22.71"
"66","000","00","020","0005","1311","532","186","346","5","537","1122","0","47.86","16.58"
"66","000","00","020","0005","1312","383","243","140","2","385","767","0","50.20","31.68"
"66","000","00","020","0006","0000","923","422","501","12","935","2030","0","46.06","20.79"
"66","000","00","020","0006","1309","323","143","180","8","331","763","0","43.38","18.74"
"66","000","00","020","0006","1310","600","279","321","4","604","1267","0","47.67","22.02"
"66","000","00","020","0007","0000","1176","526","650","13","1189","2499","0","47.58","21.05"
"66","000","00","020","0007","1313","402","195","207","6","408","859","0","47.50","22.70"
"66","000","00","020","0007","1314","363","150","213","5","368","805","0","45.71","18.63"
"66","000","00","020","0007","1315","411","181","230","2","413","835","0","49.46","21.68"
"66","000","00","020","0008","0000","966","403","563","8","974","2244","0","43.40","17.96"
"66","000","00","020","0008","1316","514","210","304","4","518","1156","0","44.81","18.17"
"66","000","00","020","0008","1317","452","193","259","4","456","1088","0","41.91","17.74"
"66","000","00","020","0009","0000","3030","1268","1762","33","3063","6693","0","45.76","18.95"
"66","000","00","020","0009","1318","536","206","330","8","544","1158","0","46.98","17.79"
"66","000","00","020","0009","1319","430","166","264","6","436","1043","0","41.80","15.92"
"66","000","00","020","0009","1320","502","233","269","2","504","1172","0","43.00","19.88"
"66","000","00","020","0009","1321","671","252","419","10","681","1350","0","50.44","18.67"
"66","000","00","020","0009","1322","519","223","296","4","523","1089","0","48.03","20.48"
"66","000","00","020","0009","1323","372","188","184","3","375","881","0","42.57","21.34"
"66","000","00","020","0010","0000","2089","1023","1066","15","2104","4732","0","44.46","21.62"
"66","000","00","020","0010","1324","547","272","275","7","554","1210","0","45.79","22.48"
"66","000","00","020","0010","1325","526","266","260","1","527","1164","0","45.27","22.85"
"66","000","00","020","0010","1326","523","252","271","4","527","1262","0","41.76","19.97"
"66","000","00","020","0010","1327","493","233","260","3","496","1096","0","45.26","21.26"
"66","000","00","020","0011","0000","1651","881","770","9","1660","3682","0","45.08","23.93"
"66","000","00","020","0011","1334","581","309","272","3","584","1306","0","44.72","23.66"
"66","000","00","020","0011","1335","518","252","266","2","520","1113","0","46.72","22.64"
"66","000","00","020","0011","1336","552","320","232","4","556","1263","0","44.02","25.34"
"66","000","00","020","0012","0000","1078","554","524","11","1089","2651","0","41.08","20.90"
"66","000","00","020","0012","1337","540","239","301","2","542","1307","0","41.47","18.29"
"66","000","00","020","0012","1338","538","315","223","9","547","1344","0","40.70","23.44"
"66","000","00","020","0013","0000","1674","1067","607","14","1688","3985","0","42.36","26.78"
"66","000","00","020","0013","1339","654","350","304","4","658","1410","0","46.67","24.82"
"66","000","00","020","0013","1340","442","263","179","5","447","1141","0","39.18","23.05"
"66","000","00","020","0013","1341","578","454","124","5","583","1434","0","40.66","31.66"
"66","000","00","020","0014","0000","762","495","267","5","767","1703","0","45.04","29.07"
"66","000","00","020","0014","1346","341","209","132","2","343","764","0","44.90","27.36"
"66","000","00","020","0014","1347","421","286","135","3","424","939","0","45.15","30.46"
"66","000","00","020","0015","0000","1839","1245","594","17","1856","4044","0","45.90","30.79"
"66","000","00","020","0015","1342","482","276","206","4","486","1172","0","41.47","23.55"
"66","000","00","020","0015","1343","436","364","72","3","439","914","0","48.03","39.82"
"66","000","00","020","0015","1344","495","280","215","5","500","993","0","50.35","28.20"
"66","000","00","020","0015","1345","426","325","101","5","431","965","0","44.66","33.68"
"66","000","00","020","0016","0000","3993","1749","2244","42","4035","8763","0","46.05","19.96"
"66","000","00","020","0016","1348","615","295","320","4","619","1254","0","49.36","23.52"
"66","000","00","020","0016","1349","595","224","371","7","602","1277","0","47.14","17.54"
"66","000","00","020","0016","1350","456","250","206","2","458","1276","0","35.89","19.59"
"66","000","00","020","0016","1351","586","244","342","9","595","1265","0","47.04","19.29"
"66","000","00","020","0016","1352","607","221","386","10","617","1258","0","49.05","17.57"
"66","000","00","020","0016","1353","523","235","288","5","528","1226","0","43.07","19.17"
"66","000","00","020","0016","1354","611","280","331","5","616","1207","0","51.04","23.20"
"66","000","00","020","0017","0000","3211","1477","1734","18","3229","7152","0","45.15","20.65"
"66","000","00","020","0017","1328","600","302","298","4","604","1228","0","49.19","24.59"
"66","000","00","020","0017","1329","452","197","255","2","454","1091","0","41.61","18.06"
"66","000","00","020","0017","1330","394","161","233","2","396","956","0","41.42","16.84"
"66","000","00","020","0017","1331","603","280","323","4","607","1293","0","46.95","21.66"
"66","000","00","020","0017","1332","613","273","340","2","615","1304","0","47.16","20.94"
"66","000","00","020","0017","1333","549","264","285","4","553","1280","0","43.20","20.63"
"66","000","00","030","0000","0000","46786","23812","22974","345","47131","105752","126574","44.57","22.52"
"66","000","00","030","0001","0000","1606","743","863","14","1620","3502","0","46.26","21.22"
"66","000","00","030","0001","1359","548","232","316","6","554","1194","0","46.40","19.43"
"66","000","00","030","0001","1360","531","256","275","6","537","1108","0","48.47","23.10"
"66","000","00","030","0001","1361","527","255","272","2","529","1200","0","44.08","21.25"
"66","000","00","030","0002","0000","1679","780","899","16","1695","3745","0","45.26","20.83"
"66","000","00","030","0002","1362","561","256","305","4","565","1213","0","46.58","21.10"
"66","000","00","030","0002","1363","542","250","292","6","548","1251","0","43.80","19.98"
"66","000","00","030","0002","1364","576","274","302","6","582","1281","0","45.43","21.39"
"66","000","00","030","0003","0000","1626","782","844","14","1640","3412","0","48.07","22.92"
"66","000","00","030","0003","1365","578","284","294","5","583","1156","0","50.43","24.57"
"66","000","00","030","0003","1366","571","285","286","8","579","1180","0","49.07","24.15"
"66","000","00","030","0003","1367","477","213","264","1","478","1076","0","44.42","19.80"
"66","000","00","030","0004","0000","1343","688","655","18","1361","2840","0","47.92","24.23"
"66","000","00","030","0004","1368","691","382","309","9","700","1361","0","51.43","28.07"
"66","000","00","030","0004","1369","652","306","346","9","661","1479","0","44.69","20.69"
"66","000","00","030","0005","0000","1148","514","634","9","1157","2506","0","46.17","20.51"
"66","000","00","030","0005","1370","523","228","295","6","529","1133","0","46.69","20.12"
"66","000","00","030","0005","1371","625","286","339","3","628","1373","0","45.74","20.83"
"66","000","00","030","0006","0000","1330","692","638","12","1342","2714","0","49.45","25.50"
"66","000","00","030","0006","1372","657","329","328","7","664","1324","0","50.15","24.85"
"66","000","00","030","0006","1373","673","363","310","5","678","1390","0","48.78","26.12"
"66","000","00","030","0007","0000","1904","1049","855","11","1915","4415","0","43.37","23.76"
"66","000","00","030","0007","1374","641","373","268","2","643","1505","0","42.72","24.78"
"66","000","00","030","0007","1375","653","367","286","4","657","1490","0","44.09","24.63"
"66","000","00","030","0007","1376","610","309","301","5","615","1420","0","43.31","21.76"
"66","000","00","030","0008","0000","1824","903","921","7","1831","3817","0","47.97","23.66"
"66","000","00","030","0008","1377","677","327","350","3","680","1314","0","51.75","24.89"
"66","000","00","030","0008","1378","610","265","345","2","612","1292","0","47.37","20.51"
"66","000","00","030","0008","1379","537","311","226","2","539","1211","0","44.51","25.68"
"66","000","00","030","0009","0000","2312","1128","1184","21","2333","5297","0","44.04","21.30"
"66","000","00","030","0009","1380","552","272","280","6","558","1305","0","42.76","20.84"
"66","000","00","030","0009","1381","620","319","301","5","625","1390","0","44.96","22.95"
"66","000","00","030","0009","1382","561","253","308","5","566","1292","0","43.81","19.58"
"66","000","00","030","0009","1383","579","284","295","5","584","1310","0","44.58","21.68"
"66","000","00","030","0010","0000","1557","770","787","11","1568","4091","0","38.33","18.82"
"66","000","00","030","0010","1388","610","290","320","1","611","1533","0","39.86","18.92"
"66","000","00","030","0010","1389","508","270","238","4","512","1216","0","42.11","22.20"
"66","000","00","030","0010","1390","439","210","229","6","445","1342","0","33.16","15.65"
"66","000","00","030","0011","0000","3522","1876","1646","17","3539","7871","0","44.96","23.83"
"66","000","00","030","0011","1399","471","249","222","2","473","1097","0","43.12","22.70"
"66","000","00","030","0011","1400","613","312","301","1","614","1260","0","48.73","24.76"
"66","000","00","030","0011","1401","597","337","260","3","600","1326","0","45.25","25.41"
"66","000","00","030","0011","1402","527","305","222","4","531","1330","0","39.92","22.93"
"66","000","00","030","0011","1403","603","314","289","1","604","1432","0","42.18","21.93"
"66","000","00","030","0011","1404","711","359","352","6","717","1426","0","50.28","25.18"
"66","000","00","030","0012","0000","5061","2544","2517","27","5088","11718","0","43.42","21.71"
"66","000","00","030","0012","1409","555","270","285","2","557","1458","0","38.20","18.52"
"66","000","00","030","0012","1410","569","323","246","3","572","1489","0","38.42","21.69"
"66","000","00","030","0012","1411","667","322","345","5","672","1437","0","46.76","22.41"
"66","000","00","030","0012","1412","713","351","362","6","719","1515","0","47.46","23.17"
"66","000","00","030","0012","1413","649","302","347","6","655","1498","0","43.72","20.16"
"66","000","00","030","0012","1414","608","312","296","1","609","1462","0","41.66","21.34"
"66","000","00","030","0012","1415","635","315","320","1","636","1435","0","44.32","21.95"
"66","000","00","030","0012","1416","665","349","316","3","668","1424","0","46.91","24.51"
"66","000","00","030","0013","0000","3757","2022","1735","29","3786","8372","0","45.22","24.15"
"66","000","00","030","0013","1422","603","317","286","1","604","1341","0","45.04","23.64"
"66","000","00","030","0013","1423","619","357","262","7","626","1430","0","43.78","24.97"
"66","000","00","030","0013","1424","648","350","298","3","651","1338","0","48.65","26.16"
"66","000","00","030","0013","1425","561","271","290","7","568","1309","0","43.39","20.70"
"66","000","00","030","0013","1426","626","358","268","4","630","1506","0","41.83","23.77"
"66","000","00","030","0013","1427","700","369","331","7","707","1448","0","48.83","25.48"
"66","000","00","030","0014","0000","1909","1020","889","14","1923","4215","0","45.62","24.20"
"66","000","00","030","0014","1428","641","328","313","3","644","1390","0","46.33","23.60"
"66","000","00","030","0014","1429","620","310","310","9","629","1386","0","45.38","22.37"
"66","000","00","030","0014","1430","648","382","266","2","650","1439","0","45.17","26.55"
"66","000","00","030","0015","0000","896","435","461","9","905","1865","0","48.53","23.32"
"66","000","00","030","0015","1355","432","196","236","8","440","897","0","49.05","21.85"
"66","000","00","030","0015","1356","464","239","225","1","465","968","0","48.04","24.69"
"66","000","00","030","0016","0000","1163","554","609","11","1174","2394","0","49.04","23.14"
"66","000","00","030","0016","1357","569","279","290","4","573","1220","0","46.97","22.87"
"66","000","00","030","0016","1358","594","275","319","7","601","1174","0","51.19","23.42"
"66","000","00","030","0017","0000","2417","1250","1167","19","2436","5566","0","43.77","22.46"
"66","000","00","030","0017","1384","686","376","310","5","691","1394","0","49.57","26.97"
"66","000","00","030","0017","1385","581","292","289","6","587","1395","0","42.08","20.93"
"66","000","00","030","0017","1386","594","272","322","6","600","1330","0","45.11","20.45"
"66","000","00","030","0017","1387","556","310","246","2","558","1447","0","38.56","21.42"
"66","000","00","030","0018","0000","1505","688","817","17","1522","3459","0","44.00","19.89"
"66","000","00","030","0018","1391","507","230","277","8","515","1156","0","44.55","19.90"
"66","000","00","030","0018","1392","495","213","282","3","498","1165","0","42.75","18.28"
"66","000","00","030","0018","1393","503","245","258","6","509","1138","0","44.73","21.53"
"66","000","00","030","0019","0000","2982","1626","1356","21","3003","7374","0","40.72","22.05"
"66","000","00","030","0019","1394","684","376","308","4","688","1463","0","47.03","25.70"
"66","000","00","030","0019","1395","637","343","294","5","642","1961","0","32.74","17.49"
"66","000","00","030","0019","1396","541","290","251","3","544","1351","0","40.27","21.47"
"66","000","00","030","0019","1397","530","274","256","4","534","1339","0","39.88","20.46"
"66","000","00","030","0019","1398","590","343","247","5","595","1260","0","47.22","27.22"
"66","000","00","030","0020","0000","1949","999","950","13","1962","4610","0","42.56","21.67"
"66","000","00","030","0020","1405","481","244","237","4","485","1163","0","41.70","20.98"
"66","000","00","030","0020","1406","527","277","250","1","528","1243","0","42.48","22.28"
"66","000","00","030","0020","1407","488","246","242","4","492","1073","0","45.85","22.93"
"66","000","00","030","0020","1408","453","232","221","4","457","1131","0","40.41","20.51"
"66","000","00","030","0021","0000","2851","1516","1335","15","2866","6608","0","43.37","22.94"
"66","000","00","030","0021","1417","535","298","237","7","542","1367","0","39.65","21.80"
"66","000","00","030","0021","1418","557","296","261","3","560","1373","0","40.79","21.56"
"66","000","00","030","0021","1419","559","268","291","1","560","1360","0","41.18","19.71"
"66","000","00","030","0021","1420","674","359","315","4","678","1323","0","51.25","27.14"
"66","000","00","030","0021","1421","526","295","231","0","526","1185","0","44.39","24.89"
"66","000","00","030","0022","0000","2445","1233","1212","20","2465","5361","0","45.98","23.00"
"66","000","00","030","0022","1431","620","286","334","4","624","1259","0","49.56","22.72"
"66","000","00","030","0022","1432","633","311","322","7","640","1336","0","47.90","23.28"
"66","000","00","030","0022","1433","608","333","275","3","611","1358","0","44.99","24.52"
"66","000","00","030","0022","1434","584","303","281","6","590","1408","0","41.90","21.52"
"66","000","00","040","0000","0000","43156","21652","21504","339","43495","94273","113744","46.14","22.97"
"66","000","00","040","0001","0000","799","409","390","8","807","1694","0","47.64","24.14"
"66","000","00","040","0001","1210","365","190","175","2","367","787","0","46.63","24.14"
"66","000","00","040","0001","1211","434","219","215","6","440","907","0","48.51","24.15"
"66","000","00","040","0002","0000","624","365","259","6","630","1340","0","47.01","27.24"
"66","000","00","040","0002","1209","624","365","259","6","630","1340","0","47.01","27.24"
"66","000","00","040","0003","0000","803","426","377","3","806","2306","0","34.95","18.47"
"66","000","00","040","0003","1207","385","205","180","1","386","1504","0","25.66","13.63"
"66","000","00","040","0003","1208","418","221","197","2","420","802","0","52.37","27.56"
"66","000","00","040","0004","0000","1101","577","524","6","1107","2250","0","49.20","25.64"
"66","000","00","040","0004","1215","595","309","286","3","598","1175","0","50.89","26.30"
"66","000","00","040","0004","1216","506","268","238","3","509","1075","0","47.35","24.93"
"66","000","00","040","0005","0000","608","303","305","5","613","1370","0","44.74","22.12"
"66","000","00","040","0005","1212","608","303","305","5","613","1370","0","44.74","22.12"
"66","000","00","040","0006","0000","809","438","371","4","813","1840","0","44.18","23.80"
"66","000","00","040","0006","1213","430","241","189","2","432","967","0","44.67","24.92"
"66","000","00","040","0006","1214","379","197","182","2","381","873","0","43.64","22.57"
"66","000","00","040","0007","0000","2244","1099","1145","23","2267","4767","0","47.56","23.05"
"66","000","00","040","0007","1217","492","256","236","5","497","1078","0","46.10","23.75"
"66","000","00","040","0007","1218","566","277","289","7","573","1191","0","48.11","23.26"
"66","000","00","040","0007","1219","585","289","296","4","589","1233","0","47.77","23.44"
"66","000","00","040","0007","1220","601","277","324","7","608","1265","0","48.06","21.90"
"66","000","00","040","0008","0000","1843","946","897","22","1865","3884","0","48.02","24.36"
"66","000","00","040","0008","1221","617","318","299","7","624","1278","0","48.83","24.88"
"66","000","00","040","0008","1222","611","324","287","8","619","1306","0","47.40","24.81"
"66","000","00","040","0008","1223","615","304","311","7","622","1300","0","47.85","23.38"
"66","000","00","040","0009","0000","2516","1214","1302","17","2533","5582","0","45.38","21.75"
"66","000","00","040","0009","1224","646","319","327","5","651","1380","0","47.17","23.12"
"66","000","00","040","0009","1225","636","301","335","7","643","1356","0","47.42","22.20"
"66","000","00","040","0009","1226","521","271","250","0","521","1430","0","36.43","18.95"
"66","000","00","040","0009","1227","713","323","390","5","718","1416","0","50.71","22.81"
"66","000","00","040","0010","0000","988","440","548","9","997","2244","0","44.43","19.61"
"66","000","00","040","0010","1247","575","262","313","7","582","1271","0","45.79","20.61"
"66","000","00","040","0010","1248","413","178","235","2","415","973","0","42.65","18.29"
"66","000","00","040","0011","0000","1510","809","701","16","1526","3397","0","44.92","23.82"
"66","000","00","040","0011","1244","459","250","209","7","466","1021","0","45.64","24.49"
"66","000","00","040","0011","1245","668","353","315","4","672","1413","0","47.56","24.98"
"66","000","00","040","0011","1246","383","206","177","5","388","963","0","40.29","21.39"
"66","000","00","040","0012","0000","1490","712","778","10","1500","3447","0","43.52","20.66"
"66","000","00","040","0012","1249","432","198","234","3","435","1069","0","40.69","18.52"
"66","000","00","040","0012","1250","562","276","286","3","565","1208","0","46.77","22.85"
"66","000","00","040","0012","1251","496","238","258","4","500","1170","0","42.74","20.34"
"66","000","00","040","0013","0000","1370","692","678","14","1384","2776","0","49.86","24.93"
"66","000","00","040","0013","1228","640","340","300","6","646","1327","0","48.68","25.62"
"66","000","00","040","0013","1229","730","352","378","8","738","1449","0","50.93","24.29"
"66","000","00","040","0014","0000","2962","1559","1403","21","2983","6405","0","46.57","24.34"
"66","000","00","040","0014","1230","612","284","328","7","619","1318","0","46.97","21.55"
"66","000","00","040","0014","1231","602","329","273","3","605","1296","0","46.68","25.39"
"66","000","00","040","0014","1232","642","335","307","8","650","1282","0","50.70","26.13"
"66","000","00","040","0014","1233","585","321","264","0","585","1308","0","44.72","24.54"
"66","000","00","040","0014","1234","521","290","231","3","524","1201","0","43.63","24.15"
"66","000","00","040","0015","0000","2512","1219","1293","15","2527","5634","0","44.85","21.64"
"66","000","00","040","0015","1254","604","292","312","7","611","1433","0","42.64","20.38"
"66","000","00","040","0015","1255","611","282","329","0","611","1396","0","43.77","20.20"
"66","000","00","040","0015","1256","607","288","319","4","611","1385","0","44.12","20.79"
"66","000","00","040","0015","1257","690","357","333","4","694","1420","0","48.87","25.14"
"66","000","00","040","0016","0000","2679","1309","1370","20","2699","5653","0","47.74","23.16"
"66","000","00","040","0016","1275","519","233","286","1","520","1115","0","46.64","20.90"
"66","000","00","040","0016","1276","548","329","219","5","553","1117","0","49.51","29.45"
"66","000","00","040","0016","1277","535","271","264","3","538","1181","0","45.55","22.95"
"66","000","00","040","0016","1278","524","231","293","6","530","1082","0","48.98","21.35"
"66","000","00","040","0016","1279","553","245","308","5","558","1158","0","48.19","21.16"
"66","000","00","040","0017","0000","2918","1484","1434","24","2942","6172","0","47.67","24.04"
"66","000","00","040","0017","1266","524","270","254","4","528","1157","0","45.64","23.34"
"66","000","00","040","0017","1267","621","324","297","5","626","1252","0","50.00","25.88"
"66","000","00","040","0017","1268","552","257","295","5","557","1161","0","47.98","22.14"
"66","000","00","040","0017","1269","579","304","275","3","582","1270","0","45.83","23.94"
"66","000","00","040","0017","1270","642","329","313","7","649","1332","0","48.72","24.70"
"66","000","00","040","0018","0000","2572","1220","1352","18","2590","5619","0","46.09","21.71"
"66","000","00","040","0018","1235","433","223","210","2","435","904","0","48.12","24.67"
"66","000","00","040","0018","1236","521","236","285","7","528","1034","0","51.06","22.82"
"66","000","00","040","0018","1237","549","268","281","7","556","1267","0","43.88","21.15"
"66","000","00","040","0018","1238","512","224","288","2","514","1234","0","41.65","18.15"
"66","000","00","040","0018","1239","557","269","288","0","557","1180","0","47.20","22.80"
"66","000","00","040","0019","0000","2479","1224","1255","18","2497","5548","0","45.01","22.06"
"66","000","00","040","0019","1280","597","257","340","4","601","1416","0","42.44","18.15"
"66","000","00","040","0019","1281","616","297","319","4","620","1318","0","47.04","22.53"
"66","000","00","040","0019","1282","606","305","301","6","612","1398","0","43.78","21.82"
"66","000","00","040","0019","1283","660","365","295","4","664","1416","0","46.89","25.78"
"66","000","00","040","0020","0000","1259","565","694","15","1274","2725","0","46.75","20.73"
"66","000","00","040","0020","1261","650","285","365","8","658","1403","0","46.90","20.31"
"66","000","00","040","0020","1262","609","280","329","7","616","1322","0","46.60","21.18"
"66","000","00","040","0021","0000","1718","754","964","8","1726","3518","0","49.06","21.43"
"66","000","00","040","0021","1258","536","237","299","2","538","1148","0","46.86","20.64"
"66","000","00","040","0021","1259","626","273","353","3","629","1258","0","50.00","21.70"
"66","000","00","040","0021","1260","556","244","312","3","559","1112","0","50.27","21.94"
"66","000","00","040","0022","0000","2121","1148","973","12","2133","4905","0","43.49","23.40"
"66","000","00","040","0022","1271","532","257","275","2","534","1220","0","43.77","21.07"
"66","000","00","040","0022","1272","534","269","265","4","538","1239","0","43.42","21.71"
"66","000","00","040","0022","1273","520","297","223","1","521","1213","0","42.95","24.48"
"66","000","00","040","0022","1274","535","325","210","5","540","1233","0","43.80","26.36"
"66","000","00","040","0023","0000","1872","961","911","11","1883","4170","0","45.16","23.05"
"66","000","00","040","0023","1263","622","313","309","1","623","1395","0","44.66","22.44"
"66","000","00","040","0023","1264","591","296","295","4","595","1372","0","43.37","21.57"
"66","000","00","040","0023","1265","659","352","307","6","665","1403","0","47.40","25.09"
"66","000","00","040","0024","0000","1237","664","573","13","1250","2712","0","46.09","24.48"
"66","000","00","040","0024","1252","582","310","272","5","587","1310","0","44.81","23.66"
"66","000","00","040","0024","1253","655","354","301","8","663","1402","0","47.29","25.25"
"66","000","00","040","0025","0000","2122","1115","1007","21","2143","4315","0","49.66","25.84"
"66","000","00","040","0025","1240","603","372","231","10","613","1135","0","54.01","32.78"
"66","000","00","040","0025","1241","470","257","213","1","471","1074","0","43.85","23.93"
"66","000","00","040","0025","1242","523","232","291","5","528","1079","0","48.93","21.50"
"66","000","00","040","0025","1243","526","254","272","5","531","1027","0","51.70","24.73"
"66","000","00","050","0000","0000","54451","28527","25924","411","54862","124160","145438","44.19","22.98"
"66","000","00","050","0001","0000","840","386","454","11","851","2049","0","41.53","18.84"
"66","000","00","050","0001","1111","428","204","224","4","432","1064","0","40.60","19.17"
"66","000","00","050","0001","1112","412","182","230","7","419","985","0","42.54","18.48"
"66","000","00","050","0002","0000","1624","1018","606","14","1638","3331","0","49.17","30.56"
"66","000","00","050","0002","1113","458","209","249","6","464","924","0","50.22","22.62"
"66","000","00","050","0002","1114","432","237","195","3","435","960","0","45.31","24.69"
"66","000","00","050","0002","1115","734","572","162","5","739","1447","0","51.07","39.53"
"66","000","00","050","0003","0000","563","232","331","6","569","1343","0","42.37","17.27"
"66","000","00","050","0003","1118","563","232","331","6","569","1343","0","42.37","17.27"
"66","000","00","050","0004","0000","617","358","259","4","621","1453","0","42.74","24.64"
"66","000","00","050","0004","1123","307","197","110","2","309","705","0","43.83","27.94"
"66","000","00","050","0004","1124","310","161","149","2","312","748","0","41.71","21.52"
"66","000","00","050","0005","0000","775","382","393","6","781","1655","0","47.19","23.08"
"66","000","00","050","0005","1121","347","174","173","1","348","683","0","50.95","25.48"
"66","000","00","050","0005","1122","428","208","220","5","433","972","0","44.55","21.40"
"66","000","00","050","0006","0000","1151","886","265","11","1162","2490","0","46.67","35.58"
"66","000","00","050","0006","1125","688","560","128","5","693","1389","0","49.89","40.32"
"66","000","00","050","0006","1126","463","326","137","6","469","1101","0","42.60","29.61"
"66","000","00","050","0007","0000","1507","786","721","7","1514","3071","0","49.30","25.59"
"66","000","00","050","0007","1127","812","399","413","4","816","1685","0","48.43","23.68"
"66","000","00","050","0007","1128","695","387","308","3","698","1386","0","50.36","27.92"
"66","000","00","050","0008","0000","2299","1131","1168","16","2315","5570","0","41.56","20.31"
"66","000","00","050","0008","1129","561","219","342","4","565","1271","0","44.45","17.23"
"66","000","00","050","0008","1130","456","187","269","3","459","1026","0","44.74","18.23"
"66","000","00","050","0008","1131","673","368","305","8","681","1714","0","39.73","21.47"
"66","000","00","050","0008","1132","609","357","252","1","610","1559","0","39.13","22.90"
"66","000","00","050","0009","0000","1452","835","617","16","1468","3236","0","45.36","25.80"
"66","000","00","050","0009","1136","443","231","212","6","449","1042","0","43.09","22.17"
"66","000","00","050","0009","1137","516","304","212","3","519","1138","0","45.61","26.71"
"66","000","00","050","0009","1138","493","300","193","7","500","1056","0","47.35","28.41"
"66","000","00","050","0010","0000","1170","654","516","12","1182","2501","0","47.26","26.15"
"66","000","00","050","0010","1142","557","314","243","3","560","1200","0","46.67","26.17"
"66","000","00","050","0010","1143","613","340","273","9","622","1301","0","47.81","26.13"
"66","000","00","050","0011","0000","1848","986","862","10","1858","4247","0","43.75","23.22"
"66","000","00","050","0011","1144","621","337","284","5","626","1375","0","45.53","24.51"
"66","000","00","050","0011","1145","625","344","281","3","628","1426","0","44.04","24.12"
"66","000","00","050","0011","1146","602","305","297","2","604","1446","0","41.77","21.09"
"66","000","00","050","0012","0000","994","520","474","6","1000","2256","0","44.33","23.05"
"66","000","00","050","0012","1147","493","256","237","4","497","1194","0","41.62","21.44"
"66","000","00","050","0012","1148","501","264","237","2","503","1062","0","47.36","24.86"
"66","000","00","050","0013","0000","2455","1218","1237","18","2473","5454","0","45.34","22.33"
"66","000","00","050","0013","1149","512","273","239","3","515","1184","0","43.50","23.06"
"66","000","00","050","0013","1150","562","281","281","5","567","1203","0","47.13","23.36"
"66","000","00","050","0013","1151","512","249","263","5","517","1053","0","49.10","23.65"
"66","000","00","050","0013","1152","439","209","230","2","441","1030","0","42.82","20.29"
"66","000","00","050","0013","1153","430","206","224","3","433","984","0","44.00","20.93"
"66","000","00","050","0014","0000","1863","1011","852","20","1883","4109","0","45.83","24.60"
"66","000","00","050","0014","1154","537","296","241","4","541","1231","0","43.95","24.05"
"66","000","00","050","0014","1155","680","336","344","8","688","1467","0","46.90","22.90"
"66","000","00","050","0014","1156","646","379","267","8","654","1411","0","46.35","26.86"
"66","000","00","050","0015","0000","1718","998","720","7","1725","5017","0","34.38","19.89"
"66","000","00","050","0015","1160","460","271","189","1","461","2015","0","22.88","13.45"
"66","000","00","050","0015","1161","674","411","263","2","676","1543","0","43.81","26.64"
"66","000","00","050","0015","1162","584","316","268","4","588","1459","0","40.30","21.66"
"66","000","00","050","0016","0000","1929","895","1034","11","1940","4300","0","45.12","20.81"
"66","000","00","050","0016","1177","597","255","342","4","601","1308","0","45.95","19.50"
"66","000","00","050","0016","1178","642","300","342","2","644","1403","0","45.90","21.38"
"66","000","00","050","0016","1179","690","340","350","5","695","1589","0","43.74","21.40"
"66","000","00","050","0017","0000","1661","866","795","8","1669","3585","0","46.56","24.16"
"66","000","00","050","0017","1180","725","393","332","4","729","1496","0","48.73","26.27"
"66","000","00","050","0017","1181","390","187","203","1","391","929","0","42.09","20.13"
"66","000","00","050","0017","1182","546","286","260","3","549","1160","0","47.33","24.66"
"66","000","00","050","0018","0000","2255","1127","1128","25","2280","5018","0","45.44","22.46"
"66","000","00","050","0018","1183","652","340","312","4","656","1456","0","45.05","23.35"
"66","000","00","050","0018","1184","485","243","242","9","494","1137","0","43.45","21.37"
"66","000","00","050","0018","1185","602","271","331","5","607","1255","0","48.37","21.59"
"66","000","00","050","0018","1186","516","273","243","7","523","1170","0","44.70","23.33"
"66","000","00","050","0019","0000","1137","571","566","12","1149","2573","0","44.66","22.19"
"66","000","00","050","0019","1205","589","279","310","9","598","1352","0","44.23","20.64"
"66","000","00","050","0019","1206","548","292","256","3","551","1221","0","45.13","23.91"
"66","000","00","050","0020","0000","1967","1099","868","10","1977","4459","0","44.34","24.65"
"66","000","00","050","0020","1139","650","335","315","6","656","1555","0","42.19","21.54"
"66","000","00","050","0020","1140","658","379","279","2","660","1501","0","43.97","25.25"
"66","000","00","050","0020","1141","659","385","274","2","661","1403","0","47.11","27.44"
"66","000","00","050","0021","0000","3048","1457","1591","35","3083","6438","0","47.89","22.63"
"66","000","00","050","0021","1187","658","322","336","6","664","1313","0","50.57","24.52"
"66","000","00","050","0021","1188","495","244","251","6","501","1049","0","47.76","23.26"
"66","000","00","050","0021","1189","577","283","294","8","585","1266","0","46.21","22.35"
"66","000","00","050","0021","1190","629","285","344","6","635","1265","0","50.20","22.53"
"66","000","00","050","0021","1191","689","323","366","9","698","1545","0","45.18","20.91"
"66","000","00","050","0022","0000","2321","1147","1174","15","2336","5217","0","44.78","21.99"
"66","000","00","050","0022","1192","566","261","305","2","568","1313","0","43.26","19.88"
"66","000","00","050","0022","1193","625","293","332","4","629","1343","0","46.84","21.82"
"66","000","00","050","0022","1194","583","313","270","7","590","1302","0","45.31","24.04"
"66","000","00","050","0022","1195","547","280","267","2","549","1259","0","43.61","22.24"
"66","000","00","050","0023","0000","2574","1303","1271","15","2589","5993","0","43.20","21.74"
"66","000","00","050","0023","1198","600","298","302","2","602","1457","0","41.32","20.45"
"66","000","00","050","0023","1199","618","300","318","2","620","1455","0","42.61","20.62"
"66","000","00","050","0023","1200","709","379","330","2","711","1524","0","46.65","24.87"
"66","000","00","050","0023","1201","647","326","321","9","656","1557","0","42.13","20.94"
"66","000","00","050","0024","0000","1580","902","678","7","1587","3763","0","42.17","23.97"
"66","000","00","050","0024","1172","562","316","246","1","563","1240","0","45.40","25.48"
"66","000","00","050","0024","1173","500","318","182","0","500","1282","0","39.00","24.80"
"66","000","00","050","0024","1174","518","268","250","6","524","1241","0","42.22","21.60"
"66","000","00","050","0025","0000","1646","951","695","9","1655","3730","0","44.37","25.50"
"66","000","00","050","0025","1166","576","320","256","2","578","1420","0","40.70","22.54"
"66","000","00","050","0025","1167","527","288","239","5","532","1153","0","46.14","24.98"
"66","000","00","050","0025","1168","543","343","200","2","545","1157","0","47.10","29.65"
"66","000","00","050","0026","0000","575","225","350","3","578","1309","0","44.16","17.19"
"66","000","00","050","0026","1109","575","225","350","3","578","1309","0","44.16","17.19"
"66","000","00","050","0027","0000","676","258","418","3","679","1727","0","39.32","14.94"
"66","000","00","050","0027","1110","676","258","418","3","679","1727","0","39.32","14.94"
"66","000","00","050","0028","0000","818","334","484","8","826","2153","0","38.37","15.51"
"66","000","00","050","0028","1116","462","181","281","4","466","1267","0","36.78","14.29"
"66","000","00","050","0028","1117","356","153","203","4","360","886","0","40.63","17.27"
"66","000","00","050","0029","0000","776","369","407","7","783","1840","0","42.55","20.05"
"66","000","00","050","0029","1119","424","230","194","3","427","994","0","42.96","23.14"
"66","000","00","050","0029","1120","352","139","213","4","356","846","0","42.08","16.43"
"66","000","00","050","0030","0000","1561","812","749","12","1573","3229","0","48.71","25.15"
"66","000","00","050","0030","1133","459","225","234","2","461","1044","0","44.16","21.55"
"66","000","00","050","0030","1134","565","311","254","6","571","1091","0","52.34","28.51"
"66","000","00","050","0030","1135","537","276","261","4","541","1094","0","49.45","25.23"
"66","000","00","050","0031","0000","1445","731","714","10","1455","3417","0","42.58","21.39"
"66","000","00","050","0031","1157","465","242","223","4","469","1113","0","42.14","21.74"
"66","000","00","050","0031","1158","495","231","264","5","500","1140","0","43.86","20.26"
"66","000","00","050","0031","1159","485","258","227","1","486","1164","0","41.75","22.16"
"66","000","00","050","0032","0000","1655","880","775","12","1667","4259","0","39.14","20.66"
"66","000","00","050","0032","1169","457","249","208","3","460","1162","0","39.59","21.43"
"66","000","00","050","0032","1170","617","323","294","5","622","1634","0","38.07","19.77"
"66","000","00","050","0032","1171","581","308","273","4","585","1463","0","39.99","21.05"
"66","000","00","050","0033","0000","1166","623","543","12","1178","2661","0","44.27","23.41"
"66","000","00","050","0033","1196","592","327","265","8","600","1340","0","44.78","24.40"
"66","000","00","050","0033","1197","574","296","278","4","578","1321","0","43.75","22.41"
"66","000","00","050","0034","0000","1553","870","683","9","1562","3755","0","41.60","23.17"
"66","000","00","050","0034","1202","503","263","240","4","507","1190","0","42.61","22.10"
"66","000","00","050","0034","1203","550","324","226","3","553","1292","0","42.80","25.08"
"66","000","00","050","0034","1204","500","283","217","2","502","1273","0","39.43","22.23"
"66","000","00","050","0035","0000","1397","744","653","9","1406","3190","0","44.08","23.32"
"66","000","00","050","0035","1175","684","382","302","3","687","1578","0","43.54","24.21"
"66","000","00","050","0035","1176","713","362","351","6","719","1612","0","44.60","22.46"
"66","000","00","050","0036","0000","1835","962","873","15","1850","3762","0","49.18","25.57"
"66","000","00","050","0036","1163","713","381","332","5","718","1327","0","54.11","28.71"
"66","000","00","050","0036","1164","602","310","292","5","607","1318","0","46.05","23.52"
"66","000","00","050","0036","1165","520","271","249","5","525","1117","0","47.00","24.26"
"66","000","00","060","0000","0000","80860","43285","37575","680","81540","188793","231415","43.19","22.93"
"66","000","00","060","0001","0000","2263","1161","1102","15","2278","5165","0","44.10","22.48"
"66","000","00","060","0001","0668","541","274","267","6","547","1268","0","43.14","21.61"
"66","000","00","060","0001","0669","575","286","289","2","577","1310","0","44.05","21.83"
"66","000","00","060","0001","0670","497","227","270","3","500","1079","0","46.34","21.04"
"66","000","00","060","0001","0671","650","374","276","4","654","1508","0","43.37","24.80"
"66","000","00","060","0002","0000","2430","1163","1267","18","2448","5884","0","41.60","19.77"
"66","000","00","060","0002","0679","499","213","286","6","505","1176","0","42.94","18.11"
"66","000","00","060","0002","0680","476","207","269","5","481","1159","0","41.50","17.86"
"66","000","00","060","0002","0681","496","236","260","2","498","1179","0","42.24","20.02"
"66","000","00","060","0002","0682","503","250","253","4","507","1207","0","42.00","20.71"
"66","000","00","060","0002","0683","456","257","199","1","457","1163","0","39.29","22.10"
"66","000","00","060","0003","0000","2272","1157","1115","24","2296","6268","0","36.63","18.46"
"66","000","00","060","0003","0684","543","310","233","8","551","1438","0","38.32","21.56"
"66","000","00","060","0003","0685","569","274","295","6","575","1406","0","40.90","19.49"
"66","000","00","060","0003","0686","644","307","337","6","650","1318","0","49.32","23.29"
"66","000","00","060","0003","0687","516","266","250","4","520","2106","0","24.69","12.63"
"66","000","00","060","0004","0000","411","162","249","5","416","833","0","49.94","19.45"
"66","000","00","060","0004","0688","411","162","249","5","416","833","0","49.94","19.45"
"66","000","00","060","0005","0000","6213","3338","2875","50","6263","14638","0","42.79","22.80"
"66","000","00","060","0005","0689","529","283","246","2","531","1292","0","41.10","21.90"
"66","000","00","060","0005","0690","512","296","216","4","516","1309","0","39.42","22.61"
"66","000","00","060","0005","0691","546","293","253","1","547","1331","0","41.10","22.01"
"66","000","00","060","0005","0692","523","288","235","3","526","1316","0","39.97","21.88"
"66","000","00","060","0005","0693","543","307","236","5","548","1309","0","41.86","23.45"
"66","000","00","060","0005","0694","647","321","326","10","657","1497","0","43.89","21.44"
"66","000","00","060","0005","0695","546","313","233","7","553","1271","0","43.51","24.63"
"66","000","00","060","0005","0696","763","393","370","6","769","1704","0","45.13","23.06"
"66","000","00","060","0005","0697","509","281","228","5","514","1229","0","41.82","22.86"
"66","000","00","060","0005","0698","590","287","303","6","596","1213","0","49.13","23.66"
"66","000","00","060","0005","0699","505","276","229","1","506","1167","0","43.36","23.65"
"66","000","00","060","0006","0000","1974","1068","906","19","1993","5016","0","39.73","21.29"
"66","000","00","060","0006","0700","514","280","234","1","515","1290","0","39.92","21.71"
"66","000","00","060","0006","0701","481","240","241","4","485","1201","0","40.38","19.98"
"66","000","00","060","0006","0702","475","280","195","7","482","1236","0","39.00","22.65"
"66","000","00","060","0006","0703","504","268","236","7","511","1289","0","39.64","20.79"
"66","000","00","060","0007","0000","1754","919","835","7","1761","4314","0","40.82","21.30"
"66","000","00","060","0007","0711","580","312","268","1","581","1517","0","38.30","20.57"
"66","000","00","060","0007","0712","580","312","268","4","584","1383","0","42.23","22.56"
"66","000","00","060","0007","0713","594","295","299","2","596","1414","0","42.15","20.86"
"66","000","00","060","0008","0000","1246","1077","169","11","1257","2619","0","48.00","41.12"
"66","000","00","060","0008","0718","635","553","82","5","640","1334","0","47.98","41.45"
"66","000","00","060","0008","0719","611","524","87","6","617","1285","0","48.02","40.78"
"66","000","00","060","0009","0000","2194","1081","1113","22","2216","5075","0","43.67","21.30"
"66","000","00","060","0009","0734","596","278","318","5","601","1329","0","45.22","20.92"
"66","000","00","060","0009","0735","529","279","250","5","534","1247","0","42.82","22.37"
"66","000","00","060","0009","0736","539","262","277","5","544","1331","0","40.87","19.68"
"66","000","00","060","0009","0737","530","262","268","7","537","1168","0","45.98","22.43"
"66","000","00","060","0010","0000","1354","653","701","7","1361","3200","0","42.53","20.41"
"66","000","00","060","0010","0720","445","228","217","2","447","1041","0","42.94","21.90"
"66","000","00","060","0010","0721","458","218","240","3","461","1017","0","45.33","21.44"
"66","000","00","060","0010","0722","451","207","244","2","453","1142","0","39.67","18.13"
"66","000","00","060","0011","0000","1798","801","997","16","1814","3726","0","48.68","21.50"
"66","000","00","060","0011","0754","578","252","326","8","586","1232","0","47.56","20.45"
"66","000","00","060","0011","0755","646","268","378","6","652","1225","0","53.22","21.88"
"66","000","00","060","0011","0756","574","281","293","2","576","1269","0","45.39","22.14"
"66","000","00","060","0012","0000","1021","882","139","20","1041","2082","0","50.00","42.36"
"66","000","00","060","0012","0757","503","433","70","7","510","1013","0","50.35","42.74"
"66","000","00","060","0012","0758","518","449","69","13","531","1069","0","49.67","42.00"
"66","000","00","060","0013","0000","1356","777","579","17","1373","3255","0","42.18","23.87"
"66","000","00","060","0013","0759","421","238","183","8","429","1038","0","41.33","22.93"
"66","000","00","060","0013","0760","418","213","205","4","422","1068","0","39.51","19.94"
"66","000","00","060","0013","0761","517","326","191","5","522","1149","0","45.43","28.37"
"66","000","00","060","0014","0000","1994","1116","878","13","2007","4745","0","42.30","23.52"
"66","000","00","060","0014","0762","589","312","277","3","592","1226","0","48.29","25.45"
"66","000","00","060","0014","0763","488","295","193","6","494","1220","0","40.49","24.18"
"66","000","00","060","0014","0764","552","299","253","2","554","1331","0","41.62","22.46"
"66","000","00","060","0014","0765","365","210","155","2","367","968","0","37.91","21.69"
"66","000","00","060","0015","0000","2124","1072","1052","19","2143","4944","0","43.35","21.68"
"66","000","00","060","0015","0766","475","186","289","7","482","1149","0","41.95","16.19"
"66","000","00","060","0015","0767","573","319","254","5","578","1282","0","45.09","24.88"
"66","000","00","060","0015","0768","528","289","239","3","531","1213","0","43.78","23.83"
"66","000","00","060","0015","0769","548","278","270","4","552","1300","0","42.46","21.38"
"66","000","00","060","0016","0000","1044","432","612","9","1053","2324","0","45.31","18.59"
"66","000","00","060","0016","0770","562","227","335","7","569","1257","0","45.27","18.06"
"66","000","00","060","0016","0771","482","205","277","2","484","1067","0","45.36","19.21"
"66","000","00","060","0017","0000","1427","794","633","14","1441","3398","0","42.41","23.37"
"66","000","00","060","0017","0772","532","341","191","3","535","1117","0","47.90","30.53"
"66","000","00","060","0017","0773","486","231","255","6","492","1182","0","41.62","19.54"
"66","000","00","060","0017","0774","409","222","187","5","414","1099","0","37.67","20.20"
"66","000","00","060","0018","0000","4990","2691","2299","41","5031","12696","0","39.63","21.20"
"66","000","00","060","0018","0775","656","257","399","10","666","1561","0","42.66","16.46"
"66","000","00","060","0018","0776","637","368","269","4","641","1432","0","44.76","25.70"
"66","000","00","060","0018","0777","596","303","293","2","598","1367","0","43.75","22.17"
"66","000","00","060","0018","0778","535","335","200","3","538","1387","0","38.79","24.15"
"66","000","00","060","0018","0779","520","271","249","3","523","1356","0","38.57","19.99"
"66","000","00","060","0018","0780","562","312","250","4","566","1397","0","40.52","22.33"
"66","000","00","060","0018","0781","494","286","208","6","500","1400","0","35.71","20.43"
"66","000","00","060","0018","0782","494","294","200","6","500","1401","0","35.69","20.99"
"66","000","00","060","0018","0783","496","265","231","3","499","1395","0","35.77","19.00"
"66","000","00","060","0019","0000","1346","736","610","16","1362","2940","0","46.33","25.03"
"66","000","00","060","0019","0784","694","368","326","9","703","1552","0","45.30","23.71"
"66","000","00","060","0019","0785","652","368","284","7","659","1388","0","47.48","26.51"
"66","000","00","060","0020","0000","1934","903","1031","15","1949","4642","0","41.99","19.45"
"66","000","00","060","0020","0810","514","239","275","6","520","1253","0","41.50","19.07"
"66","000","00","060","0020","0811","492","200","292","3","495","1123","0","44.08","17.81"
"66","000","00","060","0020","0812","444","229","215","3","447","1130","0","39.56","20.27"
"66","000","00","060","0020","0813","484","235","249","3","487","1136","0","42.87","20.69"
"66","000","00","060","0021","0000","2650","1327","1323","26","2676","6083","0","43.99","21.81"
"66","000","00","060","0021","0738","603","326","277","5","608","1478","0","41.14","22.06"
"66","000","00","060","0021","0739","634","308","326","5","639","1405","0","45.48","21.92"
"66","000","00","060","0021","0740","609","294","315","7","616","1367","0","45.06","21.51"
"66","000","00","060","0021","0741","385","190","195","2","387","890","0","43.48","21.35"
"66","000","00","060","0021","0742","419","209","210","7","426","943","0","45.17","22.16"
"66","000","00","060","0022","0000","1566","784","782","19","1585","3633","0","43.63","21.58"
"66","000","00","060","0022","0743","528","267","261","5","533","1229","0","43.37","21.72"
"66","000","00","060","0022","0744","541","273","268","7","548","1171","0","46.80","23.31"
"66","000","00","060","0022","0745","497","244","253","7","504","1233","0","40.88","19.79"
"66","000","00","060","0023","0000","2872","1571","1301","22","2894","6639","0","43.59","23.66"
"66","000","00","060","0023","0749","535","280","255","9","544","1243","0","43.77","22.53"
"66","000","00","060","0023","0750","562","306","256","1","563","1257","0","44.79","24.34"
"66","000","00","060","0023","0751","563","307","256","4","567","1319","0","42.99","23.28"
"66","000","00","060","0023","0752","634","353","281","3","637","1430","0","44.55","24.69"
"66","000","00","060","0023","0753","578","325","253","5","583","1390","0","41.94","23.38"
"66","000","00","060","0024","0000","1964","1220","744","15","1979","4807","0","41.17","25.38"
"66","000","00","060","0024","0675","458","288","170","1","459","1133","0","40.51","25.42"
"66","000","00","060","0024","0676","512","295","217","5","517","1296","0","39.89","22.76"
"66","000","00","060","0024","0677","573","424","149","6","579","1232","0","47.00","34.42"
"66","000","00","060","0024","0678","421","213","208","3","424","1146","0","37.00","18.59"
"66","000","00","060","0025","0000","1971","1048","923","10","1981","4097","0","48.35","25.58"
"66","000","00","060","0025","0726","647","350","297","3","650","1333","0","48.76","26.26"
"66","000","00","060","0025","0727","685","386","299","4","689","1386","0","49.71","27.85"
"66","000","00","060","0025","0728","639","312","327","3","642","1378","0","46.59","22.64"
"66","000","00","060","0026","0000","1904","1027","877","23","1927","4381","0","43.99","23.44"
"66","000","00","060","0026","0672","690","390","300","7","697","1616","0","43.13","24.13"
"66","000","00","060","0026","0673","567","295","272","9","576","1292","0","44.58","22.83"
"66","000","00","060","0026","0674","647","342","305","7","654","1473","0","44.40","23.22"
"66","000","00","060","0027","0000","2301","1238","1063","25","2326","5223","0","44.53","23.70"
"66","000","00","060","0027","0704","637","348","289","5","642","1385","0","46.35","25.13"
"66","000","00","060","0027","0705","562","268","294","9","571","1303","0","43.82","20.57"
"66","000","00","060","0027","0706","528","309","219","5","533","1286","0","41.45","24.03"
"66","000","00","060","0027","0707","574","313","261","6","580","1249","0","46.44","25.06"
"66","000","00","060","0028","0000","1872","1066","806","15","1887","4120","0","45.80","25.87"
"66","000","00","060","0028","0708","669","360","309","6","675","1380","0","48.91","26.09"
"66","000","00","060","0028","0709","570","340","230","6","576","1350","0","42.67","25.19"
"66","000","00","060","0028","0710","633","366","267","3","636","1390","0","45.76","26.33"
"66","000","00","060","0029","0000","2435","1340","1095","15","2450","5257","0","46.60","25.49"
"66","000","00","060","0029","0714","655","317","338","7","662","1425","0","46.46","22.25"
"66","000","00","060","0029","0715","601","354","247","2","603","1214","0","49.67","29.16"
"66","000","00","060","0029","0716","612","360","252","3","615","1307","0","47.05","27.54"
"66","000","00","060","0029","0717","567","309","258","3","570","1311","0","43.48","23.57"
"66","000","00","060","0030","0000","1688","836","852","9","1697","3558","0","47.70","23.50"
"66","000","00","060","0030","0723","613","288","325","2","615","1179","0","52.16","24.43"
"66","000","00","060","0030","0724","544","275","269","2","546","1194","0","45.73","23.03"
"66","000","00","060","0030","0725","531","273","258","5","536","1185","0","45.23","23.04"
"66","000","00","060","0031","0000","3073","1580","1493","17","3090","7080","0","43.64","22.32"
"66","000","00","060","0031","0729","650","335","315","2","652","1438","0","45.34","23.30"
"66","000","00","060","0031","0730","590","296","294","3","593","1449","0","40.92","20.43"
"66","000","00","060","0031","0731","624","310","314","3","627","1402","0","44.72","22.11"
"66","000","00","060","0031","0732","644","326","318","3","647","1403","0","46.12","23.24"
"66","000","00","060","0031","0733","565","313","252","6","571","1388","0","41.14","22.55"
"66","000","00","060","0032","0000","1965","970","995","9","1974","4322","0","45.67","22.44"
"66","000","00","060","0032","0746","644","340","304","2","646","1423","0","45.40","23.89"
"66","000","00","060","0032","0747","664","327","337","4","668","1428","0","46.78","22.90"
"66","000","00","060","0032","0748","657","303","354","3","660","1471","0","44.87","20.60"
"66","000","00","060","0033","0000","1763","733","1030","15","1778","4278","0","41.56","17.13"
"66","000","00","060","0033","0800","628","263","365","7","635","1474","0","43.08","17.84"
"66","000","00","060","0033","0801","580","220","360","6","586","1430","0","40.98","15.38"
"66","000","00","060","0033","0802","555","250","305","2","557","1374","0","40.54","18.20"
"66","000","00","060","0034","0000","1379","720","659","10","1389","3203","0","43.37","22.48"
"66","000","00","060","0034","0803","504","281","223","2","506","1105","0","45.79","25.43"
"66","000","00","060","0034","0804","467","244","223","4","471","1048","0","44.94","23.28"
"66","000","00","060","0034","0805","408","195","213","4","412","1050","0","39.24","18.57"
"66","000","00","060","0035","0000","2251","1273","978","18","2269","4778","0","47.49","26.64"
"66","000","00","060","0035","0806","574","319","255","3","577","1252","0","46.09","25.48"
"66","000","00","060","0035","0807","540","308","232","2","542","1183","0","45.82","26.04"
"66","000","00","060","0035","0808","541","327","214","7","548","1195","0","45.86","27.36"
"66","000","00","060","0035","0809","596","319","277","6","602","1148","0","52.44","27.79"
"66","000","00","060","0036","0000","1116","618","498","15","1131","3166","0","35.72","19.52"
"66","000","00","060","0036","0798","575","339","236","6","581","1626","0","35.73","20.85"
"66","000","00","060","0036","0799","541","279","262","9","550","1540","0","35.71","18.12"
"66","000","00","060","0037","0000","1120","664","456","9","1129","2980","0","37.89","22.28"
"66","000","00","060","0037","0796","588","344","244","3","591","1523","0","38.80","22.59"
"66","000","00","060","0037","0797","532","320","212","6","538","1457","0","36.93","21.96"
"66","000","00","060","0038","0000","3359","1938","1421","37","3396","7655","0","44.36","25.32"
"66","000","00","060","0038","0790","499","273","226","1","500","1275","0","39.22","21.41"
"66","000","00","060","0038","0791","567","351","216","11","578","1255","0","46.06","27.97"
"66","000","00","060","0038","0792","624","347","277","5","629","1404","0","44.80","24.72"
"66","000","00","060","0038","0793","557","282","275","7","564","1235","0","45.67","22.83"
"66","000","00","060","0038","0794","593","371","222","8","601","1274","0","47.17","29.12"
"66","000","00","060","0038","0795","519","314","205","5","524","1212","0","43.23","25.91"
"66","000","00","060","0039","0000","2466","1349","1117","13","2479","5769","0","42.97","23.38"
"66","000","00","060","0039","0786","622","323","299","6","628","1410","0","44.54","22.91"
"66","000","00","060","0039","0787","636","359","277","0","636","1394","0","45.62","25.75"
"66","000","00","060","0039","0788","643","335","308","5","648","1541","0","42.05","21.74"
"66","000","00","060","0039","0789","565","332","233","2","567","1424","0","39.82","23.31"
"66","000","00","070","0000","0000","62038","31888","30150","528","62566","142512","176754","43.90","22.38"
"66","000","00","070","0001","0000","3774","1902","1872","39","3813","8528","0","44.71","22.30"
"66","000","00","070","0001","0814","536","281","255","7","543","1220","0","44.51","23.03"
"66","000","00","070","0001","0815","548","239","309","9","557","1255","0","44.38","19.04"
"66","000","00","070","0001","0816","494","189","305","5","499","1129","0","44.20","16.74"
"66","000","00","070","0001","0817","615","268","347","4","619","1326","0","46.68","20.21"
"66","000","00","070","0001","0818","544","321","223","7","551","1272","0","43.32","25.24"
"66","000","00","070","0001","0819","561","325","236","4","565","1203","0","46.97","27.02"
"66","000","00","070","0001","0820","476","279","197","3","479","1123","0","42.65","24.84"
"66","000","00","070","0002","0000","5217","2646","2571","48","5265","11358","0","46.35","23.30"
"66","000","00","070","0002","0821","594","269","325","6","600","1414","0","42.43","19.02"
"66","000","00","070","0002","0822","617","292","325","8","625","1396","0","44.77","20.92"
"66","000","00","070","0002","0823","727","401","326","4","731","1591","0","45.95","25.20"
"66","000","00","070","0002","0824","651","326","325","13","664","1440","0","46.11","22.64"
"66","000","00","070","0002","0825","592","320","272","4","596","1349","0","44.18","23.72"
"66","000","00","070","0002","0826","649","326","323","2","651","1365","0","47.69","23.88"
"66","000","00","070","0002","0827","693","352","341","3","696","1434","0","48.54","24.55"
"66","000","00","070","0002","0828","694","360","334","8","702","1369","0","51.28","26.30"
"66","000","00","070","0003","0000","2806","1322","1484","27","2833","5891","0","48.09","22.44"
"66","000","00","070","0003","0829","678","330","348","6","684","1480","0","46.22","22.30"
"66","000","00","070","0003","0830","734","316","418","5","739","1525","0","48.46","20.72"
"66","000","00","070","0003","0831","697","329","368","7","704","1412","0","49.86","23.30"
"66","000","00","070","0003","0832","697","347","350","9","706","1474","0","47.90","23.54"
"66","000","00","070","0004","0000","1860","765","1095","16","1876","4324","0","43.39","17.69"
"66","000","00","070","0004","0833","616","257","359","9","625","1498","0","41.72","17.16"
"66","000","00","070","0004","0834","591","252","339","1","592","1384","0","42.77","18.21"
"66","000","00","070","0004","0835","653","256","397","6","659","1442","0","45.70","17.75"
"66","000","00","070","0005","0000","2460","1301","1159","25","2485","6534","0","38.03","19.91"
"66","000","00","070","0005","0838","485","226","259","9","494","1156","0","42.73","19.55"
"66","000","00","070","0005","0839","524","282","242","2","526","1270","0","41.42","22.20"
"66","000","00","070","0005","0840","509","277","232","4","513","1282","0","40.02","21.61"
"66","000","00","070","0005","0841","510","275","235","7","517","1358","0","38.07","20.25"
"66","000","00","070","0005","0842","432","241","191","3","435","1468","0","29.63","16.42"
"66","000","00","070","0006","0000","492","268","224","5","497","1366","0","36.38","19.62"
"66","000","00","070","0006","0843","492","268","224","5","497","1366","0","36.38","19.62"
"66","000","00","070","0007","0000","4276","2142","2134","30","4306","11272","0","38.20","19.00"
"66","000","00","070","0007","0844","453","218","235","4","457","1326","0","34.46","16.44"
"66","000","00","070","0007","0845","506","264","242","6","512","1248","0","41.03","21.15"
"66","000","00","070","0007","0846","471","228","243","3","474","1233","0","38.44","18.49"
"66","000","00","070","0007","0847","530","292","238","4","534","1433","0","37.26","20.38"
"66","000","00","070","0007","0848","581","265","316","1","582","1434","0","40.59","18.48"
"66","000","00","070","0007","0849","503","264","239","4","507","1405","0","36.09","18.79"
"66","000","00","070","0007","0850","634","308","326","6","640","1489","0","42.98","20.69"
"66","000","00","070","0007","0851","598","303","295","2","600","1704","0","35.21","17.78"
"66","000","00","070","0008","0000","914","438","476","5","919","2301","0","39.94","19.04"
"66","000","00","070","0008","0856","432","186","246","5","437","956","0","45.71","19.46"
"66","000","00","070","0008","0857","482","252","230","0","482","1345","0","35.84","18.74"
"66","000","00","070","0009","0000","2136","974","1162","20","2156","5105","0","42.23","19.08"
"66","000","00","070","0009","0858","510","239","271","5","515","1227","0","41.97","19.48"
"66","000","00","070","0009","0859","495","234","261","4","499","1207","0","41.34","19.39"
"66","000","00","070","0009","0860","538","219","319","7","545","1292","0","42.18","16.95"
"66","000","00","070","0009","0861","593","282","311","4","597","1379","0","43.29","20.45"
"66","000","00","070","0010","0000","2981","1583","1398","31","3012","7137","0","42.20","22.18"
"66","000","00","070","0010","0862","609","269","340","6","615","1334","0","46.10","20.16"
"66","000","00","070","0010","0863","619","345","274","3","622","1400","0","44.43","24.64"
"66","000","00","070","0010","0864","570","285","285","5","575","1397","0","41.16","20.40"
"66","000","00","070","0010","0865","621","345","276","10","631","1581","0","39.91","21.82"
"66","000","00","070","0010","0866","562","339","223","7","569","1425","0","39.93","23.79"
"66","000","00","070","0011","0000","2629","1402","1227","20","2649","5220","0","50.75","26.86"
"66","000","00","070","0011","0882","595","310","285","3","598","1150","0","52.00","26.96"
"66","000","00","070","0011","0883","667","348","319","9","676","1358","0","49.78","25.63"
"66","000","00","070","0011","0884","708","351","357","3","711","1425","0","49.89","24.63"
"66","000","00","070","0011","0885","659","393","266","5","664","1287","0","51.59","30.54"
"66","000","00","070","0012","0000","2755","1342","1413","31","2786","6268","0","44.45","21.41"
"66","000","00","070","0012","0896","745","389","356","6","751","1580","0","47.53","24.62"
"66","000","00","070","0012","0897","699","306","393","9","708","1498","0","47.26","20.43"
"66","000","00","070","0012","0898","696","343","353","7","703","1634","0","43.02","20.99"
"66","000","00","070","0012","0899","615","304","311","9","624","1556","0","40.10","19.54"
"66","000","00","070","0013","0000","1959","1181","778","12","1971","4151","0","47.48","28.45"
"66","000","00","070","0013","0878","517","335","182","2","519","951","0","54.57","35.23"
"66","000","00","070","0013","0879","469","293","176","3","472","1051","0","44.91","27.88"
"66","000","00","070","0013","0880","426","259","167","2","428","974","0","43.94","26.59"
"66","000","00","070","0013","0881","547","294","253","5","552","1175","0","46.98","25.02"
"66","000","00","070","0014","0000","576","223","353","13","589","1357","0","43.40","16.43"
"66","000","00","070","0014","0836","242","99","143","8","250","578","0","43.25","17.13"
"66","000","00","070","0014","0837","334","124","210","5","339","779","0","43.52","15.92"
"66","000","00","070","0015","0000","2274","1103","1171","11","2285","4877","0","46.85","22.62"
"66","000","00","070","0015","0910","593","296","297","3","596","1375","0","43.35","21.53"
"66","000","00","070","0015","0911","520","233","287","4","524","1133","0","46.25","20.56"
"66","000","00","070","0015","0912","593","283","310","2","595","1183","0","50.30","23.92"
"66","000","00","070","0015","0913","568","291","277","2","570","1186","0","48.06","24.54"
"66","000","00","070","0016","0000","1726","888","838","21","1747","3803","0","45.94","23.35"
"66","000","00","070","0016","0903","590","323","267","11","601","1233","0","48.74","26.20"
"66","000","00","070","0016","0904","617","304","313","7","624","1430","0","43.64","21.26"
"66","000","00","070","0016","0905","519","261","258","3","522","1140","0","45.79","22.89"
"66","000","00","070","0017","0000","2238","1178","1060","28","2266","5223","0","43.39","22.55"
"66","000","00","070","0017","0906","622","364","258","4","626","1499","0","41.76","24.28"
"66","000","00","070","0017","0907","679","367","312","5","684","1567","0","43.65","23.42"
"66","000","00","070","0017","0908","455","224","231","9","464","1019","0","45.53","21.98"
"66","000","00","070","0017","0909","482","223","259","10","492","1138","0","43.23","19.60"
"66","000","00","070","0018","0000","2162","1132","1030","19","2181","5433","0","40.14","20.84"
"66","000","00","070","0018","0900","751","358","393","5","756","1634","0","46.27","21.91"
"66","000","00","070","0018","0901","761","395","366","5","766","2281","0","33.58","17.32"
"66","000","00","070","0018","0902","650","379","271","9","659","1518","0","43.41","24.97"
"66","000","00","070","0019","0000","1644","849","795","10","1654","3609","0","45.83","23.52"
"66","000","00","070","0019","0917","515","268","247","3","518","1099","0","47.13","24.39"
"66","000","00","070","0019","0918","600","317","283","1","601","1292","0","46.52","24.54"
"66","000","00","070","0019","0919","529","264","265","6","535","1218","0","43.92","21.67"
"66","000","00","070","0020","0000","1993","958","1035","18","2011","4436","0","45.33","21.60"
"66","000","00","070","0020","0914","616","310","306","7","623","1289","0","48.33","24.05"
"66","000","00","070","0020","0915","655","308","347","5","660","1587","0","41.59","19.41"
"66","000","00","070","0020","0916","722","340","382","6","728","1560","0","46.67","21.79"
"66","000","00","070","0021","0000","3027","1612","1415","10","3037","6517","0","46.60","24.74"
"66","000","00","070","0021","0886","570","325","245","3","573","1209","0","47.39","26.88"
"66","000","00","070","0021","0887","584","316","268","0","584","1313","0","44.48","24.07"
"66","000","00","070","0021","0888","556","290","266","3","559","1259","0","44.40","23.03"
"66","000","00","070","0021","0889","617","313","304","1","618","1429","0","43.25","21.90"
"66","000","00","070","0021","0890","700","368","332","3","703","1307","0","53.79","28.16"
"66","000","00","070","0022","0000","3386","1804","1582","22","3408","7565","0","45.05","23.85"
"66","000","00","070","0022","0891","730","380","350","6","736","1629","0","45.18","23.33"
"66","000","00","070","0022","0892","625","353","272","3","628","1434","0","43.79","24.62"
"66","000","00","070","0022","0893","641","356","285","0","641","1470","0","43.61","24.22"
"66","000","00","070","0022","0894","646","345","301","8","654","1442","0","45.35","23.93"
"66","000","00","070","0022","0895","744","370","374","5","749","1590","0","47.11","23.27"
"66","000","00","070","0023","0000","2062","1035","1027","12","2074","5266","0","39.38","19.65"
"66","000","00","070","0023","0852","512","240","272","3","515","1275","0","40.39","18.82"
"66","000","00","070","0023","0853","447","203","244","2","449","1224","0","36.68","16.58"
"66","000","00","070","0023","0854","544","296","248","3","547","1334","0","41.00","22.19"
"66","000","00","070","0023","0855","559","296","263","4","563","1433","0","39.29","20.66"
"66","000","00","070","0024","0000","3778","2198","1580","41","3819","8478","0","45.05","25.93"
"66","000","00","070","0024","0872","656","375","281","5","661","1420","0","46.55","26.41"
"66","000","00","070","0024","0873","681","441","240","10","691","1475","0","46.85","29.90"
"66","000","00","070","0024","0874","685","383","302","11","696","1551","0","44.87","24.69"
"66","000","00","070","0024","0875","625","352","273","3","628","1345","0","46.69","26.17"
"66","000","00","070","0024","0876","573","327","246","7","580","1316","0","44.07","24.85"
"66","000","00","070","0024","0877","558","320","238","5","563","1371","0","41.06","23.34"
"66","000","00","070","0025","0000","2913","1642","1271","14","2927","6493","0","45.08","25.29"
"66","000","00","070","0025","0867","591","337","254","1","592","1339","0","44.21","25.17"
"66","000","00","070","0025","0868","552","332","220","2","554","1304","0","42.48","25.46"
"66","000","00","070","0025","0869","617","359","258","4","621","1290","0","48.14","27.83"
"66","000","00","070","0025","0870","604","317","287","4","608","1303","0","46.66","24.33"
"66","000","00","070","0025","0871","549","297","252","3","552","1257","0","43.91","23.63"
"66","000","00","080","0000","0000","101655","54146","47509","772","102427","238830","289830","42.89","22.67"
"66","000","00","080","0001","0000","1425","744","681","16","1441","3133","0","45.99","23.75"
"66","000","00","080","0001","0974","361","187","174","3","364","894","0","40.72","20.92"
"66","000","00","080","0001","0975","546","279","267","8","554","1150","0","48.17","24.26"
"66","000","00","080","0001","0976","518","278","240","5","523","1089","0","48.03","25.53"
"66","000","00","080","0002","0000","1476","823","653","7","1483","3392","0","43.72","24.26"
"66","000","00","080","0002","0968","524","270","254","4","528","1199","0","44.04","22.52"
"66","000","00","080","0002","0969","453","274","179","1","454","1081","0","42.00","25.35"
"66","000","00","080","0002","0970","499","279","220","2","501","1112","0","45.05","25.09"
"66","000","00","080","0003","0000","3038","1658","1380","28","3066","6954","0","44.09","23.84"
"66","000","00","080","0003","0920","599","356","243","7","606","1156","0","52.42","30.80"
"66","000","00","080","0003","0921","510","296","214","2","512","1215","0","42.14","24.36"
"66","000","00","080","0003","0922","435","231","204","3","438","1180","0","37.12","19.58"
"66","000","00","080","0003","0923","505","245","260","5","510","1178","0","43.29","20.80"
"66","000","00","080","0003","0924","474","239","235","5","479","1135","0","42.20","21.06"
"66","000","00","080","0003","0925","515","291","224","6","521","1090","0","47.80","26.70"
"66","000","00","080","0004","0000","2398","1287","1111","20","2418","5705","0","42.38","22.56"
"66","000","00","080","0004","0982","437","251","186","1","438","1072","0","40.86","23.41"
"66","000","00","080","0004","0983","555","262","293","8","563","1241","0","45.37","21.11"
"66","000","00","080","0004","0984","482","239","243","2","484","1103","0","43.88","21.67"
"66","000","00","080","0004","0985","434","237","197","2","436","1122","0","38.86","21.12"
"66","000","00","080","0004","0986","490","298","192","7","497","1167","0","42.59","25.54"
"66","000","00","080","0005","0000","2096","1185","911","10","2106","5097","0","41.32","23.25"
"66","000","00","080","0005","0991","529","272","257","3","532","1209","0","44.00","22.50"
"66","000","00","080","0005","0992","498","305","193","4","502","1196","0","41.97","25.50"
"66","000","00","080","0005","0993","580","325","255","1","581","1390","0","41.80","23.38"
"66","000","00","080","0005","0994","489","283","206","2","491","1302","0","37.71","21.74"
"66","000","00","080","0006","0000","1943","1029","914","17","1960","4595","0","42.66","22.39"
"66","000","00","080","0006","1046","452","232","220","7","459","1081","0","42.46","21.46"
"66","000","00","080","0006","1047","368","152","216","2","370","929","0","39.83","16.36"
"66","000","00","080","0006","1048","607","335","272","2","609","1260","0","48.33","26.59"
"66","000","00","080","0006","1049","516","310","206","6","522","1325","0","39.40","23.40"
"66","000","00","080","0007","0000","2929","1517","1412","23","2952","7211","0","40.94","21.04"
"66","000","00","080","0007","1104","771","406","365","6","777","1803","0","43.09","22.52"
"66","000","00","080","0007","1105","617","306","311","3","620","1632","0","37.99","18.75"
"66","000","00","080","0007","1106","558","282","276","7","565","1425","0","39.65","19.79"
"66","000","00","080","0007","1107","520","269","251","3","523","1241","0","42.14","21.68"
"66","000","00","080","0007","1108","463","254","209","4","467","1110","0","42.07","22.88"
"66","000","00","080","0008","0000","5911","2973","2938","41","5952","13462","0","44.21","22.08"
"66","000","00","080","0008","0952","514","275","239","0","514","1240","0","41.45","22.18"
"66","000","00","080","0008","0953","487","242","245","3","490","1191","0","41.14","20.32"
"66","000","00","080","0008","0954","516","269","247","6","522","1183","0","44.13","22.74"
"66","000","00","080","0008","0955","629","310","319","5","634","1279","0","49.57","24.24"
"66","000","00","080","0008","0956","571","254","317","2","573","1268","0","45.19","20.03"
"66","000","00","080","0008","0957","586","284","302","3","589","1272","0","46.31","22.33"
"66","000","00","080","0008","0958","569","301","268","1","570","1359","0","41.94","22.15"
"66","000","00","080","0008","0959","521","265","256","3","524","1234","0","42.46","21.47"
"66","000","00","080","0008","0960","545","286","259","8","553","1248","0","44.31","22.92"
"66","000","00","080","0008","0961","534","282","252","5","539","1171","0","46.03","24.08"
"66","000","00","080","0008","0962","439","205","234","5","444","1017","0","43.66","20.16"
"66","000","00","080","0009","0000","5442","2622","2820","49","5491","12347","0","44.47","21.24"
"66","000","00","080","0009","1079","507","236","271","8","515","1139","0","45.22","20.72"
"66","000","00","080","0009","1080","542","256","286","6","548","1194","0","45.90","21.44"
"66","000","00","080","0009","1081","598","314","284","3","601","1299","0","46.27","24.17"
"66","000","00","080","0009","1082","449","214","235","3","452","1172","0","38.57","18.26"
"66","000","00","080","0009","1083","515","292","223","6","521","1261","0","41.32","23.16"
"66","000","00","080","0009","1084","571","248","323","4","575","1201","0","47.88","20.65"
"66","000","00","080","0009","1085","627","298","329","5","632","1360","0","46.47","21.91"
"66","000","00","080","0009","1086","620","328","292","6","626","1336","0","46.86","24.55"
"66","000","00","080","0009","1087","492","236","256","0","492","1154","0","42.63","20.45"
"66","000","00","080","0009","1088","521","200","321","8","529","1231","0","42.97","16.25"
"66","000","00","080","0010","0000","4752","2325","2427","29","4781","11410","0","41.90","20.38"
"66","000","00","080","0010","1033","705","307","398","5","710","1594","0","44.54","19.26"
"66","000","00","080","0010","1034","501","198","303","4","505","1202","0","42.01","16.47"
"66","000","00","080","0010","1035","731","376","355","8","739","1444","0","51.18","26.04"
"66","000","00","080","0010","1036","606","327","279","3","609","1675","0","36.36","19.52"
"66","000","00","080","0010","1037","587","301","286","3","590","1364","0","43.26","22.07"
"66","000","00","080","0010","1038","473","253","220","4","477","1201","0","39.72","21.07"
"66","000","00","080","0010","1039","549","282","267","1","550","1529","0","35.97","18.44"
"66","000","00","080","0010","1040","600","281","319","1","601","1401","0","42.90","20.06"
"66","000","00","080","0011","0000","924","374","550","7","931","2030","0","45.86","18.42"
"66","000","00","080","0011","1044","524","202","322","3","527","1165","0","45.24","17.34"
"66","000","00","080","0011","1045","400","172","228","4","404","865","0","46.71","19.88"
"66","000","00","080","0012","0000","372","178","194","5","377","1008","0","37.40","17.66"
"66","000","00","080","0012","1019","372","178","194","5","377","1008","0","37.40","17.66"
"66","000","00","080","0013","0000","5451","2961","2490","40","5491","14177","0","38.73","20.89"
"66","000","00","080","0013","1096","698","399","299","10","708","2133","0","33.19","18.71"
"66","000","00","080","0013","1097","665","375","290","1","666","1606","0","41.47","23.35"
"66","000","00","080","0013","1098","554","263","291","5","559","1395","0","40.07","18.85"
"66","000","00","080","0013","1099","707","394","313","2","709","1774","0","39.97","22.21"
"66","000","00","080","0013","1100","604","321","283","4","608","1463","0","41.56","21.94"
"66","000","00","080","0013","1101","652","379","273","3","655","1773","0","36.94","21.38"
"66","000","00","080","0013","1102","917","495","422","8","925","2505","0","36.93","19.76"
"66","000","00","080","0013","1103","654","335","319","7","661","1528","0","43.26","21.92"
"66","000","00","080","0014","0000","905","429","476","13","918","2160","0","42.50","19.86"
"66","000","00","080","0014","0931","456","191","265","8","464","1063","0","43.65","17.97"
"66","000","00","080","0014","0932","449","238","211","5","454","1097","0","41.39","21.70"
"66","000","00","080","0015","0000","357","166","191","2","359","905","0","39.67","18.34"
"66","000","00","080","0015","1020","357","166","191","2","359","905","0","39.67","18.34"
"66","000","00","080","0016","0000","3875","2171","1704","26","3901","8784","0","44.41","24.72"
"66","000","00","080","0016","1054","514","269","245","3","517","1170","0","44.19","22.99"
"66","000","00","080","0016","1055","519","333","186","4","523","1113","0","46.99","29.92"
"66","000","00","080","0016","1056","537","265","272","3","540","1174","0","46.00","22.57"
"66","000","00","080","0016","1057","519","268","251","3","522","1126","0","46.36","23.80"
"66","000","00","080","0016","1058","624","363","261","5","629","1416","0","44.42","25.64"
"66","000","00","080","0016","1059","575","331","244","4","579","1337","0","43.31","24.76"
"66","000","00","080","0016","1060","587","342","245","4","591","1448","0","40.81","23.62"
"66","000","00","080","0017","0000","3505","1758","1747","28","3533","9231","0","38.27","19.04"
"66","000","00","080","0017","0937","514","261","253","2","516","1107","0","46.61","23.58"
"66","000","00","080","0017","0938","494","288","206","3","497","1201","0","41.38","23.98"
"66","000","00","080","0017","0939","279","157","122","1","280","1948","0","14.37","8.06"
"66","000","00","080","0017","0940","527","251","276","10","537","1165","0","46.09","21.55"
"66","000","00","080","0017","0941","565","234","331","5","570","1231","0","46.30","19.01"
"66","000","00","080","0017","0942","513","252","261","5","518","1282","0","40.41","19.66"
"66","000","00","080","0017","0943","613","315","298","2","615","1297","0","47.42","24.29"
"66","000","00","080","0018","0000","3989","2042","1947","26","4015","9374","0","42.83","21.78"
"66","000","00","080","0018","0944","409","217","192","3","412","1044","0","39.46","20.79"
"66","000","00","080","0018","0945","445","245","200","0","445","1141","0","39.00","21.47"
"66","000","00","080","0018","0946","623","327","296","2","625","1323","0","47.24","24.72"
"66","000","00","080","0018","0947","489","227","262","4","493","1250","0","39.44","18.16"
"66","000","00","080","0018","0948","621","316","305","7","628","1543","0","40.70","20.48"
"66","000","00","080","0018","0949","696","344","352","6","702","1601","0","43.85","21.49"
"66","000","00","080","0018","0950","706","366","340","4","710","1472","0","48.23","24.86"
"66","000","00","080","0019","0000","692","354","338","5","697","1525","0","45.70","23.21"
"66","000","00","080","0019","0977","692","354","338","5","697","1525","0","45.70","23.21"
"66","000","00","080","0020","0000","4324","2619","1705","33","4357","9850","0","44.23","26.59"
"66","000","00","080","0020","1025","542","336","206","1","543","1258","0","43.16","26.71"
"66","000","00","080","0020","1026","426","268","158","1","427","1016","0","42.03","26.38"
"66","000","00","080","0020","1027","611","384","227","4","615","1250","0","49.20","30.72"
"66","000","00","080","0020","1028","547","300","247","3","550","1324","0","41.54","22.66"
"66","000","00","080","0020","1029","533","331","202","7","540","1210","0","44.63","27.36"
"66","000","00","080","0020","1030","512","308","204","6","518","1178","0","43.97","26.15"
"66","000","00","080","0020","1031","565","321","244","6","571","1337","0","42.71","24.01"
"66","000","00","080","0020","1032","588","371","217","5","593","1277","0","46.44","29.05"
"66","000","00","080","0021","0000","2411","1302","1109","15","2426","5327","0","45.54","24.44"
"66","000","00","080","0021","1021","700","344","356","9","709","1527","0","46.43","22.53"
"66","000","00","080","0021","1022","571","323","248","1","572","1230","0","46.50","26.26"
"66","000","00","080","0021","1023","546","299","247","3","549","1287","0","42.66","23.23"
"66","000","00","080","0021","1024","594","336","258","2","596","1283","0","46.45","26.19"
"66","000","00","080","0022","0000","479","279","200","3","482","1046","0","46.08","26.67"
"66","000","00","080","0022","0951","479","279","200","3","482","1046","0","46.08","26.67"
"66","000","00","080","0023","0000","2965","1539","1426","37","3002","6614","0","45.39","23.27"
"66","000","00","080","0023","0963","595","336","259","8","603","1355","0","44.50","24.80"
"66","000","00","080","0023","0964","555","314","241","6","561","1334","0","42.05","23.54"
"66","000","00","080","0023","0965","619","274","345","5","624","1246","0","50.08","21.99"
"66","000","00","080","0023","0966","611","337","274","11","622","1425","0","43.65","23.65"
"66","000","00","080","0023","0967","585","278","307","7","592","1254","0","47.21","22.17"
"66","000","00","080","0024","0000","1930","1099","831","14","1944","4564","0","42.59","24.08"
"66","000","00","080","0024","1089","606","334","272","9","615","1420","0","43.31","23.52"
"66","000","00","080","0024","1090","450","252","198","0","450","1078","0","41.74","23.38"
"66","000","00","080","0024","1091","399","198","201","3","402","1013","0","39.68","19.55"
"66","000","00","080","0024","1092","475","315","160","2","477","1053","0","45.30","29.91"
"66","000","00","080","0025","0000","1740","1020","720","18","1758","4248","0","41.38","24.01"
"66","000","00","080","0025","1093","585","329","256","8","593","1520","0","39.01","21.64"
"66","000","00","080","0025","1094","535","333","202","6","541","1223","0","44.24","27.23"
"66","000","00","080","0025","1095","620","358","262","4","624","1505","0","41.46","23.79"
"66","000","00","080","0026","0000","2360","1186","1174","17","2377","5130","0","46.34","23.12"
"66","000","00","080","0026","0987","519","267","252","2","521","1126","0","46.27","23.71"
"66","000","00","080","0026","0988","627","298","329","3","630","1263","0","49.88","23.59"
"66","000","00","080","0026","0989","587","324","263","4","591","1345","0","43.94","24.09"
"66","000","00","080","0026","0990","627","297","330","8","635","1396","0","45.49","21.28"
"66","000","00","080","0027","0000","1397","709","688","7","1404","3146","0","44.63","22.54"
"66","000","00","080","0027","1003","503","247","256","4","507","1079","0","46.99","22.89"
"66","000","00","080","0027","1004","391","209","182","2","393","958","0","41.02","21.82"
"66","000","00","080","0027","1005","503","253","250","1","504","1109","0","45.45","22.81"
"66","000","00","080","0028","0000","2611","1387","1224","16","2627","6176","0","42.54","22.46"
"66","000","00","080","0028","1009","554","282","272","7","561","1311","0","42.79","21.51"
"66","000","00","080","0028","1010","556","279","277","1","557","1311","0","42.49","21.28"
"66","000","00","080","0028","1011","542","300","242","2","544","1360","0","40.00","22.06"
"66","000","00","080","0028","1012","516","272","244","3","519","1215","0","42.72","22.39"
"66","000","00","080","0028","1013","443","254","189","3","446","979","0","45.56","25.94"
"66","000","00","080","0029","0000","2062","1057","1005","17","2079","4780","0","43.49","22.11"
"66","000","00","080","0029","1050","491","226","265","3","494","1120","0","44.11","20.18"
"66","000","00","080","0029","1051","436","207","229","2","438","1117","0","39.21","18.53"
"66","000","00","080","0029","1052","571","304","267","9","580","1350","0","42.96","22.52"
"66","000","00","080","0029","1053","564","320","244","3","567","1193","0","47.53","26.82"
"66","000","00","080","0030","0000","2253","1285","968","17","2270","5241","0","43.31","24.52"
"66","000","00","080","0030","1070","600","350","250","4","604","1269","0","47.60","27.58"
"66","000","00","080","0030","1071","544","334","210","5","549","1345","0","40.82","24.83"
"66","000","00","080","0030","1072","577","339","238","5","582","1286","0","45.26","26.36"
"66","000","00","080","0030","1073","532","262","270","3","535","1341","0","39.90","19.54"
"66","000","00","080","0031","0000","2260","1326","934","17","2277","4863","0","46.82","27.27"
"66","000","00","080","0031","0933","606","322","284","6","612","1356","0","45.13","23.75"
"66","000","00","080","0031","0934","466","268","198","4","470","1034","0","45.45","25.92"
"66","000","00","080","0031","0935","616","367","249","4","620","1282","0","48.36","28.63"
"66","000","00","080","0031","0936","572","369","203","3","575","1191","0","48.28","30.98"
"66","000","00","080","0032","0000","2724","1458","1266","16","2740","6705","0","40.87","21.74"
"66","000","00","080","0032","1074","508","259","249","2","510","1295","0","39.38","20.00"
"66","000","00","080","0032","1075","564","301","263","4","568","1323","0","42.93","22.75"
"66","000","00","080","0032","1076","543","302","241","4","547","1370","0","39.93","22.04"
"66","000","00","080","0032","1077","503","277","226","4","507","1265","0","40.08","21.90"
"66","000","00","080","0032","1078","606","319","287","2","608","1452","0","41.87","21.97"
"66","000","00","080","0033","0000","2254","1232","1022","18","2272","5153","0","44.09","23.91"
"66","000","00","080","0033","1066","489","237","252","6","495","1316","0","37.61","18.01"
"66","000","00","080","0033","1067","571","304","267","6","577","1235","0","46.72","24.62"
"66","000","00","080","0033","1068","563","326","237","2","565","1260","0","44.84","25.87"
"66","000","00","080","0033","1069","631","365","266","4","635","1342","0","47.32","27.20"
"66","000","00","080","0034","0000","1451","719","732","16","1467","3180","0","46.13","22.61"
"66","000","00","080","0034","0971","465","213","252","9","474","1083","0","43.77","19.67"
"66","000","00","080","0034","0972","402","184","218","3","405","879","0","46.08","20.93"
"66","000","00","080","0034","0973","584","322","262","4","588","1218","0","48.28","26.44"
"66","000","00","080","0035","0000","2015","1110","905","12","2027","4765","0","42.54","23.29"
"66","000","00","080","0035","0978","524","272","252","3","527","1164","0","45.27","23.37"
"66","000","00","080","0035","0979","488","289","199","3","491","1164","0","42.18","24.83"
"66","000","00","080","0035","0980","524","278","246","4","528","1211","0","43.60","22.96"
"66","000","00","080","0035","0981","479","271","208","2","481","1226","0","39.23","22.10"
"66","000","00","080","0036","0000","1601","897","704","14","1615","3560","0","45.37","25.20"
"66","000","00","080","0036","1006","577","311","266","5","582","1161","0","50.13","26.79"
"66","000","00","080","0036","1007","486","294","192","5","491","1210","0","40.58","24.30"
"66","000","00","080","0036","1008","538","292","246","4","542","1189","0","45.58","24.56"
"66","000","00","080","0037","0000","2476","1318","1158","18","2494","6410","0","38.91","20.56"
"66","000","00","080","0037","1061","484","240","244","5","489","1275","0","38.35","18.82"
"66","000","00","080","0037","1062","505","290","215","5","510","1210","0","42.15","23.97"
"66","000","00","080","0037","1063","429","224","205","2","431","1292","0","33.36","17.34"
"66","000","00","080","0037","1064","549","300","249","2","551","1303","0","42.29","23.02"
"66","000","00","080","0037","1065","509","264","245","4","513","1330","0","38.57","19.85"
"66","000","00","080","0038","0000","2064","1128","936","18","2082","4887","0","42.60","23.08"
"66","000","00","080","0038","0999","471","252","219","4","475","1151","0","41.27","21.89"
"66","000","00","080","0038","1000","541","303","238","7","548","1303","0","42.06","23.25"
"66","000","00","080","0038","1001","462","242","220","4","466","1166","0","39.97","20.75"
"66","000","00","080","0038","1002","590","331","259","3","593","1267","0","46.80","26.12"
"66","000","00","080","0039","0000","2724","1467","1257","21","2745","6741","0","40.72","21.76"
"66","000","00","080","0039","1014","491","265","226","3","494","1422","0","34.74","18.64"
"66","000","00","080","0039","1015","580","289","291","1","581","1458","0","39.85","19.82"
"66","000","00","080","0039","1016","498","228","270","3","501","1280","0","39.14","17.81"
"66","000","00","080","0039","1017","551","299","252","6","557","1302","0","42.78","22.96"
"66","000","00","080","0039","1018","604","386","218","8","612","1279","0","47.85","30.18"
"66","000","00","080","0040","0000","1878","991","887","12","1890","4376","0","43.19","22.65"
"66","000","00","080","0040","0995","474","250","224","1","475","1106","0","42.95","22.60"
"66","000","00","080","0040","0996","444","237","207","5","449","1033","0","43.47","22.94"
"66","000","00","080","0040","0997","494","280","214","3","497","1193","0","41.66","23.47"
"66","000","00","080","0040","0998","466","224","242","3","469","1044","0","44.92","21.46"
"66","000","00","080","0041","0000","2488","1391","1097","15","2503","5662","0","44.21","24.57"
"66","000","00","080","0041","0926","584","349","235","4","588","1383","0","42.52","25.23"
"66","000","00","080","0041","0927","527","287","240","3","530","1302","0","40.71","22.04"
"66","000","00","080","0041","0928","574","332","242","2","576","1144","0","50.35","29.02"
"66","000","00","080","0041","0929","411","243","168","4","415","967","0","42.92","25.13"
"66","000","00","080","0041","0930","392","180","212","2","394","866","0","45.50","20.79"
"66","000","00","080","0042","0000","1708","1031","677","9","1717","3906","0","43.96","26.40"
"66","000","00","080","0042","1041","595","374","221","5","600","1361","0","44.09","27.48"
"66","000","00","080","0042","1042","655","384","271","1","656","1447","0","45.34","26.54"
"66","000","00","080","0042","1043","458","273","185","3","461","1098","0","41.99","24.86"
"66","000","00","090","0000","0000","58811","27344","31467","518","59329","136820","165529","43.36","19.99"
"66","000","00","090","0001","0000","984","528","456","15","999","2243","0","44.54","23.54"
"66","000","00","090","0001","1674","365","169","196","7","372","933","0","39.87","18.11"
"66","000","00","090","0001","1675","619","359","260","8","627","1310","0","47.86","27.40"
"66","000","00","090","0002","0000","420","175","245","3","423","919","0","46.03","19.04"
"66","000","00","090","0002","1677","420","175","245","3","423","919","0","46.03","19.04"
"66","000","00","090","0003","0000","403","174","229","3","406","795","0","51.07","21.89"
"66","000","00","090","0003","1678","403","174","229","3","406","795","0","51.07","21.89"
"66","000","00","090","0004","0000","517","228","289","4","521","1106","0","47.11","20.61"
"66","000","00","090","0004","1676","517","228","289","4","521","1106","0","47.11","20.61"
"66","000","00","090","0005","0000","297","137","160","4","301","744","0","40.46","18.41"
"66","000","00","090","0005","1679","297","137","160","4","301","744","0","40.46","18.41"
"66","000","00","090","0006","0000","386","168","218","1","387","720","0","53.75","23.33"
"66","000","00","090","0006","1703","386","168","218","1","387","720","0","53.75","23.33"
"66","000","00","090","0007","0000","297","126","171","7","304","607","0","50.08","20.76"
"66","000","00","090","0007","1704","297","126","171","7","304","607","0","50.08","20.76"
"66","000","00","090","0008","0000","756","375","381","4","760","1595","0","47.65","23.51"
"66","000","00","090","0008","1698","756","375","381","4","760","1595","0","47.65","23.51"
"66","000","00","090","0009","0000","2176","1024","1152","19","2195","4781","0","45.91","21.42"
"66","000","00","090","0009","1705","572","285","287","0","572","1110","0","51.53","25.68"
"66","000","00","090","0009","1706","516","224","292","4","520","1225","0","42.45","18.29"
"66","000","00","090","0009","1707","542","253","289","8","550","1223","0","44.97","20.69"
"66","000","00","090","0009","1708","546","262","284","7","553","1223","0","45.22","21.42"
"66","000","00","090","0010","0000","1044","486","558","12","1056","2152","0","49.07","22.58"
"66","000","00","090","0010","1709","648","306","342","10","658","1286","0","51.17","23.79"
"66","000","00","090","0010","1710","396","180","216","2","398","866","0","45.96","20.79"
"66","000","00","090","0011","0000","663","308","355","7","670","1433","0","46.76","21.49"
"66","000","00","090","0011","1725","663","308","355","7","670","1433","0","46.76","21.49"
"66","000","00","090","0012","0000","468","183","285","4","472","1119","0","42.18","16.35"
"66","000","00","090","0012","1726","468","183","285","4","472","1119","0","42.18","16.35"
"66","000","00","090","0013","0000","1099","486","613","6","1105","2494","0","44.31","19.49"
"66","000","00","090","0013","1684","475","202","273","5","480","1068","0","44.94","18.91"
"66","000","00","090","0013","1685","624","284","340","1","625","1426","0","43.83","19.92"
"66","000","00","090","0014","0000","1284","650","634","15","1299","2882","0","45.07","22.55"
"66","000","00","090","0014","1686","630","327","303","6","636","1435","0","44.32","22.79"
"66","000","00","090","0014","1687","654","323","331","9","663","1447","0","45.82","22.32"
"66","000","00","090","0015","0000","1666","654","1012","10","1676","3976","0","42.15","16.45"
"66","000","00","090","0015","1688","571","220","351","6","577","1464","0","39.41","15.03"
"66","000","00","090","0015","1689","592","241","351","2","594","1377","0","43.14","17.50"
"66","000","00","090","0015","1690","503","193","310","2","505","1135","0","44.49","17.00"
"66","000","00","090","0016","0000","3835","1708","2127","40","3875","9125","0","42.47","18.72"
"66","000","00","090","0016","1691","590","239","351","10","600","1367","0","43.89","17.48"
"66","000","00","090","0016","1692","642","256","386","6","648","1439","0","45.03","17.79"
"66","000","00","090","0016","1693","410","179","231","4","414","1050","0","39.43","17.05"
"66","000","00","090","0016","1694","601","296","305","10","611","1428","0","42.79","20.73"
"66","000","00","090","0016","1695","455","197","258","2","457","1107","0","41.28","17.80"
"66","000","00","090","0016","1696","601","290","311","4","605","1364","0","44.35","21.26"
"66","000","00","090","0016","1697","536","251","285","4","540","1370","0","39.42","18.32"
"66","000","00","090","0017","0000","592","262","330","8","600","1231","0","48.74","21.28"
"66","000","00","090","0017","1699","592","262","330","8","600","1231","0","48.74","21.28"
"66","000","00","090","0018","0000","1497","740","757","11","1508","3367","0","44.79","21.98"
"66","000","00","090","0018","1700","538","277","261","6","544","1212","0","44.88","22.85"
"66","000","00","090","0018","1701","500","243","257","1","501","1065","0","47.04","22.82"
"66","000","00","090","0018","1702","459","220","239","4","463","1090","0","42.48","20.18"
"66","000","00","090","0019","0000","3901","1886","2015","27","3928","9864","0","39.82","19.12"
"66","000","00","090","0019","1713","512","242","270","5","517","1263","0","40.93","19.16"
"66","000","00","090","0019","1714","570","320","250","5","575","1411","0","40.75","22.68"
"66","000","00","090","0019","1715","539","265","274","9","548","1397","0","39.23","18.97"
"66","000","00","090","0019","1716","450","226","224","1","451","1418","0","31.81","15.94"
"66","000","00","090","0019","1717","587","311","276","1","588","1451","0","40.52","21.43"
"66","000","00","090","0019","1718","639","247","392","4","643","1415","0","45.44","17.46"
"66","000","00","090","0019","1719","604","275","329","2","606","1509","0","40.16","18.22"
"66","000","00","090","0020","0000","2788","1298","1490","28","2816","6283","0","44.82","20.66"
"66","000","00","090","0020","1720","544","272","272","8","552","1151","0","47.96","23.63"
"66","000","00","090","0020","1721","521","267","254","6","527","1164","0","45.27","22.94"
"66","000","00","090","0020","1722","603","283","320","2","605","1402","0","43.15","20.19"
"66","000","00","090","0020","1723","556","223","333","6","562","1228","0","45.77","18.16"
"66","000","00","090","0020","1724","564","253","311","6","570","1338","0","42.60","18.91"
"66","000","00","090","0021","0000","1234","681","553","16","1250","2877","0","43.45","23.67"
"66","000","00","090","0021","1711","582","298","284","6","588","1397","0","42.09","21.33"
"66","000","00","090","0021","1712","652","383","269","10","662","1480","0","44.73","25.88"
"66","000","00","090","0022","0000","2483","1179","1304","27","2510","6296","0","39.87","18.73"
"66","000","00","090","0022","1727","622","285","337","8","630","1991","0","31.64","14.31"
"66","000","00","090","0022","1728","627","303","324","10","637","1437","0","44.33","21.09"
"66","000","00","090","0022","1729","580","241","339","5","585","1370","0","42.70","17.59"
"66","000","00","090","0022","1730","654","350","304","4","658","1498","0","43.93","23.36"
"66","000","00","090","0023","0000","4262","1929","2333","31","4293","10193","0","42.12","18.92"
"66","000","00","090","0023","1731","657","279","378","8","665","1443","0","46.08","19.33"
"66","000","00","090","0023","1732","635","261","374","4","639","1446","0","44.19","18.05"
"66","000","00","090","0023","1733","597","235","362","6","603","1478","0","40.80","15.90"
"66","000","00","090","0023","1734","577","266","311","2","579","1443","0","40.12","18.43"
"66","000","00","090","0023","1735","597","278","319","3","600","1465","0","40.96","18.98"
"66","000","00","090","0023","1736","543","297","246","5","548","1383","0","39.62","21.48"
"66","000","00","090","0023","1737","656","313","343","3","659","1535","0","42.93","20.39"
"66","000","00","090","0024","0000","1999","907","1092","23","2022","4633","0","43.64","19.58"
"66","000","00","090","0024","1738","649","259","390","6","655","1537","0","42.62","16.85"
"66","000","00","090","0024","1739","649","319","330","10","659","1492","0","44.17","21.38"
"66","000","00","090","0024","1740","701","329","372","7","708","1604","0","44.14","20.51"
"66","000","00","090","0025","0000","4393","2154","2239","27","4420","10538","0","41.94","20.44"
"66","000","00","090","0025","1743","481","215","266","5","486","1243","0","39.10","17.30"
"66","000","00","090","0025","1744","540","303","237","6","546","1324","0","41.24","22.89"
"66","000","00","090","0025","1745","623","302","321","2","625","1402","0","44.58","21.54"
"66","000","00","090","0025","1746","622","300","322","3","625","1365","0","45.79","21.98"
"66","000","00","090","0025","1747","542","281","261","2","544","1364","0","39.88","20.60"
"66","000","00","090","0025","1748","546","275","271","4","550","1283","0","42.87","21.43"
"66","000","00","090","0025","1749","508","227","281","4","512","1200","0","42.67","18.92"
"66","000","00","090","0025","1750","531","251","280","1","532","1357","0","39.20","18.50"
"66","000","00","090","0026","0000","1164","574","590","10","1174","2631","0","44.62","21.82"
"66","000","00","090","0026","1741","523","255","268","5","528","1174","0","44.97","21.72"
"66","000","00","090","0026","1742","641","319","322","5","646","1457","0","44.34","21.89"
"66","000","00","090","0027","0000","5444","2655","2789","33","5477","12989","0","42.17","20.44"
"66","000","00","090","0027","1751","612","309","303","0","612","1520","0","40.26","20.33"
"66","000","00","090","0027","1752","609","267","342","7","616","1446","0","42.60","18.46"
"66","000","00","090","0027","1753","598","316","282","1","599","1448","0","41.37","21.82"
"66","000","00","090","0027","1754","651","295","356","0","651","1558","0","41.78","18.93"
"66","000","00","090","0027","1755","657","321","336","6","663","1499","0","44.23","21.41"
"66","000","00","090","0027","1756","611","308","303","6","617","1434","0","43.03","21.48"
"66","000","00","090","0027","1757","621","321","300","4","625","1469","0","42.55","21.85"
"66","000","00","090","0027","1758","508","260","248","4","512","1246","0","41.09","20.87"
"66","000","00","090","0027","1759","577","258","319","5","582","1369","0","42.51","18.85"
"66","000","00","090","0028","0000","2264","1094","1170","12","2276","5045","0","45.11","21.68"
"66","000","00","090","0028","1680","601","283","318","4","605","1333","0","45.39","21.23"
"66","000","00","090","0028","1681","551","255","296","1","552","1275","0","43.29","20.00"
"66","000","00","090","0028","1682","624","312","312","2","626","1371","0","45.66","22.76"
"66","000","00","090","0028","1683","488","244","244","5","493","1066","0","46.25","22.89"
"66","000","00","090","0029","0000","727","296","431","10","737","1574","0","46.82","18.81"
"66","000","00","090","0029","1760","727","296","431","10","737","1574","0","46.82","18.81"
"66","000","00","090","0030","0000","2324","1035","1289","18","2342","5234","0","44.75","19.77"
"66","000","00","090","0030","1761","600","230","370","7","607","1400","0","43.36","16.43"
"66","000","00","090","0030","1762","581","252","329","0","581","1183","0","49.11","21.30"
"66","000","00","090","0030","1763","541","248","293","3","544","1198","0","45.41","20.70"
"66","000","00","090","0030","1764","602","305","297","8","610","1453","0","41.98","20.99"
"66","000","00","090","0031","0000","1386","568","818","22","1408","3175","0","44.35","17.89"
"66","000","00","090","0031","1765","447","196","251","8","455","1086","0","41.90","18.05"
"66","000","00","090","0031","1766","486","198","288","10","496","1085","0","45.71","18.25"
"66","000","00","090","0031","1767","453","174","279","4","457","1004","0","45.52","17.33"
"66","000","00","090","0032","0000","1439","600","839","18","1457","3377","0","43.14","17.77"
"66","000","00","090","0032","1768","480","188","292","2","482","1048","0","45.99","17.94"
"66","000","00","090","0032","1769","451","200","251","10","461","1096","0","42.06","18.25"
"66","000","00","090","0032","1770","508","212","296","6","514","1233","0","41.69","17.19"
"66","000","00","090","0033","0000","979","490","489","7","986","2265","0","43.53","21.63"
"66","000","00","090","0033","1771","491","259","232","4","495","1109","0","44.63","23.35"
"66","000","00","090","0033","1772","488","231","257","3","491","1156","0","42.47","19.98"
"66","000","00","090","0034","0000","1328","646","682","14","1342","3221","0","41.66","20.06"
"66","000","00","090","0034","1773","456","238","218","5","461","1053","0","43.78","22.60"
"66","000","00","090","0034","1774","427","184","243","7","434","1080","0","40.19","17.04"
"66","000","00","090","0034","1775","445","224","221","2","447","1088","0","41.08","20.59"
"66","000","00","090","0035","0000","957","422","535","8","965","2049","0","47.10","20.60"
"66","000","00","090","0035","1776","436","202","234","2","438","944","0","46.40","21.40"
"66","000","00","090","0035","1777","521","220","301","6","527","1105","0","47.69","19.91"
"66","000","00","090","0036","0000","1355","518","837","14","1369","3287","0","41.65","15.76"
"66","000","00","090","0036","1778","492","203","289","4","496","1089","0","45.55","18.64"
"66","000","00","090","0036","1779","421","153","268","5","426","1036","0","41.12","14.77"
"66","000","00","090","0036","1780","442","162","280","5","447","1162","0","38.47","13.94"
"66","000","00","100","0000","0000","16862","9568","7294","232","17094","42357","48747","40.36","22.59"
"66","000","00","100","0001","0000","493","323","170","7","500","1297","0","38.55","24.90"
"66","000","00","100","0001","1843","493","323","170","7","500","1297","0","38.55","24.90"
"66","000","00","100","0002","0000","366","242","124","5","371","833","0","44.54","29.05"
"66","000","00","100","0002","1842","366","242","124","5","371","833","0","44.54","29.05"
"66","000","00","100","0003","0000","430","271","159","3","433","996","0","43.47","27.21"
"66","000","00","100","0003","1841","430","271","159","3","433","996","0","43.47","27.21"
"66","000","00","100","0004","0000","807","540","267","5","812","1754","0","46.29","30.79"
"66","000","00","100","0004","1839","397","271","126","3","400","913","0","43.81","29.68"
"66","000","00","100","0004","1840","410","269","141","2","412","841","0","48.99","31.99"
"66","000","00","100","0005","0000","909","513","396","8","917","2138","0","42.89","23.99"
"66","000","00","100","0005","1837","469","285","184","3","472","1124","0","41.99","25.36"
"66","000","00","100","0005","1838","440","228","212","5","445","1014","0","43.89","22.49"
"66","000","00","100","0006","0000","424","273","151","1","425","951","0","44.69","28.71"
"66","000","00","100","0006","1835","424","273","151","1","425","951","0","44.69","28.71"
"66","000","00","100","0007","0000","573","334","239","6","579","1403","0","41.27","23.81"
"66","000","00","100","0007","1836","573","334","239","6","579","1403","0","41.27","23.81"
"66","000","00","100","0008","0000","1447","922","525","14","1461","3402","0","42.95","27.10"
"66","000","00","100","0008","1832","451","255","196","7","458","1103","0","41.52","23.12"
"66","000","00","100","0008","1833","545","379","166","4","549","1259","0","43.61","30.10"
"66","000","00","100","0008","1834","451","288","163","3","454","1040","0","43.65","27.69"
"66","000","00","100","0009","0000","668","402","266","10","678","1835","0","36.95","21.91"
"66","000","00","100","0009","1830","307","194","113","7","314","849","0","36.98","22.85"
"66","000","00","100","0009","1831","361","208","153","3","364","986","0","36.92","21.10"
"66","000","00","100","0010","0000","1452","856","596","29","1481","3709","0","39.93","23.08"
"66","000","00","100","0010","1826","482","304","178","12","494","1166","0","42.37","26.07"
"66","000","00","100","0010","1827","574","332","242","8","582","1411","0","41.25","23.53"
"66","000","00","100","0010","1828","396","220","176","9","405","1132","0","35.78","19.43"
"66","000","00","100","0011","0000","488","275","213","3","491","1418","0","34.63","19.39"
"66","000","00","100","0011","1829","488","275","213","3","491","1418","0","34.63","19.39"
"66","000","00","100","0012","0000","1895","1006","889","13","1908","4812","0","39.65","20.91"
"66","000","00","100","0012","1822","452","212","240","6","458","1276","0","35.89","16.61"
"66","000","00","100","0012","1823","461","263","198","5","466","1144","0","40.73","22.99"
"66","000","00","100","0012","1824","505","260","245","1","506","1236","0","40.94","21.04"
"66","000","00","100","0012","1825","477","271","206","1","478","1156","0","41.35","23.44"
"66","000","00","100","0013","0000","663","325","338","15","678","1616","0","41.96","20.11"
"66","000","00","100","0013","1820","389","172","217","9","398","901","0","44.17","19.09"
"66","000","00","100","0013","1821","274","153","121","6","280","715","0","39.16","21.40"
"66","000","00","100","0014","0000","426","228","198","11","437","963","0","45.38","23.68"
"66","000","00","100","0014","1818","426","228","198","11","437","963","0","45.38","23.68"
"66","000","00","100","0015","0000","361","182","179","11","372","832","0","44.71","21.88"
"66","000","00","100","0015","1819","361","182","179","11","372","832","0","44.71","21.88"
"66","000","00","100","0016","0000","694","323","371","17","711","1825","0","38.96","17.70"
"66","000","00","100","0016","1816","356","162","194","12","368","988","0","37.25","16.40"
"66","000","00","100","0016","1817","338","161","177","5","343","837","0","40.98","19.24"
"66","000","00","100","0017","0000","372","202","170","8","380","1233","0","30.82","16.38"
"66","000","00","100","0017","1815","372","202","170","8","380","1233","0","30.82","16.38"
"66","000","00","100","0018","0000","859","542","317","7","866","1954","0","44.32","27.74"
"66","000","00","100","0018","1848","415","264","151","3","418","956","0","43.72","27.62"
"66","000","00","100","0018","1849","444","278","166","4","448","998","0","44.89","27.86"
"66","000","00","100","0019","0000","837","468","369","14","851","2023","0","42.07","23.13"
"66","000","00","100","0019","1844","295","176","119","3","298","723","0","41.22","24.34"
"66","000","00","100","0019","1845","542","292","250","11","553","1300","0","42.54","22.46"
"66","000","00","100","0020","0000","654","341","313","13","667","1651","0","40.40","20.65"
"66","000","00","100","0020","1846","422","212","210","6","428","1010","0","42.38","20.99"
"66","000","00","100","0020","1847","232","129","103","7","239","641","0","37.29","20.12"
"66","000","00","100","0021","0000","456","201","255","4","460","1172","0","39.25","17.15"
"66","000","00","100","0021","1850","456","201","255","4","460","1172","0","39.25","17.15"
"66","000","00","100","0022","0000","621","353","268","6","627","1817","0","34.51","19.43"
"66","000","00","100","0022","1851","258","130","128","4","262","901","0","29.08","14.43"
"66","000","00","100","0022","1852","363","223","140","2","365","916","0","39.85","24.34"
"66","000","00","100","0023","0000","225","120","105","3","228","701","0","32.52","17.12"
"66","000","00","100","0023","1853","225","120","105","3","228","701","0","32.52","17.12"
"66","000","00","100","0024","0000","284","113","171","7","291","657","0","44.29","17.20"
"66","000","00","100","0024","1854","284","113","171","7","291","657","0","44.29","17.20"
"66","000","00","100","0025","0000","458","213","245","12","470","1365","0","34.43","15.60"
"66","000","00","100","0025","1855","458","213","245","12","470","1365","0","34.43","15.60"
"66","000","00","110","0000","0000","23342","11297","12045","247","23589","62481","75819","37.75","18.08"
"66","000","00","110","0001","0000","576","258","318","6","582","1331","0","43.73","19.38"
"66","000","00","110","0001","0001","576","258","318","6","582","1331","0","43.73","19.38"
"66","000","00","110","0002","0000","434","195","239","4","438","991","0","44.20","19.68"
"66","000","00","110","0002","0002","434","195","239","4","438","991","0","44.20","19.68"
"66","000","00","110","0003","0000","682","319","363","5","687","1532","0","44.84","20.82"
"66","000","00","110","0003","0003","322","157","165","3","325","695","0","46.76","22.59"
"66","000","00","110","0003","0004","360","162","198","2","362","837","0","43.25","19.35"
"66","000","00","110","0004","0000","288","152","136","2","290","748","0","38.77","20.32"
"66","000","00","110","0004","0005","288","152","136","2","290","748","0","38.77","20.32"
"66","000","00","110","0005","0000","784","368","416","12","796","2008","0","39.64","18.33"
"66","000","00","110","0005","0006","365","181","184","6","371","864","0","42.94","20.95"
"66","000","00","110","0005","0007","419","187","232","6","425","1144","0","37.15","16.35"
"66","000","00","110","0006","0000","882","425","457","12","894","2055","0","43.50","20.68"
"66","000","00","110","0006","0008","382","164","218","9","391","899","0","43.49","18.24"
"66","000","00","110","0006","0009","500","261","239","3","503","1156","0","43.51","22.58"
"66","000","00","110","0007","0000","1333","675","658","12","1345","3394","0","39.63","19.89"
"66","000","00","110","0007","0010","418","210","208","3","421","1062","0","39.64","19.77"
"66","000","00","110","0007","0011","481","239","242","4","485","1276","0","38.01","18.73"
"66","000","00","110","0007","0012","434","226","208","5","439","1056","0","41.57","21.40"
"66","000","00","110","0008","0000","768","374","394","11","779","2042","0","38.15","18.32"
"66","000","00","110","0008","0013","389","169","220","4","393","1015","0","38.72","16.65"
"66","000","00","110","0008","0014","379","205","174","7","386","1027","0","37.59","19.96"
"66","000","00","110","0009","0000","1718","897","821","18","1736","4515","0","38.45","19.87"
"66","000","00","110","0009","0015","429","217","212","2","431","1112","0","38.76","19.51"
"66","000","00","110","0009","0016","424","219","205","11","435","1133","0","38.39","19.33"
"66","000","00","110","0009","0017","468","267","201","2","470","1282","0","36.66","20.83"
"66","000","00","110","0009","0018","397","194","203","3","400","988","0","40.49","19.64"
"66","000","00","110","0010","0000","328","163","165","3","331","813","0","40.71","20.05"
"66","000","00","110","0010","0019","328","163","165","3","331","813","0","40.71","20.05"
"66","000","00","110","0011","0000","396","175","221","6","402","860","0","46.74","20.35"
"66","000","00","110","0011","0020","396","175","221","6","402","860","0","46.74","20.35"
"66","000","00","110","0012","0000","1144","573","571","6","1150","3232","0","35.58","17.73"
"66","000","00","110","0012","0021","577","268","309","1","578","1628","0","35.50","16.46"
"66","000","00","110","0012","0022","567","305","262","5","572","1604","0","35.66","19.01"
"66","000","00","110","0013","0000","453","238","215","3","456","1160","0","39.31","20.52"
"66","000","00","110","0013","0023","453","238","215","3","456","1160","0","39.31","20.52"
"66","000","00","110","0014","0000","354","138","216","2","356","1073","0","33.18","12.86"
"66","000","00","110","0014","0024","354","138","216","2","356","1073","0","33.18","12.86"
"66","000","00","110","0015","0000","700","351","349","5","705","1810","0","38.95","19.39"
"66","000","00","110","0015","0025","389","201","188","2","391","966","0","40.48","20.81"
"66","000","00","110","0015","0026","311","150","161","3","314","844","0","37.20","17.77"
"66","000","00","110","0016","0000","2071","1056","1015","17","2088","5206","0","40.11","20.28"
"66","000","00","110","0016","0027","540","287","253","4","544","1322","0","41.15","21.71"
"66","000","00","110","0016","0028","435","210","225","2","437","1082","0","40.39","19.41"
"66","000","00","110","0016","0029","467","245","222","6","473","1161","0","40.74","21.10"
"66","000","00","110","0016","0030","382","184","198","5","387","955","0","40.52","19.27"
"66","000","00","110","0016","0031","247","130","117","0","247","686","0","36.01","18.95"
"66","000","00","110","0017","0000","792","428","364","8","800","1996","0","40.08","21.44"
"66","000","00","110","0017","0032","502","260","242","5","507","1241","0","40.85","20.95"
"66","000","00","110","0017","0033","290","168","122","3","293","755","0","38.81","22.25"
"66","000","00","110","0018","0000","630","272","358","8","638","1755","0","36.35","15.50"
"66","000","00","110","0018","0034","293","101","192","5","298","770","0","38.70","13.12"
"66","000","00","110","0018","0035","337","171","166","3","340","985","0","34.52","17.36"
"66","000","00","110","0019","0000","466","234","232","2","468","1356","0","34.51","17.26"
"66","000","00","110","0019","0036","466","234","232","2","468","1356","0","34.51","17.26"
"66","000","00","110","0020","0000","1675","806","869","14","1689","4450","0","37.96","18.11"
"66","000","00","110","0020","0037","455","194","261","4","459","1319","0","34.80","14.71"
"66","000","00","110","0020","0038","435","226","209","6","441","1156","0","38.15","19.55"
"66","000","00","110","0020","0039","360","168","192","3","363","928","0","39.12","18.10"
"66","000","00","110","0020","0040","425","218","207","1","426","1047","0","40.69","20.82"
"66","000","00","110","0021","0000","427","187","240","10","437","1233","0","35.44","15.17"
"66","000","00","110","0021","0041","427","187","240","10","437","1233","0","35.44","15.17"
"66","000","00","110","0022","0000","1374","624","750","11","1385","3909","0","35.43","15.96"
"66","000","00","110","0022","0042","526","261","265","4","530","1363","0","38.88","19.15"
"66","000","00","110","0022","0043","352","134","218","3","355","1160","0","30.60","11.55"
"66","000","00","110","0022","0044","496","229","267","4","500","1386","0","36.08","16.52"
"66","000","00","110","0023","0000","852","384","468","12","864","2515","0","34.35","15.27"
"66","000","00","110","0023","0045","386","160","226","6","392","1119","0","35.03","14.30"
"66","000","00","110","0023","0046","466","224","242","6","472","1396","0","33.81","16.05"
"66","000","00","110","0024","0000","1809","871","938","19","1828","5476","0","33.38","15.91"
"66","000","00","110","0024","0047","453","194","259","2","455","1231","0","36.96","15.76"
"66","000","00","110","0024","0048","475","243","232","8","483","1473","0","32.79","16.50"
"66","000","00","110","0024","0049","433","199","234","4","437","1415","0","30.88","14.06"
"66","000","00","110","0024","0050","448","235","213","5","453","1357","0","33.38","17.32"
"66","000","00","110","0025","0000","571","265","306","11","582","1475","0","39.46","17.97"
"66","000","00","110","0025","0051","252","134","118","7","259","640","0","40.47","20.94"
"66","000","00","110","0025","0052","319","131","188","4","323","835","0","38.68","15.69"
"66","000","00","110","0026","0000","592","299","293","9","601","1649","0","36.45","18.13"
"66","000","00","110","0026","0053","305","146","159","4","309","869","0","35.56","16.80"
"66","000","00","110","0026","0054","287","153","134","5","292","780","0","37.44","19.62"
"66","000","00","110","0027","0000","433","204","229","8","441","1340","0","32.91","15.22"
"66","000","00","110","0027","0055","433","204","229","8","441","1340","0","32.91","15.22"
"66","000","00","110","0028","0000","371","184","187","5","376","1111","0","33.84","16.56"
"66","000","00","110","0028","0056","371","184","187","5","376","1111","0","33.84","16.56"
"66","000","00","110","0029","0000","439","182","257","6","445","1446","0","30.77","12.59"
"66","000","00","110","0029","0057","439","182","257","6","445","1446","0","30.77","12.59"
"66","000","00","120","0000","0000","28508","13331","15177","264","28772","73629","88227","39.08","18.11"
"66","000","00","120","0001","0000","461","213","248","8","469","1063","0","44.12","20.04"
"66","000","00","120","0001","0099","461","213","248","8","469","1063","0","44.12","20.04"
"66","000","00","120","0002","0000","463","232","231","3","466","930","0","50.11","24.95"
"66","000","00","120","0002","0100","463","232","231","3","466","930","0","50.11","24.95"
"66","000","00","120","0003","0000","913","419","494","8","921","2049","0","44.95","20.45"
"66","000","00","120","0003","0101","376","159","217","4","380","892","0","42.60","17.83"
"66","000","00","120","0003","0102","537","260","277","4","541","1157","0","46.76","22.47"
"66","000","00","120","0004","0000","310","134","176","4","314","661","0","47.50","20.27"
"66","000","00","120","0004","0103","310","134","176","4","314","661","0","47.50","20.27"
"66","000","00","120","0005","0000","764","371","393","3","767","1743","0","44.00","21.29"
"66","000","00","120","0005","0104","380","179","201","2","382","853","0","44.78","20.98"
"66","000","00","120","0005","0105","384","192","192","1","385","890","0","43.26","21.57"
"66","000","00","120","0006","0000","659","285","374","4","663","1553","0","42.69","18.35"
"66","000","00","120","0006","0106","659","285","374","4","663","1553","0","42.69","18.35"
"66","000","00","120","0007","0000","327","143","184","4","331","673","0","49.18","21.25"
"66","000","00","120","0007","0107","327","143","184","4","331","673","0","49.18","21.25"
"66","000","00","120","0008","0000","209","95","114","2","211","391","0","53.96","24.30"
"66","000","00","120","0008","0108","209","95","114","2","211","391","0","53.96","24.30"
"66","000","00","120","0009","0000","955","427","528","11","966","2191","0","44.09","19.49"
"66","000","00","120","0009","0109","619","274","345","8","627","1424","0","44.03","19.24"
"66","000","00","120","0009","0110","336","153","183","3","339","767","0","44.20","19.95"
"66","000","00","120","0010","0000","4115","1996","2119","28","4143","9925","0","41.74","20.11"
"66","000","00","120","0010","0111","553","267","286","3","556","1315","0","42.28","20.30"
"66","000","00","120","0010","0112","671","302","369","7","678","1676","0","40.45","18.02"
"66","000","00","120","0010","0113","528","276","252","5","533","1327","0","40.17","20.80"
"66","000","00","120","0010","0114","628","339","289","0","628","1352","0","46.45","25.07"
"66","000","00","120","0010","0115","548","251","297","3","551","1392","0","39.58","18.03"
"66","000","00","120","0010","0116","631","302","329","7","638","1553","0","41.08","19.45"
"66","000","00","120","0010","0117","556","259","297","3","559","1310","0","42.67","19.77"
"66","000","00","120","0011","0000","537","242","295","5","542","1448","0","37.43","16.71"
"66","000","00","120","0011","0118","537","242","295","5","542","1448","0","37.43","16.71"
"66","000","00","120","0012","0000","594","291","303","5","599","1505","0","39.80","19.34"
"66","000","00","120","0012","0119","594","291","303","5","599","1505","0","39.80","19.34"
"66","000","00","120","0013","0000","1752","871","881","11","1763","4370","0","40.34","19.93"
"66","000","00","120","0013","0120","583","266","317","4","587","1508","0","38.93","17.64"
"66","000","00","120","0013","0121","676","341","335","5","681","1611","0","42.27","21.17"
"66","000","00","120","0013","0122","493","264","229","2","495","1251","0","39.57","21.10"
"66","000","00","120","0014","0000","1241","575","666","11","1252","3341","0","37.47","17.21"
"66","000","00","120","0014","0123","429","164","265","2","431","1170","0","36.84","14.02"
"66","000","00","120","0014","0124","493","233","260","5","498","1310","0","38.02","17.79"
"66","000","00","120","0014","0125","319","178","141","4","323","861","0","37.51","20.67"
"66","000","00","120","0015","0000","793","347","446","12","805","2104","0","38.26","16.49"
"66","000","00","120","0015","0126","429","176","253","7","436","1082","0","40.30","16.27"
"66","000","00","120","0015","0127","364","171","193","5","369","1022","0","36.11","16.73"
"66","000","00","120","0016","0000","2299","1014","1285","15","2314","6655","0","34.77","15.24"
"66","000","00","120","0016","0128","574","275","299","3","577","1529","0","37.74","17.99"
"66","000","00","120","0016","0129","553","197","356","3","556","1473","0","37.75","13.37"
"66","000","00","120","0016","0130","656","318","338","8","664","2246","0","29.56","14.16"
"66","000","00","120","0016","0131","516","224","292","1","517","1407","0","36.74","15.92"
"66","000","00","120","0017","0000","1184","840","344","8","1192","2801","0","42.56","29.99"
"66","000","00","120","0017","0132","766","624","142","5","771","1641","0","46.98","38.03"
"66","000","00","120","0017","0133","418","216","202","3","421","1160","0","36.29","18.62"
"66","000","00","120","0018","0000","396","236","160","6","402","1278","0","31.46","18.47"
"66","000","00","120","0018","0134","396","236","160","6","402","1278","0","31.46","18.47"
"66","000","00","120","0019","0000","447","202","245","3","450","1330","0","33.83","15.19"
"66","000","00","120","0019","0135","447","202","245","3","450","1330","0","33.83","15.19"
"66","000","00","120","0020","0000","411","172","239","8","419","1234","0","33.95","13.94"
"66","000","00","120","0020","0136","411","172","239","8","419","1234","0","33.95","13.94"
"66","000","00","120","0021","0000","337","158","179","0","337","1155","0","29.18","13.68"
"66","000","00","120","0021","0137","337","158","179","0","337","1155","0","29.18","13.68"
"66","000","00","120","0022","0000","448","230","218","4","452","1309","0","34.53","17.57"
"66","000","00","120","0022","0138","448","230","218","4","452","1309","0","34.53","17.57"
"66","000","00","120","0023","0000","663","238","425","5","668","2039","0","32.76","11.67"
"66","000","00","120","0023","0139","340","116","224","2","342","1134","0","30.16","10.23"
"66","000","00","120","0023","0140","323","122","201","3","326","905","0","36.02","13.48"
"66","000","00","120","0024","0000","896","360","536","8","904","2252","0","40.14","15.99"
"66","000","00","120","0024","0141","460","181","279","7","467","1111","0","42.03","16.29"
"66","000","00","120","0024","0142","436","179","257","1","437","1141","0","38.30","15.69"
"66","000","00","120","0025","0000","598","285","313","6","604","1765","0","34.22","16.15"
"66","000","00","120","0025","0143","315","164","151","2","317","835","0","37.96","19.64"
"66","000","00","120","0025","0144","283","121","162","4","287","930","0","30.86","13.01"
"66","000","00","120","0026","0000","806","306","500","12","818","2488","0","32.88","12.30"
"66","000","00","120","0026","0145","454","177","277","7","461","1394","0","33.07","12.70"
"66","000","00","120","0026","0146","352","129","223","5","357","1094","0","32.63","11.79"
"66","000","00","120","0027","0000","2945","1246","1699","30","2975","7404","0","40.18","16.83"
"66","000","00","120","0027","0147","493","202","291","8","501","1346","0","37.22","15.01"
"66","000","00","120","0027","0148","594","248","346","4","598","1446","0","41.36","17.15"
"66","000","00","120","0027","0149","562","225","337","8","570","1336","0","42.66","16.84"
"66","000","00","120","0027","0150","741","354","387","7","748","1771","0","42.24","19.99"
"66","000","00","120","0027","0151","555","217","338","3","558","1505","0","37.08","14.42"
"66","000","00","120","0028","0000","1062","490","572","15","1077","2764","0","38.97","17.73"
"66","000","00","120","0028","0152","477","235","242","9","486","1340","0","36.27","17.54"
"66","000","00","120","0028","0153","585","255","330","6","591","1424","0","41.50","17.91"
"66","000","00","120","0029","0000","424","213","211","7","431","1197","0","36.01","17.79"
"66","000","00","120","0029","0154","424","213","211","7","431","1197","0","36.01","17.79"
"66","000","00","120","0030","0000","437","181","256","3","440","1156","0","38.06","15.66"
"66","000","00","120","0030","0156","437","181","256","3","440","1156","0","38.06","15.66"
"66","000","00","120","0031","0000","495","239","256","8","503","1390","0","36.19","17.19"
"66","000","00","120","0031","0157","495","239","256","8","503","1390","0","36.19","17.19"
"66","000","00","120","0032","0000","567","280","287","7","574","1465","0","39.18","19.11"
"66","000","00","120","0032","0155","567","280","287","7","574","1465","0","39.18","19.11"
"66","000","00","130","0000","0000","32942","16480","16462","297","33239","76561","95562","43.42","21.53"
"66","000","00","130","0001","0000","608","287","321","3","611","1364","0","44.79","21.04"
"66","000","00","130","0001","0198","376","152","224","2","378","765","0","49.41","19.87"
"66","000","00","130","0001","0199","232","135","97","1","233","599","0","38.90","22.54"
"66","000","00","130","0002","0000","1027","519","508","8","1035","1976","0","52.38","26.27"
"66","000","00","130","0002","0200","399","192","207","4","403","830","0","48.55","23.13"
"66","000","00","130","0002","0201","628","327","301","4","632","1146","0","55.15","28.53"
"66","000","00","130","0003","0000","466","188","278","3","469","893","0","52.52","21.05"
"66","000","00","130","0003","0202","466","188","278","3","469","893","0","52.52","21.05"
"66","000","00","130","0004","0000","235","120","115","3","238","489","0","48.67","24.54"
"66","000","00","130","0004","0203","235","120","115","3","238","489","0","48.67","24.54"
"66","000","00","130","0005","0000","1079","513","566","7","1086","2409","0","45.08","21.30"
"66","000","00","130","0005","0204","340","163","177","2","342","769","0","44.47","21.20"
"66","000","00","130","0005","0205","421","215","206","5","426","932","0","45.71","23.07"
"66","000","00","130","0005","0206","318","135","183","0","318","708","0","44.92","19.07"
"66","000","00","130","0006","0000","1982","973","1009","18","2000","4364","0","45.83","22.30"
"66","000","00","130","0006","0210","494","256","238","2","496","1058","0","46.88","24.20"
"66","000","00","130","0006","0211","471","241","230","2","473","974","0","48.56","24.74"
"66","000","00","130","0006","0212","605","278","327","9","614","1415","0","43.39","19.65"
"66","000","00","130","0006","0213","412","198","214","5","417","917","0","45.47","21.59"
"66","000","00","130","0007","0000","2325","1058","1267","28","2353","5345","0","44.02","19.79"
"66","000","00","130","0007","0214","514","236","278","9","523","1202","0","43.51","19.63"
"66","000","00","130","0007","0215","514","241","273","7","521","1205","0","43.24","20.00"
"66","000","00","130","0007","0216","618","254","364","2","620","1392","0","44.54","18.25"
"66","000","00","130","0007","0217","679","327","352","10","689","1546","0","44.57","21.15"
"66","000","00","130","0008","0000","3129","1267","1862","23","3152","6799","0","46.36","18.64"
"66","000","00","130","0008","0218","496","182","314","0","496","1176","0","42.18","15.48"
"66","000","00","130","0008","0219","517","205","312","4","521","1149","0","45.34","17.84"
"66","000","00","130","0008","0220","509","208","301","7","516","1155","0","44.68","18.01"
"66","000","00","130","0008","0221","498","178","320","3","501","1044","0","47.99","17.05"
"66","000","00","130","0008","0222","536","203","333","1","537","1143","0","46.98","17.76"
"66","000","00","130","0008","0223","573","291","282","8","581","1132","0","51.33","25.71"
"66","000","00","130","0009","0000","3090","1581","1509","25","3115","7344","0","42.42","21.53"
"66","000","00","130","0009","0224","390","219","171","4","394","936","0","42.09","23.40"
"66","000","00","130","0009","0225","371","179","192","1","372","879","0","42.32","20.36"
"66","000","00","130","0009","0226","471","260","211","1","472","1074","0","43.95","24.21"
"66","000","00","130","0009","0227","453","211","242","7","460","1103","0","41.70","19.13"
"66","000","00","130","0009","0228","421","185","236","6","427","1133","0","37.69","16.33"
"66","000","00","130","0009","0229","523","294","229","3","526","1137","0","46.26","25.86"
"66","000","00","130","0009","0230","461","233","228","3","464","1082","0","42.88","21.53"
"66","000","00","130","0010","0000","473","207","266","4","477","1089","0","43.80","19.01"
"66","000","00","130","0010","0231","473","207","266","4","477","1089","0","43.80","19.01"
"66","000","00","130","0011","0000","1865","953","912","22","1887","4904","0","38.48","19.43"
"66","000","00","130","0011","0235","378","183","195","4","382","974","0","39.22","18.79"
"66","000","00","130","0011","0236","373","201","172","4","377","919","0","41.02","21.87"
"66","000","00","130","0011","0237","417","198","219","6","423","1054","0","40.13","18.79"
"66","000","00","130","0011","0238","361","189","172","5","366","1025","0","35.71","18.44"
"66","000","00","130","0011","0239","336","182","154","3","339","932","0","36.37","19.53"
"66","000","00","130","0012","0000","1611","844","767","12","1623","3843","0","42.23","21.96"
"66","000","00","130","0012","0232","571","280","291","6","577","1403","0","41.13","19.96"
"66","000","00","130","0012","0233","499","279","220","3","502","1137","0","44.15","24.54"
"66","000","00","130","0012","0234","541","285","256","3","544","1303","0","41.75","21.87"
"66","000","00","130","0013","0000","771","373","398","12","783","1748","0","44.79","21.34"
"66","000","00","130","0013","0240","287","122","165","5","292","698","0","41.83","17.48"
"66","000","00","130","0013","0241","484","251","233","7","491","1050","0","46.76","23.90"
"66","000","00","130","0014","0000","2215","1073","1142","13","2228","5388","0","41.35","19.91"
"66","000","00","130","0014","0242","594","285","309","2","596","1434","0","41.56","19.87"
"66","000","00","130","0014","0243","475","212","263","5","480","1186","0","40.47","17.88"
"66","000","00","130","0014","0244","511","233","278","2","513","1272","0","40.33","18.32"
"66","000","00","130","0014","0245","635","343","292","4","639","1496","0","42.71","22.93"
"66","000","00","130","0015","0000","1408","742","666","11","1419","3381","0","41.97","21.95"
"66","000","00","130","0015","0246","296","152","144","6","302","729","0","41.43","20.85"
"66","000","00","130","0015","0247","370","191","179","0","370","853","0","43.38","22.39"
"66","000","00","130","0015","0248","427","226","201","4","431","1041","0","41.40","21.71"
"66","000","00","130","0015","0249","315","173","142","1","316","758","0","41.69","22.82"
"66","000","00","130","0016","0000","2513","1384","1129","20","2533","5682","0","44.58","24.36"
"66","000","00","130","0016","0250","541","270","271","3","544","1276","0","42.63","21.16"
"66","000","00","130","0016","0251","431","248","183","3","434","995","0","43.62","24.92"
"66","000","00","130","0016","0252","395","224","171","4","399","1026","0","38.89","21.83"
"66","000","00","130","0016","0253","539","270","269","6","545","1113","0","48.97","24.26"
"66","000","00","130","0016","0254","607","372","235","4","611","1272","0","48.03","29.25"
"66","000","00","130","0017","0000","1799","1041","758","24","1823","4396","0","41.47","23.68"
"66","000","00","130","0017","0261","529","283","246","8","537","1404","0","38.25","20.16"
"66","000","00","130","0017","0262","368","268","100","5","373","890","0","41.91","30.11"
"66","000","00","130","0017","0263","385","204","181","7","392","945","0","41.48","21.59"
"66","000","00","130","0017","0264","517","286","231","4","521","1157","0","45.03","24.72"
"66","000","00","130","0018","0000","1019","580","439","11","1030","2331","0","44.19","24.88"
"66","000","00","130","0018","0265","560","284","276","7","567","1296","0","43.75","21.91"
"66","000","00","130","0018","0266","459","296","163","4","463","1035","0","44.73","28.60"
"66","000","00","130","0019","0000","853","483","370","11","864","2130","0","40.56","22.68"
"66","000","00","130","0019","0267","457","238","219","7","464","1128","0","41.13","21.10"
"66","000","00","130","0019","0268","396","245","151","4","400","1002","0","39.92","24.45"
"66","000","00","130","0020","0000","1446","656","790","18","1464","3365","0","43.51","19.49"
"66","000","00","130","0020","0207","523","221","302","10","533","1294","0","41.19","17.08"
"66","000","00","130","0020","0208","501","247","254","4","505","1109","0","45.54","22.27"
"66","000","00","130","0020","0209","422","188","234","4","426","962","0","44.28","19.54"
"66","000","00","130","0021","0000","3028","1638","1390","21","3049","7321","0","41.65","22.37"
"66","000","00","130","0021","0255","609","317","292","7","616","1353","0","45.53","23.43"
"66","000","00","130","0021","0256","531","263","268","3","534","1340","0","39.85","19.63"
"66","000","00","130","0021","0257","503","291","212","3","506","1141","0","44.35","25.50"
"66","000","00","130","0021","0258","401","210","191","2","403","1000","0","40.30","21.00"
"66","000","00","130","0021","0259","318","174","144","1","319","886","0","36.00","19.64"
"66","000","00","130","0021","0260","666","383","283","5","671","1601","0","41.91","23.92"
"66","000","00","140","0000","0000","18628","8863","9765","189","18817","48591","59487","38.73","18.24"
"66","000","00","140","0001","0000","1432","687","745","9","1441","3632","0","39.68","18.92"
"66","000","00","140","0001","0158","440","184","256","3","443","1103","0","40.16","16.68"
"66","000","00","140","0001","0159","458","223","235","2","460","1200","0","38.33","18.58"
"66","000","00","140","0001","0160","534","280","254","4","538","1329","0","40.48","21.07"
"66","000","00","140","0002","0000","835","395","440","8","843","1967","0","42.86","20.08"
"66","000","00","140","0002","0161","483","218","265","3","486","1109","0","43.82","19.66"
"66","000","00","140","0002","0162","352","177","175","5","357","858","0","41.61","20.63"
"66","000","00","140","0003","0000","1495","775","720","12","1507","3879","0","38.85","19.98"
"66","000","00","140","0003","0163","401","203","198","5","406","1016","0","39.96","19.98"
"66","000","00","140","0003","0164","577","297","280","5","582","1440","0","40.42","20.63"
"66","000","00","140","0003","0165","517","275","242","2","519","1423","0","36.47","19.33"
"66","000","00","140","0004","0000","226","107","119","0","226","484","0","46.69","22.11"
"66","000","00","140","0004","0166","226","107","119","0","226","484","0","46.69","22.11"
"66","000","00","140","0005","0000","488","257","231","6","494","1161","0","42.55","22.14"
"66","000","00","140","0005","0167","488","257","231","6","494","1161","0","42.55","22.14"
"66","000","00","140","0006","0000","332","157","175","0","332","780","0","42.56","20.13"
"66","000","00","140","0006","0168","332","157","175","0","332","780","0","42.56","20.13"
"66","000","00","140","0007","0000","2410","1151","1259","26","2436","6132","0","39.73","18.77"
"66","000","00","140","0007","0169","374","198","176","5","379","993","0","38.17","19.94"
"66","000","00","140","0007","0170","565","267","298","4","569","1334","0","42.65","20.01"
"66","000","00","140","0007","0171","377","151","226","4","381","1020","0","37.35","14.80"
"66","000","00","140","0007","0172","549","262","287","8","557","1389","0","40.10","18.86"
"66","000","00","140","0007","0173","545","273","272","5","550","1396","0","39.40","19.56"
"66","000","00","140","0008","0000","1979","885","1094","17","1996","5294","0","37.70","16.72"
"66","000","00","140","0008","0174","473","197","276","6","479","1282","0","37.36","15.37"
"66","000","00","140","0008","0175","481","202","279","2","483","1292","0","37.38","15.63"
"66","000","00","140","0008","0176","504","218","286","3","507","1267","0","40.02","17.21"
"66","000","00","140","0008","0177","521","268","253","6","527","1453","0","36.27","18.44"
"66","000","00","140","0009","0000","1750","794","956","19","1769","4953","0","35.72","16.03"
"66","000","00","140","0009","0178","463","204","259","5","468","1231","0","38.02","16.57"
"66","000","00","140","0009","0179","412","199","213","3","415","1235","0","33.60","16.11"
"66","000","00","140","0009","0180","455","221","234","4","459","1237","0","37.11","17.87"
"66","000","00","140","0009","0181","420","170","250","7","427","1250","0","34.16","13.60"
"66","000","00","140","0010","0000","2880","1442","1438","35","2915","7509","0","38.82","19.20"
"66","000","00","140","0010","0182","409","207","202","7","416","962","0","43.24","21.52"
"66","000","00","140","0010","0183","477","223","254","5","482","1238","0","38.93","18.01"
"66","000","00","140","0010","0184","531","259","272","5","536","1409","0","38.04","18.38"
"66","000","00","140","0010","0185","421","212","209","8","429","1181","0","36.33","17.95"
"66","000","00","140","0010","0186","465","247","218","3","468","1254","0","37.32","19.70"
"66","000","00","140","0010","0187","577","294","283","7","584","1465","0","39.86","20.07"
"66","000","00","140","0011","0000","2194","1052","1142","20","2214","5687","0","38.93","18.50"
"66","000","00","140","0011","0188","551","263","288","2","553","1466","0","37.72","17.94"
"66","000","00","140","0011","0189","519","276","243","6","525","1348","0","38.95","20.47"
"66","000","00","140","0011","0190","474","206","268","8","482","1289","0","37.39","15.98"
"66","000","00","140","0011","0191","650","307","343","4","654","1584","0","41.29","19.38"
"66","000","00","140","0012","0000","827","376","451","10","837","2322","0","36.05","16.19"
"66","000","00","140","0012","0192","359","182","177","4","363","1034","0","35.11","17.60"
"66","000","00","140","0012","0193","468","194","274","6","474","1288","0","36.80","15.06"
"66","000","00","140","0013","0000","859","371","488","12","871","2298","0","37.90","16.14"
"66","000","00","140","0013","0194","399","162","237","4","403","1077","0","37.42","15.04"
"66","000","00","140","0013","0195","460","209","251","8","468","1221","0","38.33","17.12"
"66","000","00","140","0014","0000","921","414","507","15","936","2493","0","37.55","16.61"
"66","000","00","140","0014","0196","503","232","271","10","513","1394","0","36.80","16.64"
"66","000","00","140","0014","0197","418","182","236","5","423","1099","0","38.49","16.56"
"66","000","00","150","0000","0000","17390","8643","8747","216","17606","45052","54126","39.08","19.18"
"66","000","00","150","0001","0000","774","507","267","21","795","2076","0","38.29","24.42"
"66","000","00","150","0001","0456","329","206","123","6","335","882","0","37.98","23.36"
"66","000","00","150","0001","0457","445","301","144","15","460","1194","0","38.53","25.21"
"66","000","00","150","0002","0000","384","196","188","9","393","1031","0","38.12","19.01"
"66","000","00","150","0002","0458","384","196","188","9","393","1031","0","38.12","19.01"
"66","000","00","150","0003","0000","1188","692","496","15","1203","3086","0","38.98","22.42"
"66","000","00","150","0003","0459","406","221","185","3","409","1085","0","37.70","20.37"
"66","000","00","150","0003","0460","393","253","140","8","401","1020","0","39.31","24.80"
"66","000","00","150","0003","0461","389","218","171","4","393","981","0","40.06","22.22"
"66","000","00","150","0004","0000","1563","802","761","14","1577","3652","0","43.18","21.96"
"66","000","00","150","0004","0464","498","262","236","3","501","1169","0","42.86","22.41"
"66","000","00","150","0004","0465","510","251","259","6","516","1156","0","44.64","21.71"
"66","000","00","150","0004","0466","555","289","266","5","560","1327","0","42.20","21.78"
"66","000","00","150","0005","0000","830","415","415","9","839","2136","0","39.28","19.43"
"66","000","00","150","0005","0467","394","187","207","0","394","991","0","39.76","18.87"
"66","000","00","150","0005","0468","436","228","208","9","445","1145","0","38.86","19.91"
"66","000","00","150","0006","0000","1918","993","925","20","1938","4739","0","40.89","20.95"
"66","000","00","150","0006","0469","446","245","201","5","451","1171","0","38.51","20.92"
"66","000","00","150","0006","0470","491","258","233","3","494","1133","0","43.60","22.77"
"66","000","00","150","0006","0471","448","221","227","5","453","1252","0","36.18","17.65"
"66","000","00","150","0006","0472","533","269","264","7","540","1183","0","45.65","22.74"
"66","000","00","150","0007","0000","763","330","433","4","767","1917","0","40.01","17.21"
"66","000","00","150","0007","0473","371","178","193","1","372","954","0","38.99","18.66"
"66","000","00","150","0007","0474","392","152","240","3","395","963","0","41.02","15.78"
"66","000","00","150","0008","0000","1328","618","710","14","1342","3347","0","40.10","18.46"
"66","000","00","150","0008","0475","487","237","250","3","490","1173","0","41.77","20.20"
"66","000","00","150","0008","0476","455","196","259","6","461","1136","0","40.58","17.25"
"66","000","00","150","0008","0477","386","185","201","5","391","1038","0","37.67","17.82"
"66","000","00","150","0009","0000","1431","644","787","14","1445","3538","0","40.84","18.20"
"66","000","00","150","0009","0478","573","278","295","7","580","1278","0","45.38","21.75"
"66","000","00","150","0009","0479","408","164","244","3","411","1102","0","37.30","14.88"
"66","000","00","150","0009","0480","450","202","248","4","454","1158","0","39.21","17.44"
"66","000","00","150","0010","0000","933","420","513","17","950","2376","0","39.98","17.68"
"66","000","00","150","0010","0481","461","213","248","15","476","1179","0","40.37","18.07"
"66","000","00","150","0010","0482","472","207","265","2","474","1197","0","39.60","17.29"
"66","000","00","150","0011","0000","820","402","418","10","830","2187","0","37.95","18.38"
"66","000","00","150","0011","0483","453","220","233","6","459","1183","0","38.80","18.60"
"66","000","00","150","0011","0484","367","182","185","4","371","1004","0","36.95","18.13"
"66","000","00","150","0012","0000","616","270","346","6","622","1559","0","39.90","17.32"
"66","000","00","150","0012","0485","275","128","147","3","278","696","0","39.94","18.39"
"66","000","00","150","0012","0486","341","142","199","3","344","863","0","39.86","16.45"
"66","000","00","150","0013","0000","706","336","370","6","712","2131","0","33.41","15.77"
"66","000","00","150","0013","0487","354","174","180","5","359","1051","0","34.16","16.56"
"66","000","00","150","0013","0488","352","162","190","1","353","1080","0","32.69","15.00"
"66","000","00","150","0014","0000","1143","576","567","14","1157","3198","0","36.18","18.01"
"66","000","00","150","0014","0489","383","177","206","7","390","1084","0","35.98","16.33"
"66","000","00","150","0014","0490","423","208","215","6","429","1118","0","38.37","18.60"
"66","000","00","150","0014","0491","337","191","146","1","338","996","0","33.94","19.18"
"66","000","00","150","0015","0000","521","230","291","4","525","1393","0","37.69","16.51"
"66","000","00","150","0015","0496","521","230","291","4","525","1393","0","37.69","16.51"
"66","000","00","150","0016","0000","734","334","400","16","750","2139","0","35.06","15.61"
"66","000","00","150","0016","0494","379","158","221","8","387","1032","0","37.50","15.31"
"66","000","00","150","0016","0495","355","176","179","8","363","1107","0","32.79","15.90"
"66","000","00","150","0017","0000","770","311","459","11","781","1956","0","39.93","15.90"
"66","000","00","150","0017","0492","399","176","223","4","403","986","0","40.87","17.85"
"66","000","00","150","0017","0493","371","135","236","7","378","970","0","38.97","13.92"
"66","000","00","150","0018","0000","968","567","401","12","980","2591","0","37.82","21.88"
"66","000","00","150","0018","0462","484","288","196","5","489","1380","0","35.43","20.87"
"66","000","00","150","0018","0463","484","279","205","7","491","1211","0","40.55","23.04"
"66","000","00","160","0000","0000","21596","9133","12463","212","21808","54903","65143","39.72","16.63"
"66","000","00","160","0001","0000","1235","604","631","13","1248","3173","0","39.33","19.04"
"66","000","00","160","0001","0497","407","198","209","6","413","1055","0","39.15","18.77"
"66","000","00","160","0001","0498","396","193","203","4","400","978","0","40.90","19.73"
"66","000","00","160","0001","0499","432","213","219","3","435","1140","0","38.16","18.68"
"66","000","00","160","0002","0000","957","425","532","8","965","2296","0","42.03","18.51"
"66","000","00","160","0002","0500","499","221","278","5","504","1240","0","40.65","17.82"
"66","000","00","160","0002","0501","458","204","254","3","461","1056","0","43.66","19.32"
"66","000","00","160","0003","0000","1053","454","599","11","1064","2611","0","40.75","17.39"
"66","000","00","160","0003","0502","518","216","302","3","521","1298","0","40.14","16.64"
"66","000","00","160","0003","0503","535","238","297","8","543","1313","0","41.36","18.13"
"66","000","00","160","0004","0000","939","351","588","6","945","2220","0","42.57","15.81"
"66","000","00","160","0004","0504","476","164","312","4","480","1138","0","42.18","14.41"
"66","000","00","160","0004","0505","463","187","276","2","465","1082","0","42.98","17.28"
"66","000","00","160","0005","0000","2840","1238","1602","18","2858","7481","0","38.20","16.55"
"66","000","00","160","0005","0514","460","210","250","2","462","1258","0","36.72","16.69"
"66","000","00","160","0005","0515","457","207","250","7","464","1250","0","37.12","16.56"
"66","000","00","160","0005","0516","494","211","283","2","496","1377","0","36.02","15.32"
"66","000","00","160","0005","0517","447","197","250","0","447","1131","0","39.52","17.42"
"66","000","00","160","0005","0518","478","188","290","1","479","1232","0","38.88","15.26"
"66","000","00","160","0005","0519","504","225","279","6","510","1233","0","41.36","18.25"
"66","000","00","160","0006","0000","2098","836","1262","13","2111","5257","0","40.16","15.90"
"66","000","00","160","0006","0520","473","188","285","5","478","1379","0","34.66","13.63"
"66","000","00","160","0006","0521","530","209","321","2","532","1150","0","46.26","18.17"
"66","000","00","160","0006","0522","581","242","339","2","583","1442","0","40.43","16.78"
"66","000","00","160","0006","0523","514","197","317","4","518","1286","0","40.28","15.32"
"66","000","00","160","0007","0000","1082","404","678","6","1088","2555","0","42.58","15.81"
"66","000","00","160","0007","0524","530","208","322","3","533","1170","0","45.56","17.78"
"66","000","00","160","0007","0525","552","196","356","3","555","1385","0","40.07","14.15"
"66","000","00","160","0008","0000","1184","444","740","13","1197","2845","0","42.07","15.61"
"66","000","00","160","0008","0530","643","239","404","4","647","1444","0","44.81","16.55"
"66","000","00","160","0008","0531","541","205","336","9","550","1401","0","39.26","14.63"
"66","000","00","160","0009","0000","1684","771","913","13","1697","4465","0","38.01","17.27"
"66","000","00","160","0009","0526","480","204","276","2","482","1118","0","43.11","18.25"
"66","000","00","160","0009","0527","448","184","264","2","450","1124","0","40.04","16.37"
"66","000","00","160","0009","0528","342","189","153","3","345","1005","0","34.33","18.81"
"66","000","00","160","0009","0529","414","194","220","6","420","1218","0","34.48","15.93"
"66","000","00","160","0010","0000","2788","1192","1596","27","2815","7152","0","39.36","16.67"
"66","000","00","160","0010","0532","424","201","223","2","426","1229","0","34.66","16.35"
"66","000","00","160","0010","0533","477","196","281","4","481","1303","0","36.91","15.04"
"66","000","00","160","0010","0534","425","157","268","8","433","1075","0","40.28","14.60"
"66","000","00","160","0010","0535","549","231","318","3","552","1311","0","42.11","17.62"
"66","000","00","160","0010","0536","405","163","242","6","411","1024","0","40.14","15.92"
"66","000","00","160","0010","0537","508","244","264","4","512","1210","0","42.31","20.17"
"66","000","00","160","0011","0000","1076","405","671","18","1094","2539","0","43.09","15.95"
"66","000","00","160","0011","0538","538","188","350","7","545","1215","0","44.86","15.47"
"66","000","00","160","0011","0539","538","217","321","11","549","1324","0","41.47","16.39"
"66","000","00","160","0012","0000","1106","462","644","20","1126","2800","0","40.21","16.50"
"66","000","00","160","0012","0540","545","250","295","9","554","1464","0","37.84","17.08"
"66","000","00","160","0012","0541","561","212","349","11","572","1336","0","42.81","15.87"
"66","000","00","160","0013","0000","888","427","461","17","905","2268","0","39.90","18.83"
"66","000","00","160","0013","0506","508","211","297","9","517","1199","0","43.12","17.60"
"66","000","00","160","0013","0507","380","216","164","8","388","1069","0","36.30","20.21"
"66","000","00","160","0014","0000","1455","599","856","16","1471","4135","0","35.57","14.49"
"66","000","00","160","0014","0510","478","183","295","1","479","1301","0","36.82","14.07"
"66","000","00","160","0014","0511","527","211","316","11","538","1396","0","38.54","15.11"
"66","000","00","160","0014","0512","450","205","245","4","454","1438","0","31.57","14.26"
"66","000","00","160","0015","0000","800","378","422","8","808","2090","0","38.66","18.09"
"66","000","00","160","0015","0508","395","175","220","3","398","887","0","44.87","19.73"
"66","000","00","160","0015","0509","405","203","202","5","410","1203","0","34.08","16.87"
"66","000","00","160","0016","0000","411","143","268","5","416","1016","0","40.94","14.07"
"66","000","00","160","0016","0513","411","143","268","5","416","1016","0","40.94","14.07"
"66","000","00","170","0000","0000","37682","18303","19379","296","37978","91035","109158","41.72","20.11"
"66","000","00","170","0001","0000","4318","2066","2252","34","4352","10990","0","39.60","18.80"
"66","000","00","170","0001","0600","460","206","254","4","464","1184","0","39.19","17.40"
"66","000","00","170","0001","0601","466","224","242","4","470","1267","0","37.10","17.68"
"66","000","00","170","0001","0602","494","196","298","4","498","1322","0","37.67","14.83"
"66","000","00","170","0001","0603","386","190","196","5","391","987","0","39.61","19.25"
"66","000","00","170","0001","0604","565","267","298","4","569","1376","0","41.35","19.40"
"66","000","00","170","0001","0605","591","322","269","8","599","1485","0","40.34","21.68"
"66","000","00","170","0001","0606","471","227","244","3","474","1199","0","39.53","18.93"
"66","000","00","170","0001","0607","461","231","230","1","462","1120","0","41.25","20.63"
"66","000","00","170","0001","0608","424","203","221","1","425","1050","0","40.48","19.33"
"66","000","00","170","0002","0000","595","228","367","7","602","1262","0","47.70","18.07"
"66","000","00","170","0002","0597","595","228","367","7","602","1262","0","47.70","18.07"
"66","000","00","170","0003","0000","1017","518","499","8","1025","2378","0","43.10","21.78"
"66","000","00","170","0003","0598","483","268","215","6","489","1119","0","43.70","23.95"
"66","000","00","170","0003","0599","534","250","284","2","536","1259","0","42.57","19.86"
"66","000","00","170","0004","0000","4200","2204","1996","22","4222","10488","0","40.26","21.01"
"66","000","00","170","0004","0609","565","286","279","5","570","1308","0","43.58","21.87"
"66","000","00","170","0004","0610","522","283","239","3","525","1379","0","38.07","20.52"
"66","000","00","170","0004","0611","466","234","232","1","467","1426","0","32.75","16.41"
"66","000","00","170","0004","0612","464","249","215","3","467","1145","0","40.79","21.75"
"66","000","00","170","0004","0613","611","319","292","4","615","1425","0","43.16","22.39"
"66","000","00","170","0004","0614","635","329","306","3","638","1463","0","43.61","22.49"
"66","000","00","170","0004","0615","561","324","237","1","562","1339","0","41.97","24.20"
"66","000","00","170","0004","0616","376","180","196","2","378","1003","0","37.69","17.95"
"66","000","00","170","0005","0000","2275","1198","1077","21","2296","5345","0","42.96","22.41"
"66","000","00","170","0005","0617","653","344","309","7","660","1422","0","46.41","24.19"
"66","000","00","170","0005","0618","521","256","265","5","526","1365","0","38.53","18.75"
"66","000","00","170","0005","0619","567","301","266","4","571","1269","0","45.00","23.72"
"66","000","00","170","0005","0620","534","297","237","5","539","1289","0","41.82","23.04"
"66","000","00","170","0006","0000","3873","2007","1866","21","3894","9332","0","41.73","21.51"
"66","000","00","170","0006","0635","602","335","267","4","606","1324","0","45.77","25.30"
"66","000","00","170","0006","0636","614","319","295","3","617","1311","0","47.06","24.33"
"66","000","00","170","0006","0637","552","285","267","0","552","1372","0","40.23","20.77"
"66","000","00","170","0006","0638","604","281","323","1","605","1407","0","43.00","19.97"
"66","000","00","170","0006","0639","533","283","250","5","538","1325","0","40.60","21.36"
"66","000","00","170","0006","0640","459","231","228","3","462","1298","0","35.59","17.80"
"66","000","00","170","0006","0641","509","273","236","5","514","1295","0","39.69","21.08"
"66","000","00","170","0007","0000","5015","2321","2694","41","5056","12018","0","42.07","19.31"
"66","000","00","170","0007","0642","554","269","285","8","562","1369","0","41.05","19.65"
"66","000","00","170","0007","0643","593","276","317","3","596","1354","0","44.02","20.38"
"66","000","00","170","0007","0644","548","211","337","6","554","1268","0","43.69","16.64"
"66","000","00","170","0007","0645","605","286","319","6","611","1458","0","41.91","19.62"
"66","000","00","170","0007","0646","583","280","303","3","586","1250","0","46.88","22.40"
"66","000","00","170","0007","0647","512","277","235","9","521","1219","0","42.74","22.72"
"66","000","00","170","0007","0648","541","256","285","1","542","1470","0","36.87","17.41"
"66","000","00","170","0007","0649","597","253","344","2","599","1314","0","45.59","19.25"
"66","000","00","170","0007","0650","482","213","269","3","485","1316","0","36.85","16.19"
"66","000","00","170","0008","0000","1216","543","673","11","1227","2801","0","43.81","19.39"
"66","000","00","170","0008","0651","625","259","366","4","629","1453","0","43.29","17.83"
"66","000","00","170","0008","0652","591","284","307","7","598","1348","0","44.36","21.07"
"66","000","00","170","0009","0000","2552","1155","1397","23","2575","6066","0","42.45","19.04"
"66","000","00","170","0009","0653","625","306","319","4","629","1464","0","42.96","20.90"
"66","000","00","170","0009","0654","603","264","339","5","608","1529","0","39.76","17.27"
"66","000","00","170","0009","0655","650","296","354","8","658","1544","0","42.62","19.17"
"66","000","00","170","0009","0656","674","289","385","6","680","1529","0","44.47","18.90"
"66","000","00","170","0010","0000","2115","904","1211","21","2136","4733","0","45.13","19.10"
"66","000","00","170","0010","0657","553","256","297","7","560","1303","0","42.98","19.65"
"66","000","00","170","0010","0658","479","214","265","6","485","1066","0","45.50","20.08"
"66","000","00","170","0010","0659","539","239","300","5","544","1234","0","44.08","19.37"
"66","000","00","170","0010","0660","544","195","349","3","547","1130","0","48.41","17.26"
"66","000","00","170","0011","0000","1610","691","919","18","1628","3997","0","40.73","17.29"
"66","000","00","170","0011","0661","568","203","365","9","577","1442","0","40.01","14.08"
"66","000","00","170","0011","0662","595","289","306","5","600","1447","0","41.47","19.97"
"66","000","00","170","0011","0663","447","199","248","4","451","1108","0","40.70","17.96"
"66","000","00","170","0012","0000","663","259","404","6","669","1536","0","43.55","16.86"
"66","000","00","170","0012","0664","663","259","404","6","669","1536","0","43.55","16.86"
"66","000","00","170","0013","0000","1576","754","822","19","1595","4262","0","37.42","17.69"
"66","000","00","170","0013","0665","559","239","320","7","566","1374","0","41.19","17.39"
"66","000","00","170","0013","0666","557","275","282","8","565","1421","0","39.76","19.35"
"66","000","00","170","0013","0667","460","240","220","4","464","1467","0","31.63","16.36"
"66","000","00","170","0014","0000","1765","897","868","9","1774","4319","0","41.07","20.77"
"66","000","00","170","0014","0621","490","259","231","4","494","1307","0","37.80","19.82"
"66","000","00","170","0014","0622","551","315","236","4","555","1219","0","45.53","25.84"
"66","000","00","170","0014","0623","306","119","187","0","306","711","0","43.04","16.74"
"66","000","00","170","0014","0624","418","204","214","1","419","1082","0","38.72","18.85"
"66","000","00","170","0015","0000","2903","1545","1358","13","2916","6933","0","42.06","22.28"
"66","000","00","170","0015","0625","507","260","247","2","509","1302","0","39.09","19.97"
"66","000","00","170","0015","0626","462","253","209","3","465","1045","0","44.50","24.21"
"66","000","00","170","0015","0627","495","275","220","1","496","1155","0","42.94","23.81"
"66","000","00","170","0015","0628","513","301","212","1","514","1231","0","41.75","24.45"
"66","000","00","170","0015","0629","449","206","243","1","450","998","0","45.09","20.64"
"66","000","00","170","0015","0630","477","250","227","5","482","1202","0","40.10","20.80"
"66","000","00","170","0016","0000","1989","1013","976","22","2011","4575","0","43.96","22.14"
"66","000","00","170","0016","0631","635","310","325","4","639","1360","0","46.99","22.79"
"66","000","00","170","0016","0632","530","292","238","7","537","1215","0","44.20","24.03"
"66","000","00","170","0016","0633","396","202","194","4","400","901","0","44.40","22.42"
"66","000","00","170","0016","0634","428","209","219","7","435","1099","0","39.58","19.02"
"66","000","00","180","0000","0000","30408","15414","14994","244","30652","78438","95800","39.08","19.65"
"66","000","00","180","0001","0000","1788","911","877","15","1803","4325","0","41.69","21.06"
"66","000","00","180","0001","0546","593","319","274","5","598","1407","0","42.50","22.67"
"66","000","00","180","0001","0547","605","319","286","4","609","1456","0","41.83","21.91"
"66","000","00","180","0001","0548","590","273","317","6","596","1462","0","40.77","18.67"
"66","000","00","180","0002","0000","3627","1711","1916","25","3652","9201","0","39.69","18.60"
"66","000","00","180","0002","0578","588","281","307","4","592","1527","0","38.77","18.40"
"66","000","00","180","0002","0579","619","313","306","3","622","1547","0","40.21","20.23"
"66","000","00","180","0002","0580","595","292","303","2","597","1502","0","39.75","19.44"
"66","000","00","180","0002","0581","609","286","323","7","616","1502","0","41.01","19.04"
"66","000","00","180","0002","0582","561","251","310","5","566","1577","0","35.89","15.92"
"66","000","00","180","0002","0583","655","288","367","4","659","1546","0","42.63","18.63"
"66","000","00","180","0003","0000","2397","1317","1080","28","2425","6208","0","39.06","21.21"
"66","000","00","180","0003","0584","542","388","154","7","549","1489","0","36.87","26.06"
"66","000","00","180","0003","0585","698","307","391","7","705","1673","0","42.14","18.35"
"66","000","00","180","0003","0586","528","315","213","4","532","1495","0","35.59","21.07"
"66","000","00","180","0003","0587","629","307","322","10","639","1551","0","41.20","19.79"
"66","000","00","180","0004","0000","1339","600","739","17","1356","3353","0","40.44","17.89"
"66","000","00","180","0004","0588","408","173","235","7","415","1002","0","41.42","17.27"
"66","000","00","180","0004","0589","477","207","270","6","483","1182","0","40.86","17.51"
"66","000","00","180","0004","0590","454","220","234","4","458","1169","0","39.18","18.82"
"66","000","00","180","0005","0000","1299","957","342","14","1313","3594","0","36.53","26.63"
"66","000","00","180","0005","0594","363","287","76","6","369","1107","0","33.33","25.93"
"66","000","00","180","0005","0595","424","295","129","6","430","1175","0","36.60","25.11"
"66","000","00","180","0005","0596","512","375","137","2","514","1312","0","39.18","28.58"
"66","000","00","180","0006","0000","1706","826","880","12","1718","4313","0","39.83","19.15"
"66","000","00","180","0006","0591","564","258","306","4","568","1434","0","39.61","17.99"
"66","000","00","180","0006","0592","636","305","331","6","642","1557","0","41.23","19.59"
"66","000","00","180","0006","0593","506","263","243","2","508","1322","0","38.43","19.89"
"66","000","00","180","0007","0000","2040","1010","1030","24","2064","5252","0","39.30","19.23"
"66","000","00","180","0007","0553","522","261","261","8","530","1293","0","40.99","20.19"
"66","000","00","180","0007","0554","602","271","331","7","609","1464","0","41.60","18.51"
"66","000","00","180","0007","0555","429","208","221","6","435","1194","0","36.43","17.42"
"66","000","00","180","0007","0556","487","270","217","3","490","1301","0","37.66","20.75"
"66","000","00","180","0008","0000","1755","822","933","12","1767","4779","0","36.97","17.20"
"66","000","00","180","0008","0564","556","260","296","3","559","1664","0","33.59","15.63"
"66","000","00","180","0008","0565","605","294","311","1","606","1558","0","38.90","18.87"
"66","000","00","180","0008","0566","594","268","326","8","602","1557","0","38.66","17.21"
"66","000","00","180","0009","0000","2296","1058","1238","20","2316","6244","0","37.09","16.94"
"66","000","00","180","0009","0567","587","278","309","3","590","1557","0","37.89","17.85"
"66","000","00","180","0009","0568","564","259","305","4","568","1511","0","37.59","17.14"
"66","000","00","180","0009","0569","529","222","307","9","538","1529","0","35.19","14.52"
"66","000","00","180","0009","0570","616","299","317","4","620","1647","0","37.64","18.15"
"66","000","00","180","0010","0000","2318","1161","1157","12","2330","5915","0","39.39","19.63"
"66","000","00","180","0010","0557","601","283","318","2","603","1450","0","41.59","19.52"
"66","000","00","180","0010","0558","567","268","299","3","570","1525","0","37.38","17.57"
"66","000","00","180","0010","0559","612","312","300","6","618","1467","0","42.13","21.27"
"66","000","00","180","0010","0560","538","298","240","1","539","1473","0","36.59","20.23"
"66","000","00","180","0011","0000","1928","1014","914","12","1940","4622","0","41.97","21.94"
"66","000","00","180","0011","0561","665","358","307","5","670","1599","0","41.90","22.39"
"66","000","00","180","0011","0562","616","321","295","3","619","1526","0","40.56","21.04"
"66","000","00","180","0011","0563","647","335","312","4","651","1497","0","43.49","22.38"
"66","000","00","180","0012","0000","2275","1113","1162","16","2291","6037","0","37.95","18.44"
"66","000","00","180","0012","0542","578","314","264","4","582","1504","0","38.70","20.88"
"66","000","00","180","0012","0543","568","246","322","1","569","1478","0","38.50","16.64"
"66","000","00","180","0012","0544","502","208","294","6","508","1538","0","33.03","13.52"
"66","000","00","180","0012","0545","627","345","282","5","632","1517","0","41.66","22.74"
"66","000","00","180","0013","0000","2357","1262","1095","9","2366","6021","0","39.30","20.96"
"66","000","00","180","0013","0549","584","343","241","1","585","1530","0","38.24","22.42"
"66","000","00","180","0013","0550","609","348","261","3","612","1547","0","39.56","22.50"
"66","000","00","180","0013","0551","628","315","313","2","630","1499","0","42.03","21.01"
"66","000","00","180","0013","0552","536","256","280","3","539","1445","0","37.30","17.72"
"66","000","00","180","0014","0000","1952","959","993","20","1972","5029","0","39.21","19.07"
"66","000","00","180","0014","0571","475","250","225","5","480","1310","0","36.64","19.08"
"66","000","00","180","0014","0572","524","265","259","4","528","1313","0","40.21","20.18"
"66","000","00","180","0014","0573","484","236","248","6","490","1210","0","40.50","19.50"
"66","000","00","180","0014","0574","469","208","261","5","474","1196","0","39.63","17.39"
"66","000","00","180","0015","0000","1331","693","638","8","1339","3545","0","37.77","19.55"
"66","000","00","180","0015","0575","392","197","195","3","395","1034","0","38.20","19.05"
"66","000","00","180","0015","0576","481","245","236","2","483","1122","0","43.05","21.84"
"66","000","00","180","0015","0577","458","251","207","3","461","1389","0","33.19","18.07"
"66","000","00","190","0000","0000","8050","4040","4010","130","8180","20710","23859","39.50","19.51"
"66","000","00","190","0001","0000","1367","754","613","20","1387","3261","0","42.53","23.12"
"66","000","00","190","0001","1792","451","229","222","4","455","1005","0","45.27","22.79"
"66","000","00","190","0001","1793","486","263","223","6","492","1181","0","41.66","22.27"
"66","000","00","190","0001","1794","430","262","168","10","440","1075","0","40.93","24.37"
"66","000","00","190","0002","0000","606","331","275","7","613","1835","0","33.41","18.04"
"66","000","00","190","0002","1795","300","153","147","2","302","906","0","33.33","16.89"
"66","000","00","190","0002","1796","306","178","128","5","311","929","0","33.48","19.16"
"66","000","00","190","0003","0000","536","279","257","7","543","1342","0","40.46","20.79"
"66","000","00","190","0003","1797","536","279","257","7","543","1342","0","40.46","20.79"
"66","000","00","190","0004","0000","379","161","218","10","389","986","0","39.45","16.33"
"66","000","00","190","0004","1798","379","161","218","10","389","986","0","39.45","16.33"
"66","000","00","190","0005","0000","471","161","310","1","472","1156","0","40.83","13.93"
"66","000","00","190","0005","1799","471","161","310","1","472","1156","0","40.83","13.93"
"66","000","00","190","0006","0000","722","376","346","15","737","1879","0","39.22","20.01"
"66","000","00","190","0006","1800","394","199","195","6","400","987","0","40.53","20.16"
"66","000","00","190","0006","1801","328","177","151","9","337","892","0","37.78","19.84"
"66","000","00","190","0007","0000","1157","468","689","21","1178","2983","0","39.49","15.69"
"66","000","00","190","0007","1802","380","196","184","5","385","1047","0","36.77","18.72"
"66","000","00","190","0007","1803","399","149","250","10","409","1060","0","38.58","14.06"
"66","000","00","190","0007","1804","378","123","255","6","384","876","0","43.84","14.04"
"66","000","00","190","0008","0000","266","202","64","1","267","582","0","45.88","34.71"
"66","000","00","190","0008","1805","266","202","64","1","267","582","0","45.88","34.71"
"66","000","00","190","0009","0000","1098","480","618","18","1116","2927","0","38.13","16.40"
"66","000","00","190","0009","1806","369","172","197","4","373","1004","0","37.15","17.13"
"66","000","00","190","0009","1807","358","128","230","11","369","909","0","40.59","14.08"
"66","000","00","190","0009","1808","371","180","191","3","374","1014","0","36.88","17.75"
"66","000","00","190","0010","0000","489","299","190","9","498","1187","0","41.95","25.19"
"66","000","00","190","0010","1809","489","299","190","9","498","1187","0","41.95","25.19"
"66","000","00","190","0011","0000","318","127","191","8","326","885","0","36.84","14.35"
"66","000","00","190","0011","1810","110","58","52","2","112","229","0","48.91","25.33"
"66","000","00","190","0011","1811","208","69","139","6","214","656","0","32.62","10.52"
"66","000","00","190","0012","0000","226","173","53","6","232","575","0","40.35","30.09"
"66","000","00","190","0012","1812","226","173","53","6","232","575","0","40.35","30.09"
"66","000","00","190","0013","0000","415","229","186","7","422","1112","0","37.95","20.59"
"66","000","00","190","0013","1813","320","156","164","6","326","897","0","36.34","17.39"
"66","000","00","190","0013","1814","95","73","22","1","96","215","0","44.65","33.95"
"66","000","00","200","0000","0000","5206","2775","2431","81","5287","12679","14532","41.70","21.89"
"66","000","00","200","0001","0000","440","227","213","6","446","1210","0","36.86","18.76"
"66","000","00","200","0001","1781","440","227","213","6","446","1210","0","36.86","18.76"
"66","000","00","200","0002","0000","648","329","319","8","656","1518","0","43.21","21.67"
"66","000","00","200","0002","1782","648","329","319","8","656","1518","0","43.21","21.67"
"66","000","00","200","0003","0000","523","269","254","3","526","1204","0","43.69","22.34"
"66","000","00","200","0003","1783","523","269","254","3","526","1204","0","43.69","22.34"
"66","000","00","200","0004","0000","459","227","232","10","469","1232","0","38.07","18.43"
"66","000","00","200","0004","1784","459","227","232","10","469","1232","0","38.07","18.43"
"66","000","00","200","0005","0000","259","127","132","4","263","638","0","41.22","19.91"
"66","000","00","200","0005","1785","259","127","132","4","263","638","0","41.22","19.91"
"66","000","00","200","0006","0000","618","327","291","11","629","1443","0","43.59","22.66"
"66","000","00","200","0006","1786","618","327","291","11","629","1443","0","43.59","22.66"
"66","000","00","200","0007","0000","749","388","361","15","764","1794","0","42.59","21.63"
"66","000","00","200","0007","1787","282","126","156","7","289","674","0","42.88","18.69"
"66","000","00","200","0007","1788","467","262","205","8","475","1120","0","42.41","23.39"
"66","000","00","200","0008","0000","414","237","177","6","420","1002","0","41.92","23.65"
"66","000","00","200","0008","1789","414","237","177","6","420","1002","0","41.92","23.65"
"66","000","00","200","0009","0000","568","329","239","13","581","1408","0","41.26","23.37"
"66","000","00","200","0009","1790","568","329","239","13","581","1408","0","41.26","23.37"
"66","000","00","200","0010","0000","528","315","213","5","533","1230","0","43.33","25.61"
"66","000","00","200","0010","1791","528","315","213","5","533","1230","0","43.33","25.61"
"66","000","00","210","0000","0000","9781","5191","4590","100","9881","27041","31790","36.54","19.20"
"66","000","00","210","0001","0000","385","211","174","5","390","1099","0","35.49","19.20"
"66","000","00","210","0001","0075","385","211","174","5","390","1099","0","35.49","19.20"
"66","000","00","210","0002","0000","776","439","337","4","780","2193","0","35.57","20.02"
"66","000","00","210","0002","0076","351","210","141","0","351","1038","0","33.82","20.23"
"66","000","00","210","0002","0077","425","229","196","4","429","1155","0","37.14","19.83"
"66","000","00","210","0003","0000","620","328","292","7","627","1887","0","33.23","17.38"
"66","000","00","210","0003","0087","394","215","179","4","398","1070","0","37.20","20.09"
"66","000","00","210","0003","0088","226","113","113","3","229","817","0","28.03","13.83"
"66","000","00","210","0004","0000","1764","990","774","17","1781","4680","0","38.06","21.15"
"66","000","00","210","0004","0078","418","234","184","3","421","1083","0","38.87","21.61"
"66","000","00","210","0004","0079","366","178","188","3","369","849","0","43.46","20.97"
"66","000","00","210","0004","0080","484","282","202","7","491","1305","0","37.62","21.61"
"66","000","00","210","0004","0081","496","296","200","4","500","1443","0","34.65","20.51"
"66","000","00","210","0005","0000","1250","654","596","19","1269","3392","0","37.41","19.28"
"66","000","00","210","0005","0089","398","202","196","7","405","1086","0","37.29","18.60"
"66","000","00","210","0005","0090","386","227","159","6","392","1086","0","36.10","20.90"
"66","000","00","210","0005","0091","466","225","241","6","472","1220","0","38.69","18.44"
"66","000","00","210","0006","0000","2337","1235","1102","25","2362","6342","0","37.24","19.47"
"66","000","00","210","0006","0082","421","221","200","4","425","1064","0","39.94","20.77"
"66","000","00","210","0006","0083","430","237","193","4","434","1212","0","35.81","19.55"
"66","000","00","210","0006","0084","437","224","213","4","441","1357","0","32.50","16.51"
"66","000","00","210","0006","0085","508","277","231","5","513","1367","0","37.53","20.26"
"66","000","00","210","0006","0086","541","276","265","8","549","1342","0","40.91","20.57"
"66","000","00","210","0007","0000","477","228","249","4","481","1384","0","34.75","16.47"
"66","000","00","210","0007","0095","477","228","249","4","481","1384","0","34.75","16.47"
"66","000","00","210","0008","0000","522","301","221","4","526","1210","0","43.47","24.88"
"66","000","00","210","0008","0094","522","301","221","4","526","1210","0","43.47","24.88"
"66","000","00","210","0009","0000","704","396","308","7","711","2115","0","33.62","18.72"
"66","000","00","210","0009","0092","293","167","126","4","297","944","0","31.46","17.69"
"66","000","00","210","0009","0093","411","229","182","3","414","1171","0","35.35","19.56"
"66","000","00","210","0010","0000","597","247","350","2","599","1581","0","37.89","15.62"
"66","000","00","210","0010","0096","297","107","190","1","298","815","0","36.56","13.13"
"66","000","00","210","0010","0097","300","140","160","1","301","766","0","39.30","18.28"
"66","000","00","210","0011","0000","349","162","187","6","355","1158","0","30.66","13.99"
"66","000","00","210","0011","0098","349","162","187","6","355","1158","0","30.66","13.99"
"66","000","00","220","0000","0000","5672","2625","3047","65","5737","16320","18688","35.15","16.08"
"66","000","00","220","0001","0000","356","127","229","6","362","1055","0","34.31","12.04"
"66","000","00","220","0001","0058","356","127","229","6","362","1055","0","34.31","12.04"
"66","000","00","220","0002","0000","356","164","192","1","357","1023","0","34.90","16.03"
"66","000","00","220","0002","0059","356","164","192","1","357","1023","0","34.90","16.03"
"66","000","00","220","0003","0000","863","385","478","5","868","2624","0","33.08","14.67"
"66","000","00","220","0003","0060","427","187","240","2","429","1210","0","35.45","15.45"
"66","000","00","220","0003","0061","436","198","238","3","439","1414","0","31.05","14.00"
"66","000","00","220","0004","0000","523","258","265","5","528","1502","0","35.15","17.18"
"66","000","00","220","0004","0064","357","178","179","4","361","872","0","41.40","20.41"
"66","000","00","220","0004","0065","166","80","86","1","167","630","0","26.51","12.70"
"66","000","00","220","0005","0000","392","165","227","8","400","1149","0","34.81","14.36"
"66","000","00","220","0005","0063","392","165","227","8","400","1149","0","34.81","14.36"
"66","000","00","220","0006","0000","448","210","238","2","450","1199","0","37.53","17.51"
"66","000","00","220","0006","0062","448","210","238","2","450","1199","0","37.53","17.51"
"66","000","00","220","0007","0000","338","161","177","8","346","889","0","38.92","18.11"
"66","000","00","220","0007","0066","338","161","177","8","346","889","0","38.92","18.11"
"66","000","00","220","0008","0000","558","260","298","12","570","1753","0","32.52","14.83"
"66","000","00","220","0008","0067","391","171","220","9","400","1291","0","30.98","13.25"
"66","000","00","220","0008","0068","167","89","78","3","170","462","0","36.80","19.26"
"66","000","00","220","0009","0000","337","159","178","1","338","1037","0","32.59","15.33"
"66","000","00","220","0009","0069","337","159","178","1","338","1037","0","32.59","15.33"
"66","000","00","220","0010","0000","450","241","209","4","454","1385","0","32.78","17.40"
"66","000","00","220","0010","0070","211","119","92","4","215","629","0","34.18","18.92"
"66","000","00","220","0010","0071","239","122","117","0","239","756","0","31.61","16.14"
"66","000","00","220","0011","0000","609","298","311","12","621","1738","0","35.73","17.15"
"66","000","00","220","0011","0072","340","140","200","8","348","938","0","37.10","14.93"
"66","000","00","220","0011","0073","269","158","111","4","273","800","0","34.13","19.75"
"66","000","00","220","0012","0000","442","197","245","1","443","966","0","45.86","20.39"
"66","000","00","220","0012","0074","442","197","245","1","443","966","0","45.86","20.39"
"66","000","00","230","0000","0000","28982","13994","14988","230","29212","63587","76907","45.94","22.01"
"66","000","00","230","0001","0000","4122","1973","2149","38","4160","8638","0","48.16","22.84"
"66","000","00","230","0001","0359","720","345","375","7","727","1437","0","50.59","24.01"
"66","000","00","230","0001","0360","614","295","319","8","622","1385","0","44.91","21.30"
"66","000","00","230","0001","0361","594","246","348","5","599","1271","0","47.13","19.35"
"66","000","00","230","0001","0362","696","335","361","4","700","1508","0","46.42","22.21"
"66","000","00","230","0001","0363","688","316","372","5","693","1415","0","48.98","22.33"
"66","000","00","230","0001","0364","810","436","374","9","819","1622","0","50.49","26.88"
"66","000","00","230","0002","0000","1152","527","625","13","1165","2486","0","46.86","21.20"
"66","000","00","230","0002","0365","591","253","338","7","598","1210","0","49.42","20.91"
"66","000","00","230","0002","0366","561","274","287","6","567","1276","0","44.44","21.47"
"66","000","00","230","0003","0000","2500","1262","1238","24","2524","5768","0","43.76","21.88"
"66","000","00","230","0003","0367","875","386","489","9","884","1785","0","49.52","21.62"
"66","000","00","230","0003","0368","690","336","354","5","695","1792","0","38.78","18.75"
"66","000","00","230","0003","0369","398","254","144","7","405","1012","0","40.02","25.10"
"66","000","00","230","0003","0370","537","286","251","3","540","1179","0","45.80","24.26"
"66","000","00","230","0004","0000","2468","1335","1133","9","2477","5795","0","42.74","23.04"
"66","000","00","230","0004","0371","664","359","305","0","664","1636","0","40.59","21.94"
"66","000","00","230","0004","0372","557","325","232","2","559","1379","0","40.54","23.57"
"66","000","00","230","0004","0373","612","329","283","6","618","1348","0","45.85","24.41"
"66","000","00","230","0004","0374","635","322","313","1","636","1432","0","44.41","22.49"
"66","000","00","230","0005","0000","1141","617","524","10","1151","2612","0","44.07","23.62"
"66","000","00","230","0005","0375","608","333","275","5","613","1389","0","44.13","23.97"
"66","000","00","230","0005","0376","533","284","249","5","538","1223","0","43.99","23.22"
"66","000","00","230","0006","0000","5799","2760","3039","30","5829","12829","0","45.44","21.51"
"66","000","00","230","0006","0377","747","347","400","5","752","1541","0","48.80","22.52"
"66","000","00","230","0006","0378","561","261","300","3","564","1305","0","43.22","20.00"
"66","000","00","230","0006","0379","606","279","327","5","611","1229","0","49.72","22.70"
"66","000","00","230","0006","0380","679","364","315","6","685","1492","0","45.91","24.40"
"66","000","00","230","0006","0381","494","167","327","4","498","1075","0","46.33","15.53"
"66","000","00","230","0006","0382","376","201","175","3","379","790","0","47.97","25.44"
"66","000","00","230","0006","0383","544","263","281","3","547","1426","0","38.36","18.44"
"66","000","00","230","0006","0384","580","258","322","0","580","1323","0","43.84","19.50"
"66","000","00","230","0006","0385","710","371","339","0","710","1419","0","50.04","26.15"
"66","000","00","230","0006","0386","502","249","253","1","503","1229","0","40.93","20.26"
"66","000","00","230","0007","0000","3566","1747","1819","26","3592","7556","0","47.54","23.12"
"66","000","00","230","0007","0387","650","272","378","9","659","1376","0","47.89","19.77"
"66","000","00","230","0007","0388","542","266","276","4","546","1280","0","42.66","20.78"
"66","000","00","230","0007","0389","689","371","318","1","690","1388","0","49.71","26.73"
"66","000","00","230","0007","0390","500","260","240","3","503","1069","0","47.05","24.32"
"66","000","00","230","0007","0391","601","304","297","2","603","1171","0","51.49","25.96"
"66","000","00","230","0007","0392","584","274","310","7","591","1272","0","46.46","21.54"
"66","000","00","230","0008","0000","800","337","463","7","807","1621","0","49.78","20.79"
"66","000","00","230","0008","0393","318","133","185","2","320","655","0","48.85","20.31"
"66","000","00","230","0008","0394","482","204","278","5","487","966","0","50.41","21.12"
"66","000","00","230","0009","0000","751","339","412","12","763","1676","0","45.53","20.23"
"66","000","00","230","0009","0395","751","339","412","12","763","1676","0","45.53","20.23"
"66","000","00","230","0010","0000","944","417","527","5","949","2095","0","45.30","19.90"
"66","000","00","230","0010","0396","397","155","242","1","398","884","0","45.02","17.53"
"66","000","00","230","0010","0397","547","262","285","4","551","1211","0","45.50","21.64"
"66","000","00","230","0011","0000","966","419","547","13","979","2196","0","44.58","19.08"
"66","000","00","230","0011","0398","543","251","292","7","550","1222","0","45.01","20.54"
"66","000","00","230","0011","0399","423","168","255","6","429","974","0","44.05","17.25"
"66","000","00","230","0012","0000","1926","875","1051","18","1944","4327","0","44.93","20.22"
"66","000","00","230","0012","0400","633","308","325","6","639","1383","0","46.20","22.27"
"66","000","00","230","0012","0401","739","335","404","7","746","1642","0","45.43","20.40"
"66","000","00","230","0012","0402","554","232","322","5","559","1302","0","42.93","17.82"
"66","000","00","230","0013","0000","1072","495","577","11","1083","2158","0","50.19","22.94"
"66","000","00","230","0013","0403","519","225","294","7","526","1037","0","50.72","21.70"
"66","000","00","230","0013","0404","553","270","283","4","557","1121","0","49.69","24.09"
"66","000","00","230","0014","0000","755","320","435","6","761","1651","0","46.09","19.38"
"66","000","00","230","0014","0405","755","320","435","6","761","1651","0","46.09","19.38"
"66","000","00","230","0015","0000","656","360","296","3","659","1350","0","48.81","26.67"
"66","000","00","230","0015","0406","656","360","296","3","659","1350","0","48.81","26.67"
"66","000","00","230","0016","0000","364","211","153","5","369","829","0","44.51","25.45"
"66","000","00","230","0016","0407","364","211","153","5","369","829","0","44.51","25.45"
"66","000","00","240","0000","0000","20500","10136","10364","191","20691","47755","56669","43.33","21.23"
"66","000","00","240","0001","0000","1741","806","935","16","1757","4325","0","40.62","18.64"
"66","000","00","240","0001","0320","629","273","356","8","637","1459","0","43.66","18.71"
"66","000","00","240","0001","0321","489","233","256","5","494","1373","0","35.98","16.97"
"66","000","00","240","0001","0322","623","300","323","3","626","1493","0","41.93","20.09"
"66","000","00","240","0002","0000","411","186","225","4","415","865","0","47.98","21.50"
"66","000","00","240","0002","0323","411","186","225","4","415","865","0","47.98","21.50"
"66","000","00","240","0003","0000","1492","693","799","10","1502","3486","0","43.09","19.88"
"66","000","00","240","0003","0324","570","285","285","4","574","1242","0","46.22","22.95"
"66","000","00","240","0003","0325","473","209","264","4","477","1254","0","38.04","16.67"
"66","000","00","240","0003","0326","449","199","250","2","451","990","0","45.56","20.10"
"66","000","00","240","0004","0000","641","298","343","7","648","1505","0","43.06","19.80"
"66","000","00","240","0004","0327","641","298","343","7","648","1505","0","43.06","19.80"
"66","000","00","240","0005","0000","1100","591","509","7","1107","2438","0","45.41","24.24"
"66","000","00","240","0005","0328","560","317","243","1","561","1188","0","47.22","26.68"
"66","000","00","240","0005","0329","540","274","266","6","546","1250","0","43.68","21.92"
"66","000","00","240","0006","0000","1127","559","568","7","1134","2601","0","43.60","21.49"
"66","000","00","240","0006","0330","583","297","286","3","586","1333","0","43.96","22.28"
"66","000","00","240","0006","0331","544","262","282","4","548","1268","0","43.22","20.66"
"66","000","00","240","0007","0000","1366","725","641","14","1380","3003","0","45.95","24.14"
"66","000","00","240","0007","0332","384","212","172","3","387","899","0","43.05","23.58"
"66","000","00","240","0007","0333","425","231","194","3","428","888","0","48.20","26.01"
"66","000","00","240","0007","0334","557","282","275","8","565","1216","0","46.46","23.19"
"66","000","00","240","0008","0000","1097","588","509","7","1104","2165","0","50.99","27.16"
"66","000","00","240","0008","0335","413","215","198","6","419","850","0","49.29","25.29"
"66","000","00","240","0008","0336","684","373","311","1","685","1315","0","52.09","28.37"
"66","000","00","240","0009","0000","397","216","181","6","403","819","0","49.21","26.37"
"66","000","00","240","0009","0337","397","216","181","6","403","819","0","49.21","26.37"
"66","000","00","240","0010","0000","727","353","374","7","734","1699","0","43.20","20.78"
"66","000","00","240","0010","0338","727","353","374","7","734","1699","0","43.20","20.78"
"66","000","00","240","0011","0000","767","343","424","9","776","1688","0","45.97","20.32"
"66","000","00","240","0011","0339","767","343","424","9","776","1688","0","45.97","20.32"
"66","000","00","240","0012","0000","368","208","160","6","374","943","0","39.66","22.06"
"66","000","00","240","0012","0340","368","208","160","6","374","943","0","39.66","22.06"
"66","000","00","240","0013","0000","571","281","290","13","584","1310","0","44.58","21.45"
"66","000","00","240","0013","0341","571","281","290","13","584","1310","0","44.58","21.45"
"66","000","00","240","0014","0000","3201","1687","1514","29","3230","7418","0","43.54","22.74"
"66","000","00","240","0014","0342","554","283","271","5","559","1316","0","42.48","21.50"
"66","000","00","240","0014","0343","519","242","277","7","526","1249","0","42.11","19.38"
"66","000","00","240","0014","0344","570","317","253","7","577","1369","0","42.15","23.16"
"66","000","00","240","0014","0345","536","278","258","3","539","1111","0","48.51","25.02"
"66","000","00","240","0014","0346","508","287","221","4","512","1213","0","42.21","23.66"
"66","000","00","240","0014","0347","514","280","234","3","517","1160","0","44.57","24.14"
"66","000","00","240","0015","0000","2051","970","1081","22","2073","5061","0","40.96","19.17"
"66","000","00","240","0015","0348","508","199","309","8","516","1197","0","43.11","16.62"
"66","000","00","240","0015","0349","567","266","301","7","574","1352","0","42.46","19.67"
"66","000","00","240","0015","0350","500","256","244","4","504","1212","0","41.58","21.12"
"66","000","00","240","0015","0351","476","249","227","3","479","1300","0","36.85","19.15"
"66","000","00","240","0016","0000","1946","819","1127","8","1954","4958","0","39.41","16.52"
"66","000","00","240","0016","0352","517","216","301","2","519","1302","0","39.86","16.59"
"66","000","00","240","0016","0353","480","190","290","2","482","1189","0","40.54","15.98"
"66","000","00","240","0016","0354","459","183","276","2","461","1192","0","38.67","15.35"
"66","000","00","240","0016","0355","490","230","260","2","492","1275","0","38.59","18.04"
"66","000","00","240","0017","0000","1497","813","684","19","1516","3471","0","43.68","23.42"
"66","000","00","240","0017","0356","464","196","268","11","475","1191","0","39.88","16.46"
"66","000","00","240","0017","0357","558","336","222","6","564","1187","0","47.51","28.31"
"66","000","00","240","0017","0358","475","281","194","2","477","1093","0","43.64","25.71"
"66","000","00","250","0000","0000","26543","13295","13248","236","26779","64759","78039","41.35","20.53"
"66","000","00","250","0001","0000","1235","653","582","9","1244","3019","0","41.21","21.63"
"66","000","00","250","0001","0269","381","178","203","1","382","932","0","40.99","19.10"
"66","000","00","250","0001","0270","324","176","148","1","325","852","0","38.15","20.66"
"66","000","00","250","0001","0271","530","299","231","7","537","1235","0","43.48","24.21"
"66","000","00","250","0002","0000","1159","581","578","6","1165","2849","0","40.89","20.39"
"66","000","00","250","0002","0272","580","276","304","6","586","1412","0","41.50","19.55"
"66","000","00","250","0002","0273","579","305","274","0","579","1437","0","40.29","21.22"
"66","000","00","250","0003","0000","776","422","354","8","784","1822","0","43.03","23.16"
"66","000","00","250","0003","0274","367","174","193","5","372","941","0","39.53","18.49"
"66","000","00","250","0003","0275","409","248","161","3","412","881","0","46.77","28.15"
"66","000","00","250","0004","0000","1577","761","816","17","1594","3624","0","43.98","21.00"
"66","000","00","250","0004","0276","564","260","304","5","569","1302","0","43.70","19.97"
"66","000","00","250","0004","0277","579","278","301","7","586","1264","0","46.36","21.99"
"66","000","00","250","0004","0278","434","223","211","5","439","1058","0","41.49","21.08"
"66","000","00","250","0005","0000","375","197","178","8","383","1043","0","36.72","18.89"
"66","000","00","250","0005","0279","375","197","178","8","383","1043","0","36.72","18.89"
"66","000","00","250","0006","0000","926","520","406","8","934","2271","0","41.13","22.90"
"66","000","00","250","0006","0280","553","327","226","4","557","1397","0","39.87","23.41"
"66","000","00","250","0006","0281","373","193","180","4","377","874","0","43.14","22.08"
"66","000","00","250","0007","0000","1987","895","1092","19","2006","5015","0","40.00","17.85"
"66","000","00","250","0007","0282","574","276","298","2","576","1465","0","39.32","18.84"
"66","000","00","250","0007","0283","579","309","270","9","588","1375","0","42.76","22.47"
"66","000","00","250","0007","0284","480","225","255","4","484","1318","0","36.72","17.07"
"66","000","00","250","0007","0285","354","85","269","4","358","857","0","41.77","9.92"
"66","000","00","250","0008","0000","1039","432","607","10","1049","2952","0","35.54","14.63"
"66","000","00","250","0008","0286","523","220","303","5","528","1533","0","34.44","14.35"
"66","000","00","250","0008","0287","516","212","304","5","521","1419","0","36.72","14.94"
"66","000","00","250","0009","0000","1967","842","1125","20","1987","4892","0","40.62","17.21"
"66","000","00","250","0009","0288","535","226","309","8","543","1172","0","46.33","19.28"
"66","000","00","250","0009","0289","472","198","274","5","477","1293","0","36.89","15.31"
"66","000","00","250","0009","0290","507","260","247","4","511","1256","0","40.68","20.70"
"66","000","00","250","0009","0291","453","158","295","3","456","1171","0","38.94","13.49"
"66","000","00","250","0010","0000","2191","993","1198","20","2211","5745","0","38.49","17.28"
"66","000","00","250","0010","0292","569","273","296","7","576","1510","0","38.15","18.08"
"66","000","00","250","0010","0293","523","228","295","4","527","1421","0","37.09","16.05"
"66","000","00","250","0010","0294","532","245","287","1","533","1470","0","36.26","16.67"
"66","000","00","250","0010","0295","567","247","320","8","575","1344","0","42.78","18.38"
"66","000","00","250","0011","0000","3093","1589","1504","27","3120","7612","0","40.99","20.87"
"66","000","00","250","0011","0296","566","305","261","9","575","1456","0","39.49","20.95"
"66","000","00","250","0011","0297","564","253","311","7","571","1565","0","36.49","16.17"
"66","000","00","250","0011","0298","630","333","297","3","633","1434","0","44.14","23.22"
"66","000","00","250","0011","0299","399","204","195","1","400","941","0","42.51","21.68"
"66","000","00","250","0011","0300","373","201","172","4","377","918","0","41.07","21.90"
"66","000","00","250","0011","0301","561","293","268","3","564","1298","0","43.45","22.57"
"66","000","00","250","0012","0000","1080","540","540","6","1086","2640","0","41.14","20.45"
"66","000","00","250","0012","0302","557","290","267","4","561","1489","0","37.68","19.48"
"66","000","00","250","0012","0303","523","250","273","2","525","1151","0","45.61","21.72"
"66","000","00","250","0013","0000","2530","1267","1263","20","2550","6354","0","40.13","19.94"
"66","000","00","250","0013","0304","552","285","267","4","556","1492","0","37.27","19.10"
"66","000","00","250","0013","0305","446","228","218","4","450","1197","0","37.59","19.05"
"66","000","00","250","0013","0306","446","252","194","3","449","1116","0","40.23","22.58"
"66","000","00","250","0013","0307","480","212","268","7","487","1155","0","42.16","18.35"
"66","000","00","250","0013","0308","606","290","316","2","608","1394","0","43.62","20.80"
"66","000","00","250","0014","0000","703","299","404","8","711","1558","0","45.64","19.19"
"66","000","00","250","0014","0309","703","299","404","8","711","1558","0","45.64","19.19"
"66","000","00","250","0015","0000","2078","1117","961","18","2096","4747","0","44.15","23.53"
"66","000","00","250","0015","0310","480","233","247","10","490","1087","0","45.08","21.44"
"66","000","00","250","0015","0311","447","216","231","2","449","996","0","45.08","21.69"
"66","000","00","250","0015","0312","591","351","240","1","592","1404","0","42.17","25.00"
"66","000","00","250","0015","0313","560","317","243","5","565","1260","0","44.84","25.16"
"66","000","00","250","0016","0000","3827","2187","1640","32","3859","8616","0","44.79","25.38"
"66","000","00","250","0016","0314","586","326","260","3","589","1380","0","42.68","23.62"
"66","000","00","250","0016","0315","662","401","261","5","667","1523","0","43.80","26.33"
"66","000","00","250","0016","0316","678","329","349","7","685","1546","0","44.31","21.28"
"66","000","00","250","0016","0317","634","373","261","7","641","1423","0","45.05","26.21"
"66","000","00","250","0016","0318","645","363","282","3","648","1348","0","48.07","26.93"
"66","000","00","250","0016","0319","622","395","227","7","629","1396","0","45.06","28.30"
"66","000","00","260","0000","0000","24658","11973","12685","198","24856","55248","64801","44.99","21.67"
"66","000","00","260","0001","0000","540","262","278","6","546","1194","0","45.73","21.94"
"66","000","00","260","0001","0408","540","262","278","6","546","1194","0","45.73","21.94"
"66","000","00","260","0002","0000","4005","1995","2010","18","4023","9381","0","42.88","21.27"
"66","000","00","260","0002","0409","481","238","243","1","482","1155","0","41.73","20.61"
"66","000","00","260","0002","0410","523","250","273","1","524","1129","0","46.41","22.14"
"66","000","00","260","0002","0411","507","261","246","1","508","1253","0","40.54","20.83"
"66","000","00","260","0002","0412","460","222","238","1","461","1116","0","41.31","19.89"
"66","000","00","260","0002","0413","417","177","240","3","420","1037","0","40.50","17.07"
"66","000","00","260","0002","0414","487","271","216","6","493","1161","0","42.46","23.34"
"66","000","00","260","0002","0415","544","237","307","3","547","1248","0","43.83","18.99"
"66","000","00","260","0002","0416","586","339","247","2","588","1282","0","45.87","26.44"
"66","000","00","260","0003","0000","1974","1036","938","14","1988","4671","0","42.56","22.18"
"66","000","00","260","0003","0417","478","239","239","4","482","1103","0","43.70","21.67"
"66","000","00","260","0003","0418","505","279","226","5","510","1253","0","40.70","22.27"
"66","000","00","260","0003","0419","505","278","227","2","507","1196","0","42.39","23.24"
"66","000","00","260","0003","0420","486","240","246","3","489","1119","0","43.70","21.45"
"66","000","00","260","0004","0000","1090","540","550","9","1099","2320","0","47.37","23.28"
"66","000","00","260","0004","0421","534","251","283","5","539","1066","0","50.56","23.55"
"66","000","00","260","0004","0422","556","289","267","4","560","1254","0","44.66","23.05"
"66","000","00","260","0005","0000","998","507","491","5","1003","2025","0","49.53","25.04"
"66","000","00","260","0005","0423","589","320","269","4","593","1153","0","51.43","27.75"
"66","000","00","260","0005","0424","409","187","222","1","410","872","0","47.02","21.44"
"66","000","00","260","0006","0000","563","297","266","5","568","1224","0","46.41","24.26"
"66","000","00","260","0006","0425","563","297","266","5","568","1224","0","46.41","24.26"
"66","000","00","260","0007","0000","487","208","279","9","496","1045","0","47.46","19.90"
"66","000","00","260","0007","0426","487","208","279","9","496","1045","0","47.46","19.90"
"66","000","00","260","0008","0000","2663","1442","1221","15","2678","5783","0","46.31","24.94"
"66","000","00","260","0008","0427","523","268","255","3","526","1031","0","51.02","25.99"
"66","000","00","260","0008","0428","604","326","278","3","607","1250","0","48.56","26.08"
"66","000","00","260","0008","0429","546","318","228","4","550","1180","0","46.61","26.95"
"66","000","00","260","0008","0430","537","298","239","3","540","1268","0","42.59","23.50"
"66","000","00","260","0008","0431","453","232","221","2","455","1054","0","43.17","22.01"
"66","000","00","260","0009","0000","1330","697","633","15","1345","2918","0","46.09","23.89"
"66","000","00","260","0009","0450","486","280","206","4","490","1071","0","45.75","26.14"
"66","000","00","260","0009","0451","419","192","227","6","425","995","0","42.71","19.30"
"66","000","00","260","0009","0452","425","225","200","5","430","852","0","50.47","26.41"
"66","000","00","260","0010","0000","1759","799","960","10","1769","3965","0","44.62","20.15"
"66","000","00","260","0010","0432","552","288","264","1","553","1280","0","43.20","22.50"
"66","000","00","260","0010","0433","564","235","329","4","568","1289","0","44.07","18.23"
"66","000","00","260","0010","0434","643","276","367","5","648","1396","0","46.42","19.77"
"66","000","00","260","0011","0000","913","432","481","9","922","1860","0","49.57","23.23"
"66","000","00","260","0011","0435","500","234","266","5","505","995","0","50.75","23.52"
"66","000","00","260","0011","0436","413","198","215","4","417","865","0","48.21","22.89"
"66","000","00","260","0012","0000","1029","453","576","10","1039","2470","0","42.06","18.34"
"66","000","00","260","0012","0437","557","257","300","8","565","1360","0","41.54","18.90"
"66","000","00","260","0012","0438","472","196","276","2","474","1110","0","42.70","17.66"
"66","000","00","260","0013","0000","1196","563","633","17","1213","2651","0","45.76","21.24"
"66","000","00","260","0013","0439","628","317","311","11","639","1346","0","47.47","23.55"
"66","000","00","260","0013","0440","568","246","322","6","574","1305","0","43.98","18.85"
"66","000","00","260","0014","0000","1104","482","622","8","1112","2577","0","43.15","18.70"
"66","000","00","260","0014","0446","541","211","330","6","547","1294","0","42.27","16.31"
"66","000","00","260","0014","0447","563","271","292","2","565","1283","0","44.04","21.12"
"66","000","00","260","0015","0000","879","411","468","11","890","2046","0","43.50","20.09"
"66","000","00","260","0015","0448","409","176","233","8","417","973","0","42.86","18.09"
"66","000","00","260","0015","0449","470","235","235","3","473","1073","0","44.08","21.90"
"66","000","00","260","0016","0000","432","167","265","4","436","1104","0","39.49","15.13"
"66","000","00","260","0016","0453","432","167","265","4","436","1104","0","39.49","15.13"
"66","000","00","260","0017","0000","1114","441","673","13","1127","2352","0","47.92","18.75"
"66","000","00","260","0017","0454","545","195","350","5","550","1151","0","47.78","16.94"
"66","000","00","260","0017","0455","569","246","323","8","577","1201","0","48.04","20.48"
"66","000","00","260","0018","0000","1073","439","634","15","1088","2284","0","47.64","19.22"
"66","000","00","260","0018","0441","565","264","301","5","570","1132","0","50.35","23.32"
"66","000","00","260","0018","0442","508","175","333","10","518","1152","0","44.97","15.19"
"66","000","00","260","0019","0000","950","535","415","4","954","2071","0","46.06","25.83"
"66","000","00","260","0019","0443","457","261","196","3","460","1018","0","45.19","25.64"
"66","000","00","260","0019","0444","493","274","219","1","494","1053","0","46.91","26.02"
"66","000","00","260","0020","0000","559","267","292","1","560","1307","0","42.85","20.43"
"66","000","00","260","0020","0445","559","267","292","1","560","1307","0","42.85","20.43"
"66","000","00","270","0000","0000","62626","30638","31988","571","63197","162482","195494","38.89","18.86"
"66","000","00","270","0001","0000","2172","931","1241","27","2199","5378","0","40.89","17.31"
"66","000","00","270","0001","1435","547","245","302","7","554","1314","0","42.16","18.65"
"66","000","00","270","0001","1436","567","242","325","9","576","1428","0","40.34","16.95"
"66","000","00","270","0001","1437","521","221","300","7","528","1350","0","39.11","16.37"
"66","000","00","270","0001","1438","537","223","314","4","541","1286","0","42.07","17.34"
"66","000","00","270","0002","0000","2406","1185","1221","28","2434","6193","0","39.30","19.13"
"66","000","00","270","0002","1439","677","299","378","8","685","1545","0","44.34","19.35"
"66","000","00","270","0002","1440","525","247","278","6","531","1378","0","38.53","17.92"
"66","000","00","270","0002","1441","536","286","250","6","542","1555","0","34.86","18.39"
"66","000","00","270","0002","1442","668","353","315","8","676","1715","0","39.42","20.58"
"66","000","00","270","0003","0000","1587","715","872","15","1602","4030","0","39.75","17.74"
"66","000","00","270","0003","1448","576","260","316","8","584","1468","0","39.78","17.71"
"66","000","00","270","0003","1449","515","233","282","2","517","1277","0","40.49","18.25"
"66","000","00","270","0003","1450","496","222","274","5","501","1285","0","38.99","17.28"
"66","000","00","270","0004","0000","1331","557","774","9","1340","3192","0","41.98","17.45"
"66","000","00","270","0004","1456","441","202","239","2","443","993","0","44.61","20.34"
"66","000","00","270","0004","1457","437","190","247","5","442","1124","0","39.32","16.90"
"66","000","00","270","0004","1458","453","165","288","2","455","1075","0","42.33","15.35"
"66","000","00","270","0005","0000","1123","532","591","15","1138","2873","0","39.61","18.52"
"66","000","00","270","0005","1470","481","258","223","8","489","1357","0","36.04","19.01"
"66","000","00","270","0005","1471","642","274","368","7","649","1516","0","42.81","18.07"
"66","000","00","270","0006","0000","1531","703","828","13","1544","4108","0","37.59","17.11"
"66","000","00","270","0006","1462","494","210","284","4","498","1474","0","33.79","14.25"
"66","000","00","270","0006","1463","510","211","299","6","516","1376","0","37.50","15.33"
"66","000","00","270","0006","1464","527","282","245","3","530","1258","0","42.13","22.42"
"66","000","00","270","0007","0000","2316","1033","1283","21","2337","6203","0","37.68","16.65"
"66","000","00","270","0007","1493","666","305","361","7","673","1721","0","39.11","17.72"
"66","000","00","270","0007","1494","557","241","316","6","563","1539","0","36.58","15.66"
"66","000","00","270","0007","1495","570","249","321","5","575","1468","0","39.17","16.96"
"66","000","00","270","0007","1496","523","238","285","3","526","1475","0","35.66","16.14"
"66","000","00","270","0008","0000","1275","729","546","8","1283","3727","0","34.42","19.56"
"66","000","00","270","0008","1488","678","425","253","3","681","1674","0","40.68","25.39"
"66","000","00","270","0008","1489","597","304","293","5","602","2053","0","29.32","14.81"
"66","000","00","270","0009","0000","1443","847","596","15","1458","3294","0","44.26","25.71"
"66","000","00","270","0009","1474","495","276","219","7","502","1128","0","44.50","24.47"
"66","000","00","270","0009","1475","473","265","208","5","478","1071","0","44.63","24.74"
"66","000","00","270","0009","1476","475","306","169","3","478","1095","0","43.65","27.95"
"66","000","00","270","0010","0000","2081","1147","934","22","2103","5188","0","40.54","22.11"
"66","000","00","270","0010","1481","593","307","286","9","602","1345","0","44.76","22.83"
"66","000","00","270","0010","1482","636","393","243","5","641","1550","0","41.35","25.35"
"66","000","00","270","0010","1483","437","213","224","3","440","1139","0","38.63","18.70"
"66","000","00","270","0010","1484","415","234","181","5","420","1154","0","36.40","20.28"
"66","000","00","270","0011","0000","2762","1492","1270","24","2786","7707","0","36.15","19.36"
"66","000","00","270","0011","1504","522","291","231","7","529","1491","0","35.48","19.52"
"66","000","00","270","0011","1505","616","340","276","6","622","1566","0","39.72","21.71"
"66","000","00","270","0011","1506","501","258","243","2","503","1590","0","31.64","16.23"
"66","000","00","270","0011","1507","612","313","299","5","617","1579","0","39.08","19.82"
"66","000","00","270","0011","1508","511","290","221","4","515","1481","0","34.77","19.58"
"66","000","00","270","0012","0000","3086","1484","1602","28","3114","7600","0","40.97","19.53"
"66","000","00","270","0012","1517","561","229","332","1","562","1373","0","40.93","16.68"
"66","000","00","270","0012","1518","603","280","323","7","610","1482","0","41.16","18.89"
"66","000","00","270","0012","1519","603","311","292","6","609","1445","0","42.15","21.52"
"66","000","00","270","0012","1520","665","357","308","6","671","1643","0","40.84","21.73"
"66","000","00","270","0012","1521","654","307","347","8","662","1657","0","39.95","18.53"
"66","000","00","270","0013","0000","2743","1398","1345","17","2760","6669","0","41.39","20.96"
"66","000","00","270","0013","1531","654","350","304","4","658","1433","0","45.92","24.42"
"66","000","00","270","0013","1532","461","206","255","4","465","1223","0","38.02","16.84"
"66","000","00","270","0013","1533","502","266","236","1","503","1184","0","42.48","22.47"
"66","000","00","270","0013","1534","502","276","226","3","505","1376","0","36.70","20.06"
"66","000","00","270","0013","1535","624","300","324","5","629","1453","0","43.29","20.65"
"66","000","00","270","0014","0000","659","325","334","6","665","1767","0","37.63","18.39"
"66","000","00","270","0014","1536","341","177","164","5","346","870","0","39.77","20.34"
"66","000","00","270","0014","1537","318","148","170","1","319","897","0","35.56","16.50"
"66","000","00","270","0015","0000","400","161","239","7","407","1199","0","33.94","13.43"
"66","000","00","270","0015","1539","400","161","239","7","407","1199","0","33.94","13.43"
"66","000","00","270","0016","0000","1181","581","600","16","1197","3227","0","37.09","18.00"
"66","000","00","270","0016","1540","570","305","265","5","575","1651","0","34.83","18.47"
"66","000","00","270","0016","1541","611","276","335","11","622","1576","0","39.47","17.51"
"66","000","00","270","0017","0000","1185","426","759","10","1195","3052","0","39.15","13.96"
"66","000","00","270","0017","1546","589","205","384","6","595","1486","0","40.04","13.80"
"66","000","00","270","0017","1547","596","221","375","4","600","1566","0","38.31","14.11"
"66","000","00","270","0018","0000","1778","755","1023","14","1792","4742","0","37.79","15.92"
"66","000","00","270","0018","1550","449","184","265","4","453","1123","0","40.34","16.38"
"66","000","00","270","0018","1551","425","177","248","4","429","1258","0","34.10","14.07"
"66","000","00","270","0018","1552","476","207","269","2","478","1052","0","45.44","19.68"
"66","000","00","270","0018","1553","428","187","241","4","432","1309","0","33.00","14.29"
"66","000","00","270","0019","0000","245","104","141","8","253","649","0","38.98","16.02"
"66","000","00","270","0019","1545","245","104","141","8","253","649","0","38.98","16.02"
"66","000","00","270","0020","0000","2528","1192","1336","26","2554","6807","0","37.52","17.51"
"66","000","00","270","0020","1443","523","257","266","4","527","1351","0","39.01","19.02"
"66","000","00","270","0020","1444","437","197","240","5","442","1323","0","33.41","14.89"
"66","000","00","270","0020","1445","527","247","280","5","532","1397","0","38.08","17.68"
"66","000","00","270","0020","1446","547","259","288","6","553","1369","0","40.39","18.92"
"66","000","00","270","0020","1447","494","232","262","6","500","1367","0","36.58","16.97"
"66","000","00","270","0021","0000","1539","679","860","4","1543","4018","0","38.40","16.90"
"66","000","00","270","0021","1459","513","248","265","1","514","1387","0","37.06","17.88"
"66","000","00","270","0021","1460","516","209","307","3","519","1279","0","40.58","16.34"
"66","000","00","270","0021","1461","510","222","288","0","510","1352","0","37.72","16.42"
"66","000","00","270","0022","0000","1454","604","850","13","1467","3985","0","36.81","15.16"
"66","000","00","270","0022","1465","455","174","281","4","459","1207","0","38.03","14.42"
"66","000","00","270","0022","1466","503","205","298","5","508","1430","0","35.52","14.34"
"66","000","00","270","0022","1467","496","225","271","4","500","1348","0","37.09","16.69"
"66","000","00","270","0023","0000","1027","490","537","5","1032","2818","0","36.62","17.39"
"66","000","00","270","0023","1468","512","242","270","3","515","1415","0","36.40","17.10"
"66","000","00","270","0023","1469","515","248","267","2","517","1403","0","36.85","17.68"
"66","000","00","270","0024","0000","1390","639","751","14","1404","3701","0","37.94","17.27"
"66","000","00","270","0024","1451","450","214","236","4","454","1168","0","38.87","18.32"
"66","000","00","270","0024","1452","450","199","251","8","458","1191","0","38.46","16.71"
"66","000","00","270","0024","1453","490","226","264","2","492","1342","0","36.66","16.84"
"66","000","00","270","0025","0000","868","373","495","12","880","2204","0","39.93","16.92"
"66","000","00","270","0025","1454","445","176","269","6","451","1190","0","37.90","14.79"
"66","000","00","270","0025","1455","423","197","226","6","429","1014","0","42.31","19.43"
"66","000","00","270","0026","0000","998","464","534","10","1008","2894","0","34.83","16.03"
"66","000","00","270","0026","1472","517","225","292","6","523","1465","0","35.70","15.36"
"66","000","00","270","0026","1473","481","239","242","4","485","1429","0","33.94","16.72"
"66","000","00","270","0027","0000","2250","1126","1124","15","2265","5508","0","41.12","20.44"
"66","000","00","270","0027","1522","513","241","272","5","518","1237","0","41.88","19.48"
"66","000","00","270","0027","1523","584","307","277","4","588","1351","0","43.52","22.72"
"66","000","00","270","0027","1524","587","290","297","3","590","1470","0","40.14","19.73"
"66","000","00","270","0027","1525","566","288","278","3","569","1450","0","39.24","19.86"
"66","000","00","270","0028","0000","3237","1673","1564","25","3262","8031","0","40.62","20.83"
"66","000","00","270","0028","1526","578","298","280","4","582","1458","0","39.92","20.44"
"66","000","00","270","0028","1527","653","357","296","10","663","1546","0","42.88","23.09"
"66","000","00","270","0028","1528","572","276","296","3","575","1545","0","37.22","17.86"
"66","000","00","270","0028","1529","535","279","256","5","540","1438","0","37.55","19.40"
"66","000","00","270","0028","1530","899","463","436","3","902","2044","0","44.13","22.65"
"66","000","00","270","0029","0000","2201","1183","1018","19","2220","5692","0","39.00","20.78"
"66","000","00","270","0029","1509","594","291","303","4","598","1449","0","41.27","20.08"
"66","000","00","270","0029","1510","479","262","217","6","485","1346","0","36.03","19.47"
"66","000","00","270","0029","1511","478","257","221","2","480","1255","0","38.25","20.48"
"66","000","00","270","0029","1512","650","373","277","7","657","1642","0","40.01","22.72"
"66","000","00","270","0030","0000","1949","1062","887","15","1964","5664","0","34.68","18.75"
"66","000","00","270","0030","1513","477","256","221","6","483","1312","0","36.81","19.51"
"66","000","00","270","0030","1514","516","290","226","1","517","1527","0","33.86","18.99"
"66","000","00","270","0030","1515","420","221","199","4","424","1321","0","32.10","16.73"
"66","000","00","270","0030","1516","536","295","241","4","540","1504","0","35.90","19.61"
"66","000","00","270","0031","0000","2307","1175","1132","17","2324","6055","0","38.38","19.41"
"66","000","00","270","0031","1497","570","311","259","4","574","1587","0","36.17","19.60"
"66","000","00","270","0031","1498","683","354","329","6","689","1573","0","43.80","22.50"
"66","000","00","270","0031","1499","529","251","278","2","531","1417","0","37.47","17.71"
"66","000","00","270","0031","1500","525","259","266","5","530","1478","0","35.86","17.52"
"66","000","00","270","0032","0000","1398","614","784","18","1416","3821","0","37.06","16.07"
"66","000","00","270","0032","1501","624","248","376","13","637","1479","0","43.07","16.77"
"66","000","00","270","0032","1502","409","186","223","2","411","1212","0","33.91","15.35"
"66","000","00","270","0032","1503","365","180","185","3","368","1130","0","32.57","15.93"
"66","000","00","270","0033","0000","1501","892","609","11","1512","3832","0","39.46","23.28"
"66","000","00","270","0033","1485","498","295","203","6","504","1256","0","40.13","23.49"
"66","000","00","270","0033","1486","451","245","206","0","451","1175","0","38.38","20.85"
"66","000","00","270","0033","1487","552","352","200","5","557","1401","0","39.76","25.12"
"66","000","00","270","0034","0000","1910","1041","869","15","1925","4323","0","44.53","24.08"
"66","000","00","270","0034","1490","702","408","294","5","707","1549","0","45.64","26.34"
"66","000","00","270","0034","1491","593","284","309","5","598","1426","0","41.94","19.92"
"66","000","00","270","0034","1492","615","349","266","5","620","1348","0","45.99","25.89"
"66","000","00","270","0035","0000","932","442","490","7","939","2539","0","36.98","17.41"
"66","000","00","270","0035","1477","577","284","293","4","581","1495","0","38.86","19.00"
"66","000","00","270","0035","1478","355","158","197","3","358","1044","0","34.29","15.13"
"66","000","00","270","0036","0000","896","533","363","13","909","2139","0","42.50","24.92"
"66","000","00","270","0036","1479","486","287","199","6","492","1081","0","45.51","26.55"
"66","000","00","270","0036","1480","410","246","164","7","417","1058","0","39.41","23.25"
"66","000","00","270","0037","0000","588","275","313","6","594","1536","0","38.67","17.90"
"66","000","00","270","0037","1538","588","275","313","6","594","1536","0","38.67","17.90"
"66","000","00","270","0038","0000","1452","659","793","13","1465","3631","0","40.35","18.15"
"66","000","00","270","0038","1542","496","212","284","3","499","1249","0","39.95","16.97"
"66","000","00","270","0038","1543","619","292","327","7","626","1501","0","41.71","19.45"
"66","000","00","270","0038","1544","337","155","182","3","340","881","0","38.59","17.59"
"66","000","00","270","0039","0000","897","417","480","10","907","2486","0","36.48","16.77"
"66","000","00","270","0039","1548","422","181","241","4","426","1191","0","35.77","15.20"
"66","000","00","270","0039","1549","475","236","239","6","481","1295","0","37.14","18.22"
"66","000","00","280","0000","0000","70949","33585","37364","602","71551","174651","212710","40.97","19.23"
"66","000","00","280","0001","0000","1537","715","822","16","1553","3731","0","41.62","19.16"
"66","000","00","280","0001","1563","569","251","318","8","577","1381","0","41.78","18.18"
"66","000","00","280","0001","1564","536","259","277","5","541","1231","0","43.95","21.04"
"66","000","00","280","0001","1565","432","205","227","3","435","1119","0","38.87","18.32"
"66","000","00","280","0002","0000","4246","2047","2199","24","4270","10438","0","40.91","19.61"
"66","000","00","280","0002","1566","685","300","385","4","689","1641","0","41.99","18.28"
"66","000","00","280","0002","1567","906","450","456","5","911","2900","0","31.41","15.52"
"66","000","00","280","0002","1568","666","302","364","4","670","1710","0","39.18","17.66"
"66","000","00","280","0002","1569","591","284","307","4","595","1334","0","44.60","21.29"
"66","000","00","280","0002","1570","577","345","232","1","578","1144","0","50.52","30.16"
"66","000","00","280","0002","1571","821","366","455","6","827","1709","0","48.39","21.42"
"66","000","00","280","0003","0000","1555","605","950","17","1572","3621","0","43.41","16.71"
"66","000","00","280","0003","1576","518","188","330","4","522","1172","0","44.54","16.04"
"66","000","00","280","0003","1577","530","222","308","3","533","1317","0","40.47","16.86"
"66","000","00","280","0003","1578","507","195","312","10","517","1132","0","45.67","17.23"
"66","000","00","280","0004","0000","2907","1358","1549","22","2929","6901","0","42.44","19.68"
"66","000","00","280","0004","1619","589","271","318","5","594","1372","0","43.29","19.75"
"66","000","00","280","0004","1620","515","243","272","7","522","1365","0","38.24","17.80"
"66","000","00","280","0004","1621","619","264","355","4","623","1335","0","46.67","19.78"
"66","000","00","280","0004","1622","575","242","333","3","578","1331","0","43.43","18.18"
"66","000","00","280","0004","1623","609","338","271","3","612","1498","0","40.85","22.56"
"66","000","00","280","0005","0000","3090","1410","1680","31","3121","7279","0","42.88","19.37"
"66","000","00","280","0005","1579","707","315","392","8","715","1624","0","44.03","19.40"
"66","000","00","280","0005","1580","529","234","295","3","532","1251","0","42.53","18.71"
"66","000","00","280","0005","1581","661","307","354","4","665","1614","0","41.20","19.02"
"66","000","00","280","0005","1582","679","334","345","8","687","1666","0","41.24","20.05"
"66","000","00","280","0005","1583","514","220","294","8","522","1124","0","46.44","19.57"
"66","000","00","280","0006","0000","1818","895","923","17","1835","4162","0","44.09","21.50"
"66","000","00","280","0006","1633","572","298","274","5","577","1293","0","44.62","23.05"
"66","000","00","280","0006","1634","569","278","291","4","573","1257","0","45.58","22.12"
"66","000","00","280","0006","1635","677","319","358","8","685","1612","0","42.49","19.79"
"66","000","00","280","0007","0000","2195","1030","1165","26","2221","5520","0","40.24","18.66"
"66","000","00","280","0007","1636","540","245","295","6","546","1415","0","38.59","17.31"
"66","000","00","280","0007","1637","552","225","327","4","556","1363","0","40.79","16.51"
"66","000","00","280","0007","1638","540","279","261","7","547","1413","0","38.71","19.75"
"66","000","00","280","0007","1639","563","281","282","9","572","1329","0","43.04","21.14"
"66","000","00","280","0008","0000","3385","1742","1643","21","3406","8350","0","40.79","20.86"
"66","000","00","280","0008","1584","567","301","266","3","570","1350","0","42.22","22.30"
"66","000","00","280","0008","1585","616","317","299","3","619","1476","0","41.94","21.48"
"66","000","00","280","0008","1586","554","265","289","4","558","1368","0","40.79","19.37"
"66","000","00","280","0008","1587","549","289","260","6","555","1395","0","39.78","20.72"
"66","000","00","280","0008","1588","599","304","295","5","604","1452","0","41.60","20.94"
"66","000","00","280","0008","1589","500","266","234","0","500","1309","0","38.20","20.32"
"66","000","00","280","0009","0000","1410","679","731","20","1430","3400","0","42.06","19.97"
"66","000","00","280","0009","1594","699","343","356","11","710","1707","0","41.59","20.09"
"66","000","00","280","0009","1595","711","336","375","9","720","1693","0","42.53","19.85"
"66","000","00","280","0010","0000","1971","860","1111","23","1994","5356","0","37.23","16.06"
"66","000","00","280","0010","1652","520","231","289","8","528","1387","0","38.07","16.65"
"66","000","00","280","0010","1653","449","202","247","3","452","1272","0","35.53","15.88"
"66","000","00","280","0010","1654","508","251","257","5","513","1415","0","36.25","17.74"
"66","000","00","280","0010","1655","494","176","318","7","501","1282","0","39.08","13.73"
"66","000","00","280","0011","0000","3234","1453","1781","32","3266","7841","0","41.65","18.53"
"66","000","00","280","0011","1661","554","243","311","7","561","1424","0","39.40","17.06"
"66","000","00","280","0011","1662","734","331","403","9","743","1644","0","45.19","20.13"
"66","000","00","280","0011","1663","707","331","376","6","713","1727","0","41.29","19.17"
"66","000","00","280","0011","1664","669","277","392","4","673","1522","0","44.22","18.20"
"66","000","00","280","0011","1665","570","271","299","6","576","1524","0","37.80","17.78"
"66","000","00","280","0012","0000","1880","820","1060","14","1894","4167","0","45.45","19.68"
"66","000","00","280","0012","1596","517","230","287","2","519","1129","0","45.97","20.37"
"66","000","00","280","0012","1597","718","269","449","7","725","1539","0","47.11","17.48"
"66","000","00","280","0012","1598","645","321","324","5","650","1499","0","43.36","21.41"
"66","000","00","280","0013","0000","462","179","283","7","469","982","0","47.76","18.23"
"66","000","00","280","0013","1599","462","179","283","7","469","982","0","47.76","18.23"
"66","000","00","280","0014","0000","3122","1386","1736","34","3156","8402","0","37.56","16.50"
"66","000","00","280","0014","1600","552","264","288","2","554","1493","0","37.11","17.68"
"66","000","00","280","0014","1601","475","177","298","7","482","1330","0","36.24","13.31"
"66","000","00","280","0014","1602","496","216","280","11","507","1299","0","39.03","16.63"
"66","000","00","280","0014","1603","521","223","298","6","527","1435","0","36.72","15.54"
"66","000","00","280","0014","1604","542","244","298","5","547","1415","0","38.66","17.24"
"66","000","00","280","0014","1605","536","262","274","3","539","1430","0","37.69","18.32"
"66","000","00","280","0015","0000","1695","754","941","21","1716","4704","0","36.48","16.03"
"66","000","00","280","0015","1610","552","219","333","7","559","1419","0","39.39","15.43"
"66","000","00","280","0015","1611","604","261","343","8","612","1702","0","35.96","15.33"
"66","000","00","280","0015","1612","539","274","265","6","545","1583","0","34.43","17.31"
"66","000","00","280","0016","0000","3199","1406","1793","28","3227","8359","0","38.61","16.82"
"66","000","00","280","0016","1613","505","233","272","5","510","1419","0","35.94","16.42"
"66","000","00","280","0016","1614","565","293","272","9","574","1394","0","41.18","21.02"
"66","000","00","280","0016","1615","585","264","321","2","587","1441","0","40.74","18.32"
"66","000","00","280","0016","1616","480","189","291","3","483","1311","0","36.84","14.42"
"66","000","00","280","0016","1617","480","166","314","3","483","1312","0","36.81","12.65"
"66","000","00","280","0016","1618","584","261","323","6","590","1482","0","39.81","17.61"
"66","000","00","280","0017","0000","4489","2132","2357","29","4518","11593","0","38.97","18.39"
"66","000","00","280","0017","1666","504","215","289","3","507","1354","0","37.44","15.88"
"66","000","00","280","0017","1667","606","317","289","1","607","1445","0","42.01","21.94"
"66","000","00","280","0017","1668","564","283","281","5","569","1521","0","37.41","18.61"
"66","000","00","280","0017","1669","561","262","299","7","568","1441","0","39.42","18.18"
"66","000","00","280","0017","1670","633","338","295","1","634","1485","0","42.69","22.76"
"66","000","00","280","0017","1671","482","213","269","0","482","1486","0","32.44","14.33"
"66","000","00","280","0017","1672","487","216","271","8","495","1364","0","36.29","15.84"
"66","000","00","280","0017","1673","652","288","364","4","656","1497","0","43.82","19.24"
"66","000","00","280","0018","0000","3749","1833","1916","27","3776","9507","0","39.72","19.28"
"66","000","00","280","0018","1646","625","315","310","4","629","1589","0","39.58","19.82"
"66","000","00","280","0018","1647","629","337","292","9","638","1631","0","39.12","20.66"
"66","000","00","280","0018","1648","622","285","337","5","627","1441","0","43.51","19.78"
"66","000","00","280","0018","1649","632","299","333","2","634","1620","0","39.14","18.46"
"66","000","00","280","0018","1650","659","316","343","5","664","1743","0","38.10","18.13"
"66","000","00","280","0018","1651","582","281","301","2","584","1483","0","39.38","18.95"
"66","000","00","280","0019","0000","4017","1934","2083","36","4053","10403","0","38.96","18.59"
"66","000","00","280","0019","1554","605","323","282","6","611","1624","0","37.62","19.89"
"66","000","00","280","0019","1555","583","271","312","8","591","1597","0","37.01","16.97"
"66","000","00","280","0019","1556","552","254","298","3","555","1650","0","33.64","15.39"
"66","000","00","280","0019","1557","543","263","280","5","548","1291","0","42.45","20.37"
"66","000","00","280","0019","1558","586","271","315","3","589","1439","0","40.93","18.83"
"66","000","00","280","0019","1559","493","248","245","7","500","1191","0","41.98","20.82"
"66","000","00","280","0019","1560","655","304","351","4","659","1611","0","40.91","18.87"
"66","000","00","280","0020","0000","1166","505","661","13","1179","2803","0","42.06","18.02"
"66","000","00","280","0020","1561","621","260","361","4","625","1402","0","44.58","18.54"
"66","000","00","280","0020","1562","545","245","300","9","554","1401","0","39.54","17.49"
"66","000","00","280","0021","0000","2451","1269","1182","17","2468","5719","0","43.15","22.19"
"66","000","00","280","0021","1572","621","330","291","2","623","1417","0","43.97","23.29"
"66","000","00","280","0021","1573","555","265","290","3","558","1410","0","39.57","18.79"
"66","000","00","280","0021","1574","714","385","329","9","723","1564","0","46.23","24.62"
"66","000","00","280","0021","1575","561","289","272","3","564","1328","0","42.47","21.76"
"66","000","00","280","0022","0000","1677","785","892","10","1687","4144","0","40.71","18.94"
"66","000","00","280","0022","1624","575","268","307","6","581","1495","0","38.86","17.93"
"66","000","00","280","0022","1625","504","237","267","3","507","1251","0","40.53","18.94"
"66","000","00","280","0022","1626","598","280","318","1","599","1398","0","42.85","20.03"
"66","000","00","280","0023","0000","4422","2316","2106","27","4449","9667","0","46.02","23.96"
"66","000","00","280","0023","1627","773","424","349","4","777","1621","0","47.93","26.16"
"66","000","00","280","0023","1628","698","359","339","7","705","1552","0","45.43","23.13"
"66","000","00","280","0023","1629","785","402","383","4","789","1589","0","49.65","25.30"
"66","000","00","280","0023","1630","726","379","347","6","732","1612","0","45.41","23.51"
"66","000","00","280","0023","1631","710","377","333","4","714","1616","0","44.18","23.33"
"66","000","00","280","0023","1632","730","375","355","2","732","1677","0","43.65","22.36"
"66","000","00","280","0024","0000","3811","1935","1876","31","3842","8636","0","44.49","22.41"
"66","000","00","280","0024","1640","630","322","308","3","633","1498","0","42.26","21.50"
"66","000","00","280","0024","1641","639","332","307","2","641","1387","0","46.21","23.94"
"66","000","00","280","0024","1642","628","326","302","8","636","1387","0","45.85","23.50"
"66","000","00","280","0024","1643","653","291","362","7","660","1351","0","48.85","21.54"
"66","000","00","280","0024","1644","627","310","317","11","638","1486","0","42.93","20.86"
"66","000","00","280","0024","1645","634","354","280","0","634","1527","0","41.52","23.18"
"66","000","00","280","0025","0000","2124","1059","1065","19","2143","5389","0","39.77","19.65"
"66","000","00","280","0025","1590","496","238","258","1","497","1278","0","38.89","18.62"
"66","000","00","280","0025","1591","516","242","274","4","520","1315","0","39.54","18.40"
"66","000","00","280","0025","1592","580","319","261","9","589","1507","0","39.08","21.17"
"66","000","00","280","0025","1593","532","260","272","5","537","1289","0","41.66","20.17"
"66","000","00","280","0026","0000","3021","1435","1586","24","3045","7712","0","39.48","18.61"
"66","000","00","280","0026","1656","628","291","337","4","632","1585","0","39.87","18.36"
"66","000","00","280","0026","1657","622","284","338","8","630","1574","0","40.03","18.04"
"66","000","00","280","0026","1658","563","257","306","2","565","1512","0","37.37","17.00"
"66","000","00","280","0026","1659","635","324","311","6","641","1630","0","39.33","19.88"
"66","000","00","280","0026","1660","573","279","294","4","577","1411","0","40.89","19.77"
"66","000","00","280","0027","0000","2316","1043","1273","16","2332","5865","0","39.76","17.78"
"66","000","00","280","0027","1606","635","269","366","1","636","1566","0","40.61","17.18"
"66","000","00","280","0027","1607","568","283","285","6","574","1464","0","39.21","19.33"
"66","000","00","280","0027","1608","436","189","247","6","442","1161","0","38.07","16.28"
"66","000","00","280","0027","1609","677","302","375","3","680","1674","0","40.62","18.04"
"66","000","00","290","0000","0000","2988","2067","921","39","3027","9436","10841","32.08","21.91"
"66","000","00","290","0001","0000","646","408","238","14","660","1883","0","35.05","21.67"
"66","000","00","290","0001","1856","317","157","160","9","326","936","0","34.83","16.77"
"66","000","00","290","0001","1857","329","251","78","5","334","947","0","35.27","26.50"
"66","000","00","290","0002","0000","141","74","67","4","145","456","0","31.80","16.23"
"66","000","00","290","0002","1858","141","74","67","4","145","456","0","31.80","16.23"
"66","000","00","290","0003","0000","528","396","132","7","535","1641","0","32.60","24.13"
"66","000","00","290","0003","1859","317","240","77","4","321","999","0","32.13","24.02"
"66","000","00","290","0003","1860","211","156","55","3","214","642","0","33.33","24.30"
"66","000","00","290","0004","0000","192","134","58","3","195","461","0","42.30","29.07"
"66","000","00","290","0004","1866","192","134","58","3","195","461","0","42.30","29.07"
"66","000","00","290","0005","0000","422","322","100","3","425","1081","0","39.32","29.79"
"66","000","00","290","0005","1861","101","58","43","0","101","291","0","34.71","19.93"
"66","000","00","290","0005","1862","174","154","20","2","176","459","0","38.34","33.55"
"66","000","00","290","0005","1863","147","110","37","1","148","331","0","44.71","33.23"
"66","000","00","290","0006","0000","420","294","126","2","422","1107","0","38.12","26.56"
"66","000","00","290","0006","1864","289","192","97","2","291","755","0","38.54","25.43"
"66","000","00","290","0006","1865","131","102","29","0","131","352","0","37.22","28.98"
"66","000","00","290","0007","0000","431","280","151","2","433","1939","0","22.33","14.44"
"66","000","00","290","0007","1867","81","45","36","0","81","346","0","23.41","13.01"
"66","000","00","290","0007","1868","159","109","50","2","161","755","0","21.32","14.44"
"66","000","00","290","0007","1869","132","91","41","0","132","566","0","23.32","16.08"
"66","000","00","290","0007","1870","59","35","24","0","59","272","0","21.69","12.87"
"66","000","00","290","0008","0000","208","159","49","4","212","868","0","24.42","18.32"
"66","000","00","290","0008","1871","35","28","7","0","35","149","0","23.49","18.79"
"66","000","00","290","0008","1872","173","131","42","4","177","719","0","24.62","18.22"
"67","000","00","000","0000","0000","648499","243004","405495","5693","654192","1592388","1868739","41.08","15.26"
"67","000","00","010","0000","0000","25152","10766","14386","216","25368","63992","76027","39.64","16.82"
"67","000","00","010","0001","0000","1946","1038","908","9","1955","4561","0","42.86","22.76"
"67","000","00","010","0001","0139","499","271","228","1","500","1274","0","39.25","21.27"
"67","000","00","010","0001","0140","446","252","194","2","448","1112","0","40.29","22.66"
"67","000","00","010","0001","0141","478","237","241","1","479","1035","0","46.28","22.90"
"67","000","00","010","0001","0142","523","278","245","5","528","1140","0","46.32","24.39"
"67","000","00","010","0002","0000","906","407","499","11","917","2212","0","41.46","18.40"
"67","000","00","010","0002","0143","477","188","289","8","485","1156","0","41.96","16.26"
"67","000","00","010","0002","0144","429","219","210","3","432","1056","0","40.91","20.74"
"67","000","00","010","0003","0000","1144","502","642","12","1156","2807","0","41.18","17.88"
"67","000","00","010","0003","0145","559","239","320","6","565","1366","0","41.36","17.50"
"67","000","00","010","0003","0146","585","263","322","6","591","1441","0","41.01","18.25"
"67","000","00","010","0007","0000","1171","496","675","8","1179","2795","0","42.18","17.75"
"67","000","00","010","0007","0150","426","192","234","3","429","1014","0","42.31","18.93"
"67","000","00","010","0007","0151","366","162","204","1","367","892","0","41.14","18.16"
"67","000","00","010","0007","0152","379","142","237","4","383","889","0","43.08","15.97"
"67","000","00","010","0008","0000","1575","702","873","14","1589","4010","0","39.63","17.51"
"67","000","00","010","0008","0153","515","227","288","6","521","1314","0","39.65","17.28"
"67","000","00","010","0008","0154","472","221","251","8","480","1311","0","36.61","16.86"
"67","000","00","010","0008","0155","588","254","334","0","588","1385","0","42.45","18.34"
"67","000","00","010","0009","0000","473","194","279","4","477","1131","0","42.18","17.15"
"67","000","00","010","0009","0161","473","194","279","4","477","1131","0","42.18","17.15"
"67","000","00","010","0010","0000","570","185","385","7","577","1430","0","40.35","12.94"
"67","000","00","010","0010","0162","570","185","385","7","577","1430","0","40.35","12.94"
"67","000","00","010","0012","0000","884","401","483","7","891","2371","0","37.58","16.91"
"67","000","00","010","0012","0165","449","182","267","5","454","1166","0","38.94","15.61"
"67","000","00","010","0012","0166","435","219","216","2","437","1205","0","36.27","18.17"
"67","000","00","010","0013","0000","737","345","392","5","742","1734","0","42.79","19.90"
"67","000","00","010","0013","0163","329","177","152","4","333","816","0","40.81","21.69"
"67","000","00","010","0013","0164","408","168","240","1","409","918","0","44.55","18.30"
"67","000","00","010","0014","0000","1202","493","709","10","1212","3194","0","37.95","15.44"
"67","000","00","010","0014","0167","389","153","236","3","392","1000","0","39.20","15.30"
"67","000","00","010","0014","0168","359","145","214","2","361","1000","0","36.10","14.50"
"67","000","00","010","0014","0169","454","195","259","5","459","1194","0","38.44","16.33"
"67","000","00","010","0015","0000","1642","664","978","19","1661","4405","0","37.71","15.07"
"67","000","00","010","0015","0178","450","194","256","0","450","1256","0","35.83","15.45"
"67","000","00","010","0015","0179","363","133","230","5","368","912","0","40.35","14.58"
"67","000","00","010","0015","0180","373","163","210","10","383","1038","0","36.90","15.70"
"67","000","00","010","0015","0181","456","174","282","4","460","1199","0","38.37","14.51"
"67","000","00","010","0016","0000","640","243","397","14","654","1632","0","40.07","14.89"
"67","000","00","010","0016","0182","372","131","241","6","378","921","0","41.04","14.22"
"67","000","00","010","0016","0183","268","112","156","8","276","711","0","38.82","15.75"
"67","000","00","010","0017","0000","514","171","343","2","516","1333","0","38.71","12.83"
"67","000","00","010","0017","0184","514","171","343","2","516","1333","0","38.71","12.83"
"67","000","00","010","0018","0000","597","162","435","8","605","1724","0","35.09","9.40"
"67","000","00","010","0018","0185","481","126","355","5","486","1456","0","33.38","8.65"
"67","000","00","010","0018","0186","116","36","80","3","119","268","0","44.40","13.43"
"67","000","00","010","0019","0000","657","191","466","5","662","1696","0","39.03","11.26"
"67","000","00","010","0019","0187","384","121","263","2","386","939","0","41.11","12.89"
"67","000","00","010","0019","0188","273","70","203","3","276","757","0","36.46","9.25"
"67","000","00","010","0020","0000","1321","584","737","14","1335","3665","0","36.43","15.93"
"67","000","00","010","0020","0189","430","177","253","5","435","1169","0","37.21","15.14"
"67","000","00","010","0020","0190","482","214","268","6","488","1361","0","35.86","15.72"
"67","000","00","010","0020","0191","409","193","216","3","412","1135","0","36.30","17.00"
"67","000","00","010","0021","0000","659","227","432","6","665","1880","0","35.37","12.07"
"67","000","00","010","0021","0192","357","114","243","3","360","1038","0","34.68","10.98"
"67","000","00","010","0021","0193","302","113","189","3","305","842","0","36.22","13.42"
"67","000","00","010","0025","0000","609","155","454","6","615","1555","0","39.55","9.97"
"67","000","00","010","0025","0196","247","66","181","2","249","670","0","37.16","9.85"
"67","000","00","010","0025","0197","362","89","273","4","366","885","0","41.36","10.06"
"67","000","00","010","0026","0000","339","106","233","8","347","897","0","38.68","11.82"
"67","000","00","010","0026","0194","209","56","153","2","211","507","0","41.62","11.05"
"67","000","00","010","0026","0195","130","50","80","6","136","390","0","34.87","12.82"
"67","000","00","010","0027","0000","1880","903","977","16","1896","4874","0","38.90","18.53"
"67","000","00","010","0027","0170","495","227","268","4","499","1254","0","39.79","18.10"
"67","000","00","010","0027","0171","453","224","229","3","456","1274","0","35.79","17.58"
"67","000","00","010","0027","0172","424","196","228","7","431","1082","0","39.83","18.11"
"67","000","00","010","0027","0173","508","256","252","2","510","1264","0","40.35","20.25"
"67","000","00","010","0028","0000","2046","877","1169","10","2056","5086","0","40.42","17.24"
"67","000","00","010","0028","0174","560","222","338","0","560","1369","0","40.91","16.22"
"67","000","00","010","0028","0175","507","245","262","3","510","1265","0","40.32","19.37"
"67","000","00","010","0028","0176","457","193","264","2","459","1171","0","39.20","16.48"
"67","000","00","010","0028","0177","522","217","305","5","527","1281","0","41.14","16.94"
"67","000","00","010","0029","0000","2509","1251","1258","11","2520","6401","0","39.37","19.54"
"67","000","00","010","0029","0156","495","218","277","0","495","1252","0","39.54","17.41"
"67","000","00","010","0029","0157","518","291","227","5","523","1310","0","39.92","22.21"
"67","000","00","010","0029","0158","448","215","233","1","449","1215","0","36.95","17.70"
"67","000","00","010","0029","0159","523","270","253","2","525","1294","0","40.57","20.87"
"67","000","00","010","0029","0160","525","257","268","3","528","1330","0","39.70","19.32"
"67","000","00","010","0030","0000","1131","469","662","10","1141","2599","0","43.90","18.05"
"67","000","00","010","0030","0147","399","171","228","0","399","867","0","46.02","19.72"
"67","000","00","010","0030","0148","429","168","261","7","436","1004","0","43.43","16.73"
"67","000","00","010","0030","0149","303","130","173","3","306","728","0","42.03","17.86"
"67","000","00","020","0000","0000","8323","2667","5656","110","8433","21950","24892","38.42","12.15"
"67","000","00","020","0001","0000","587","196","391","7","594","1549","0","38.35","12.65"
"67","000","00","020","0001","0108","400","120","280","7","407","1074","0","37.90","11.17"
"67","000","00","020","0001","0109","187","76","111","0","187","475","0","39.37","16.00"
"67","000","00","020","0008","0000","1292","477","815","17","1309","3724","0","35.15","12.81"
"67","000","00","020","0008","0116","413","143","270","2","415","1093","0","37.97","13.08"
"67","000","00","020","0008","0117","472","182","290","10","482","1366","0","35.29","13.32"
"67","000","00","020","0008","0118","407","152","255","5","412","1265","0","32.57","12.02"
"67","000","00","020","0010","0000","310","44","266","14","324","875","0","37.03","5.03"
"67","000","00","020","0010","0122","310","44","266","14","324","875","0","37.03","5.03"
"67","000","00","020","0011","0000","1449","531","918","14","1463","3815","0","38.35","13.92"
"67","000","00","020","0011","0119","520","197","323","7","527","1434","0","36.75","13.74"
"67","000","00","020","0011","0120","543","188","355","6","549","1289","0","42.59","14.58"
"67","000","00","020","0011","0121","386","146","240","1","387","1092","0","35.44","13.37"
"67","000","00","020","0014","0000","607","169","438","7","614","1621","0","37.88","10.43"
"67","000","00","020","0014","0130","356","112","244","4","360","903","0","39.87","12.40"
"67","000","00","020","0014","0131","251","57","194","3","254","718","0","35.38","7.94"
"67","000","00","020","0026","0000","610","223","387","5","615","1413","0","43.52","15.78"
"67","000","00","020","0026","0110","250","92","158","1","251","626","0","40.10","14.70"
"67","000","00","020","0026","0111","140","51","89","1","141","308","0","45.78","16.56"
"67","000","00","020","0026","0112","220","80","140","3","223","479","0","46.56","16.70"
"67","000","00","020","0027","0000","649","282","367","4","653","1575","0","41.46","17.90"
"67","000","00","020","0027","0113","307","133","174","1","308","761","0","40.47","17.48"
"67","000","00","020","0027","0114","128","48","80","0","128","315","0","40.63","15.24"
"67","000","00","020","0027","0115","214","101","113","3","217","499","0","43.49","20.24"
"67","000","00","020","0028","0000","622","143","479","5","627","1519","0","41.28","9.41"
"67","000","00","020","0028","0125","336","66","270","2","338","770","0","43.90","8.57"
"67","000","00","020","0028","0126","118","31","87","0","118","282","0","41.84","10.99"
"67","000","00","020","0028","0127","168","46","122","3","171","467","0","36.62","9.85"
"67","000","00","020","0029","0000","563","154","409","7","570","1545","0","36.89","9.97"
"67","000","00","020","0029","0123","302","74","228","3","305","817","0","37.33","9.06"
"67","000","00","020","0029","0124","261","80","181","4","265","728","0","36.40","10.99"
"67","000","00","020","0030","0000","366","96","270","3","369","981","0","37.61","9.79"
"67","000","00","020","0030","0128","237","60","177","3","240","597","0","40.20","10.05"
"67","000","00","020","0030","0129","129","36","93","0","129","384","0","33.59","9.38"
"67","000","00","020","0031","0000","434","106","328","10","444","1073","0","41.38","9.88"
"67","000","00","020","0031","0135","303","73","230","7","310","724","0","42.82","10.08"
"67","000","00","020","0031","0136","131","33","98","3","134","349","0","38.40","9.46"
"67","000","00","020","0032","0000","369","114","255","7","376","900","0","41.78","12.67"
"67","000","00","020","0032","0132","108","28","80","2","110","211","0","52.13","13.27"
"67","000","00","020","0032","0133","130","52","78","5","135","382","0","35.34","13.61"
"67","000","00","020","0032","0134","131","34","97","0","131","307","0","42.67","11.07"
"67","000","00","020","0033","0000","465","132","333","10","475","1360","0","34.93","9.71"
"67","000","00","020","0033","0137","319","84","235","4","323","903","0","35.77","9.30"
"67","000","00","020","0033","0138","146","48","98","6","152","457","0","33.26","10.50"
"67","000","00","030","0000","0000","9144","2861","6283","115","9259","24122","26978","38.38","11.86"
"67","000","00","030","0001","0000","671","218","453","3","674","1688","0","39.93","12.91"
"67","000","00","030","0001","0030","373","110","263","1","374","953","0","39.24","11.54"
"67","000","00","030","0001","0031","298","108","190","2","300","735","0","40.82","14.69"
"67","000","00","030","0002","0000","1273","443","830","4","1277","2937","0","43.48","15.08"
"67","000","00","030","0002","0032","394","128","266","1","395","864","0","45.72","14.81"
"67","000","00","030","0002","0033","415","152","263","1","416","966","0","43.06","15.73"
"67","000","00","030","0002","0034","464","163","301","2","466","1107","0","42.10","14.72"
"67","000","00","030","0003","0000","546","180","366","4","550","1364","0","40.32","13.20"
"67","000","00","030","0003","0035","546","180","366","4","550","1364","0","40.32","13.20"
"67","000","00","030","0004","0000","643","201","442","9","652","1596","0","40.85","12.59"
"67","000","00","030","0004","0036","290","85","205","6","296","699","0","42.35","12.16"
"67","000","00","030","0004","0037","353","116","237","3","356","897","0","39.69","12.93"
"67","000","00","030","0005","0000","335","110","225","7","342","874","0","39.13","12.59"
"67","000","00","030","0005","0038","335","110","225","7","342","874","0","39.13","12.59"
"67","000","00","030","0006","0000","543","175","368","11","554","1334","0","41.53","13.12"
"67","000","00","030","0006","0039","340","109","231","8","348","793","0","43.88","13.75"
"67","000","00","030","0006","0040","203","66","137","3","206","541","0","38.08","12.20"
"67","000","00","030","0007","0000","175","62","113","3","178","440","0","40.45","14.09"
"67","000","00","030","0007","0041","175","62","113","3","178","440","0","40.45","14.09"
"67","000","00","030","0008","0000","182","40","142","1","183","560","0","32.68","7.14"
"67","000","00","030","0008","0042","182","40","142","1","183","560","0","32.68","7.14"
"67","000","00","030","0009","0000","121","39","82","2","123","369","0","33.33","10.57"
"67","000","00","030","0009","0043","121","39","82","2","123","369","0","33.33","10.57"
"67","000","00","030","0010","0000","159","37","122","3","162","487","0","33.26","7.60"
"67","000","00","030","0010","0044","159","37","122","3","162","487","0","33.26","7.60"
"67","000","00","030","0011","0000","380","139","241","8","388","1178","0","32.94","11.80"
"67","000","00","030","0011","0047","141","77","64","2","143","431","0","33.18","17.87"
"67","000","00","030","0011","0048","239","62","177","6","245","747","0","32.80","8.30"
"67","000","00","030","0012","0000","333","86","247","4","337","1001","0","33.67","8.59"
"67","000","00","030","0012","0045","212","49","163","1","213","617","0","34.52","7.94"
"67","000","00","030","0012","0046","121","37","84","3","124","384","0","32.29","9.64"
"67","000","00","030","0014","0000","494","159","335","4","498","1380","0","36.09","11.52"
"67","000","00","030","0014","0051","257","85","172","2","259","698","0","37.11","12.18"
"67","000","00","030","0014","0052","237","74","163","2","239","682","0","35.04","10.85"
"67","000","00","030","0018","0000","318","107","211","7","325","836","0","38.88","12.80"
"67","000","00","030","0018","0055","318","107","211","7","325","836","0","38.88","12.80"
"67","000","00","030","0019","0000","190","87","103","4","194","705","0","27.52","12.34"
"67","000","00","030","0019","0056","190","87","103","4","194","705","0","27.52","12.34"
"67","000","00","030","0020","0000","475","130","345","8","483","1303","0","37.07","9.98"
"67","000","00","030","0020","0057","475","130","345","8","483","1303","0","37.07","9.98"
"67","000","00","030","0021","0000","280","72","208","5","285","707","0","40.31","10.18"
"67","000","00","030","0021","0058","280","72","208","5","285","707","0","40.31","10.18"
"67","000","00","030","0022","0000","253","81","172","4","257","657","0","39.12","12.33"
"67","000","00","030","0022","0059","253","81","172","4","257","657","0","39.12","12.33"
"67","000","00","030","0025","0000","748","210","538","7","755","1930","0","39.12","10.88"
"67","000","00","030","0025","0049","322","67","255","2","324","781","0","41.49","8.58"
"67","000","00","030","0025","0050","426","143","283","5","431","1149","0","37.51","12.45"
"67","000","00","030","0026","0000","584","161","423","6","590","1458","0","40.47","11.04"
"67","000","00","030","0026","0053","226","71","155","1","227","620","0","36.61","11.45"
"67","000","00","030","0026","0054","358","90","268","5","363","838","0","43.32","10.74"
"67","000","00","030","0027","0000","441","124","317","11","452","1318","0","34.29","9.41"
"67","000","00","030","0027","0060","286","96","190","7","293","817","0","35.86","11.75"
"67","000","00","030","0027","0061","155","28","127","4","159","501","0","31.74","5.59"
"67","000","00","040","0000","0000","7153","2358","4795","79","7232","18522","20733","39.05","12.73"
"67","000","00","040","0001","0000","711","236","475","10","721","1825","0","39.51","12.93"
"67","000","00","040","0001","0198","435","131","304","9","444","1142","0","38.88","11.47"
"67","000","00","040","0001","0199","276","105","171","1","277","683","0","40.56","15.37"
"67","000","00","040","0002","0000","705","251","454","3","708","1608","0","44.03","15.61"
"67","000","00","040","0002","0200","324","124","200","1","325","731","0","44.46","16.96"
"67","000","00","040","0002","0201","381","127","254","2","383","877","0","43.67","14.48"
"67","000","00","040","0003","0000","448","172","276","5","453","1107","0","40.92","15.54"
"67","000","00","040","0003","0202","448","172","276","5","453","1107","0","40.92","15.54"
"67","000","00","040","0004","0000","1093","399","694","9","1102","2722","0","40.48","14.66"
"67","000","00","040","0004","0203","347","115","232","4","351","880","0","39.89","13.07"
"67","000","00","040","0004","0204","391","141","250","3","394","981","0","40.16","14.37"
"67","000","00","040","0004","0205","355","143","212","2","357","861","0","41.46","16.61"
"67","000","00","040","0005","0000","507","173","334","4","511","1368","0","37.35","12.65"
"67","000","00","040","0005","0206","507","173","334","4","511","1368","0","37.35","12.65"
"67","000","00","040","0006","0000","297","105","192","1","298","727","0","40.99","14.44"
"67","000","00","040","0006","0207","172","67","105","1","173","398","0","43.47","16.83"
"67","000","00","040","0006","0208","125","38","87","0","125","329","0","37.99","11.55"
"67","000","00","040","0007","0000","601","206","395","15","616","1454","0","42.37","14.17"
"67","000","00","040","0007","0209","320","130","190","8","328","701","0","46.79","18.54"
"67","000","00","040","0007","0210","281","76","205","7","288","753","0","38.25","10.09"
"67","000","00","040","0008","0000","645","187","458","7","652","1738","0","37.51","10.76"
"67","000","00","040","0008","0211","257","61","196","5","262","690","0","37.97","8.84"
"67","000","00","040","0008","0212","293","95","198","2","295","768","0","38.41","12.37"
"67","000","00","040","0008","0213","95","31","64","0","95","280","0","33.93","11.07"
"67","000","00","040","0009","0000","470","144","326","5","475","1275","0","37.25","11.29"
"67","000","00","040","0009","0214","223","77","146","3","226","666","0","33.93","11.56"
"67","000","00","040","0009","0215","247","67","180","2","249","609","0","40.89","11.00"
"67","000","00","040","0010","0000","254","56","198","4","258","652","0","39.57","8.59"
"67","000","00","040","0010","0216","254","56","198","4","258","652","0","39.57","8.59"
"67","000","00","040","0011","0000","482","145","337","8","490","1337","0","36.65","10.85"
"67","000","00","040","0011","0217","405","122","283","6","411","1139","0","36.08","10.71"
"67","000","00","040","0011","0218","77","23","54","2","79","198","0","39.90","11.62"
"67","000","00","040","0012","0000","437","128","309","4","441","1192","0","37.00","10.74"
"67","000","00","040","0012","0219","358","95","263","2","360","1033","0","34.85","9.20"
"67","000","00","040","0012","0220","79","33","46","2","81","159","0","50.94","20.75"
"67","000","00","040","0013","0000","503","156","347","4","507","1517","0","33.42","10.28"
"67","000","00","040","0013","0221","264","88","176","3","267","858","0","31.12","10.26"
"67","000","00","040","0013","0222","183","50","133","1","184","491","0","37.47","10.18"
"67","000","00","040","0013","0223","56","18","38","0","56","168","0","33.33","10.71"
"67","000","00","050","0000","0000","8037","2568","5469","118","8155","20265","22532","40.24","12.67"
"67","000","00","050","0001","0000","691","269","422","6","697","1620","0","43.02","16.60"
"67","000","00","050","0001","0001","316","110","206","1","317","717","0","44.21","15.34"
"67","000","00","050","0001","0002","375","159","216","5","380","903","0","42.08","17.61"
"67","000","00","050","0002","0000","507","170","337","4","511","1264","0","40.43","13.45"
"67","000","00","050","0002","0003","305","111","194","4","309","748","0","41.31","14.84"
"67","000","00","050","0002","0004","202","59","143","0","202","516","0","39.15","11.43"
"67","000","00","050","0003","0000","479","158","321","6","485","1275","0","38.04","12.39"
"67","000","00","050","0003","0005","379","130","249","6","385","1039","0","37.05","12.51"
"67","000","00","050","0003","0006","100","28","72","0","100","236","0","42.37","11.86"
"67","000","00","050","0004","0000","527","139","388","5","532","1304","0","40.80","10.66"
"67","000","00","050","0004","0007","197","62","135","2","199","459","0","43.36","13.51"
"67","000","00","050","0004","0008","330","77","253","3","333","845","0","39.41","9.11"
"67","000","00","050","0010","0000","573","118","455","8","581","1336","0","43.49","8.83"
"67","000","00","050","0010","0021","411","80","331","4","415","902","0","46.01","8.87"
"67","000","00","050","0010","0022","162","38","124","4","166","434","0","38.25","8.76"
"67","000","00","050","0011","0000","607","177","430","6","613","1610","0","38.07","10.99"
"67","000","00","050","0011","0023","249","75","174","3","252","639","0","39.44","11.74"
"67","000","00","050","0011","0024","358","102","256","3","361","971","0","37.18","10.50"
"67","000","00","050","0012","0000","480","187","293","11","491","1223","0","40.15","15.29"
"67","000","00","050","0012","0025","480","187","293","11","491","1223","0","40.15","15.29"
"67","000","00","050","0013","0000","505","197","308","8","513","1216","0","42.19","16.20"
"67","000","00","050","0013","0026","266","109","157","4","270","659","0","40.97","16.54"
"67","000","00","050","0013","0027","239","88","151","4","243","557","0","43.63","15.80"
"67","000","00","050","0014","0000","683","238","445","8","691","1753","0","39.42","13.58"
"67","000","00","050","0014","0028","225","58","167","3","228","603","0","37.81","9.62"
"67","000","00","050","0014","0029","458","180","278","5","463","1150","0","40.26","15.65"
"67","000","00","050","0018","0000","564","183","381","7","571","1379","0","41.41","13.27"
"67","000","00","050","0018","0013","142","48","94","1","143","349","0","40.97","13.75"
"67","000","00","050","0018","0014","264","75","189","2","266","636","0","41.82","11.79"
"67","000","00","050","0018","0015","158","60","98","4","162","394","0","41.12","15.23"
"67","000","00","050","0019","0000","303","82","221","4","307","966","0","31.78","8.49"
"67","000","00","050","0019","0016","168","43","125","1","169","515","0","32.82","8.35"
"67","000","00","050","0019","0017","135","39","96","3","138","451","0","30.60","8.65"
"67","000","00","050","0022","0000","811","251","560","23","834","1961","0","42.53","12.80"
"67","000","00","050","0022","0018","359","131","228","18","377","953","0","39.56","13.75"
"67","000","00","050","0022","0019","232","54","178","3","235","476","0","49.37","11.34"
"67","000","00","050","0022","0020","220","66","154","2","222","532","0","41.73","12.41"
"67","000","00","050","0023","0000","859","249","610","14","873","2164","0","40.34","11.51"
"67","000","00","050","0023","0009","425","123","302","11","436","1052","0","41.44","11.69"
"67","000","00","050","0023","0010","434","126","308","3","437","1112","0","39.30","11.33"
"67","000","00","050","0024","0000","448","150","298","8","456","1194","0","38.19","12.56"
"67","000","00","050","0024","0011","290","90","200","3","293","749","0","39.12","12.02"
"67","000","00","050","0024","0012","158","60","98","5","163","445","0","36.63","13.48"
"67","000","00","060","0000","0000","5740","1999","3741","77","5817","17960","19922","32.39","11.13"
"67","000","00","060","0001","0000","476","199","277","6","482","1400","0","34.43","14.21"
"67","000","00","060","0001","0224","476","199","277","6","482","1400","0","34.43","14.21"
"67","000","00","060","0002","0000","869","340","529","6","875","2475","0","35.35","13.74"
"67","000","00","060","0002","0225","445","167","278","2","447","1166","0","38.34","14.32"
"67","000","00","060","0002","0226","424","173","251","4","428","1309","0","32.70","13.22"
"67","000","00","060","0003","0000","469","134","335","3","472","1405","0","33.59","9.54"
"67","000","00","060","0003","0227","227","60","167","1","228","715","0","31.89","8.39"
"67","000","00","060","0003","0228","242","74","168","2","244","690","0","35.36","10.72"
"67","000","00","060","0004","0000","285","88","197","3","288","920","0","31.30","9.57"
"67","000","00","060","0004","0230","285","88","197","3","288","920","0","31.30","9.57"
"67","000","00","060","0005","0000","296","100","196","2","298","1058","0","28.17","9.45"
"67","000","00","060","0005","0229","296","100","196","2","298","1058","0","28.17","9.45"
"67","000","00","060","0006","0000","415","137","278","9","424","1193","0","35.54","11.48"
"67","000","00","060","0006","0231","168","63","105","5","173","633","0","27.33","9.95"
"67","000","00","060","0006","0232","247","74","173","4","251","560","0","44.82","13.21"
"67","000","00","060","0007","0000","290","74","216","10","300","826","0","36.32","8.96"
"67","000","00","060","0007","0233","290","74","216","10","300","826","0","36.32","8.96"
"67","000","00","060","0008","0000","115","30","85","3","118","420","0","28.10","7.14"
"67","000","00","060","0008","0237","115","30","85","3","118","420","0","28.10","7.14"
"67","000","00","060","0009","0000","106","28","78","0","106","376","0","28.19","7.45"
"67","000","00","060","0009","0238","106","28","78","0","106","376","0","28.19","7.45"
"67","000","00","060","0010","0000","136","43","93","4","140","370","0","37.84","11.62"
"67","000","00","060","0010","0239","136","43","93","4","140","370","0","37.84","11.62"
"67","000","00","060","0011","0000","621","246","375","7","628","2040","0","30.78","12.06"
"67","000","00","060","0011","0240","372","130","242","6","378","1181","0","32.01","11.01"
"67","000","00","060","0011","0241","249","116","133","1","250","859","0","29.10","13.50"
"67","000","00","060","0012","0000","147","55","92","1","148","647","0","22.87","8.50"
"67","000","00","060","0012","0242","147","55","92","1","148","647","0","22.87","8.50"
"67","000","00","060","0013","0000","277","92","185","3","280","1054","0","26.57","8.73"
"67","000","00","060","0013","0243","277","92","185","3","280","1054","0","26.57","8.73"
"67","000","00","060","0014","0000","300","112","188","4","304","1052","0","28.90","10.65"
"67","000","00","060","0014","0244","300","112","188","4","304","1052","0","28.90","10.65"
"67","000","00","060","0015","0000","217","109","108","4","221","877","0","25.20","12.43"
"67","000","00","060","0015","0245","217","109","108","4","221","877","0","25.20","12.43"
"67","000","00","060","0016","0000","721","212","509","12","733","1847","0","39.69","11.48"
"67","000","00","060","0016","0234","308","78","230","3","311","756","0","41.14","10.32"
"67","000","00","060","0016","0235","171","52","119","6","177","481","0","36.80","10.81"
"67","000","00","060","0016","0236","242","82","160","3","245","610","0","40.16","13.44"
"67","000","00","070","0000","0000","16416","4447","11969","170","16586","37508","43610","44.22","11.86"
"67","000","00","070","0003","0000","1123","387","736","10","1133","2562","0","44.22","15.11"
"67","000","00","070","0003","0388","397","129","268","3","400","945","0","42.33","13.65"
"67","000","00","070","0003","0389","374","131","243","4","378","800","0","47.25","16.38"
"67","000","00","070","0003","0390","352","127","225","3","355","817","0","43.45","15.54"
"67","000","00","070","0004","0000","1103","309","794","17","1120","2463","0","45.47","12.55"
"67","000","00","070","0004","0391","331","92","239","2","333","737","0","45.18","12.48"
"67","000","00","070","0004","0392","355","105","250","8","363","826","0","43.95","12.71"
"67","000","00","070","0004","0393","417","112","305","7","424","900","0","47.11","12.44"
"67","000","00","070","0005","0000","969","317","652","6","975","2086","0","46.74","15.20"
"67","000","00","070","0005","0386","445","136","309","3","448","915","0","48.96","14.86"
"67","000","00","070","0005","0387","524","181","343","3","527","1171","0","45.00","15.46"
"67","000","00","070","0006","0000","849","290","559","9","858","1936","0","44.32","14.98"
"67","000","00","070","0006","0394","461","157","304","7","468","990","0","47.27","15.86"
"67","000","00","070","0006","0395","388","133","255","2","390","946","0","41.23","14.06"
"67","000","00","070","0007","0000","647","192","455","6","653","1433","0","45.57","13.40"
"67","000","00","070","0007","0396","389","131","258","2","391","768","0","50.91","17.06"
"67","000","00","070","0007","0397","258","61","197","4","262","665","0","39.40","9.17"
"67","000","00","070","0009","0000","1590","420","1170","13","1603","3474","0","46.14","12.09"
"67","000","00","070","0009","0398","532","163","369","2","534","1107","0","48.24","14.72"
"67","000","00","070","0009","0399","562","147","415","3","565","1273","0","44.38","11.55"
"67","000","00","070","0009","0400","496","110","386","8","504","1094","0","46.07","10.05"
"67","000","00","070","0010","0000","456","78","378","5","461","1093","0","42.18","7.14"
"67","000","00","070","0010","0401","456","78","378","5","461","1093","0","42.18","7.14"
"67","000","00","070","0011","0000","1247","358","889","12","1259","2846","0","44.24","12.58"
"67","000","00","070","0011","0402","401","135","266","4","405","852","0","47.54","15.85"
"67","000","00","070","0011","0403","386","88","298","3","389","918","0","42.37","9.59"
"67","000","00","070","0011","0404","460","135","325","5","465","1076","0","43.22","12.55"
"67","000","00","070","0014","0000","994","349","645","6","1000","2315","0","43.20","15.08"
"67","000","00","070","0014","0407","295","108","187","2","297","689","0","43.11","15.67"
"67","000","00","070","0014","0408","337","137","200","3","340","782","0","43.48","17.52"
"67","000","00","070","0014","0409","362","104","258","1","363","844","0","43.01","12.32"
"67","000","00","070","0015","0000","748","152","596","3","751","1645","0","45.65","9.24"
"67","000","00","070","0015","0410","346","65","281","0","346","804","0","43.03","8.08"
"67","000","00","070","0015","0411","402","87","315","3","405","841","0","48.16","10.34"
"67","000","00","070","0017","0000","954","204","750","9","963","2284","0","42.16","8.93"
"67","000","00","070","0017","0412","529","126","403","5","534","1321","0","40.42","9.54"
"67","000","00","070","0017","0413","425","78","347","4","429","963","0","44.55","8.10"
"67","000","00","070","0019","0000","830","198","632","17","847","2089","0","40.55","9.48"
"67","000","00","070","0019","0414","379","101","278","8","387","985","0","39.29","10.25"
"67","000","00","070","0019","0415","279","67","212","6","285","648","0","43.98","10.34"
"67","000","00","070","0019","0416","172","30","142","3","175","456","0","38.38","6.58"
"67","000","00","070","0021","0000","518","142","376","6","524","1232","0","42.53","11.53"
"67","000","00","070","0021","0417","518","142","376","6","524","1232","0","42.53","11.53"
"67","000","00","070","0022","0000","445","95","350","4","449","1171","0","38.34","8.11"
"67","000","00","070","0022","0418","445","95","350","4","449","1171","0","38.34","8.11"
"67","000","00","070","0024","0000","628","147","481","5","633","1297","0","48.80","11.33"
"67","000","00","070","0024","0419","280","74","206","2","282","539","0","52.32","13.73"
"67","000","00","070","0024","0420","348","73","275","3","351","758","0","46.31","9.63"
"67","000","00","070","0028","0000","377","95","282","2","379","925","0","40.97","10.27"
"67","000","00","070","0028","0423","377","95","282","2","379","925","0","40.97","10.27"
"67","000","00","070","0030","0000","794","208","586","11","805","1871","0","43.03","11.12"
"67","000","00","070","0030","0384","501","130","371","7","508","1192","0","42.62","10.91"
"67","000","00","070","0030","0385","293","78","215","4","297","679","0","43.74","11.49"
"67","000","00","070","0031","0000","774","157","617","14","788","1633","0","48.25","9.61"
"67","000","00","070","0031","0421","406","92","314","11","417","844","0","49.41","10.90"
"67","000","00","070","0031","0422","368","65","303","3","371","789","0","47.02","8.24"
"67","000","00","070","0032","0000","752","174","578","8","760","1704","0","44.60","10.21"
"67","000","00","070","0032","0424","488","103","385","4","492","1110","0","44.32","9.28"
"67","000","00","070","0032","0425","264","71","193","4","268","594","0","45.12","11.95"
"67","000","00","070","0033","0000","618","175","443","7","625","1449","0","43.13","12.08"
"67","000","00","070","0033","0405","298","99","199","2","300","691","0","43.42","14.33"
"67","000","00","070","0033","0406","320","76","244","5","325","758","0","42.88","10.03"
"67","000","00","080","0000","0000","7824","2532","5292","96","7920","20418","23214","38.79","12.40"
"67","000","00","080","0001","0000","615","245","370","6","621","1503","0","41.32","16.30"
"67","000","00","080","0001","0270","314","120","194","4","318","759","0","41.90","15.81"
"67","000","00","080","0001","0271","301","125","176","2","303","744","0","40.73","16.80"
"67","000","00","080","0002","0000","701","232","469","6","707","1925","0","36.73","12.05"
"67","000","00","080","0002","0272","325","109","216","0","325","951","0","34.17","11.46"
"67","000","00","080","0002","0273","376","123","253","6","382","974","0","39.22","12.63"
"67","000","00","080","0003","0000","607","230","377","7","614","1601","0","38.35","14.37"
"67","000","00","080","0003","0274","277","101","176","1","278","735","0","37.82","13.74"
"67","000","00","080","0003","0275","330","129","201","6","336","866","0","38.80","14.90"
"67","000","00","080","0004","0000","611","229","382","4","615","1555","0","39.55","14.73"
"67","000","00","080","0004","0276","300","118","182","2","302","730","0","41.37","16.16"
"67","000","00","080","0004","0277","311","111","200","2","313","825","0","37.94","13.45"
"67","000","00","080","0005","0000","681","237","444","5","686","1945","0","35.27","12.19"
"67","000","00","080","0005","0278","344","139","205","3","347","994","0","34.91","13.98"
"67","000","00","080","0005","0279","337","98","239","2","339","951","0","35.65","10.30"
"67","000","00","080","0006","0000","806","282","524","12","818","2079","0","39.35","13.56"
"67","000","00","080","0006","0280","381","123","258","7","388","1036","0","37.45","11.87"
"67","000","00","080","0006","0281","425","159","266","5","430","1043","0","41.23","15.24"
"67","000","00","080","0011","0000","727","203","524","8","735","1817","0","40.45","11.17"
"67","000","00","080","0011","0286","373","106","267","2","375","919","0","40.81","11.53"
"67","000","00","080","0011","0287","354","97","257","6","360","898","0","40.09","10.80"
"67","000","00","080","0012","0000","390","101","289","7","397","866","0","45.84","11.66"
"67","000","00","080","0012","0288","390","101","289","7","397","866","0","45.84","11.66"
"67","000","00","080","0013","0000","424","129","295","3","427","1269","0","33.65","10.17"
"67","000","00","080","0013","0289","226","76","150","2","228","647","0","35.24","11.75"
"67","000","00","080","0013","0290","198","53","145","1","199","622","0","31.99","8.52"
"67","000","00","080","0016","0000","850","233","617","9","859","2146","0","40.03","10.86"
"67","000","00","080","0016","0284","456","127","329","7","463","1099","0","42.13","11.56"
"67","000","00","080","0016","0285","394","106","288","2","396","1047","0","37.82","10.12"
"67","000","00","080","0017","0000","562","199","363","12","574","1539","0","37.30","12.93"
"67","000","00","080","0017","0282","256","82","174","5","261","700","0","37.29","11.71"
"67","000","00","080","0017","0283","306","117","189","7","313","839","0","37.31","13.95"
"67","000","00","080","0018","0000","850","212","638","17","867","2173","0","39.90","9.76"
"67","000","00","080","0018","0291","460","116","344","10","470","1138","0","41.30","10.19"
"67","000","00","080","0018","0292","390","96","294","7","397","1035","0","38.36","9.28"
"67","000","00","090","0000","0000","7019","2256","4763","81","7100","18759","21572","37.85","12.03"
"67","000","00","090","0001","0000","1061","349","712","9","1070","2866","0","37.33","12.18"
"67","000","00","090","0001","0293","304","112","192","1","305","795","0","38.36","14.09"
"67","000","00","090","0001","0294","229","83","146","0","229","627","0","36.52","13.24"
"67","000","00","090","0001","0295","528","154","374","8","536","1444","0","37.12","10.66"
"67","000","00","090","0002","0000","956","291","665","15","971","2601","0","37.33","11.19"
"67","000","00","090","0002","0296","572","186","386","8","580","1483","0","39.11","12.54"
"67","000","00","090","0002","0297","384","105","279","7","391","1118","0","34.97","9.39"
"67","000","00","090","0003","0000","545","189","356","7","552","1327","0","41.60","14.24"
"67","000","00","090","0003","0298","545","189","356","7","552","1327","0","41.60","14.24"
"67","000","00","090","0005","0000","695","205","490","9","704","1910","0","36.86","10.73"
"67","000","00","090","0005","0299","337","107","230","5","342","1014","0","33.73","10.55"
"67","000","00","090","0005","0300","358","98","260","4","362","896","0","40.40","10.94"
"67","000","00","090","0006","0000","1260","402","858","14","1274","3299","0","38.62","12.19"
"67","000","00","090","0006","0301","532","156","376","3","535","1369","0","39.08","11.40"
"67","000","00","090","0006","0302","342","116","226","9","351","938","0","37.42","12.37"
"67","000","00","090","0006","0303","386","130","256","2","388","992","0","39.11","13.10"
"67","000","00","090","0007","0000","770","240","530","6","776","2062","0","37.63","11.64"
"67","000","00","090","0007","0304","438","131","307","3","441","1168","0","37.76","11.22"
"67","000","00","090","0007","0305","332","109","223","3","335","894","0","37.47","12.19"
"67","000","00","090","0008","0000","616","210","406","8","624","1583","0","39.42","13.27"
"67","000","00","090","0008","0306","228","76","152","1","229","603","0","37.98","12.60"
"67","000","00","090","0008","0307","388","134","254","7","395","980","0","40.31","13.67"
"67","000","00","090","0009","0000","474","160","314","6","480","1229","0","39.06","13.02"
"67","000","00","090","0009","0308","474","160","314","6","480","1229","0","39.06","13.02"
"67","000","00","090","0010","0000","265","102","163","3","268","583","0","45.97","17.50"
"67","000","00","090","0010","0309","265","102","163","3","268","583","0","45.97","17.50"
"67","000","00","090","0011","0000","194","58","136","2","196","719","0","27.26","8.07"
"67","000","00","090","0011","0310","194","58","136","2","196","719","0","27.26","8.07"
"67","000","00","090","0012","0000","183","50","133","2","185","580","0","31.90","8.62"
"67","000","00","090","0012","0311","183","50","133","2","185","580","0","31.90","8.62"
"67","000","00","100","0000","0000","7637","2349","5288","90","7727","18603","21123","41.54","12.63"
"67","000","00","100","0001","0000","809","264","545","8","817","2045","0","39.95","12.91"
"67","000","00","100","0001","0426","438","165","273","3","441","1070","0","41.21","15.42"
"67","000","00","100","0001","0427","371","99","272","5","376","975","0","38.56","10.15"
"67","000","00","100","0002","0000","1317","311","1006","13","1330","3141","0","42.34","9.90"
"67","000","00","100","0002","0428","445","113","332","3","448","1017","0","44.05","11.11"
"67","000","00","100","0002","0429","396","90","306","5","401","1037","0","38.67","8.68"
"67","000","00","100","0002","0430","476","108","368","5","481","1087","0","44.25","9.94"
"67","000","00","100","0005","0000","145","51","94","1","146","402","0","36.32","12.69"
"67","000","00","100","0005","0433","145","51","94","1","146","402","0","36.32","12.69"
"67","000","00","100","0006","0000","781","295","486","12","793","1948","0","40.71","15.14"
"67","000","00","100","0006","0434","426","162","264","6","432","934","0","46.25","17.34"
"67","000","00","100","0006","0435","355","133","222","6","361","1014","0","35.60","13.12"
"67","000","00","100","0007","0000","1410","543","867","15","1425","3476","0","41.00","15.62"
"67","000","00","100","0007","0436","329","97","232","3","332","923","0","35.97","10.51"
"67","000","00","100","0007","0437","514","204","310","7","521","1208","0","43.13","16.89"
"67","000","00","100","0007","0438","567","242","325","5","572","1345","0","42.53","17.99"
"67","000","00","100","0008","0000","459","227","232","2","461","1243","0","37.09","18.26"
"67","000","00","100","0008","0439","459","227","232","2","461","1243","0","37.09","18.26"
"67","000","00","100","0013","0000","313","70","243","3","316","855","0","36.96","8.19"
"67","000","00","100","0013","0446","313","70","243","3","316","855","0","36.96","8.19"
"67","000","00","100","0014","0000","523","142","381","2","525","1197","0","43.86","11.86"
"67","000","00","100","0014","0431","403","90","313","2","405","928","0","43.64","9.70"
"67","000","00","100","0014","0432","120","52","68","0","120","269","0","44.61","19.33"
"67","000","00","100","0015","0000","1078","333","745","22","1100","2498","0","44.04","13.33"
"67","000","00","100","0015","0442","231","84","147","2","233","497","0","46.88","16.90"
"67","000","00","100","0015","0443","313","98","215","6","319","706","0","45.18","13.88"
"67","000","00","100","0015","0444","332","94","238","8","340","785","0","43.31","11.97"
"67","000","00","100","0015","0445","202","57","145","6","208","510","0","40.78","11.18"
"67","000","00","100","0016","0000","802","113","689","12","814","1798","0","45.27","6.28"
"67","000","00","100","0016","0440","554","79","475","8","562","1215","0","46.26","6.50"
"67","000","00","100","0016","0441","248","34","214","4","252","583","0","43.22","5.83"
"67","000","00","110","0000","0000","3190","972","2218","39","3229","8312","9096","38.85","11.69"
"67","000","00","110","0001","0000","385","123","262","4","389","992","0","39.21","12.40"
"67","000","00","110","0001","0480","292","70","222","3","295","743","0","39.70","9.42"
"67","000","00","110","0001","0481","93","53","40","1","94","249","0","37.75","21.29"
"67","000","00","110","0002","0000","229","54","175","6","235","619","0","37.96","8.72"
"67","000","00","110","0002","0482","229","54","175","6","235","619","0","37.96","8.72"
"67","000","00","110","0003","0000","523","136","387","6","529","1411","0","37.49","9.64"
"67","000","00","110","0003","0483","523","136","387","6","529","1411","0","37.49","9.64"
"67","000","00","110","0004","0000","328","126","202","2","330","885","0","37.29","14.24"
"67","000","00","110","0004","0484","328","126","202","2","330","885","0","37.29","14.24"
"67","000","00","110","0005","0000","352","121","231","4","356","744","0","47.85","16.26"
"67","000","00","110","0005","0485","352","121","231","4","356","744","0","47.85","16.26"
"67","000","00","110","0006","0000","250","71","179","2","252","598","0","42.14","11.87"
"67","000","00","110","0006","0486","250","71","179","2","252","598","0","42.14","11.87"
"67","000","00","110","0007","0000","337","101","236","3","340","969","0","35.09","10.42"
"67","000","00","110","0007","0487","337","101","236","3","340","969","0","35.09","10.42"
"67","000","00","110","0008","0000","237","70","167","4","241","722","0","33.38","9.70"
"67","000","00","110","0008","0488","237","70","167","4","241","722","0","33.38","9.70"
"67","000","00","110","0009","0000","327","120","207","4","331","822","0","40.27","14.60"
"67","000","00","110","0009","0489","327","120","207","4","331","822","0","40.27","14.60"
"67","000","00","110","0010","0000","222","50","172","4","226","550","0","41.09","9.09"
"67","000","00","110","0010","0490","222","50","172","4","226","550","0","41.09","9.09"
"67","000","00","120","0000","0000","19715","6509","13206","158","19873","49901","58600","39.82","13.04"
"67","000","00","120","0001","0000","997","338","659","10","1007","2192","0","45.94","15.42"
"67","000","00","120","0001","0337","486","153","333","5","491","1081","0","45.42","14.15"
"67","000","00","120","0001","0338","511","185","326","5","516","1111","0","46.44","16.65"
"67","000","00","120","0002","0000","1081","331","750","8","1089","2827","0","38.52","11.71"
"67","000","00","120","0002","0339","554","164","390","5","559","1371","0","40.77","11.96"
"67","000","00","120","0002","0340","527","167","360","3","530","1456","0","36.40","11.47"
"67","000","00","120","0003","0000","2155","718","1437","15","2170","5534","0","39.21","12.97"
"67","000","00","120","0003","0341","432","141","291","2","434","1083","0","40.07","13.02"
"67","000","00","120","0003","0342","424","145","279","1","425","1102","0","38.57","13.16"
"67","000","00","120","0003","0343","409","152","257","3","412","1066","0","38.65","14.26"
"67","000","00","120","0003","0344","429","153","276","4","433","1127","0","38.42","13.58"
"67","000","00","120","0003","0345","461","127","334","5","466","1156","0","40.31","10.99"
"67","000","00","120","0004","0000","1603","571","1032","12","1615","4239","0","38.10","13.47"
"67","000","00","120","0004","0355","405","129","276","3","408","1034","0","39.46","12.48"
"67","000","00","120","0004","0356","382","143","239","3","385","999","0","38.54","14.31"
"67","000","00","120","0004","0357","425","150","275","2","427","1164","0","36.68","12.89"
"67","000","00","120","0004","0358","391","149","242","4","395","1042","0","37.91","14.30"
"67","000","00","120","0005","0000","2281","800","1481","15","2296","5723","0","40.12","13.98"
"67","000","00","120","0005","0346","427","154","273","6","433","1034","0","41.88","14.89"
"67","000","00","120","0005","0347","455","162","293","2","457","1155","0","39.57","14.03"
"67","000","00","120","0005","0348","419","147","272","1","420","1097","0","38.29","13.40"
"67","000","00","120","0005","0349","522","197","325","2","524","1234","0","42.46","15.96"
"67","000","00","120","0005","0350","458","140","318","4","462","1203","0","38.40","11.64"
"67","000","00","120","0006","0000","1576","597","979","14","1590","3989","0","39.86","14.97"
"67","000","00","120","0006","0363","543","184","359","5","548","1367","0","40.09","13.46"
"67","000","00","120","0006","0364","515","187","328","5","520","1338","0","38.86","13.98"
"67","000","00","120","0006","0365","518","226","292","4","522","1284","0","40.65","17.60"
"67","000","00","120","0007","0000","813","253","560","6","819","2115","0","38.72","11.96"
"67","000","00","120","0007","0366","431","145","286","5","436","1146","0","38.05","12.65"
"67","000","00","120","0007","0367","382","108","274","1","383","969","0","39.53","11.15"
"67","000","00","120","0012","0000","771","237","534","10","781","2153","0","36.27","11.01"
"67","000","00","120","0012","0372","423","139","284","2","425","1148","0","37.02","12.11"
"67","000","00","120","0012","0373","348","98","250","8","356","1005","0","35.42","9.75"
"67","000","00","120","0019","0000","666","169","497","1","667","1660","0","40.18","10.18"
"67","000","00","120","0019","0379","513","126","387","1","514","1290","0","39.84","9.77"
"67","000","00","120","0019","0380","153","43","110","0","153","370","0","41.35","11.62"
"67","000","00","120","0020","0000","984","262","722","14","998","2328","0","42.87","11.25"
"67","000","00","120","0020","0381","287","64","223","4","291","677","0","42.98","9.45"
"67","000","00","120","0020","0382","294","96","198","5","299","739","0","40.46","12.99"
"67","000","00","120","0020","0383","403","102","301","5","408","912","0","44.74","11.18"
"67","000","00","120","0022","0000","398","142","256","10","408","1045","0","39.04","13.59"
"67","000","00","120","0022","0370","264","90","174","8","272","689","0","39.48","13.06"
"67","000","00","120","0022","0371","134","52","82","2","136","356","0","38.20","14.61"
"67","000","00","120","0023","0000","2025","805","1220","4","2029","5063","0","40.08","15.90"
"67","000","00","120","0023","0351","467","189","278","0","467","1180","0","39.58","16.02"
"67","000","00","120","0023","0352","534","211","323","1","535","1337","0","40.01","15.78"
"67","000","00","120","0023","0353","509","189","320","2","511","1309","0","39.04","14.44"
"67","000","00","120","0023","0354","515","216","299","1","516","1237","0","41.71","17.46"
"67","000","00","120","0024","0000","897","248","649","11","908","2103","0","43.18","11.79"
"67","000","00","120","0024","0368","470","118","352","7","477","1162","0","41.05","10.15"
"67","000","00","120","0024","0369","427","130","297","4","431","941","0","45.80","13.82"
"67","000","00","120","0025","0000","721","219","502","4","725","1786","0","40.59","12.26"
"67","000","00","120","0025","0374","372","101","271","2","374","856","0","43.69","11.80"
"67","000","00","120","0025","0375","349","118","231","2","351","930","0","37.74","12.69"
"67","000","00","120","0026","0000","1055","265","790","15","1070","2729","0","39.21","9.71"
"67","000","00","120","0026","0376","437","114","323","5","442","1006","0","43.94","11.33"
"67","000","00","120","0026","0377","317","83","234","7","324","944","0","34.32","8.79"
"67","000","00","120","0026","0378","301","68","233","3","304","779","0","39.02","8.73"
"67","000","00","120","0027","0000","1692","554","1138","9","1701","4415","0","38.53","12.55"
"67","000","00","120","0027","0359","382","146","236","1","383","1070","0","35.79","13.64"
"67","000","00","120","0027","0360","406","109","297","1","407","1131","0","35.99","9.64"
"67","000","00","120","0027","0361","360","121","239","3","363","942","0","38.54","12.85"
"67","000","00","120","0027","0362","544","178","366","4","548","1272","0","43.08","13.99"
"67","000","00","130","0000","0000","8652","2549","6103","79","8731","22220","25121","39.29","11.47"
"67","000","00","130","0001","0000","1588","488","1100","9","1597","3771","0","42.35","12.94"
"67","000","00","130","0001","0088","425","129","296","1","426","953","0","44.70","13.54"
"67","000","00","130","0001","0089","466","146","320","1","467","1083","0","43.12","13.48"
"67","000","00","130","0001","0090","376","94","282","3","379","886","0","42.78","10.61"
"67","000","00","130","0001","0091","321","119","202","4","325","849","0","38.28","14.02"
"67","000","00","130","0002","0000","886","272","614","4","890","2308","0","38.56","11.79"
"67","000","00","130","0002","0095","396","102","294","3","399","1064","0","37.50","9.59"
"67","000","00","130","0002","0096","490","170","320","1","491","1244","0","39.47","13.67"
"67","000","00","130","0003","0000","459","106","353","0","459","1207","0","38.03","8.78"
"67","000","00","130","0003","0101","308","64","244","0","308","821","0","37.52","7.80"
"67","000","00","130","0003","0102","151","42","109","0","151","386","0","39.12","10.88"
"67","000","00","130","0004","0000","280","89","191","7","287","771","0","37.22","11.54"
"67","000","00","130","0004","0103","280","89","191","7","287","771","0","37.22","11.54"
"67","000","00","130","0005","0000","773","292","481","9","782","1967","0","39.76","14.84"
"67","000","00","130","0005","0085","279","115","164","4","283","625","0","45.28","18.40"
"67","000","00","130","0005","0086","317","108","209","4","321","924","0","34.74","11.69"
"67","000","00","130","0005","0087","177","69","108","1","178","418","0","42.58","16.51"
"67","000","00","130","0006","0000","954","285","669","12","966","2463","0","39.22","11.57"
"67","000","00","130","0006","0080","310","93","217","3","313","848","0","36.91","10.97"
"67","000","00","130","0006","0081","249","65","184","4","253","663","0","38.16","9.80"
"67","000","00","130","0006","0082","395","127","268","5","400","952","0","42.02","13.34"
"67","000","00","130","0007","0000","779","196","583","5","784","1887","0","41.55","10.39"
"67","000","00","130","0007","0083","417","83","334","4","421","1058","0","39.79","7.84"
"67","000","00","130","0007","0084","362","113","249","1","363","829","0","43.79","13.63"
"67","000","00","130","0008","0000","446","100","346","5","451","1175","0","38.38","8.51"
"67","000","00","130","0008","0098","446","100","346","5","451","1175","0","38.38","8.51"
"67","000","00","130","0009","0000","374","65","309","3","377","1001","0","37.66","6.49"
"67","000","00","130","0009","0104","374","65","309","3","377","1001","0","37.66","6.49"
"67","000","00","130","0010","0000","786","270","516","11","797","2054","0","38.80","13.15"
"67","000","00","130","0010","0092","296","120","176","6","302","712","0","42.42","16.85"
"67","000","00","130","0010","0093","264","95","169","2","266","743","0","35.80","12.79"
"67","000","00","130","0010","0094","226","55","171","3","229","599","0","38.23","9.18"
"67","000","00","130","0011","0000","383","104","279","2","385","939","0","41.00","11.08"
"67","000","00","130","0011","0097","383","104","279","2","385","939","0","41.00","11.08"
"67","000","00","130","0012","0000","477","147","330","6","483","1310","0","36.87","11.22"
"67","000","00","130","0012","0105","202","64","138","2","204","578","0","35.29","11.07"
"67","000","00","130","0012","0106","136","47","89","2","138","405","0","34.07","11.60"
"67","000","00","130","0012","0107","139","36","103","2","141","327","0","43.12","11.01"
"67","000","00","130","0013","0000","467","135","332","6","473","1367","0","34.60","9.88"
"67","000","00","130","0013","0099","279","80","199","3","282","808","0","34.90","9.90"
"67","000","00","130","0013","0100","188","55","133","3","191","559","0","34.17","9.84"
"67","000","00","140","0000","0000","8083","2290","5793","94","8177","21470","24521","38.09","10.67"
"67","000","00","140","0001","0000","1238","356","882","17","1255","3112","0","40.33","11.44"
"67","000","00","140","0001","0516","387","131","256","6","393","920","0","42.72","14.24"
"67","000","00","140","0001","0517","401","102","299","5","406","884","0","45.93","11.54"
"67","000","00","140","0001","0518","450","123","327","6","456","1308","0","34.86","9.40"
"67","000","00","140","0002","0000","982","264","718","9","991","2413","0","41.07","10.94"
"67","000","00","140","0002","0522","690","208","482","8","698","1682","0","41.50","12.37"
"67","000","00","140","0002","0523","292","56","236","1","293","731","0","40.08","7.66"
"67","000","00","140","0003","0000","600","168","432","3","603","1625","0","37.11","10.34"
"67","000","00","140","0003","0524","441","145","296","1","442","1217","0","36.32","11.91"
"67","000","00","140","0003","0525","159","23","136","2","161","408","0","39.46","5.64"
"67","000","00","140","0004","0000","546","139","407","4","550","1640","0","33.54","8.48"
"67","000","00","140","0004","0526","298","71","227","3","301","778","0","38.69","9.13"
"67","000","00","140","0004","0527","248","68","180","1","249","862","0","28.89","7.89"
"67","000","00","140","0005","0000","497","116","381","10","507","1436","0","35.31","8.08"
"67","000","00","140","0005","0528","497","116","381","10","507","1436","0","35.31","8.08"
"67","000","00","140","0006","0000","472","126","346","4","476","1456","0","32.69","8.65"
"67","000","00","140","0006","0529","472","126","346","4","476","1456","0","32.69","8.65"
"67","000","00","140","0007","0000","314","79","235","5","319","758","0","42.08","10.42"
"67","000","00","140","0007","0530","314","79","235","5","319","758","0","42.08","10.42"
"67","000","00","140","0008","0000","492","145","347","9","501","1338","0","37.44","10.84"
"67","000","00","140","0008","0531","492","145","347","9","501","1338","0","37.44","10.84"
"67","000","00","140","0009","0000","557","138","419","4","561","1342","0","41.80","10.28"
"67","000","00","140","0009","0532","557","138","419","4","561","1342","0","41.80","10.28"
"67","000","00","140","0010","0000","537","136","401","6","543","1352","0","40.16","10.06"
"67","000","00","140","0010","0533","339","90","249","4","343","961","0","35.69","9.37"
"67","000","00","140","0010","0534","198","46","152","2","200","391","0","51.15","11.76"
"67","000","00","140","0011","0000","282","108","174","4","286","805","0","35.53","13.42"
"67","000","00","140","0011","0535","282","108","174","4","286","805","0","35.53","13.42"
"67","000","00","140","0012","0000","1566","515","1051","19","1585","4193","0","37.80","12.28"
"67","000","00","140","0012","0519","485","182","303","5","490","1354","0","36.19","13.44"
"67","000","00","140","0012","0520","561","186","375","7","568","1294","0","43.89","14.37"
"67","000","00","140","0012","0521","520","147","373","7","527","1545","0","34.11","9.51"
"67","000","00","150","0000","0000","7069","1866","5203","74","7143","19595","21996","36.45","9.52"
"67","000","00","150","0001","0000","391","95","296","2","393","998","0","39.38","9.52"
"67","000","00","150","0001","0312","188","49","139","1","189","518","0","36.49","9.46"
"67","000","00","150","0001","0313","203","46","157","1","204","480","0","42.50","9.58"
"67","000","00","150","0002","0000","232","48","184","4","236","648","0","36.42","7.41"
"67","000","00","150","0002","0314","232","48","184","4","236","648","0","36.42","7.41"
"67","000","00","150","0004","0000","307","94","213","1","308","820","0","37.56","11.46"
"67","000","00","150","0004","0315","307","94","213","1","308","820","0","37.56","11.46"
"67","000","00","150","0005","0000","309","98","211","2","311","809","0","38.44","12.11"
"67","000","00","150","0005","0316","309","98","211","2","311","809","0","38.44","12.11"
"67","000","00","150","0006","0000","164","40","124","1","165","444","0","37.16","9.01"
"67","000","00","150","0006","0317","164","40","124","1","165","444","0","37.16","9.01"
"67","000","00","150","0007","0000","153","30","123","2","155","410","0","37.80","7.32"
"67","000","00","150","0007","0318","153","30","123","2","155","410","0","37.80","7.32"
"67","000","00","150","0008","0000","609","124","485","7","616","1608","0","38.31","7.71"
"67","000","00","150","0008","0320","313","75","238","7","320","832","0","38.46","9.01"
"67","000","00","150","0008","0321","296","49","247","0","296","776","0","38.14","6.31"
"67","000","00","150","0009","0000","129","48","81","0","129","343","0","37.61","13.99"
"67","000","00","150","0009","0322","129","48","81","0","129","343","0","37.61","13.99"
"67","000","00","150","0010","0000","346","76","270","1","347","861","0","40.30","8.83"
"67","000","00","150","0010","0323","346","76","270","1","347","861","0","40.30","8.83"
"67","000","00","150","0011","0000","275","84","191","6","281","775","0","36.26","10.84"
"67","000","00","150","0011","0324","275","84","191","6","281","775","0","36.26","10.84"
"67","000","00","150","0012","0000","884","206","678","8","892","2548","0","35.01","8.08"
"67","000","00","150","0012","0325","270","73","197","3","273","856","0","31.89","8.53"
"67","000","00","150","0012","0326","288","63","225","1","289","811","0","35.64","7.77"
"67","000","00","150","0012","0327","326","70","256","4","330","881","0","37.46","7.95"
"67","000","00","150","0015","0000","625","141","484","10","635","1894","0","33.53","7.44"
"67","000","00","150","0015","0328","392","84","308","5","397","1185","0","33.50","7.09"
"67","000","00","150","0015","0329","233","57","176","5","238","709","0","33.57","8.04"
"67","000","00","150","0017","0000","236","58","178","3","239","683","0","34.99","8.49"
"67","000","00","150","0017","0319","236","58","178","3","239","683","0","34.99","8.49"
"67","000","00","150","0018","0000","479","140","339","11","490","1214","0","40.36","11.53"
"67","000","00","150","0018","0330","233","64","169","10","243","605","0","40.17","10.58"
"67","000","00","150","0018","0331","246","76","170","1","247","609","0","40.56","12.48"
"67","000","00","150","0019","0000","709","197","512","8","717","1858","0","38.59","10.60"
"67","000","00","150","0019","0332","428","127","301","3","431","1170","0","36.84","10.85"
"67","000","00","150","0019","0333","281","70","211","5","286","688","0","41.57","10.17"
"67","000","00","150","0021","0000","346","119","227","2","348","992","0","35.08","12.00"
"67","000","00","150","0021","0334","346","119","227","2","348","992","0","35.08","12.00"
"67","000","00","150","0022","0000","444","122","322","2","446","1329","0","33.56","9.18"
"67","000","00","150","0022","0335","444","122","322","2","446","1329","0","33.56","9.18"
"67","000","00","150","0023","0000","431","146","285","4","435","1361","0","31.96","10.73"
"67","000","00","150","0023","0336","431","146","285","4","435","1361","0","31.96","10.73"
"67","000","00","160","0000","0000","6211","1593","4618","79","6290","17313","18966","36.33","9.20"
"67","000","00","160","0001","0000","435","133","302","4","439","1136","0","38.64","11.71"
"67","000","00","160","0001","0246","435","133","302","4","439","1136","0","38.64","11.71"
"67","000","00","160","0013","0000","262","47","215","1","263","821","0","32.03","5.72"
"67","000","00","160","0013","0262","262","47","215","1","263","821","0","32.03","5.72"
"67","000","00","160","0014","0000","183","65","118","4","187","636","0","29.40","10.22"
"67","000","00","160","0014","0263","183","65","118","4","187","636","0","29.40","10.22"
"67","000","00","160","0015","0000","449","100","349","5","454","1312","0","34.60","7.62"
"67","000","00","160","0015","0264","264","54","210","3","267","673","0","39.67","8.02"
"67","000","00","160","0015","0265","185","46","139","2","187","639","0","29.26","7.20"
"67","000","00","160","0016","0000","429","99","330","6","435","1171","0","37.15","8.45"
"67","000","00","160","0016","0266","429","99","330","6","435","1171","0","37.15","8.45"
"67","000","00","160","0017","0000","655","128","527","7","662","1862","0","35.55","6.87"
"67","000","00","160","0017","0267","236","40","196","3","239","800","0","29.88","5.00"
"67","000","00","160","0017","0268","419","88","331","4","423","1062","0","39.83","8.29"
"67","000","00","160","0018","0000","272","56","216","6","278","946","0","29.39","5.92"
"67","000","00","160","0018","0269","272","56","216","6","278","946","0","29.39","5.92"
"67","000","00","160","0019","0000","469","97","372","4","473","1166","0","40.57","8.32"
"67","000","00","160","0019","0257","260","55","205","3","263","614","0","42.83","8.96"
"67","000","00","160","0019","0258","209","42","167","1","210","552","0","38.04","7.61"
"67","000","00","160","0020","0000","909","258","651","11","920","2358","0","39.02","10.94"
"67","000","00","160","0020","0247","556","162","394","8","564","1453","0","38.82","11.15"
"67","000","00","160","0020","0248","353","96","257","3","356","905","0","39.34","10.61"
"67","000","00","160","0021","0000","845","249","596","16","861","2413","0","35.68","10.32"
"67","000","00","160","0021","0249","204","64","140","4","208","490","0","42.45","13.06"
"67","000","00","160","0021","0250","349","101","248","4","353","1065","0","33.15","9.48"
"67","000","00","160","0021","0251","166","42","124","8","174","516","0","33.72","8.14"
"67","000","00","160","0021","0252","126","42","84","0","126","342","0","36.84","12.28"
"67","000","00","160","0022","0000","756","202","554","12","768","1964","0","39.10","10.29"
"67","000","00","160","0022","0253","203","60","143","2","205","556","0","36.87","10.79"
"67","000","00","160","0022","0254","157","32","125","4","161","395","0","40.76","8.10"
"67","000","00","160","0022","0255","216","58","158","4","220","560","0","39.29","10.36"
"67","000","00","160","0022","0256","180","52","128","2","182","453","0","40.18","11.48"
"67","000","00","160","0023","0000","547","159","388","3","550","1528","0","35.99","10.41"
"67","000","00","160","0023","0259","193","50","143","2","195","569","0","34.27","8.79"
"67","000","00","160","0023","0260","198","65","133","0","198","543","0","36.46","11.97"
"67","000","00","160","0023","0261","156","44","112","1","157","416","0","37.74","10.58"
"67","000","00","170","0000","0000","3032","1015","2017","34","3066","9549","10460","32.11","10.63"
"67","000","00","170","0001","0000","385","135","250","4","389","1309","0","29.72","10.31"
"67","000","00","170","0001","0068","215","70","145","3","218","711","0","30.66","9.85"
"67","000","00","170","0001","0069","170","65","105","1","171","598","0","28.60","10.87"
"67","000","00","170","0002","0000","147","54","93","2","149","451","0","33.04","11.97"
"67","000","00","170","0002","0073","147","54","93","2","149","451","0","33.04","11.97"
"67","000","00","170","0005","0000","271","105","166","1","272","820","0","33.17","12.80"
"67","000","00","170","0005","0064","168","72","96","0","168","454","0","37.00","15.86"
"67","000","00","170","0005","0065","103","33","70","1","104","366","0","28.42","9.02"
"67","000","00","170","0006","0000","249","95","154","2","251","909","0","27.61","10.45"
"67","000","00","170","0006","0074","249","95","154","2","251","909","0","27.61","10.45"
"67","000","00","170","0007","0000","392","138","254","8","400","1152","0","34.72","11.98"
"67","000","00","170","0007","0076","203","60","143","5","208","647","0","32.15","9.27"
"67","000","00","170","0007","0077","189","78","111","3","192","505","0","38.02","15.45"
"67","000","00","170","0009","0000","243","65","178","4","247","702","0","35.19","9.26"
"67","000","00","170","0009","0066","133","37","96","3","136","344","0","39.53","10.76"
"67","000","00","170","0009","0067","110","28","82","1","111","358","0","31.01","7.82"
"67","000","00","170","0011","0000","201","67","134","0","201","726","0","27.69","9.23"
"67","000","00","170","0011","0075","201","67","134","0","201","726","0","27.69","9.23"
"67","000","00","170","0013","0000","282","103","179","3","285","843","0","33.81","12.22"
"67","000","00","170","0013","0062","163","45","118","1","164","454","0","36.12","9.91"
"67","000","00","170","0013","0063","119","58","61","2","121","389","0","31.11","14.91"
"67","000","00","170","0014","0000","429","137","292","3","432","1415","0","30.53","9.68"
"67","000","00","170","0014","0070","156","48","108","0","156","567","0","27.51","8.47"
"67","000","00","170","0014","0071","177","74","103","1","178","539","0","33.02","13.73"
"67","000","00","170","0014","0072","96","15","81","2","98","309","0","31.72","4.85"
"67","000","00","170","0015","0000","433","116","317","7","440","1222","0","36.01","9.49"
"67","000","00","170","0015","0078","201","48","153","5","206","606","0","33.99","7.92"
"67","000","00","170","0015","0079","232","68","164","2","234","616","0","37.99","11.04"
"67","000","00","180","0000","0000","14731","5678","9053","141","14872","37315","43049","39.86","15.22"
"67","000","00","180","0001","0000","1348","592","756","15","1363","3038","0","44.87","19.49"
"67","000","00","180","0001","1020","332","169","163","2","334","722","0","46.26","23.41"
"67","000","00","180","0001","1021","464","196","268","5","469","1094","0","42.87","17.92"
"67","000","00","180","0001","1022","173","71","102","2","175","334","0","52.40","21.26"
"67","000","00","180","0001","1023","379","156","223","6","385","888","0","43.36","17.57"
"67","000","00","180","0002","0000","1583","664","919","10","1593","3973","0","40.10","16.71"
"67","000","00","180","0002","1024","485","226","259","4","489","1178","0","41.51","19.19"
"67","000","00","180","0002","1025","330","111","219","2","332","822","0","40.39","13.50"
"67","000","00","180","0002","1026","357","140","217","2","359","921","0","38.98","15.20"
"67","000","00","180","0002","1027","411","187","224","2","413","1052","0","39.26","17.78"
"67","000","00","180","0003","0000","1082","427","655","6","1088","2724","0","39.94","15.68"
"67","000","00","180","0003","1028","411","148","263","3","414","912","0","45.39","16.23"
"67","000","00","180","0003","1029","320","155","165","2","322","810","0","39.75","19.14"
"67","000","00","180","0003","1030","351","124","227","1","352","1002","0","35.13","12.38"
"67","000","00","180","0004","0000","1833","681","1152","16","1849","4411","0","41.92","15.44"
"67","000","00","180","0004","1031","568","204","364","7","575","1338","0","42.97","15.25"
"67","000","00","180","0004","1032","400","164","236","5","405","1025","0","39.51","16.00"
"67","000","00","180","0004","1033","491","177","314","3","494","1256","0","39.33","14.09"
"67","000","00","180","0004","1034","374","136","238","1","375","792","0","47.35","17.17"
"67","000","00","180","0009","0000","1285","519","766","15","1300","3203","0","40.59","16.20"
"67","000","00","180","0009","1035","380","129","251","6","386","984","0","39.23","13.11"
"67","000","00","180","0009","1036","384","169","215","5","389","991","0","39.25","17.05"
"67","000","00","180","0009","1037","521","221","300","4","525","1228","0","42.75","18.00"
"67","000","00","180","0010","0000","854","302","552","7","861","2153","0","39.99","14.03"
"67","000","00","180","0010","1038","479","200","279","2","481","1160","0","41.47","17.24"
"67","000","00","180","0010","1039","375","102","273","5","380","993","0","38.27","10.27"
"67","000","00","180","0011","0000","563","195","368","3","566","1482","0","38.19","13.16"
"67","000","00","180","0011","1040","563","195","368","3","566","1482","0","38.19","13.16"
"67","000","00","180","0012","0000","1198","498","700","22","1220","3226","0","37.82","15.44"
"67","000","00","180","0012","1041","452","182","270","9","461","1224","0","37.66","14.87"
"67","000","00","180","0012","1042","436","194","242","5","441","1245","0","35.42","15.58"
"67","000","00","180","0012","1043","310","122","188","8","318","757","0","42.01","16.12"
"67","000","00","180","0013","0000","1092","481","611","13","1105","2804","0","39.41","17.15"
"67","000","00","180","0013","1044","462","184","278","8","470","1366","0","34.41","13.47"
"67","000","00","180","0013","1045","630","297","333","5","635","1438","0","44.16","20.65"
"67","000","00","180","0014","0000","851","269","582","7","858","2123","0","40.41","12.67"
"67","000","00","180","0014","1046","391","116","275","4","395","1011","0","39.07","11.47"
"67","000","00","180","0014","1047","460","153","307","3","463","1112","0","41.64","13.76"
"67","000","00","180","0015","0000","834","300","534","8","842","2155","0","39.07","13.92"
"67","000","00","180","0015","1048","476","166","310","5","481","1177","0","40.87","14.10"
"67","000","00","180","0015","1049","358","134","224","3","361","978","0","36.91","13.70"
"67","000","00","180","0016","0000","573","200","373","6","579","1679","0","34.48","11.91"
"67","000","00","180","0016","1050","345","118","227","4","349","962","0","36.28","12.27"
"67","000","00","180","0016","1051","228","82","146","2","230","717","0","32.08","11.44"
"67","000","00","180","0017","0000","162","37","125","0","162","425","0","38.12","8.71"
"67","000","00","180","0017","1052","162","37","125","0","162","425","0","38.12","8.71"
"67","000","00","180","0018","0000","739","307","432","6","745","2087","0","35.70","14.71"
"67","000","00","180","0018","1053","358","151","207","1","359","1051","0","34.16","14.37"
"67","000","00","180","0018","1054","381","156","225","5","386","1036","0","37.26","15.06"
"67","000","00","180","0019","0000","355","134","221","2","357","899","0","39.71","14.91"
"67","000","00","180","0019","1055","355","134","221","2","357","899","0","39.71","14.91"
"67","000","00","180","0020","0000","379","72","307","5","384","933","0","41.16","7.72"
"67","000","00","180","0020","1056","379","72","307","5","384","933","0","41.16","7.72"
"67","000","00","190","0000","0000","16681","5842","10839","172","16853","41406","51052","40.70","14.11"
"67","000","00","190","0001","0000","439","174","265","5","444","1123","0","39.54","15.49"
"67","000","00","190","0001","0447","439","174","265","5","444","1123","0","39.54","15.49"
"67","000","00","190","0002","0000","1557","659","898","18","1575","3901","0","40.37","16.89"
"67","000","00","190","0002","0448","604","291","313","7","611","1398","0","43.71","20.82"
"67","000","00","190","0002","0449","496","203","293","4","500","1169","0","42.77","17.37"
"67","000","00","190","0002","0450","457","165","292","7","464","1334","0","34.78","12.37"
"67","000","00","190","0003","0000","2210","896","1314","18","2228","5414","0","41.15","16.55"
"67","000","00","190","0003","0451","572","233","339","2","574","1342","0","42.77","17.36"
"67","000","00","190","0003","0452","598","234","364","3","601","1363","0","44.09","17.17"
"67","000","00","190","0003","0453","581","248","333","7","588","1496","0","39.30","16.58"
"67","000","00","190","0003","0454","459","181","278","6","465","1213","0","38.33","14.92"
"67","000","00","190","0004","0000","1014","385","629","8","1022","2685","0","38.06","14.34"
"67","000","00","190","0004","0455","584","231","353","4","588","1531","0","38.41","15.09"
"67","000","00","190","0004","0456","430","154","276","4","434","1154","0","37.61","13.34"
"67","000","00","190","0005","0000","733","231","502","7","740","1791","0","41.32","12.90"
"67","000","00","190","0005","0457","376","109","267","5","381","946","0","40.27","11.52"
"67","000","00","190","0005","0458","357","122","235","2","359","845","0","42.49","14.44"
"67","000","00","190","0008","0000","626","208","418","6","632","1601","0","39.48","12.99"
"67","000","00","190","0008","0460","626","208","418","6","632","1601","0","39.48","12.99"
"67","000","00","190","0009","0000","531","105","426","6","537","1235","0","43.48","8.50"
"67","000","00","190","0009","0461","531","105","426","6","537","1235","0","43.48","8.50"
"67","000","00","190","0010","0000","837","256","581","14","851","2010","0","42.34","12.74"
"67","000","00","190","0010","0462","447","128","319","7","454","1063","0","42.71","12.04"
"67","000","00","190","0010","0463","390","128","262","7","397","947","0","41.92","13.52"
"67","000","00","190","0011","0000","496","145","351","4","500","1226","0","40.78","11.83"
"67","000","00","190","0011","0464","496","145","351","4","500","1226","0","40.78","11.83"
"67","000","00","190","0012","0000","840","316","524","9","849","1944","0","43.67","16.26"
"67","000","00","190","0012","0465","439","166","273","3","442","1018","0","43.42","16.31"
"67","000","00","190","0012","0466","401","150","251","6","407","926","0","43.95","16.20"
"67","000","00","190","0013","0000","284","65","219","2","286","677","0","42.25","9.60"
"67","000","00","190","0013","0467","284","65","219","2","286","677","0","42.25","9.60"
"67","000","00","190","0014","0000","393","95","298","4","397","1041","0","38.14","9.13"
"67","000","00","190","0014","0468","393","95","298","4","397","1041","0","38.14","9.13"
"67","000","00","190","0015","0000","671","185","486","9","680","1684","0","40.38","10.99"
"67","000","00","190","0015","0469","671","185","486","9","680","1684","0","40.38","10.99"
"67","000","00","190","0018","0000","675","226","449","15","690","1608","0","42.91","14.05"
"67","000","00","190","0018","0472","675","226","449","15","690","1608","0","42.91","14.05"
"67","000","00","190","0019","0000","637","191","446","10","647","1587","0","40.77","12.04"
"67","000","00","190","0019","0473","637","191","446","10","647","1587","0","40.77","12.04"
"67","000","00","190","0020","0000","429","106","323","1","430","1068","0","40.26","9.93"
"67","000","00","190","0020","0474","429","106","323","1","430","1068","0","40.26","9.93"
"67","000","00","190","0021","0000","1681","618","1063","14","1695","4425","0","38.31","13.97"
"67","000","00","190","0021","0475","588","186","402","7","595","1414","0","42.08","13.15"
"67","000","00","190","0021","0476","557","214","343","4","561","1410","0","39.79","15.18"
"67","000","00","190","0021","0477","536","218","318","3","539","1601","0","33.67","13.62"
"67","000","00","190","0022","0000","482","183","299","2","484","1117","0","43.33","16.38"
"67","000","00","190","0022","0459","482","183","299","2","484","1117","0","43.33","16.38"
"67","000","00","190","0023","0000","776","229","547","14","790","1945","0","40.62","11.77"
"67","000","00","190","0023","0470","446","122","324","8","454","1083","0","41.92","11.27"
"67","000","00","190","0023","0471","330","107","223","6","336","862","0","38.98","12.41"
"67","000","00","190","0024","0000","1370","569","801","6","1376","3324","0","41.40","17.12"
"67","000","00","190","0024","0478","747","333","414","3","750","1824","0","41.12","18.26"
"67","000","00","190","0024","0479","623","236","387","3","626","1500","0","41.73","15.73"
"67","000","00","200","0000","0000","12203","4235","7968","104","12307","31369","37721","39.23","13.50"
"67","000","00","200","0001","0000","1140","416","724","13","1153","2990","0","38.56","13.91"
"67","000","00","200","0001","0829","355","132","223","5","360","964","0","37.34","13.69"
"67","000","00","200","0001","0830","458","162","296","4","462","1090","0","42.39","14.86"
"67","000","00","200","0001","0831","327","122","205","4","331","936","0","35.36","13.03"
"67","000","00","200","0002","0000","2655","1033","1622","22","2677","6488","0","41.26","15.92"
"67","000","00","200","0002","0832","514","181","333","5","519","1253","0","41.42","14.45"
"67","000","00","200","0002","0833","542","200","342","3","545","1258","0","43.32","15.90"
"67","000","00","200","0002","0834","428","197","231","5","433","1056","0","41.00","18.66"
"67","000","00","200","0002","0835","446","174","272","4","450","1082","0","41.59","16.08"
"67","000","00","200","0002","0836","425","165","260","3","428","976","0","43.85","16.91"
"67","000","00","200","0002","0837","300","116","184","2","302","863","0","34.99","13.44"
"67","000","00","200","0003","0000","1113","353","760","7","1120","2768","0","40.46","12.75"
"67","000","00","200","0003","0838","392","120","272","3","395","932","0","42.38","12.88"
"67","000","00","200","0003","0839","401","157","244","2","403","1038","0","38.82","15.13"
"67","000","00","200","0003","0840","320","76","244","2","322","798","0","40.35","9.52"
"67","000","00","200","0004","0000","313","88","225","5","318","714","0","44.54","12.32"
"67","000","00","200","0004","0841","313","88","225","5","318","714","0","44.54","12.32"
"67","000","00","200","0005","0000","317","97","220","3","320","870","0","36.78","11.15"
"67","000","00","200","0005","0842","317","97","220","3","320","870","0","36.78","11.15"
"67","000","00","200","0006","0000","610","191","419","3","613","1563","0","39.22","12.22"
"67","000","00","200","0006","0843","340","102","238","3","343","910","0","37.69","11.21"
"67","000","00","200","0006","0844","270","89","181","0","270","653","0","41.35","13.63"
"67","000","00","200","0007","0000","1254","493","761","6","1260","3380","0","37.28","14.59"
"67","000","00","200","0007","0845","390","176","214","2","392","1124","0","34.88","15.66"
"67","000","00","200","0007","0846","445","178","267","2","447","1131","0","39.52","15.74"
"67","000","00","200","0007","0847","419","139","280","2","421","1125","0","37.42","12.36"
"67","000","00","200","0008","0000","1726","499","1227","14","1740","4530","0","38.41","11.02"
"67","000","00","200","0008","0848","446","157","289","5","451","1195","0","37.74","13.14"
"67","000","00","200","0008","0849","368","104","264","4","372","1048","0","35.50","9.92"
"67","000","00","200","0008","0850","473","132","341","4","477","1237","0","38.56","10.67"
"67","000","00","200","0008","0851","439","106","333","1","440","1050","0","41.90","10.10"
"67","000","00","200","0009","0000","677","197","480","5","682","1790","0","38.10","11.01"
"67","000","00","200","0009","0852","324","91","233","3","327","866","0","37.76","10.51"
"67","000","00","200","0009","0853","353","106","247","2","355","924","0","38.42","11.47"
"67","000","00","200","0010","0000","1163","393","770","17","1180","3330","0","35.44","11.80"
"67","000","00","200","0010","0854","294","132","162","4","298","913","0","32.64","14.46"
"67","000","00","200","0010","0855","431","107","324","7","438","1239","0","35.35","8.64"
"67","000","00","200","0010","0856","438","154","284","6","444","1178","0","37.69","13.07"
"67","000","00","200","0011","0000","1235","475","760","9","1244","2946","0","42.23","16.12"
"67","000","00","200","0011","0857","301","107","194","1","302","700","0","43.14","15.29"
"67","000","00","200","0011","0858","422","158","264","5","427","1056","0","40.44","14.96"
"67","000","00","200","0011","0859","512","210","302","3","515","1190","0","43.28","17.65"
"67","000","00","210","0000","0000","10659","3333","7326","110","10769","26163","30286","41.16","12.74"
"67","000","00","210","0001","0000","905","266","639","19","924","2065","0","44.75","12.88"
"67","000","00","210","0001","0536","546","168","378","8","554","1207","0","45.90","13.92"
"67","000","00","210","0001","0537","359","98","261","11","370","858","0","43.12","11.42"
"67","000","00","210","0002","0000","780","258","522","5","785","2038","0","38.52","12.66"
"67","000","00","210","0002","0538","421","148","273","4","425","1143","0","37.18","12.95"
"67","000","00","210","0002","0539","359","110","249","1","360","895","0","40.22","12.29"
"67","000","00","210","0003","0000","568","185","383","2","570","1381","0","41.27","13.40"
"67","000","00","210","0003","0540","251","89","162","2","253","653","0","38.74","13.63"
"67","000","00","210","0003","0541","317","96","221","0","317","728","0","43.54","13.19"
"67","000","00","210","0004","0000","892","280","612","10","902","2194","0","41.11","12.76"
"67","000","00","210","0004","0542","444","122","322","5","449","1112","0","40.38","10.97"
"67","000","00","210","0004","0543","448","158","290","5","453","1082","0","41.87","14.60"
"67","000","00","210","0006","0000","587","190","397","5","592","1485","0","39.87","12.79"
"67","000","00","210","0006","0544","277","81","196","2","279","726","0","38.43","11.16"
"67","000","00","210","0006","0545","310","109","201","3","313","759","0","41.24","14.36"
"67","000","00","210","0007","0000","716","240","476","9","725","1715","0","42.27","13.99"
"67","000","00","210","0007","0546","344","119","225","2","346","823","0","42.04","14.46"
"67","000","00","210","0007","0547","372","121","251","7","379","892","0","42.49","13.57"
"67","000","00","210","0008","0000","1190","421","769","11","1201","2901","0","41.40","14.51"
"67","000","00","210","0008","0548","484","191","293","5","489","1122","0","43.58","17.02"
"67","000","00","210","0008","0549","416","129","287","5","421","977","0","43.09","13.20"
"67","000","00","210","0008","0550","290","101","189","1","291","802","0","36.28","12.59"
"67","000","00","210","0009","0000","1092","313","779","11","1103","2658","0","41.50","11.78"
"67","000","00","210","0009","0551","530","125","405","6","536","1348","0","39.76","9.27"
"67","000","00","210","0009","0552","562","188","374","5","567","1310","0","43.28","14.35"
"67","000","00","210","0012","0000","317","106","211","0","317","715","0","44.34","14.83"
"67","000","00","210","0012","0555","317","106","211","0","317","715","0","44.34","14.83"
"67","000","00","210","0013","0000","977","279","698","7","984","2448","0","40.20","11.40"
"67","000","00","210","0013","0556","477","142","335","4","481","1260","0","38.17","11.27"
"67","000","00","210","0013","0557","500","137","363","3","503","1188","0","42.34","11.53"
"67","000","00","210","0014","0000","1033","332","701","13","1046","2574","0","40.64","12.90"
"67","000","00","210","0014","0558","511","147","364","5","516","1180","0","43.73","12.46"
"67","000","00","210","0014","0559","522","185","337","8","530","1394","0","38.02","13.27"
"67","000","00","210","0017","0000","678","192","486","5","683","1609","0","42.45","11.93"
"67","000","00","210","0017","0560","403","109","294","4","407","998","0","40.78","10.92"
"67","000","00","210","0017","0561","275","83","192","1","276","611","0","45.17","13.58"
"67","000","00","210","0018","0000","924","271","653","13","937","2380","0","39.37","11.39"
"67","000","00","210","0018","0553","486","121","365","6","492","1168","0","42.12","10.36"
"67","000","00","210","0018","0554","438","150","288","7","445","1212","0","36.72","12.38"
"67","000","00","220","0000","0000","2308","806","1502","40","2348","6378","7053","36.81","12.64"
"67","000","00","220","0001","0000","573","209","364","7","580","1662","0","34.90","12.58"
"67","000","00","220","0001","0562","285","111","174","4","289","848","0","34.08","13.09"
"67","000","00","220","0001","0563","288","98","190","3","291","814","0","35.75","12.04"
"67","000","00","220","0002","0000","640","211","429","11","651","1522","0","42.77","13.86"
"67","000","00","220","0002","0564","321","112","209","4","325","740","0","43.92","15.14"
"67","000","00","220","0002","0565","319","99","220","7","326","782","0","41.69","12.66"
"67","000","00","220","0003","0000","337","123","214","10","347","961","0","36.11","12.80"
"67","000","00","220","0003","0566","337","123","214","10","347","961","0","36.11","12.80"
"67","000","00","220","0004","0000","304","87","217","3","307","930","0","33.01","9.35"
"67","000","00","220","0004","0567","304","87","217","3","307","930","0","33.01","9.35"
"67","000","00","220","0005","0000","196","70","126","3","199","560","0","35.54","12.50"
"67","000","00","220","0005","0568","196","70","126","3","199","560","0","35.54","12.50"
"67","000","00","220","0006","0000","137","63","74","1","138","351","0","39.32","17.95"
"67","000","00","220","0006","0569","137","63","74","1","138","351","0","39.32","17.95"
"67","000","00","220","0007","0000","121","43","78","5","126","392","0","32.14","10.97"
"67","000","00","220","0007","0570","121","43","78","5","126","392","0","32.14","10.97"
"67","000","00","230","0000","0000","4359","2061","2298","61","4420","12025","13483","36.76","17.14"
"67","000","00","230","0001","0000","449","240","209","5","454","1202","0","37.77","19.97"
"67","000","00","230","0001","0491","449","240","209","5","454","1202","0","37.77","19.97"
"67","000","00","230","0002","0000","1263","671","592","17","1280","3556","0","36.00","18.87"
"67","000","00","230","0002","0492","336","196","140","7","343","960","0","35.73","20.42"
"67","000","00","230","0002","0493","289","137","152","4","293","811","0","36.13","16.89"
"67","000","00","230","0002","0494","281","137","144","2","283","822","0","34.43","16.67"
"67","000","00","230","0002","0495","357","201","156","4","361","963","0","37.49","20.87"
"67","000","00","230","0003","0000","485","216","269","6","491","1198","0","40.98","18.03"
"67","000","00","230","0003","0496","228","111","117","1","229","590","0","38.81","18.81"
"67","000","00","230","0003","0497","257","105","152","5","262","608","0","43.09","17.27"
"67","000","00","230","0004","0000","479","229","250","7","486","1398","0","34.76","16.38"
"67","000","00","230","0004","0498","311","150","161","5","316","899","0","35.15","16.69"
"67","000","00","230","0004","0499","168","79","89","2","170","499","0","34.07","15.83"
"67","000","00","230","0005","0000","197","98","99","7","204","497","0","41.05","19.72"
"67","000","00","230","0005","0500","197","98","99","7","204","497","0","41.05","19.72"
"67","000","00","230","0006","0000","176","58","118","1","177","490","0","36.12","11.84"
"67","000","00","230","0006","0501","176","58","118","1","177","490","0","36.12","11.84"
"67","000","00","230","0007","0000","292","122","170","3","295","731","0","40.36","16.69"
"67","000","00","230","0007","0502","292","122","170","3","295","731","0","40.36","16.69"
"67","000","00","230","0008","0000","497","222","275","4","501","1428","0","35.08","15.55"
"67","000","00","230","0008","0503","270","145","125","3","273","651","0","41.94","22.27"
"67","000","00","230","0008","0504","227","77","150","1","228","777","0","29.34","9.91"
"67","000","00","230","0009","0000","204","74","130","4","208","580","0","35.86","12.76"
"67","000","00","230","0009","0505","204","74","130","4","208","580","0","35.86","12.76"
"67","000","00","230","0010","0000","317","131","186","7","324","945","0","34.29","13.86"
"67","000","00","230","0010","0506","317","131","186","7","324","945","0","34.29","13.86"
"67","000","00","240","0000","0000","2631","1354","1277","33","2664","8230","9115","32.37","16.45"
"67","000","00","240","0001","0000","586","335","251","8","594","1779","0","33.39","18.83"
"67","000","00","240","0001","0507","316","182","134","4","320","950","0","33.68","19.16"
"67","000","00","240","0001","0508","270","153","117","4","274","829","0","33.05","18.46"
"67","000","00","240","0002","0000","291","127","164","3","294","1071","0","27.45","11.86"
"67","000","00","240","0002","0509","291","127","164","3","294","1071","0","27.45","11.86"
"67","000","00","240","0003","0000","203","107","96","1","204","681","0","29.96","15.71"
"67","000","00","240","0003","0510","203","107","96","1","204","681","0","29.96","15.71"
"67","000","00","240","0004","0000","306","133","173","2","308","951","0","32.39","13.99"
"67","000","00","240","0004","0511","306","133","173","2","308","951","0","32.39","13.99"
"67","000","00","240","0005","0000","312","182","130","5","317","894","0","35.46","20.36"
"67","000","00","240","0005","0512","312","182","130","5","317","894","0","35.46","20.36"
"67","000","00","240","0006","0000","204","95","109","4","208","639","0","32.55","14.87"
"67","000","00","240","0006","0513","204","95","109","4","208","639","0","32.55","14.87"
"67","000","00","240","0007","0000","729","375","354","10","739","2215","0","33.36","16.93"
"67","000","00","240","0007","0514","385","193","192","8","393","1176","0","33.42","16.41"
"67","000","00","240","0007","0515","344","182","162","2","346","1039","0","33.30","17.52"
"67","000","00","250","0000","0000","2297","1045","1252","25","2322","7508","8305","30.93","13.92"
"67","000","00","250","0001","0000","539","227","312","7","546","1343","0","40.66","16.90"
"67","000","00","250","0001","0581","258","119","139","2","260","664","0","39.16","17.92"
"67","000","00","250","0001","0582","281","108","173","5","286","679","0","42.12","15.91"
"67","000","00","250","0002","0000","216","95","121","3","219","764","0","28.66","12.43"
"67","000","00","250","0002","0583","216","95","121","3","219","764","0","28.66","12.43"
"67","000","00","250","0003","0000","118","59","59","1","119","404","0","29.46","14.60"
"67","000","00","250","0003","0586","118","59","59","1","119","404","0","29.46","14.60"
"67","000","00","250","0004","0000","200","77","123","5","205","547","0","37.48","14.08"
"67","000","00","250","0004","0587","200","77","123","5","205","547","0","37.48","14.08"
"67","000","00","250","0005","0000","176","75","101","0","176","620","0","28.39","12.10"
"67","000","00","250","0005","0584","176","75","101","0","176","620","0","28.39","12.10"
"67","000","00","250","0006","0000","209","96","113","2","211","725","0","29.10","13.24"
"67","000","00","250","0006","0585","209","96","113","2","211","725","0","29.10","13.24"
"67","000","00","250","0007","0000","346","166","180","1","347","1130","0","30.71","14.69"
"67","000","00","250","0007","0588","346","166","180","1","347","1130","0","30.71","14.69"
"67","000","00","250","0008","0000","311","146","165","3","314","1027","0","30.57","14.22"
"67","000","00","250","0008","0589","311","146","165","3","314","1027","0","30.57","14.22"
"67","000","00","250","0009","0000","182","104","78","3","185","948","0","19.51","10.97"
"67","000","00","250","0009","0590","182","104","78","3","185","948","0","19.51","10.97"
"67","000","00","260","0000","0000","1499","533","966","23","1522","4192","4475","36.31","12.71"
"67","000","00","260","0001","0000","126","50","76","0","126","359","0","35.10","13.93"
"67","000","00","260","0001","0571","126","50","76","0","126","359","0","35.10","13.93"
"67","000","00","260","0002","0000","226","64","162","5","231","612","0","37.75","10.46"
"67","000","00","260","0002","0572","226","64","162","5","231","612","0","37.75","10.46"
"67","000","00","260","0003","0000","157","60","97","5","162","456","0","35.53","13.16"
"67","000","00","260","0003","0573","157","60","97","5","162","456","0","35.53","13.16"
"67","000","00","260","0004","0000","235","115","120","1","236","717","0","32.91","16.04"
"67","000","00","260","0004","0574","235","115","120","1","236","717","0","32.91","16.04"
"67","000","00","260","0005","0000","119","55","64","2","121","333","0","36.34","16.52"
"67","000","00","260","0005","0575","119","55","64","2","121","333","0","36.34","16.52"
"67","000","00","260","0006","0000","148","61","87","3","151","355","0","42.54","17.18"
"67","000","00","260","0006","0576","148","61","87","3","151","355","0","42.54","17.18"
"67","000","00","260","0007","0000","166","32","134","4","170","488","0","34.84","6.56"
"67","000","00","260","0007","0580","166","32","134","4","170","488","0","34.84","6.56"
"67","000","00","260","0008","0000","137","40","97","0","137","407","0","33.66","9.83"
"67","000","00","260","0008","0577","137","40","97","0","137","407","0","33.66","9.83"
"67","000","00","260","0009","0000","95","35","60","3","98","286","0","34.27","12.24"
"67","000","00","260","0009","0578","95","35","60","3","98","286","0","34.27","12.24"
"67","000","00","260","0010","0000","90","21","69","0","90","179","0","50.28","11.73"
"67","000","00","260","0010","0579","90","21","69","0","90","179","0","50.28","11.73"
"67","000","00","270","0000","0000","27455","10567","16888","257","27712","65371","76229","42.39","16.16"
"67","000","00","270","0001","0000","2402","714","1688","21","2423","5421","0","44.70","13.17"
"67","000","00","270","0001","1384","607","176","431","8","615","1331","0","46.21","13.22"
"67","000","00","270","0001","1385","608","206","402","4","612","1418","0","43.16","14.53"
"67","000","00","270","0001","1386","631","167","464","3","634","1435","0","44.18","11.64"
"67","000","00","270","0001","1387","556","165","391","6","562","1237","0","45.43","13.34"
"67","000","00","270","0002","0000","1252","318","934","10","1262","2737","0","46.11","11.62"
"67","000","00","270","0002","1388","667","180","487","6","673","1432","0","47.00","12.57"
"67","000","00","270","0002","1389","585","138","447","4","589","1305","0","45.13","10.57"
"67","000","00","270","0003","0000","1113","414","699","11","1124","2570","0","43.74","16.11"
"67","000","00","270","0003","1390","543","213","330","6","549","1318","0","41.65","16.16"
"67","000","00","270","0003","1391","570","201","369","5","575","1252","0","45.93","16.05"
"67","000","00","270","0004","0000","3048","1224","1824","24","3072","7630","0","40.26","16.04"
"67","000","00","270","0004","1392","441","155","286","7","448","1109","0","40.40","13.98"
"67","000","00","270","0004","1393","446","175","271","2","448","1092","0","41.03","16.03"
"67","000","00","270","0004","1394","431","159","272","4","435","1074","0","40.50","14.80"
"67","000","00","270","0004","1395","415","163","252","4","419","1175","0","35.66","13.87"
"67","000","00","270","0004","1396","578","277","301","3","581","1431","0","40.60","19.36"
"67","000","00","270","0004","1397","386","155","231","3","389","949","0","40.99","16.33"
"67","000","00","270","0004","1398","351","140","211","1","352","800","0","44.00","17.50"
"67","000","00","270","0005","0000","3928","1539","2389","24","3952","9033","0","43.75","17.04"
"67","000","00","270","0005","1399","651","261","390","1","652","1441","0","45.25","18.11"
"67","000","00","270","0005","1400","567","206","361","4","571","1347","0","42.39","15.29"
"67","000","00","270","0005","1401","689","312","377","3","692","1477","0","46.85","21.12"
"67","000","00","270","0005","1402","492","184","308","0","492","1208","0","40.73","15.23"
"67","000","00","270","0005","1403","555","250","305","4","559","1348","0","41.47","18.55"
"67","000","00","270","0005","1404","482","172","310","6","488","1067","0","45.74","16.12"
"67","000","00","270","0005","1405","492","154","338","6","498","1145","0","43.49","13.45"
"67","000","00","270","0006","0000","1469","522","947","10","1479","3381","0","43.74","15.44"
"67","000","00","270","0006","1406","522","153","369","3","525","1247","0","42.10","12.27"
"67","000","00","270","0006","1407","446","165","281","5","451","971","0","46.45","16.99"
"67","000","00","270","0006","1408","501","204","297","2","503","1163","0","43.25","17.54"
"67","000","00","270","0007","0000","3797","1422","2375","29","3826","9317","0","41.06","15.26"
"67","000","00","270","0007","1409","565","201","364","5","570","1393","0","40.92","14.43"
"67","000","00","270","0007","1410","635","210","425","4","639","1453","0","43.98","14.45"
"67","000","00","270","0007","1411","573","213","360","5","578","1399","0","41.32","15.23"
"67","000","00","270","0007","1412","535","191","344","5","540","1332","0","40.54","14.34"
"67","000","00","270","0007","1413","446","169","277","7","453","1229","0","36.86","13.75"
"67","000","00","270","0007","1414","369","161","208","0","369","937","0","39.38","17.18"
"67","000","00","270","0007","1415","437","177","260","1","438","1027","0","42.65","17.23"
"67","000","00","270","0007","1416","237","100","137","2","239","547","0","43.69","18.28"
"67","000","00","270","0008","0000","2349","795","1554","29","2378","6025","0","39.47","13.20"
"67","000","00","270","0008","1417","326","124","202","6","332","846","0","39.24","14.66"
"67","000","00","270","0008","1418","310","105","205","5","315","759","0","41.50","13.83"
"67","000","00","270","0008","1419","547","181","366","5","552","1435","0","38.47","12.61"
"67","000","00","270","0008","1420","294","92","202","0","294","764","0","38.48","12.04"
"67","000","00","270","0008","1421","386","116","270","6","392","998","0","39.28","11.62"
"67","000","00","270","0008","1422","486","177","309","7","493","1223","0","40.31","14.47"
"67","000","00","270","0011","0000","1082","400","682","6","1088","2705","0","40.22","14.79"
"67","000","00","270","0011","1425","571","198","373","2","573","1380","0","41.52","14.35"
"67","000","00","270","0011","1426","511","202","309","4","515","1325","0","38.87","15.25"
"67","000","00","270","0012","0000","2104","1104","1000","27","2131","4809","0","44.31","22.96"
"67","000","00","270","0012","1427","629","326","303","7","636","1400","0","45.43","23.29"
"67","000","00","270","0012","1428","604","312","292","10","614","1333","0","46.06","23.41"
"67","000","00","270","0012","1429","585","342","243","9","594","1431","0","41.51","23.90"
"67","000","00","270","0012","1430","286","124","162","1","287","645","0","44.50","19.22"
"67","000","00","270","0013","0000","688","553","135","11","699","1493","0","46.82","37.04"
"67","000","00","270","0013","1431","688","553","135","11","699","1493","0","46.82","37.04"
"67","000","00","270","0014","0000","529","293","236","5","534","1211","0","44.10","24.19"
"67","000","00","270","0014","1432","529","293","236","5","534","1211","0","44.10","24.19"
"67","000","00","270","0015","0000","818","297","521","7","825","2102","0","39.25","14.13"
"67","000","00","270","0015","1433","467","187","280","4","471","1147","0","41.06","16.30"
"67","000","00","270","0015","1434","351","110","241","3","354","955","0","37.07","11.52"
"67","000","00","270","0016","0000","879","300","579","16","895","2110","0","42.42","14.22"
"67","000","00","270","0016","1435","417","134","283","6","423","935","0","45.24","14.33"
"67","000","00","270","0016","1436","462","166","296","10","472","1175","0","40.17","14.13"
"67","000","00","270","0017","0000","1071","363","708","18","1089","2612","0","41.69","13.90"
"67","000","00","270","0017","1437","495","155","340","8","503","1159","0","43.40","13.37"
"67","000","00","270","0017","1438","576","208","368","10","586","1453","0","40.33","14.32"
"67","000","00","270","0019","0000","926","309","617","9","935","2215","0","42.21","13.95"
"67","000","00","270","0019","1423","512","174","338","4","516","1252","0","41.21","13.90"
"67","000","00","270","0019","1424","414","135","279","5","419","963","0","43.51","14.02"
"67","000","00","280","0000","0000","23826","8096","15730","203","24029","57425","68074","41.84","14.10"
"67","000","00","280","0001","0000","2435","842","1593","12","2447","5856","0","41.79","14.38"
"67","000","00","280","0001","1439","485","174","311","2","487","1201","0","40.55","14.49"
"67","000","00","280","0001","1440","505","177","328","4","509","1154","0","44.11","15.34"
"67","000","00","280","0001","1441","430","159","271","1","431","1001","0","43.06","15.88"
"67","000","00","280","0001","1442","514","188","326","4","518","1212","0","42.74","15.51"
"67","000","00","280","0001","1443","501","144","357","1","502","1288","0","38.98","11.18"
"67","000","00","280","0002","0000","1382","424","958","6","1388","3838","0","36.16","11.05"
"67","000","00","280","0002","1448","345","102","243","2","347","967","0","35.88","10.55"
"67","000","00","280","0002","1449","264","82","182","1","265","961","0","27.58","8.53"
"67","000","00","280","0002","1450","381","100","281","1","382","957","0","39.92","10.45"
"67","000","00","280","0002","1451","392","140","252","2","394","953","0","41.34","14.69"
"67","000","00","280","0003","0000","923","373","550","10","933","2285","0","40.83","16.32"
"67","000","00","280","0003","1481","534","210","324","7","541","1255","0","43.11","16.73"
"67","000","00","280","0003","1482","389","163","226","3","392","1030","0","38.06","15.83"
"67","000","00","280","0004","0000","1339","454","885","14","1353","3225","0","41.95","14.08"
"67","000","00","280","0004","1454","458","170","288","5","463","1040","0","44.52","16.35"
"67","000","00","280","0004","1455","409","127","282","5","414","1073","0","38.58","11.84"
"67","000","00","280","0004","1456","472","157","315","4","476","1112","0","42.81","14.12"
"67","000","00","280","0005","0000","1341","501","840","7","1348","3248","0","41.50","15.42"
"67","000","00","280","0005","1460","413","176","237","5","418","1045","0","40.00","16.84"
"67","000","00","280","0005","1461","490","177","313","1","491","1125","0","43.64","15.73"
"67","000","00","280","0005","1462","438","148","290","1","439","1078","0","40.72","13.73"
"67","000","00","280","0006","0000","1324","457","867","13","1337","3254","0","41.09","14.04"
"67","000","00","280","0006","1466","458","169","289","2","460","1142","0","40.28","14.80"
"67","000","00","280","0006","1467","425","129","296","6","431","1040","0","41.44","12.40"
"67","000","00","280","0006","1468","441","159","282","5","446","1072","0","41.60","14.83"
"67","000","00","280","0007","0000","932","321","611","7","939","2155","0","43.57","14.90"
"67","000","00","280","0007","1469","471","163","308","3","474","1081","0","43.85","15.08"
"67","000","00","280","0007","1470","461","158","303","4","465","1074","0","43.30","14.71"
"67","000","00","280","0008","0000","764","285","479","8","772","1781","0","43.35","16.00"
"67","000","00","280","0008","1471","444","151","293","6","450","1012","0","44.47","14.92"
"67","000","00","280","0008","1472","320","134","186","2","322","769","0","41.87","17.43"
"67","000","00","280","0009","0000","1360","438","922","13","1373","3017","0","45.51","14.52"
"67","000","00","280","0009","1473","457","139","318","5","462","1055","0","43.79","13.18"
"67","000","00","280","0009","1474","413","140","273","1","414","917","0","45.15","15.27"
"67","000","00","280","0009","1475","490","159","331","7","497","1045","0","47.56","15.22"
"67","000","00","280","0010","0000","276","88","188","3","279","692","0","40.32","12.72"
"67","000","00","280","0010","1476","276","88","188","3","279","692","0","40.32","12.72"
"67","000","00","280","0011","0000","742","208","534","10","752","1871","0","40.19","11.12"
"67","000","00","280","0011","1477","409","120","289","6","415","995","0","41.71","12.06"
"67","000","00","280","0011","1478","333","88","245","4","337","876","0","38.47","10.05"
"67","000","00","280","0012","0000","646","235","411","5","651","1767","0","36.84","13.30"
"67","000","00","280","0012","1479","353","131","222","3","356","872","0","40.83","15.02"
"67","000","00","280","0012","1480","293","104","189","2","295","895","0","32.96","11.62"
"67","000","00","280","0013","0000","1177","382","795","10","1187","2678","0","44.32","14.26"
"67","000","00","280","0013","1483","393","126","267","3","396","848","0","46.70","14.86"
"67","000","00","280","0013","1484","366","124","242","3","369","862","0","42.81","14.39"
"67","000","00","280","0013","1485","418","132","286","4","422","968","0","43.60","13.64"
"67","000","00","280","0014","0000","1409","478","931","17","1426","3293","0","43.30","14.52"
"67","000","00","280","0014","1486","314","126","188","2","316","742","0","42.59","16.98"
"67","000","00","280","0014","1487","401","139","262","7","408","897","0","45.48","15.50"
"67","000","00","280","0014","1488","380","97","283","4","384","859","0","44.70","11.29"
"67","000","00","280","0014","1489","314","116","198","4","318","795","0","40.00","14.59"
"67","000","00","280","0015","0000","843","244","599","10","853","1938","0","44.01","12.59"
"67","000","00","280","0015","1490","388","125","263","3","391","938","0","41.68","13.33"
"67","000","00","280","0015","1491","455","119","336","7","462","1000","0","46.20","11.90"
"67","000","00","280","0016","0000","738","222","516","7","745","1652","0","45.10","13.44"
"67","000","00","280","0016","1492","420","125","295","6","426","940","0","45.32","13.30"
"67","000","00","280","0016","1493","318","97","221","1","319","712","0","44.80","13.62"
"67","000","00","280","0017","0000","1275","424","851","12","1287","3037","0","42.38","13.96"
"67","000","00","280","0017","1494","392","127","265","6","398","1022","0","38.94","12.43"
"67","000","00","280","0017","1495","435","118","317","3","438","936","0","46.79","12.61"
"67","000","00","280","0017","1496","448","179","269","3","451","1079","0","41.80","16.59"
"67","000","00","280","0018","0000","1767","658","1109","20","1787","4221","0","42.34","15.59"
"67","000","00","280","0018","1444","417","177","240","4","421","1012","0","41.60","17.49"
"67","000","00","280","0018","1445","469","162","307","4","473","1109","0","42.65","14.61"
"67","000","00","280","0018","1446","447","174","273","7","454","1045","0","43.44","16.65"
"67","000","00","280","0018","1447","434","145","289","5","439","1055","0","41.61","13.74"
"67","000","00","280","0019","0000","970","314","656","4","974","2447","0","39.80","12.83"
"67","000","00","280","0019","1463","341","116","225","0","341","883","0","38.62","13.14"
"67","000","00","280","0019","1464","425","149","276","4","429","1020","0","42.06","14.61"
"67","000","00","280","0019","1465","204","49","155","0","204","544","0","37.50","9.01"
"67","000","00","280","0020","0000","962","310","652","4","966","2218","0","43.55","13.98"
"67","000","00","280","0020","1452","481","154","327","2","483","1107","0","43.63","13.91"
"67","000","00","280","0020","1453","481","156","325","2","483","1111","0","43.47","14.04"
"67","000","00","280","0021","0000","1221","438","783","11","1232","2952","0","41.73","14.84"
"67","000","00","280","0021","1457","413","143","270","1","414","959","0","43.17","14.91"
"67","000","00","280","0021","1458","390","158","232","4","394","919","0","42.87","17.19"
"67","000","00","280","0021","1459","418","137","281","6","424","1074","0","39.48","12.76"
"67","000","00","290","0000","0000","12216","3967","8249","136","12352","29940","33986","41.26","13.25"
"67","000","00","290","0001","0000","960","330","630","19","979","2249","0","43.53","14.67"
"67","000","00","290","0001","1497","403","130","273","8","411","961","0","42.77","13.53"
"67","000","00","290","0001","1498","557","200","357","11","568","1288","0","44.10","15.53"
"67","000","00","290","0002","0000","855","263","592","5","860","2011","0","42.76","13.08"
"67","000","00","290","0002","1499","369","123","246","3","372","968","0","38.43","12.71"
"67","000","00","290","0002","1500","486","140","346","2","488","1043","0","46.79","13.42"
"67","000","00","290","0003","0000","1440","535","905","9","1449","3209","0","45.15","16.67"
"67","000","00","290","0003","1501","446","175","271","7","453","953","0","47.53","18.36"
"67","000","00","290","0003","1502","439","153","286","1","440","1001","0","43.96","15.28"
"67","000","00","290","0003","1503","555","207","348","1","556","1255","0","44.30","16.49"
"67","000","00","290","0004","0000","1041","320","721","14","1055","2473","0","42.66","12.94"
"67","000","00","290","0004","1504","557","168","389","9","566","1288","0","43.94","13.04"
"67","000","00","290","0004","1505","484","152","332","5","489","1185","0","41.27","12.83"
"67","000","00","290","0005","0000","368","113","255","7","375","1038","0","36.13","10.89"
"67","000","00","290","0005","1506","368","113","255","7","375","1038","0","36.13","10.89"
"67","000","00","290","0006","0000","285","76","209","1","286","695","0","41.15","10.94"
"67","000","00","290","0006","1507","285","76","209","1","286","695","0","41.15","10.94"
"67","000","00","290","0007","0000","1270","466","804","12","1282","3182","0","40.29","14.64"
"67","000","00","290","0007","1508","450","163","287","7","457","1105","0","41.36","14.75"
"67","000","00","290","0007","1509","438","163","275","2","440","1063","0","41.39","15.33"
"67","000","00","290","0007","1510","382","140","242","3","385","1014","0","37.97","13.81"
"67","000","00","290","0008","0000","1208","407","801","17","1225","3141","0","39.00","12.96"
"67","000","00","290","0008","1511","408","121","287","7","415","1112","0","37.32","10.88"
"67","000","00","290","0008","1512","347","151","196","6","353","981","0","35.98","15.39"
"67","000","00","290","0008","1513","453","135","318","4","457","1048","0","43.61","12.88"
"67","000","00","290","0009","0000","754","222","532","10","764","1949","0","39.20","11.39"
"67","000","00","290","0009","1514","346","101","245","4","350","965","0","36.27","10.47"
"67","000","00","290","0009","1515","408","121","287","6","414","984","0","42.07","12.30"
"67","000","00","290","0012","0000","592","207","385","6","598","1468","0","40.74","14.10"
"67","000","00","290","0012","1520","327","109","218","4","331","772","0","42.88","14.12"
"67","000","00","290","0012","1521","265","98","167","2","267","696","0","38.36","14.08"
"67","000","00","290","0013","0000","474","124","350","7","481","1183","0","40.66","10.48"
"67","000","00","290","0013","1522","330","92","238","5","335","826","0","40.56","11.14"
"67","000","00","290","0013","1523","144","32","112","2","146","357","0","40.90","8.96"
"67","000","00","290","0016","0000","769","240","529","10","779","1936","0","40.24","12.40"
"67","000","00","290","0016","1526","350","123","227","0","350","903","0","38.76","13.62"
"67","000","00","290","0016","1527","419","117","302","10","429","1033","0","41.53","11.33"
"67","000","00","290","0017","0000","204","73","131","5","209","470","0","44.47","15.53"
"67","000","00","290","0017","1528","204","73","131","5","209","470","0","44.47","15.53"
"67","000","00","290","0018","0000","1387","415","972","11","1398","3442","0","40.62","12.06"
"67","000","00","290","0018","1516","331","96","235","6","337","762","0","44.23","12.60"
"67","000","00","290","0018","1517","287","98","189","2","289","623","0","46.39","15.73"
"67","000","00","290","0018","1518","400","112","288","2","402","965","0","41.66","11.61"
"67","000","00","290","0018","1519","369","109","260","1","370","1092","0","33.88","9.98"
"67","000","00","290","0019","0000","609","176","433","3","612","1494","0","40.96","11.78"
"67","000","00","290","0019","1524","336","89","247","0","336","791","0","42.48","11.25"
"67","000","00","290","0019","1525","273","87","186","3","276","703","0","39.26","12.38"
"67","000","00","300","0000","0000","1303","506","797","19","1322","3545","3720","37.29","14.27"
"67","000","00","300","0001","0000","372","126","246","8","380","990","0","38.38","12.73"
"67","000","00","300","0001","1529","372","126","246","8","380","990","0","38.38","12.73"
"67","000","00","300","0002","0000","211","63","148","2","213","601","0","35.44","10.48"
"67","000","00","300","0002","1530","211","63","148","2","213","601","0","35.44","10.48"
"67","000","00","300","0003","0000","53","20","33","0","53","152","0","34.87","13.16"
"67","000","00","300","0003","1531","53","20","33","0","53","152","0","34.87","13.16"
"67","000","00","300","0004","0000","160","56","104","0","160","371","0","43.13","15.09"
"67","000","00","300","0004","1532","160","56","104","0","160","371","0","43.13","15.09"
"67","000","00","300","0005","0000","127","50","77","3","130","300","0","43.33","16.67"
"67","000","00","300","0005","1533","127","50","77","3","130","300","0","43.33","16.67"
"67","000","00","300","0006","0000","125","65","60","1","126","286","0","44.06","22.73"
"67","000","00","300","0006","1534","125","65","60","1","126","286","0","44.06","22.73"
"67","000","00","300","0007","0000","121","70","51","1","122","416","0","29.33","16.83"
"67","000","00","300","0007","1535","121","70","51","1","122","416","0","29.33","16.83"
"67","000","00","300","0008","0000","134","56","78","4","138","429","0","32.17","13.05"
"67","000","00","300","0008","1536","134","56","78","4","138","429","0","32.17","13.05"
"67","000","00","310","0000","0000","78916","32285","46631","641","79557","196894","235327","40.41","16.40"
"67","000","00","310","0001","0000","2207","924","1283","17","2224","5645","0","39.40","16.37"
"67","000","00","310","0001","0860","566","271","295","3","569","1365","0","41.68","19.85"
"67","000","00","310","0001","0861","539","209","330","4","543","1453","0","37.37","14.38"
"67","000","00","310","0001","0862","607","221","386","5","612","1410","0","43.40","15.67"
"67","000","00","310","0001","0863","495","223","272","5","500","1417","0","35.29","15.74"
"67","000","00","310","0002","0000","2742","1069","1673","23","2765","6942","0","39.83","15.40"
"67","000","00","310","0002","0871","572","198","374","10","582","1418","0","41.04","13.96"
"67","000","00","310","0002","0872","495","217","278","4","499","1322","0","37.75","16.41"
"67","000","00","310","0002","0873","549","208","341","0","549","1314","0","41.78","15.83"
"67","000","00","310","0002","0874","520","198","322","4","524","1337","0","39.19","14.81"
"67","000","00","310","0002","0875","606","248","358","5","611","1551","0","39.39","15.99"
"67","000","00","310","0003","0000","3077","1241","1836","19","3096","8806","0","35.16","14.09"
"67","000","00","310","0003","0882","598","245","353","4","602","1412","0","42.63","17.35"
"67","000","00","310","0003","0883","533","205","328","3","536","1364","0","39.30","15.03"
"67","000","00","310","0003","0884","534","195","339","3","537","1409","0","38.11","13.84"
"67","000","00","310","0003","0885","454","206","248","2","456","1318","0","34.60","15.63"
"67","000","00","310","0003","0886","356","141","215","1","357","1784","0","20.01","7.90"
"67","000","00","310","0003","0887","602","249","353","6","608","1519","0","40.03","16.39"
"67","000","00","310","0004","0000","2857","1048","1809","21","2878","7154","0","40.23","14.65"
"67","000","00","310","0004","0888","430","132","298","5","435","1045","0","41.63","12.63"
"67","000","00","310","0004","0889","441","177","264","0","441","1166","0","37.82","15.18"
"67","000","00","310","0004","0890","464","184","280","3","467","1185","0","39.41","15.53"
"67","000","00","310","0004","0891","595","251","344","5","600","1401","0","42.83","17.92"
"67","000","00","310","0004","0892","425","132","293","2","427","1068","0","39.98","12.36"
"67","000","00","310","0004","0893","502","172","330","6","508","1289","0","39.41","13.34"
"67","000","00","310","0005","0000","2332","1025","1307","19","2351","5595","0","42.02","18.32"
"67","000","00","310","0005","0903","492","221","271","3","495","1123","0","44.08","19.68"
"67","000","00","310","0005","0904","447","204","243","6","453","1145","0","39.56","17.82"
"67","000","00","310","0005","0905","490","193","297","3","493","1124","0","43.86","17.17"
"67","000","00","310","0005","0906","451","205","246","5","456","1116","0","40.86","18.37"
"67","000","00","310","0005","0907","452","202","250","2","454","1087","0","41.77","18.58"
"67","000","00","310","0006","0000","1005","306","699","9","1014","2455","0","41.30","12.46"
"67","000","00","310","0006","0949","534","146","388","5","539","1247","0","43.22","11.71"
"67","000","00","310","0006","0950","471","160","311","4","475","1208","0","39.32","13.25"
"67","000","00","310","0007","0000","1092","405","687","8","1100","2791","0","39.41","14.51"
"67","000","00","310","0007","0951","540","183","357","5","545","1346","0","40.49","13.60"
"67","000","00","310","0007","0952","552","222","330","3","555","1445","0","38.41","15.36"
"67","000","00","310","0008","0000","709","165","544","4","713","1847","0","38.60","8.93"
"67","000","00","310","0008","0920","346","56","290","1","347","935","0","37.11","5.99"
"67","000","00","310","0008","0921","363","109","254","3","366","912","0","40.13","11.95"
"67","000","00","310","0009","0000","653","248","405","8","661","1503","0","43.98","16.50"
"67","000","00","310","0009","0922","427","182","245","5","432","958","0","45.09","19.00"
"67","000","00","310","0009","0923","226","66","160","3","229","545","0","42.02","12.11"
"67","000","00","310","0010","0000","2062","689","1373","14","2076","4855","0","42.76","14.19"
"67","000","00","310","0010","0924","538","189","349","4","542","1293","0","41.92","14.62"
"67","000","00","310","0010","0925","541","159","382","5","546","1218","0","44.83","13.05"
"67","000","00","310","0010","0926","505","166","339","3","508","1198","0","42.40","13.86"
"67","000","00","310","0010","0927","478","175","303","2","480","1146","0","41.88","15.27"
"67","000","00","310","0011","0000","982","318","664","6","988","2226","0","44.38","14.29"
"67","000","00","310","0011","0936","347","140","207","2","349","887","0","39.35","15.78"
"67","000","00","310","0011","0937","635","178","457","4","639","1339","0","47.72","13.29"
"67","000","00","310","0012","0000","1414","424","990","10","1424","3408","0","41.78","12.44"
"67","000","00","310","0012","0960","452","120","332","2","454","1147","0","39.58","10.46"
"67","000","00","310","0012","0961","428","132","296","3","431","1014","0","42.50","13.02"
"67","000","00","310","0012","0962","534","172","362","5","539","1247","0","43.22","13.79"
"67","000","00","310","0013","0000","1422","410","1012","23","1445","3440","0","42.01","11.92"
"67","000","00","310","0013","0963","470","131","339","8","478","1124","0","42.53","11.65"
"67","000","00","310","0013","0964","442","120","322","8","450","1154","0","38.99","10.40"
"67","000","00","310","0013","0965","510","159","351","7","517","1162","0","44.49","13.68"
"67","000","00","310","0014","0000","3003","1110","1893","22","3025","7237","0","41.80","15.34"
"67","000","00","310","0014","0966","499","151","348","3","502","1210","0","41.49","12.48"
"67","000","00","310","0014","0967","495","175","320","7","502","1113","0","45.10","15.72"
"67","000","00","310","0014","0968","520","208","312","0","520","1358","0","38.29","15.32"
"67","000","00","310","0014","0969","485","177","308","2","487","1140","0","42.72","15.53"
"67","000","00","310","0014","0970","526","206","320","7","533","1200","0","44.42","17.17"
"67","000","00","310","0014","0971","478","193","285","3","481","1216","0","39.56","15.87"
"67","000","00","310","0015","0000","1565","461","1104","6","1571","3833","0","40.99","12.03"
"67","000","00","310","0015","0972","547","160","387","3","550","1335","0","41.20","11.99"
"67","000","00","310","0015","0973","516","135","381","2","518","1239","0","41.81","10.90"
"67","000","00","310","0015","0974","502","166","336","1","503","1259","0","39.95","13.19"
"67","000","00","310","0016","0000","2526","866","1660","18","2544","5820","0","43.71","14.88"
"67","000","00","310","0016","0975","478","203","275","4","482","1136","0","42.43","17.87"
"67","000","00","310","0016","0976","539","157","382","1","540","1220","0","44.26","12.87"
"67","000","00","310","0016","0977","545","197","348","7","552","1220","0","45.25","16.15"
"67","000","00","310","0016","0978","503","183","320","4","507","1136","0","44.63","16.11"
"67","000","00","310","0016","0979","461","126","335","2","463","1108","0","41.79","11.37"
"67","000","00","310","0017","0000","1653","542","1111","13","1666","4081","0","40.82","13.28"
"67","000","00","310","0017","0980","577","194","383","4","581","1481","0","39.23","13.10"
"67","000","00","310","0017","0981","553","177","376","2","555","1344","0","41.29","13.17"
"67","000","00","310","0017","0982","523","171","352","7","530","1256","0","42.20","13.61"
"67","000","00","310","0018","0000","824","265","559","8","832","2121","0","39.23","12.49"
"67","000","00","310","0018","0958","394","138","256","3","397","1032","0","38.47","13.37"
"67","000","00","310","0018","0959","430","127","303","5","435","1089","0","39.94","11.66"
"67","000","00","310","0019","0000","710","494","216","8","718","1919","0","37.42","25.74"
"67","000","00","310","0019","0987","359","255","104","6","365","1036","0","35.23","24.61"
"67","000","00","310","0019","0988","351","239","112","2","353","883","0","39.98","27.07"
"67","000","00","310","0020","0000","3313","1759","1554","29","3342","8455","0","39.53","20.80"
"67","000","00","310","0020","0992","605","308","297","5","610","1313","0","46.46","23.46"
"67","000","00","310","0020","0993","563","315","248","3","566","1463","0","38.69","21.53"
"67","000","00","310","0020","0994","458","229","229","1","459","1339","0","34.28","17.10"
"67","000","00","310","0020","0995","411","211","200","6","417","1112","0","37.50","18.97"
"67","000","00","310","0020","0996","419","214","205","4","423","1277","0","33.12","16.76"
"67","000","00","310","0020","0997","334","184","150","2","336","812","0","41.38","22.66"
"67","000","00","310","0020","0998","523","298","225","8","531","1139","0","46.62","26.16"
"67","000","00","310","0021","0000","770","467","303","13","783","1905","0","41.10","24.51"
"67","000","00","310","0021","0990","346","238","108","11","357","864","0","41.32","27.55"
"67","000","00","310","0021","0991","424","229","195","2","426","1041","0","40.92","22.00"
"67","000","00","310","0022","0000","467","254","213","4","471","1264","0","37.26","20.09"
"67","000","00","310","0022","1006","467","254","213","4","471","1264","0","37.26","20.09"
"67","000","00","310","0023","0000","2425","874","1551","25","2450","6123","0","40.01","14.27"
"67","000","00","310","0023","0953","468","178","290","4","472","1230","0","38.37","14.47"
"67","000","00","310","0023","0954","464","193","271","8","472","1174","0","40.20","16.44"
"67","000","00","310","0023","0955","503","169","334","4","507","1264","0","40.11","13.37"
"67","000","00","310","0023","0956","509","176","333","3","512","1266","0","40.44","13.90"
"67","000","00","310","0023","0957","481","158","323","6","487","1189","0","40.96","13.29"
"67","000","00","310","0024","0000","831","583","248","17","848","2032","0","41.73","28.69"
"67","000","00","310","0024","1007","436","335","101","11","447","1022","0","43.74","32.78"
"67","000","00","310","0024","1008","395","248","147","6","401","1010","0","39.70","24.55"
"67","000","00","310","0025","0000","1388","713","675","10","1398","3317","0","42.15","21.50"
"67","000","00","310","0025","1011","443","239","204","1","444","1113","0","39.89","21.47"
"67","000","00","310","0025","1012","472","229","243","6","478","1128","0","42.38","20.30"
"67","000","00","310","0025","1013","473","245","228","3","476","1076","0","44.24","22.77"
"67","000","00","310","0026","0000","2964","1497","1467","25","2989","7661","0","39.02","19.54"
"67","000","00","310","0026","1014","555","257","298","2","557","1301","0","42.81","19.75"
"67","000","00","310","0026","1015","462","221","241","5","467","1207","0","38.69","18.31"
"67","000","00","310","0026","1016","413","198","215","0","413","1132","0","36.48","17.49"
"67","000","00","310","0026","1017","478","235","243","5","483","1396","0","34.60","16.83"
"67","000","00","310","0026","1018","521","251","270","4","525","1369","0","38.35","18.33"
"67","000","00","310","0026","1019","535","335","200","9","544","1256","0","43.31","26.67"
"67","000","00","310","0027","0000","2298","734","1564","21","2319","6139","0","37.77","11.96"
"67","000","00","310","0027","0941","479","152","327","3","482","1235","0","39.03","12.31"
"67","000","00","310","0027","0942","484","151","333","9","493","1279","0","38.55","11.81"
"67","000","00","310","0027","0943","460","142","318","2","462","1288","0","35.87","11.02"
"67","000","00","310","0027","0944","484","169","315","4","488","1307","0","37.34","12.93"
"67","000","00","310","0027","0945","391","120","271","3","394","1030","0","38.25","11.65"
"67","000","00","310","0028","0000","196","138","58","1","197","527","0","37.38","26.19"
"67","000","00","310","0028","0989","196","138","58","1","197","527","0","37.38","26.19"
"67","000","00","310","0029","0000","2385","868","1517","14","2399","5686","0","42.19","15.27"
"67","000","00","310","0029","0931","449","163","286","4","453","1175","0","38.55","13.87"
"67","000","00","310","0029","0932","432","130","302","0","432","1010","0","42.77","12.87"
"67","000","00","310","0029","0933","526","202","324","2","528","1201","0","43.96","16.82"
"67","000","00","310","0029","0934","486","197","289","5","491","1121","0","43.80","17.57"
"67","000","00","310","0029","0935","492","176","316","3","495","1179","0","41.98","14.93"
"67","000","00","310","0030","0000","3157","1437","1720","20","3177","7749","0","41.00","18.54"
"67","000","00","310","0030","0876","443","217","226","2","445","1212","0","36.72","17.90"
"67","000","00","310","0030","0877","552","262","290","3","555","1359","0","40.84","19.28"
"67","000","00","310","0030","0878","497","241","256","3","500","1244","0","40.19","19.37"
"67","000","00","310","0030","0879","541","234","307","0","541","1262","0","42.87","18.54"
"67","000","00","310","0030","0880","533","234","299","6","539","1296","0","41.59","18.06"
"67","000","00","310","0030","0881","591","249","342","6","597","1376","0","43.39","18.10"
"67","000","00","310","0031","0000","2252","1009","1243","12","2264","5449","0","41.55","18.52"
"67","000","00","310","0031","0867","536","212","324","2","538","1310","0","41.07","16.18"
"67","000","00","310","0031","0868","573","205","368","5","578","1365","0","42.34","15.02"
"67","000","00","310","0031","0869","540","262","278","1","541","1392","0","38.86","18.82"
"67","000","00","310","0031","0870","603","330","273","4","607","1382","0","43.92","23.88"
"67","000","00","310","0032","0000","1396","607","789","12","1408","3456","0","40.74","17.56"
"67","000","00","310","0032","0864","485","214","271","4","489","1139","0","42.93","18.79"
"67","000","00","310","0032","0865","471","223","248","5","476","1146","0","41.54","19.46"
"67","000","00","310","0032","0866","440","170","270","3","443","1171","0","37.83","14.52"
"67","000","00","310","0033","0000","2798","1120","1678","20","2818","7184","0","39.23","15.59"
"67","000","00","310","0033","0908","674","266","408","7","681","1629","0","41.80","16.33"
"67","000","00","310","0033","0909","698","267","431","4","702","1671","0","42.01","15.98"
"67","000","00","310","0033","0910","650","288","362","3","653","1747","0","37.38","16.49"
"67","000","00","310","0033","0911","283","100","183","3","286","667","0","42.88","14.99"
"67","000","00","310","0033","0912","493","199","294","3","496","1470","0","33.74","13.54"
"67","000","00","310","0034","0000","1863","783","1080","17","1880","4806","0","39.12","16.29"
"67","000","00","310","0034","0916","425","191","234","4","429","1106","0","38.79","17.27"
"67","000","00","310","0034","0917","480","205","275","4","484","1356","0","35.69","15.12"
"67","000","00","310","0034","0918","482","180","302","4","486","1217","0","39.93","14.79"
"67","000","00","310","0034","0919","476","207","269","5","481","1127","0","42.68","18.37"
"67","000","00","310","0035","0000","1240","500","740","13","1253","3018","0","41.52","16.57"
"67","000","00","310","0035","0913","385","156","229","5","390","946","0","41.23","16.49"
"67","000","00","310","0035","0914","432","170","262","6","438","1068","0","41.01","15.92"
"67","000","00","310","0035","0915","423","174","249","2","425","1004","0","42.33","17.33"
"67","000","00","310","0036","0000","1642","571","1071","13","1655","3737","0","44.29","15.28"
"67","000","00","310","0036","0938","566","182","384","5","571","1168","0","48.89","15.58"
"67","000","00","310","0036","0939","486","130","356","6","492","1138","0","43.23","11.42"
"67","000","00","310","0036","0940","590","259","331","2","592","1431","0","41.37","18.10"
"67","000","00","310","0037","0000","3644","1837","1807","25","3669","9242","0","39.70","19.88"
"67","000","00","310","0037","0999","568","301","267","6","574","1490","0","38.52","20.20"
"67","000","00","310","0037","1000","492","240","252","0","492","1382","0","35.60","17.37"
"67","000","00","310","0037","1001","486","229","257","4","490","1208","0","40.56","18.96"
"67","000","00","310","0037","1002","559","290","269","1","560","1281","0","43.72","22.64"
"67","000","00","310","0037","1003","559","295","264","6","565","1337","0","42.26","22.06"
"67","000","00","310","0037","1004","544","267","277","3","547","1434","0","38.15","18.62"
"67","000","00","310","0037","1005","436","215","221","5","441","1110","0","39.73","19.37"
"67","000","00","310","0038","0000","3024","1126","1898","25","3049","7578","0","40.23","14.86"
"67","000","00","310","0038","0897","552","192","360","2","554","1295","0","42.78","14.83"
"67","000","00","310","0038","0898","498","196","302","7","505","1159","0","43.57","16.91"
"67","000","00","310","0038","0899","478","175","303","7","485","1189","0","40.79","14.72"
"67","000","00","310","0038","0900","531","156","375","4","535","1283","0","41.70","12.16"
"67","000","00","310","0038","0901","489","193","296","1","490","1326","0","36.95","14.56"
"67","000","00","310","0038","0902","476","214","262","4","480","1326","0","36.20","16.14"
"67","000","00","310","0039","0000","1329","694","635","12","1341","2787","0","48.12","24.90"
"67","000","00","310","0039","1009","702","385","317","10","712","1441","0","49.41","26.72"
"67","000","00","310","0039","1010","627","309","318","2","629","1346","0","46.73","22.96"
"67","000","00","310","0040","0000","2039","773","1266","14","2053","4977","0","41.25","15.53"
"67","000","00","310","0040","0983","543","197","346","3","546","1294","0","42.19","15.22"
"67","000","00","310","0040","0984","474","199","275","5","479","1206","0","39.72","16.50"
"67","000","00","310","0040","0985","561","212","349","2","563","1300","0","43.31","16.31"
"67","000","00","310","0040","0986","461","165","296","4","465","1177","0","39.51","14.02"
"67","000","00","310","0041","0000","1456","566","890","8","1464","3732","0","39.23","15.17"
"67","000","00","310","0041","0894","435","174","261","2","437","1141","0","38.30","15.25"
"67","000","00","310","0041","0895","513","185","328","4","517","1255","0","41.20","14.74"
"67","000","00","310","0041","0896","508","207","301","2","510","1336","0","38.17","15.49"
"67","000","00","310","0042","0000","1852","830","1022","23","1875","4598","0","40.78","18.05"
"67","000","00","310","0042","0946","628","287","341","7","635","1595","0","39.81","17.99"
"67","000","00","310","0042","0947","567","258","309","8","575","1438","0","39.99","17.94"
"67","000","00","310","0042","0948","657","285","372","8","665","1565","0","42.49","18.21"
"67","000","00","310","0043","0000","1352","535","817","12","1364","3794","0","35.95","14.10"
"67","000","00","310","0043","0928","397","141","256","4","401","1118","0","35.87","12.61"
"67","000","00","310","0043","0929","460","192","268","6","466","1410","0","33.05","13.62"
"67","000","00","310","0043","0930","495","202","293","2","497","1266","0","39.26","15.96"
"67","000","00","320","0000","0000","67898","31105","36793","473","68371","151996","183689","44.98","20.46"
"67","000","00","320","0001","0000","965","388","577","6","971","2144","0","45.29","18.10"
"67","000","00","320","0001","1379","487","198","289","2","489","1065","0","45.92","18.59"
"67","000","00","320","0001","1380","478","190","288","4","482","1079","0","44.67","17.61"
"67","000","00","320","0002","0000","1297","575","722","13","1310","2857","0","45.85","20.13"
"67","000","00","320","0002","1374","658","278","380","10","668","1493","0","44.74","18.62"
"67","000","00","320","0002","1375","639","297","342","3","642","1364","0","47.07","21.77"
"67","000","00","320","0003","0000","2803","1392","1411","19","2822","6524","0","43.26","21.34"
"67","000","00","320","0003","1310","508","220","288","4","512","1319","0","38.82","16.68"
"67","000","00","320","0003","1311","647","347","300","6","653","1353","0","48.26","25.65"
"67","000","00","320","0003","1312","555","300","255","5","560","1242","0","45.09","24.15"
"67","000","00","320","0003","1313","545","283","262","4","549","1297","0","42.33","21.82"
"67","000","00","320","0003","1314","548","242","306","0","548","1313","0","41.74","18.43"
"67","000","00","320","0004","0000","1286","554","732","12","1298","2838","0","45.74","19.52"
"67","000","00","320","0004","1256","415","192","223","5","420","897","0","46.82","21.40"
"67","000","00","320","0004","1257","441","175","266","5","446","942","0","47.35","18.58"
"67","000","00","320","0004","1258","430","187","243","2","432","999","0","43.24","18.72"
"67","000","00","320","0005","0000","2063","864","1199","21","2084","4536","0","45.94","19.05"
"67","000","00","320","0005","1280","505","211","294","8","513","1156","0","44.38","18.25"
"67","000","00","320","0005","1281","483","207","276","4","487","1052","0","46.29","19.68"
"67","000","00","320","0005","1282","633","266","367","3","636","1367","0","46.53","19.46"
"67","000","00","320","0005","1283","442","180","262","6","448","961","0","46.62","18.73"
"67","000","00","320","0006","0000","1875","802","1073","15","1890","4489","0","42.10","17.87"
"67","000","00","320","0006","1318","608","271","337","3","611","1451","0","42.11","18.68"
"67","000","00","320","0006","1319","597","278","319","6","603","1463","0","41.22","19.00"
"67","000","00","320","0006","1320","670","253","417","6","676","1575","0","42.92","16.06"
"67","000","00","320","0007","0000","1187","492","695","12","1199","2816","0","42.58","17.47"
"67","000","00","320","0007","1352","352","137","215","3","355","857","0","41.42","15.99"
"67","000","00","320","0007","1353","420","174","246","5","425","965","0","44.04","18.03"
"67","000","00","320","0007","1354","415","181","234","4","419","994","0","42.15","18.21"
"67","000","00","320","0008","0000","2196","1055","1141","14","2210","4731","0","46.71","22.30"
"67","000","00","320","0008","1355","638","282","356","5","643","1332","0","48.27","21.17"
"67","000","00","320","0008","1356","444","201","243","3","447","1033","0","43.27","19.46"
"67","000","00","320","0008","1357","522","296","226","4","526","1208","0","43.54","24.50"
"67","000","00","320","0008","1358","592","276","316","2","594","1158","0","51.30","23.83"
"67","000","00","320","0009","0000","1155","567","588","4","1159","2370","0","48.90","23.92"
"67","000","00","320","0009","1369","527","265","262","2","529","1092","0","48.44","24.27"
"67","000","00","320","0009","1370","628","302","326","2","630","1278","0","49.30","23.63"
"67","000","00","320","0010","0000","1342","605","737","10","1352","2931","0","46.13","20.64"
"67","000","00","320","0010","1266","433","197","236","2","435","978","0","44.48","20.14"
"67","000","00","320","0010","1267","400","192","208","3","403","853","0","47.25","22.51"
"67","000","00","320","0010","1268","509","216","293","5","514","1100","0","46.73","19.64"
"67","000","00","320","0011","0000","538","210","328","3","541","1309","0","41.33","16.04"
"67","000","00","320","0011","1269","538","210","328","3","541","1309","0","41.33","16.04"
"67","000","00","320","0012","0000","1825","916","909","8","1833","3981","0","46.04","23.01"
"67","000","00","320","0012","1381","639","353","286","3","642","1357","0","47.31","26.01"
"67","000","00","320","0012","1382","555","273","282","5","560","1219","0","45.94","22.40"
"67","000","00","320","0012","1383","631","290","341","0","631","1405","0","44.91","20.64"
"67","000","00","320","0013","0000","2183","1032","1151","11","2194","5154","0","42.57","20.02"
"67","000","00","320","0013","1336","551","264","287","3","554","1344","0","41.22","19.64"
"67","000","00","320","0013","1337","580","270","310","1","581","1229","0","47.27","21.97"
"67","000","00","320","0013","1338","517","257","260","4","521","1311","0","39.74","19.60"
"67","000","00","320","0013","1339","535","241","294","3","538","1270","0","42.36","18.98"
"67","000","00","320","0014","0000","2115","912","1203","17","2132","5004","0","42.61","18.23"
"67","000","00","320","0014","1321","565","230","335","4","569","1246","0","45.67","18.46"
"67","000","00","320","0014","1322","588","263","325","2","590","1399","0","42.17","18.80"
"67","000","00","320","0014","1323","510","222","288","6","516","1272","0","40.57","17.45"
"67","000","00","320","0014","1324","452","197","255","5","457","1087","0","42.04","18.12"
"67","000","00","320","0015","0000","735","375","360","4","739","1574","0","46.95","23.82"
"67","000","00","320","0015","1276","735","375","360","4","739","1574","0","46.95","23.82"
"67","000","00","320","0016","0000","653","278","375","5","658","1465","0","44.91","18.98"
"67","000","00","320","0016","1275","653","278","375","5","658","1465","0","44.91","18.98"
"67","000","00","320","0017","0000","2076","1037","1039","12","2088","4496","0","46.44","23.06"
"67","000","00","320","0017","1342","496","234","262","0","496","1103","0","44.97","21.21"
"67","000","00","320","0017","1343","507","245","262","3","510","1059","0","48.16","23.14"
"67","000","00","320","0017","1344","504","274","230","4","508","1104","0","46.01","24.82"
"67","000","00","320","0017","1345","569","284","285","5","574","1230","0","46.67","23.09"
"67","000","00","320","0018","0000","650","283","367","9","659","1504","0","43.82","18.82"
"67","000","00","320","0018","1373","650","283","367","9","659","1504","0","43.82","18.82"
"67","000","00","320","0019","0000","2203","927","1276","10","2213","4969","0","44.54","18.66"
"67","000","00","320","0019","1295","651","261","390","6","657","1409","0","46.63","18.52"
"67","000","00","320","0019","1296","550","242","308","2","552","1370","0","40.29","17.66"
"67","000","00","320","0019","1297","581","237","344","1","582","1272","0","45.75","18.63"
"67","000","00","320","0019","1298","421","187","234","1","422","918","0","45.97","20.37"
"67","000","00","320","0020","0000","1933","799","1134","18","1951","4395","0","44.39","18.18"
"67","000","00","320","0020","1376","624","243","381","2","626","1416","0","44.21","17.16"
"67","000","00","320","0020","1377","582","257","325","9","591","1415","0","41.77","18.16"
"67","000","00","320","0020","1378","727","299","428","7","734","1564","0","46.93","19.12"
"67","000","00","320","0021","0000","861","366","495","7","868","1797","0","48.30","20.37"
"67","000","00","320","0021","1264","518","215","303","6","524","1038","0","50.48","20.71"
"67","000","00","320","0021","1265","343","151","192","1","344","759","0","45.32","19.89"
"67","000","00","320","0022","0000","1834","919","915","9","1843","4122","0","44.71","22.30"
"67","000","00","320","0022","1365","458","234","224","2","460","1038","0","44.32","22.54"
"67","000","00","320","0022","1366","507","268","239","1","508","1052","0","48.29","25.48"
"67","000","00","320","0022","1367","463","212","251","3","466","1083","0","43.03","19.58"
"67","000","00","320","0022","1368","406","205","201","3","409","949","0","43.10","21.60"
"67","000","00","320","0023","0000","516","248","268","5","521","1038","0","50.19","23.89"
"67","000","00","320","0023","1259","516","248","268","5","521","1038","0","50.19","23.89"
"67","000","00","320","0024","0000","2156","965","1191","9","2165","4589","0","47.18","21.03"
"67","000","00","320","0024","1284","426","191","235","1","427","924","0","46.21","20.67"
"67","000","00","320","0024","1285","602","286","316","3","605","1265","0","47.83","22.61"
"67","000","00","320","0024","1286","413","184","229","2","415","935","0","44.39","19.68"
"67","000","00","320","0024","1287","715","304","411","3","718","1465","0","49.01","20.75"
"67","000","00","320","0025","0000","2277","979","1298","15","2292","5079","0","45.13","19.28"
"67","000","00","320","0025","1325","549","236","313","3","552","1287","0","42.89","18.34"
"67","000","00","320","0025","1326","629","253","376","3","632","1346","0","46.95","18.80"
"67","000","00","320","0025","1327","510","254","256","3","513","1159","0","44.26","21.92"
"67","000","00","320","0025","1328","589","236","353","6","595","1287","0","46.23","18.34"
"67","000","00","320","0026","0000","1414","566","848","12","1426","3195","0","44.63","17.72"
"67","000","00","320","0026","1315","476","190","286","4","480","1083","0","44.32","17.54"
"67","000","00","320","0026","1316","599","229","370","6","605","1339","0","45.18","17.10"
"67","000","00","320","0026","1317","339","147","192","2","341","773","0","44.11","19.02"
"67","000","00","320","0027","0000","1552","734","818","9","1561","3480","0","44.86","21.09"
"67","000","00","320","0027","1362","501","231","270","2","503","1124","0","44.75","20.55"
"67","000","00","320","0027","1363","574","302","272","5","579","1242","0","46.62","24.32"
"67","000","00","320","0027","1364","477","201","276","2","479","1114","0","43.00","18.04"
"67","000","00","320","0028","0000","731","305","426","4","735","1609","0","45.68","18.96"
"67","000","00","320","0028","1274","731","305","426","4","735","1609","0","45.68","18.96"
"67","000","00","320","0029","0000","1936","944","992","20","1956","4148","0","47.16","22.76"
"67","000","00","320","0029","1270","437","227","210","6","443","975","0","45.44","23.28"
"67","000","00","320","0029","1271","464","186","278","7","471","1025","0","45.95","18.15"
"67","000","00","320","0029","1272","535","271","264","6","541","1086","0","49.82","24.95"
"67","000","00","320","0029","1273","500","260","240","1","501","1062","0","47.18","24.48"
"67","000","00","320","0030","0000","1110","587","523","4","1114","2346","0","47.49","25.02"
"67","000","00","320","0030","1371","495","286","209","1","496","1100","0","45.09","26.00"
"67","000","00","320","0030","1372","615","301","314","3","618","1246","0","49.60","24.16"
"67","000","00","320","0031","0000","1340","622","718","10","1350","2853","0","47.32","21.80"
"67","000","00","320","0031","1359","420","214","206","3","423","883","0","47.90","24.24"
"67","000","00","320","0031","1360","426","189","237","5","431","913","0","47.21","20.70"
"67","000","00","320","0031","1361","494","219","275","2","496","1057","0","46.93","20.72"
"67","000","00","320","0032","0000","2072","981","1091","15","2087","4400","0","47.43","22.30"
"67","000","00","320","0032","1291","588","291","297","8","596","1179","0","50.55","24.68"
"67","000","00","320","0032","1292","539","243","296","3","542","1152","0","47.05","21.09"
"67","000","00","320","0032","1293","502","254","248","0","502","1080","0","46.48","23.52"
"67","000","00","320","0032","1294","443","193","250","4","447","989","0","45.20","19.51"
"67","000","00","320","0033","0000","1199","562","637","12","1211","2747","0","44.08","20.46"
"67","000","00","320","0033","1307","361","172","189","3","364","824","0","44.17","20.87"
"67","000","00","320","0033","1308","436","210","226","5","441","1030","0","42.82","20.39"
"67","000","00","320","0033","1309","402","180","222","4","406","893","0","45.46","20.16"
"67","000","00","320","0034","0000","933","395","538","6","939","2206","0","42.57","17.91"
"67","000","00","320","0034","1340","443","171","272","3","446","1092","0","40.84","15.66"
"67","000","00","320","0034","1341","490","224","266","3","493","1114","0","44.25","20.11"
"67","000","00","320","0035","0000","1272","603","669","7","1279","2925","0","43.73","20.62"
"67","000","00","320","0035","1299","408","194","214","1","409","938","0","43.60","20.68"
"67","000","00","320","0035","1300","477","205","272","3","480","1072","0","44.78","19.12"
"67","000","00","320","0035","1301","387","204","183","3","390","915","0","42.62","22.30"
"67","000","00","320","0036","0000","837","354","483","5","842","1800","0","46.78","19.67"
"67","000","00","320","0036","1262","383","174","209","0","383","865","0","44.28","20.12"
"67","000","00","320","0036","1263","454","180","274","5","459","935","0","49.09","19.25"
"67","000","00","320","0037","0000","835","410","425","5","840","1924","0","43.66","21.31"
"67","000","00","320","0037","1260","447","212","235","4","451","987","0","45.69","21.48"
"67","000","00","320","0037","1261","388","198","190","1","389","937","0","41.52","21.13"
"67","000","00","320","0038","0000","1249","570","679","5","1254","2848","0","44.03","20.01"
"67","000","00","320","0038","1277","328","148","180","2","330","810","0","40.74","18.27"
"67","000","00","320","0038","1278","455","212","243","3","458","969","0","47.27","21.88"
"67","000","00","320","0038","1279","466","210","256","0","466","1069","0","43.59","19.64"
"67","000","00","320","0039","0000","1877","880","997","14","1891","3861","0","48.98","22.79"
"67","000","00","320","0039","1288","679","305","374","7","686","1363","0","50.33","22.38"
"67","000","00","320","0039","1289","619","286","333","3","622","1219","0","51.03","23.46"
"67","000","00","320","0039","1290","579","289","290","4","583","1279","0","45.58","22.60"
"67","000","00","320","0040","0000","1560","617","943","7","1567","4399","0","35.62","14.03"
"67","000","00","320","0040","1253","558","199","359","4","562","2040","0","27.55","9.75"
"67","000","00","320","0040","1254","585","252","333","3","588","1324","0","44.41","19.03"
"67","000","00","320","0040","1255","417","166","251","0","417","1035","0","40.29","16.04"
"67","000","00","320","0041","0000","2592","1255","1337","13","2605","5808","0","44.85","21.61"
"67","000","00","320","0041","1302","527","253","274","3","530","1097","0","48.31","23.06"
"67","000","00","320","0041","1303","544","261","283","3","547","1301","0","42.04","20.06"
"67","000","00","320","0041","1304","557","258","299","2","559","1279","0","43.71","20.17"
"67","000","00","320","0041","1305","519","281","238","1","520","1169","0","44.48","24.04"
"67","000","00","320","0041","1306","445","202","243","4","449","962","0","46.67","21.00"
"67","000","00","320","0042","0000","1462","572","890","18","1480","3284","0","45.07","17.42"
"67","000","00","320","0042","1333","517","183","334","9","526","1179","0","44.61","15.52"
"67","000","00","320","0042","1334","410","176","234","5","415","1038","0","39.98","16.96"
"67","000","00","320","0042","1335","535","213","322","4","539","1067","0","50.52","19.96"
"67","000","00","320","0043","0000","2111","1086","1025","13","2124","4654","0","45.64","23.33"
"67","000","00","320","0043","1329","563","264","299","4","567","1181","0","48.01","22.35"
"67","000","00","320","0043","1330","540","298","242","5","545","1093","0","49.86","27.26"
"67","000","00","320","0043","1331","512","280","232","2","514","1211","0","42.44","23.12"
"67","000","00","320","0043","1332","496","244","252","2","498","1169","0","42.60","20.87"
"67","000","00","320","0044","0000","1132","556","576","8","1140","2522","0","45.20","22.05"
"67","000","00","320","0044","1346","524","239","285","6","530","1141","0","46.45","20.95"
"67","000","00","320","0044","1347","608","317","291","2","610","1381","0","44.17","22.95"
"67","000","00","320","0045","0000","1960","966","994","18","1978","4275","0","46.27","22.60"
"67","000","00","320","0045","1348","499","228","271","2","501","1104","0","45.38","20.65"
"67","000","00","320","0045","1349","522","232","290","10","532","1079","0","49.30","21.50"
"67","000","00","320","0045","1350","465","264","201","2","467","1067","0","43.77","24.74"
"67","000","00","320","0045","1351","474","242","232","4","478","1025","0","46.63","23.61"
"67","000","00","330","0000","0000","47481","17408","30073","349","47830","108304","123057","44.16","16.07"
"67","000","00","330","0001","0000","824","402","422","6","830","1623","0","51.14","24.77"
"67","000","00","330","0001","1170","382","200","182","3","385","799","0","48.19","25.03"
"67","000","00","330","0001","1171","442","202","240","3","445","824","0","54.00","24.51"
"67","000","00","330","0003","0000","548","280","268","4","552","1383","0","39.91","20.25"
"67","000","00","330","0003","1172","548","280","268","4","552","1383","0","39.91","20.25"
"67","000","00","330","0004","0000","797","352","445","4","801","1753","0","45.69","20.08"
"67","000","00","330","0004","1173","430","217","213","1","431","985","0","43.76","22.03"
"67","000","00","330","0004","1174","367","135","232","3","370","768","0","48.18","17.58"
"67","000","00","330","0005","0000","1074","354","720","14","1088","2226","0","48.88","15.90"
"67","000","00","330","0005","1183","528","168","360","4","532","1117","0","47.63","15.04"
"67","000","00","330","0005","1184","546","186","360","10","556","1109","0","50.14","16.77"
"67","000","00","330","0006","0000","952","382","570","10","962","2173","0","44.27","17.58"
"67","000","00","330","0006","1185","501","184","317","4","505","1199","0","42.12","15.35"
"67","000","00","330","0006","1186","451","198","253","6","457","974","0","46.92","20.33"
"67","000","00","330","0007","0000","1246","469","777","11","1257","2697","0","46.61","17.39"
"67","000","00","330","0007","1178","423","170","253","2","425","884","0","48.08","19.23"
"67","000","00","330","0007","1179","408","145","263","6","414","889","0","46.57","16.31"
"67","000","00","330","0007","1180","415","154","261","3","418","924","0","45.24","16.67"
"67","000","00","330","0008","0000","1377","564","813","7","1384","3096","0","44.70","18.22"
"67","000","00","330","0008","1175","426","160","266","2","428","953","0","44.91","16.79"
"67","000","00","330","0008","1176","544","254","290","3","547","1173","0","46.63","21.65"
"67","000","00","330","0008","1177","407","150","257","2","409","970","0","42.16","15.46"
"67","000","00","330","0009","0000","1240","431","809","5","1245","2875","0","43.30","14.99"
"67","000","00","330","0009","1198","420","137","283","3","423","964","0","43.88","14.21"
"67","000","00","330","0009","1199","411","138","273","2","413","881","0","46.88","15.66"
"67","000","00","330","0009","1200","409","156","253","0","409","1030","0","39.71","15.15"
"67","000","00","330","0011","0000","1769","565","1204","20","1789","4140","0","43.21","13.65"
"67","000","00","330","0011","1205","414","105","309","5","419","945","0","44.34","11.11"
"67","000","00","330","0011","1206","408","164","244","7","415","947","0","43.82","17.32"
"67","000","00","330","0011","1207","493","130","363","5","498","1179","0","42.24","11.03"
"67","000","00","330","0011","1208","454","166","288","3","457","1069","0","42.75","15.53"
"67","000","00","330","0013","0000","1591","551","1040","10","1601","3510","0","45.61","15.70"
"67","000","00","330","0013","1209","467","163","304","1","468","1060","0","44.15","15.38"
"67","000","00","330","0013","1210","500","173","327","3","503","1099","0","45.77","15.74"
"67","000","00","330","0013","1211","624","215","409","6","630","1351","0","46.63","15.91"
"67","000","00","330","0014","0000","903","241","662","6","909","2071","0","43.89","11.64"
"67","000","00","330","0014","1238","476","146","330","3","479","1131","0","42.35","12.91"
"67","000","00","330","0014","1239","427","95","332","3","430","940","0","45.74","10.11"
"67","000","00","330","0015","0000","952","226","726","10","962","2143","0","44.89","10.55"
"67","000","00","330","0015","1235","450","120","330","5","455","1096","0","41.51","10.95"
"67","000","00","330","0015","1236","502","106","396","5","507","1047","0","48.42","10.12"
"67","000","00","330","0016","0000","544","116","428","2","546","1191","0","45.84","9.74"
"67","000","00","330","0016","1237","544","116","428","2","546","1191","0","45.84","9.74"
"67","000","00","330","0017","0000","1477","410","1067","10","1487","3849","0","38.63","10.65"
"67","000","00","330","0017","1240","546","113","433","6","552","1280","0","43.13","8.83"
"67","000","00","330","0017","1241","451","166","285","2","453","1303","0","34.77","12.74"
"67","000","00","330","0017","1242","480","131","349","2","482","1266","0","38.07","10.35"
"67","000","00","330","0018","0000","1097","294","803","11","1108","2639","0","41.99","11.14"
"67","000","00","330","0018","1251","439","91","348","6","445","1067","0","41.71","8.53"
"67","000","00","330","0018","1252","658","203","455","5","663","1572","0","42.18","12.91"
"67","000","00","330","0019","0000","943","282","661","5","948","2169","0","43.71","13.00"
"67","000","00","330","0019","1249","490","169","321","1","491","1137","0","43.18","14.86"
"67","000","00","330","0019","1250","453","113","340","4","457","1032","0","44.28","10.95"
"67","000","00","330","0020","0000","1057","248","809","6","1063","2471","0","43.02","10.04"
"67","000","00","330","0020","1247","523","116","407","2","525","1136","0","46.21","10.21"
"67","000","00","330","0020","1248","534","132","402","4","538","1335","0","40.30","9.89"
"67","000","00","330","0021","0000","1040","536","504","7","1047","2187","0","47.87","24.51"
"67","000","00","330","0021","1161","506","252","254","5","511","1095","0","46.67","23.01"
"67","000","00","330","0021","1162","534","284","250","2","536","1092","0","49.08","26.01"
"67","000","00","330","0022","0000","2017","880","1137","14","2031","4438","0","45.76","19.83"
"67","000","00","330","0022","1163","540","193","347","2","542","1189","0","45.58","16.23"
"67","000","00","330","0022","1164","490","237","253","2","492","997","0","49.35","23.77"
"67","000","00","330","0022","1165","384","188","196","3","387","955","0","40.52","19.69"
"67","000","00","330","0022","1166","603","262","341","7","610","1297","0","47.03","20.20"
"67","000","00","330","0023","0000","1459","666","793","9","1468","3368","0","43.59","19.77"
"67","000","00","330","0023","1158","412","182","230","4","416","904","0","46.02","20.13"
"67","000","00","330","0023","1159","508","223","285","3","511","1245","0","41.04","17.91"
"67","000","00","330","0023","1160","539","261","278","2","541","1219","0","44.38","21.41"
"67","000","00","330","0024","0000","1503","1050","453","17","1520","3347","0","45.41","31.37"
"67","000","00","330","0024","1167","448","300","148","4","452","1065","0","42.44","28.17"
"67","000","00","330","0024","1168","549","416","133","7","556","1127","0","49.33","36.91"
"67","000","00","330","0024","1169","506","334","172","6","512","1155","0","44.33","28.92"
"67","000","00","330","0025","0000","1055","392","663","4","1059","2222","0","47.66","17.64"
"67","000","00","330","0025","1181","568","216","352","2","570","1195","0","47.70","18.08"
"67","000","00","330","0025","1182","487","176","311","2","489","1027","0","47.61","17.14"
"67","000","00","330","0026","0000","1437","418","1019","8","1445","3277","0","44.10","12.76"
"67","000","00","330","0026","1215","720","208","512","6","726","1567","0","46.33","13.27"
"67","000","00","330","0026","1216","717","210","507","2","719","1710","0","42.05","12.28"
"67","000","00","330","0027","0000","1483","563","920","11","1494","3213","0","46.50","17.52"
"67","000","00","330","0027","1187","488","178","310","4","492","1116","0","44.09","15.95"
"67","000","00","330","0027","1188","481","175","306","4","485","1041","0","46.59","16.81"
"67","000","00","330","0027","1189","514","210","304","3","517","1056","0","48.96","19.89"
"67","000","00","330","0028","0000","2124","798","1326","15","2139","4948","0","43.23","16.13"
"67","000","00","330","0028","1194","529","206","323","2","531","1249","0","42.51","16.49"
"67","000","00","330","0028","1195","521","175","346","4","525","1293","0","40.60","13.53"
"67","000","00","330","0028","1196","504","197","307","6","510","1192","0","42.79","16.53"
"67","000","00","330","0028","1197","570","220","350","3","573","1214","0","47.20","18.12"
"67","000","00","330","0029","0000","932","360","572","11","943","2683","0","35.15","13.42"
"67","000","00","330","0029","1223","505","183","322","6","511","1660","0","30.78","11.02"
"67","000","00","330","0029","1224","427","177","250","5","432","1023","0","42.23","17.30"
"67","000","00","330","0030","0000","2369","867","1502","14","2383","5627","0","42.35","15.41"
"67","000","00","330","0030","1227","680","293","387","4","684","1666","0","41.06","17.59"
"67","000","00","330","0030","1228","481","170","311","3","484","1166","0","41.51","14.58"
"67","000","00","330","0030","1229","548","182","366","3","551","1282","0","42.98","14.20"
"67","000","00","330","0030","1230","660","222","438","4","664","1513","0","43.89","14.67"
"67","000","00","330","0031","0000","656","229","427","5","661","1531","0","43.17","14.96"
"67","000","00","330","0031","1231","352","120","232","2","354","903","0","39.20","13.29"
"67","000","00","330","0031","1232","304","109","195","3","307","628","0","48.89","17.36"
"67","000","00","330","0032","0000","2313","754","1559","13","2326","5014","0","46.39","15.04"
"67","000","00","330","0032","1219","573","190","383","6","579","1210","0","47.85","15.70"
"67","000","00","330","0032","1220","522","187","335","1","523","1114","0","46.95","16.79"
"67","000","00","330","0032","1221","573","181","392","2","575","1241","0","46.33","14.59"
"67","000","00","330","0032","1222","645","196","449","4","649","1449","0","44.79","13.53"
"67","000","00","330","0033","0000","1563","577","986","13","1576","3483","0","45.25","16.57"
"67","000","00","330","0033","1217","648","230","418","6","654","1472","0","44.43","15.63"
"67","000","00","330","0033","1218","915","347","568","7","922","2011","0","45.85","17.26"
"67","000","00","330","0034","0000","1930","711","1219","16","1946","4744","0","41.02","14.99"
"67","000","00","330","0034","1212","690","284","406","9","699","1720","0","40.64","16.51"
"67","000","00","330","0034","1213","620","227","393","2","622","1543","0","40.31","14.71"
"67","000","00","330","0034","1214","620","200","420","5","625","1481","0","42.20","13.50"
"67","000","00","330","0035","0000","2279","878","1401","13","2292","4978","0","46.04","17.64"
"67","000","00","330","0035","1190","467","172","295","1","468","1139","0","41.09","15.10"
"67","000","00","330","0035","1191","508","219","289","2","510","1152","0","44.27","19.01"
"67","000","00","330","0035","1192","691","271","420","4","695","1353","0","51.37","20.03"
"67","000","00","330","0035","1193","613","216","397","6","619","1334","0","46.40","16.19"
"67","000","00","330","0036","0000","688","249","439","5","693","1717","0","40.36","14.50"
"67","000","00","330","0036","1233","401","144","257","4","405","952","0","42.54","15.13"
"67","000","00","330","0036","1234","287","105","182","1","288","765","0","37.65","13.73"
"67","000","00","330","0037","0000","813","226","587","10","823","1752","0","46.97","12.90"
"67","000","00","330","0037","1245","501","112","389","7","508","1039","0","48.89","10.78"
"67","000","00","330","0037","1246","312","114","198","3","315","713","0","44.18","15.99"
"67","000","00","330","0038","0000","771","206","565","8","779","1700","0","45.82","12.12"
"67","000","00","330","0038","1243","414","107","307","5","419","963","0","43.51","11.11"
"67","000","00","330","0038","1244","357","99","258","3","360","737","0","48.85","13.43"
"67","000","00","330","0039","0000","980","357","623","6","986","2425","0","40.66","14.72"
"67","000","00","330","0039","1225","469","172","297","3","472","1193","0","39.56","14.42"
"67","000","00","330","0039","1226","511","185","326","3","514","1232","0","41.72","15.02"
"67","000","00","330","0040","0000","1678","524","1154","9","1687","3641","0","46.33","14.39"
"67","000","00","330","0040","1201","399","98","301","4","403","896","0","44.98","10.94"
"67","000","00","330","0040","1202","352","116","236","2","354","807","0","43.87","14.37"
"67","000","00","330","0040","1203","516","147","369","2","518","1025","0","50.54","14.34"
"67","000","00","330","0040","1204","411","163","248","1","412","913","0","45.13","17.85"
"67","000","00","340","0000","0000","48071","20538","27533","373","48444","109685","129057","44.17","18.72"
"67","000","00","340","0001","0000","1446","634","812","12","1458","3350","0","43.52","18.93"
"67","000","00","340","0001","0732","460","234","226","6","466","1150","0","40.52","20.35"
"67","000","00","340","0001","0733","511","201","310","4","515","1097","0","46.95","18.32"
"67","000","00","340","0001","0734","475","199","276","2","477","1103","0","43.25","18.04"
"67","000","00","340","0004","0000","934","508","426","7","941","1911","0","49.24","26.58"
"67","000","00","340","0004","0745","460","288","172","5","465","1003","0","46.36","28.71"
"67","000","00","340","0004","0746","474","220","254","2","476","908","0","52.42","24.23"
"67","000","00","340","0005","0000","1092","548","544","9","1101","2358","0","46.69","23.24"
"67","000","00","340","0005","0741","479","231","248","4","483","1160","0","41.64","19.91"
"67","000","00","340","0005","0742","613","317","296","5","618","1198","0","51.59","26.46"
"67","000","00","340","0007","0000","875","349","526","8","883","1929","0","45.78","18.09"
"67","000","00","340","0007","0750","425","169","256","3","428","931","0","45.97","18.15"
"67","000","00","340","0007","0751","450","180","270","5","455","998","0","45.59","18.04"
"67","000","00","340","0008","0000","1088","533","555","10","1098","2173","0","50.53","24.53"
"67","000","00","340","0008","0752","580","284","296","8","588","1135","0","51.81","25.02"
"67","000","00","340","0008","0753","508","249","259","2","510","1038","0","49.13","23.99"
"67","000","00","340","0018","0000","1682","573","1109","10","1692","4183","0","40.45","13.70"
"67","000","00","340","0018","0822","421","139","282","1","422","1018","0","41.45","13.65"
"67","000","00","340","0018","0823","374","113","261","3","377","1012","0","37.25","11.17"
"67","000","00","340","0018","0824","415","162","253","4","419","985","0","42.54","16.45"
"67","000","00","340","0018","0825","472","159","313","2","474","1168","0","40.58","13.61"
"67","000","00","340","0019","0000","881","445","436","6","887","1829","0","48.50","24.33"
"67","000","00","340","0019","0743","486","253","233","2","488","991","0","49.24","25.53"
"67","000","00","340","0019","0744","395","192","203","4","399","838","0","47.61","22.91"
"67","000","00","340","0020","0000","2203","915","1288","13","2216","4751","0","46.64","19.26"
"67","000","00","340","0020","0797","573","262","311","4","577","1250","0","46.16","20.96"
"67","000","00","340","0020","0798","499","222","277","1","500","1089","0","45.91","20.39"
"67","000","00","340","0020","0799","599","241","358","5","604","1298","0","46.53","18.57"
"67","000","00","340","0020","0800","532","190","342","3","535","1114","0","48.03","17.06"
"67","000","00","340","0023","0000","1381","461","920","14","1395","3128","0","44.60","14.74"
"67","000","00","340","0023","0780","496","181","315","4","500","1110","0","45.05","16.31"
"67","000","00","340","0023","0781","418","128","290","2","420","934","0","44.97","13.70"
"67","000","00","340","0023","0782","467","152","315","8","475","1084","0","43.82","14.02"
"67","000","00","340","0024","0000","1936","714","1222","8","1944","4481","0","43.38","15.93"
"67","000","00","340","0024","0783","688","227","461","2","690","1543","0","44.72","14.71"
"67","000","00","340","0024","0784","672","258","414","4","676","1545","0","43.75","16.70"
"67","000","00","340","0024","0785","576","229","347","2","578","1393","0","41.49","16.44"
"67","000","00","340","0025","0000","1443","560","883","11","1454","3391","0","42.88","16.51"
"67","000","00","340","0025","0811","440","164","276","5","445","1036","0","42.95","15.83"
"67","000","00","340","0025","0812","503","199","304","4","507","1277","0","39.70","15.58"
"67","000","00","340","0025","0813","500","197","303","2","502","1078","0","46.57","18.27"
"67","000","00","340","0026","0000","2372","910","1462","15","2387","5281","0","45.20","17.23"
"67","000","00","340","0026","0817","431","122","309","1","432","877","0","49.26","13.91"
"67","000","00","340","0026","0818","409","144","265","1","410","946","0","43.34","15.22"
"67","000","00","340","0026","0819","425","156","269","4","429","1020","0","42.06","15.29"
"67","000","00","340","0026","0820","505","237","268","1","506","1099","0","46.04","21.57"
"67","000","00","340","0026","0821","602","251","351","8","610","1339","0","45.56","18.75"
"67","000","00","340","0032","0000","653","277","376","8","661","1388","0","47.62","19.96"
"67","000","00","340","0032","0754","653","277","376","8","661","1388","0","47.62","19.96"
"67","000","00","340","0033","0000","816","401","415","9","825","1809","0","45.61","22.17"
"67","000","00","340","0033","0769","404","217","187","5","409","856","0","47.78","25.35"
"67","000","00","340","0033","0770","412","184","228","4","416","953","0","43.65","19.31"
"67","000","00","340","0038","0000","1600","732","868","7","1607","4041","0","39.77","18.11"
"67","000","00","340","0038","0735","622","283","339","2","624","1626","0","38.38","17.40"
"67","000","00","340","0038","0736","403","186","217","1","404","1037","0","38.96","17.94"
"67","000","00","340","0038","0737","575","263","312","4","579","1378","0","42.02","19.09"
"67","000","00","340","0039","0000","1351","587","764","19","1370","3012","0","45.48","19.49"
"67","000","00","340","0039","0755","668","318","350","13","681","1498","0","45.46","21.23"
"67","000","00","340","0039","0756","683","269","414","6","689","1514","0","45.51","17.77"
"67","000","00","340","0040","0000","1905","830","1075","13","1918","4329","0","44.31","19.17"
"67","000","00","340","0040","0793","508","204","304","1","509","1159","0","43.92","17.60"
"67","000","00","340","0040","0794","490","203","287","5","495","1121","0","44.16","18.11"
"67","000","00","340","0040","0795","504","231","273","5","509","1141","0","44.61","20.25"
"67","000","00","340","0040","0796","403","192","211","2","405","908","0","44.60","21.15"
"67","000","00","340","0041","0000","1332","516","816","2","1334","2933","0","45.48","17.59"
"67","000","00","340","0041","0805","473","195","278","0","473","1015","0","46.60","19.21"
"67","000","00","340","0041","0806","431","141","290","0","431","938","0","45.95","15.03"
"67","000","00","340","0041","0807","428","180","248","2","430","980","0","43.88","18.37"
"67","000","00","340","0042","0000","1552","492","1060","9","1561","3603","0","43.33","13.66"
"67","000","00","340","0042","0814","554","171","383","3","557","1249","0","44.60","13.69"
"67","000","00","340","0042","0815","541","184","357","3","544","1179","0","46.14","15.61"
"67","000","00","340","0042","0816","457","137","320","3","460","1175","0","39.15","11.66"
"67","000","00","340","0043","0000","1651","608","1043","8","1659","3566","0","46.52","17.05"
"67","000","00","340","0043","0826","548","200","348","2","550","1149","0","47.87","17.41"
"67","000","00","340","0043","0827","554","235","319","1","555","1268","0","43.77","18.53"
"67","000","00","340","0043","0828","549","173","376","5","554","1149","0","48.22","15.06"
"67","000","00","340","0044","0000","1700","1059","641","27","1727","3781","0","45.68","28.01"
"67","000","00","340","0044","0747","529","266","263","11","540","1193","0","45.26","22.30"
"67","000","00","340","0044","0748","582","446","136","9","591","1336","0","44.24","33.38"
"67","000","00","340","0044","0749","589","347","242","7","596","1252","0","47.60","27.72"
"67","000","00","340","0045","0000","1540","666","874","9","1549","3378","0","45.86","19.72"
"67","000","00","340","0045","0738","575","253","322","2","577","1275","0","45.25","19.84"
"67","000","00","340","0045","0739","483","209","274","4","487","1058","0","46.03","19.75"
"67","000","00","340","0045","0740","482","204","278","3","485","1045","0","46.41","19.52"
"67","000","00","340","0046","0000","2189","971","1218","20","2209","5163","0","42.79","18.81"
"67","000","00","340","0046","0757","389","221","168","3","392","989","0","39.64","22.35"
"67","000","00","340","0046","0758","472","260","212","4","476","1047","0","45.46","24.83"
"67","000","00","340","0046","0759","398","143","255","3","401","942","0","42.57","15.18"
"67","000","00","340","0046","0760","453","171","282","2","455","1038","0","43.83","16.47"
"67","000","00","340","0046","0761","477","176","301","8","485","1147","0","42.28","15.34"
"67","000","00","340","0047","0000","1588","625","963","21","1609","3826","0","42.05","16.34"
"67","000","00","340","0047","0776","377","144","233","9","386","924","0","41.77","15.58"
"67","000","00","340","0047","0777","370","130","240","5","375","831","0","45.13","15.64"
"67","000","00","340","0047","0778","398","174","224","3","401","923","0","43.45","18.85"
"67","000","00","340","0047","0779","443","177","266","4","447","1148","0","38.94","15.42"
"67","000","00","340","0048","0000","2035","1235","800","19","2054","4747","0","43.27","26.02"
"67","000","00","340","0048","0762","545","378","167","8","553","1284","0","43.07","29.44"
"67","000","00","340","0048","0763","441","334","107","4","445","1034","0","43.04","32.30"
"67","000","00","340","0048","0764","541","334","207","2","543","1318","0","41.20","25.34"
"67","000","00","340","0048","0765","508","189","319","5","513","1111","0","46.17","17.01"
"67","000","00","340","0049","0000","1264","535","729","10","1274","2929","0","43.50","18.27"
"67","000","00","340","0049","0766","409","153","256","1","410","966","0","42.44","15.84"
"67","000","00","340","0049","0767","454","197","257","6","460","993","0","46.32","19.84"
"67","000","00","340","0049","0768","401","185","216","3","404","970","0","41.65","19.07"
"67","000","00","340","0050","0000","1129","439","690","6","1135","2655","0","42.75","16.53"
"67","000","00","340","0050","0774","559","200","359","4","563","1250","0","45.04","16.00"
"67","000","00","340","0050","0775","570","239","331","2","572","1405","0","40.71","17.01"
"67","000","00","340","0051","0000","1460","538","922","12","1472","3987","0","36.92","13.49"
"67","000","00","340","0051","0771","536","190","346","4","540","1251","0","43.17","15.19"
"67","000","00","340","0051","0772","503","188","315","5","508","1230","0","41.30","15.28"
"67","000","00","340","0051","0773","421","160","261","3","424","1506","0","28.15","10.62"
"67","000","00","340","0052","0000","1565","648","917","10","1575","3631","0","43.38","17.85"
"67","000","00","340","0052","0786","470","209","261","4","474","1081","0","43.85","19.33"
"67","000","00","340","0052","0787","673","283","390","4","677","1560","0","43.40","18.14"
"67","000","00","340","0052","0788","422","156","266","2","424","990","0","42.83","15.76"
"67","000","00","340","0053","0000","1954","855","1099","12","1966","4418","0","44.50","19.35"
"67","000","00","340","0053","0789","434","209","225","3","437","980","0","44.59","21.33"
"67","000","00","340","0053","0790","481","203","278","2","483","1137","0","42.48","17.85"
"67","000","00","340","0053","0791","507","213","294","5","512","1102","0","46.46","19.33"
"67","000","00","340","0053","0792","532","230","302","2","534","1199","0","44.54","19.18"
"67","000","00","340","0054","0000","1117","387","730","3","1120","2467","0","45.40","15.69"
"67","000","00","340","0054","0801","559","207","352","0","559","1343","0","41.62","15.41"
"67","000","00","340","0054","0802","558","180","378","3","561","1124","0","49.91","16.01"
"67","000","00","340","0055","0000","1017","461","556","7","1024","2258","0","45.35","20.42"
"67","000","00","340","0055","0803","481","231","250","4","485","1060","0","45.75","21.79"
"67","000","00","340","0055","0804","536","230","306","3","539","1198","0","44.99","19.20"
"67","000","00","340","0056","0000","1320","526","794","19","1339","2999","0","44.65","17.54"
"67","000","00","340","0056","0808","483","207","276","10","493","1033","0","47.73","20.04"
"67","000","00","340","0056","0809","396","171","225","8","404","936","0","43.16","18.27"
"67","000","00","340","0056","0810","441","148","293","1","442","1030","0","42.91","14.37"
"67","000","00","350","0000","0000","63641","21398","42243","468","64109","163001","196238","39.33","13.13"
"67","000","00","350","0001","0000","1136","420","716","8","1144","2798","0","40.89","15.01"
"67","000","00","350","0001","0591","548","195","353","6","554","1403","0","39.49","13.90"
"67","000","00","350","0001","0592","588","225","363","2","590","1395","0","42.29","16.13"
"67","000","00","350","0002","0000","1902","683","1219","24","1926","4730","0","40.72","14.44"
"67","000","00","350","0002","0605","447","156","291","11","458","1194","0","38.36","13.07"
"67","000","00","350","0002","0606","463","164","299","6","469","1181","0","39.71","13.89"
"67","000","00","350","0002","0607","525","175","350","4","529","1185","0","44.64","14.77"
"67","000","00","350","0002","0608","467","188","279","3","470","1170","0","40.17","16.07"
"67","000","00","350","0003","0000","1800","614","1186","10","1810","4668","0","38.77","13.15"
"67","000","00","350","0003","0593","452","173","279","4","456","1080","0","42.22","16.02"
"67","000","00","350","0003","0594","506","161","345","2","508","1247","0","40.74","12.91"
"67","000","00","350","0003","0595","408","121","287","1","409","1167","0","35.05","10.37"
"67","000","00","350","0003","0596","434","159","275","3","437","1174","0","37.22","13.54"
"67","000","00","350","0004","0000","1973","677","1296","18","1991","5017","0","39.69","13.49"
"67","000","00","350","0004","0597","491","173","318","2","493","1196","0","41.22","14.46"
"67","000","00","350","0004","0598","553","165","388","5","558","1371","0","40.70","12.04"
"67","000","00","350","0004","0599","508","194","314","8","516","1310","0","39.39","14.81"
"67","000","00","350","0004","0600","421","145","276","3","424","1140","0","37.19","12.72"
"67","000","00","350","0005","0000","1815","620","1195","11","1826","4446","0","41.07","13.95"
"67","000","00","350","0005","0601","463","160","303","5","468","1206","0","38.81","13.27"
"67","000","00","350","0005","0602","441","154","287","3","444","1100","0","40.36","14.00"
"67","000","00","350","0005","0603","476","138","338","1","477","1137","0","41.95","12.14"
"67","000","00","350","0005","0604","435","168","267","2","437","1003","0","43.57","16.75"
"67","000","00","350","0006","0000","1183","385","798","6","1189","2762","0","43.05","13.94"
"67","000","00","350","0006","0634","612","221","391","2","614","1454","0","42.23","15.20"
"67","000","00","350","0006","0635","571","164","407","4","575","1308","0","43.96","12.54"
"67","000","00","350","0007","0000","1439","485","954","13","1452","3488","0","41.63","13.90"
"67","000","00","350","0007","0627","505","146","359","5","510","1159","0","44.00","12.60"
"67","000","00","350","0007","0628","466","148","318","6","472","1197","0","39.43","12.36"
"67","000","00","350","0007","0629","468","191","277","2","470","1132","0","41.52","16.87"
"67","000","00","350","0008","0000","1872","584","1288","16","1888","4518","0","41.79","12.93"
"67","000","00","350","0008","0614","424","158","266","3","427","1187","0","35.97","13.31"
"67","000","00","350","0008","0615","455","154","301","1","456","1057","0","43.14","14.57"
"67","000","00","350","0008","0616","491","93","398","6","497","1141","0","43.56","8.15"
"67","000","00","350","0008","0617","502","179","323","6","508","1133","0","44.84","15.80"
"67","000","00","350","0009","0000","2501","1023","1478","19","2520","6006","0","41.96","17.03"
"67","000","00","350","0009","0618","530","162","368","2","532","1198","0","44.41","13.52"
"67","000","00","350","0009","0619","496","178","318","4","500","1327","0","37.68","13.41"
"67","000","00","350","0009","0620","504","339","165","6","510","1258","0","40.54","26.95"
"67","000","00","350","0009","0621","497","179","318","4","501","1103","0","45.42","16.23"
"67","000","00","350","0009","0622","474","165","309","3","477","1120","0","42.59","14.73"
"67","000","00","350","0010","0000","2500","906","1594","13","2513","6119","0","41.07","14.81"
"67","000","00","350","0010","0609","457","172","285","4","461","1230","0","37.48","13.98"
"67","000","00","350","0010","0610","574","194","380","4","578","1421","0","40.68","13.65"
"67","000","00","350","0010","0611","559","221","338","2","561","1297","0","43.25","17.04"
"67","000","00","350","0010","0612","439","138","301","1","440","1090","0","40.37","12.66"
"67","000","00","350","0010","0613","471","181","290","2","473","1081","0","43.76","16.74"
"67","000","00","350","0011","0000","867","310","557","5","872","2171","0","40.17","14.28"
"67","000","00","350","0011","0654","492","176","316","3","495","1193","0","41.49","14.75"
"67","000","00","350","0011","0655","375","134","241","2","377","978","0","38.55","13.70"
"67","000","00","350","0012","0000","740","218","522","5","745","1811","0","41.14","12.04"
"67","000","00","350","0012","0662","374","96","278","2","376","938","0","40.09","10.23"
"67","000","00","350","0012","0663","366","122","244","3","369","873","0","42.27","13.97"
"67","000","00","350","0013","0000","1835","580","1255","12","1847","4706","0","39.25","12.32"
"67","000","00","350","0013","0656","498","151","347","2","500","1373","0","36.42","11.00"
"67","000","00","350","0013","0657","410","123","287","5","415","1040","0","39.90","11.83"
"67","000","00","350","0013","0658","453","151","302","1","454","1106","0","41.05","13.65"
"67","000","00","350","0013","0659","474","155","319","4","478","1187","0","40.27","13.06"
"67","000","00","350","0014","0000","461","129","332","1","462","1148","0","40.24","11.24"
"67","000","00","350","0014","0660","461","129","332","1","462","1148","0","40.24","11.24"
"67","000","00","350","0015","0000","2006","593","1413","5","2011","5528","0","36.38","10.73"
"67","000","00","350","0015","0647","410","122","288","0","410","1307","0","31.37","9.33"
"67","000","00","350","0015","0648","536","152","384","1","537","1446","0","37.14","10.51"
"67","000","00","350","0015","0649","520","155","365","3","523","1356","0","38.57","11.43"
"67","000","00","350","0015","0650","540","164","376","1","541","1419","0","38.13","11.56"
"67","000","00","350","0016","0000","1094","377","717","3","1097","2803","0","39.14","13.45"
"67","000","00","350","0016","0677","608","213","395","3","611","1502","0","40.68","14.18"
"67","000","00","350","0016","0678","486","164","322","0","486","1301","0","37.36","12.61"
"67","000","00","350","0017","0000","1004","315","689","6","1010","2365","0","42.71","13.32"
"67","000","00","350","0017","0712","540","160","380","1","541","1290","0","41.94","12.40"
"67","000","00","350","0017","0713","464","155","309","5","469","1075","0","43.63","14.42"
"67","000","00","350","0018","0000","2675","952","1723","22","2697","7823","0","34.48","12.17"
"67","000","00","350","0018","0679","487","169","318","5","492","1371","0","35.89","12.33"
"67","000","00","350","0018","0680","490","172","318","2","492","1272","0","38.68","13.52"
"67","000","00","350","0018","0681","453","153","300","5","458","1270","0","36.06","12.05"
"67","000","00","350","0018","0682","438","144","294","4","442","1342","0","32.94","10.73"
"67","000","00","350","0018","0683","527","209","318","4","531","1323","0","40.14","15.80"
"67","000","00","350","0018","0684","280","105","175","2","282","1245","0","22.65","8.43"
"67","000","00","350","0019","0000","648","281","367","11","659","1587","0","41.52","17.71"
"67","000","00","350","0019","0730","287","117","170","6","293","796","0","36.81","14.70"
"67","000","00","350","0019","0731","361","164","197","5","366","791","0","46.27","20.73"
"67","000","00","350","0020","0000","1716","726","990","15","1731","4730","0","36.60","15.35"
"67","000","00","350","0020","0685","416","297","119","6","422","1260","0","33.49","23.57"
"67","000","00","350","0020","0686","395","99","296","2","397","1105","0","35.93","8.96"
"67","000","00","350","0020","0687","446","152","294","3","449","1135","0","39.56","13.39"
"67","000","00","350","0020","0688","459","178","281","4","463","1230","0","37.64","14.47"
"67","000","00","350","0021","0000","1145","377","768","13","1158","3591","0","32.25","10.50"
"67","000","00","350","0021","0674","420","134","286","5","425","1329","0","31.98","10.08"
"67","000","00","350","0021","0675","393","133","260","4","397","1283","0","30.94","10.37"
"67","000","00","350","0021","0676","332","110","222","4","336","979","0","34.32","11.24"
"67","000","00","350","0022","0000","1197","388","809","6","1203","3358","0","35.82","11.55"
"67","000","00","350","0022","0669","342","87","255","0","342","1040","0","32.88","8.37"
"67","000","00","350","0022","0670","367","117","250","4","371","1026","0","36.16","11.40"
"67","000","00","350","0022","0671","488","184","304","2","490","1292","0","37.93","14.24"
"67","000","00","350","0023","0000","718","236","482","3","721","2107","0","34.22","11.20"
"67","000","00","350","0023","0672","307","106","201","1","308","991","0","31.08","10.70"
"67","000","00","350","0023","0673","411","130","281","2","413","1116","0","37.01","11.65"
"67","000","00","350","0024","0000","447","152","295","3","450","1031","0","43.65","14.74"
"67","000","00","350","0024","0668","447","152","295","3","450","1031","0","43.65","14.74"
"67","000","00","350","0025","0000","647","167","480","6","653","1831","0","35.66","9.12"
"67","000","00","350","0025","0664","349","102","247","3","352","866","0","40.65","11.78"
"67","000","00","350","0025","0665","298","65","233","3","301","965","0","31.19","6.74"
"67","000","00","350","0026","0000","794","240","554","9","803","2484","0","32.33","9.66"
"67","000","00","350","0026","0666","371","130","241","2","373","1240","0","30.08","10.48"
"67","000","00","350","0026","0667","423","110","313","7","430","1244","0","34.57","8.84"
"67","000","00","350","0027","0000","526","198","328","3","529","1572","0","33.65","12.60"
"67","000","00","350","0027","0714","280","104","176","2","282","812","0","34.73","12.81"
"67","000","00","350","0027","0715","246","94","152","1","247","760","0","32.50","12.37"
"67","000","00","350","0028","0000","589","165","424","7","596","1569","0","37.99","10.52"
"67","000","00","350","0028","0721","346","90","256","2","348","905","0","38.45","9.94"
"67","000","00","350","0028","0722","243","75","168","5","248","664","0","37.35","11.30"
"67","000","00","350","0029","0000","401","142","259","4","405","1050","0","38.57","13.52"
"67","000","00","350","0029","0723","401","142","259","4","405","1050","0","38.57","13.52"
"67","000","00","350","0030","0000","1136","345","791","15","1151","3209","0","35.87","10.75"
"67","000","00","350","0030","0716","334","75","259","3","337","845","0","39.88","8.88"
"67","000","00","350","0030","0717","329","115","214","5","334","1010","0","33.07","11.39"
"67","000","00","350","0030","0718","473","155","318","7","480","1354","0","35.45","11.45"
"67","000","00","350","0031","0000","510","133","377","1","511","1442","0","35.44","9.22"
"67","000","00","350","0031","0720","510","133","377","1","511","1442","0","35.44","9.22"
"67","000","00","350","0032","0000","454","132","322","2","456","1507","0","30.26","8.76"
"67","000","00","350","0032","0719","454","132","322","2","456","1507","0","30.26","8.76"
"67","000","00","350","0033","0000","503","144","359","9","512","1292","0","39.63","11.15"
"67","000","00","350","0033","0724","234","56","178","6","240","597","0","40.20","9.38"
"67","000","00","350","0033","0725","269","88","181","3","272","695","0","39.14","12.66"
"67","000","00","350","0035","0000","279","112","167","6","285","888","0","32.09","12.61"
"67","000","00","350","0035","0727","279","112","167","6","285","888","0","32.09","12.61"
"67","000","00","350","0036","0000","740","266","474","3","743","1882","0","39.48","14.13"
"67","000","00","350","0036","0728","410","167","243","1","411","1021","0","40.25","16.36"
"67","000","00","350","0036","0729","330","99","231","2","332","861","0","38.56","11.50"
"67","000","00","350","0037","0000","893","277","616","5","898","2122","0","42.32","13.05"
"67","000","00","350","0037","0625","461","148","313","2","463","1145","0","40.44","12.93"
"67","000","00","350","0037","0626","432","129","303","3","435","977","0","44.52","13.20"
"67","000","00","350","0038","0000","1213","430","783","11","1224","2749","0","44.53","15.64"
"67","000","00","350","0038","0623","639","183","456","5","644","1394","0","46.20","13.13"
"67","000","00","350","0038","0624","574","247","327","6","580","1355","0","42.80","18.23"
"67","000","00","350","0039","0000","1883","683","1200","13","1896","4392","0","43.17","15.55"
"67","000","00","350","0039","0630","470","157","313","6","476","1089","0","43.71","14.42"
"67","000","00","350","0039","0631","511","189","322","3","514","1177","0","43.67","16.06"
"67","000","00","350","0039","0632","443","147","296","2","445","1073","0","41.47","13.70"
"67","000","00","350","0039","0633","459","190","269","2","461","1053","0","43.78","18.04"
"67","000","00","350","0040","0000","1241","362","879","8","1249","3015","0","41.43","12.01"
"67","000","00","350","0040","0692","433","135","298","3","436","1013","0","43.04","13.33"
"67","000","00","350","0040","0693","416","112","304","4","420","1038","0","40.46","10.79"
"67","000","00","350","0040","0694","392","115","277","1","393","964","0","40.77","11.93"
"67","000","00","350","0041","0000","1798","534","1264","13","1811","4278","0","42.33","12.48"
"67","000","00","350","0041","0695","590","163","427","5","595","1351","0","44.04","12.07"
"67","000","00","350","0041","0696","581","175","406","3","584","1418","0","41.18","12.34"
"67","000","00","350","0041","0697","627","196","431","5","632","1509","0","41.88","12.99"
"67","000","00","350","0042","0000","1560","446","1114","12","1572","3596","0","43.72","12.40"
"67","000","00","350","0042","0709","505","158","347","5","510","1151","0","44.31","13.73"
"67","000","00","350","0042","0710","522","155","367","2","524","1217","0","43.06","12.74"
"67","000","00","350","0042","0711","533","133","400","5","538","1228","0","43.81","10.83"
"67","000","00","350","0043","0000","1660","607","1053","10","1670","4402","0","37.94","13.79"
"67","000","00","350","0043","0636","625","240","385","5","630","1551","0","40.62","15.47"
"67","000","00","350","0043","0637","527","193","334","4","531","1483","0","35.81","13.01"
"67","000","00","350","0043","0638","508","174","334","1","509","1368","0","37.21","12.72"
"67","000","00","350","0044","0000","1614","557","1057","16","1630","4025","0","40.50","13.84"
"67","000","00","350","0044","0639","418","152","266","3","421","1057","0","39.83","14.38"
"67","000","00","350","0044","0640","476","158","318","2","478","1061","0","45.05","14.89"
"67","000","00","350","0044","0641","303","97","206","5","308","944","0","32.63","10.28"
"67","000","00","350","0044","0642","417","150","267","6","423","963","0","43.93","15.58"
"67","000","00","350","0045","0000","1913","564","1349","7","1920","4467","0","42.98","12.63"
"67","000","00","350","0045","0643","416","112","304","1","417","1115","0","37.40","10.04"
"67","000","00","350","0045","0644","483","140","343","0","483","1098","0","43.99","12.75"
"67","000","00","350","0045","0645","551","164","387","3","554","1253","0","44.21","13.09"
"67","000","00","350","0045","0646","463","148","315","3","466","1001","0","46.55","14.79"
"67","000","00","350","0046","0000","1623","605","1018","10","1633","3943","0","41.42","15.34"
"67","000","00","350","0046","0700","441","153","288","4","445","980","0","45.41","15.61"
"67","000","00","350","0046","0701","393","148","245","2","395","1034","0","38.20","14.31"
"67","000","00","350","0046","0702","407","161","246","3","410","999","0","41.04","16.12"
"67","000","00","350","0046","0703","382","143","239","1","383","930","0","41.18","15.38"
"67","000","00","350","0047","0000","1258","395","863","11","1269","3321","0","38.21","11.89"
"67","000","00","350","0047","0689","379","138","241","5","384","974","0","39.43","14.17"
"67","000","00","350","0047","0690","468","145","323","3","471","1227","0","38.39","11.82"
"67","000","00","350","0047","0691","411","112","299","3","414","1120","0","36.96","10.00"
"67","000","00","350","0048","0000","579","202","377","4","583","1480","0","39.39","13.65"
"67","000","00","350","0048","0661","579","202","377","4","583","1480","0","39.39","13.65"
"67","000","00","350","0049","0000","1145","365","780","11","1156","2718","0","42.53","13.43"
"67","000","00","350","0049","0698","482","136","346","4","486","1182","0","41.12","11.51"
"67","000","00","350","0049","0699","663","229","434","7","670","1536","0","43.62","14.91"
"67","000","00","350","0050","0000","2071","640","1431","12","2083","5393","0","38.62","11.87"
"67","000","00","350","0050","0704","351","79","272","3","354","1006","0","35.19","7.85"
"67","000","00","350","0050","0705","466","146","320","3","469","1235","0","37.98","11.82"
"67","000","00","350","0050","0706","450","166","284","4","454","1138","0","39.89","14.59"
"67","000","00","350","0050","0707","389","119","270","0","389","1094","0","35.56","10.88"
"67","000","00","350","0050","0708","415","130","285","2","417","920","0","45.33","14.13"
"67","000","00","350","0051","0000","1455","465","990","8","1463","3607","0","40.56","12.89"
"67","000","00","350","0051","0651","425","168","257","3","428","1076","0","39.78","15.61"
"67","000","00","350","0051","0652","501","154","347","3","504","1217","0","41.41","12.65"
"67","000","00","350","0051","0653","529","143","386","2","531","1314","0","40.41","10.88"
"67","000","00","350","0052","0000","482","191","291","4","486","1456","0","33.38","13.12"
"67","000","00","350","0052","0726","482","191","291","4","486","1456","0","33.38","13.12"
"67","000","00","360","0000","0000","23034","9476","13558","140","23174","56716","67297","40.86","16.71"
"67","000","00","360","0002","0000","824","366","458","5","829","2012","0","41.20","18.19"
"67","000","00","360","0002","1099","323","127","196","3","326","895","0","36.42","14.19"
"67","000","00","360","0002","1100","501","239","262","2","503","1117","0","45.03","21.40"
"67","000","00","360","0004","0000","197","61","136","3","200","435","0","45.98","14.02"
"67","000","00","360","0004","1091","197","61","136","3","200","435","0","45.98","14.02"
"67","000","00","360","0005","0000","2098","849","1249","11","2109","5116","0","41.22","16.59"
"67","000","00","360","0005","1061","480","218","262","1","481","1243","0","38.70","17.54"
"67","000","00","360","0005","1062","515","203","312","3","518","1165","0","44.46","17.42"
"67","000","00","360","0005","1063","529","196","333","5","534","1312","0","40.70","14.94"
"67","000","00","360","0005","1064","574","232","342","2","576","1396","0","41.26","16.62"
"67","000","00","360","0006","0000","1677","708","969","12","1689","4196","0","40.25","16.87"
"67","000","00","360","0006","1065","563","248","315","5","568","1458","0","38.96","17.01"
"67","000","00","360","0006","1066","554","215","339","0","554","1385","0","40.00","15.52"
"67","000","00","360","0006","1067","560","245","315","7","567","1353","0","41.91","18.11"
"67","000","00","360","0007","0000","2015","844","1171","12","2027","4827","0","41.99","17.48"
"67","000","00","360","0007","1068","533","230","303","4","537","1199","0","44.79","19.18"
"67","000","00","360","0007","1069","460","182","278","3","463","1233","0","37.55","14.76"
"67","000","00","360","0007","1070","500","222","278","0","500","1210","0","41.32","18.35"
"67","000","00","360","0007","1071","522","210","312","5","527","1185","0","44.47","17.72"
"67","000","00","360","0008","0000","2711","1147","1564","20","2731","7232","0","37.76","15.86"
"67","000","00","360","0008","1072","485","206","279","5","490","1482","0","33.06","13.90"
"67","000","00","360","0008","1073","573","249","324","4","577","1402","0","41.16","17.76"
"67","000","00","360","0008","1074","475","196","279","4","479","1393","0","34.39","14.07"
"67","000","00","360","0008","1075","566","225","341","3","569","1476","0","38.55","15.24"
"67","000","00","360","0008","1076","612","271","341","4","616","1479","0","41.65","18.32"
"67","000","00","360","0009","0000","2250","976","1274","20","2270","5000","0","45.40","19.52"
"67","000","00","360","0009","1057","523","210","313","4","527","1130","0","46.64","18.58"
"67","000","00","360","0009","1058","508","217","291","4","512","1153","0","44.41","18.82"
"67","000","00","360","0009","1059","584","256","328","5","589","1353","0","43.53","18.92"
"67","000","00","360","0009","1060","635","293","342","7","642","1364","0","47.07","21.48"
"67","000","00","360","0010","0000","3060","1290","1770","18","3078","7593","0","40.54","16.99"
"67","000","00","360","0010","1085","605","228","377","4","609","1345","0","45.28","16.95"
"67","000","00","360","0010","1086","566","258","308","1","567","1244","0","45.58","20.74"
"67","000","00","360","0010","1087","506","238","268","3","509","1252","0","40.65","19.01"
"67","000","00","360","0010","1088","554","254","300","5","559","1307","0","42.77","19.43"
"67","000","00","360","0010","1089","452","179","273","4","456","1202","0","37.94","14.89"
"67","000","00","360","0010","1090","377","133","244","1","378","1243","0","30.41","10.70"
"67","000","00","360","0011","0000","2971","1346","1625","12","2983","7951","0","37.52","16.93"
"67","000","00","360","0011","1079","481","194","287","4","485","1364","0","35.56","14.22"
"67","000","00","360","0011","1080","539","256","283","1","540","1300","0","41.54","19.69"
"67","000","00","360","0011","1081","508","245","263","0","508","1333","0","38.11","18.38"
"67","000","00","360","0011","1082","461","213","248","3","464","1286","0","36.08","16.56"
"67","000","00","360","0011","1083","528","227","301","0","528","1379","0","38.29","16.46"
"67","000","00","360","0011","1084","454","211","243","4","458","1289","0","35.53","16.37"
"67","000","00","360","0012","0000","1309","518","791","7","1316","3031","0","43.42","17.09"
"67","000","00","360","0012","1077","654","266","388","5","659","1510","0","43.64","17.62"
"67","000","00","360","0012","1078","655","252","403","2","657","1521","0","43.20","16.57"
"67","000","00","360","0015","0000","1452","519","933","6","1458","3301","0","44.17","15.72"
"67","000","00","360","0015","1092","759","289","470","4","763","1666","0","45.80","17.35"
"67","000","00","360","0015","1093","693","230","463","2","695","1635","0","42.51","14.07"
"67","000","00","360","0016","0000","1387","480","907","8","1395","3261","0","42.78","14.72"
"67","000","00","360","0016","1094","488","202","286","3","491","1105","0","44.43","18.28"
"67","000","00","360","0016","1095","432","149","283","3","435","1093","0","39.80","13.63"
"67","000","00","360","0016","1096","467","129","338","2","469","1063","0","44.12","12.14"
"67","000","00","360","0017","0000","1083","372","711","6","1089","2761","0","39.44","13.47"
"67","000","00","360","0017","1097","557","201","356","4","561","1383","0","40.56","14.53"
"67","000","00","360","0017","1098","526","171","355","2","528","1378","0","38.32","12.41"
"67","000","00","370","0000","0000","28893","11174","17719","216","29109","64466","78163","45.15","17.33"
"67","000","00","370","0005","0000","1658","577","1081","11","1669","3653","0","45.69","15.80"
"67","000","00","370","0005","1101","541","187","354","4","545","1290","0","42.25","14.50"
"67","000","00","370","0005","1102","596","220","376","4","600","1182","0","50.76","18.61"
"67","000","00","370","0005","1103","521","170","351","3","524","1181","0","44.37","14.39"
"67","000","00","370","0007","0000","1331","571","760","6","1337","3036","0","44.04","18.81"
"67","000","00","370","0007","1104","675","307","368","3","678","1552","0","43.69","19.78"
"67","000","00","370","0007","1105","656","264","392","3","659","1484","0","44.41","17.79"
"67","000","00","370","0009","0000","1235","553","682","12","1247","2678","0","46.56","20.65"
"67","000","00","370","0009","1106","597","244","353","8","605","1315","0","46.01","18.56"
"67","000","00","370","0009","1107","638","309","329","4","642","1363","0","47.10","22.67"
"67","000","00","370","0011","0000","1001","348","653","9","1010","2406","0","41.98","14.46"
"67","000","00","370","0011","1108","507","171","336","7","514","1251","0","41.09","13.67"
"67","000","00","370","0011","1109","494","177","317","2","496","1155","0","42.94","15.32"
"67","000","00","370","0016","0000","1135","457","678","9","1144","2516","0","45.47","18.16"
"67","000","00","370","0016","1110","575","241","334","7","582","1280","0","45.47","18.83"
"67","000","00","370","0016","1111","560","216","344","2","562","1236","0","45.47","17.48"
"67","000","00","370","0022","0000","1470","517","953","12","1482","3287","0","45.09","15.73"
"67","000","00","370","0022","1112","330","124","206","3","333","762","0","43.70","16.27"
"67","000","00","370","0022","1113","422","120","302","3","425","936","0","45.41","12.82"
"67","000","00","370","0022","1114","368","137","231","5","373","797","0","46.80","17.19"
"67","000","00","370","0022","1115","350","136","214","1","351","792","0","44.32","17.17"
"67","000","00","370","0025","0000","1620","574","1046","13","1633","3479","0","46.94","16.50"
"67","000","00","370","0025","1116","463","151","312","6","469","1026","0","45.71","14.72"
"67","000","00","370","0025","1117","541","190","351","4","545","1149","0","47.43","16.54"
"67","000","00","370","0025","1118","616","233","383","3","619","1304","0","47.47","17.87"
"67","000","00","370","0031","0000","1123","472","651","10","1133","2515","0","45.05","18.77"
"67","000","00","370","0031","1119","570","229","341","4","574","1289","0","44.53","17.77"
"67","000","00","370","0031","1120","553","243","310","6","559","1226","0","45.60","19.82"
"67","000","00","370","0033","0000","2631","1140","1491","23","2654","5665","0","46.85","20.12"
"67","000","00","370","0033","1121","712","321","391","6","718","1410","0","50.92","22.77"
"67","000","00","370","0033","1122","649","254","395","6","655","1394","0","46.99","18.22"
"67","000","00","370","0033","1123","690","333","357","7","697","1615","0","43.16","20.62"
"67","000","00","370","0033","1124","580","232","348","4","584","1246","0","46.87","18.62"
"67","000","00","370","0034","0000","2333","957","1376","12","2345","4932","0","47.55","19.40"
"67","000","00","370","0034","1125","624","251","373","2","626","1306","0","47.93","19.22"
"67","000","00","370","0034","1126","570","236","334","5","575","1190","0","48.32","19.83"
"67","000","00","370","0034","1127","555","214","341","2","557","1193","0","46.69","17.94"
"67","000","00","370","0034","1128","584","256","328","3","587","1243","0","47.22","20.60"
"67","000","00","370","0039","0000","1651","589","1062","10","1661","3667","0","45.30","16.06"
"67","000","00","370","0039","1129","363","144","219","4","367","870","0","42.18","16.55"
"67","000","00","370","0039","1130","398","117","281","4","402","863","0","46.58","13.56"
"67","000","00","370","0039","1131","453","186","267","0","453","1038","0","43.64","17.92"
"67","000","00","370","0039","1132","437","142","295","2","439","896","0","49.00","15.85"
"67","000","00","370","0040","0000","1371","483","888","6","1377","3143","0","43.81","15.37"
"67","000","00","370","0040","1133","480","170","310","2","482","1100","0","43.82","15.45"
"67","000","00","370","0040","1134","484","170","314","1","485","1073","0","45.20","15.84"
"67","000","00","370","0040","1135","407","143","264","3","410","970","0","42.27","14.74"
"67","000","00","370","0041","0000","1182","542","640","5","1187","2478","0","47.90","21.87"
"67","000","00","370","0041","1136","597","312","285","5","602","1252","0","48.08","24.92"
"67","000","00","370","0041","1137","585","230","355","0","585","1226","0","47.72","18.76"
"67","000","00","370","0042","0000","1347","577","770","8","1355","3070","0","44.14","18.79"
"67","000","00","370","0042","1138","481","224","257","1","482","1116","0","43.19","20.07"
"67","000","00","370","0042","1139","475","204","271","3","478","1067","0","44.80","19.12"
"67","000","00","370","0042","1140","391","149","242","4","395","887","0","44.53","16.80"
"67","000","00","370","0043","0000","874","327","547","6","880","1972","0","44.62","16.58"
"67","000","00","370","0043","1141","437","148","289","0","437","1061","0","41.19","13.95"
"67","000","00","370","0043","1142","437","179","258","6","443","911","0","48.63","19.65"
"67","000","00","370","0044","0000","1567","512","1055","19","1586","3846","0","41.24","13.31"
"67","000","00","370","0044","1143","482","169","313","4","486","1403","0","34.64","12.05"
"67","000","00","370","0044","1144","517","151","366","8","525","1199","0","43.79","12.59"
"67","000","00","370","0044","1145","568","192","376","7","575","1244","0","46.22","15.43"
"67","000","00","370","0045","0000","1064","396","668","9","1073","2485","0","43.18","15.94"
"67","000","00","370","0045","1146","565","184","381","2","567","1274","0","44.51","14.44"
"67","000","00","370","0045","1147","499","212","287","7","506","1211","0","41.78","17.51"
"67","000","00","370","0046","0000","826","288","538","9","835","1878","0","44.46","15.34"
"67","000","00","370","0046","1148","438","132","306","4","442","982","0","45.01","13.44"
"67","000","00","370","0046","1149","388","156","232","5","393","896","0","43.86","17.41"
"67","000","00","370","0047","0000","1700","582","1118","12","1712","3913","0","43.75","14.87"
"67","000","00","370","0047","1150","488","174","314","1","489","1072","0","45.62","16.23"
"67","000","00","370","0047","1151","409","132","277","2","411","855","0","48.07","15.44"
"67","000","00","370","0047","1152","413","143","270","2","415","1021","0","40.65","14.01"
"67","000","00","370","0047","1153","390","133","257","7","397","965","0","41.14","13.78"
"67","000","00","370","0048","0000","1774","712","1062","15","1789","3847","0","46.50","18.51"
"67","000","00","370","0048","1154","396","119","277","4","400","887","0","45.10","13.42"
"67","000","00","370","0048","1155","545","210","335","4","549","1144","0","47.99","18.36"
"67","000","00","370","0048","1156","475","219","256","4","479","1001","0","47.85","21.88"
"67","000","00","370","0048","1157","358","164","194","3","361","815","0","44.29","20.12"
"64","000","00","000","0000","0000","986840","398161","588679","7700","994540","2353773","2755491","42.25","16.92"
"64","000","00","010","0000","0000","9914","3679","6235","84","9998","20951","23272","47.72","17.56"
"64","000","00","010","0001","0000","626","209","417","7","633","1261","0","50.20","16.57"
"64","000","00","010","0001","1297","626","209","417","7","633","1261","0","50.20","16.57"
"64","000","00","010","0002","0000","156","52","104","0","156","321","0","48.60","16.20"
"64","000","00","010","0002","1298","156","52","104","0","156","321","0","48.60","16.20"
"64","000","00","010","0003","0000","326","113","213","5","331","626","0","52.88","18.05"
"64","000","00","010","0003","1299","326","113","213","5","331","626","0","52.88","18.05"
"64","000","00","010","0004","0000","538","242","296","8","546","1222","0","44.68","19.80"
"64","000","00","010","0004","1300","538","242","296","8","546","1222","0","44.68","19.80"
"64","000","00","010","0005","0000","601","258","343","2","603","1240","0","48.63","20.81"
"64","000","00","010","0005","1301","601","258","343","2","603","1240","0","48.63","20.81"
"64","000","00","010","0006","0000","925","368","557","11","936","1941","0","48.22","18.96"
"64","000","00","010","0006","1302","410","168","242","3","413","830","0","49.76","20.24"
"64","000","00","010","0006","1303","515","200","315","8","523","1111","0","47.07","18.00"
"64","000","00","010","0007","0000","415","175","240","1","416","805","0","51.68","21.74"
"64","000","00","010","0007","1304","415","175","240","1","416","805","0","51.68","21.74"
"64","000","00","010","0008","0000","301","97","204","1","302","569","0","53.08","17.05"
"64","000","00","010","0008","1305","301","97","204","1","302","569","0","53.08","17.05"
"64","000","00","010","0009","0000","578","193","385","7","585","1394","0","41.97","13.85"
"64","000","00","010","0009","1306","578","193","385","7","585","1394","0","41.97","13.85"
"64","000","00","010","0010","0000","360","137","223","3","363","733","0","49.52","18.69"
"64","000","00","010","0010","1307","360","137","223","3","363","733","0","49.52","18.69"
"64","000","00","010","0011","0000","783","294","489","8","791","1581","0","50.03","18.60"
"64","000","00","010","0011","1308","369","134","235","6","375","801","0","46.82","16.73"
"64","000","00","010","0011","1309","414","160","254","2","416","780","0","53.33","20.51"
"64","000","00","010","0012","0000","332","109","223","2","334","721","0","46.32","15.12"
"64","000","00","010","0012","1310","332","109","223","2","334","721","0","46.32","15.12"
"64","000","00","010","0013","0000","421","158","263","5","426","935","0","45.56","16.90"
"64","000","00","010","0013","1311","421","158","263","5","426","935","0","45.56","16.90"
"64","000","00","010","0014","0000","500","179","321","4","504","1042","0","48.37","17.18"
"64","000","00","010","0014","1312","500","179","321","4","504","1042","0","48.37","17.18"
"64","000","00","010","0015","0000","490","171","319","0","490","1023","0","47.90","16.72"
"64","000","00","010","0015","1313","490","171","319","0","490","1023","0","47.90","16.72"
"64","000","00","010","0016","0000","376","155","221","5","381","775","0","49.16","20.00"
"64","000","00","010","0016","1314","376","155","221","5","381","775","0","49.16","20.00"
"64","000","00","010","0017","0000","862","333","529","6","868","1989","0","43.64","16.74"
"64","000","00","010","0017","1315","477","191","286","1","478","1046","0","45.70","18.26"
"64","000","00","010","0017","1316","385","142","243","5","390","943","0","41.36","15.06"
"64","000","00","010","0018","0000","514","181","333","1","515","1114","0","46.23","16.25"
"64","000","00","010","0018","1317","514","181","333","1","515","1114","0","46.23","16.25"
"64","000","00","010","0019","0000","278","92","186","1","279","547","0","51.01","16.82"
"64","000","00","010","0019","1318","278","92","186","1","279","547","0","51.01","16.82"
"64","000","00","010","0020","0000","270","107","163","5","275","543","0","50.64","19.71"
"64","000","00","010","0020","1319","270","107","163","5","275","543","0","50.64","19.71"
"64","000","00","010","0021","0000","262","56","206","2","264","569","0","46.40","9.84"
"64","000","00","010","0021","1320","262","56","206","2","264","569","0","46.40","9.84"
"64","000","00","020","0000","0000","50739","22465","28274","308","51047","116097","141101","43.97","19.35"
"64","000","00","020","0001","0000","846","471","375","5","851","1923","0","44.25","24.49"
"64","000","00","020","0001","1214","421","238","183","1","422","953","0","44.28","24.97"
"64","000","00","020","0001","1215","425","233","192","4","429","970","0","44.23","24.02"
"64","000","00","020","0002","0000","826","542","284","5","831","1924","0","43.19","28.17"
"64","000","00","020","0002","1216","363","257","106","3","366","881","0","41.54","29.17"
"64","000","00","020","0002","1217","463","285","178","2","465","1043","0","44.58","27.33"
"64","000","00","020","0003","0000","1947","985","962","15","1962","4040","0","48.56","24.38"
"64","000","00","020","0003","1218","711","293","418","4","715","1453","0","49.21","20.17"
"64","000","00","020","0003","1219","655","353","302","7","662","1382","0","47.90","25.54"
"64","000","00","020","0003","1220","581","339","242","4","585","1205","0","48.55","28.13"
"64","000","00","020","0004","0000","1561","478","1083","7","1568","3318","0","47.26","14.41"
"64","000","00","020","0004","1221","471","144","327","4","475","1026","0","46.30","14.04"
"64","000","00","020","0004","1222","530","163","367","1","531","1149","0","46.21","14.19"
"64","000","00","020","0004","1223","560","171","389","2","562","1143","0","49.17","14.96"
"64","000","00","020","0005","0000","637","239","398","7","644","1257","0","51.23","19.01"
"64","000","00","020","0005","1224","637","239","398","7","644","1257","0","51.23","19.01"
"64","000","00","020","0006","0000","486","154","332","2","488","1072","0","45.52","14.37"
"64","000","00","020","0006","1225","486","154","332","2","488","1072","0","45.52","14.37"
"64","000","00","020","0007","0000","1080","447","633","9","1089","2405","0","45.28","18.59"
"64","000","00","020","0007","1226","544","221","323","5","549","1167","0","47.04","18.94"
"64","000","00","020","0007","1227","536","226","310","4","540","1238","0","43.62","18.26"
"64","000","00","020","0008","0000","1554","607","947","8","1562","3652","0","42.77","16.62"
"64","000","00","020","0008","1228","557","237","320","1","558","1259","0","44.32","18.82"
"64","000","00","020","0008","1229","448","135","313","5","453","1194","0","37.94","11.31"
"64","000","00","020","0008","1230","549","235","314","2","551","1199","0","45.95","19.60"
"64","000","00","020","0009","0000","374","345","29","1","375","703","0","53.34","49.08"
"64","000","00","020","0009","1231","374","345","29","1","375","703","0","53.34","49.08"
"64","000","00","020","0010","0000","518","202","316","3","521","1210","0","43.06","16.69"
"64","000","00","020","0010","1232","518","202","316","3","521","1210","0","43.06","16.69"
"64","000","00","020","0011","0000","858","267","591","6","864","1928","0","44.81","13.85"
"64","000","00","020","0011","1233","858","267","591","6","864","1928","0","44.81","13.85"
"64","000","00","020","0012","0000","1604","531","1073","7","1611","3346","0","48.15","15.87"
"64","000","00","020","0012","1234","796","246","550","4","800","1689","0","47.37","14.56"
"64","000","00","020","0012","1235","808","285","523","3","811","1657","0","48.94","17.20"
"64","000","00","020","0013","0000","1209","421","788","11","1220","2539","0","48.05","16.58"
"64","000","00","020","0013","1236","604","196","408","8","612","1243","0","49.24","15.77"
"64","000","00","020","0013","1237","605","225","380","3","608","1296","0","46.91","17.36"
"64","000","00","020","0014","0000","1356","471","885","10","1366","2970","0","45.99","15.86"
"64","000","00","020","0014","1238","576","212","364","4","580","1219","0","47.58","17.39"
"64","000","00","020","0014","1239","780","259","521","6","786","1751","0","44.89","14.79"
"64","000","00","020","0015","0000","6592","3030","3562","48","6640","15526","0","42.77","19.52"
"64","000","00","020","0015","1240","647","350","297","3","650","1435","0","45.30","24.39"
"64","000","00","020","0015","1241","649","262","387","5","654","1489","0","43.92","17.60"
"64","000","00","020","0015","1242","675","252","423","7","682","1517","0","44.96","16.61"
"64","000","00","020","0015","1243","664","320","344","6","670","1608","0","41.67","19.90"
"64","000","00","020","0015","1244","661","311","350","2","663","1581","0","41.94","19.67"
"64","000","00","020","0015","1245","627","336","291","7","634","1613","0","39.31","20.83"
"64","000","00","020","0015","1246","639","319","320","1","640","1582","0","40.46","20.16"
"64","000","00","020","0015","1247","705","292","413","5","710","1553","0","45.72","18.80"
"64","000","00","020","0015","1248","706","305","401","4","710","1620","0","43.83","18.83"
"64","000","00","020","0015","1249","619","283","336","8","627","1528","0","41.03","18.52"
"64","000","00","020","0016","0000","9796","4602","5194","37","9833","22850","0","43.03","20.14"
"64","000","00","020","0016","1250","671","294","377","1","672","1607","0","41.82","18.29"
"64","000","00","020","0016","1251","755","356","399","2","757","1869","0","40.50","19.05"
"64","000","00","020","0016","1252","880","449","431","1","881","2030","0","43.40","22.12"
"64","000","00","020","0016","1253","705","366","339","2","707","1661","0","42.56","22.03"
"64","000","00","020","0016","1254","767","320","447","5","772","1840","0","41.96","17.39"
"64","000","00","020","0016","1255","799","374","425","3","802","1856","0","43.21","20.15"
"64","000","00","020","0016","1256","723","330","393","3","726","1683","0","43.14","19.61"
"64","000","00","020","0016","1257","743","401","342","1","744","1710","0","43.51","23.45"
"64","000","00","020","0016","1258","830","386","444","1","831","1799","0","46.19","21.46"
"64","000","00","020","0016","1259","802","337","465","4","806","1880","0","42.87","17.93"
"64","000","00","020","0016","1260","723","338","385","7","730","1623","0","44.98","20.83"
"64","000","00","020","0016","1261","699","315","384","4","703","1642","0","42.81","19.18"
"64","000","00","020","0016","1262","699","336","363","3","702","1650","0","42.55","20.36"
"64","000","00","020","0017","0000","6795","3453","3342","28","6823","16357","0","41.71","21.11"
"64","000","00","020","0017","1263","650","340","310","0","650","1658","0","39.20","20.51"
"64","000","00","020","0017","1264","719","344","375","1","720","1699","0","42.38","20.25"
"64","000","00","020","0017","1265","655","358","297","2","657","1621","0","40.53","22.09"
"64","000","00","020","0017","1266","684","345","339","6","690","1733","0","39.82","19.91"
"64","000","00","020","0017","1267","694","347","347","2","696","1643","0","42.36","21.12"
"64","000","00","020","0017","1268","694","289","405","4","698","1562","0","44.69","18.50"
"64","000","00","020","0017","1269","675","330","345","3","678","1672","0","40.55","19.74"
"64","000","00","020","0017","1270","696","364","332","3","699","1574","0","44.41","23.13"
"64","000","00","020","0017","1271","675","397","278","5","680","1590","0","42.77","24.97"
"64","000","00","020","0017","1272","653","339","314","2","655","1605","0","40.81","21.12"
"64","000","00","020","0018","0000","1645","826","819","11","1656","3836","0","43.17","21.53"
"64","000","00","020","0018","1273","768","385","383","6","774","1830","0","42.30","21.04"
"64","000","00","020","0018","1274","877","441","436","5","882","2006","0","43.97","21.98"
"64","000","00","020","0019","0000","1426","750","676","9","1435","3144","0","45.64","23.85"
"64","000","00","020","0019","1275","699","402","297","5","704","1540","0","45.71","26.10"
"64","000","00","020","0019","1276","727","348","379","4","731","1604","0","45.57","21.70"
"64","000","00","020","0020","0000","1145","700","445","6","1151","2453","0","46.92","28.54"
"64","000","00","020","0020","1277","510","296","214","3","513","1102","0","46.55","26.86"
"64","000","00","020","0020","1278","635","404","231","3","638","1351","0","47.22","29.90"
"64","000","00","020","0021","0000","473","152","321","9","482","1125","0","42.84","13.51"
"64","000","00","020","0021","1279","473","152","321","9","482","1125","0","42.84","13.51"
"64","000","00","020","0022","0000","567","171","396","2","569","1113","0","51.12","15.36"
"64","000","00","020","0022","1280","567","171","396","2","569","1113","0","51.12","15.36"
"64","000","00","020","0023","0000","519","186","333","5","524","1920","0","27.29","9.69"
"64","000","00","020","0023","1281","519","186","333","5","524","1920","0","27.29","9.69"
"64","000","00","020","0024","0000","559","205","354","6","565","1241","0","45.53","16.52"
"64","000","00","020","0024","1282","559","205","354","6","565","1241","0","45.53","16.52"
"64","000","00","020","0025","0000","533","207","326","2","535","1207","0","44.32","17.15"
"64","000","00","020","0025","1283","533","207","326","2","535","1207","0","44.32","17.15"
"64","000","00","020","0026","0000","608","276","332","2","610","1306","0","46.71","21.13"
"64","000","00","020","0026","1284","608","276","332","2","610","1306","0","46.71","21.13"
"64","000","00","020","0027","0000","559","227","332","3","562","1301","0","43.20","17.45"
"64","000","00","020","0027","1285","559","227","332","3","562","1301","0","43.20","17.45"
"64","000","00","020","0028","0000","614","214","400","6","620","1361","0","45.55","15.72"
"64","000","00","020","0028","1286","614","214","400","6","620","1361","0","45.55","15.72"
"64","000","00","020","0029","0000","256","99","157","2","258","605","0","42.64","16.36"
"64","000","00","020","0029","1287","256","99","157","2","258","605","0","42.64","16.36"
"64","000","00","020","0030","0000","356","110","246","2","358","778","0","46.02","14.14"
"64","000","00","020","0030","1288","356","110","246","2","358","778","0","46.02","14.14"
"64","000","00","020","0031","0000","420","137","283","4","424","928","0","45.69","14.76"
"64","000","00","020","0031","1289","420","137","283","4","424","928","0","45.69","14.76"
"64","000","00","020","0032","0000","419","111","308","4","423","955","0","44.29","11.62"
"64","000","00","020","0032","1290","419","111","308","4","423","955","0","44.29","11.62"
"64","000","00","020","0033","0000","363","105","258","3","366","715","0","51.19","14.69"
"64","000","00","020","0033","1291","363","105","258","3","366","715","0","51.19","14.69"
"64","000","00","020","0034","0000","577","202","375","4","581","1190","0","48.82","16.97"
"64","000","00","020","0034","1292","577","202","375","4","581","1190","0","48.82","16.97"
"64","000","00","020","0035","0000","472","135","337","5","477","1102","0","43.28","12.25"
"64","000","00","020","0035","1293","472","135","337","5","477","1102","0","43.28","12.25"
"64","000","00","020","0036","0000","528","149","379","4","532","1307","0","40.70","11.40"
"64","000","00","020","0036","1294","528","149","379","4","532","1307","0","40.70","11.40"
"64","000","00","020","0037","0000","428","176","252","4","432","963","0","44.86","18.28"
"64","000","00","020","0037","1295","428","176","252","4","432","963","0","44.86","18.28"
"64","000","00","020","0038","0000","233","82","151","6","239","527","0","45.35","15.56"
"64","000","00","020","0038","1296","233","82","151","6","239","527","0","45.35","15.56"
"64","000","00","030","0000","0000","69552","34242","35310","505","70057","164087","196916","42.70","20.87"
"64","000","00","030","0001","0000","647","310","337","6","653","2636","0","24.77","11.76"
"64","000","00","030","0001","0651","242","126","116","3","245","1669","0","14.68","7.55"
"64","000","00","030","0001","0652","405","184","221","3","408","967","0","42.19","19.03"
"64","000","00","030","0002","0000","474","148","326","7","481","973","0","49.43","15.21"
"64","000","00","030","0002","0653","474","148","326","7","481","973","0","49.43","15.21"
"64","000","00","030","0003","0000","273","96","177","1","274","512","0","53.52","18.75"
"64","000","00","030","0003","0654","273","96","177","1","274","512","0","53.52","18.75"
"64","000","00","030","0004","0000","296","65","231","8","304","603","0","50.41","10.78"
"64","000","00","030","0004","0655","296","65","231","8","304","603","0","50.41","10.78"
"64","000","00","030","0005","0000","245","69","176","0","245","496","0","49.40","13.91"
"64","000","00","030","0005","0656","245","69","176","0","245","496","0","49.40","13.91"
"64","000","00","030","0006","0000","408","92","316","4","412","799","0","51.56","11.51"
"64","000","00","030","0006","0657","408","92","316","4","412","799","0","51.56","11.51"
"64","000","00","030","0007","0000","402","100","302","6","408","839","0","48.63","11.92"
"64","000","00","030","0007","0658","402","100","302","6","408","839","0","48.63","11.92"
"64","000","00","030","0008","0000","326","83","243","2","328","705","0","46.52","11.77"
"64","000","00","030","0008","0659","326","83","243","2","328","705","0","46.52","11.77"
"64","000","00","030","0009","0000","1402","532","870","12","1414","3265","0","43.31","16.29"
"64","000","00","030","0009","0660","648","243","405","4","652","1515","0","43.04","16.04"
"64","000","00","030","0009","0661","754","289","465","8","762","1750","0","43.54","16.51"
"64","000","00","030","0011","0000","637","435","202","15","652","1512","0","43.12","28.77"
"64","000","00","030","0011","0662","637","435","202","15","652","1512","0","43.12","28.77"
"64","000","00","030","0012","0000","148","113","35","0","148","331","0","44.71","34.14"
"64","000","00","030","0012","0663","148","113","35","0","148","331","0","44.71","34.14"
"64","000","00","030","0013","0000","189","129","60","2","191","600","0","31.83","21.50"
"64","000","00","030","0013","0664","189","129","60","2","191","600","0","31.83","21.50"
"64","000","00","030","0015","0000","732","440","292","3","735","1687","0","43.57","26.08"
"64","000","00","030","0015","0665","732","440","292","3","735","1687","0","43.57","26.08"
"64","000","00","030","0016","0000","1033","529","504","5","1038","2403","0","43.20","22.01"
"64","000","00","030","0016","0666","494","275","219","3","497","1166","0","42.62","23.58"
"64","000","00","030","0016","0667","539","254","285","2","541","1237","0","43.73","20.53"
"64","000","00","030","0017","0000","1242","1114","128","12","1254","2489","0","50.38","44.76"
"64","000","00","030","0017","0668","644","579","65","7","651","1259","0","51.71","45.99"
"64","000","00","030","0017","0669","598","535","63","5","603","1230","0","49.02","43.50"
"64","000","00","030","0019","0000","289","196","93","2","291","611","0","47.63","32.08"
"64","000","00","030","0019","0670","289","196","93","2","291","611","0","47.63","32.08"
"64","000","00","030","0021","0000","447","104","343","3","450","907","0","49.61","11.47"
"64","000","00","030","0021","0671","447","104","343","3","450","907","0","49.61","11.47"
"64","000","00","030","0022","0000","366","101","265","2","368","711","0","51.76","14.21"
"64","000","00","030","0022","0672","366","101","265","2","368","711","0","51.76","14.21"
"64","000","00","030","0023","0000","156","43","113","0","156","329","0","47.42","13.07"
"64","000","00","030","0023","0673","156","43","113","0","156","329","0","47.42","13.07"
"64","000","00","030","0024","0000","253","79","174","2","255","522","0","48.85","15.13"
"64","000","00","030","0024","0674","253","79","174","2","255","522","0","48.85","15.13"
"64","000","00","030","0025","0000","241","64","177","2","243","491","0","49.49","13.03"
"64","000","00","030","0025","0675","241","64","177","2","243","491","0","49.49","13.03"
"64","000","00","030","0026","0000","367","112","255","2","369","690","0","53.48","16.23"
"64","000","00","030","0026","0676","367","112","255","2","369","690","0","53.48","16.23"
"64","000","00","030","0027","0000","194","38","156","3","197","391","0","50.38","9.72"
"64","000","00","030","0027","0677","194","38","156","3","197","391","0","50.38","9.72"
"64","000","00","030","0028","0000","295","96","199","1","296","575","0","51.48","16.70"
"64","000","00","030","0028","0678","295","96","199","1","296","575","0","51.48","16.70"
"64","000","00","030","0029","0000","405","167","238","1","406","842","0","48.22","19.83"
"64","000","00","030","0029","0679","405","167","238","1","406","842","0","48.22","19.83"
"64","000","00","030","0030","0000","557","343","214","11","568","1260","0","45.08","27.22"
"64","000","00","030","0030","0680","557","343","214","11","568","1260","0","45.08","27.22"
"64","000","00","030","0031","0000","414","159","255","5","419","920","0","45.54","17.28"
"64","000","00","030","0031","0681","414","159","255","5","419","920","0","45.54","17.28"
"64","000","00","030","0032","0000","2708","2210","498","35","2743","5561","0","49.33","39.74"
"64","000","00","030","0032","0682","703","547","156","6","709","1439","0","49.27","38.01"
"64","000","00","030","0032","0683","509","404","105","9","518","1129","0","45.88","35.78"
"64","000","00","030","0032","0684","377","314","63","5","382","794","0","48.11","39.55"
"64","000","00","030","0032","0685","498","421","77","6","504","969","0","52.01","43.45"
"64","000","00","030","0032","0686","621","524","97","9","630","1230","0","51.22","42.60"
"64","000","00","030","0034","0000","1347","813","534","10","1357","3147","0","43.12","25.83"
"64","000","00","030","0034","0687","730","446","284","2","732","1564","0","46.80","28.52"
"64","000","00","030","0034","0688","617","367","250","8","625","1583","0","39.48","23.18"
"64","000","00","030","0035","0000","366","211","155","1","367","907","0","40.46","23.26"
"64","000","00","030","0035","0689","366","211","155","1","367","907","0","40.46","23.26"
"64","000","00","030","0036","0000","1268","995","273","6","1274","2680","0","47.54","37.13"
"64","000","00","030","0036","0690","728","621","107","4","732","1460","0","50.14","42.53"
"64","000","00","030","0036","0691","540","374","166","2","542","1220","0","44.43","30.66"
"64","000","00","030","0037","0000","691","529","162","10","701","1445","0","48.51","36.61"
"64","000","00","030","0037","0692","691","529","162","10","701","1445","0","48.51","36.61"
"64","000","00","030","0038","0000","663","523","140","6","669","1540","0","43.44","33.96"
"64","000","00","030","0038","0693","663","523","140","6","669","1540","0","43.44","33.96"
"64","000","00","030","0039","0000","5906","2938","2968","42","5948","13601","0","43.73","21.60"
"64","000","00","030","0039","0694","633","295","338","5","638","1476","0","43.22","19.99"
"64","000","00","030","0039","0695","725","346","379","5","730","1538","0","47.46","22.50"
"64","000","00","030","0039","0696","612","334","278","4","616","1363","0","45.19","24.50"
"64","000","00","030","0039","0697","626","302","324","6","632","1529","0","41.33","19.75"
"64","000","00","030","0039","0698","635","327","308","3","638","1512","0","42.20","21.63"
"64","000","00","030","0039","0699","624","320","304","3","627","1518","0","41.30","21.08"
"64","000","00","030","0039","0700","708","323","385","6","714","1562","0","45.71","20.68"
"64","000","00","030","0039","0701","675","365","310","4","679","1535","0","44.23","23.78"
"64","000","00","030","0039","0702","668","326","342","6","674","1568","0","42.98","20.79"
"64","000","00","030","0040","0000","10893","4757","6136","84","10977","25163","0","43.62","18.90"
"64","000","00","030","0040","0703","746","317","429","2","748","1524","0","49.08","20.80"
"64","000","00","030","0040","0704","765","277","488","11","776","1588","0","48.87","17.44"
"64","000","00","030","0040","0705","724","272","452","7","731","1556","0","46.98","17.48"
"64","000","00","030","0040","0706","694","269","425","3","697","1623","0","42.95","16.57"
"64","000","00","030","0040","0707","594","286","308","3","597","1468","0","40.67","19.48"
"64","000","00","030","0040","0708","627","336","291","4","631","1641","0","38.45","20.48"
"64","000","00","030","0040","0709","643","267","376","4","647","1563","0","41.39","17.08"
"64","000","00","030","0040","0710","755","330","425","2","757","1639","0","46.19","20.13"
"64","000","00","030","0040","0711","730","325","405","6","736","1605","0","45.86","20.25"
"64","000","00","030","0040","0712","707","343","364","9","716","1682","0","42.57","20.39"
"64","000","00","030","0040","0713","642","297","345","6","648","1536","0","42.19","19.34"
"64","000","00","030","0040","0714","739","306","433","7","746","1631","0","45.74","18.76"
"64","000","00","030","0040","0715","679","294","385","11","690","1674","0","41.22","17.56"
"64","000","00","030","0040","0716","616","267","349","4","620","1524","0","40.68","17.52"
"64","000","00","030","0040","0717","661","294","367","4","665","1610","0","41.30","18.26"
"64","000","00","030","0040","0718","571","277","294","1","572","1299","0","44.03","21.32"
"64","000","00","030","0041","0000","2180","666","1514","17","2197","4725","0","46.50","14.10"
"64","000","00","030","0041","0719","708","242","466","6","714","1646","0","43.38","14.70"
"64","000","00","030","0041","0720","736","190","546","4","740","1464","0","50.55","12.98"
"64","000","00","030","0041","0721","736","234","502","7","743","1615","0","46.01","14.49"
"64","000","00","030","0042","0000","5754","2672","3082","32","5786","13461","0","42.98","19.85"
"64","000","00","030","0042","0722","606","232","374","7","613","1299","0","47.19","17.86"
"64","000","00","030","0042","0723","682","288","394","3","685","1574","0","43.52","18.30"
"64","000","00","030","0042","0724","585","276","309","2","587","1453","0","40.40","19.00"
"64","000","00","030","0042","0725","645","291","354","4","649","1518","0","42.75","19.17"
"64","000","00","030","0042","0726","651","299","352","5","656","1452","0","45.18","20.59"
"64","000","00","030","0042","0727","734","350","384","5","739","1681","0","43.96","20.82"
"64","000","00","030","0042","0728","635","304","331","0","635","1514","0","41.94","20.08"
"64","000","00","030","0042","0729","578","270","308","4","582","1521","0","38.26","17.75"
"64","000","00","030","0042","0730","638","362","276","2","640","1449","0","44.17","24.98"
"64","000","00","030","0043","0000","11559","5385","6174","72","11631","28382","0","40.98","18.97"
"64","000","00","030","0043","0731","626","281","345","2","628","1523","0","41.23","18.45"
"64","000","00","030","0043","0732","627","279","348","3","630","1529","0","41.20","18.25"
"64","000","00","030","0043","0733","671","289","382","4","675","1588","0","42.51","18.20"
"64","000","00","030","0043","0734","605","214","391","7","612","1466","0","41.75","14.60"
"64","000","00","030","0043","0735","557","227","330","1","558","1463","0","38.14","15.52"
"64","000","00","030","0043","0736","588","274","314","3","591","1450","0","40.76","18.90"
"64","000","00","030","0043","0737","634","308","326","5","639","1603","0","39.86","19.21"
"64","000","00","030","0043","0738","583","249","334","5","588","1516","0","38.79","16.42"
"64","000","00","030","0043","0739","614","282","332","4","618","1505","0","41.06","18.74"
"64","000","00","030","0043","0740","663","319","344","2","665","1533","0","43.38","20.81"
"64","000","00","030","0043","0741","619","318","301","4","623","1429","0","43.60","22.25"
"64","000","00","030","0043","0742","682","336","346","3","685","1661","0","41.24","20.23"
"64","000","00","030","0043","0743","738","361","377","4","742","1778","0","41.73","20.30"
"64","000","00","030","0043","0744","710","337","373","5","715","1674","0","42.71","20.13"
"64","000","00","030","0043","0745","627","296","331","8","635","1721","0","36.90","17.20"
"64","000","00","030","0043","0746","678","345","333","2","680","1739","0","39.10","19.84"
"64","000","00","030","0043","0747","636","278","358","3","639","1566","0","40.80","17.75"
"64","000","00","030","0043","0748","701","392","309","7","708","1638","0","43.22","23.93"
"64","000","00","030","0044","0000","13779","6786","6993","73","13852","35376","0","39.16","19.18"
"64","000","00","030","0044","0749","590","306","284","5","595","1546","0","38.49","19.79"
"64","000","00","030","0044","0750","597","296","301","3","600","1625","0","36.92","18.22"
"64","000","00","030","0044","0751","582","299","283","1","583","1626","0","35.85","18.39"
"64","000","00","030","0044","0752","596","303","293","1","597","1538","0","38.82","19.70"
"64","000","00","030","0044","0753","689","392","297","5","694","1671","0","41.53","23.46"
"64","000","00","030","0044","0754","683","332","351","4","687","1654","0","41.54","20.07"
"64","000","00","030","0044","0755","599","285","314","3","602","1634","0","36.84","17.44"
"64","000","00","030","0044","0756","667","351","316","3","670","1604","0","41.77","21.88"
"64","000","00","030","0044","0757","584","269","315","1","585","1493","0","39.18","18.02"
"64","000","00","030","0044","0758","637","264","373","4","641","1613","0","39.74","16.37"
"64","000","00","030","0044","0759","613","305","308","5","618","1628","0","37.96","18.73"
"64","000","00","030","0044","0760","596","255","341","1","597","1627","0","36.69","15.67"
"64","000","00","030","0044","0761","551","284","267","7","558","1584","0","35.23","17.93"
"64","000","00","030","0044","0762","697","363","334","7","704","1732","0","40.65","20.96"
"64","000","00","030","0044","0763","633","296","337","3","636","1709","0","37.21","17.32"
"64","000","00","030","0044","0764","686","326","360","1","687","1777","0","38.66","18.35"
"64","000","00","030","0044","0765","679","329","350","4","683","1685","0","40.53","19.53"
"64","000","00","030","0044","0766","661","281","380","3","664","1605","0","41.37","17.51"
"64","000","00","030","0044","0767","541","262","279","0","541","1434","0","37.73","18.27"
"64","000","00","030","0044","0768","703","315","388","2","705","1634","0","43.15","19.28"
"64","000","00","030","0044","0769","608","355","253","6","614","1450","0","42.34","24.48"
"64","000","00","030","0044","0770","587","318","269","4","591","1507","0","39.22","21.10"
"64","000","00","040","0000","0000","64594","27530","37064","444","65038","156746","189931","41.49","17.56"
"64","000","00","040","0001","0000","8668","3422","5246","61","8729","21636","0","40.34","15.82"
"64","000","00","040","0001","0523","441","163","278","0","441","1036","0","42.57","15.73"
"64","000","00","040","0001","0524","477","165","312","5","482","1027","0","46.93","16.07"
"64","000","00","040","0001","0525","547","187","360","4","551","1244","0","44.29","15.03"
"64","000","00","040","0001","0526","468","203","265","3","471","1336","0","35.25","15.19"
"64","000","00","040","0001","0527","625","217","408","6","631","1425","0","44.28","15.23"
"64","000","00","040","0001","0528","548","221","327","2","550","1503","0","36.59","14.70"
"64","000","00","040","0001","0529","529","215","314","7","536","1292","0","41.49","16.64"
"64","000","00","040","0001","0530","497","188","309","4","501","1250","0","40.08","15.04"
"64","000","00","040","0001","0531","504","236","268","6","510","1235","0","41.30","19.11"
"64","000","00","040","0001","0532","579","227","352","5","584","1375","0","42.47","16.51"
"64","000","00","040","0001","0533","611","263","348","2","613","1418","0","43.23","18.55"
"64","000","00","040","0001","0534","491","218","273","2","493","1340","0","36.79","16.27"
"64","000","00","040","0001","0535","720","275","445","5","725","1707","0","42.47","16.11"
"64","000","00","040","0001","0536","507","197","310","3","510","1390","0","36.69","14.17"
"64","000","00","040","0001","0537","542","221","321","3","545","1437","0","37.93","15.38"
"64","000","00","040","0001","0538","582","226","356","4","586","1621","0","36.15","13.94"
"64","000","00","040","0002","0000","1755","705","1050","9","1764","4264","0","41.37","16.53"
"64","000","00","040","0002","0539","579","243","336","1","580","1373","0","42.24","17.70"
"64","000","00","040","0002","0540","552","182","370","4","556","1416","0","39.27","12.85"
"64","000","00","040","0002","0541","624","280","344","4","628","1475","0","42.58","18.98"
"64","000","00","040","0003","0000","2365","850","1515","12","2377","6356","0","37.40","13.37"
"64","000","00","040","0003","0542","543","202","341","5","548","1389","0","39.45","14.54"
"64","000","00","040","0003","0543","489","173","316","2","491","1229","0","39.95","14.08"
"64","000","00","040","0003","0544","472","154","318","2","474","1308","0","36.24","11.77"
"64","000","00","040","0003","0545","443","166","277","0","443","1245","0","35.58","13.33"
"64","000","00","040","0003","0546","418","155","263","3","421","1185","0","35.53","13.08"
"64","000","00","040","0004","0000","1272","451","821","3","1275","3150","0","40.48","14.32"
"64","000","00","040","0004","0547","432","132","300","2","434","1008","0","43.06","13.10"
"64","000","00","040","0004","0548","425","157","268","1","426","1075","0","39.63","14.60"
"64","000","00","040","0004","0549","415","162","253","0","415","1067","0","38.89","15.18"
"64","000","00","040","0005","0000","1330","417","913","14","1344","3252","0","41.33","12.82"
"64","000","00","040","0005","0553","656","214","442","9","665","1642","0","40.50","13.03"
"64","000","00","040","0005","0554","674","203","471","5","679","1610","0","42.17","12.61"
"64","000","00","040","0006","0000","1046","387","659","4","1050","3163","0","33.20","12.24"
"64","000","00","040","0006","0550","294","77","217","2","296","1231","0","24.05","6.26"
"64","000","00","040","0006","0551","396","159","237","1","397","977","0","40.63","16.27"
"64","000","00","040","0006","0552","356","151","205","1","357","955","0","37.38","15.81"
"64","000","00","040","0007","0000","1732","683","1049","18","1750","3884","0","45.06","17.58"
"64","000","00","040","0007","0555","605","220","385","4","609","1266","0","48.10","17.38"
"64","000","00","040","0007","0556","579","267","312","6","585","1323","0","44.22","20.18"
"64","000","00","040","0007","0557","548","196","352","8","556","1295","0","42.93","15.14"
"64","000","00","040","0008","0000","2013","1015","998","20","2033","4669","0","43.54","21.74"
"64","000","00","040","0008","0558","471","214","257","7","478","1153","0","41.46","18.56"
"64","000","00","040","0008","0559","487","241","246","4","491","1123","0","43.72","21.46"
"64","000","00","040","0008","0560","466","244","222","4","470","1088","0","43.20","22.43"
"64","000","00","040","0008","0561","589","316","273","5","594","1305","0","45.52","24.21"
"64","000","00","040","0009","0000","1356","342","1014","11","1367","2830","0","48.30","12.08"
"64","000","00","040","0009","0562","382","130","252","6","388","825","0","47.03","15.76"
"64","000","00","040","0009","0563","416","89","327","4","420","851","0","49.35","10.46"
"64","000","00","040","0009","0564","558","123","435","1","559","1154","0","48.44","10.66"
"64","000","00","040","0010","0000","1020","229","791","12","1032","2059","0","50.12","11.12"
"64","000","00","040","0010","0565","461","92","369","8","469","918","0","51.09","10.02"
"64","000","00","040","0010","0566","559","137","422","4","563","1141","0","49.34","12.01"
"64","000","00","040","0011","0000","1668","478","1190","17","1685","3828","0","44.02","12.49"
"64","000","00","040","0011","0567","526","143","383","3","529","1164","0","45.45","12.29"
"64","000","00","040","0011","0568","633","211","422","7","640","1566","0","40.87","13.47"
"64","000","00","040","0011","0569","509","124","385","7","516","1098","0","46.99","11.29"
"64","000","00","040","0012","0000","719","149","570","5","724","1375","0","52.65","10.84"
"64","000","00","040","0012","0570","719","149","570","5","724","1375","0","52.65","10.84"
"64","000","00","040","0013","0000","1396","528","868","14","1410","3487","0","40.44","15.14"
"64","000","00","040","0013","0571","442","153","289","3","445","1061","0","41.94","14.42"
"64","000","00","040","0013","0572","514","187","327","9","523","1268","0","41.25","14.75"
"64","000","00","040","0013","0573","440","188","252","2","442","1158","0","38.17","16.23"
"64","000","00","040","0014","0000","6101","3138","2963","33","6134","16189","0","37.89","19.38"
"64","000","00","040","0014","0574","571","293","278","3","574","1565","0","36.68","18.72"
"64","000","00","040","0014","0575","559","326","233","2","561","1554","0","36.10","20.98"
"64","000","00","040","0014","0576","525","279","246","6","531","1449","0","36.65","19.25"
"64","000","00","040","0014","0577","603","311","292","3","606","1502","0","40.35","20.71"
"64","000","00","040","0014","0578","566","293","273","6","572","1444","0","39.61","20.29"
"64","000","00","040","0014","0579","568","284","284","3","571","1455","0","39.24","19.52"
"64","000","00","040","0014","0580","549","275","274","1","550","1394","0","39.45","19.73"
"64","000","00","040","0014","0581","530","242","288","6","536","1444","0","37.12","16.76"
"64","000","00","040","0014","0582","493","241","252","0","493","1441","0","34.21","16.72"
"64","000","00","040","0014","0583","548","318","230","2","550","1434","0","38.35","22.18"
"64","000","00","040","0014","0584","589","276","313","1","590","1507","0","39.15","18.31"
"64","000","00","040","0015","0000","355","194","161","4","359","657","0","54.64","29.53"
"64","000","00","040","0015","0585","355","194","161","4","359","657","0","54.64","29.53"
"64","000","00","040","0016","0000","1055","471","584","5","1060","2064","0","51.36","22.82"
"64","000","00","040","0016","0586","519","243","276","2","521","1040","0","50.10","23.37"
"64","000","00","040","0016","0587","536","228","308","3","539","1024","0","52.64","22.27"
"64","000","00","040","0017","0000","1082","572","510","4","1086","2417","0","44.93","23.67"
"64","000","00","040","0017","0588","494","238","256","2","496","956","0","51.88","24.90"
"64","000","00","040","0017","0589","588","334","254","2","590","1461","0","40.38","22.86"
"64","000","00","040","0018","0000","1273","568","705","7","1280","2885","0","44.37","19.69"
"64","000","00","040","0018","0590","662","235","427","4","666","1446","0","46.06","16.25"
"64","000","00","040","0018","0591","611","333","278","3","614","1439","0","42.67","23.14"
"64","000","00","040","0019","0000","1067","483","584","6","1073","2765","0","38.81","17.47"
"64","000","00","040","0019","0592","564","267","297","3","567","1487","0","38.13","17.96"
"64","000","00","040","0019","0593","503","216","287","3","506","1278","0","39.59","16.90"
"64","000","00","040","0020","0000","775","354","421","6","781","2046","0","38.17","17.30"
"64","000","00","040","0020","0594","376","155","221","3","379","994","0","38.13","15.59"
"64","000","00","040","0020","0595","399","199","200","3","402","1052","0","38.21","18.92"
"64","000","00","040","0021","0000","963","366","597","8","971","2023","0","48.00","18.09"
"64","000","00","040","0021","0596","437","159","278","3","440","911","0","48.30","17.45"
"64","000","00","040","0021","0597","526","207","319","5","531","1112","0","47.75","18.62"
"64","000","00","040","0022","0000","2317","1133","1184","14","2331","5347","0","43.59","21.19"
"64","000","00","040","0022","0598","614","292","322","4","618","1318","0","46.89","22.15"
"64","000","00","040","0022","0599","573","270","303","4","577","1416","0","40.75","19.07"
"64","000","00","040","0022","0600","547","269","278","2","549","1273","0","43.13","21.13"
"64","000","00","040","0022","0601","583","302","281","4","587","1340","0","43.81","22.54"
"64","000","00","040","0023","0000","561","218","343","6","567","1397","0","40.59","15.60"
"64","000","00","040","0023","0602","561","218","343","6","567","1397","0","40.59","15.60"
"64","000","00","040","0024","0000","1809","759","1050","13","1822","4314","0","42.23","17.59"
"64","000","00","040","0024","0603","427","179","248","2","429","1042","0","41.17","17.18"
"64","000","00","040","0024","0604","477","185","292","1","478","1102","0","43.38","16.79"
"64","000","00","040","0024","0605","412","195","217","8","420","1050","0","40.00","18.57"
"64","000","00","040","0024","0606","493","200","293","2","495","1120","0","44.20","17.86"
"64","000","00","040","0025","0000","1071","495","576","6","1077","2534","0","42.50","19.53"
"64","000","00","040","0025","0607","541","216","325","4","545","1262","0","43.19","17.12"
"64","000","00","040","0025","0608","530","279","251","2","532","1272","0","41.82","21.93"
"64","000","00","040","0026","0000","1394","654","740","7","1401","3221","0","43.50","20.30"
"64","000","00","040","0026","0609","528","251","277","1","529","1156","0","45.76","21.71"
"64","000","00","040","0026","0610","389","157","232","3","392","924","0","42.42","16.99"
"64","000","00","040","0026","0611","477","246","231","3","480","1141","0","42.07","21.56"
"64","000","00","040","0027","0000","885","417","468","8","893","1997","0","44.72","20.88"
"64","000","00","040","0027","0612","444","196","248","7","451","957","0","47.13","20.48"
"64","000","00","040","0027","0613","441","221","220","1","442","1040","0","42.50","21.25"
"64","000","00","040","0028","0000","1538","746","792","6","1544","3122","0","49.46","23.89"
"64","000","00","040","0028","0614","550","289","261","2","552","1112","0","49.64","25.99"
"64","000","00","040","0028","0615","490","255","235","4","494","1000","0","49.40","25.50"
"64","000","00","040","0028","0616","498","202","296","0","498","1010","0","49.31","20.00"
"64","000","00","040","0029","0000","1389","651","738","15","1404","3235","0","43.40","20.12"
"64","000","00","040","0029","0617","464","206","258","3","467","1088","0","42.92","18.93"
"64","000","00","040","0029","0618","452","194","258","8","460","1053","0","43.68","18.42"
"64","000","00","040","0029","0619","473","251","222","4","477","1094","0","43.60","22.94"
"64","000","00","040","0030","0000","947","472","475","5","952","2104","0","45.25","22.43"
"64","000","00","040","0030","0620","457","214","243","1","458","1048","0","43.70","20.42"
"64","000","00","040","0030","0621","490","258","232","4","494","1056","0","46.78","24.43"
"64","000","00","040","0031","0000","1848","770","1078","15","1863","4652","0","40.05","16.55"
"64","000","00","040","0031","0622","492","182","310","4","496","1164","0","42.61","15.64"
"64","000","00","040","0031","0623","407","191","216","3","410","1194","0","34.34","16.00"
"64","000","00","040","0031","0624","461","176","285","5","466","1157","0","40.28","15.21"
"64","000","00","040","0031","0625","488","221","267","3","491","1137","0","43.18","19.44"
"64","000","00","040","0032","0000","1428","600","828","10","1438","3394","0","42.37","17.68"
"64","000","00","040","0032","0626","494","208","286","3","497","1161","0","42.81","17.92"
"64","000","00","040","0032","0627","448","189","259","3","451","1074","0","41.99","17.60"
"64","000","00","040","0032","0628","486","203","283","4","490","1159","0","42.28","17.52"
"64","000","00","040","0033","0000","3349","1720","1629","22","3371","8252","0","40.85","20.84"
"64","000","00","040","0033","0629","395","186","209","1","396","953","0","41.55","19.52"
"64","000","00","040","0033","0630","490","249","241","1","491","1107","0","44.35","22.49"
"64","000","00","040","0033","0631","462","239","223","2","464","1085","0","42.76","22.03"
"64","000","00","040","0033","0632","390","201","189","5","395","988","0","39.98","20.34"
"64","000","00","040","0033","0633","405","201","204","4","409","1028","0","39.79","19.55"
"64","000","00","040","0033","0634","401","221","180","2","403","1059","0","38.05","20.87"
"64","000","00","040","0033","0635","384","212","172","4","388","1026","0","37.82","20.66"
"64","000","00","040","0033","0636","422","211","211","3","425","1006","0","42.25","20.97"
"64","000","00","040","0034","0000","1937","1001","936","10","1947","4959","0","39.26","20.19"
"64","000","00","040","0034","0637","500","253","247","3","503","1294","0","38.87","19.55"
"64","000","00","040","0034","0638","514","260","254","4","518","1310","0","39.54","19.85"
"64","000","00","040","0034","0639","469","244","225","1","470","1249","0","37.63","19.54"
"64","000","00","040","0034","0640","454","244","210","2","456","1106","0","41.23","22.06"
"64","000","00","040","0035","0000","2978","1360","1618","19","2997","7507","0","39.92","18.12"
"64","000","00","040","0035","0641","490","220","270","3","493","1201","0","41.05","18.32"
"64","000","00","040","0035","0642","562","248","314","5","567","1287","0","44.06","19.27"
"64","000","00","040","0035","0643","612","295","317","2","614","1375","0","44.65","21.45"
"64","000","00","040","0035","0644","528","228","300","2","530","1418","0","37.38","16.08"
"64","000","00","040","0035","0645","379","183","196","5","384","1112","0","34.53","16.46"
"64","000","00","040","0035","0646","407","186","221","2","409","1114","0","36.71","16.70"
"64","000","00","040","0036","0000","698","218","480","5","703","1558","0","45.12","13.99"
"64","000","00","040","0036","0647","698","218","480","5","703","1558","0","45.12","13.99"
"64","000","00","040","0037","0000","1434","514","920","10","1444","4154","0","34.76","12.37"
"64","000","00","040","0037","0648","480","142","338","4","484","1197","0","40.43","11.86"
"64","000","00","040","0037","0649","459","157","302","2","461","1300","0","35.46","12.08"
"64","000","00","040","0037","0650","495","215","280","4","499","1657","0","30.11","12.98"
"64","000","00","050","0000","0000","124706","49148","75558","797","125503","285944","334725","43.89","17.19"
"64","000","00","050","0001","0000","1545","556","989","7","1552","3804","0","40.80","14.62"
"64","000","00","050","0001","0998","450","165","285","2","452","1213","0","37.26","13.60"
"64","000","00","050","0001","0999","541","221","320","1","542","1302","0","41.63","16.97"
"64","000","00","050","0001","1000","554","170","384","4","558","1289","0","43.29","13.19"
"64","000","00","050","0002","0000","3014","1233","1781","16","3030","7370","0","41.11","16.73"
"64","000","00","050","0002","1001","679","289","390","3","682","1617","0","42.18","17.87"
"64","000","00","050","0002","1002","653","276","377","3","656","1521","0","43.13","18.15"
"64","000","00","050","0002","1003","592","242","350","5","597","1452","0","41.12","16.67"
"64","000","00","050","0002","1004","569","237","332","1","570","1569","0","36.33","15.11"
"64","000","00","050","0002","1005","521","189","332","4","525","1211","0","43.35","15.61"
"64","000","00","050","0003","0000","1627","585","1042","9","1636","3793","0","43.13","15.42"
"64","000","00","050","0003","1006","585","180","405","4","589","1344","0","43.82","13.39"
"64","000","00","050","0003","1007","546","189","357","4","550","1305","0","42.15","14.48"
"64","000","00","050","0003","1008","496","216","280","1","497","1144","0","43.44","18.88"
"64","000","00","050","0004","0000","1693","647","1046","13","1706","3884","0","43.92","16.66"
"64","000","00","050","0004","1009","572","226","346","9","581","1449","0","40.10","15.60"
"64","000","00","050","0004","1010","668","250","418","1","669","1446","0","46.27","17.29"
"64","000","00","050","0004","1011","453","171","282","3","456","989","0","46.11","17.29"
"64","000","00","050","0005","0000","2837","1054","1783","16","2853","7030","0","40.58","14.99"
"64","000","00","050","0005","1012","599","255","344","4","603","1391","0","43.35","18.33"
"64","000","00","050","0005","1013","553","179","374","4","557","1321","0","42.17","13.55"
"64","000","00","050","0005","1014","555","189","366","3","558","1395","0","40.00","13.55"
"64","000","00","050","0005","1015","605","232","373","2","607","1498","0","40.52","15.49"
"64","000","00","050","0005","1016","525","199","326","3","528","1425","0","37.05","13.96"
"64","000","00","050","0006","0000","1588","534","1054","11","1599","3436","0","46.54","15.54"
"64","000","00","050","0006","1017","481","137","344","4","485","1011","0","47.97","13.55"
"64","000","00","050","0006","1018","527","185","342","2","529","1114","0","47.49","16.61"
"64","000","00","050","0006","1019","580","212","368","5","585","1311","0","44.62","16.17"
"64","000","00","050","0007","0000","9199","4245","4954","50","9249","20899","0","44.26","20.31"
"64","000","00","050","0007","1020","627","216","411","4","631","1480","0","42.64","14.59"
"64","000","00","050","0007","1021","591","304","287","2","593","1474","0","40.23","20.62"
"64","000","00","050","0007","1022","652","321","331","2","654","1497","0","43.69","21.44"
"64","000","00","050","0007","1023","623","274","349","4","627","1399","0","44.82","19.59"
"64","000","00","050","0007","1024","633","217","416","5","638","1469","0","43.43","14.77"
"64","000","00","050","0007","1025","635","223","412","9","644","1494","0","43.11","14.93"
"64","000","00","050","0007","1026","644","275","369","3","647","1509","0","42.88","18.22"
"64","000","00","050","0007","1027","627","257","370","0","627","1509","0","41.55","17.03"
"64","000","00","050","0007","1028","683","344","339","2","685","1517","0","45.15","22.68"
"64","000","00","050","0007","1029","722","378","344","5","727","1501","0","48.43","25.18"
"64","000","00","050","0007","1030","663","326","337","4","667","1516","0","44.00","21.50"
"64","000","00","050","0007","1031","778","404","374","3","781","1510","0","51.72","26.75"
"64","000","00","050","0007","1032","627","356","271","4","631","1490","0","42.35","23.89"
"64","000","00","050","0007","1033","694","350","344","3","697","1534","0","45.44","22.82"
"64","000","00","050","0008","0000","3536","1357","2179","18","3554","8380","0","42.41","16.19"
"64","000","00","050","0008","1034","759","255","504","3","762","1732","0","44.00","14.72"
"64","000","00","050","0008","1035","774","308","466","7","781","1709","0","45.70","18.02"
"64","000","00","050","0008","1036","678","281","397","2","680","1535","0","44.30","18.31"
"64","000","00","050","0008","1037","624","234","390","3","627","1601","0","39.16","14.62"
"64","000","00","050","0008","1038","701","279","422","3","704","1803","0","39.05","15.47"
"64","000","00","050","0009","0000","3040","1222","1818","17","3057","6992","0","43.72","17.48"
"64","000","00","050","0009","1039","640","224","416","4","644","1372","0","46.94","16.33"
"64","000","00","050","0009","1040","633","265","368","3","636","1434","0","44.35","18.48"
"64","000","00","050","0009","1041","617","238","379","2","619","1367","0","45.28","17.41"
"64","000","00","050","0009","1042","553","216","337","4","557","1376","0","40.48","15.70"
"64","000","00","050","0009","1043","597","279","318","4","601","1443","0","41.65","19.33"
"64","000","00","050","0010","0000","868","335","533","7","875","1915","0","45.69","17.49"
"64","000","00","050","0010","1044","427","184","243","2","429","1017","0","42.18","18.09"
"64","000","00","050","0010","1045","441","151","290","5","446","898","0","49.67","16.82"
"64","000","00","050","0011","0000","713","239","474","5","718","1561","0","46.00","15.31"
"64","000","00","050","0011","1046","394","132","262","2","396","858","0","46.15","15.38"
"64","000","00","050","0011","1047","319","107","212","3","322","703","0","45.80","15.22"
"64","000","00","050","0012","0000","2191","894","1297","18","2209","4987","0","44.30","17.93"
"64","000","00","050","0012","1048","550","241","309","7","557","1309","0","42.55","18.41"
"64","000","00","050","0012","1049","537","175","362","3","540","1161","0","46.51","15.07"
"64","000","00","050","0012","1050","575","250","325","8","583","1301","0","44.81","19.22"
"64","000","00","050","0012","1051","529","228","301","0","529","1216","0","43.50","18.75"
"64","000","00","050","0013","0000","1928","836","1092","9","1937","4277","0","45.29","19.55"
"64","000","00","050","0013","1052","641","294","347","4","645","1476","0","43.70","19.92"
"64","000","00","050","0013","1053","625","272","353","1","626","1357","0","46.13","20.04"
"64","000","00","050","0013","1054","662","270","392","4","666","1444","0","46.12","18.70"
"64","000","00","050","0014","0000","1978","891","1087","7","1985","4461","0","44.50","19.97"
"64","000","00","050","0014","1055","644","280","364","2","646","1524","0","42.39","18.37"
"64","000","00","050","0014","1056","645","297","348","3","648","1454","0","44.57","20.43"
"64","000","00","050","0014","1057","689","314","375","2","691","1483","0","46.59","21.17"
"64","000","00","050","0015","0000","3229","1387","1842","17","3246","7143","0","45.44","19.42"
"64","000","00","050","0015","1058","737","297","440","2","739","1488","0","49.66","19.96"
"64","000","00","050","0015","1059","647","308","339","2","649","1521","0","42.67","20.25"
"64","000","00","050","0015","1060","635","262","373","4","639","1403","0","45.55","18.67"
"64","000","00","050","0015","1061","597","266","331","4","601","1308","0","45.95","20.34"
"64","000","00","050","0015","1062","613","254","359","5","618","1423","0","43.43","17.85"
"64","000","00","050","0016","0000","1622","652","970","7","1629","3486","0","46.73","18.70"
"64","000","00","050","0016","1063","432","173","259","3","435","1021","0","42.61","16.94"
"64","000","00","050","0016","1064","625","261","364","3","628","1291","0","48.64","20.22"
"64","000","00","050","0016","1065","565","218","347","1","566","1174","0","48.21","18.57"
"64","000","00","050","0017","0000","2073","799","1274","17","2090","4824","0","43.33","16.56"
"64","000","00","050","0017","1066","565","261","304","6","571","1249","0","45.72","20.90"
"64","000","00","050","0017","1067","450","197","253","4","454","1252","0","36.26","15.73"
"64","000","00","050","0017","1068","549","191","358","4","553","1171","0","47.22","16.31"
"64","000","00","050","0017","1069","509","150","359","3","512","1152","0","44.44","13.02"
"64","000","00","050","0018","0000","1524","573","951","12","1536","3831","0","40.09","14.96"
"64","000","00","050","0018","1070","504","188","316","4","508","1300","0","39.08","14.46"
"64","000","00","050","0018","1071","505","190","315","5","510","1224","0","41.67","15.52"
"64","000","00","050","0018","1072","515","195","320","3","518","1307","0","39.63","14.92"
"64","000","00","050","0019","0000","2741","1078","1663","21","2762","6396","0","43.18","16.85"
"64","000","00","050","0019","1073","649","224","425","9","658","1506","0","43.69","14.87"
"64","000","00","050","0019","1074","697","266","431","4","701","1569","0","44.68","16.95"
"64","000","00","050","0019","1075","705","311","394","1","706","1674","0","42.17","18.58"
"64","000","00","050","0019","1076","690","277","413","7","697","1647","0","42.32","16.82"
"64","000","00","050","0020","0000","1223","450","773","10","1233","2807","0","43.93","16.03"
"64","000","00","050","0020","1077","623","231","392","5","628","1481","0","42.40","15.60"
"64","000","00","050","0020","1078","600","219","381","5","605","1326","0","45.63","16.52"
"64","000","00","050","0021","0000","1348","606","742","8","1356","3089","0","43.90","19.62"
"64","000","00","050","0021","1079","673","325","348","3","676","1507","0","44.86","21.57"
"64","000","00","050","0021","1080","675","281","394","5","680","1582","0","42.98","17.76"
"64","000","00","050","0022","0000","3201","1360","1841","23","3224","7514","0","42.91","18.10"
"64","000","00","050","0022","1081","608","268","340","2","610","1433","0","42.57","18.70"
"64","000","00","050","0022","1082","572","228","344","7","579","1515","0","38.22","15.05"
"64","000","00","050","0022","1083","626","245","381","4","630","1486","0","42.40","16.49"
"64","000","00","050","0022","1084","681","307","374","3","684","1523","0","44.91","20.16"
"64","000","00","050","0022","1085","714","312","402","7","721","1557","0","46.31","20.04"
"64","000","00","050","0023","0000","1223","526","697","10","1233","3030","0","40.69","17.36"
"64","000","00","050","0023","1086","629","254","375","7","636","1554","0","40.93","16.34"
"64","000","00","050","0023","1087","594","272","322","3","597","1476","0","40.45","18.43"
"64","000","00","050","0024","0000","1081","438","643","9","1090","2557","0","42.63","17.13"
"64","000","00","050","0024","1088","544","238","306","4","548","1272","0","43.08","18.71"
"64","000","00","050","0024","1089","537","200","337","5","542","1285","0","42.18","15.56"
"64","000","00","050","0025","0000","2429","1054","1375","12","2441","5630","0","43.36","18.72"
"64","000","00","050","0025","1090","593","242","351","2","595","1406","0","42.32","17.21"
"64","000","00","050","0025","1091","530","206","324","2","532","1245","0","42.73","16.55"
"64","000","00","050","0025","1092","548","237","311","3","551","1245","0","44.26","19.04"
"64","000","00","050","0025","1093","758","369","389","5","763","1734","0","44.00","21.28"
"64","000","00","050","0026","0000","2265","985","1280","16","2281","4748","0","48.04","20.75"
"64","000","00","050","0026","1094","803","316","487","8","811","1605","0","50.53","19.69"
"64","000","00","050","0026","1095","652","276","376","2","654","1432","0","45.67","19.27"
"64","000","00","050","0026","1096","810","393","417","6","816","1711","0","47.69","22.97"
"64","000","00","050","0027","0000","2807","1256","1551","15","2822","6808","0","41.45","18.45"
"64","000","00","050","0027","1097","568","245","323","6","574","1276","0","44.98","19.20"
"64","000","00","050","0027","1098","563","254","309","4","567","1336","0","42.44","19.01"
"64","000","00","050","0027","1099","519","238","281","4","523","1348","0","38.80","17.66"
"64","000","00","050","0027","1100","570","264","306","0","570","1427","0","39.94","18.50"
"64","000","00","050","0027","1101","587","255","332","1","588","1421","0","41.38","17.95"
"64","000","00","050","0028","0000","1889","765","1124","15","1904","3982","0","47.82","19.21"
"64","000","00","050","0028","1102","629","203","426","5","634","1365","0","46.45","14.87"
"64","000","00","050","0028","1103","763","374","389","6","769","1488","0","51.68","25.13"
"64","000","00","050","0028","1104","497","188","309","4","501","1129","0","44.38","16.65"
"64","000","00","050","0029","0000","2265","915","1350","8","2273","6719","0","33.83","13.62"
"64","000","00","050","0029","1105","744","313","431","2","746","3284","0","22.72","9.53"
"64","000","00","050","0029","1106","838","363","475","3","841","1758","0","47.84","20.65"
"64","000","00","050","0029","1107","683","239","444","3","686","1677","0","40.91","14.25"
"64","000","00","050","0030","0000","3295","1398","1897","14","3309","7920","0","41.78","17.65"
"64","000","00","050","0030","1108","697","264","433","4","701","1660","0","42.23","15.90"
"64","000","00","050","0030","1109","669","298","371","2","671","1525","0","44.00","19.54"
"64","000","00","050","0030","1110","590","269","321","4","594","1471","0","40.38","18.29"
"64","000","00","050","0030","1111","705","294","411","1","706","1642","0","43.00","17.90"
"64","000","00","050","0030","1112","634","273","361","3","637","1622","0","39.27","16.83"
"64","000","00","050","0031","0000","1509","618","891","5","1514","3836","0","39.47","16.11"
"64","000","00","050","0031","1113","504","180","324","3","507","1271","0","39.89","14.16"
"64","000","00","050","0031","1114","522","201","321","1","523","1311","0","39.89","15.33"
"64","000","00","050","0031","1115","483","237","246","1","484","1254","0","38.60","18.90"
"64","000","00","050","0032","0000","1012","357","655","14","1026","2898","0","35.40","12.32"
"64","000","00","050","0032","1116","451","161","290","5","456","1388","0","32.85","11.60"
"64","000","00","050","0032","1117","561","196","365","9","570","1510","0","37.75","12.98"
"64","000","00","050","0033","0000","2027","717","1310","14","2041","5297","0","38.53","13.54"
"64","000","00","050","0033","1118","642","205","437","3","645","1708","0","37.76","12.00"
"64","000","00","050","0033","1119","724","256","468","7","731","1817","0","40.23","14.09"
"64","000","00","050","0033","1120","661","256","405","4","665","1772","0","37.53","14.45"
"64","000","00","050","0034","0000","1053","405","648","3","1056","2586","0","40.84","15.66"
"64","000","00","050","0034","1121","467","161","306","2","469","1182","0","39.68","13.62"
"64","000","00","050","0034","1122","586","244","342","1","587","1404","0","41.81","17.38"
"64","000","00","050","0035","0000","773","209","564","6","779","1821","0","42.78","11.48"
"64","000","00","050","0035","1123","344","98","246","2","346","906","0","38.19","10.82"
"64","000","00","050","0035","1124","429","111","318","4","433","915","0","47.32","12.13"
"64","000","00","050","0036","0000","1426","420","1006","6","1432","3021","0","47.40","13.90"
"64","000","00","050","0036","1125","731","254","477","3","734","1594","0","46.05","15.93"
"64","000","00","050","0036","1126","695","166","529","3","698","1427","0","48.91","11.63"
"64","000","00","050","0037","0000","1376","541","835","14","1390","3493","0","39.79","15.49"
"64","000","00","050","0037","1127","418","173","245","2","420","1062","0","39.55","16.29"
"64","000","00","050","0037","1128","516","175","341","7","523","1159","0","45.13","15.10"
"64","000","00","050","0037","1129","442","193","249","5","447","1272","0","35.14","15.17"
"64","000","00","050","0038","0000","4725","2022","2703","27","4752","11804","0","40.26","17.13"
"64","000","00","050","0038","1130","603","222","381","3","606","1476","0","41.06","15.04"
"64","000","00","050","0038","1131","589","225","364","3","592","1544","0","38.34","14.57"
"64","000","00","050","0038","1132","602","278","324","4","606","1495","0","40.54","18.60"
"64","000","00","050","0038","1133","574","189","385","3","577","1385","0","41.66","13.65"
"64","000","00","050","0038","1134","632","301","331","1","633","1572","0","40.27","19.15"
"64","000","00","050","0038","1135","604","268","336","5","609","1501","0","40.57","17.85"
"64","000","00","050","0038","1136","592","280","312","6","598","1468","0","40.74","19.07"
"64","000","00","050","0038","1137","529","259","270","2","531","1363","0","38.96","19.00"
"64","000","00","050","0039","0000","1680","678","1002","5","1685","3743","0","45.02","18.11"
"64","000","00","050","0039","1138","575","227","348","1","576","1273","0","45.25","17.83"
"64","000","00","050","0039","1139","602","252","350","0","602","1306","0","46.09","19.30"
"64","000","00","050","0039","1140","503","199","304","4","507","1164","0","43.56","17.10"
"64","000","00","050","0040","0000","802","287","515","5","807","1778","0","45.39","16.14"
"64","000","00","050","0040","1141","388","163","225","3","391","866","0","45.15","18.82"
"64","000","00","050","0040","1142","414","124","290","2","416","912","0","45.61","13.60"
"64","000","00","050","0041","0000","1016","391","625","6","1022","2499","0","40.90","15.65"
"64","000","00","050","0041","1143","555","236","319","2","557","1330","0","41.88","17.74"
"64","000","00","050","0041","1144","461","155","306","4","465","1169","0","39.78","13.26"
"64","000","00","050","0042","0000","1025","350","675","8","1033","2682","0","38.52","13.05"
"64","000","00","050","0042","1145","501","166","335","5","506","1379","0","36.69","12.04"
"64","000","00","050","0042","1146","524","184","340","3","527","1303","0","40.45","14.12"
"64","000","00","050","0043","0000","775","275","500","9","784","1744","0","44.95","15.77"
"64","000","00","050","0043","1147","374","111","263","3","377","832","0","45.31","13.34"
"64","000","00","050","0043","1148","401","164","237","6","407","912","0","44.63","17.98"
"64","000","00","050","0044","0000","1855","776","1079","10","1865","4294","0","43.43","18.07"
"64","000","00","050","0044","1149","537","263","274","2","539","1315","0","40.99","20.00"
"64","000","00","050","0044","1150","649","260","389","3","652","1454","0","44.84","17.88"
"64","000","00","050","0044","1151","669","253","416","5","674","1525","0","44.20","16.59"
"64","000","00","050","0045","0000","1912","754","1158","11","1923","4233","0","45.43","17.81"
"64","000","00","050","0045","1152","644","284","360","6","650","1414","0","45.97","20.08"
"64","000","00","050","0045","1153","617","228","389","3","620","1348","0","45.99","16.91"
"64","000","00","050","0045","1154","651","242","409","2","653","1471","0","44.39","16.45"
"64","000","00","050","0046","0000","1413","491","922","9","1422","2893","0","49.15","16.97"
"64","000","00","050","0046","1155","695","234","461","4","699","1425","0","49.05","16.42"
"64","000","00","050","0046","1156","718","257","461","5","723","1468","0","49.25","17.51"
"64","000","00","050","0047","0000","1155","384","771","13","1168","2309","0","50.58","16.63"
"64","000","00","050","0047","1157","516","169","347","4","520","1035","0","50.24","16.33"
"64","000","00","050","0047","1158","639","215","424","9","648","1274","0","50.86","16.88"
"64","000","00","050","0048","0000","639","211","428","4","643","1208","0","53.23","17.47"
"64","000","00","050","0048","1159","639","211","428","4","643","1208","0","53.23","17.47"
"64","000","00","050","0049","0000","718","250","468","9","727","1482","0","49.06","16.87"
"64","000","00","050","0049","1160","718","250","468","9","727","1482","0","49.06","16.87"
"64","000","00","050","0050","0000","662","224","438","4","666","1379","0","48.30","16.24"
"64","000","00","050","0050","1161","662","224","438","4","666","1379","0","48.30","16.24"
"64","000","00","050","0051","0000","403","152","251","3","406","882","0","46.03","17.23"
"64","000","00","050","0051","1162","403","152","251","3","406","882","0","46.03","17.23"
"64","000","00","050","0052","0000","1305","490","815","9","1314","2589","0","50.75","18.93"
"64","000","00","050","0052","1163","700","261","439","5","705","1399","0","50.39","18.66"
"64","000","00","050","0052","1164","605","229","376","4","609","1190","0","51.18","19.24"
"64","000","00","050","0053","0000","992","381","611","5","997","2030","0","49.11","18.77"
"64","000","00","050","0053","1165","504","185","319","4","508","966","0","52.59","19.15"
"64","000","00","050","0053","1166","488","196","292","1","489","1064","0","45.96","18.42"
"64","000","00","050","0054","0000","870","321","549","6","876","1812","0","48.34","17.72"
"64","000","00","050","0054","1167","431","161","270","4","435","917","0","47.44","17.56"
"64","000","00","050","0054","1168","439","160","279","2","441","895","0","49.27","17.88"
"64","000","00","050","0055","0000","695","221","474","4","699","1339","0","52.20","16.50"
"64","000","00","050","0055","1169","695","221","474","4","699","1339","0","52.20","16.50"
"64","000","00","050","0056","0000","396","133","263","0","396","748","0","52.94","17.78"
"64","000","00","050","0056","1170","396","133","263","0","396","748","0","52.94","17.78"
"64","000","00","050","0057","0000","568","191","377","5","573","1023","0","56.01","18.67"
"64","000","00","050","0057","1171","568","191","377","5","573","1023","0","56.01","18.67"
"64","000","00","050","0058","0000","694","251","443","7","701","1448","0","48.41","17.33"
"64","000","00","050","0058","1172","694","251","443","7","701","1448","0","48.41","17.33"
"64","000","00","050","0059","0000","1001","336","665","10","1011","1900","0","53.21","17.68"
"64","000","00","050","0059","1173","484","150","334","7","491","946","0","51.90","15.86"
"64","000","00","050","0059","1174","517","186","331","3","520","954","0","54.51","19.50"
"64","000","00","050","0060","0000","1467","498","969","8","1475","2953","0","49.95","16.86"
"64","000","00","050","0060","1175","746","241","505","4","750","1530","0","49.02","15.75"
"64","000","00","050","0060","1176","721","257","464","4","725","1423","0","50.95","18.06"
"64","000","00","050","0061","0000","1654","627","1027","21","1675","3633","0","46.11","17.26"
"64","000","00","050","0061","1177","530","194","336","11","541","1137","0","47.58","17.06"
"64","000","00","050","0061","1178","604","212","392","7","611","1287","0","47.47","16.47"
"64","000","00","050","0061","1179","520","221","299","3","523","1209","0","43.26","18.28"
"64","000","00","050","0062","0000","1729","624","1105","5","1734","3606","0","48.09","17.30"
"64","000","00","050","0062","1180","541","201","340","2","543","1222","0","44.44","16.45"
"64","000","00","050","0062","1181","642","203","439","3","645","1264","0","51.03","16.06"
"64","000","00","050","0062","1182","546","220","326","0","546","1120","0","48.75","19.64"
"64","000","00","050","0063","0000","753","241","512","2","755","1671","0","45.18","14.42"
"64","000","00","050","0063","1183","753","241","512","2","755","1671","0","45.18","14.42"
"64","000","00","050","0064","0000","834","290","544","3","837","1690","0","49.53","17.16"
"64","000","00","050","0064","1184","449","158","291","1","450","907","0","49.61","17.42"
"64","000","00","050","0064","1185","385","132","253","2","387","783","0","49.43","16.86"
"64","000","00","050","0065","0000","932","365","567","6","938","1992","0","47.09","18.32"
"64","000","00","050","0065","1186","533","206","327","3","536","1127","0","47.56","18.28"
"64","000","00","050","0065","1187","399","159","240","3","402","865","0","46.47","18.38"
"64","000","00","050","0066","0000","336","106","230","3","339","659","0","51.44","16.08"
"64","000","00","050","0066","1188","336","106","230","3","339","659","0","51.44","16.08"
"64","000","00","050","0067","0000","386","121","265","0","386","914","0","42.23","13.24"
"64","000","00","050","0067","1189","386","121","265","0","386","914","0","42.23","13.24"
"64","000","00","050","0068","0000","591","199","392","3","594","1341","0","44.30","14.84"
"64","000","00","050","0068","1190","591","199","392","3","594","1341","0","44.30","14.84"
"64","000","00","050","0069","0000","628","258","370","3","631","1337","0","47.20","19.30"
"64","000","00","050","0069","1191","628","258","370","3","631","1337","0","47.20","19.30"
"64","000","00","050","0070","0000","332","123","209","4","336","760","0","44.21","16.18"
"64","000","00","050","0070","1192","332","123","209","4","336","760","0","44.21","16.18"
"64","000","00","050","0072","0000","542","220","322","1","543","1126","0","48.22","19.54"
"64","000","00","050","0072","1193","542","220","322","1","543","1126","0","48.22","19.54"
"64","000","00","050","0073","0000","1833","706","1127","18","1851","3922","0","47.20","18.00"
"64","000","00","050","0073","1194","582","240","342","8","590","1299","0","45.42","18.48"
"64","000","00","050","0073","1195","618","209","409","5","623","1300","0","47.92","16.08"
"64","000","00","050","0073","1196","633","257","376","5","638","1323","0","48.22","19.43"
"64","000","00","050","0074","0000","422","185","237","4","426","1008","0","42.26","18.35"
"64","000","00","050","0074","1197","422","185","237","4","426","1008","0","42.26","18.35"
"64","000","00","050","0075","0000","445","201","244","6","451","1147","0","39.32","17.52"
"64","000","00","050","0075","1198","445","201","244","6","451","1147","0","39.32","17.52"
"64","000","00","050","0076","0000","860","362","498","10","870","1905","0","45.67","19.00"
"64","000","00","050","0076","1199","423","170","253","4","427","915","0","46.67","18.58"
"64","000","00","050","0076","1200","437","192","245","6","443","990","0","44.75","19.39"
"64","000","00","050","0077","0000","457","130","327","6","463","886","0","52.26","14.67"
"64","000","00","050","0077","1201","457","130","327","6","463","886","0","52.26","14.67"
"64","000","00","050","0078","0000","656","213","443","8","664","1307","0","50.80","16.30"
"64","000","00","050","0078","1202","656","213","443","8","664","1307","0","50.80","16.30"
"64","000","00","050","0079","0000","427","170","257","5","432","998","0","43.29","17.03"
"64","000","00","050","0079","1203","427","170","257","5","432","998","0","43.29","17.03"
"64","000","00","050","0081","0000","973","335","638","8","981","2347","0","41.80","14.27"
"64","000","00","050","0081","1204","485","163","322","5","490","1206","0","40.63","13.52"
"64","000","00","050","0081","1205","488","172","316","3","491","1141","0","43.03","15.07"
"64","000","00","050","0082","0000","530","189","341","1","531","1212","0","43.81","15.59"
"64","000","00","050","0082","1206","530","189","341","1","531","1212","0","43.81","15.59"
"64","000","00","050","0083","0000","500","184","316","7","507","1226","0","41.35","15.01"
"64","000","00","050","0083","1207","500","184","316","7","507","1226","0","41.35","15.01"
"64","000","00","050","0084","0000","493","179","314","3","496","1046","0","47.42","17.11"
"64","000","00","050","0084","1208","493","179","314","3","496","1046","0","47.42","17.11"
"64","000","00","050","0085","0000","579","236","343","5","584","1082","0","53.97","21.81"
"64","000","00","050","0085","1209","579","236","343","5","584","1082","0","53.97","21.81"
"64","000","00","050","0086","0000","558","217","341","1","559","1156","0","48.36","18.77"
"64","000","00","050","0086","1210","558","217","341","1","559","1156","0","48.36","18.77"
"64","000","00","050","0087","0000","460","155","305","3","463","1009","0","45.89","15.36"
"64","000","00","050","0087","1211","460","155","305","3","463","1009","0","45.89","15.36"
"64","000","00","050","0088","0000","880","308","572","5","885","1967","0","44.99","15.66"
"64","000","00","050","0088","1212","423","145","278","2","425","925","0","45.95","15.68"
"64","000","00","050","0088","1213","457","163","294","3","460","1042","0","44.15","15.64"
"64","000","00","060","0000","0000","20099","8411","11688","134","20233","43307","49925","46.72","19.42"
"64","000","00","060","0001","0000","837","419","418","3","840","1749","0","48.03","23.96"
"64","000","00","060","0001","1346","391","198","193","1","392","794","0","49.37","24.94"
"64","000","00","060","0001","1347","446","221","225","2","448","955","0","46.91","23.14"
"64","000","00","060","0002","0000","484","218","266","2","486","1026","0","47.37","21.25"
"64","000","00","060","0002","1348","484","218","266","2","486","1026","0","47.37","21.25"
"64","000","00","060","0003","0000","1305","584","721","7","1312","2842","0","46.16","20.55"
"64","000","00","060","0003","1349","668","283","385","2","670","1394","0","48.06","20.30"
"64","000","00","060","0003","1350","637","301","336","5","642","1448","0","44.34","20.79"
"64","000","00","060","0004","0000","494","221","273","2","496","1011","0","49.06","21.86"
"64","000","00","060","0004","1351","494","221","273","2","496","1011","0","49.06","21.86"
"64","000","00","060","0005","0000","644","279","365","5","649","1282","0","50.62","21.76"
"64","000","00","060","0005","1352","644","279","365","5","649","1282","0","50.62","21.76"
"64","000","00","060","0006","0000","301","158","143","6","307","626","0","49.04","25.24"
"64","000","00","060","0006","1353","301","158","143","6","307","626","0","49.04","25.24"
"64","000","00","060","0007","0000","419","171","248","2","421","979","0","43.00","17.47"
"64","000","00","060","0007","1354","419","171","248","2","421","979","0","43.00","17.47"
"64","000","00","060","0008","0000","830","359","471","3","833","1808","0","46.07","19.86"
"64","000","00","060","0008","1355","435","199","236","3","438","883","0","49.60","22.54"
"64","000","00","060","0008","1356","395","160","235","0","395","925","0","42.70","17.30"
"64","000","00","060","0009","0000","407","159","248","3","410","902","0","45.45","17.63"
"64","000","00","060","0009","1357","407","159","248","3","410","902","0","45.45","17.63"
"64","000","00","060","0010","0000","358","153","205","7","365","706","0","51.70","21.67"
"64","000","00","060","0010","1358","358","153","205","7","365","706","0","51.70","21.67"
"64","000","00","060","0011","0000","596","243","353","4","600","1289","0","46.55","18.85"
"64","000","00","060","0011","1359","596","243","353","4","600","1289","0","46.55","18.85"
"64","000","00","060","0012","0000","316","121","195","2","318","736","0","43.21","16.44"
"64","000","00","060","0012","1360","316","121","195","2","318","736","0","43.21","16.44"
"64","000","00","060","0013","0000","854","326","528","3","857","1998","0","42.89","16.32"
"64","000","00","060","0013","1361","460","159","301","1","461","1026","0","44.93","15.50"
"64","000","00","060","0013","1362","394","167","227","2","396","972","0","40.74","17.18"
"64","000","00","060","0014","0000","1324","562","762","4","1328","2739","0","48.48","20.52"
"64","000","00","060","0014","1363","731","315","416","2","733","1469","0","49.90","21.44"
"64","000","00","060","0014","1364","593","247","346","2","595","1270","0","46.85","19.45"
"64","000","00","060","0015","0000","1056","471","585","4","1060","2197","0","48.25","21.44"
"64","000","00","060","0015","1365","538","215","323","3","541","1173","0","46.12","18.33"
"64","000","00","060","0015","1366","518","256","262","1","519","1024","0","50.68","25.00"
"64","000","00","060","0016","0000","782","355","427","9","791","1572","0","50.32","22.58"
"64","000","00","060","0016","1367","360","171","189","4","364","697","0","52.22","24.53"
"64","000","00","060","0016","1368","422","184","238","5","427","875","0","48.80","21.03"
"64","000","00","060","0017","0000","1584","673","911","7","1591","3254","0","48.89","20.68"
"64","000","00","060","0017","1369","494","224","270","4","498","1064","0","46.80","21.05"
"64","000","00","060","0017","1370","509","207","302","1","510","1108","0","46.03","18.68"
"64","000","00","060","0017","1371","581","242","339","2","583","1082","0","53.88","22.37"
"64","000","00","060","0018","0000","588","291","297","2","590","1299","0","45.42","22.40"
"64","000","00","060","0018","1372","588","291","297","2","590","1299","0","45.42","22.40"
"64","000","00","060","0019","0000","456","165","291","4","460","1074","0","42.83","15.36"
"64","000","00","060","0019","1373","456","165","291","4","460","1074","0","42.83","15.36"
"64","000","00","060","0020","0000","386","153","233","2","388","801","0","48.44","19.10"
"64","000","00","060","0020","1374","386","153","233","2","388","801","0","48.44","19.10"
"64","000","00","060","0021","0000","437","175","262","2","439","996","0","44.08","17.57"
"64","000","00","060","0021","1375","437","175","262","2","439","996","0","44.08","17.57"
"64","000","00","060","0022","0000","985","343","642","11","996","1859","0","53.58","18.45"
"64","000","00","060","0022","1376","485","158","327","5","490","901","0","54.38","17.54"
"64","000","00","060","0022","1377","500","185","315","6","506","958","0","52.82","19.31"
"64","000","00","060","0023","0000","1073","482","591","6","1079","2712","0","39.79","17.77"
"64","000","00","060","0023","1378","448","197","251","4","452","1363","0","33.16","14.45"
"64","000","00","060","0023","1379","625","285","340","2","627","1349","0","46.48","21.13"
"64","000","00","060","0024","0000","305","112","193","4","309","692","0","44.65","16.18"
"64","000","00","060","0024","1380","305","112","193","4","309","692","0","44.65","16.18"
"64","000","00","060","0025","0000","473","174","299","6","479","1021","0","46.91","17.04"
"64","000","00","060","0025","1381","473","174","299","6","479","1021","0","46.91","17.04"
"64","000","00","060","0026","0000","414","154","260","5","419","960","0","43.65","16.04"
"64","000","00","060","0026","1382","414","154","260","5","419","960","0","43.65","16.04"
"64","000","00","060","0027","0000","388","161","227","4","392","934","0","41.97","17.24"
"64","000","00","060","0027","1383","388","161","227","4","392","934","0","41.97","17.24"
"64","000","00","060","0028","0000","385","133","252","1","386","919","0","42.00","14.47"
"64","000","00","060","0028","1384","385","133","252","1","386","919","0","42.00","14.47"
"64","000","00","060","0029","0000","388","133","255","3","391","785","0","49.81","16.94"
"64","000","00","060","0029","1385","388","133","255","3","391","785","0","49.81","16.94"
"64","000","00","060","0030","0000","326","121","205","3","329","685","0","48.03","17.66"
"64","000","00","060","0030","1386","326","121","205","3","329","685","0","48.03","17.66"
"64","000","00","060","0031","0000","331","157","174","3","334","702","0","47.58","22.36"
"64","000","00","060","0031","1387","331","157","174","3","334","702","0","47.58","22.36"
"64","000","00","060","0032","0000","573","185","388","5","578","1152","0","50.17","16.06"
"64","000","00","060","0032","1388","573","185","388","5","578","1152","0","50.17","16.06"
"64","000","00","070","0000","0000","11105","4686","6419","74","11179","23787","26498","47.00","19.70"
"64","000","00","070","0001","0000","326","88","238","2","328","658","0","49.85","13.37"
"64","000","00","070","0001","1321","326","88","238","2","328","658","0","49.85","13.37"
"64","000","00","070","0002","0000","485","212","273","6","491","983","0","49.95","21.57"
"64","000","00","070","0002","1322","485","212","273","6","491","983","0","49.95","21.57"
"64","000","00","070","0003","0000","580","204","376","6","586","1310","0","44.73","15.57"
"64","000","00","070","0003","1323","580","204","376","6","586","1310","0","44.73","15.57"
"64","000","00","070","0004","0000","372","141","231","1","373","809","0","46.11","17.43"
"64","000","00","070","0004","1324","372","141","231","1","373","809","0","46.11","17.43"
"64","000","00","070","0005","0000","472","178","294","2","474","957","0","49.53","18.60"
"64","000","00","070","0005","1325","472","178","294","2","474","957","0","49.53","18.60"
"64","000","00","070","0006","0000","1628","761","867","6","1634","3581","0","45.63","21.25"
"64","000","00","070","0006","1326","566","275","291","4","570","1215","0","46.91","22.63"
"64","000","00","070","0006","1327","586","250","336","1","587","1234","0","47.57","20.26"
"64","000","00","070","0006","1328","476","236","240","1","477","1132","0","42.14","20.85"
"64","000","00","070","0007","0000","308","132","176","3","311","662","0","46.98","19.94"
"64","000","00","070","0007","1329","308","132","176","3","311","662","0","46.98","19.94"
"64","000","00","070","0008","0000","530","221","309","5","535","1150","0","46.52","19.22"
"64","000","00","070","0008","1330","530","221","309","5","535","1150","0","46.52","19.22"
"64","000","00","070","0009","0000","811","331","480","11","822","1817","0","45.24","18.22"
"64","000","00","070","0009","1331","411","172","239","6","417","895","0","46.59","19.22"
"64","000","00","070","0009","1332","400","159","241","5","405","922","0","43.93","17.25"
"64","000","00","070","0010","0000","352","159","193","0","352","778","0","45.24","20.44"
"64","000","00","070","0010","1333","352","159","193","0","352","778","0","45.24","20.44"
"64","000","00","070","0011","0000","478","205","273","2","480","992","0","48.39","20.67"
"64","000","00","070","0011","1334","478","205","273","2","480","992","0","48.39","20.67"
"64","000","00","070","0012","0000","403","146","257","3","406","1030","0","39.42","14.17"
"64","000","00","070","0012","1335","403","146","257","3","406","1030","0","39.42","14.17"
"64","000","00","070","0013","0000","412","164","248","2","414","901","0","45.95","18.20"
"64","000","00","070","0013","1336","412","164","248","2","414","901","0","45.95","18.20"
"64","000","00","070","0014","0000","680","330","350","2","682","1424","0","47.89","23.17"
"64","000","00","070","0014","1337","325","170","155","0","325","698","0","46.56","24.36"
"64","000","00","070","0014","1338","355","160","195","2","357","726","0","49.17","22.04"
"64","000","00","070","0015","0000","508","237","271","2","510","1017","0","50.15","23.30"
"64","000","00","070","0015","1339","508","237","271","2","510","1017","0","50.15","23.30"
"64","000","00","070","0016","0000","465","193","272","2","467","986","0","47.36","19.57"
"64","000","00","070","0016","1340","465","193","272","2","467","986","0","47.36","19.57"
"64","000","00","070","0017","0000","818","384","434","8","826","1640","0","50.37","23.41"
"64","000","00","070","0017","1341","422","206","216","4","426","863","0","49.36","23.87"
"64","000","00","070","0017","1342","396","178","218","4","400","777","0","51.48","22.91"
"64","000","00","070","0018","0000","487","205","282","4","491","1043","0","47.08","19.65"
"64","000","00","070","0018","1343","487","205","282","4","491","1043","0","47.08","19.65"
"64","000","00","070","0019","0000","451","169","282","2","453","941","0","48.14","17.96"
"64","000","00","070","0019","1344","451","169","282","2","453","941","0","48.14","17.96"
"64","000","00","070","0020","0000","539","226","313","5","544","1108","0","49.10","20.40"
"64","000","00","070","0020","1345","539","226","313","5","544","1108","0","49.10","20.40"
"64","000","00","080","0000","0000","64840","27829","37011","427","65267","143752","166008","45.40","19.36"
"64","000","00","080","0001","0000","338","167","171","3","341","681","0","50.07","24.52"
"64","000","00","080","0001","1389","338","167","171","3","341","681","0","50.07","24.52"
"64","000","00","080","0002","0000","626","291","335","4","630","1496","0","42.11","19.45"
"64","000","00","080","0002","1390","331","155","176","4","335","785","0","42.68","19.75"
"64","000","00","080","0002","1391","295","136","159","0","295","711","0","41.49","19.13"
"64","000","00","080","0003","0000","503","224","279","5","508","1147","0","44.29","19.53"
"64","000","00","080","0003","1392","503","224","279","5","508","1147","0","44.29","19.53"
"64","000","00","080","0004","0000","702","268","434","12","714","1552","0","46.01","17.27"
"64","000","00","080","0004","1393","328","134","194","7","335","739","0","45.33","18.13"
"64","000","00","080","0004","1394","374","134","240","5","379","813","0","46.62","16.48"
"64","000","00","080","0005","0000","607","284","323","4","611","1384","0","44.15","20.52"
"64","000","00","080","0005","1395","294","140","154","2","296","681","0","43.47","20.56"
"64","000","00","080","0005","1396","313","144","169","2","315","703","0","44.81","20.48"
"64","000","00","080","0006","0000","603","196","407","1","604","1405","0","42.99","13.95"
"64","000","00","080","0006","1397","321","95","226","1","322","720","0","44.72","13.19"
"64","000","00","080","0006","1398","282","101","181","0","282","685","0","41.17","14.74"
"64","000","00","080","0007","0000","657","272","385","5","662","1540","0","42.99","17.66"
"64","000","00","080","0007","1399","312","143","169","3","315","773","0","40.75","18.50"
"64","000","00","080","0007","1400","345","129","216","2","347","767","0","45.24","16.82"
"64","000","00","080","0008","0000","260","107","153","0","260","506","0","51.38","21.15"
"64","000","00","080","0008","1401","260","107","153","0","260","506","0","51.38","21.15"
"64","000","00","080","0009","0000","803","345","458","3","806","1861","0","43.31","18.54"
"64","000","00","080","0009","1402","383","170","213","0","383","919","0","41.68","18.50"
"64","000","00","080","0009","1403","420","175","245","3","423","942","0","44.90","18.58"
"64","000","00","080","0010","0000","1383","654","729","11","1394","3663","0","38.06","17.85"
"64","000","00","080","0010","1404","461","194","267","5","466","1119","0","41.64","17.34"
"64","000","00","080","0010","1405","474","227","247","2","476","1305","0","36.48","17.39"
"64","000","00","080","0010","1406","448","233","215","4","452","1239","0","36.48","18.81"
"64","000","00","080","0011","0000","410","155","255","2","412","878","0","46.92","17.65"
"64","000","00","080","0011","1407","410","155","255","2","412","878","0","46.92","17.65"
"64","000","00","080","0012","0000","608","269","339","5","613","1259","0","48.69","21.37"
"64","000","00","080","0012","1408","608","269","339","5","613","1259","0","48.69","21.37"
"64","000","00","080","0013","0000","720","288","432","7","727","1714","0","42.42","16.80"
"64","000","00","080","0013","1409","369","141","228","2","371","881","0","42.11","16.00"
"64","000","00","080","0013","1410","351","147","204","5","356","833","0","42.74","17.65"
"64","000","00","080","0014","0000","636","281","355","3","639","1191","0","53.65","23.59"
"64","000","00","080","0014","1411","636","281","355","3","639","1191","0","53.65","23.59"
"64","000","00","080","0015","0000","814","287","527","8","822","1686","0","48.75","17.02"
"64","000","00","080","0015","1412","418","147","271","6","424","866","0","48.96","16.97"
"64","000","00","080","0015","1413","396","140","256","2","398","820","0","48.54","17.07"
"64","000","00","080","0016","0000","491","220","271","4","495","1085","0","45.62","20.28"
"64","000","00","080","0016","1414","491","220","271","4","495","1085","0","45.62","20.28"
"64","000","00","080","0017","0000","1378","587","791","5","1383","2948","0","46.91","19.91"
"64","000","00","080","0017","1415","479","195","284","3","482","959","0","50.26","20.33"
"64","000","00","080","0017","1416","470","196","274","2","472","987","0","47.82","19.86"
"64","000","00","080","0017","1417","429","196","233","0","429","1002","0","42.81","19.56"
"64","000","00","080","0018","0000","1004","403","601","1","1005","2080","0","48.32","19.38"
"64","000","00","080","0018","1418","520","181","339","1","521","1045","0","49.86","17.32"
"64","000","00","080","0018","1419","484","222","262","0","484","1035","0","46.76","21.45"
"64","000","00","080","0019","0000","1389","577","812","6","1395","2971","0","46.95","19.42"
"64","000","00","080","0019","1420","484","189","295","0","484","1006","0","48.11","18.79"
"64","000","00","080","0019","1421","443","197","246","1","444","960","0","46.25","20.52"
"64","000","00","080","0019","1422","462","191","271","5","467","1005","0","46.47","19.00"
"64","000","00","080","0020","0000","900","391","509","4","904","1962","0","46.08","19.93"
"64","000","00","080","0020","1423","451","223","228","2","453","971","0","46.65","22.97"
"64","000","00","080","0020","1424","449","168","281","2","451","991","0","45.51","16.95"
"64","000","00","080","0021","0000","752","331","421","6","758","2551","0","29.71","12.98"
"64","000","00","080","0021","1425","566","240","326","4","570","1215","0","46.91","19.75"
"64","000","00","080","0021","1426","186","91","95","2","188","1336","0","14.07","6.81"
"64","000","00","080","0022","0000","1568","708","860","9","1577","3394","0","46.46","20.86"
"64","000","00","080","0022","1427","546","261","285","5","551","1116","0","49.37","23.39"
"64","000","00","080","0022","1428","559","246","313","2","561","1267","0","44.28","19.42"
"64","000","00","080","0022","1429","463","201","262","2","465","1011","0","45.99","19.88"
"64","000","00","080","0023","0000","1028","467","561","7","1035","2101","0","49.26","22.23"
"64","000","00","080","0023","1430","575","232","343","4","579","1182","0","48.98","19.63"
"64","000","00","080","0023","1431","453","235","218","3","456","919","0","49.62","25.57"
"64","000","00","080","0024","0000","1061","523","538","5","1066","2233","0","47.74","23.42"
"64","000","00","080","0024","1432","540","283","257","5","545","1113","0","48.97","25.43"
"64","000","00","080","0024","1433","521","240","281","0","521","1120","0","46.52","21.43"
"64","000","00","080","0025","0000","651","308","343","0","651","1434","0","45.40","21.48"
"64","000","00","080","0025","1434","320","142","178","0","320","702","0","45.58","20.23"
"64","000","00","080","0025","1435","331","166","165","0","331","732","0","45.22","22.68"
"64","000","00","080","0026","0000","317","95","222","6","323","666","0","48.50","14.26"
"64","000","00","080","0026","1436","317","95","222","6","323","666","0","48.50","14.26"
"64","000","00","080","0027","0000","559","167","392","1","560","1226","0","45.68","13.62"
"64","000","00","080","0027","1437","285","88","197","0","285","590","0","48.31","14.92"
"64","000","00","080","0027","1438","274","79","195","1","275","636","0","43.24","12.42"
"64","000","00","080","0028","0000","1212","450","762","7","1219","2632","0","46.31","17.10"
"64","000","00","080","0028","1439","396","133","263","2","398","846","0","47.04","15.72"
"64","000","00","080","0028","1440","425","148","277","2","427","873","0","48.91","16.95"
"64","000","00","080","0028","1441","391","169","222","3","394","913","0","43.15","18.51"
"64","000","00","080","0029","0000","664","278","386","3","667","1516","0","44.00","18.34"
"64","000","00","080","0029","1442","338","141","197","2","340","777","0","43.76","18.15"
"64","000","00","080","0029","1443","326","137","189","1","327","739","0","44.25","18.54"
"64","000","00","080","0030","0000","1249","508","741","10","1259","2734","0","46.05","18.58"
"64","000","00","080","0030","1444","449","179","270","3","452","975","0","46.36","18.36"
"64","000","00","080","0030","1445","405","155","250","5","410","904","0","45.35","17.15"
"64","000","00","080","0030","1446","395","174","221","2","397","855","0","46.43","20.35"
"64","000","00","080","0031","0000","876","436","440","4","880","1845","0","47.70","23.63"
"64","000","00","080","0031","1447","437","204","233","2","439","899","0","48.83","22.69"
"64","000","00","080","0031","1448","439","232","207","2","441","946","0","46.62","24.52"
"64","000","00","080","0032","0000","1311","686","625","3","1314","2771","0","47.42","24.76"
"64","000","00","080","0032","1449","413","231","182","1","414","866","0","47.81","26.67"
"64","000","00","080","0032","1450","445","236","209","1","446","905","0","49.28","26.08"
"64","000","00","080","0032","1451","453","219","234","1","454","1000","0","45.40","21.90"
"64","000","00","080","0033","0000","1268","575","693","10","1278","2724","0","46.92","21.11"
"64","000","00","080","0033","1452","449","214","235","5","454","923","0","49.19","23.19"
"64","000","00","080","0033","1453","399","184","215","2","401","855","0","46.90","21.52"
"64","000","00","080","0033","1454","420","177","243","3","423","946","0","44.71","18.71"
"64","000","00","080","0034","0000","693","298","395","7","700","1480","0","47.30","20.14"
"64","000","00","080","0034","1455","360","152","208","3","363","756","0","48.02","20.11"
"64","000","00","080","0034","1456","333","146","187","4","337","724","0","46.55","20.17"
"64","000","00","080","0035","0000","983","493","490","12","995","2090","0","47.61","23.59"
"64","000","00","080","0035","1457","466","244","222","3","469","1021","0","45.94","23.90"
"64","000","00","080","0035","1458","517","249","268","9","526","1069","0","49.20","23.29"
"64","000","00","080","0036","0000","939","510","429","3","942","2096","0","44.94","24.33"
"64","000","00","080","0036","1459","486","248","238","2","488","1054","0","46.30","23.53"
"64","000","00","080","0036","1460","453","262","191","1","454","1042","0","43.57","25.14"
"64","000","00","080","0037","0000","1103","497","606","9","1112","2380","0","46.72","20.88"
"64","000","00","080","0037","1461","595","247","348","4","599","1274","0","47.02","19.39"
"64","000","00","080","0037","1462","508","250","258","5","513","1106","0","46.38","22.60"
"64","000","00","080","0038","0000","711","334","377","6","717","1489","0","48.15","22.43"
"64","000","00","080","0038","1463","323","154","169","1","324","697","0","46.48","22.09"
"64","000","00","080","0038","1464","388","180","208","5","393","792","0","49.62","22.73"
"64","000","00","080","0039","0000","678","208","470","8","686","1389","0","49.39","14.97"
"64","000","00","080","0039","1465","327","108","219","3","330","705","0","46.81","15.32"
"64","000","00","080","0039","1466","351","100","251","5","356","684","0","52.05","14.62"
"64","000","00","080","0040","0000","783","296","487","14","797","1620","0","49.20","18.27"
"64","000","00","080","0040","1467","369","132","237","7","376","765","0","49.15","17.25"
"64","000","00","080","0040","1468","414","164","250","7","421","855","0","49.24","19.18"
"64","000","00","080","0041","0000","1098","484","614","6","1104","2086","0","52.92","23.20"
"64","000","00","080","0041","1469","590","245","345","3","593","1110","0","53.42","22.07"
"64","000","00","080","0041","1470","508","239","269","3","511","976","0","52.36","24.49"
"64","000","00","080","0042","0000","1736","735","1001","12","1748","3752","0","46.59","19.59"
"64","000","00","080","0042","1471","446","180","266","6","452","914","0","49.45","19.69"
"64","000","00","080","0042","1472","385","161","224","2","387","851","0","45.48","18.92"
"64","000","00","080","0042","1473","415","152","263","2","417","923","0","45.18","16.47"
"64","000","00","080","0042","1474","490","242","248","2","492","1064","0","46.24","22.74"
"64","000","00","080","0043","0000","832","381","451","4","836","1742","0","47.99","21.87"
"64","000","00","080","0043","1475","452","222","230","3","455","931","0","48.87","23.85"
"64","000","00","080","0043","1476","380","159","221","1","381","811","0","46.98","19.61"
"64","000","00","080","0044","0000","777","346","431","4","781","1748","0","44.68","19.79"
"64","000","00","080","0044","1477","398","196","202","1","399","855","0","46.67","22.92"
"64","000","00","080","0044","1478","379","150","229","3","382","893","0","42.78","16.80"
"64","000","00","080","0045","0000","1669","776","893","6","1675","3776","0","44.36","20.55"
"64","000","00","080","0045","1479","560","300","260","2","562","1250","0","44.96","24.00"
"64","000","00","080","0045","1480","608","264","344","2","610","1284","0","47.51","20.56"
"64","000","00","080","0045","1481","501","212","289","2","503","1242","0","40.50","17.07"
"64","000","00","080","0046","0000","818","298","520","5","823","1791","0","45.95","16.64"
"64","000","00","080","0046","1482","404","155","249","1","405","894","0","45.30","17.34"
"64","000","00","080","0046","1483","414","143","271","4","418","897","0","46.60","15.94"
"64","000","00","080","0047","0000","732","410","322","11","743","1489","0","49.90","27.54"
"64","000","00","080","0047","1484","366","185","181","10","376","774","0","48.58","23.90"
"64","000","00","080","0047","1485","366","225","141","1","367","715","0","51.33","31.47"
"64","000","00","080","0048","0000","620","246","374","3","623","1371","0","45.44","17.94"
"64","000","00","080","0048","1486","326","121","205","2","328","714","0","45.94","16.95"
"64","000","00","080","0048","1487","294","125","169","1","295","657","0","44.90","19.03"
"64","000","00","080","0049","0000","1131","412","719","8","1139","2410","0","47.26","17.10"
"64","000","00","080","0049","1488","559","214","345","4","563","1205","0","46.72","17.76"
"64","000","00","080","0049","1489","572","198","374","4","576","1205","0","47.80","16.43"
"64","000","00","080","0050","0000","527","226","301","3","530","1158","0","45.77","19.52"
"64","000","00","080","0050","1490","527","226","301","3","530","1158","0","45.77","19.52"
"64","000","00","080","0051","0000","456","226","230","1","457","1023","0","44.67","22.09"
"64","000","00","080","0051","1491","456","226","230","1","457","1023","0","44.67","22.09"
"64","000","00","080","0052","0000","851","293","558","10","861","1787","0","48.18","16.40"
"64","000","00","080","0052","1492","428","127","301","7","435","907","0","47.96","14.00"
"64","000","00","080","0052","1493","423","166","257","3","426","880","0","48.41","18.86"
"64","000","00","080","0053","0000","822","347","475","7","829","1974","0","42.00","17.58"
"64","000","00","080","0053","1494","447","182","265","4","451","1084","0","41.61","16.79"
"64","000","00","080","0053","1495","375","165","210","3","378","890","0","42.47","18.54"
"64","000","00","080","0054","0000","1074","431","643","6","1080","2537","0","42.57","16.99"
"64","000","00","080","0054","1496","514","183","331","5","519","1276","0","40.67","14.34"
"64","000","00","080","0054","1497","560","248","312","1","561","1261","0","44.49","19.67"
"64","000","00","080","0055","0000","1060","363","697","8","1068","2583","0","41.35","14.05"
"64","000","00","080","0055","1498","480","171","309","4","484","1278","0","37.87","13.38"
"64","000","00","080","0055","1499","580","192","388","4","584","1305","0","44.75","14.71"
"64","000","00","080","0056","0000","1095","467","628","6","1101","2521","0","43.67","18.52"
"64","000","00","080","0056","1500","500","199","301","1","501","1165","0","43.00","17.08"
"64","000","00","080","0056","1501","595","268","327","5","600","1356","0","44.25","19.76"
"64","000","00","080","0057","0000","778","278","500","10","788","1685","0","46.77","16.50"
"64","000","00","080","0057","1502","389","135","254","4","393","809","0","48.58","16.69"
"64","000","00","080","0057","1503","389","143","246","6","395","876","0","45.09","16.32"
"64","000","00","080","0058","0000","985","456","529","4","989","2051","0","48.22","22.23"
"64","000","00","080","0058","1504","531","246","285","2","533","1035","0","51.50","23.77"
"64","000","00","080","0058","1505","454","210","244","2","456","1016","0","44.88","20.67"
"64","000","00","080","0059","0000","990","411","579","7","997","2240","0","44.51","18.35"
"64","000","00","080","0059","1506","484","207","277","4","488","1092","0","44.69","18.96"
"64","000","00","080","0059","1507","506","204","302","3","509","1148","0","44.34","17.77"
"64","000","00","080","0060","0000","1202","514","688","6","1208","2641","0","45.74","19.46"
"64","000","00","080","0060","1508","407","187","220","3","410","872","0","47.02","21.44"
"64","000","00","080","0060","1509","331","149","182","1","332","772","0","43.01","19.30"
"64","000","00","080","0060","1510","464","178","286","2","466","997","0","46.74","17.85"
"64","000","00","080","0061","0000","1998","955","1043","15","2013","4822","0","41.75","19.81"
"64","000","00","080","0061","1511","545","281","264","1","546","1250","0","43.68","22.48"
"64","000","00","080","0061","1512","465","226","239","2","467","1057","0","44.18","21.38"
"64","000","00","080","0061","1513","490","203","287","4","494","1239","0","39.87","16.38"
"64","000","00","080","0061","1514","498","245","253","8","506","1276","0","39.66","19.20"
"64","000","00","080","0062","0000","1638","709","929","10","1648","3581","0","46.02","19.80"
"64","000","00","080","0062","1515","593","286","307","3","596","1189","0","50.13","24.05"
"64","000","00","080","0062","1516","506","204","302","3","509","1167","0","43.62","17.48"
"64","000","00","080","0062","1517","539","219","320","4","543","1225","0","44.33","17.88"
"64","000","00","080","0063","0000","1589","707","882","13","1602","3399","0","47.13","20.80"
"64","000","00","080","0063","1518","532","229","303","5","537","1149","0","46.74","19.93"
"64","000","00","080","0063","1519","507","224","283","2","509","1137","0","44.77","19.70"
"64","000","00","080","0063","1520","550","254","296","6","556","1113","0","49.96","22.82"
"64","000","00","080","0064","0000","1724","735","989","9","1733","4055","0","42.74","18.13"
"64","000","00","080","0064","1521","580","244","336","2","582","1372","0","42.42","17.78"
"64","000","00","080","0064","1522","536","233","303","5","541","1318","0","41.05","17.68"
"64","000","00","080","0064","1523","608","258","350","2","610","1365","0","44.69","18.90"
"64","000","00","080","0065","0000","1160","429","731","4","1164","2329","0","49.98","18.42"
"64","000","00","080","0065","1524","547","197","350","2","549","1155","0","47.53","17.06"
"64","000","00","080","0065","1525","613","232","381","2","615","1174","0","52.39","19.76"
"64","000","00","080","0066","0000","1007","461","546","5","1012","2409","0","42.01","19.14"
"64","000","00","080","0066","1526","484","216","268","3","487","1188","0","40.99","18.18"
"64","000","00","080","0066","1527","523","245","278","2","525","1221","0","43.00","20.07"
"64","000","00","080","0067","0000","1545","574","971","13","1558","3573","0","43.60","16.06"
"64","000","00","080","0067","1528","538","182","356","8","546","1192","0","45.81","15.27"
"64","000","00","080","0067","1529","499","198","301","3","502","1202","0","41.76","16.47"
"64","000","00","080","0067","1530","508","194","314","2","510","1179","0","43.26","16.45"
"64","000","00","080","0068","0000","801","298","503","4","805","1945","0","41.39","15.32"
"64","000","00","080","0068","1531","376","125","251","2","378","920","0","41.09","13.59"
"64","000","00","080","0068","1532","425","173","252","2","427","1025","0","41.66","16.88"
"64","000","00","080","0069","0000","887","427","460","4","891","1894","0","47.04","22.54"
"64","000","00","080","0069","1533","450","207","243","0","450","957","0","47.02","21.63"
"64","000","00","080","0069","1534","437","220","217","4","441","937","0","47.07","23.48"
"64","000","00","090","0000","0000","70107","27596","42511","543","70650","159582","184355","44.27","17.29"
"64","000","00","090","0001","0000","3586","1133","2453","37","3623","9285","0","39.02","12.20"
"64","000","00","090","0001","1787","428","128","300","8","436","956","0","45.61","13.39"
"64","000","00","090","0001","1788","209","68","141","4","213","419","0","50.84","16.23"
"64","000","00","090","0001","1789","493","173","320","4","497","1290","0","38.53","13.41"
"64","000","00","090","0001","1790","513","168","345","7","520","1318","0","39.45","12.75"
"64","000","00","090","0001","1791","460","142","318","3","463","1342","0","34.50","10.58"
"64","000","00","090","0001","1792","440","135","305","3","443","1252","0","35.38","10.78"
"64","000","00","090","0001","1793","496","152","344","6","502","1316","0","38.15","11.55"
"64","000","00","090","0001","1794","547","167","380","2","549","1392","0","39.44","12.00"
"64","000","00","090","0002","0000","981","301","680","7","988","2288","0","43.18","13.16"
"64","000","00","090","0002","1795","373","116","257","5","378","821","0","46.04","14.13"
"64","000","00","090","0002","1796","351","106","245","1","352","831","0","42.36","12.76"
"64","000","00","090","0002","1797","257","79","178","1","258","636","0","40.57","12.42"
"64","000","00","090","0003","0000","2219","708","1511","20","2239","4994","0","44.83","14.18"
"64","000","00","090","0003","1798","502","153","349","5","507","1106","0","45.84","13.83"
"64","000","00","090","0003","1799","442","152","290","5","447","1037","0","43.11","14.66"
"64","000","00","090","0003","1800","481","134","347","5","486","1066","0","45.59","12.57"
"64","000","00","090","0003","1801","341","117","224","1","342","718","0","47.63","16.30"
"64","000","00","090","0003","1802","453","152","301","4","457","1067","0","42.83","14.25"
"64","000","00","090","0004","0000","979","347","632","10","989","2203","0","44.89","15.75"
"64","000","00","090","0004","1803","476","202","274","5","481","1030","0","46.70","19.61"
"64","000","00","090","0004","1804","503","145","358","5","508","1173","0","43.31","12.36"
"64","000","00","090","0005","0000","567","161","406","6","573","1263","0","45.37","12.75"
"64","000","00","090","0005","1805","567","161","406","6","573","1263","0","45.37","12.75"
"64","000","00","090","0006","0000","732","284","448","7","739","1891","0","39.08","15.02"
"64","000","00","090","0006","1806","384","127","257","5","389","914","0","42.56","13.89"
"64","000","00","090","0006","1807","348","157","191","2","350","977","0","35.82","16.07"
"64","000","00","090","0007","0000","854","279","575","9","863","2883","0","29.93","9.68"
"64","000","00","090","0007","1808","477","146","331","8","485","1163","0","41.70","12.55"
"64","000","00","090","0007","1809","377","133","244","1","378","1720","0","21.98","7.73"
"64","000","00","090","0008","0000","243","55","188","4","247","606","0","40.76","9.08"
"64","000","00","090","0008","1810","243","55","188","4","247","606","0","40.76","9.08"
"64","000","00","090","0009","0000","622","156","466","11","633","1420","0","44.58","10.99"
"64","000","00","090","0009","1811","622","156","466","11","633","1420","0","44.58","10.99"
"64","000","00","090","0010","0000","635","180","455","5","640","1365","0","46.89","13.19"
"64","000","00","090","0010","1812","635","180","455","5","640","1365","0","46.89","13.19"
"64","000","00","090","0011","0000","916","305","611","7","923","2203","0","41.90","13.84"
"64","000","00","090","0011","1813","395","124","271","3","398","929","0","42.84","13.35"
"64","000","00","090","0011","1814","521","181","340","4","525","1274","0","41.21","14.21"
"64","000","00","090","0012","0000","446","125","321","3","449","1033","0","43.47","12.10"
"64","000","00","090","0012","1815","446","125","321","3","449","1033","0","43.47","12.10"
"64","000","00","090","0013","0000","315","98","217","2","317","656","0","48.32","14.94"
"64","000","00","090","0013","1816","315","98","217","2","317","656","0","48.32","14.94"
"64","000","00","090","0014","0000","310","69","241","1","311","673","0","46.21","10.25"
"64","000","00","090","0014","1817","310","69","241","1","311","673","0","46.21","10.25"
"64","000","00","090","0015","0000","597","175","422","7","604","1293","0","46.71","13.53"
"64","000","00","090","0015","1818","597","175","422","7","604","1293","0","46.71","13.53"
"64","000","00","090","0016","0000","830","239","591","6","836","1636","0","51.10","14.61"
"64","000","00","090","0016","1819","435","145","290","3","438","827","0","52.96","17.53"
"64","000","00","090","0016","1820","395","94","301","3","398","809","0","49.20","11.62"
"64","000","00","090","0017","0000","915","266","649","6","921","2041","0","45.12","13.03"
"64","000","00","090","0017","1821","469","137","332","5","474","1000","0","47.40","13.70"
"64","000","00","090","0017","1822","446","129","317","1","447","1041","0","42.94","12.39"
"64","000","00","090","0018","0000","851","267","584","13","864","1918","0","45.05","13.92"
"64","000","00","090","0018","1823","445","135","310","5","450","1022","0","44.03","13.21"
"64","000","00","090","0018","1824","406","132","274","8","414","896","0","46.21","14.73"
"64","000","00","090","0019","0000","1753","645","1108","11","1764","3979","0","44.33","16.21"
"64","000","00","090","0019","1825","544","178","366","5","549","1316","0","41.72","13.53"
"64","000","00","090","0019","1826","662","252","410","4","666","1396","0","47.71","18.05"
"64","000","00","090","0019","1827","547","215","332","2","549","1267","0","43.33","16.97"
"64","000","00","090","0020","0000","399","148","251","4","403","902","0","44.68","16.41"
"64","000","00","090","0020","1828","399","148","251","4","403","902","0","44.68","16.41"
"64","000","00","090","0021","0000","1250","558","692","7","1257","2779","0","45.23","20.08"
"64","000","00","090","0021","1829","648","304","344","4","652","1413","0","46.14","21.51"
"64","000","00","090","0021","1830","602","254","348","3","605","1366","0","44.29","18.59"
"64","000","00","090","0022","0000","367","130","237","0","367","802","0","45.76","16.21"
"64","000","00","090","0022","1831","367","130","237","0","367","802","0","45.76","16.21"
"64","000","00","090","0023","0000","495","175","320","10","505","1077","0","46.89","16.25"
"64","000","00","090","0023","1832","495","175","320","10","505","1077","0","46.89","16.25"
"64","000","00","090","0024","0000","2526","1751","775","24","2550","5166","0","49.36","33.89"
"64","000","00","090","0024","1833","616","527","89","13","629","1218","0","51.64","43.27"
"64","000","00","090","0024","1834","698","558","140","8","706","1393","0","50.68","40.06"
"64","000","00","090","0024","1835","546","393","153","2","548","1113","0","49.24","35.31"
"64","000","00","090","0024","1836","666","273","393","1","667","1442","0","46.26","18.93"
"64","000","00","090","0025","0000","985","809","176","13","998","1970","0","50.66","41.07"
"64","000","00","090","0025","1837","566","466","100","9","575","1023","0","56.21","45.55"
"64","000","00","090","0025","1838","419","343","76","4","423","947","0","44.67","36.22"
"64","000","00","090","0028","0000","1465","682","783","11","1476","3261","0","45.26","20.91"
"64","000","00","090","0028","1839","435","173","262","2","437","1006","0","43.44","17.20"
"64","000","00","090","0028","1840","511","242","269","3","514","1105","0","46.52","21.90"
"64","000","00","090","0028","1841","519","267","252","6","525","1150","0","45.65","23.22"
"64","000","00","090","0029","0000","1928","980","948","11","1939","3898","0","49.74","25.14"
"64","000","00","090","0029","1842","663","311","352","5","668","1253","0","53.31","24.82"
"64","000","00","090","0029","1843","692","357","335","2","694","1358","0","51.10","26.29"
"64","000","00","090","0029","1844","573","312","261","4","577","1287","0","44.83","24.24"
"64","000","00","090","0030","0000","586","266","320","6","592","1249","0","47.40","21.30"
"64","000","00","090","0030","1845","586","266","320","6","592","1249","0","47.40","21.30"
"64","000","00","090","0031","0000","1006","478","528","4","1010","2251","0","44.87","21.24"
"64","000","00","090","0031","1846","473","210","263","2","475","1077","0","44.10","19.50"
"64","000","00","090","0031","1847","533","268","265","2","535","1174","0","45.57","22.83"
"64","000","00","090","0032","0000","1358","715","643","4","1362","2750","0","49.53","26.00"
"64","000","00","090","0032","1848","718","359","359","3","721","1426","0","50.56","25.18"
"64","000","00","090","0032","1849","640","356","284","1","641","1324","0","48.41","26.89"
"64","000","00","090","0033","0000","905","332","573","8","913","2053","0","44.47","16.17"
"64","000","00","090","0033","1850","486","176","310","7","493","1007","0","48.96","17.48"
"64","000","00","090","0033","1851","419","156","263","1","420","1046","0","40.15","14.91"
"64","000","00","090","0034","0000","1109","546","563","4","1113","2633","0","42.27","20.74"
"64","000","00","090","0034","1852","587","303","284","3","590","1345","0","43.87","22.53"
"64","000","00","090","0034","1853","522","243","279","1","523","1288","0","40.61","18.87"
"64","000","00","090","0035","0000","1306","533","773","8","1314","2968","0","44.27","17.96"
"64","000","00","090","0035","1854","676","266","410","4","680","1474","0","46.13","18.05"
"64","000","00","090","0035","1855","630","267","363","4","634","1494","0","42.44","17.87"
"64","000","00","090","0036","0000","1299","550","749","11","1310","2985","0","43.89","18.43"
"64","000","00","090","0036","1856","472","207","265","3","475","1047","0","45.37","19.77"
"64","000","00","090","0036","1857","485","200","285","2","487","963","0","50.57","20.77"
"64","000","00","090","0036","1858","342","143","199","6","348","975","0","35.69","14.67"
"64","000","00","090","0037","0000","2489","1105","1384","16","2505","5492","0","45.61","20.12"
"64","000","00","090","0037","1859","597","220","377","5","602","1329","0","45.30","16.55"
"64","000","00","090","0037","1860","585","285","300","5","590","1249","0","47.24","22.82"
"64","000","00","090","0037","1861","627","247","380","2","629","1506","0","41.77","16.40"
"64","000","00","090","0037","1862","680","353","327","4","684","1408","0","48.58","25.07"
"64","000","00","090","0038","0000","1376","657","719","9","1385","2994","0","46.26","21.94"
"64","000","00","090","0038","1863","726","363","363","4","730","1606","0","45.45","22.60"
"64","000","00","090","0038","1864","650","294","356","5","655","1388","0","47.19","21.18"
"64","000","00","090","0039","0000","1175","442","733","11","1186","2585","0","45.88","17.10"
"64","000","00","090","0039","1865","541","176","365","4","545","1299","0","41.96","13.55"
"64","000","00","090","0039","1866","634","266","368","7","641","1286","0","49.84","20.68"
"64","000","00","090","0040","0000","1240","417","823","13","1253","2634","0","47.57","15.83"
"64","000","00","090","0040","1867","597","195","402","8","605","1323","0","45.73","14.74"
"64","000","00","090","0040","1868","643","222","421","5","648","1311","0","49.43","16.93"
"64","000","00","090","0041","0000","922","357","565","5","927","2104","0","44.06","16.97"
"64","000","00","090","0041","1869","433","165","268","2","435","1002","0","43.41","16.47"
"64","000","00","090","0041","1870","489","192","297","3","492","1102","0","44.65","17.42"
"64","000","00","090","0042","0000","2890","1273","1617","18","2908","6665","0","43.63","19.10"
"64","000","00","090","0042","1871","642","228","414","2","644","1470","0","43.81","15.51"
"64","000","00","090","0042","1872","665","265","400","8","673","1512","0","44.51","17.53"
"64","000","00","090","0042","1873","495","231","264","3","498","1038","0","47.98","22.25"
"64","000","00","090","0042","1874","575","275","300","2","577","1401","0","41.18","19.63"
"64","000","00","090","0042","1875","513","274","239","3","516","1244","0","41.48","22.03"
"64","000","00","090","0043","0000","1002","412","590","5","1007","2331","0","43.20","17.67"
"64","000","00","090","0043","1876","507","211","296","1","508","1111","0","45.72","18.99"
"64","000","00","090","0043","1877","495","201","294","4","499","1220","0","40.90","16.48"
"64","000","00","090","0044","0000","1828","788","1040","12","1840","3965","0","46.41","19.87"
"64","000","00","090","0044","1878","637","245","392","8","645","1382","0","46.67","17.73"
"64","000","00","090","0044","1879","614","247","367","1","615","1278","0","48.12","19.33"
"64","000","00","090","0044","1880","577","296","281","3","580","1305","0","44.44","22.68"
"64","000","00","090","0045","0000","1531","627","904","11","1542","3340","0","46.17","18.77"
"64","000","00","090","0045","1881","490","228","262","2","492","1172","0","41.98","19.45"
"64","000","00","090","0045","1882","467","187","280","5","472","977","0","48.31","19.14"
"64","000","00","090","0045","1883","574","212","362","4","578","1191","0","48.53","17.80"
"64","000","00","090","0046","0000","642","231","411","8","650","1563","0","41.59","14.78"
"64","000","00","090","0046","1884","360","105","255","6","366","822","0","44.53","12.77"
"64","000","00","090","0046","1885","282","126","156","2","284","741","0","38.33","17.00"
"64","000","00","090","0047","0000","1916","652","1264","11","1927","4567","0","42.19","14.28"
"64","000","00","090","0047","1886","406","127","279","1","407","1080","0","37.69","11.76"
"64","000","00","090","0047","1887","503","144","359","5","508","1224","0","41.50","11.76"
"64","000","00","090","0047","1888","426","143","283","1","427","963","0","44.34","14.85"
"64","000","00","090","0047","1889","581","238","343","4","585","1300","0","45.00","18.31"
"64","000","00","090","0048","0000","1084","391","693","10","1094","2650","0","41.28","14.75"
"64","000","00","090","0048","1890","548","195","353","4","552","1341","0","41.16","14.54"
"64","000","00","090","0048","1891","536","196","340","6","542","1309","0","41.41","14.97"
"64","000","00","090","0049","0000","1889","732","1157","14","1903","4492","0","42.36","16.30"
"64","000","00","090","0049","1892","440","158","282","4","444","1083","0","41.00","14.59"
"64","000","00","090","0049","1893","525","202","323","2","527","1254","0","42.03","16.11"
"64","000","00","090","0049","1894","441","172","269","4","445","1033","0","43.08","16.65"
"64","000","00","090","0049","1895","483","200","283","4","487","1122","0","43.40","17.83"
"64","000","00","090","0050","0000","942","307","635","3","945","2252","0","41.96","13.63"
"64","000","00","090","0050","1896","497","179","318","3","500","1202","0","41.60","14.89"
"64","000","00","090","0050","1897","445","128","317","0","445","1050","0","42.38","12.19"
"64","000","00","090","0051","0000","788","246","542","6","794","1810","0","43.87","13.59"
"64","000","00","090","0051","1898","404","136","268","4","408","933","0","43.73","14.58"
"64","000","00","090","0051","1899","384","110","274","2","386","877","0","44.01","12.54"
"64","000","00","090","0052","0000","1599","593","1006","13","1612","3473","0","46.42","17.07"
"64","000","00","090","0052","1900","554","193","361","4","558","1118","0","49.91","17.26"
"64","000","00","090","0052","1901","513","157","356","4","517","1067","0","48.45","14.71"
"64","000","00","090","0052","1902","532","243","289","5","537","1288","0","41.69","18.87"
"64","000","00","090","0053","0000","1491","525","966","14","1505","3408","0","44.16","15.40"
"64","000","00","090","0053","1903","498","157","341","6","504","1127","0","44.72","13.93"
"64","000","00","090","0053","1904","413","151","262","5","418","958","0","43.63","15.76"
"64","000","00","090","0053","1905","580","217","363","3","583","1323","0","44.07","16.40"
"64","000","00","090","0054","0000","1351","452","899","15","1366","3140","0","43.50","14.39"
"64","000","00","090","0054","1906","662","201","461","6","668","1547","0","43.18","12.99"
"64","000","00","090","0054","1907","689","251","438","9","698","1593","0","43.82","15.76"
"64","000","00","090","0055","0000","1062","302","760","11","1073","2484","0","43.20","12.16"
"64","000","00","090","0055","1908","519","161","358","4","523","1248","0","41.91","12.90"
"64","000","00","090","0055","1909","543","141","402","7","550","1236","0","44.50","11.41"
"64","000","00","090","0056","0000","1142","394","748","4","1146","2474","0","46.32","15.93"
"64","000","00","090","0056","1910","542","194","348","3","545","1138","0","47.89","17.05"
"64","000","00","090","0056","1911","600","200","400","1","601","1336","0","44.99","14.97"
"64","000","00","090","0057","0000","1083","339","744","4","1087","2446","0","44.44","13.86"
"64","000","00","090","0057","1912","541","174","367","1","542","1193","0","45.43","14.59"
"64","000","00","090","0057","1913","542","165","377","3","545","1253","0","43.50","13.17"
"64","000","00","090","0058","0000","1070","426","644","7","1077","2518","0","42.77","16.92"
"64","000","00","090","0058","1914","587","239","348","5","592","1338","0","44.25","17.86"
"64","000","00","090","0058","1915","483","187","296","2","485","1180","0","41.10","15.85"
"64","000","00","090","0059","0000","990","304","686","4","994","2355","0","42.21","12.91"
"64","000","00","090","0059","1916","465","154","311","4","469","1144","0","41.00","13.46"
"64","000","00","090","0059","1917","525","150","375","0","525","1211","0","43.35","12.39"
"64","000","00","090","0060","0000","1956","763","1193","12","1968","4394","0","44.79","17.36"
"64","000","00","090","0060","1918","603","261","342","3","606","1372","0","44.17","19.02"
"64","000","00","090","0060","1919","647","195","452","4","651","1456","0","44.71","13.39"
"64","000","00","090","0060","1920","706","307","399","5","711","1566","0","45.40","19.60"
"64","000","00","090","0061","0000","1314","415","899","10","1324","3072","0","43.10","13.51"
"64","000","00","090","0061","1921","394","127","267","3","397","970","0","40.93","13.09"
"64","000","00","090","0061","1922","407","98","309","3","410","911","0","45.01","10.76"
"64","000","00","090","0061","1923","513","190","323","4","517","1191","0","43.41","15.95"
"64","000","00","100","0000","0000","9204","2747","6457","80","9284","24346","27515","38.13","11.28"
"64","000","00","100","0001","0000","512","129","383","3","515","1181","0","43.61","10.92"
"64","000","00","100","0001","1767","512","129","383","3","515","1181","0","43.61","10.92"
"64","000","00","100","0002","0000","384","139","245","4","388","1056","0","36.74","13.16"
"64","000","00","100","0002","1768","384","139","245","4","388","1056","0","36.74","13.16"
"64","000","00","100","0003","0000","620","171","449","8","628","1544","0","40.67","11.08"
"64","000","00","100","0003","1769","620","171","449","8","628","1544","0","40.67","11.08"
"64","000","00","100","0004","0000","789","233","556","6","795","2240","0","35.49","10.40"
"64","000","00","100","0004","1770","415","141","274","5","420","1157","0","36.30","12.19"
"64","000","00","100","0004","1771","374","92","282","1","375","1083","0","34.63","8.49"
"64","000","00","100","0005","0000","991","413","578","10","1001","2922","0","34.26","14.13"
"64","000","00","100","0005","1772","487","180","307","2","489","1437","0","34.03","12.53"
"64","000","00","100","0005","1773","504","233","271","8","512","1485","0","34.48","15.69"
"64","000","00","100","0006","0000","636","177","459","5","641","1497","0","42.82","11.82"
"64","000","00","100","0006","1774","636","177","459","5","641","1497","0","42.82","11.82"
"64","000","00","100","0007","0000","506","302","204","7","513","1394","0","36.80","21.66"
"64","000","00","100","0007","1775","506","302","204","7","513","1394","0","36.80","21.66"
"64","000","00","100","0008","0000","871","279","592","7","878","2620","0","33.51","10.65"
"64","000","00","100","0008","1776","422","149","273","5","427","1346","0","31.72","11.07"
"64","000","00","100","0008","1777","449","130","319","2","451","1274","0","35.40","10.20"
"64","000","00","100","0009","0000","779","193","586","9","788","2021","0","38.99","9.55"
"64","000","00","100","0009","1778","357","104","253","3","360","952","0","37.82","10.92"
"64","000","00","100","0009","1779","422","89","333","6","428","1069","0","40.04","8.33"
"64","000","00","100","0010","0000","1030","211","819","12","1042","2749","0","37.90","7.68"
"64","000","00","100","0010","1780","427","83","344","7","434","1092","0","39.74","7.60"
"64","000","00","100","0010","1781","603","128","475","5","608","1657","0","36.69","7.72"
"64","000","00","100","0011","0000","742","194","548","2","744","1802","0","41.29","10.77"
"64","000","00","100","0011","1782","445","113","332","0","445","1033","0","43.08","10.94"
"64","000","00","100","0011","1783","297","81","216","2","299","769","0","38.88","10.53"
"64","000","00","100","0012","0000","332","61","271","0","332","863","0","38.47","7.07"
"64","000","00","100","0012","1784","332","61","271","0","332","863","0","38.47","7.07"
"64","000","00","100","0013","0000","1012","245","767","7","1019","2457","0","41.47","9.97"
"64","000","00","100","0013","1785","534","112","422","0","534","1184","0","45.10","9.46"
"64","000","00","100","0013","1786","478","133","345","7","485","1273","0","38.10","10.45"
"64","000","00","110","0000","0000","52883","19542","33341","391","53274","132828","156580","40.11","14.71"
"64","000","00","110","0001","0000","978","366","612","9","987","2204","0","44.78","16.61"
"64","000","00","110","0001","1924","519","236","283","6","525","1075","0","48.84","21.95"
"64","000","00","110","0001","1925","459","130","329","3","462","1129","0","40.92","11.51"
"64","000","00","110","0002","0000","1374","626","748","7","1381","3080","0","44.84","20.32"
"64","000","00","110","0002","1926","720","333","387","1","721","1483","0","48.62","22.45"
"64","000","00","110","0002","1927","654","293","361","6","660","1597","0","41.33","18.35"
"64","000","00","110","0003","0000","998","475","523","8","1006","2455","0","40.98","19.35"
"64","000","00","110","0003","1928","459","249","210","0","459","1061","0","43.26","23.47"
"64","000","00","110","0003","1929","539","226","313","8","547","1394","0","39.24","16.21"
"64","000","00","110","0004","0000","655","248","407","5","660","1658","0","39.81","14.96"
"64","000","00","110","0004","1930","655","248","407","5","660","1658","0","39.81","14.96"
"64","000","00","110","0005","0000","1118","407","711","12","1130","3006","0","37.59","13.54"
"64","000","00","110","0005","1931","592","192","400","4","596","1561","0","38.18","12.30"
"64","000","00","110","0005","1932","526","215","311","8","534","1445","0","36.96","14.88"
"64","000","00","110","0006","0000","1090","394","696","5","1095","2482","0","44.12","15.87"
"64","000","00","110","0006","1933","514","173","341","2","516","1158","0","44.56","14.94"
"64","000","00","110","0006","1934","576","221","355","3","579","1324","0","43.73","16.69"
"64","000","00","110","0007","0000","900","338","562","4","904","2715","0","33.30","12.45"
"64","000","00","110","0007","1935","384","140","244","2","386","1434","0","26.92","9.76"
"64","000","00","110","0007","1936","516","198","318","2","518","1281","0","40.44","15.46"
"64","000","00","110","0008","0000","1013","369","644","7","1020","2209","0","46.17","16.70"
"64","000","00","110","0008","1937","541","200","341","5","546","1146","0","47.64","17.45"
"64","000","00","110","0008","1938","472","169","303","2","474","1063","0","44.59","15.90"
"64","000","00","110","0009","0000","995","332","663","4","999","2601","0","38.41","12.76"
"64","000","00","110","0009","1939","536","184","352","2","538","1405","0","38.29","13.10"
"64","000","00","110","0009","1940","459","148","311","2","461","1196","0","38.55","12.37"
"64","000","00","110","0010","0000","2247","796","1451","20","2267","5620","0","40.34","14.16"
"64","000","00","110","0010","1941","650","206","444","5","655","1560","0","41.99","13.21"
"64","000","00","110","0010","1942","483","163","320","7","490","1215","0","40.33","13.42"
"64","000","00","110","0010","1943","506","199","307","4","510","1422","0","35.86","13.99"
"64","000","00","110","0010","1944","608","228","380","4","612","1423","0","43.01","16.02"
"64","000","00","110","0011","0000","1051","413","638","10","1061","2419","0","43.86","17.07"
"64","000","00","110","0011","1945","507","200","307","3","510","1183","0","43.11","16.91"
"64","000","00","110","0011","1946","544","213","331","7","551","1236","0","44.58","17.23"
"64","000","00","110","0012","0000","1417","461","956","6","1423","3563","0","39.94","12.94"
"64","000","00","110","0012","1947","508","182","326","3","511","1301","0","39.28","13.99"
"64","000","00","110","0012","1948","453","151","302","1","454","1118","0","40.61","13.51"
"64","000","00","110","0012","1949","456","128","328","2","458","1144","0","40.03","11.19"
"64","000","00","110","0013","0000","1188","452","736","7","1195","2779","0","43.00","16.26"
"64","000","00","110","0013","1950","555","209","346","2","557","1394","0","39.96","14.99"
"64","000","00","110","0013","1951","633","243","390","5","638","1385","0","46.06","17.55"
"64","000","00","110","0014","0000","1467","616","851","16","1483","3906","0","37.97","15.77"
"64","000","00","110","0014","1952","506","219","287","2","508","1387","0","36.63","15.79"
"64","000","00","110","0014","1953","469","201","268","9","478","1227","0","38.96","16.38"
"64","000","00","110","0014","1954","492","196","296","5","497","1292","0","38.47","15.17"
"64","000","00","110","0015","0000","1722","691","1031","9","1731","4344","0","39.85","15.91"
"64","000","00","110","0015","1955","595","214","381","3","598","1495","0","40.00","14.31"
"64","000","00","110","0015","1956","561","224","337","4","565","1437","0","39.32","15.59"
"64","000","00","110","0015","1957","566","253","313","2","568","1412","0","40.23","17.92"
"64","000","00","110","0016","0000","1084","409","675","8","1092","2502","0","43.65","16.35"
"64","000","00","110","0016","1958","506","161","345","3","509","1227","0","41.48","13.12"
"64","000","00","110","0016","1959","578","248","330","5","583","1275","0","45.73","19.45"
"64","000","00","110","0017","0000","1212","466","746","6","1218","3165","0","38.48","14.72"
"64","000","00","110","0017","1960","608","255","353","3","611","1609","0","37.97","15.85"
"64","000","00","110","0017","1961","604","211","393","3","607","1556","0","39.01","13.56"
"64","000","00","110","0018","0000","1143","531","612","5","1148","2869","0","40.01","18.51"
"64","000","00","110","0018","1962","573","249","324","4","577","1423","0","40.55","17.50"
"64","000","00","110","0018","1963","570","282","288","1","571","1446","0","39.49","19.50"
"64","000","00","110","0019","0000","1007","605","402","8","1015","2305","0","44.03","26.25"
"64","000","00","110","0019","1964","498","331","167","7","505","1078","0","46.85","30.71"
"64","000","00","110","0019","1965","509","274","235","1","510","1227","0","41.56","22.33"
"64","000","00","110","0020","0000","1666","780","886","10","1676","4066","0","41.22","19.18"
"64","000","00","110","0020","1966","634","304","330","3","637","1441","0","44.21","21.10"
"64","000","00","110","0020","1967","576","281","295","3","579","1435","0","40.35","19.58"
"64","000","00","110","0020","1968","456","195","261","4","460","1190","0","38.66","16.39"
"64","000","00","110","0021","0000","1335","484","851","9","1344","3176","0","42.32","15.24"
"64","000","00","110","0021","1969","667","247","420","4","671","1549","0","43.32","15.95"
"64","000","00","110","0021","1970","668","237","431","5","673","1627","0","41.36","14.57"
"64","000","00","110","0022","0000","4227","1476","2751","32","4259","11217","0","37.97","13.16"
"64","000","00","110","0022","1971","440","139","301","2","442","1297","0","34.08","10.72"
"64","000","00","110","0022","1972","582","210","372","3","585","1352","0","43.27","15.53"
"64","000","00","110","0022","1973","517","172","345","4","521","1327","0","39.26","12.96"
"64","000","00","110","0022","1974","629","225","404","3","632","1605","0","39.38","14.02"
"64","000","00","110","0022","1975","510","158","352","6","516","1266","0","40.76","12.48"
"64","000","00","110","0022","1976","472","189","283","2","474","1322","0","35.85","14.30"
"64","000","00","110","0022","1977","559","174","385","8","567","1404","0","40.38","12.39"
"64","000","00","110","0022","1978","518","209","309","4","522","1644","0","31.75","12.71"
"64","000","00","110","0023","0000","1592","565","1027","14","1606","4154","0","38.66","13.60"
"64","000","00","110","0023","1979","466","170","296","4","470","1296","0","36.27","13.12"
"64","000","00","110","0023","1980","583","201","382","4","587","1467","0","40.01","13.70"
"64","000","00","110","0023","1981","543","194","349","6","549","1391","0","39.47","13.95"
"64","000","00","110","0024","0000","1004","347","657","8","1012","2549","0","39.70","13.61"
"64","000","00","110","0024","1982","478","173","305","3","481","1207","0","39.85","14.33"
"64","000","00","110","0024","1983","526","174","352","5","531","1342","0","39.57","12.97"
"64","000","00","110","0025","0000","1330","527","803","12","1342","3066","0","43.77","17.19"
"64","000","00","110","0025","1984","734","279","455","2","736","1598","0","46.06","17.46"
"64","000","00","110","0025","1985","596","248","348","10","606","1468","0","41.28","16.89"
"64","000","00","110","0026","0000","1117","384","733","11","1128","2844","0","39.66","13.50"
"64","000","00","110","0026","1986","531","164","367","7","538","1262","0","42.63","13.00"
"64","000","00","110","0026","1987","586","220","366","4","590","1582","0","37.29","13.91"
"64","000","00","110","0027","0000","2186","767","1419","12","2198","6006","0","36.60","12.77"
"64","000","00","110","0027","1988","485","156","329","6","491","1214","0","40.44","12.85"
"64","000","00","110","0027","1989","403","140","263","0","403","1201","0","33.56","11.66"
"64","000","00","110","0027","1990","493","170","323","3","496","1181","0","42.00","14.39"
"64","000","00","110","0027","1991","325","110","215","0","325","1036","0","31.37","10.62"
"64","000","00","110","0027","1992","480","191","289","3","483","1374","0","35.15","13.90"
"64","000","00","110","0028","0000","1930","704","1226","19","1949","4655","0","41.87","15.12"
"64","000","00","110","0028","1993","609","190","419","3","612","1210","0","50.58","15.70"
"64","000","00","110","0028","1994","472","162","310","4","476","1209","0","39.37","13.40"
"64","000","00","110","0028","1995","484","219","265","9","493","1244","0","39.63","17.60"
"64","000","00","110","0028","1996","365","133","232","3","368","992","0","37.10","13.41"
"64","000","00","110","0029","0000","1478","577","901","18","1496","3839","0","38.97","15.03"
"64","000","00","110","0029","1997","551","234","317","7","558","1396","0","39.97","16.76"
"64","000","00","110","0029","1998","486","142","344","7","493","1096","0","44.98","12.96"
"64","000","00","110","0029","1999","441","201","240","4","445","1347","0","33.04","14.92"
"64","000","00","110","0030","0000","1147","400","747","4","1151","2569","0","44.80","15.57"
"64","000","00","110","0030","2000","542","192","350","1","543","1179","0","46.06","16.28"
"64","000","00","110","0030","2001","605","208","397","3","608","1390","0","43.74","14.96"
"64","000","00","110","0031","0000","3077","1075","2002","17","3094","7687","0","40.25","13.98"
"64","000","00","110","0031","2002","601","158","443","3","604","1467","0","41.17","10.77"
"64","000","00","110","0031","2003","646","230","416","6","652","1572","0","41.48","14.63"
"64","000","00","110","0031","2004","626","230","396","4","630","1545","0","40.78","14.89"
"64","000","00","110","0031","2005","586","225","361","2","588","1512","0","38.89","14.88"
"64","000","00","110","0031","2006","618","232","386","2","620","1591","0","38.97","14.58"
"64","000","00","110","0032","0000","1359","500","859","12","1371","3630","0","37.77","13.77"
"64","000","00","110","0032","2007","423","151","272","4","427","1076","0","39.68","14.03"
"64","000","00","110","0032","2008","502","176","326","6","508","1356","0","37.46","12.98"
"64","000","00","110","0032","2009","434","173","261","2","436","1198","0","36.39","14.44"
"64","000","00","110","0033","0000","1215","423","792","14","1229","3132","0","39.24","13.51"
"64","000","00","110","0033","2010","561","197","364","10","571","1415","0","40.35","13.92"
"64","000","00","110","0033","2011","654","226","428","4","658","1717","0","38.32","13.16"
"64","000","00","110","0034","0000","1188","398","790","9","1197","3059","0","39.13","13.01"
"64","000","00","110","0034","2012","588","173","415","8","596","1505","0","39.60","11.50"
"64","000","00","110","0034","2013","600","225","375","1","601","1554","0","38.67","14.48"
"64","000","00","110","0035","0000","896","232","664","8","904","2196","0","41.17","10.56"
"64","000","00","110","0035","2014","435","92","343","6","441","1069","0","41.25","8.61"
"64","000","00","110","0035","2015","461","140","321","2","463","1127","0","41.08","12.42"
"64","000","00","110","0036","0000","1208","334","874","6","1214","3013","0","40.29","11.09"
"64","000","00","110","0036","2016","611","167","444","4","615","1475","0","41.69","11.32"
"64","000","00","110","0036","2017","597","167","430","2","599","1538","0","38.95","10.86"
"64","000","00","110","0037","0000","929","265","664","6","935","2483","0","37.66","10.67"
"64","000","00","110","0037","2018","493","151","342","2","495","1249","0","39.63","12.09"
"64","000","00","110","0037","2019","436","114","322","4","440","1234","0","35.66","9.24"
"64","000","00","110","0038","0000","1340","309","1031","14","1354","3605","0","37.56","8.57"
"64","000","00","110","0038","2020","440","111","329","5","445","1067","0","41.71","10.40"
"64","000","00","110","0038","2021","471","107","364","4","475","1292","0","36.76","8.28"
"64","000","00","110","0038","2022","429","91","338","5","434","1246","0","34.83","7.30"
"64","000","00","120","0000","0000","127633","54984","72649","912","128545","302069","358785","42.55","18.20"
"64","000","00","120","0001","0000","174","72","102","2","176","406","0","43.35","17.73"
"64","000","00","120","0001","1587","174","72","102","2","176","406","0","43.35","17.73"
"64","000","00","120","0002","0000","280","104","176","1","281","599","0","46.91","17.36"
"64","000","00","120","0002","1586","280","104","176","1","281","599","0","46.91","17.36"
"64","000","00","120","0003","0000","573","215","358","5","578","1288","0","44.88","16.69"
"64","000","00","120","0003","1588","573","215","358","5","578","1288","0","44.88","16.69"
"64","000","00","120","0004","0000","428","220","208","2","430","847","0","50.77","25.97"
"64","000","00","120","0004","1601","428","220","208","2","430","847","0","50.77","25.97"
"64","000","00","120","0005","0000","414","162","252","1","415","864","0","48.03","18.75"
"64","000","00","120","0005","1594","414","162","252","1","415","864","0","48.03","18.75"
"64","000","00","120","0006","0000","967","445","522","3","970","2199","0","44.11","20.24"
"64","000","00","120","0006","1589","351","157","194","2","353","712","0","49.58","22.05"
"64","000","00","120","0006","1590","616","288","328","1","617","1487","0","41.49","19.37"
"64","000","00","120","0007","0000","490","244","246","4","494","1023","0","48.29","23.85"
"64","000","00","120","0007","1535","490","244","246","4","494","1023","0","48.29","23.85"
"64","000","00","120","0008","0000","1587","811","776","13","1600","3304","0","48.43","24.55"
"64","000","00","120","0008","1614","539","233","306","5","544","1132","0","48.06","20.58"
"64","000","00","120","0008","1615","504","300","204","5","509","1118","0","45.53","26.83"
"64","000","00","120","0008","1616","544","278","266","3","547","1054","0","51.90","26.38"
"64","000","00","120","0009","0000","3713","1483","2230","31","3744","10134","0","36.94","14.63"
"64","000","00","120","0009","1546","611","217","394","9","620","1472","0","42.12","14.74"
"64","000","00","120","0009","1547","447","174","273","1","448","1439","0","31.13","12.09"
"64","000","00","120","0009","1548","636","283","353","2","638","1718","0","37.14","16.47"
"64","000","00","120","0009","1549","411","167","244","6","417","1249","0","33.39","13.37"
"64","000","00","120","0009","1550","520","205","315","2","522","1462","0","35.70","14.02"
"64","000","00","120","0009","1551","441","199","242","5","446","1360","0","32.79","14.63"
"64","000","00","120","0009","1552","647","238","409","6","653","1434","0","45.54","16.60"
"64","000","00","120","0010","0000","359","169","190","2","361","800","0","45.13","21.13"
"64","000","00","120","0010","1536","359","169","190","2","361","800","0","45.13","21.13"
"64","000","00","120","0011","0000","1515","616","899","7","1522","3583","0","42.48","17.19"
"64","000","00","120","0011","1557","556","178","378","4","560","1263","0","44.34","14.09"
"64","000","00","120","0011","1558","471","197","274","0","471","1071","0","43.98","18.39"
"64","000","00","120","0011","1559","488","241","247","3","491","1249","0","39.31","19.30"
"64","000","00","120","0012","0000","2155","917","1238","18","2173","4831","0","44.98","18.98"
"64","000","00","120","0012","1539","541","244","297","2","543","1150","0","47.22","21.22"
"64","000","00","120","0012","1540","523","204","319","7","530","1202","0","44.09","16.97"
"64","000","00","120","0012","1541","568","231","337","5","573","1306","0","43.87","17.69"
"64","000","00","120","0012","1542","523","238","285","4","527","1173","0","44.93","20.29"
"64","000","00","120","0013","0000","953","397","556","6","959","2419","0","39.64","16.41"
"64","000","00","120","0013","1622","474","218","256","5","479","1268","0","37.78","17.19"
"64","000","00","120","0013","1623","479","179","300","1","480","1151","0","41.70","15.55"
"64","000","00","120","0014","0000","2513","1212","1301","11","2524","5862","0","43.06","20.68"
"64","000","00","120","0014","1645","637","247","390","0","637","1501","0","42.44","16.46"
"64","000","00","120","0014","1646","550","228","322","3","553","1355","0","40.81","16.83"
"64","000","00","120","0014","1647","653","360","293","2","655","1511","0","43.35","23.83"
"64","000","00","120","0014","1648","673","377","296","6","679","1495","0","45.42","25.22"
"64","000","00","120","0015","0000","1872","1507","365","20","1892","4101","0","46.14","36.75"
"64","000","00","120","0015","1649","509","335","174","6","515","1178","0","43.72","28.44"
"64","000","00","120","0015","1650","690","578","112","6","696","1617","0","43.04","35.75"
"64","000","00","120","0015","1651","673","594","79","8","681","1306","0","52.14","45.48"
"64","000","00","120","0016","0000","1969","730","1239","18","1987","4690","0","42.37","15.57"
"64","000","00","120","0016","1729","551","206","345","4","555","1243","0","44.65","16.57"
"64","000","00","120","0016","1730","421","173","248","4","425","980","0","43.37","17.65"
"64","000","00","120","0016","1731","511","189","322","4","515","1337","0","38.52","14.14"
"64","000","00","120","0016","1732","486","162","324","6","492","1130","0","43.54","14.34"
"64","000","00","120","0017","0000","2795","932","1863","17","2812","6676","0","42.12","13.96"
"64","000","00","120","0017","1690","552","187","365","0","552","1280","0","43.13","14.61"
"64","000","00","120","0017","1691","677","230","447","4","681","1584","0","42.99","14.52"
"64","000","00","120","0017","1692","683","225","458","6","689","1622","0","42.48","13.87"
"64","000","00","120","0017","1693","446","150","296","4","450","1137","0","39.58","13.19"
"64","000","00","120","0017","1694","437","140","297","3","440","1053","0","41.79","13.30"
"64","000","00","120","0018","0000","2122","1001","1121","13","2135","5045","0","42.32","19.84"
"64","000","00","120","0018","1624","517","225","292","4","521","1193","0","43.67","18.86"
"64","000","00","120","0018","1625","509","234","275","2","511","1197","0","42.69","19.55"
"64","000","00","120","0018","1626","525","288","237","2","527","1285","0","41.01","22.41"
"64","000","00","120","0018","1627","571","254","317","5","576","1370","0","42.04","18.54"
"64","000","00","120","0019","0000","2051","971","1080","17","2068","4468","0","46.28","21.73"
"64","000","00","120","0019","1605","426","199","227","3","429","951","0","45.11","20.93"
"64","000","00","120","0019","1606","402","192","210","5","407","939","0","43.34","20.45"
"64","000","00","120","0019","1607","539","310","229","2","541","1243","0","43.52","24.94"
"64","000","00","120","0019","1608","684","270","414","7","691","1335","0","51.76","20.22"
"64","000","00","120","0020","0000","1686","883","803","11","1697","3708","0","45.77","23.81"
"64","000","00","120","0020","1617","539","264","275","2","541","1210","0","44.71","21.82"
"64","000","00","120","0020","1618","609","334","275","5","614","1259","0","48.77","26.53"
"64","000","00","120","0020","1619","538","285","253","4","542","1239","0","43.74","23.00"
"64","000","00","120","0021","0000","715","274","441","4","719","3408","0","21.10","8.04"
"64","000","00","120","0021","1596","510","179","331","3","513","1041","0","49.28","17.20"
"64","000","00","120","0021","1597","205","95","110","1","206","2367","0","8.70","4.01"
"64","000","00","120","0022","0000","1257","707","550","7","1264","2855","0","44.27","24.76"
"64","000","00","120","0022","1652","590","328","262","3","593","1352","0","43.86","24.26"
"64","000","00","120","0022","1653","667","379","288","4","671","1503","0","44.64","25.22"
"64","000","00","120","0024","0000","1494","560","934","10","1504","3386","0","44.42","16.54"
"64","000","00","120","0024","1555","698","238","460","5","703","1628","0","43.18","14.62"
"64","000","00","120","0024","1556","796","322","474","5","801","1758","0","45.56","18.32"
"64","000","00","120","0025","0000","1339","516","823","15","1354","2970","0","45.59","17.37"
"64","000","00","120","0025","1670","691","267","424","7","698","1474","0","47.35","18.11"
"64","000","00","120","0025","1671","648","249","399","8","656","1496","0","43.85","16.64"
"64","000","00","120","0026","0000","2008","769","1239","11","2019","4656","0","43.36","16.52"
"64","000","00","120","0026","1666","423","153","270","5","428","952","0","44.96","16.07"
"64","000","00","120","0026","1667","533","197","336","3","536","1185","0","45.23","16.62"
"64","000","00","120","0026","1668","491","194","297","1","492","1155","0","42.60","16.80"
"64","000","00","120","0026","1669","561","225","336","2","563","1364","0","41.28","16.50"
"64","000","00","120","0027","0000","2609","886","1723","22","2631","6047","0","43.51","14.65"
"64","000","00","120","0027","1711","551","218","333","9","560","1375","0","40.73","15.85"
"64","000","00","120","0027","1712","471","138","333","1","472","1070","0","44.11","12.90"
"64","000","00","120","0027","1713","546","184","362","4","550","1212","0","45.38","15.18"
"64","000","00","120","0027","1714","486","159","327","4","490","1194","0","41.04","13.32"
"64","000","00","120","0027","1715","555","187","368","4","559","1196","0","46.74","15.64"
"64","000","00","120","0028","0000","1257","397","860","12","1269","3158","0","40.18","12.57"
"64","000","00","120","0028","1721","363","100","263","3","366","905","0","40.44","11.05"
"64","000","00","120","0028","1722","472","150","322","8","480","1177","0","40.78","12.74"
"64","000","00","120","0028","1723","422","147","275","1","423","1076","0","39.31","13.66"
"64","000","00","120","0029","0000","2330","791","1539","21","2351","5638","0","41.70","14.03"
"64","000","00","120","0029","1757","440","164","276","1","441","984","0","44.82","16.67"
"64","000","00","120","0029","1758","464","156","308","5","469","1089","0","43.07","14.33"
"64","000","00","120","0029","1759","521","160","361","5","526","1250","0","42.08","12.80"
"64","000","00","120","0029","1760","496","161","335","7","503","1229","0","40.93","13.10"
"64","000","00","120","0029","1761","409","150","259","3","412","1086","0","37.94","13.81"
"64","000","00","120","0030","0000","2221","1225","996","20","2241","5295","0","42.32","23.14"
"64","000","00","120","0030","1631","493","237","256","6","499","1355","0","36.83","17.49"
"64","000","00","120","0030","1632","620","490","130","7","627","1247","0","50.28","39.29"
"64","000","00","120","0030","1633","520","250","270","2","522","1273","0","41.01","19.64"
"64","000","00","120","0030","1634","588","248","340","5","593","1420","0","41.76","17.46"
"64","000","00","120","0031","0000","2012","1034","978","20","2032","4791","0","42.41","21.58"
"64","000","00","120","0031","1628","632","308","324","8","640","1497","0","42.75","20.57"
"64","000","00","120","0031","1629","598","368","230","7","605","1565","0","38.66","23.51"
"64","000","00","120","0031","1630","782","358","424","5","787","1729","0","45.52","20.71"
"64","000","00","120","0032","0000","1504","536","968","9","1513","3443","0","43.94","15.57"
"64","000","00","120","0032","1749","501","171","330","3","504","1117","0","45.12","15.31"
"64","000","00","120","0032","1750","502","201","301","2","504","1176","0","42.86","17.09"
"64","000","00","120","0032","1751","501","164","337","4","505","1150","0","43.91","14.26"
"64","000","00","120","0033","0000","2310","945","1365","10","2320","5183","0","44.76","18.23"
"64","000","00","120","0033","1680","603","220","383","4","607","1404","0","43.23","15.67"
"64","000","00","120","0033","1681","506","190","316","1","507","1188","0","42.68","15.99"
"64","000","00","120","0033","1682","650","264","386","3","653","1422","0","45.92","18.57"
"64","000","00","120","0033","1683","551","271","280","2","553","1169","0","47.31","23.18"
"64","000","00","120","0034","0000","1593","705","888","10","1603","3682","0","43.54","19.15"
"64","000","00","120","0034","1654","494","212","282","4","498","1162","0","42.86","18.24"
"64","000","00","120","0034","1655","525","240","285","4","529","1201","0","44.05","19.98"
"64","000","00","120","0034","1656","574","253","321","2","576","1319","0","43.67","19.18"
"64","000","00","120","0035","0000","2678","1172","1506","20","2698","6156","0","43.83","19.04"
"64","000","00","120","0035","1641","628","267","361","7","635","1397","0","45.45","19.11"
"64","000","00","120","0035","1642","674","270","404","5","679","1578","0","43.03","17.11"
"64","000","00","120","0035","1643","657","300","357","4","661","1528","0","43.26","19.63"
"64","000","00","120","0035","1644","719","335","384","4","723","1653","0","43.74","20.27"
"64","000","00","120","0036","0000","1645","753","892","9","1654","3986","0","41.50","18.89"
"64","000","00","120","0036","1687","484","310","174","2","486","1195","0","40.67","25.94"
"64","000","00","120","0036","1688","562","175","387","4","566","1318","0","42.94","13.28"
"64","000","00","120","0036","1689","599","268","331","3","602","1473","0","40.87","18.19"
"64","000","00","120","0037","0000","1479","675","804","9","1488","3202","0","46.47","21.08"
"64","000","00","120","0037","1657","484","222","262","2","486","1074","0","45.25","20.67"
"64","000","00","120","0037","1658","504","221","283","6","510","1110","0","45.95","19.91"
"64","000","00","120","0037","1659","491","232","259","1","492","1018","0","48.33","22.79"
"64","000","00","120","0038","0000","1066","356","710","7","1073","2412","0","44.49","14.76"
"64","000","00","120","0038","1660","534","169","365","6","540","1177","0","45.88","14.36"
"64","000","00","120","0038","1661","532","187","345","1","533","1235","0","43.16","15.14"
"64","000","00","120","0039","0000","3796","1861","1935","19","3815","8807","0","43.32","21.13"
"64","000","00","120","0039","1571","630","317","313","2","632","1397","0","45.24","22.69"
"64","000","00","120","0039","1572","650","367","283","5","655","1414","0","46.32","25.95"
"64","000","00","120","0039","1573","621","279","342","1","622","1444","0","43.07","19.32"
"64","000","00","120","0039","1574","648","316","332","8","656","1536","0","42.71","20.57"
"64","000","00","120","0039","1575","603","271","332","2","605","1525","0","39.67","17.77"
"64","000","00","120","0039","1576","644","311","333","1","645","1491","0","43.26","20.86"
"64","000","00","120","0040","0000","5110","2093","3017","21","5131","13720","0","37.40","15.26"
"64","000","00","120","0040","1703","629","237","392","1","630","1730","0","36.42","13.70"
"64","000","00","120","0040","1704","622","254","368","0","622","1675","0","37.13","15.16"
"64","000","00","120","0040","1705","658","266","392","3","661","1703","0","38.81","15.62"
"64","000","00","120","0040","1706","613","210","403","5","618","1703","0","36.29","12.33"
"64","000","00","120","0040","1707","619","303","316","4","623","1713","0","36.37","17.69"
"64","000","00","120","0040","1708","672","315","357","2","674","1734","0","38.87","18.17"
"64","000","00","120","0040","1709","663","276","387","2","665","1668","0","39.87","16.55"
"64","000","00","120","0040","1710","634","232","402","4","638","1794","0","35.56","12.93"
"64","000","00","120","0041","0000","875","416","459","8","883","1878","0","47.02","22.15"
"64","000","00","120","0041","1537","413","191","222","3","416","845","0","49.23","22.60"
"64","000","00","120","0041","1538","462","225","237","5","467","1033","0","45.21","21.78"
"64","000","00","120","0042","0000","1516","663","853","15","1531","3300","0","46.39","20.09"
"64","000","00","120","0042","1598","479","247","232","2","481","1073","0","44.83","23.02"
"64","000","00","120","0042","1599","526","212","314","6","532","1112","0","47.84","19.06"
"64","000","00","120","0042","1600","511","204","307","7","518","1115","0","46.46","18.30"
"64","000","00","120","0043","0000","1322","487","835","11","1333","2954","0","45.13","16.49"
"64","000","00","120","0043","1755","695","255","440","5","700","1515","0","46.20","16.83"
"64","000","00","120","0043","1756","627","232","395","6","633","1439","0","43.99","16.12"
"64","000","00","120","0044","0000","2446","1140","1306","13","2459","5599","0","43.92","20.36"
"64","000","00","120","0044","1609","473","191","282","2","475","1162","0","40.88","16.44"
"64","000","00","120","0044","1610","437","205","232","3","440","983","0","44.76","20.85"
"64","000","00","120","0044","1611","480","238","242","1","481","1095","0","43.93","21.74"
"64","000","00","120","0044","1612","577","273","304","3","580","1305","0","44.44","20.92"
"64","000","00","120","0044","1613","479","233","246","4","483","1054","0","45.83","22.11"
"64","000","00","120","0045","0000","890","498","392","9","899","1995","0","45.06","24.96"
"64","000","00","120","0045","1620","470","269","201","3","473","1017","0","46.51","26.45"
"64","000","00","120","0045","1621","420","229","191","6","426","978","0","43.56","23.42"
"64","000","00","120","0046","0000","2039","878","1161","17","2056","4606","0","44.64","19.06"
"64","000","00","120","0046","1591","713","298","415","4","717","1536","0","46.68","19.40"
"64","000","00","120","0046","1592","662","282","380","8","670","1542","0","43.45","18.29"
"64","000","00","120","0046","1593","664","298","366","5","669","1528","0","43.78","19.50"
"64","000","00","120","0047","0000","1472","801","671","9","1481","3154","0","46.96","25.40"
"64","000","00","120","0047","1602","466","208","258","3","469","997","0","47.04","20.86"
"64","000","00","120","0047","1603","469","296","173","1","470","1011","0","46.49","29.28"
"64","000","00","120","0047","1604","537","297","240","5","542","1146","0","47.29","25.92"
"64","000","00","120","0048","0000","2714","1058","1656","19","2733","6154","0","44.41","17.19"
"64","000","00","120","0048","1566","529","204","325","4","533","1297","0","41.09","15.73"
"64","000","00","120","0048","1567","661","266","395","2","663","1505","0","44.05","17.67"
"64","000","00","120","0048","1568","469","148","321","4","473","1044","0","45.31","14.18"
"64","000","00","120","0048","1569","551","185","366","6","557","1215","0","45.84","15.23"
"64","000","00","120","0048","1570","504","255","249","3","507","1093","0","46.39","23.33"
"64","000","00","120","0049","0000","1961","741","1220","19","1980","4554","0","43.48","16.27"
"64","000","00","120","0049","1764","641","246","395","6","647","1464","0","44.19","16.80"
"64","000","00","120","0049","1765","665","297","368","4","669","1625","0","41.17","18.28"
"64","000","00","120","0049","1766","655","198","457","9","664","1465","0","45.32","13.52"
"64","000","00","120","0050","0000","1008","556","452","17","1025","2537","0","40.40","21.92"
"64","000","00","120","0050","1635","530","307","223","13","543","1258","0","43.16","24.40"
"64","000","00","120","0050","1636","478","249","229","4","482","1279","0","37.69","19.47"
"64","000","00","120","0051","0000","505","230","275","7","512","1040","0","49.23","22.12"
"64","000","00","120","0051","1595","505","230","275","7","512","1040","0","49.23","22.12"
"64","000","00","120","0053","0000","1669","655","1014","13","1682","3969","0","42.38","16.50"
"64","000","00","120","0053","1543","628","261","367","5","633","1454","0","43.54","17.95"
"64","000","00","120","0053","1544","526","208","318","4","530","1268","0","41.80","16.40"
"64","000","00","120","0053","1545","515","186","329","4","519","1247","0","41.62","14.92"
"64","000","00","120","0054","0000","730","276","454","8","738","1831","0","40.31","15.07"
"64","000","00","120","0054","1733","392","153","239","3","395","950","0","41.58","16.11"
"64","000","00","120","0054","1734","338","123","215","5","343","881","0","38.93","13.96"
"64","000","00","120","0055","0000","3523","1208","2315","20","3543","8197","0","43.22","14.74"
"64","000","00","120","0055","1743","557","163","394","2","559","1298","0","43.07","12.56"
"64","000","00","120","0055","1744","574","195","379","5","579","1256","0","46.10","15.53"
"64","000","00","120","0055","1745","597","213","384","4","601","1626","0","36.96","13.10"
"64","000","00","120","0055","1746","624","237","387","3","627","1405","0","44.63","16.87"
"64","000","00","120","0055","1747","599","206","393","4","603","1399","0","43.10","14.72"
"64","000","00","120","0055","1748","572","194","378","2","574","1213","0","47.32","15.99"
"64","000","00","120","0056","0000","3602","1919","1683","32","3634","8181","0","44.42","23.46"
"64","000","00","120","0056","1560","707","589","118","13","720","1615","0","44.58","36.47"
"64","000","00","120","0056","1561","545","223","322","5","550","1162","0","47.33","19.19"
"64","000","00","120","0056","1562","572","234","338","2","574","1262","0","45.48","18.54"
"64","000","00","120","0056","1563","552","279","273","3","555","1488","0","37.30","18.75"
"64","000","00","120","0056","1564","555","296","259","5","560","1158","0","48.36","25.56"
"64","000","00","120","0056","1565","671","298","373","4","675","1496","0","45.12","19.92"
"64","000","00","120","0057","0000","1703","591","1112","15","1718","4349","0","39.50","13.59"
"64","000","00","120","0057","1752","521","185","336","6","527","1394","0","37.80","13.27"
"64","000","00","120","0057","1753","559","192","367","6","565","1408","0","40.13","13.64"
"64","000","00","120","0057","1754","623","214","409","3","626","1547","0","40.47","13.83"
"64","000","00","120","0058","0000","1045","411","634","8","1053","2612","0","40.31","15.74"
"64","000","00","120","0058","1553","622","257","365","5","627","1420","0","44.15","18.10"
"64","000","00","120","0058","1554","423","154","269","3","426","1192","0","35.74","12.92"
"64","000","00","120","0059","0000","1684","754","930","10","1694","4036","0","41.97","18.68"
"64","000","00","120","0059","1577","481","240","241","3","484","1266","0","38.23","18.96"
"64","000","00","120","0059","1578","609","258","351","6","615","1409","0","43.65","18.31"
"64","000","00","120","0059","1579","594","256","338","1","595","1361","0","43.72","18.81"
"64","000","00","120","0060","0000","4076","1921","2155","25","4101","9452","0","43.39","20.32"
"64","000","00","120","0060","1580","815","412","403","3","818","1790","0","45.70","23.02"
"64","000","00","120","0060","1581","719","317","402","5","724","1681","0","43.07","18.86"
"64","000","00","120","0060","1582","631","313","318","4","635","1565","0","40.58","20.00"
"64","000","00","120","0060","1583","656","290","366","3","659","1445","0","45.61","20.07"
"64","000","00","120","0060","1584","588","291","297","6","594","1353","0","43.90","21.51"
"64","000","00","120","0060","1585","667","298","369","4","671","1618","0","41.47","18.42"
"64","000","00","120","0061","0000","812","532","280","7","819","2046","0","40.03","26.00"
"64","000","00","120","0061","1637","340","186","154","3","343","804","0","42.66","23.13"
"64","000","00","120","0061","1638","472","346","126","4","476","1242","0","38.33","27.86"
"64","000","00","120","0062","0000","1073","605","468","7","1080","2686","0","40.21","22.52"
"64","000","00","120","0062","1639","585","356","229","5","590","1490","0","39.60","23.89"
"64","000","00","120","0062","1640","488","249","239","2","490","1196","0","40.97","20.82"
"64","000","00","120","0063","0000","1180","561","619","6","1186","2531","0","46.86","22.17"
"64","000","00","120","0063","1662","605","273","332","3","608","1330","0","45.71","20.53"
"64","000","00","120","0063","1663","575","288","287","3","578","1201","0","48.13","23.98"
"64","000","00","120","0064","0000","1008","385","623","9","1017","2292","0","44.37","16.80"
"64","000","00","120","0064","1664","507","178","329","5","512","1098","0","46.63","16.21"
"64","000","00","120","0064","1665","501","207","294","4","505","1194","0","42.29","17.34"
"64","000","00","120","0065","0000","1670","693","977","13","1683","3737","0","45.04","18.54"
"64","000","00","120","0065","1684","442","158","284","3","445","1085","0","41.01","14.56"
"64","000","00","120","0065","1685","525","200","325","2","527","1162","0","45.35","17.21"
"64","000","00","120","0065","1686","703","335","368","8","711","1490","0","47.72","22.48"
"64","000","00","120","0066","0000","1043","362","681","10","1053","2353","0","44.75","15.38"
"64","000","00","120","0066","1672","579","196","383","3","582","1271","0","45.79","15.42"
"64","000","00","120","0066","1673","464","166","298","7","471","1082","0","43.53","15.34"
"64","000","00","120","0067","0000","1816","759","1057","5","1821","4273","0","42.62","17.76"
"64","000","00","120","0067","1677","538","216","322","4","542","1334","0","40.63","16.19"
"64","000","00","120","0067","1678","585","225","360","1","586","1382","0","42.40","16.28"
"64","000","00","120","0067","1679","693","318","375","0","693","1557","0","44.51","20.42"
"64","000","00","120","0068","0000","1637","729","908","11","1648","4006","0","41.14","18.20"
"64","000","00","120","0068","1674","579","236","343","5","584","1449","0","40.30","16.29"
"64","000","00","120","0068","1675","556","269","287","2","558","1329","0","41.99","20.24"
"64","000","00","120","0068","1676","502","224","278","4","506","1228","0","41.21","18.24"
"64","000","00","120","0069","0000","1065","461","604","7","1072","2454","0","43.68","18.79"
"64","000","00","120","0069","1698","525","240","285","1","526","1174","0","44.80","20.44"
"64","000","00","120","0069","1699","540","221","319","6","546","1280","0","42.66","17.27"
"64","000","00","120","0070","0000","1745","748","997","8","1753","4441","0","39.47","16.84"
"64","000","00","120","0070","1700","555","265","290","2","557","1447","0","38.49","18.31"
"64","000","00","120","0070","1701","607","250","357","3","610","1411","0","43.23","17.72"
"64","000","00","120","0070","1702","583","233","350","3","586","1583","0","37.02","14.72"
"64","000","00","120","0071","0000","1830","667","1163","18","1848","4469","0","41.35","14.93"
"64","000","00","120","0071","1695","636","261","375","9","645","1487","0","43.38","17.55"
"64","000","00","120","0071","1696","603","205","398","2","605","1543","0","39.21","13.29"
"64","000","00","120","0071","1697","591","201","390","7","598","1439","0","41.56","13.97"
"64","000","00","120","0072","0000","1918","695","1223","15","1933","4472","0","43.22","15.54"
"64","000","00","120","0072","1724","637","200","437","4","641","1452","0","44.15","13.77"
"64","000","00","120","0072","1725","616","234","382","3","619","1425","0","43.44","16.42"
"64","000","00","120","0072","1726","665","261","404","8","673","1595","0","42.19","16.36"
"64","000","00","120","0073","0000","1134","361","773","4","1138","2740","0","41.53","13.18"
"64","000","00","120","0073","1727","571","191","380","2","573","1336","0","42.89","14.30"
"64","000","00","120","0073","1728","563","170","393","2","565","1404","0","40.24","12.11"
"64","000","00","120","0074","0000","986","386","600","6","992","2367","0","41.91","16.31"
"64","000","00","120","0074","1739","457","152","305","4","461","1058","0","43.57","14.37"
"64","000","00","120","0074","1740","529","234","295","2","531","1309","0","40.57","17.88"
"64","000","00","120","0075","0000","2060","759","1301","18","2078","5524","0","37.62","13.74"
"64","000","00","120","0075","1735","452","188","264","7","459","1280","0","35.86","14.69"
"64","000","00","120","0075","1736","479","194","285","7","486","1368","0","35.53","14.18"
"64","000","00","120","0075","1737","564","178","386","2","566","1454","0","38.93","12.24"
"64","000","00","120","0075","1738","565","199","366","2","567","1422","0","39.87","13.99"
"64","000","00","120","0076","0000","1099","392","707","12","1111","2597","0","42.78","15.09"
"64","000","00","120","0076","1741","583","195","388","7","590","1373","0","42.97","14.20"
"64","000","00","120","0076","1742","516","197","319","5","521","1224","0","42.57","16.09"
"64","000","00","120","0077","0000","1098","333","765","4","1102","2652","0","41.55","12.56"
"64","000","00","120","0077","1762","549","139","410","3","552","1314","0","42.01","10.58"
"64","000","00","120","0077","1763","549","194","355","1","550","1338","0","41.11","14.50"
"64","000","00","120","0078","0000","2640","1007","1633","19","2659","6389","0","41.62","15.76"
"64","000","00","120","0078","1716","572","206","366","5","577","1337","0","43.16","15.41"
"64","000","00","120","0078","1717","590","243","347","2","592","1334","0","44.38","18.22"
"64","000","00","120","0078","1718","522","195","327","5","527","1298","0","40.60","15.02"
"64","000","00","120","0078","1719","504","192","312","5","509","1176","0","43.28","16.33"
"64","000","00","120","0078","1720","452","171","281","2","454","1244","0","36.50","13.75"
"64","000","00","130","0000","0000","22970","7251","15719","242","23212","59161","69161","39.24","12.26"
"64","000","00","130","0001","0000","1020","327","693","7","1027","2799","0","36.69","11.68"
"64","000","00","130","0001","0947","504","178","326","4","508","1213","0","41.88","14.67"
"64","000","00","130","0001","0948","516","149","367","3","519","1586","0","32.72","9.39"
"64","000","00","130","0002","0000","1248","442","806","13","1261","3070","0","41.07","14.40"
"64","000","00","130","0002","0949","422","163","259","4","426","1074","0","39.66","15.18"
"64","000","00","130","0002","0950","376","127","249","2","378","981","0","38.53","12.95"
"64","000","00","130","0002","0951","450","152","298","7","457","1015","0","45.02","14.98"
"64","000","00","130","0003","0000","1537","487","1050","16","1553","4129","0","37.61","11.79"
"64","000","00","130","0003","0952","541","159","382","5","546","1369","0","39.88","11.61"
"64","000","00","130","0003","0953","480","154","326","6","486","1244","0","39.07","12.38"
"64","000","00","130","0003","0954","516","174","342","5","521","1516","0","34.37","11.48"
"64","000","00","130","0004","0000","1064","399","665","14","1078","2749","0","39.21","14.51"
"64","000","00","130","0004","0955","588","209","379","7","595","1414","0","42.08","14.78"
"64","000","00","130","0004","0956","476","190","286","7","483","1335","0","36.18","14.23"
"64","000","00","130","0005","0000","1236","472","764","18","1254","2981","0","42.07","15.83"
"64","000","00","130","0005","0957","600","178","422","9","609","1479","0","41.18","12.04"
"64","000","00","130","0005","0958","636","294","342","9","645","1502","0","42.94","19.57"
"64","000","00","130","0006","0000","988","322","666","13","1001","2474","0","40.46","13.02"
"64","000","00","130","0006","0959","478","166","312","5","483","1230","0","39.27","13.50"
"64","000","00","130","0006","0960","510","156","354","8","518","1244","0","41.64","12.54"
"64","000","00","130","0007","0000","1769","538","1231","22","1791","4546","0","39.40","11.83"
"64","000","00","130","0007","0961","438","125","313","3","441","1118","0","39.45","11.18"
"64","000","00","130","0007","0962","516","145","371","4","520","1357","0","38.32","10.69"
"64","000","00","130","0007","0963","368","123","245","6","374","909","0","41.14","13.53"
"64","000","00","130","0007","0964","447","145","302","9","456","1162","0","39.24","12.48"
"64","000","00","130","0008","0000","753","208","545","9","762","1795","0","42.45","11.59"
"64","000","00","130","0008","0965","377","110","267","2","379","939","0","40.36","11.71"
"64","000","00","130","0008","0966","376","98","278","7","383","856","0","44.74","11.45"
"64","000","00","130","0009","0000","1302","326","976","16","1318","3401","0","38.75","9.59"
"64","000","00","130","0009","0967","395","91","304","2","397","1083","0","36.66","8.40"
"64","000","00","130","0009","0968","427","109","318","8","435","1067","0","40.77","10.22"
"64","000","00","130","0009","0969","480","126","354","6","486","1251","0","38.85","10.07"
"64","000","00","130","0010","0000","704","177","527","9","713","1671","0","42.67","10.59"
"64","000","00","130","0010","0970","704","177","527","9","713","1671","0","42.67","10.59"
"64","000","00","130","0011","0000","526","184","342","4","530","1576","0","33.63","11.68"
"64","000","00","130","0011","0971","196","108","88","4","200","581","0","34.42","18.59"
"64","000","00","130","0011","0972","330","76","254","0","330","995","0","33.17","7.64"
"64","000","00","130","0012","0000","714","317","397","9","723","1960","0","36.89","16.17"
"64","000","00","130","0012","0973","416","155","261","4","420","981","0","42.81","15.80"
"64","000","00","130","0012","0974","298","162","136","5","303","979","0","30.95","16.55"
"64","000","00","130","0013","0000","1614","567","1047","16","1630","4087","0","39.88","13.87"
"64","000","00","130","0013","0975","622","216","406","6","628","1603","0","39.18","13.47"
"64","000","00","130","0013","0976","509","182","327","5","514","1294","0","39.72","14.06"
"64","000","00","130","0013","0977","483","169","314","5","488","1190","0","41.01","14.20"
"64","000","00","130","0014","0000","479","162","317","3","482","1274","0","37.83","12.72"
"64","000","00","130","0014","0978","479","162","317","3","482","1274","0","37.83","12.72"
"64","000","00","130","0015","0000","856","255","601","3","859","1939","0","44.30","13.15"
"64","000","00","130","0015","0979","453","138","315","1","454","1055","0","43.03","13.08"
"64","000","00","130","0015","0980","403","117","286","2","405","884","0","45.81","13.24"
"64","000","00","130","0016","0000","715","173","542","6","721","1726","0","41.77","10.02"
"64","000","00","130","0016","0981","352","65","287","6","358","820","0","43.66","7.93"
"64","000","00","130","0016","0982","363","108","255","0","363","906","0","40.07","11.92"
"64","000","00","130","0017","0000","693","151","542","8","701","1767","0","39.67","8.55"
"64","000","00","130","0017","0983","379","74","305","4","383","998","0","38.38","7.41"
"64","000","00","130","0017","0984","314","77","237","4","318","769","0","41.35","10.01"
"64","000","00","130","0018","0000","319","82","237","2","321","883","0","36.35","9.29"
"64","000","00","130","0018","0985","319","82","237","2","321","883","0","36.35","9.29"
"64","000","00","130","0019","0000","264","64","200","0","264","729","0","36.21","8.78"
"64","000","00","130","0019","0986","264","64","200","0","264","729","0","36.21","8.78"
"64","000","00","130","0020","0000","1202","360","842","10","1212","2918","0","41.54","12.34"
"64","000","00","130","0020","0987","662","205","457","2","664","1445","0","45.95","14.19"
"64","000","00","130","0020","0988","540","155","385","8","548","1473","0","37.20","10.52"
"64","000","00","130","0021","0000","1012","384","628","11","1023","2393","0","42.75","16.05"
"64","000","00","130","0021","0989","566","240","326","6","572","1368","0","41.81","17.54"
"64","000","00","130","0021","0990","446","144","302","5","451","1025","0","44.00","14.05"
"64","000","00","130","0022","0000","1338","437","901","12","1350","3366","0","40.11","12.98"
"64","000","00","130","0022","0991","495","156","339","3","498","1180","0","42.20","13.22"
"64","000","00","130","0022","0992","409","125","284","5","414","1113","0","37.20","11.23"
"64","000","00","130","0022","0993","434","156","278","4","438","1073","0","40.82","14.54"
"64","000","00","130","0023","0000","854","268","586","7","861","2660","0","32.37","10.08"
"64","000","00","130","0023","0994","488","168","320","4","492","1359","0","36.20","12.36"
"64","000","00","130","0023","0995","366","100","266","3","369","1301","0","28.36","7.69"
"64","000","00","130","0024","0000","763","149","614","14","777","2268","0","34.26","6.57"
"64","000","00","130","0024","0996","419","75","344","5","424","1134","0","37.39","6.61"
"64","000","00","130","0024","0997","344","74","270","9","353","1134","0","31.13","6.53"
"64","000","00","140","0000","0000","39099","14480","24619","383","39482","97638","112129","40.44","14.83"
"64","000","00","140","0001","0000","587","155","432","10","597","1391","0","42.92","11.14"
"64","000","00","140","0001","0861","288","64","224","7","295","691","0","42.69","9.26"
"64","000","00","140","0001","0862","299","91","208","3","302","700","0","43.14","13.00"
"64","000","00","140","0002","0000","2101","786","1315","19","2120","5790","0","36.61","13.58"
"64","000","00","140","0002","0863","513","162","351","2","515","1246","0","41.33","13.00"
"64","000","00","140","0002","0864","322","120","202","4","326","909","0","35.86","13.20"
"64","000","00","140","0002","0865","283","91","192","5","288","756","0","38.10","12.04"
"64","000","00","140","0002","0866","174","61","113","1","175","425","0","41.18","14.35"
"64","000","00","140","0002","0867","468","191","277","5","473","1233","0","38.36","15.49"
"64","000","00","140","0002","0868","341","161","180","2","343","1221","0","28.09","13.19"
"64","000","00","140","0003","0000","2389","765","1624","37","2426","6676","0","36.34","11.46"
"64","000","00","140","0003","0869","446","146","300","7","453","1302","0","34.79","11.21"
"64","000","00","140","0003","0870","499","178","321","6","505","1389","0","36.36","12.81"
"64","000","00","140","0003","0871","537","185","352","10","547","1469","0","37.24","12.59"
"64","000","00","140","0003","0872","482","124","358","7","489","1399","0","34.95","8.86"
"64","000","00","140","0003","0873","425","132","293","7","432","1117","0","38.68","11.82"
"64","000","00","140","0004","0000","984","261","723","8","992","2414","0","41.09","10.81"
"64","000","00","140","0004","0874","481","140","341","4","485","1208","0","40.15","11.59"
"64","000","00","140","0004","0875","503","121","382","4","507","1206","0","42.04","10.03"
"64","000","00","140","0005","0000","1869","607","1262","21","1890","4615","0","40.95","13.15"
"64","000","00","140","0005","0876","561","176","385","4","565","1362","0","41.48","12.92"
"64","000","00","140","0005","0877","478","170","308","4","482","1196","0","40.30","14.21"
"64","000","00","140","0005","0878","433","165","268","3","436","1075","0","40.56","15.35"
"64","000","00","140","0005","0879","397","96","301","10","407","982","0","41.45","9.78"
"64","000","00","140","0006","0000","1974","582","1392","14","1988","4639","0","42.85","12.55"
"64","000","00","140","0006","0880","559","165","394","2","561","1307","0","42.92","12.62"
"64","000","00","140","0006","0881","752","234","518","6","758","1733","0","43.74","13.50"
"64","000","00","140","0006","0882","663","183","480","6","669","1599","0","41.84","11.44"
"64","000","00","140","0007","0000","1752","441","1311","16","1768","3885","0","45.51","11.35"
"64","000","00","140","0007","0883","570","155","415","7","577","1235","0","46.72","12.55"
"64","000","00","140","0007","0884","608","146","462","4","612","1382","0","44.28","10.56"
"64","000","00","140","0007","0885","574","140","434","5","579","1268","0","45.66","11.04"
"64","000","00","140","0008","0000","1087","448","639","10","1097","2318","0","47.33","19.33"
"64","000","00","140","0008","0886","598","278","320","4","602","1286","0","46.81","21.62"
"64","000","00","140","0008","0887","489","170","319","6","495","1032","0","47.97","16.47"
"64","000","00","140","0009","0000","4181","1505","2676","38","4219","10756","0","39.22","13.99"
"64","000","00","140","0009","0888","568","182","386","3","571","1357","0","42.08","13.41"
"64","000","00","140","0009","0889","479","207","272","9","488","1287","0","37.92","16.08"
"64","000","00","140","0009","0890","449","167","282","8","457","1283","0","35.62","13.02"
"64","000","00","140","0009","0891","542","186","356","4","546","1421","0","38.42","13.09"
"64","000","00","140","0009","0892","568","208","360","3","571","1381","0","41.35","15.06"
"64","000","00","140","0009","0893","504","184","320","3","507","1283","0","39.52","14.34"
"64","000","00","140","0009","0894","544","217","327","4","548","1365","0","40.15","15.90"
"64","000","00","140","0009","0895","527","154","373","4","531","1379","0","38.51","11.17"
"64","000","00","140","0010","0000","3086","1223","1863","26","3112","7626","0","40.81","16.04"
"64","000","00","140","0010","0896","524","197","327","3","527","1238","0","42.57","15.91"
"64","000","00","140","0010","0897","337","133","204","0","337","910","0","37.03","14.62"
"64","000","00","140","0010","0898","469","198","271","5","474","1127","0","42.06","17.57"
"64","000","00","140","0010","0899","317","119","198","2","319","719","0","44.37","16.55"
"64","000","00","140","0010","0900","367","175","192","3","370","963","0","38.42","18.17"
"64","000","00","140","0010","0901","547","217","330","8","555","1349","0","41.14","16.09"
"64","000","00","140","0010","0902","525","184","341","5","530","1320","0","40.15","13.94"
"64","000","00","140","0011","0000","750","222","528","10","760","1803","0","42.15","12.31"
"64","000","00","140","0011","0903","453","142","311","8","461","1045","0","44.11","13.59"
"64","000","00","140","0011","0904","297","80","217","2","299","758","0","39.45","10.55"
"64","000","00","140","0012","0000","596","180","416","3","599","1666","0","35.95","10.80"
"64","000","00","140","0012","0905","320","112","208","0","320","928","0","34.48","12.07"
"64","000","00","140","0012","0906","276","68","208","3","279","738","0","37.80","9.21"
"64","000","00","140","0013","0000","994","322","672","9","1003","2472","0","40.57","13.03"
"64","000","00","140","0013","0907","470","145","325","5","475","1200","0","39.58","12.08"
"64","000","00","140","0013","0908","524","177","347","4","528","1272","0","41.51","13.92"
"64","000","00","140","0014","0000","1179","319","860","18","1197","2917","0","41.04","10.94"
"64","000","00","140","0014","0909","396","110","286","7","403","988","0","40.79","11.13"
"64","000","00","140","0014","0910","341","80","261","4","345","934","0","36.94","8.57"
"64","000","00","140","0014","0911","442","129","313","7","449","995","0","45.13","12.96"
"64","000","00","140","0015","0000","592","194","398","3","595","1538","0","38.69","12.61"
"64","000","00","140","0015","0912","326","107","219","1","327","826","0","39.59","12.95"
"64","000","00","140","0015","0913","266","87","179","2","268","712","0","37.64","12.22"
"64","000","00","140","0016","0000","2338","985","1353","24","2362","6229","0","37.92","15.81"
"64","000","00","140","0016","0914","432","156","276","3","435","1152","0","37.76","13.54"
"64","000","00","140","0016","0915","503","191","312","2","505","1212","0","41.67","15.76"
"64","000","00","140","0016","0916","467","199","268","3","470","1130","0","41.59","17.61"
"64","000","00","140","0016","0917","362","164","198","8","370","1338","0","27.65","12.26"
"64","000","00","140","0016","0918","574","275","299","8","582","1397","0","41.66","19.69"
"64","000","00","140","0017","0000","2968","1446","1522","26","2994","7455","0","40.16","19.40"
"64","000","00","140","0017","0919","445","134","311","1","446","1061","0","42.04","12.63"
"64","000","00","140","0017","0920","437","195","242","3","440","1236","0","35.60","15.78"
"64","000","00","140","0017","0921","510","276","234","1","511","1159","0","44.09","23.81"
"64","000","00","140","0017","0922","522","294","228","6","528","1271","0","41.54","23.13"
"64","000","00","140","0017","0923","555","283","272","7","562","1518","0","37.02","18.64"
"64","000","00","140","0017","0924","499","264","235","8","507","1210","0","41.90","21.82"
"64","000","00","140","0018","0000","244","157","87","4","248","541","0","45.84","29.02"
"64","000","00","140","0018","0925","244","157","87","4","248","541","0","45.84","29.02"
"64","000","00","140","0019","0000","2771","1015","1756","18","2789","6812","0","40.94","14.90"
"64","000","00","140","0019","0926","377","153","224","6","383","1050","0","36.48","14.57"
"64","000","00","140","0019","0927","529","208","321","2","531","1241","0","42.79","16.76"
"64","000","00","140","0019","0928","453","185","268","2","455","1038","0","43.83","17.82"
"64","000","00","140","0019","0929","499","159","340","2","501","1219","0","41.10","13.04"
"64","000","00","140","0019","0930","457","159","298","2","459","1097","0","41.84","14.49"
"64","000","00","140","0019","0931","456","151","305","4","460","1167","0","39.42","12.94"
"64","000","00","140","0020","0000","956","293","663","11","967","2201","0","43.93","13.31"
"64","000","00","140","0020","0932","431","126","305","6","437","972","0","44.96","12.96"
"64","000","00","140","0020","0933","525","167","358","5","530","1229","0","43.12","13.59"
"64","000","00","140","0021","0000","677","223","454","5","682","1545","0","44.14","14.43"
"64","000","00","140","0021","0934","304","95","209","4","308","713","0","43.20","13.32"
"64","000","00","140","0021","0935","373","128","245","1","374","832","0","44.95","15.38"
"64","000","00","140","0022","0000","822","260","562","6","828","1851","0","44.73","14.05"
"64","000","00","140","0022","0936","426","146","280","1","427","930","0","45.91","15.70"
"64","000","00","140","0022","0937","396","114","282","5","401","921","0","43.54","12.38"
"64","000","00","140","0023","0000","1399","411","988","13","1412","3723","0","37.93","11.04"
"64","000","00","140","0023","0938","490","138","352","5","495","1272","0","38.92","10.85"
"64","000","00","140","0023","0939","441","115","326","6","447","1164","0","38.40","9.88"
"64","000","00","140","0023","0940","468","158","310","2","470","1287","0","36.52","12.28"
"64","000","00","140","0024","0000","42","28","14","4","46","111","0","41.44","25.23"
"64","000","00","140","0024","0941","42","28","14","4","46","111","0","41.44","25.23"
"64","000","00","140","0025","0000","2761","1652","1109","30","2791","6664","0","41.88","24.79"
"64","000","00","140","0025","0942","578","400","178","8","586","1392","0","42.10","28.74"
"64","000","00","140","0025","0943","617","361","256","4","621","1376","0","45.13","26.24"
"64","000","00","140","0025","0944","518","311","207","5","523","1327","0","39.41","23.44"
"64","000","00","140","0025","0945","546","281","265","7","553","1299","0","42.57","21.63"
"64","000","00","140","0025","0946","502","299","203","6","508","1270","0","40.00","23.54"
"64","000","00","150","0000","0000","14959","4792","10167","152","15111","36462","41549","41.44","13.14"
"64","000","00","150","0001","0000","1119","435","684","7","1126","2680","0","42.01","16.23"
"64","000","00","150","0001","0198","545","184","361","3","548","1328","0","41.27","13.86"
"64","000","00","150","0001","0199","574","251","323","4","578","1352","0","42.75","18.57"
"64","000","00","150","0002","0000","1906","751","1155","20","1926","5186","0","37.14","14.48"
"64","000","00","150","0002","0200","432","165","267","4","436","1273","0","34.25","12.96"
"64","000","00","150","0002","0201","416","163","253","5","421","1228","0","34.28","13.27"
"64","000","00","150","0002","0202","544","198","346","6","550","1351","0","40.71","14.66"
"64","000","00","150","0002","0203","514","225","289","5","519","1334","0","38.91","16.87"
"64","000","00","150","0003","0000","1733","680","1053","20","1753","4079","0","42.98","16.67"
"64","000","00","150","0003","0204","585","254","331","6","591","1411","0","41.89","18.00"
"64","000","00","150","0003","0205","577","228","349","8","585","1315","0","44.49","17.34"
"64","000","00","150","0003","0206","571","198","373","6","577","1353","0","42.65","14.63"
"64","000","00","150","0004","0000","1024","308","716","12","1036","2313","0","44.79","13.32"
"64","000","00","150","0004","0207","450","112","338","6","456","1076","0","42.38","10.41"
"64","000","00","150","0004","0208","574","196","378","6","580","1237","0","46.89","15.84"
"64","000","00","150","0005","0000","1015","298","717","6","1021","2219","0","46.01","13.43"
"64","000","00","150","0005","0209","484","149","335","4","488","1113","0","43.85","13.39"
"64","000","00","150","0005","0210","531","149","382","2","533","1106","0","48.19","13.47"
"64","000","00","150","0006","0000","1347","412","935","10","1357","3451","0","39.32","11.94"
"64","000","00","150","0006","0211","474","130","344","5","479","1261","0","37.99","10.31"
"64","000","00","150","0006","0212","427","148","279","2","429","1065","0","40.28","13.90"
"64","000","00","150","0006","0213","446","134","312","3","449","1125","0","39.91","11.91"
"64","000","00","150","0007","0000","420","87","333","1","421","1026","0","41.03","8.48"
"64","000","00","150","0007","0214","420","87","333","1","421","1026","0","41.03","8.48"
"64","000","00","150","0008","0000","403","114","289","3","406","994","0","40.85","11.47"
"64","000","00","150","0008","0215","403","114","289","3","406","994","0","40.85","11.47"
"64","000","00","150","0009","0000","435","109","326","5","440","962","0","45.74","11.33"
"64","000","00","150","0009","0216","435","109","326","5","440","962","0","45.74","11.33"
"64","000","00","150","0010","0000","564","168","396","7","571","1434","0","39.82","11.72"
"64","000","00","150","0010","0217","564","168","396","7","571","1434","0","39.82","11.72"
"64","000","00","150","0011","0000","651","159","492","6","657","1505","0","43.65","10.56"
"64","000","00","150","0011","0218","321","77","244","4","325","741","0","43.86","10.39"
"64","000","00","150","0011","0219","330","82","248","2","332","764","0","43.46","10.73"
"64","000","00","150","0012","0000","562","172","390","12","574","1311","0","43.78","13.12"
"64","000","00","150","0012","0220","562","172","390","12","574","1311","0","43.78","13.12"
"64","000","00","150","0013","0000","765","138","627","10","775","1752","0","44.24","7.88"
"64","000","00","150","0013","0221","432","73","359","10","442","879","0","50.28","8.30"
"64","000","00","150","0013","0222","333","65","268","0","333","873","0","38.14","7.45"
"64","000","00","150","0014","0000","1000","266","734","10","1010","2492","0","40.53","10.67"
"64","000","00","150","0014","0223","496","133","363","3","499","1262","0","39.54","10.54"
"64","000","00","150","0014","0224","504","133","371","7","511","1230","0","41.54","10.81"
"64","000","00","150","0015","0000","379","142","237","1","380","994","0","38.23","14.29"
"64","000","00","150","0015","0225","379","142","237","1","380","994","0","38.23","14.29"
"64","000","00","150","0016","0000","623","165","458","10","633","1539","0","41.13","10.72"
"64","000","00","150","0016","0226","310","93","217","4","314","792","0","39.65","11.74"
"64","000","00","150","0016","0227","313","72","241","6","319","747","0","42.70","9.64"
"64","000","00","150","0017","0000","749","306","443","10","759","1855","0","40.92","16.50"
"64","000","00","150","0017","0228","425","111","314","2","427","980","0","43.57","11.33"
"64","000","00","150","0017","0229","324","195","129","8","332","875","0","37.94","22.29"
"64","000","00","150","0018","0000","264","82","182","2","266","670","0","39.70","12.24"
"64","000","00","150","0018","0230","264","82","182","2","266","670","0","39.70","12.24"
"64","000","00","160","0000","0000","12614","4205","8409","129","12743","30109","34208","42.32","13.97"
"64","000","00","160","0001","0000","318","127","191","3","321","899","0","35.71","14.13"
"64","000","00","160","0001","0231","318","127","191","3","321","899","0","35.71","14.13"
"64","000","00","160","0002","0000","1414","503","911","16","1430","3267","0","43.77","15.40"
"64","000","00","160","0002","0232","477","147","330","5","482","1026","0","46.98","14.33"
"64","000","00","160","0002","0233","464","196","268","5","469","1115","0","42.06","17.58"
"64","000","00","160","0002","0234","473","160","313","6","479","1126","0","42.54","14.21"
"64","000","00","160","0003","0000","2051","713","1338","11","2062","4936","0","41.77","14.44"
"64","000","00","160","0003","0235","423","136","287","2","425","1034","0","41.10","13.15"
"64","000","00","160","0003","0236","357","112","245","2","359","1005","0","35.72","11.14"
"64","000","00","160","0003","0237","460","146","314","1","461","1041","0","44.28","14.02"
"64","000","00","160","0003","0238","470","182","288","3","473","1030","0","45.92","17.67"
"64","000","00","160","0003","0239","341","137","204","3","344","826","0","41.65","16.59"
"64","000","00","160","0004","0000","691","201","490","8","699","1648","0","42.42","12.20"
"64","000","00","160","0004","0258","301","65","236","3","304","697","0","43.62","9.33"
"64","000","00","160","0004","0259","390","136","254","5","395","951","0","41.54","14.30"
"64","000","00","160","0005","0000","1174","370","804","14","1188","2706","0","43.90","13.67"
"64","000","00","160","0005","0243","429","144","285","7","436","1062","0","41.05","13.56"
"64","000","00","160","0005","0244","379","117","262","3","382","882","0","43.31","13.27"
"64","000","00","160","0005","0245","366","109","257","4","370","762","0","48.56","14.30"
"64","000","00","160","0006","0000","2409","760","1649","28","2437","5416","0","45.00","14.03"
"64","000","00","160","0006","0246","559","163","396","13","572","1111","0","51.49","14.67"
"64","000","00","160","0006","0247","486","159","327","4","490","1158","0","42.31","13.73"
"64","000","00","160","0006","0248","451","141","310","5","456","1079","0","42.26","13.07"
"64","000","00","160","0006","0249","460","162","298","4","464","1034","0","44.87","15.67"
"64","000","00","160","0006","0250","453","135","318","2","455","1034","0","44.00","13.06"
"64","000","00","160","0007","0000","1917","675","1242","13","1930","4948","0","39.01","13.64"
"64","000","00","160","0007","0251","503","165","338","4","507","1270","0","39.92","12.99"
"64","000","00","160","0007","0252","500","176","324","3","503","1270","0","39.61","13.86"
"64","000","00","160","0007","0253","515","190","325","3","518","1248","0","41.51","15.22"
"64","000","00","160","0007","0254","399","144","255","3","402","1160","0","34.66","12.41"
"64","000","00","160","0008","0000","1330","445","885","18","1348","3171","0","42.51","14.03"
"64","000","00","160","0008","0255","494","151","343","10","504","1108","0","45.49","13.63"
"64","000","00","160","0008","0256","445","158","287","4","449","1153","0","38.94","13.70"
"64","000","00","160","0008","0257","391","136","255","4","395","910","0","43.41","14.95"
"64","000","00","160","0009","0000","1310","411","899","18","1328","3118","0","42.59","13.18"
"64","000","00","160","0009","0240","420","142","278","5","425","1053","0","40.36","13.49"
"64","000","00","160","0009","0241","452","152","300","4","456","1048","0","43.51","14.50"
"64","000","00","160","0009","0242","438","117","321","9","447","1017","0","43.95","11.50"
"64","000","00","170","0000","0000","32165","11777","20388","243","32408","78723","92846","41.17","14.96"
"64","000","00","170","0001","0000","1837","655","1182","8","1845","4416","0","41.78","14.83"
"64","000","00","170","0001","0771","654","229","425","2","656","1456","0","45.05","15.73"
"64","000","00","170","0001","0772","628","218","410","4","632","1568","0","40.31","13.90"
"64","000","00","170","0001","0773","555","208","347","2","557","1392","0","40.01","14.94"
"64","000","00","170","0002","0000","3146","1158","1988","26","3172","7950","0","39.90","14.57"
"64","000","00","170","0002","0774","562","190","372","4","566","1398","0","40.49","13.59"
"64","000","00","170","0002","0775","501","153","348","6","507","1202","0","42.18","12.73"
"64","000","00","170","0002","0776","489","146","343","5","494","1203","0","41.06","12.14"
"64","000","00","170","0002","0777","477","182","295","4","481","1330","0","36.17","13.68"
"64","000","00","170","0002","0778","528","217","311","2","530","1316","0","40.27","16.49"
"64","000","00","170","0002","0779","589","270","319","5","594","1501","0","39.57","17.99"
"64","000","00","170","0003","0000","1214","472","742","10","1224","2625","0","46.63","17.98"
"64","000","00","170","0003","0780","586","205","381","5","591","1319","0","44.81","15.54"
"64","000","00","170","0003","0781","628","267","361","5","633","1306","0","48.47","20.44"
"64","000","00","170","0004","0000","1364","494","870","17","1381","3764","0","36.69","13.12"
"64","000","00","170","0004","0782","449","175","274","6","455","1194","0","38.11","14.66"
"64","000","00","170","0004","0783","371","110","261","5","376","1182","0","31.81","9.31"
"64","000","00","170","0004","0784","544","209","335","6","550","1388","0","39.63","15.06"
"64","000","00","170","0005","0000","323","107","216","9","332","849","0","39.10","12.60"
"64","000","00","170","0005","0785","323","107","216","9","332","849","0","39.10","12.60"
"64","000","00","170","0006","0000","2038","663","1375","17","2055","5452","0","37.69","12.16"
"64","000","00","170","0006","0786","561","179","382","7","568","1372","0","41.40","13.05"
"64","000","00","170","0006","0787","397","146","251","0","397","1387","0","28.62","10.53"
"64","000","00","170","0006","0788","586","163","423","3","589","1364","0","43.18","11.95"
"64","000","00","170","0006","0789","494","175","319","7","501","1329","0","37.70","13.17"
"64","000","00","170","0007","0000","3766","1316","2450","27","3793","9055","0","41.89","14.53"
"64","000","00","170","0007","0790","699","205","494","2","701","1596","0","43.92","12.84"
"64","000","00","170","0007","0791","646","246","400","4","650","1609","0","40.40","15.29"
"64","000","00","170","0007","0792","602","192","410","3","605","1455","0","41.58","13.20"
"64","000","00","170","0007","0793","626","259","367","6","632","1501","0","42.11","17.26"
"64","000","00","170","0007","0794","609","228","381","5","614","1392","0","44.11","16.38"
"64","000","00","170","0007","0795","584","186","398","7","591","1502","0","39.35","12.38"
"64","000","00","170","0008","0000","1015","230","785","10","1025","2172","0","47.19","10.59"
"64","000","00","170","0008","0796","510","103","407","2","512","1031","0","49.66","9.99"
"64","000","00","170","0008","0797","505","127","378","8","513","1141","0","44.96","11.13"
"64","000","00","170","0009","0000","7048","2794","4254","43","7091","17709","0","40.04","15.78"
"64","000","00","170","0009","0798","575","169","406","3","578","1358","0","42.56","12.44"
"64","000","00","170","0009","0799","656","253","403","7","663","1495","0","44.35","16.92"
"64","000","00","170","0009","0800","613","270","343","2","615","1460","0","42.12","18.49"
"64","000","00","170","0009","0801","610","237","373","1","611","1445","0","42.28","16.40"
"64","000","00","170","0009","0802","507","192","315","4","511","1315","0","38.86","14.60"
"64","000","00","170","0009","0803","557","211","346","3","560","1455","0","38.49","14.50"
"64","000","00","170","0009","0804","509","219","290","1","510","1417","0","35.99","15.46"
"64","000","00","170","0009","0805","580","245","335","6","586","1421","0","41.24","17.24"
"64","000","00","170","0009","0806","562","231","331","4","566","1392","0","40.66","16.59"
"64","000","00","170","0009","0807","601","290","311","1","602","1418","0","42.45","20.45"
"64","000","00","170","0009","0808","559","186","373","9","568","1415","0","40.14","13.14"
"64","000","00","170","0009","0809","719","291","428","2","721","2118","0","34.04","13.74"
"64","000","00","170","0010","0000","1087","399","688","14","1101","2610","0","42.18","15.29"
"64","000","00","170","0010","0810","574","195","379","7","581","1363","0","42.63","14.31"
"64","000","00","170","0010","0811","513","204","309","7","520","1247","0","41.70","16.36"
"64","000","00","170","0011","0000","1067","286","781","6","1073","2542","0","42.21","11.25"
"64","000","00","170","0011","0812","538","142","396","3","541","1237","0","43.73","11.48"
"64","000","00","170","0011","0813","529","144","385","3","532","1305","0","40.77","11.03"
"64","000","00","170","0012","0000","646","260","386","4","650","1606","0","40.47","16.19"
"64","000","00","170","0012","0814","646","260","386","4","650","1606","0","40.47","16.19"
"64","000","00","170","0013","0000","2000","744","1256","10","2010","5171","0","38.87","14.39"
"64","000","00","170","0013","0815","460","162","298","1","461","1249","0","36.91","12.97"
"64","000","00","170","0013","0816","493","169","324","2","495","1234","0","40.11","13.70"
"64","000","00","170","0013","0817","499","225","274","2","501","1327","0","37.75","16.96"
"64","000","00","170","0013","0818","548","188","360","5","553","1361","0","40.63","13.81"
"64","000","00","170","0014","0000","1701","655","1046","11","1712","3838","0","44.61","17.07"
"64","000","00","170","0014","0819","574","222","352","7","581","1268","0","45.82","17.51"
"64","000","00","170","0014","0820","547","212","335","2","549","1277","0","42.99","16.60"
"64","000","00","170","0014","0821","580","221","359","2","582","1293","0","45.01","17.09"
"64","000","00","170","0015","0000","2849","1123","1726","22","2871","6762","0","42.46","16.61"
"64","000","00","170","0015","0822","598","226","372","8","606","1390","0","43.60","16.26"
"64","000","00","170","0015","0823","561","204","357","4","565","1341","0","42.13","15.21"
"64","000","00","170","0015","0824","554","245","309","5","559","1330","0","42.03","18.42"
"64","000","00","170","0015","0825","554","230","324","3","557","1318","0","42.26","17.45"
"64","000","00","170","0015","0826","582","218","364","2","584","1383","0","42.23","15.76"
"64","000","00","170","0016","0000","1064","421","643","9","1073","2202","0","48.73","19.12"
"64","000","00","170","0016","0827","520","213","307","5","525","1077","0","48.75","19.78"
"64","000","00","170","0016","0828","544","208","336","4","548","1125","0","48.71","18.49"
"64","000","00","180","0000","0000","18012","7012","11000","104","18116","39800","44727","45.52","17.62"
"64","000","00","180","0001","0000","4426","1760","2666","32","4458","10418","0","42.79","16.89"
"64","000","00","180","0001","0829","532","208","324","3","535","1207","0","44.32","17.23"
"64","000","00","180","0001","0830","591","239","352","0","591","1254","0","47.13","19.06"
"64","000","00","180","0001","0831","549","208","341","2","551","1301","0","42.35","15.99"
"64","000","00","180","0001","0832","617","255","362","8","625","1342","0","46.57","19.00"
"64","000","00","180","0001","0833","540","242","298","2","542","1420","0","38.17","17.04"
"64","000","00","180","0001","0834","534","248","286","3","537","1295","0","41.47","19.15"
"64","000","00","180","0001","0835","518","194","324","10","528","1283","0","41.15","15.12"
"64","000","00","180","0001","0836","545","166","379","4","549","1316","0","41.72","12.61"
"64","000","00","180","0002","0000","2309","954","1355","14","2323","4917","0","47.24","19.40"
"64","000","00","180","0002","0837","683","271","412","4","687","1419","0","48.41","19.10"
"64","000","00","180","0002","0838","579","187","392","3","582","1159","0","50.22","16.13"
"64","000","00","180","0002","0839","463","219","244","5","468","1101","0","42.51","19.89"
"64","000","00","180","0002","0840","584","277","307","2","586","1238","0","47.33","22.37"
"64","000","00","180","0003","0000","4823","2138","2685","16","4839","9866","0","49.05","21.67"
"64","000","00","180","0003","0841","654","231","423","3","657","1243","0","52.86","18.58"
"64","000","00","180","0003","0842","645","303","342","1","646","1337","0","48.32","22.66"
"64","000","00","180","0003","0843","619","266","353","2","621","1285","0","48.33","20.70"
"64","000","00","180","0003","0844","554","251","303","0","554","1156","0","47.92","21.71"
"64","000","00","180","0003","0845","485","243","242","3","488","1070","0","45.61","22.71"
"64","000","00","180","0003","0846","665","299","366","2","667","1319","0","50.57","22.67"
"64","000","00","180","0003","0847","619","236","383","4","623","1207","0","51.62","19.55"
"64","000","00","180","0003","0848","582","309","273","1","583","1249","0","46.68","24.74"
"64","000","00","180","0004","0000","1637","564","1073","6","1643","3551","0","46.27","15.88"
"64","000","00","180","0004","0849","559","193","366","1","560","1211","0","46.24","15.94"
"64","000","00","180","0004","0850","558","219","339","4","562","1213","0","46.33","18.05"
"64","000","00","180","0004","0851","520","152","368","1","521","1127","0","46.23","13.49"
"64","000","00","180","0005","0000","2751","856","1895","22","2773","6496","0","42.69","13.18"
"64","000","00","180","0005","0852","565","140","425","3","568","1245","0","45.62","11.24"
"64","000","00","180","0005","0853","674","211","463","3","677","1502","0","45.07","14.05"
"64","000","00","180","0005","0854","532","165","367","4","536","1387","0","38.64","11.90"
"64","000","00","180","0005","0855","538","193","345","5","543","1313","0","41.36","14.70"
"64","000","00","180","0005","0856","442","147","295","7","449","1049","0","42.80","14.01"
"64","000","00","180","0006","0000","334","97","237","3","337","678","0","49.71","14.31"
"64","000","00","180","0006","0857","334","97","237","3","337","678","0","49.71","14.31"
"64","000","00","180","0007","0000","1732","643","1089","11","1743","3874","0","44.99","16.60"
"64","000","00","180","0007","0858","594","207","387","5","599","1345","0","44.54","15.39"
"64","000","00","180","0007","0859","527","201","326","3","530","1248","0","42.47","16.11"
"64","000","00","180","0007","0860","611","235","376","3","614","1281","0","47.93","18.35"
"64","000","00","190","0000","0000","34608","14815","19793","277","34885","81201","96433","42.96","18.24"
"64","000","00","190","0001","0000","470","193","277","6","476","1073","0","44.36","17.99"
"64","000","00","190","0001","0375","470","193","277","6","476","1073","0","44.36","17.99"
"64","000","00","190","0002","0000","1679","661","1018","4","1683","4363","0","38.57","15.15"
"64","000","00","190","0002","0368","562","263","299","1","563","1338","0","42.08","19.66"
"64","000","00","190","0002","0369","360","109","251","0","360","1084","0","33.21","10.06"
"64","000","00","190","0002","0370","387","163","224","1","388","1056","0","36.74","15.44"
"64","000","00","190","0002","0371","370","126","244","2","372","885","0","42.03","14.24"
"64","000","00","190","0003","0000","1435","650","785","13","1448","3149","0","45.98","20.64"
"64","000","00","190","0003","0372","414","168","246","2","416","893","0","46.58","18.81"
"64","000","00","190","0003","0373","473","206","267","6","479","1063","0","45.06","19.38"
"64","000","00","190","0003","0374","548","276","272","5","553","1193","0","46.35","23.13"
"64","000","00","190","0004","0000","416","150","266","4","420","985","0","42.64","15.23"
"64","000","00","190","0004","0376","416","150","266","4","420","985","0","42.64","15.23"
"64","000","00","190","0005","0000","1692","794","898","18","1710","4134","0","41.36","19.21"
"64","000","00","190","0005","0381","558","200","358","7","565","1346","0","41.98","14.86"
"64","000","00","190","0005","0382","588","250","338","4","592","1369","0","43.24","18.26"
"64","000","00","190","0005","0383","546","344","202","7","553","1419","0","38.97","24.24"
"64","000","00","190","0006","0000","636","186","450","8","644","1366","0","47.14","13.62"
"64","000","00","190","0006","0377","636","186","450","8","644","1366","0","47.14","13.62"
"64","000","00","190","0007","0000","1326","1020","306","11","1337","2810","0","47.58","36.30"
"64","000","00","190","0007","0433","594","468","126","4","598","1316","0","45.44","35.56"
"64","000","00","190","0007","0434","564","477","87","6","570","1163","0","49.01","41.01"
"64","000","00","190","0007","0435","168","75","93","1","169","331","0","51.06","22.66"
"64","000","00","190","0008","0000","152","67","85","2","154","300","0","51.33","22.33"
"64","000","00","190","0008","0440","152","67","85","2","154","300","0","51.33","22.33"
"64","000","00","190","0009","0000","1188","463","725","10","1198","2809","0","42.65","16.48"
"64","000","00","190","0009","0401","563","225","338","6","569","1296","0","43.90","17.36"
"64","000","00","190","0009","0402","625","238","387","4","629","1513","0","41.57","15.73"
"64","000","00","190","0010","0000","706","224","482","8","714","1401","0","50.96","15.99"
"64","000","00","190","0010","0417","706","224","482","8","714","1401","0","50.96","15.99"
"64","000","00","190","0011","0000","1612","671","941","23","1635","3572","0","45.77","18.78"
"64","000","00","190","0011","0412","546","238","308","7","553","1283","0","43.10","18.55"
"64","000","00","190","0011","0413","487","227","260","6","493","1014","0","48.62","22.39"
"64","000","00","190","0011","0414","579","206","373","10","589","1275","0","46.20","16.16"
"64","000","00","190","0012","0000","2229","1051","1178","17","2246","5458","0","41.15","19.26"
"64","000","00","190","0012","0408","521","212","309","4","525","1271","0","41.31","16.68"
"64","000","00","190","0012","0409","599","271","328","7","606","1376","0","44.04","19.69"
"64","000","00","190","0012","0410","581","296","285","2","583","1330","0","43.83","22.26"
"64","000","00","190","0012","0411","528","272","256","4","532","1481","0","35.92","18.37"
"64","000","00","190","0013","0000","657","372","285","4","661","1556","0","42.48","23.91"
"64","000","00","190","0013","0438","356","199","157","3","359","828","0","43.36","24.03"
"64","000","00","190","0013","0439","301","173","128","1","302","728","0","41.48","23.76"
"64","000","00","190","0014","0000","337","87","250","3","340","761","0","44.68","11.43"
"64","000","00","190","0014","0428","337","87","250","3","340","761","0","44.68","11.43"
"64","000","00","190","0015","0000","365","78","287","4","369","867","0","42.56","9.00"
"64","000","00","190","0015","0431","365","78","287","4","369","867","0","42.56","9.00"
"64","000","00","190","0016","0000","1502","623","879","11","1513","3290","0","45.99","18.94"
"64","000","00","190","0016","0405","489","175","314","6","495","1036","0","47.78","16.89"
"64","000","00","190","0016","0406","511","208","303","3","514","1055","0","48.72","19.72"
"64","000","00","190","0016","0407","502","240","262","2","504","1199","0","42.04","20.02"
"64","000","00","190","0017","0000","1543","628","915","10","1553","3822","0","40.63","16.43"
"64","000","00","190","0017","0384","466","194","272","5","471","1258","0","37.44","15.42"
"64","000","00","190","0017","0385","496","200","296","3","499","1199","0","41.62","16.68"
"64","000","00","190","0017","0386","581","234","347","2","583","1365","0","42.71","17.14"
"64","000","00","190","0018","0000","1718","794","924","13","1731","4091","0","42.31","19.41"
"64","000","00","190","0018","0378","539","224","315","6","545","1301","0","41.89","17.22"
"64","000","00","190","0018","0379","600","271","329","2","602","1380","0","43.62","19.64"
"64","000","00","190","0018","0380","579","299","280","5","584","1410","0","41.42","21.21"
"64","000","00","190","0019","0000","2652","1068","1584","20","2672","6810","0","39.24","15.68"
"64","000","00","190","0019","0387","455","195","260","3","458","1257","0","36.44","15.51"
"64","000","00","190","0019","0388","553","203","350","1","554","1310","0","42.29","15.50"
"64","000","00","190","0019","0389","540","230","310","5","545","1341","0","40.64","17.15"
"64","000","00","190","0019","0390","566","230","336","6","572","1421","0","40.25","16.19"
"64","000","00","190","0019","0391","538","210","328","5","543","1481","0","36.66","14.18"
"64","000","00","190","0020","0000","2311","877","1434","14","2325","5811","0","40.01","15.09"
"64","000","00","190","0020","0392","645","238","407","6","651","1569","0","41.49","15.17"
"64","000","00","190","0020","0393","655","258","397","2","657","1647","0","39.89","15.66"
"64","000","00","190","0020","0394","528","218","310","4","532","1423","0","37.39","15.32"
"64","000","00","190","0020","0395","483","163","320","2","485","1172","0","41.38","13.91"
"64","000","00","190","0021","0000","769","286","483","4","773","1862","0","41.51","15.36"
"64","000","00","190","0021","0397","405","161","244","1","406","1000","0","40.60","16.10"
"64","000","00","190","0021","0398","364","125","239","3","367","862","0","42.58","14.50"
"64","000","00","190","0022","0000","783","307","476","5","788","1933","0","40.77","15.88"
"64","000","00","190","0022","0418","386","113","273","2","388","867","0","44.75","13.03"
"64","000","00","190","0022","0419","397","194","203","3","400","1066","0","37.52","18.20"
"64","000","00","190","0023","0000","887","317","570","5","892","1850","0","48.22","17.14"
"64","000","00","190","0023","0420","385","107","278","3","388","845","0","45.92","12.66"
"64","000","00","190","0023","0421","502","210","292","2","504","1005","0","50.15","20.90"
"64","000","00","190","0024","0000","472","182","290","3","475","1048","0","45.32","17.37"
"64","000","00","190","0024","0422","472","182","290","3","475","1048","0","45.32","17.37"
"64","000","00","190","0025","0000","679","236","443","3","682","1683","0","40.52","14.02"
"64","000","00","190","0025","0399","332","111","221","2","334","821","0","40.68","13.52"
"64","000","00","190","0025","0400","347","125","222","1","348","862","0","40.37","14.50"
"64","000","00","190","0026","0000","1397","397","1000","11","1408","3339","0","42.17","11.89"
"64","000","00","190","0026","0423","441","127","314","4","445","1013","0","43.93","12.54"
"64","000","00","190","0026","0424","408","126","282","4","412","996","0","41.37","12.65"
"64","000","00","190","0026","0425","548","144","404","3","551","1330","0","41.43","10.83"
"64","000","00","190","0027","0000","776","277","499","9","785","1747","0","44.93","15.86"
"64","000","00","190","0027","0426","624","233","391","6","630","1442","0","43.69","16.16"
"64","000","00","190","0027","0427","152","44","108","3","155","305","0","50.82","14.43"
"64","000","00","190","0028","0000","749","141","608","8","757","1567","0","48.31","9.00"
"64","000","00","190","0028","0429","341","73","268","4","345","723","0","47.72","10.10"
"64","000","00","190","0028","0430","408","68","340","4","412","844","0","48.82","8.06"
"64","000","00","190","0029","0000","362","134","228","4","366","984","0","37.20","13.62"
"64","000","00","190","0029","0432","362","134","228","4","366","984","0","37.20","13.62"
"64","000","00","190","0030","0000","869","463","406","1","870","2090","0","41.63","22.15"
"64","000","00","190","0030","0415","362","186","176","0","362","875","0","41.37","21.26"
"64","000","00","190","0030","0416","507","277","230","1","508","1215","0","41.81","22.80"
"64","000","00","190","0031","0000","290","93","197","3","293","631","0","46.43","14.74"
"64","000","00","190","0031","0396","290","93","197","3","293","631","0","46.43","14.74"
"64","000","00","190","0032","0000","964","445","519","8","972","2230","0","43.59","19.96"
"64","000","00","190","0032","0403","419","170","249","2","421","954","0","44.13","17.82"
"64","000","00","190","0032","0404","545","275","270","6","551","1276","0","43.18","21.55"
"64","000","00","190","0033","0000","985","880","105","10","995","1809","0","55.00","48.65"
"64","000","00","190","0033","0436","484","443","41","5","489","887","0","55.13","49.94"
"64","000","00","190","0033","0437","501","437","64","5","506","922","0","54.88","47.40"
"64","000","00","200","0000","0000","15839","5233","10606","144","15983","34350","39528","46.53","15.23"
"64","000","00","200","0001","0000","944","353","591","7","951","2052","0","46.35","17.20"
"64","000","00","200","0001","0489","452","156","296","5","457","944","0","48.41","16.53"
"64","000","00","200","0001","0490","492","197","295","2","494","1108","0","44.58","17.78"
"64","000","00","200","0002","0000","542","170","372","4","546","1060","0","51.51","16.04"
"64","000","00","200","0002","0491","542","170","372","4","546","1060","0","51.51","16.04"
"64","000","00","200","0003","0000","1130","362","768","8","1138","2289","0","49.72","15.81"
"64","000","00","200","0003","0492","593","195","398","4","597","1211","0","49.30","16.10"
"64","000","00","200","0003","0493","537","167","370","4","541","1078","0","50.19","15.49"
"64","000","00","200","0004","0000","1252","463","789","10","1262","2597","0","48.59","17.83"
"64","000","00","200","0004","0494","636","244","392","5","641","1338","0","47.91","18.24"
"64","000","00","200","0004","0495","616","219","397","5","621","1259","0","49.32","17.39"
"64","000","00","200","0005","0000","559","168","391","3","562","1196","0","46.99","14.05"
"64","000","00","200","0005","0496","559","168","391","3","562","1196","0","46.99","14.05"
"64","000","00","200","0006","0000","1075","304","771","11","1086","2294","0","47.34","13.25"
"64","000","00","200","0006","0497","479","143","336","6","485","1025","0","47.32","13.95"
"64","000","00","200","0006","0498","596","161","435","5","601","1269","0","47.36","12.69"
"64","000","00","200","0007","0000","653","168","485","4","657","1371","0","47.92","12.25"
"64","000","00","200","0007","0499","336","73","263","1","337","668","0","50.45","10.93"
"64","000","00","200","0007","0500","317","95","222","3","320","703","0","45.52","13.51"
"64","000","00","200","0008","0000","1439","511","928","14","1453","3241","0","44.83","15.77"
"64","000","00","200","0008","0501","532","166","366","3","535","1274","0","41.99","13.03"
"64","000","00","200","0008","0502","551","195","356","6","557","1230","0","45.28","15.85"
"64","000","00","200","0008","0503","356","150","206","5","361","737","0","48.98","20.35"
"64","000","00","200","0009","0000","726","203","523","8","734","1506","0","48.74","13.48"
"64","000","00","200","0009","0504","422","114","308","7","429","918","0","46.73","12.42"
"64","000","00","200","0009","0505","304","89","215","1","305","588","0","51.87","15.14"
"64","000","00","200","0010","0000","1865","763","1102","7","1872","4359","0","42.95","17.50"
"64","000","00","200","0010","0506","410","117","293","1","411","803","0","51.18","14.57"
"64","000","00","200","0010","0507","165","42","123","5","170","334","0","50.90","12.57"
"64","000","00","200","0010","0508","525","219","306","1","526","1367","0","38.48","16.02"
"64","000","00","200","0010","0509","363","168","195","0","363","888","0","40.88","18.92"
"64","000","00","200","0010","0510","402","217","185","0","402","967","0","41.57","22.44"
"64","000","00","200","0011","0000","929","324","605","17","946","2139","0","44.23","15.15"
"64","000","00","200","0011","0511","544","174","370","13","557","1208","0","46.11","14.40"
"64","000","00","200","0011","0512","385","150","235","4","389","931","0","41.78","16.11"
"64","000","00","200","0012","0000","1071","354","717","14","1085","2401","0","45.19","14.74"
"64","000","00","200","0012","0513","523","166","357","8","531","1196","0","44.40","13.88"
"64","000","00","200","0012","0514","548","188","360","6","554","1205","0","45.98","15.60"
"64","000","00","200","0013","0000","589","188","401","8","597","1340","0","44.55","14.03"
"64","000","00","200","0013","0515","589","188","401","8","597","1340","0","44.55","14.03"
"64","000","00","200","0014","0000","283","61","222","2","285","662","0","43.05","9.21"
"64","000","00","200","0014","0516","283","61","222","2","285","662","0","43.05","9.21"
"64","000","00","200","0015","0000","1763","549","1214","16","1779","3625","0","49.08","15.14"
"64","000","00","200","0015","0517","588","174","414","7","595","1212","0","49.09","14.36"
"64","000","00","200","0015","0518","601","182","419","6","607","1234","0","49.19","14.75"
"64","000","00","200","0015","0519","574","193","381","3","577","1179","0","48.94","16.37"
"64","000","00","200","0016","0000","666","215","451","8","674","1442","0","46.74","14.91"
"64","000","00","200","0016","0520","397","129","268","7","404","816","0","49.51","15.81"
"64","000","00","200","0016","0521","269","86","183","1","270","626","0","43.13","13.74"
"64","000","00","200","0017","0000","353","77","276","3","356","776","0","45.88","9.92"
"64","000","00","200","0017","0522","353","77","276","3","356","776","0","45.88","9.92"
"64","000","00","210","0000","0000","10337","3744","6593","113","10450","25855","29312","40.42","14.48"
"64","000","00","210","0001","0000","435","136","299","0","435","1096","0","39.69","12.41"
"64","000","00","210","0001","0173","435","136","299","0","435","1096","0","39.69","12.41"
"64","000","00","210","0002","0000","911","296","615","11","922","2055","0","44.87","14.40"
"64","000","00","210","0002","0174","503","167","336","7","510","1110","0","45.95","15.05"
"64","000","00","210","0002","0175","408","129","279","4","412","945","0","43.60","13.65"
"64","000","00","210","0003","0000","1388","471","917","24","1412","3308","0","42.68","14.24"
"64","000","00","210","0003","0176","457","128","329","3","460","1011","0","45.50","12.66"
"64","000","00","210","0003","0177","424","149","275","1","425","1072","0","39.65","13.90"
"64","000","00","210","0003","0178","410","113","297","5","415","1011","0","41.05","11.18"
"64","000","00","210","0003","0179","97","81","16","15","112","214","0","52.34","37.85"
"64","000","00","210","0004","0000","1144","436","708","14","1158","2690","0","43.05","16.21"
"64","000","00","210","0004","0180","438","184","254","9","447","935","0","47.81","19.68"
"64","000","00","210","0004","0181","270","60","210","2","272","620","0","43.87","9.68"
"64","000","00","210","0004","0182","436","192","244","3","439","1135","0","38.68","16.92"
"64","000","00","210","0005","0000","1051","362","689","8","1059","2471","0","42.86","14.65"
"64","000","00","210","0005","0183","475","141","334","3","478","1097","0","43.57","12.85"
"64","000","00","210","0005","0184","576","221","355","5","581","1374","0","42.29","16.08"
"64","000","00","210","0006","0000","165","79","86","6","171","464","0","36.85","17.03"
"64","000","00","210","0006","0185","165","79","86","6","171","464","0","36.85","17.03"
"64","000","00","210","0007","0000","874","309","565","8","882","2315","0","38.10","13.35"
"64","000","00","210","0007","0186","435","140","295","5","440","1191","0","36.94","11.75"
"64","000","00","210","0007","0187","439","169","270","3","442","1124","0","39.32","15.04"
"64","000","00","210","0008","0000","1500","642","858","13","1513","3871","0","39.09","16.58"
"64","000","00","210","0008","0188","471","172","299","6","477","1131","0","42.18","15.21"
"64","000","00","210","0008","0189","506","239","267","5","511","1389","0","36.79","17.21"
"64","000","00","210","0008","0190","523","231","292","2","525","1351","0","38.86","17.10"
"64","000","00","210","0009","0000","1279","465","814","11","1290","3315","0","38.91","14.03"
"64","000","00","210","0009","0191","413","147","266","4","417","958","0","43.53","15.34"
"64","000","00","210","0009","0192","427","157","270","6","433","1081","0","40.06","14.52"
"64","000","00","210","0009","0193","439","161","278","1","440","1276","0","34.48","12.62"
"64","000","00","210","0010","0000","700","249","451","8","708","1874","0","37.78","13.29"
"64","000","00","210","0010","0194","313","94","219","2","315","763","0","41.28","12.32"
"64","000","00","210","0010","0195","387","155","232","6","393","1111","0","35.37","13.95"
"64","000","00","210","0011","0000","890","299","591","10","900","2396","0","37.56","12.48"
"64","000","00","210","0011","0196","547","176","371","6","553","1371","0","40.34","12.84"
"64","000","00","210","0011","0197","343","123","220","4","347","1025","0","33.85","12.00"
"64","000","00","220","0000","0000","2320","693","1627","37","2357","6357","6860","37.08","10.90"
"64","000","00","220","0001","0000","142","50","92","0","142","347","0","40.92","14.41"
"64","000","00","220","0001","0161","142","50","92","0","142","347","0","40.92","14.41"
"64","000","00","220","0002","0000","366","108","258","8","374","1016","0","36.81","10.63"
"64","000","00","220","0002","0162","217","72","145","2","219","637","0","34.38","11.30"
"64","000","00","220","0002","0163","149","36","113","6","155","379","0","40.90","9.50"
"64","000","00","220","0003","0000","142","27","115","1","143","364","0","39.29","7.42"
"64","000","00","220","0003","0164","142","27","115","1","143","364","0","39.29","7.42"
"64","000","00","220","0004","0000","128","32","96","1","129","364","0","35.44","8.79"
"64","000","00","220","0004","0165","128","32","96","1","129","364","0","35.44","8.79"
"64","000","00","220","0005","0000","224","54","170","3","227","594","0","38.22","9.09"
"64","000","00","220","0005","0166","224","54","170","3","227","594","0","38.22","9.09"
"64","000","00","220","0006","0000","342","137","205","6","348","914","0","38.07","14.99"
"64","000","00","220","0006","0167","342","137","205","6","348","914","0","38.07","14.99"
"64","000","00","220","0007","0000","255","89","166","6","261","777","0","33.59","11.45"
"64","000","00","220","0007","0168","255","89","166","6","261","777","0","33.59","11.45"
"64","000","00","220","0008","0000","110","42","68","2","112","333","0","33.63","12.61"
"64","000","00","220","0008","0169","110","42","68","2","112","333","0","33.63","12.61"
"64","000","00","220","0009","0000","159","42","117","3","162","484","0","33.47","8.68"
"64","000","00","220","0009","0170","159","42","117","3","162","484","0","33.47","8.68"
"64","000","00","220","0010","0000","452","112","340","7","459","1164","0","39.43","9.62"
"64","000","00","220","0010","0171","219","42","177","2","221","574","0","38.50","7.32"
"64","000","00","220","0010","0172","233","70","163","5","238","590","0","40.34","11.86"
"64","000","00","230","0000","0000","9344","3035","6309","113","9457","24309","28170","38.90","12.49"
"64","000","00","230","0001","0000","485","129","356","4","489","1283","0","38.11","10.05"
"64","000","00","230","0001","0137","485","129","356","4","489","1283","0","38.11","10.05"
"64","000","00","230","0002","0000","823","180","643","12","835","1973","0","42.32","9.12"
"64","000","00","230","0002","0138","452","100","352","5","457","1086","0","42.08","9.21"
"64","000","00","230","0002","0139","371","80","291","7","378","887","0","42.62","9.02"
"64","000","00","230","0003","0000","460","123","337","5","465","1209","0","38.46","10.17"
"64","000","00","230","0003","0140","460","123","337","5","465","1209","0","38.46","10.17"
"64","000","00","230","0004","0000","870","360","510","7","877","2122","0","41.33","16.97"
"64","000","00","230","0004","0141","288","120","168","2","290","682","0","42.52","17.60"
"64","000","00","230","0004","0142","342","145","197","3","345","876","0","39.38","16.55"
"64","000","00","230","0004","0143","240","95","145","2","242","564","0","42.91","16.84"
"64","000","00","230","0005","0000","271","109","162","8","279","761","0","36.66","14.32"
"64","000","00","230","0005","0144","271","109","162","8","279","761","0","36.66","14.32"
"64","000","00","230","0006","0000","1787","596","1191","21","1808","4888","0","36.99","12.19"
"64","000","00","230","0006","0145","456","141","315","5","461","1226","0","37.60","11.50"
"64","000","00","230","0006","0146","441","154","287","5","446","1153","0","38.68","13.36"
"64","000","00","230","0006","0147","410","132","278","4","414","1222","0","33.88","10.80"
"64","000","00","230","0006","0148","480","169","311","7","487","1287","0","37.84","13.13"
"64","000","00","230","0007","0000","951","296","655","12","963","2590","0","37.18","11.43"
"64","000","00","230","0007","0149","309","83","226","0","309","893","0","34.60","9.29"
"64","000","00","230","0007","0150","311","93","218","3","314","831","0","37.79","11.19"
"64","000","00","230","0007","0151","331","120","211","9","340","866","0","39.26","13.86"
"64","000","00","230","0008","0000","915","275","640","13","928","2291","0","40.51","12.00"
"64","000","00","230","0008","0152","424","129","295","5","429","1057","0","40.59","12.20"
"64","000","00","230","0008","0153","491","146","345","8","499","1234","0","40.44","11.83"
"64","000","00","230","0009","0000","563","205","358","4","567","1541","0","36.79","13.30"
"64","000","00","230","0009","0154","563","205","358","4","567","1541","0","36.79","13.30"
"64","000","00","230","0010","0000","630","210","420","10","640","1648","0","38.83","12.74"
"64","000","00","230","0010","0155","327","82","245","2","329","852","0","38.62","9.62"
"64","000","00","230","0010","0156","303","128","175","8","311","796","0","39.07","16.08"
"64","000","00","230","0011","0000","455","102","353","11","466","1043","0","44.68","9.78"
"64","000","00","230","0011","0157","455","102","353","11","466","1043","0","44.68","9.78"
"64","000","00","230","0012","0000","1134","450","684","6","1140","2960","0","38.51","15.20"
"64","000","00","230","0012","0158","409","144","265","2","411","1082","0","37.99","13.31"
"64","000","00","230","0012","0159","374","160","214","2","376","1054","0","35.67","15.18"
"64","000","00","230","0012","0160","351","146","205","2","353","824","0","42.84","17.72"
"64","000","00","240","0000","0000","17127","6423","10704","171","17298","43320","51490","39.93","14.83"
"64","000","00","240","0001","0000","1150","430","720","9","1159","3254","0","35.62","13.21"
"64","000","00","240","0001","0311","383","138","245","2","385","1004","0","38.35","13.75"
"64","000","00","240","0001","0312","356","106","250","3","359","1055","0","34.03","10.05"
"64","000","00","240","0001","0313","411","186","225","4","415","1195","0","34.73","15.56"
"64","000","00","240","0002","0000","468","171","297","7","475","1144","0","41.52","14.95"
"64","000","00","240","0002","0314","468","171","297","7","475","1144","0","41.52","14.95"
"64","000","00","240","0003","0000","442","151","291","7","449","1195","0","37.57","12.64"
"64","000","00","240","0003","0315","442","151","291","7","449","1195","0","37.57","12.64"
"64","000","00","240","0004","0000","436","140","296","1","437","1098","0","39.80","12.75"
"64","000","00","240","0004","0316","436","140","296","1","437","1098","0","39.80","12.75"
"64","000","00","240","0005","0000","568","193","375","6","574","1220","0","47.05","15.82"
"64","000","00","240","0005","0317","568","193","375","6","574","1220","0","47.05","15.82"
"64","000","00","240","0006","0000","897","344","553","12","909","2211","0","41.11","15.56"
"64","000","00","240","0006","0318","417","171","246","5","422","1120","0","37.68","15.27"
"64","000","00","240","0006","0319","480","173","307","7","487","1091","0","44.64","15.86"
"64","000","00","240","0007","0000","818","295","523","8","826","2084","0","39.64","14.16"
"64","000","00","240","0007","0320","408","151","257","3","411","942","0","43.63","16.03"
"64","000","00","240","0007","0321","410","144","266","5","415","1142","0","36.34","12.61"
"64","000","00","240","0008","0000","1198","533","665","13","1211","3276","0","36.97","16.27"
"64","000","00","240","0008","0322","388","162","226","3","391","1014","0","38.56","15.98"
"64","000","00","240","0008","0323","404","198","206","3","407","996","0","40.86","19.88"
"64","000","00","240","0008","0324","406","173","233","7","413","1266","0","32.62","13.67"
"64","000","00","240","0009","0000","964","306","658","12","976","2623","0","37.21","11.67"
"64","000","00","240","0009","0325","323","105","218","3","326","854","0","38.17","12.30"
"64","000","00","240","0009","0326","301","105","196","6","307","827","0","37.12","12.70"
"64","000","00","240","0009","0327","340","96","244","3","343","942","0","36.41","10.19"
"64","000","00","240","0010","0000","655","202","453","7","662","1825","0","36.27","11.07"
"64","000","00","240","0010","0328","281","100","181","2","283","787","0","35.96","12.71"
"64","000","00","240","0010","0329","374","102","272","5","379","1038","0","36.51","9.83"
"64","000","00","240","0011","0000","1384","563","821","10","1394","3439","0","40.54","16.37"
"64","000","00","240","0011","0330","372","141","231","1","373","912","0","40.90","15.46"
"64","000","00","240","0011","0331","323","139","184","4","327","717","0","45.61","19.39"
"64","000","00","240","0011","0332","330","137","193","3","333","914","0","36.43","14.99"
"64","000","00","240","0011","0333","359","146","213","2","361","896","0","40.29","16.29"
"64","000","00","240","0012","0000","869","365","504","7","876","2163","0","40.50","16.87"
"64","000","00","240","0012","0334","392","149","243","4","396","1026","0","38.60","14.52"
"64","000","00","240","0012","0335","477","216","261","3","480","1137","0","42.22","19.00"
"64","000","00","240","0013","0000","1149","396","753","8","1157","2976","0","38.88","13.31"
"64","000","00","240","0013","0336","377","126","251","1","378","952","0","39.71","13.24"
"64","000","00","240","0013","0337","418","157","261","5","423","1036","0","40.83","15.15"
"64","000","00","240","0013","0338","354","113","241","2","356","988","0","36.03","11.44"
"64","000","00","240","0014","0000","1013","424","589","10","1023","2337","0","43.77","18.14"
"64","000","00","240","0014","0339","511","198","313","5","516","1234","0","41.82","16.05"
"64","000","00","240","0014","0340","502","226","276","5","507","1103","0","45.97","20.49"
"64","000","00","240","0015","0000","358","110","248","2","360","841","0","42.81","13.08"
"64","000","00","240","0015","0341","358","110","248","2","360","841","0","42.81","13.08"
"64","000","00","240","0016","0000","770","274","496","9","779","1908","0","40.83","14.36"
"64","000","00","240","0016","0342","429","154","275","5","434","971","0","44.70","15.86"
"64","000","00","240","0016","0343","341","120","221","4","345","937","0","36.82","12.81"
"64","000","00","240","0017","0000","681","220","461","8","689","1711","0","40.27","12.86"
"64","000","00","240","0017","0344","302","97","205","2","304","823","0","36.94","11.79"
"64","000","00","240","0017","0345","379","123","256","6","385","888","0","43.36","13.85"
"64","000","00","240","0018","0000","330","106","224","3","333","846","0","39.36","12.53"
"64","000","00","240","0018","0346","330","106","224","3","333","846","0","39.36","12.53"
"64","000","00","240","0019","0000","1168","470","698","8","1176","2643","0","44.49","17.78"
"64","000","00","240","0019","0347","417","156","261","1","418","921","0","45.39","16.94"
"64","000","00","240","0019","0348","384","169","215","4","388","849","0","45.70","19.91"
"64","000","00","240","0019","0349","367","145","222","3","370","873","0","42.38","16.61"
"64","000","00","240","0020","0000","1809","730","1079","24","1833","4526","0","40.50","16.13"
"64","000","00","240","0020","0350","384","134","250","5","389","902","0","43.13","14.86"
"64","000","00","240","0020","0351","367","136","231","6","373","858","0","43.47","15.85"
"64","000","00","240","0020","0352","312","124","188","2","314","913","0","34.39","13.58"
"64","000","00","240","0020","0353","346","147","199","6","352","894","0","39.37","16.44"
"64","000","00","240","0020","0354","400","189","211","5","405","959","0","42.23","19.71"
"64","000","00","250","0000","0000","10017","3404","6613","90","10107","25813","29772","39.15","13.19"
"64","000","00","250","0001","0000","475","160","315","5","480","1070","0","44.86","14.95"
"64","000","00","250","0001","0284","475","160","315","5","480","1070","0","44.86","14.95"
"64","000","00","250","0002","0000","392","121","271","3","395","981","0","40.27","12.33"
"64","000","00","250","0002","0285","392","121","271","3","395","981","0","40.27","12.33"
"64","000","00","250","0003","0000","358","96","262","2","360","768","0","46.88","12.50"
"64","000","00","250","0003","0286","358","96","262","2","360","768","0","46.88","12.50"
"64","000","00","250","0004","0000","856","306","550","6","862","2214","0","38.93","13.82"
"64","000","00","250","0004","0287","420","145","275","4","424","1104","0","38.41","13.13"
"64","000","00","250","0004","0288","436","161","275","2","438","1110","0","39.46","14.50"
"64","000","00","250","0005","0000","1026","277","749","7","1033","2648","0","39.01","10.46"
"64","000","00","250","0005","0289","351","90","261","1","352","889","0","39.60","10.12"
"64","000","00","250","0005","0290","338","88","250","4","342","876","0","39.04","10.05"
"64","000","00","250","0005","0291","337","99","238","2","339","883","0","38.39","11.21"
"64","000","00","250","0006","0000","1441","564","877","10","1451","3677","0","39.46","15.34"
"64","000","00","250","0006","0292","318","110","208","5","323","882","0","36.62","12.47"
"64","000","00","250","0006","0293","389","127","262","1","390","914","0","42.67","13.89"
"64","000","00","250","0006","0294","379","168","211","3","382","930","0","41.08","18.06"
"64","000","00","250","0006","0295","355","159","196","1","356","951","0","37.43","16.72"
"64","000","00","250","0007","0000","399","151","248","4","403","997","0","40.42","15.15"
"64","000","00","250","0007","0296","399","151","248","4","403","997","0","40.42","15.15"
"64","000","00","250","0008","0000","1477","576","901","10","1487","3781","0","39.33","15.23"
"64","000","00","250","0008","0297","322","120","202","3","325","795","0","40.88","15.09"
"64","000","00","250","0008","0298","360","115","245","3","363","778","0","46.66","14.78"
"64","000","00","250","0008","0299","377","166","211","3","380","1059","0","35.88","15.68"
"64","000","00","250","0008","0300","418","175","243","1","419","1149","0","36.47","15.23"
"64","000","00","250","0009","0000","716","191","525","9","725","1752","0","41.38","10.90"
"64","000","00","250","0009","0301","412","101","311","3","415","913","0","45.45","11.06"
"64","000","00","250","0009","0302","304","90","214","6","310","839","0","36.95","10.73"
"64","000","00","250","0010","0000","482","152","330","3","485","1198","0","40.48","12.69"
"64","000","00","250","0010","0303","482","152","330","3","485","1198","0","40.48","12.69"
"64","000","00","250","0011","0000","765","207","558","7","772","2155","0","35.82","9.61"
"64","000","00","250","0011","0304","367","93","274","2","369","1074","0","34.36","8.66"
"64","000","00","250","0011","0305","398","114","284","5","403","1081","0","37.28","10.55"
"64","000","00","250","0012","0000","423","121","302","7","430","1133","0","37.95","10.68"
"64","000","00","250","0012","0306","423","121","302","7","430","1133","0","37.95","10.68"
"64","000","00","250","0013","0000","275","86","189","2","277","700","0","39.57","12.29"
"64","000","00","250","0013","0307","275","86","189","2","277","700","0","39.57","12.29"
"64","000","00","250","0014","0000","932","396","536","15","947","2739","0","34.57","14.46"
"64","000","00","250","0014","0308","339","147","192","9","348","935","0","37.22","15.72"
"64","000","00","250","0014","0309","328","147","181","4","332","961","0","34.55","15.30"
"64","000","00","250","0014","0310","265","102","163","2","267","843","0","31.67","12.10"
"64","000","00","260","0000","0000","9750","3220","6530","80","9830","26119","29883","37.64","12.33"
"64","000","00","260","0001","0000","421","109","312","3","424","955","0","44.40","11.41"
"64","000","00","260","0001","0260","421","109","312","3","424","955","0","44.40","11.41"
"64","000","00","260","0002","0000","333","109","224","4","337","854","0","39.46","12.76"
"64","000","00","260","0002","0261","333","109","224","4","337","854","0","39.46","12.76"
"64","000","00","260","0003","0000","685","266","419","4","689","1718","0","40.10","15.48"
"64","000","00","260","0003","0262","375","149","226","3","378","899","0","42.05","16.57"
"64","000","00","260","0003","0263","310","117","193","1","311","819","0","37.97","14.29"
"64","000","00","260","0004","0000","1454","473","981","7","1461","3784","0","38.61","12.50"
"64","000","00","260","0004","0264","413","145","268","2","415","1247","0","33.28","11.63"
"64","000","00","260","0004","0265","542","177","365","2","544","1323","0","41.12","13.38"
"64","000","00","260","0004","0266","499","151","348","3","502","1214","0","41.35","12.44"
"64","000","00","260","0005","0000","670","241","429","1","671","1771","0","37.89","13.61"
"64","000","00","260","0005","0267","340","135","205","0","340","945","0","35.98","14.29"
"64","000","00","260","0005","0268","330","106","224","1","331","826","0","40.07","12.83"
"64","000","00","260","0006","0000","420","114","306","3","423","1100","0","38.45","10.36"
"64","000","00","260","0006","0274","420","114","306","3","423","1100","0","38.45","10.36"
"64","000","00","260","0007","0000","1116","332","784","5","1121","2955","0","37.94","11.24"
"64","000","00","260","0007","0275","522","146","376","2","524","1303","0","40.21","11.20"
"64","000","00","260","0007","0276","594","186","408","3","597","1652","0","36.14","11.26"
"64","000","00","260","0008","0000","307","104","203","1","308","919","0","33.51","11.32"
"64","000","00","260","0008","0278","307","104","203","1","308","919","0","33.51","11.32"
"64","000","00","260","0009","0000","340","117","223","4","344","1060","0","32.45","11.04"
"64","000","00","260","0009","0277","340","117","223","4","344","1060","0","32.45","11.04"
"64","000","00","260","0010","0000","433","118","315","5","438","1114","0","39.32","10.59"
"64","000","00","260","0010","0279","433","118","315","5","438","1114","0","39.32","10.59"
"64","000","00","260","0011","0000","760","269","491","9","769","2061","0","37.31","13.05"
"64","000","00","260","0011","0269","302","118","184","3","305","823","0","37.06","14.34"
"64","000","00","260","0011","0270","458","151","307","6","464","1238","0","37.48","12.20"
"64","000","00","260","0012","0000","382","105","277","2","384","1067","0","35.99","9.84"
"64","000","00","260","0012","0271","382","105","277","2","384","1067","0","35.99","9.84"
"64","000","00","260","0013","0000","310","98","212","6","316","966","0","32.71","10.14"
"64","000","00","260","0013","0272","310","98","212","6","316","966","0","32.71","10.14"
"64","000","00","260","0014","0000","458","143","315","3","461","1116","0","41.31","12.81"
"64","000","00","260","0014","0273","458","143","315","3","461","1116","0","41.31","12.81"
"64","000","00","260","0015","0000","1661","622","1039","23","1684","4679","0","35.99","13.29"
"64","000","00","260","0015","0280","425","176","249","9","434","1073","0","40.45","16.40"
"64","000","00","260","0015","0281","423","159","264","11","434","1133","0","38.31","14.03"
"64","000","00","260","0015","0282","371","132","239","2","373","1135","0","32.86","11.63"
"64","000","00","260","0015","0283","442","155","287","1","443","1338","0","33.11","11.58"
"64","000","00","270","0000","0000","4608","1681","2927","28","4636","11982","13609","38.69","14.03"
"64","000","00","270","0001","0000","639","260","379","3","642","1558","0","41.21","16.69"
"64","000","00","270","0001","0355","337","135","202","1","338","751","0","45.01","17.98"
"64","000","00","270","0001","0356","302","125","177","2","304","807","0","37.67","15.49"
"64","000","00","270","0002","0000","736","278","458","5","741","1799","0","41.19","15.45"
"64","000","00","270","0002","0357","377","144","233","4","381","849","0","44.88","16.96"
"64","000","00","270","0002","0358","359","134","225","1","360","950","0","37.89","14.11"
"64","000","00","270","0003","0000","888","283","605","4","892","2291","0","38.93","12.35"
"64","000","00","270","0003","0359","322","99","223","0","322","818","0","39.36","12.10"
"64","000","00","270","0003","0360","315","86","229","2","317","832","0","38.10","10.34"
"64","000","00","270","0003","0361","251","98","153","2","253","641","0","39.47","15.29"
"64","000","00","270","0004","0000","141","39","102","1","142","374","0","37.97","10.43"
"64","000","00","270","0004","0362","141","39","102","1","142","374","0","37.97","10.43"
"64","000","00","270","0005","0000","949","386","563","4","953","2564","0","37.17","15.05"
"64","000","00","270","0005","0363","496","209","287","1","497","1343","0","37.01","15.56"
"64","000","00","270","0005","0364","453","177","276","3","456","1221","0","37.35","14.50"
"64","000","00","270","0006","0000","1255","435","820","11","1266","3396","0","37.28","12.81"
"64","000","00","270","0006","0365","442","118","324","6","448","1137","0","39.40","10.38"
"64","000","00","270","0006","0366","404","129","275","1","405","1085","0","37.33","11.89"
"64","000","00","270","0006","0367","409","188","221","4","413","1174","0","35.18","16.01"
"64","000","00","280","0000","0000","6574","2580","3994","70","6644","16271","18759","40.83","15.86"
"64","000","00","280","0001","0000","498","162","336","7","505","1250","0","40.40","12.96"
"64","000","00","280","0001","0441","498","162","336","7","505","1250","0","40.40","12.96"
"64","000","00","280","0002","0000","779","281","498","8","787","1846","0","42.63","15.22"
"64","000","00","280","0002","0442","399","153","246","2","401","893","0","44.90","17.13"
"64","000","00","280","0002","0443","380","128","252","6","386","953","0","40.50","13.43"
"64","000","00","280","0003","0000","214","100","114","1","215","533","0","40.34","18.76"
"64","000","00","280","0003","0444","214","100","114","1","215","533","0","40.34","18.76"
"64","000","00","280","0004","0000","343","161","182","2","345","738","0","46.75","21.82"
"64","000","00","280","0004","0445","343","161","182","2","345","738","0","46.75","21.82"
"64","000","00","280","0005","0000","735","308","427","8","743","1710","0","43.45","18.01"
"64","000","00","280","0005","0446","361","167","194","4","365","815","0","44.79","20.49"
"64","000","00","280","0005","0447","374","141","233","4","378","895","0","42.23","15.75"
"64","000","00","280","0006","0000","622","234","388","7","629","1565","0","40.19","14.95"
"64","000","00","280","0006","0448","300","110","190","3","303","761","0","39.82","14.45"
"64","000","00","280","0006","0449","322","124","198","4","326","804","0","40.55","15.42"
"64","000","00","280","0007","0000","670","230","440","11","681","1681","0","40.51","13.68"
"64","000","00","280","0007","0450","339","121","218","3","342","858","0","39.86","14.10"
"64","000","00","280","0007","0451","331","109","222","8","339","823","0","41.19","13.24"
"64","000","00","280","0008","0000","805","308","497","5","810","2007","0","40.36","15.35"
"64","000","00","280","0008","0453","402","147","255","4","406","1000","0","40.60","14.70"
"64","000","00","280","0008","0454","403","161","242","1","404","1007","0","40.12","15.99"
"64","000","00","280","0009","0000","357","142","215","7","364","918","0","39.65","15.47"
"64","000","00","280","0009","0452","357","142","215","7","364","918","0","39.65","15.47"
"64","000","00","280","0010","0000","294","124","170","3","297","804","0","36.94","15.42"
"64","000","00","280","0010","0455","294","124","170","3","297","804","0","36.94","15.42"
"64","000","00","280","0011","0000","453","216","237","5","458","1134","0","40.39","19.05"
"64","000","00","280","0011","0456","453","216","237","5","458","1134","0","40.39","19.05"
"64","000","00","280","0012","0000","804","314","490","6","810","2085","0","38.85","15.06"
"64","000","00","280","0012","0457","482","203","279","3","485","1228","0","39.50","16.53"
"64","000","00","280","0012","0458","322","111","211","3","325","857","0","37.92","12.95"
"64","000","00","290","0000","0000","12983","4126","8857","107","13090","30908","35292","42.35","13.35"
"64","000","00","290","0001","0000","911","252","659","5","916","2095","0","43.72","12.03"
"64","000","00","290","0001","0459","440","115","325","2","442","1053","0","41.98","10.92"
"64","000","00","290","0001","0460","471","137","334","3","474","1042","0","45.49","13.15"
"64","000","00","290","0002","0000","825","268","557","5","830","2030","0","40.89","13.20"
"64","000","00","290","0002","0461","401","123","278","1","402","942","0","42.68","13.06"
"64","000","00","290","0002","0462","424","145","279","4","428","1088","0","39.34","13.33"
"64","000","00","290","0003","0000","1095","342","753","4","1099","2213","0","49.66","15.45"
"64","000","00","290","0003","0463","387","123","264","3","390","814","0","47.91","15.11"
"64","000","00","290","0003","0464","310","88","222","0","310","632","0","49.05","13.92"
"64","000","00","290","0003","0465","398","131","267","1","399","767","0","52.02","17.08"
"64","000","00","290","0004","0000","659","194","465","11","670","1476","0","45.39","13.14"
"64","000","00","290","0004","0466","659","194","465","11","670","1476","0","45.39","13.14"
"64","000","00","290","0005","0000","561","168","393","2","563","1154","0","48.79","14.56"
"64","000","00","290","0005","0467","561","168","393","2","563","1154","0","48.79","14.56"
"64","000","00","290","0006","0000","767","218","549","7","774","1791","0","43.22","12.17"
"64","000","00","290","0006","0472","470","144","326","3","473","1102","0","42.92","13.07"
"64","000","00","290","0006","0473","297","74","223","4","301","689","0","43.69","10.74"
"64","000","00","290","0007","0000","799","209","590","7","806","2055","0","39.22","10.17"
"64","000","00","290","0007","0477","411","94","317","2","413","1033","0","39.98","9.10"
"64","000","00","290","0007","0478","388","115","273","5","393","1022","0","38.45","11.25"
"64","000","00","290","0008","0000","1122","386","736","8","1130","2858","0","39.54","13.51"
"64","000","00","290","0008","0479","442","115","327","3","445","1216","0","36.60","9.46"
"64","000","00","290","0008","0480","313","100","213","4","317","787","0","40.28","12.71"
"64","000","00","290","0008","0481","367","171","196","1","368","855","0","43.04","20.00"
"64","000","00","290","0009","0000","876","317","559","6","882","2313","0","38.13","13.71"
"64","000","00","290","0009","0482","282","103","179","2","284","814","0","34.89","12.65"
"64","000","00","290","0009","0483","594","214","380","4","598","1499","0","39.89","14.28"
"64","000","00","290","0010","0000","386","125","261","3","389","970","0","40.10","12.89"
"64","000","00","290","0010","0468","386","125","261","3","389","970","0","40.10","12.89"
"64","000","00","290","0011","0000","1528","474","1054","14","1542","3701","0","41.66","12.81"
"64","000","00","290","0011","0469","583","166","417","7","590","1353","0","43.61","12.27"
"64","000","00","290","0011","0470","522","171","351","0","522","1270","0","41.10","13.46"
"64","000","00","290","0011","0471","423","137","286","7","430","1078","0","39.89","12.71"
"64","000","00","290","0012","0000","906","251","655","11","917","2221","0","41.29","11.30"
"64","000","00","290","0012","0474","505","129","376","6","511","1290","0","39.61","10.00"
"64","000","00","290","0012","0475","401","122","279","5","406","931","0","43.61","13.10"
"64","000","00","290","0013","0000","342","121","221","4","346","801","0","43.20","15.11"
"64","000","00","290","0013","0476","342","121","221","4","346","801","0","43.20","15.11"
"64","000","00","290","0014","0000","905","312","593","10","915","2258","0","40.52","13.82"
"64","000","00","290","0014","0484","514","177","337","5","519","1142","0","45.45","15.50"
"64","000","00","290","0014","0485","391","135","256","5","396","1116","0","35.48","12.10"
"64","000","00","290","0015","0000","1301","489","812","10","1311","2972","0","44.11","16.45"
"64","000","00","290","0015","0486","538","170","368","6","544","1230","0","44.23","13.82"
"64","000","00","290","0015","0487","315","75","240","2","317","764","0","41.49","9.82"
"64","000","00","290","0015","0488","448","244","204","2","450","978","0","46.01","24.95"
"64","000","00","300","0000","0000","11733","4426","7307","142","11875","31152","35449","38.12","14.21"
"64","000","00","300","0001","0000","835","336","499","6","841","2165","0","38.85","15.52"
"64","000","00","300","0001","0064","458","182","276","1","459","1066","0","43.06","17.07"
"64","000","00","300","0001","0065","377","154","223","5","382","1099","0","34.76","14.01"
"64","000","00","300","0002","0000","919","422","497","12","931","2273","0","40.96","18.57"
"64","000","00","300","0002","0066","413","193","220","2","415","1071","0","38.75","18.02"
"64","000","00","300","0002","0067","506","229","277","10","516","1202","0","42.93","19.05"
"64","000","00","300","0003","0000","579","214","365","6","585","1578","0","37.07","13.56"
"64","000","00","300","0003","0068","304","119","185","4","308","874","0","35.24","13.62"
"64","000","00","300","0003","0069","275","95","180","2","277","704","0","39.35","13.49"
"64","000","00","300","0004","0000","585","232","353","10","595","1802","0","33.02","12.87"
"64","000","00","300","0004","0070","358","132","226","8","366","1071","0","34.17","12.32"
"64","000","00","300","0004","0071","227","100","127","2","229","731","0","31.33","13.68"
"64","000","00","300","0005","0000","456","213","243","4","460","1418","0","32.44","15.02"
"64","000","00","300","0005","0072","341","131","210","1","342","1075","0","31.81","12.19"
"64","000","00","300","0005","0073","115","82","33","3","118","343","0","34.40","23.91"
"64","000","00","300","0006","0000","414","191","223","7","421","1338","0","31.46","14.28"
"64","000","00","300","0006","0074","254","96","158","6","260","840","0","30.95","11.43"
"64","000","00","300","0006","0075","160","95","65","1","161","498","0","32.33","19.08"
"64","000","00","300","0007","0000","386","93","293","1","387","1008","0","38.39","9.23"
"64","000","00","300","0007","0076","386","93","293","1","387","1008","0","38.39","9.23"
"64","000","00","300","0008","0000","317","115","202","9","326","759","0","42.95","15.15"
"64","000","00","300","0008","0077","317","115","202","9","326","759","0","42.95","15.15"
"64","000","00","300","0009","0000","841","250","591","13","854","2092","0","40.82","11.95"
"64","000","00","300","0009","0078","396","122","274","7","403","917","0","43.95","13.30"
"64","000","00","300","0009","0079","445","128","317","6","451","1175","0","38.38","10.89"
"64","000","00","300","0010","0000","67","19","48","1","68","179","0","37.99","10.61"
"64","000","00","300","0010","0080","67","19","48","1","68","179","0","37.99","10.61"
"64","000","00","300","0011","0000","806","320","486","11","817","1924","0","42.46","16.63"
"64","000","00","300","0011","0082","400","177","223","4","404","926","0","43.63","19.11"
"64","000","00","300","0011","0083","406","143","263","7","413","998","0","41.38","14.33"
"64","000","00","300","0012","0000","389","175","214","3","392","983","0","39.88","17.80"
"64","000","00","300","0012","0081","389","175","214","3","392","983","0","39.88","17.80"
"64","000","00","300","0013","0000","568","254","314","9","577","1544","0","37.37","16.45"
"64","000","00","300","0013","0084","335","142","193","5","340","876","0","38.81","16.21"
"64","000","00","300","0013","0085","233","112","121","4","237","668","0","35.48","16.77"
"64","000","00","300","0014","0000","755","278","477","6","761","1999","0","38.07","13.91"
"64","000","00","300","0014","0086","365","113","252","1","366","943","0","38.81","11.98"
"64","000","00","300","0014","0087","390","165","225","5","395","1056","0","37.41","15.63"
"64","000","00","300","0015","0000","1108","408","700","12","1120","3245","0","34.51","12.57"
"64","000","00","300","0015","0088","419","151","268","6","425","1085","0","39.17","13.92"
"64","000","00","300","0015","0089","312","128","184","3","315","1056","0","29.83","12.12"
"64","000","00","300","0015","0090","377","129","248","3","380","1104","0","34.42","11.68"
"64","000","00","300","0016","0000","834","322","512","5","839","2216","0","37.86","14.53"
"64","000","00","300","0016","0091","347","170","177","2","349","949","0","36.78","17.91"
"64","000","00","300","0016","0092","240","90","150","1","241","608","0","39.64","14.80"
"64","000","00","300","0016","0093","247","62","185","2","249","659","0","37.78","9.41"
"64","000","00","300","0017","0000","324","69","255","4","328","705","0","46.52","9.79"
"64","000","00","300","0017","0094","324","69","255","4","328","705","0","46.52","9.79"
"64","000","00","300","0018","0000","482","148","334","5","487","1254","0","38.84","11.80"
"64","000","00","300","0018","0095","482","148","334","5","487","1254","0","38.84","11.80"
"64","000","00","300","0019","0000","326","91","235","4","330","797","0","41.41","11.42"
"64","000","00","300","0019","0096","326","91","235","4","330","797","0","41.41","11.42"
"64","000","00","300","0020","0000","523","164","359","7","530","1262","0","42.00","13.00"
"64","000","00","300","0020","0097","523","164","359","7","530","1262","0","42.00","13.00"
"64","000","00","300","0021","0000","219","112","107","7","226","611","0","36.99","18.33"
"64","000","00","300","0021","0098","219","112","107","7","226","611","0","36.99","18.33"
"64","000","00","310","0000","0000","12618","6024","6594","146","12764","34303","38209","37.21","17.56"
"64","000","00","310","0001","0000","982","457","525","12","994","2547","0","39.03","17.94"
"64","000","00","310","0001","0099","463","216","247","6","469","1141","0","41.10","18.93"
"64","000","00","310","0001","0100","232","118","114","3","235","689","0","34.11","17.13"
"64","000","00","310","0001","0101","287","123","164","3","290","717","0","40.45","17.15"
"64","000","00","310","0002","0000","833","448","385","9","842","2321","0","36.28","19.30"
"64","000","00","310","0002","0102","358","188","170","3","361","958","0","37.68","19.62"
"64","000","00","310","0002","0103","239","127","112","2","241","655","0","36.79","19.39"
"64","000","00","310","0002","0104","236","133","103","4","240","708","0","33.90","18.79"
"64","000","00","310","0003","0000","967","496","471","15","982","2552","0","38.48","19.44"
"64","000","00","310","0003","0105","475","237","238","12","487","1295","0","37.61","18.30"
"64","000","00","310","0003","0106","492","259","233","3","495","1257","0","39.38","20.60"
"64","000","00","310","0004","0000","702","339","363","4","706","1978","0","35.69","17.14"
"64","000","00","310","0004","0107","345","149","196","2","347","968","0","35.85","15.39"
"64","000","00","310","0004","0108","357","190","167","2","359","1010","0","35.54","18.81"
"64","000","00","310","0005","0000","539","320","219","7","546","1462","0","37.35","21.89"
"64","000","00","310","0005","0109","539","320","219","7","546","1462","0","37.35","21.89"
"64","000","00","310","0006","0000","685","335","350","14","699","2113","0","33.08","15.85"
"64","000","00","310","0006","0110","356","171","185","8","364","1105","0","32.94","15.48"
"64","000","00","310","0006","0111","329","164","165","6","335","1008","0","33.23","16.27"
"64","000","00","310","0007","0000","963","417","546","6","969","2433","0","39.83","17.14"
"64","000","00","310","0007","0112","545","216","329","4","549","1428","0","38.45","15.13"
"64","000","00","310","0007","0113","418","201","217","2","420","1005","0","41.79","20.00"
"64","000","00","310","0008","0000","531","247","284","6","537","1382","0","38.86","17.87"
"64","000","00","310","0008","0114","274","136","138","3","277","646","0","42.88","21.05"
"64","000","00","310","0008","0115","257","111","146","3","260","736","0","35.33","15.08"
"64","000","00","310","0009","0000","468","202","266","5","473","1299","0","36.41","15.55"
"64","000","00","310","0009","0116","468","202","266","5","473","1299","0","36.41","15.55"
"64","000","00","310","0010","0000","425","180","245","7","432","1158","0","37.31","15.54"
"64","000","00","310","0010","0117","425","180","245","7","432","1158","0","37.31","15.54"
"64","000","00","310","0011","0000","754","395","359","10","764","2066","0","36.98","19.12"
"64","000","00","310","0011","0118","343","161","182","4","347","880","0","39.43","18.30"
"64","000","00","310","0011","0119","411","234","177","6","417","1186","0","35.16","19.73"
"64","000","00","310","0012","0000","429","187","242","2","431","1184","0","36.40","15.79"
"64","000","00","310","0012","0120","429","187","242","2","431","1184","0","36.40","15.79"
"64","000","00","310","0013","0000","611","312","299","4","615","1527","0","40.28","20.43"
"64","000","00","310","0013","0121","278","129","149","1","279","718","0","38.86","17.97"
"64","000","00","310","0013","0122","333","183","150","3","336","809","0","41.53","22.62"
"64","000","00","310","0014","0000","791","363","428","5","796","2186","0","36.41","16.61"
"64","000","00","310","0014","0123","368","159","209","0","368","1066","0","34.52","14.92"
"64","000","00","310","0014","0124","423","204","219","5","428","1120","0","38.21","18.21"
"64","000","00","310","0015","0000","662","320","342","3","665","1720","0","38.66","18.60"
"64","000","00","310","0015","0125","335","168","167","3","338","944","0","35.81","17.80"
"64","000","00","310","0015","0126","327","152","175","0","327","776","0","42.14","19.59"
"64","000","00","310","0016","0000","680","301","379","11","691","1826","0","37.84","16.48"
"64","000","00","310","0016","0127","318","149","169","8","326","918","0","35.51","16.23"
"64","000","00","310","0016","0128","362","152","210","3","365","908","0","40.20","16.74"
"64","000","00","310","0017","0000","495","255","240","7","502","1334","0","37.63","19.12"
"64","000","00","310","0017","0129","495","255","240","7","502","1334","0","37.63","19.12"
"64","000","00","310","0018","0000","593","219","374","5","598","1779","0","33.61","12.31"
"64","000","00","310","0018","0130","311","128","183","1","312","903","0","34.55","14.17"
"64","000","00","310","0018","0131","282","91","191","4","286","876","0","32.65","10.39"
"64","000","00","310","0019","0000","508","231","277","14","522","1436","0","36.35","16.09"
"64","000","00","310","0019","0132","295","142","153","10","305","782","0","39.00","18.16"
"64","000","00","310","0019","0133","213","89","124","4","217","654","0","33.18","13.61"
"64","000","00","320","0000","0000","3213","1255","1958","59","3272","10933","12236","29.93","11.48"
"64","000","00","320","0001","0000","228","80","148","4","232","714","0","32.49","11.20"
"64","000","00","320","0001","0021","228","80","148","4","232","714","0","32.49","11.20"
"64","000","00","320","0002","0000","192","62","130","3","195","649","0","30.05","9.55"
"64","000","00","320","0002","0022","192","62","130","3","195","649","0","30.05","9.55"
"64","000","00","320","0003","0000","236","83","153","6","242","626","0","38.66","13.26"
"64","000","00","320","0003","0023","236","83","153","6","242","626","0","38.66","13.26"
"64","000","00","320","0004","0000","225","83","142","1","226","926","0","24.41","8.96"
"64","000","00","320","0004","0024","225","83","142","1","226","926","0","24.41","8.96"
"64","000","00","320","0005","0000","328","118","210","6","334","1359","0","24.58","8.68"
"64","000","00","320","0005","0025","328","118","210","6","334","1359","0","24.58","8.68"
"64","000","00","320","0006","0000","237","79","158","5","242","942","0","25.69","8.39"
"64","000","00","320","0006","0026","237","79","158","5","242","942","0","25.69","8.39"
"64","000","00","320","0007","0000","351","154","197","4","355","1029","0","34.50","14.97"
"64","000","00","320","0007","0027","351","154","197","4","355","1029","0","34.50","14.97"
"64","000","00","320","0008","0000","222","64","158","5","227","785","0","28.92","8.15"
"64","000","00","320","0008","0028","222","64","158","5","227","785","0","28.92","8.15"
"64","000","00","320","0009","0000","459","253","206","11","470","1363","0","34.48","18.56"
"64","000","00","320","0009","0029","459","253","206","11","470","1363","0","34.48","18.56"
"64","000","00","320","0010","0000","241","92","149","6","247","858","0","28.79","10.72"
"64","000","00","320","0010","0030","241","92","149","6","247","858","0","28.79","10.72"
"64","000","00","320","0011","0000","370","146","224","6","376","1379","0","27.27","10.59"
"64","000","00","320","0011","0031","370","146","224","6","376","1379","0","27.27","10.59"
"64","000","00","320","0012","0000","124","41","83","2","126","303","0","41.58","13.53"
"64","000","00","320","0012","0032","124","41","83","2","126","303","0","41.58","13.53"
"64","000","00","330","0000","0000","1683","860","823","27","1710","5257","5798","32.53","16.36"
"64","000","00","330","0001","0000","109","58","51","3","112","445","0","25.17","13.03"
"64","000","00","330","0001","0013","109","58","51","3","112","445","0","25.17","13.03"
"64","000","00","330","0002","0000","352","231","121","4","356","835","0","42.63","27.66"
"64","000","00","330","0002","0014","352","231","121","4","356","835","0","42.63","27.66"
"64","000","00","330","0003","0000","232","142","90","2","234","668","0","35.03","21.26"
"64","000","00","330","0003","0015","232","142","90","2","234","668","0","35.03","21.26"
"64","000","00","330","0004","0000","441","213","228","7","448","1557","0","28.77","13.68"
"64","000","00","330","0004","0016","169","62","107","4","173","657","0","26.33","9.44"
"64","000","00","330","0004","0017","272","151","121","3","275","900","0","30.56","16.78"
"64","000","00","330","0005","0000","219","72","147","5","224","651","0","34.41","11.06"
"64","000","00","330","0005","0018","219","72","147","5","224","651","0","34.41","11.06"
"64","000","00","330","0006","0000","200","83","117","4","204","587","0","34.75","14.14"
"64","000","00","330","0006","0019","200","83","117","4","204","587","0","34.75","14.14"
"64","000","00","330","0007","0000","130","61","69","2","132","514","0","25.68","11.87"
"64","000","00","330","0007","0020","130","61","69","2","132","514","0","25.68","11.87"
"64","000","00","340","0000","0000","3037","1286","1751","53","3090","10258","11365","30.12","12.54"
"64","000","00","340","0001","0000","166","57","109","3","169","597","0","28.31","9.55"
"64","000","00","340","0001","0033","166","57","109","3","169","597","0","28.31","9.55"
"64","000","00","340","0002","0000","155","49","106","3","158","655","0","24.12","7.48"
"64","000","00","340","0002","0034","155","49","106","3","158","655","0","24.12","7.48"
"64","000","00","340","0003","0000","325","100","225","4","329","1230","0","26.75","8.13"
"64","000","00","340","0003","0035","325","100","225","4","329","1230","0","26.75","8.13"
"64","000","00","340","0004","0000","480","226","254","9","489","1464","0","33.40","15.44"
"64","000","00","340","0004","0036","297","173","124","5","302","984","0","30.69","17.58"
"64","000","00","340","0004","0037","183","53","130","4","187","480","0","38.96","11.04"
"64","000","00","340","0005","0000","462","218","244","10","472","1537","0","30.71","14.18"
"64","000","00","340","0005","0038","310","162","148","7","317","975","0","32.51","16.62"
"64","000","00","340","0005","0039","152","56","96","3","155","562","0","27.58","9.96"
"64","000","00","340","0006","0000","548","279","269","10","558","1603","0","34.81","17.40"
"64","000","00","340","0006","0040","365","213","152","8","373","996","0","37.45","21.39"
"64","000","00","340","0006","0041","183","66","117","2","185","607","0","30.48","10.87"
"64","000","00","340","0007","0000","382","146","236","10","392","1207","0","32.48","12.10"
"64","000","00","340","0007","0044","382","146","236","10","392","1207","0","32.48","12.10"
"64","000","00","340","0008","0000","519","211","308","4","523","1965","0","26.62","10.74"
"64","000","00","340","0008","0042","308","92","216","3","311","979","0","31.77","9.40"
"64","000","00","340","0008","0043","211","119","92","1","212","986","0","21.50","12.07"
"64","000","00","350","0000","0000","3939","1550","2389","64","4003","12595","13870","31.78","12.31"
"64","000","00","350","0001","0000","246","91","155","3","249","931","0","26.75","9.77"
"64","000","00","350","0001","0045","246","91","155","3","249","931","0","26.75","9.77"
"64","000","00","350","0002","0000","203","63","140","6","209","627","0","33.33","10.05"
"64","000","00","350","0002","0046","203","63","140","6","209","627","0","33.33","10.05"
"64","000","00","350","0003","0000","285","115","170","7","292","955","0","30.58","12.04"
"64","000","00","350","0003","0047","285","115","170","7","292","955","0","30.58","12.04"
"64","000","00","350","0004","0000","119","56","63","1","120","413","0","29.06","13.56"
"64","000","00","350","0004","0048","119","56","63","1","120","413","0","29.06","13.56"
"64","000","00","350","0005","0000","119","46","73","2","121","384","0","31.51","11.98"
"64","000","00","350","0005","0049","119","46","73","2","121","384","0","31.51","11.98"
"64","000","00","350","0006","0000","117","44","73","1","118","493","0","23.94","8.92"
"64","000","00","350","0006","0050","117","44","73","1","118","493","0","23.94","8.92"
"64","000","00","350","0007","0000","364","160","204","4","368","963","0","38.21","16.61"
"64","000","00","350","0007","0051","364","160","204","4","368","963","0","38.21","16.61"
"64","000","00","350","0008","0000","365","145","220","4","369","1176","0","31.38","12.33"
"64","000","00","350","0008","0052","365","145","220","4","369","1176","0","31.38","12.33"
"64","000","00","350","0009","0000","559","253","306","8","567","1682","0","33.71","15.04"
"64","000","00","350","0009","0053","268","108","160","2","270","822","0","32.85","13.14"
"64","000","00","350","0009","0054","291","145","146","6","297","860","0","34.53","16.86"
"64","000","00","350","0010","0000","176","99","77","1","177","537","0","32.96","18.44"
"64","000","00","350","0010","0055","176","99","77","1","177","537","0","32.96","18.44"
"64","000","00","350","0011","0000","279","99","180","6","285","765","0","37.25","12.94"
"64","000","00","350","0011","0056","279","99","180","6","285","765","0","37.25","12.94"
"64","000","00","350","0012","0000","102","47","55","1","103","403","0","25.56","11.66"
"64","000","00","350","0012","0057","102","47","55","1","103","403","0","25.56","11.66"
"64","000","00","350","0013","0000","150","50","100","2","152","474","0","32.07","10.55"
"64","000","00","350","0013","0058","150","50","100","2","152","474","0","32.07","10.55"
"64","000","00","350","0014","0000","196","63","133","5","201","638","0","31.50","9.87"
"64","000","00","350","0014","0059","196","63","133","5","201","638","0","31.50","9.87"
"64","000","00","350","0015","0000","184","51","133","4","188","589","0","31.92","8.66"
"64","000","00","350","0015","0060","184","51","133","4","188","589","0","31.92","8.66"
"64","000","00","350","0016","0000","164","28","136","4","168","602","0","27.91","4.65"
"64","000","00","350","0016","0061","164","28","136","4","168","602","0","27.91","4.65"
"64","000","00","350","0017","0000","117","59","58","5","122","318","0","38.36","18.55"
"64","000","00","350","0017","0062","117","59","58","5","122","318","0","38.36","18.55"
"64","000","00","350","0018","0000","194","81","113","0","194","645","0","30.08","12.56"
"64","000","00","350","0018","0063","194","81","113","0","194","645","0","30.08","12.56"
"64","000","00","360","0000","0000","505","396","109","7","512","1559","1879","32.84","25.40"
"64","000","00","360","0001","0000","225","179","46","1","226","712","0","31.74","25.14"
"64","000","00","360","0001","0136","225","179","46","1","226","712","0","31.74","25.14"
"64","000","00","360","0002","0000","132","94","38","4","136","356","0","38.20","26.40"
"64","000","00","360","0002","0135","132","94","38","4","136","356","0","38.20","26.40"
"64","000","00","360","0003","0000","148","123","25","2","150","491","0","30.55","25.05"
"64","000","00","360","0003","0134","148","123","25","2","150","491","0","30.55","25.05"
"64","000","00","370","0000","0000","721","535","186","15","736","3415","4205","21.55","15.67"
"64","000","00","370","0001","0000","141","114","27","5","146","766","0","19.06","14.88"
"64","000","00","370","0001","0005","141","114","27","5","146","766","0","19.06","14.88"
"64","000","00","370","0002","0000","101","78","23","4","105","458","0","22.93","17.03"
"64","000","00","370","0002","0008","101","78","23","4","105","458","0","22.93","17.03"
"64","000","00","370","0003","0000","100","70","30","0","100","587","0","17.04","11.93"
"64","000","00","370","0003","0007","100","70","30","0","100","587","0","17.04","11.93"
"64","000","00","370","0004","0000","133","102","31","0","133","620","0","21.45","16.45"
"64","000","00","370","0004","0006","133","102","31","0","133","620","0","21.45","16.45"
"64","000","00","370","0005","0000","44","25","19","2","46","212","0","21.70","11.79"
"64","000","00","370","0005","0004","44","25","19","2","46","212","0","21.70","11.79"
"64","000","00","370","0006","0000","61","56","5","1","62","287","0","21.60","19.51"
"64","000","00","370","0006","0003","61","56","5","1","62","287","0","21.60","19.51"
"64","000","00","370","0007","0000","70","37","33","2","72","230","0","31.30","16.09"
"64","000","00","370","0007","0002","70","37","33","2","72","230","0","31.30","16.09"
"64","000","00","370","0008","0000","71","53","18","1","72","255","0","28.24","20.78"
"64","000","00","370","0008","0001","71","53","18","1","72","255","0","28.24","20.78"
"64","000","00","380","0000","0000","689","499","190","5","694","2427","3141","28.59","20.56"
"64","000","00","380","0001","0000","334","266","68","5","339","1343","0","25.24","19.81"
"64","000","00","380","0001","0009","177","149","28","2","179","747","0","23.96","19.95"
"64","000","00","380","0001","0010","157","117","40","3","160","596","0","26.85","19.63"
"64","000","00","380","0002","0000","202","167","35","0","202","602","0","33.55","27.74"
"64","000","00","380","0002","0011","202","167","35","0","202","602","0","33.55","27.74"
"64","000","00","380","0003","0000","153","66","87","0","153","482","0","31.74","13.69"
"64","000","00","380","0003","0012","153","66","87","0","153","482","0","31.74","13.69"
"10","004","00","000","0000","0000","178238","112428","65810","1652","179890","461638","573385","38.97","24.35"
"10","004","00","010","0000","0000","62616","36704","25912","470","63086","150431","203904","41.94","24.40"
"10","004","00","010","0001","0000","3000","1813","1187","13","3013","6791","0","44.37","26.70"
"10","004","00","010","0001","0053","595","351","244","2","597","1344","0","44.42","26.12"
"10","004","00","010","0001","0054","552","325","227","2","554","1272","0","43.55","25.55"
"10","004","00","010","0001","0055","607","376","231","4","611","1269","0","48.15","29.63"
"10","004","00","010","0001","0056","584","363","221","2","586","1290","0","45.43","28.14"
"10","004","00","010","0001","0057","662","398","264","3","665","1616","0","41.15","24.63"
"10","004","00","010","0002","0000","4846","2896","1950","36","4882","10611","0","46.01","27.29"
"10","004","00","010","0002","0001","588","354","234","6","594","1244","0","47.75","28.46"
"10","004","00","010","0002","0002","563","323","240","6","569","1275","0","44.63","25.33"
"10","004","00","010","0002","0003","564","347","217","4","568","1289","0","44.07","26.92"
"10","004","00","010","0002","0004","628","382","246","1","629","1292","0","48.68","29.57"
"10","004","00","010","0002","0005","562","354","208","6","568","1324","0","42.90","26.74"
"10","004","00","010","0002","0006","618","389","229","6","624","1357","0","45.98","28.67"
"10","004","00","010","0002","0007","727","406","321","2","729","1480","0","49.26","27.43"
"10","004","00","010","0002","0008","596","341","255","5","601","1350","0","44.52","25.26"
"10","004","00","010","0003","0000","5447","2973","2474","30","5477","11738","0","46.66","25.33"
"10","004","00","010","0003","0009","515","282","233","4","519","1107","0","46.88","25.47"
"10","004","00","010","0003","0010","568","339","229","2","570","1201","0","47.46","28.23"
"10","004","00","010","0003","0011","542","301","241","2","544","1187","0","45.83","25.36"
"10","004","00","010","0003","0012","500","267","233","1","501","1133","0","44.22","23.57"
"10","004","00","010","0003","0013","539","307","232","3","542","1215","0","44.61","25.27"
"10","004","00","010","0003","0014","623","340","283","4","627","1324","0","47.36","25.68"
"10","004","00","010","0003","0015","577","280","297","5","582","1205","0","48.30","23.24"
"10","004","00","010","0003","0016","587","325","262","3","590","1193","0","49.46","27.24"
"10","004","00","010","0003","0017","483","257","226","3","486","1023","0","47.51","25.12"
"10","004","00","010","0003","0018","513","275","238","3","516","1150","0","44.87","23.91"
"10","004","00","010","0004","0000","3790","2239","1551","36","3826","8015","0","47.74","27.94"
"10","004","00","010","0004","0019","669","381","288","4","673","1490","0","45.17","25.57"
"10","004","00","010","0004","0020","606","370","236","11","617","1251","0","49.32","29.58"
"10","004","00","010","0004","0021","697","401","296","6","703","1430","0","49.16","28.04"
"10","004","00","010","0004","0022","682","388","294","3","685","1373","0","49.89","28.26"
"10","004","00","010","0004","0023","640","358","282","7","647","1249","0","51.80","28.66"
"10","004","00","010","0004","0024","496","341","155","5","501","1222","0","41.00","27.91"
"10","004","00","010","0005","0000","1317","795","522","3","1320","2974","0","44.38","26.73"
"10","004","00","010","0005","0025","484","307","177","0","484","1086","0","44.57","28.27"
"10","004","00","010","0005","0026","460","277","183","1","461","1022","0","45.11","27.10"
"10","004","00","010","0005","0027","373","211","162","2","375","866","0","43.30","24.36"
"10","004","00","010","0006","0000","1100","740","360","11","1111","2997","0","37.07","24.69"
"10","004","00","010","0006","0028","365","242","123","3","368","1019","0","36.11","23.75"
"10","004","00","010","0006","0029","397","278","119","4","401","1061","0","37.79","26.20"
"10","004","00","010","0006","0030","338","220","118","4","342","917","0","37.30","23.99"
"10","004","00","010","0007","0000","2896","1791","1105","18","2914","7661","0","38.04","23.38"
"10","004","00","010","0007","0071","528","329","199","1","529","1255","0","42.15","26.22"
"10","004","00","010","0007","0072","443","278","165","3","446","1309","0","34.07","21.24"
"10","004","00","010","0007","0073","547","316","231","3","550","1605","0","34.27","19.69"
"10","004","00","010","0007","0074","417","261","156","4","421","1190","0","35.38","21.93"
"10","004","00","010","0007","0075","495","307","188","4","499","1112","0","44.87","27.61"
"10","004","00","010","0007","0076","466","300","166","3","469","1190","0","39.41","25.21"
"10","004","00","010","0008","0000","3531","2243","1288","25","3556","8745","0","40.66","25.65"
"10","004","00","010","0008","0077","391","274","117","5","396","1040","0","38.08","26.35"
"10","004","00","010","0008","0078","403","255","148","4","407","1068","0","38.11","23.88"
"10","004","00","010","0008","0079","427","273","154","3","430","1151","0","37.36","23.72"
"10","004","00","010","0008","0080","453","300","153","3","456","1101","0","41.42","27.25"
"10","004","00","010","0008","0081","486","264","222","2","488","1090","0","44.77","24.22"
"10","004","00","010","0008","0082","539","344","195","3","542","1185","0","45.74","29.03"
"10","004","00","010","0008","0083","417","259","158","2","419","1064","0","39.38","24.34"
"10","004","00","010","0008","0084","415","274","141","3","418","1046","0","39.96","26.20"
"10","004","00","010","0009","0000","2079","1247","832","15","2094","5860","0","35.73","21.28"
"10","004","00","010","0009","0088","529","314","215","4","533","1331","0","40.05","23.59"
"10","004","00","010","0009","0089","380","219","161","3","383","1088","0","35.20","20.13"
"10","004","00","010","0009","0090","477","307","170","2","479","1163","0","41.19","26.40"
"10","004","00","010","0009","0091","431","254","177","2","433","1129","0","38.35","22.50"
"10","004","00","010","0009","0092","262","153","109","4","266","1149","0","23.15","13.32"
"10","004","00","010","0010","0000","2238","1397","841","15","2253","5932","0","37.98","23.55"
"10","004","00","010","0010","0093","512","314","198","2","514","1336","0","38.47","23.50"
"10","004","00","010","0010","0094","506","313","193","6","512","1260","0","40.63","24.84"
"10","004","00","010","0010","0095","390","245","145","2","392","1078","0","36.36","22.73"
"10","004","00","010","0010","0096","433","282","151","2","435","1222","0","35.60","23.08"
"10","004","00","010","0010","0097","397","243","154","3","400","1036","0","38.61","23.46"
"10","004","00","010","0011","0000","2681","1649","1032","32","2713","7074","0","38.35","23.31"
"10","004","00","010","0011","0098","479","307","172","8","487","1191","0","40.89","25.78"
"10","004","00","010","0011","0099","479","297","182","4","483","1166","0","41.42","25.47"
"10","004","00","010","0011","0100","429","268","161","7","436","1151","0","37.88","23.28"
"10","004","00","010","0011","0101","385","226","159","1","386","1022","0","37.77","22.11"
"10","004","00","010","0011","0102","413","277","136","8","421","1171","0","35.95","23.65"
"10","004","00","010","0011","0103","496","274","222","4","500","1373","0","36.42","19.96"
"10","004","00","010","0012","0000","1773","1052","721","20","1793","4441","0","40.37","23.69"
"10","004","00","010","0012","0109","399","237","162","4","403","1092","0","36.90","21.70"
"10","004","00","010","0012","0110","349","211","138","5","354","862","0","41.07","24.48"
"10","004","00","010","0012","0111","523","302","221","6","529","1259","0","42.02","23.99"
"10","004","00","010","0012","0112","502","302","200","5","507","1228","0","41.29","24.59"
"10","004","00","010","0013","0000","752","404","348","5","757","1986","0","38.12","20.34"
"10","004","00","010","0013","0113","342","173","169","1","343","859","0","39.93","20.14"
"10","004","00","010","0013","0114","410","231","179","4","414","1127","0","36.73","20.50"
"10","004","00","010","0014","0000","1038","543","495","8","1046","2468","0","42.38","22.00"
"10","004","00","010","0014","0115","474","255","219","3","477","1097","0","43.48","23.25"
"10","004","00","010","0014","0116","564","288","276","5","569","1371","0","41.50","21.01"
"10","004","00","010","0015","0000","802","417","385","11","813","2202","0","36.92","18.94"
"10","004","00","010","0015","0118","344","188","156","7","351","984","0","35.67","19.11"
"10","004","00","010","0015","0119","458","229","229","4","462","1218","0","37.93","18.80"
"10","004","00","010","0016","0000","497","192","305","6","503","1218","0","41.30","15.76"
"10","004","00","010","0016","0120","497","192","305","6","503","1218","0","41.30","15.76"
"10","004","00","010","0017","0000","638","268","370","6","644","1607","0","40.07","16.68"
"10","004","00","010","0017","0123","382","163","219","3","385","940","0","40.96","17.34"
"10","004","00","010","0017","0124","256","105","151","3","259","667","0","38.83","15.74"
"10","004","00","010","0018","0000","751","294","457","5","756","1914","0","39.50","15.36"
"10","004","00","010","0018","0127","391","156","235","4","395","966","0","40.89","16.15"
"10","004","00","010","0018","0128","360","138","222","1","361","948","0","38.08","14.56"
"10","004","00","010","0019","0000","695","385","310","6","701","1741","0","40.26","22.11"
"10","004","00","010","0019","0121","370","194","176","3","373","935","0","39.89","20.75"
"10","004","00","010","0019","0122","325","191","134","3","328","806","0","40.69","23.70"
"10","004","00","010","0020","0000","622","243","379","7","629","1683","0","37.37","14.44"
"10","004","00","010","0020","0125","326","119","207","2","328","832","0","39.42","14.30"
"10","004","00","010","0020","0126","296","124","172","5","301","851","0","35.37","14.57"
"10","004","00","010","0021","0000","3055","1774","1281","16","3071","6632","0","46.31","26.75"
"10","004","00","010","0021","0041","575","318","257","5","580","1203","0","48.21","26.43"
"10","004","00","010","0021","0042","540","326","214","6","546","1095","0","49.86","29.77"
"10","004","00","010","0021","0043","513","291","222","2","515","1102","0","46.73","26.41"
"10","004","00","010","0021","0044","599","348","251","1","600","1257","0","47.73","27.68"
"10","004","00","010","0021","0045","436","253","183","1","437","1009","0","43.31","25.07"
"10","004","00","010","0021","0046","392","238","154","1","393","966","0","40.68","24.64"
"10","004","00","010","0022","0000","2311","1324","987","20","2331","6000","0","38.85","22.07"
"10","004","00","010","0022","0104","457","281","176","2","459","1110","0","41.35","25.32"
"10","004","00","010","0022","0105","448","251","197","0","448","1209","0","37.06","20.76"
"10","004","00","010","0022","0106","413","229","184","7","420","1165","0","36.05","19.66"
"10","004","00","010","0022","0107","480","255","225","5","485","1295","0","37.45","19.69"
"10","004","00","010","0022","0108","513","308","205","6","519","1221","0","42.51","25.23"
"10","004","00","010","0023","0000","400","235","165","4","404","1064","0","37.97","22.09"
"10","004","00","010","0023","0117","400","235","165","4","404","1064","0","37.97","22.09"
"10","004","00","010","0024","0000","1649","1047","602","16","1665","3833","0","43.44","27.32"
"10","004","00","010","0024","0063","521","323","198","7","528","1196","0","44.15","27.01"
"10","004","00","010","0024","0064","602","374","228","6","608","1366","0","44.51","27.38"
"10","004","00","010","0024","0065","526","350","176","3","529","1271","0","41.62","27.54"
"10","004","00","010","0025","0000","2523","1474","1049","24","2547","6255","0","40.72","23.57"
"10","004","00","010","0025","0066","457","284","173","2","459","1187","0","38.67","23.93"
"10","004","00","010","0025","0067","556","315","241","7","563","1312","0","42.91","24.01"
"10","004","00","010","0025","0068","502","291","211","4","506","1191","0","42.49","24.43"
"10","004","00","010","0025","0069","547","329","218","8","555","1239","0","44.79","26.55"
"10","004","00","010","0025","0070","461","255","206","3","464","1326","0","34.99","19.23"
"10","004","00","010","0026","0000","1347","843","504","11","1358","3262","0","41.63","25.84"
"10","004","00","010","0026","0085","431","285","146","2","433","1027","0","42.16","27.75"
"10","004","00","010","0026","0086","503","303","200","6","509","1130","0","45.04","26.81"
"10","004","00","010","0026","0087","413","255","158","3","416","1105","0","37.65","23.08"
"10","004","00","010","0027","0000","2848","1555","1293","24","2872","7126","0","40.30","21.82"
"10","004","00","010","0027","0031","467","259","208","4","471","1182","0","39.85","21.91"
"10","004","00","010","0027","0032","489","294","195","4","493","1198","0","41.15","24.54"
"10","004","00","010","0027","0033","510","256","254","2","512","1202","0","42.60","21.30"
"10","004","00","010","0027","0034","489","237","252","3","492","1285","0","38.29","18.44"
"10","004","00","010","0027","0035","481","263","218","8","489","1123","0","43.54","23.42"
"10","004","00","010","0027","0036","412","246","166","3","415","1136","0","36.53","21.65"
"10","004","00","010","0028","0000","2188","1229","959","12","2200","5571","0","39.49","22.06"
"10","004","00","010","0028","0037","583","332","251","1","584","1430","0","40.84","23.22"
"10","004","00","010","0028","0038","516","305","211","2","518","1361","0","38.06","22.41"
"10","004","00","010","0028","0039","538","293","245","2","540","1427","0","37.84","20.53"
"10","004","00","010","0028","0040","551","299","252","7","558","1353","0","41.24","22.10"
"10","004","00","010","0029","0000","1477","951","526","8","1485","3538","0","41.97","26.88"
"10","004","00","010","0029","0047","488","313","175","3","491","1202","0","40.85","26.04"
"10","004","00","010","0029","0048","497","310","187","1","498","1125","0","44.27","27.56"
"10","004","00","010","0029","0049","492","328","164","4","496","1211","0","40.96","27.09"
"10","004","00","010","0030","0000","1497","944","553","16","1513","3337","0","45.34","28.29"
"10","004","00","010","0030","0050","518","324","194","7","525","1136","0","46.21","28.52"
"10","004","00","010","0030","0051","473","316","157","4","477","1041","0","45.82","30.36"
"10","004","00","010","0030","0052","506","304","202","5","511","1160","0","44.05","26.21"
"10","004","00","010","0031","0000","2828","1747","1081","11","2839","6155","0","46.13","28.38"
"10","004","00","010","0031","0058","600","405","195","3","603","1221","0","49.39","33.17"
"10","004","00","010","0031","0059","557","338","219","0","557","1176","0","47.36","28.74"
"10","004","00","010","0031","0060","497","278","219","2","499","1201","0","41.55","23.15"
"10","004","00","010","0031","0061","538","331","207","4","542","1200","0","45.17","27.58"
"10","004","00","010","0031","0062","636","395","241","2","638","1357","0","47.02","29.11"
"10","004","00","020","0000","0000","29964","20491","9473","268","30232","80187","96850","37.70","25.55"
"10","004","00","020","0001","0000","100","72","28","0","100","303","0","33.00","23.76"
"10","004","00","020","0001","0129","100","72","28","0","100","303","0","33.00","23.76"
"10","004","00","020","0002","0000","135","81","54","2","137","402","0","34.08","20.15"
"10","004","00","020","0002","0130","135","81","54","2","137","402","0","34.08","20.15"
"10","004","00","020","0003","0000","133","90","43","1","134","369","0","36.31","24.39"
"10","004","00","020","0003","0131","133","90","43","1","134","369","0","36.31","24.39"
"10","004","00","020","0004","0000","836","618","218","3","839","2251","0","37.27","27.45"
"10","004","00","020","0004","0132","376","266","110","2","378","1092","0","34.62","24.36"
"10","004","00","020","0004","0133","460","352","108","1","461","1159","0","39.78","30.37"
"10","004","00","020","0005","0000","1252","904","348","11","1263","3227","0","39.14","28.01"
"10","004","00","020","0005","0142","380","292","88","4","384","995","0","38.59","29.35"
"10","004","00","020","0005","0143","407","291","116","4","411","1185","0","34.68","24.56"
"10","004","00","020","0005","0144","465","321","144","3","468","1047","0","44.70","30.66"
"10","004","00","020","0006","0000","3269","2343","926","33","3302","9255","0","35.68","25.32"
"10","004","00","020","0006","0134","426","297","129","6","432","1189","0","36.33","24.98"
"10","004","00","020","0006","0135","487","352","135","0","487","1217","0","40.02","28.92"
"10","004","00","020","0006","0136","474","345","129","9","483","1278","0","37.79","27.00"
"10","004","00","020","0006","0137","337","243","94","1","338","1345","0","25.13","18.07"
"10","004","00","020","0006","0138","411","304","107","6","417","1204","0","34.63","25.25"
"10","004","00","020","0006","0139","388","284","104","1","389","917","0","42.42","30.97"
"10","004","00","020","0006","0140","328","204","124","3","331","939","0","35.25","21.73"
"10","004","00","020","0006","0141","418","314","104","7","425","1166","0","36.45","26.93"
"10","004","00","020","0007","0000","1599","1136","463","20","1619","4597","0","35.22","24.71"
"10","004","00","020","0007","0147","355","233","122","6","361","1125","0","32.09","20.71"
"10","004","00","020","0007","0148","343","252","91","6","349","1044","0","33.43","24.14"
"10","004","00","020","0007","0149","475","345","130","6","481","1266","0","37.99","27.25"
"10","004","00","020","0007","0150","426","306","120","2","428","1162","0","36.83","26.33"
"10","004","00","020","0008","0000","310","209","101","1","311","643","0","48.37","32.50"
"10","004","00","020","0008","0154","310","209","101","1","311","643","0","48.37","32.50"
"10","004","00","020","0009","0000","986","728","258","8","994","3051","0","32.58","23.86"
"10","004","00","020","0009","0155","278","206","72","2","280","984","0","28.46","20.93"
"10","004","00","020","0009","0156","400","307","93","3","403","969","0","41.59","31.68"
"10","004","00","020","0009","0157","308","215","93","3","311","1098","0","28.32","19.58"
"10","004","00","020","0010","0000","578","352","226","10","588","1321","0","44.51","26.65"
"10","004","00","020","0010","0158","274","167","107","6","280","579","0","48.36","28.84"
"10","004","00","020","0010","0159","304","185","119","4","308","742","0","41.51","24.93"
"10","004","00","020","0011","0000","596","410","186","2","598","1352","0","44.23","30.33"
"10","004","00","020","0011","0169","306","214","92","1","307","693","0","44.30","30.88"
"10","004","00","020","0011","0170","290","196","94","1","291","659","0","44.16","29.74"
"10","004","00","020","0012","0000","1362","946","416","12","1374","3726","0","36.88","25.39"
"10","004","00","020","0012","0162","318","212","106","4","322","923","0","34.89","22.97"
"10","004","00","020","0012","0163","300","219","81","3","303","949","0","31.93","23.08"
"10","004","00","020","0012","0164","329","252","77","2","331","901","0","36.74","27.97"
"10","004","00","020","0012","0165","415","263","152","3","418","953","0","43.86","27.60"
"10","004","00","020","0013","0000","1272","860","412","10","1282","3284","0","39.04","26.19"
"10","004","00","020","0013","0166","383","263","120","3","386","962","0","40.12","27.34"
"10","004","00","020","0013","0167","434","297","137","6","440","1159","0","37.96","25.63"
"10","004","00","020","0013","0168","455","300","155","1","456","1163","0","39.21","25.80"
"10","004","00","020","0014","0000","2419","1660","759","14","2433","7516","0","32.37","22.09"
"10","004","00","020","0014","0177","380","252","128","3","383","1248","0","30.69","20.19"
"10","004","00","020","0014","0178","299","195","104","1","300","1254","0","23.92","15.55"
"10","004","00","020","0014","0179","415","299","116","4","419","1219","0","34.37","24.53"
"10","004","00","020","0014","0180","330","214","116","1","331","1139","0","29.06","18.79"
"10","004","00","020","0014","0181","591","411","180","3","594","1554","0","38.22","26.45"
"10","004","00","020","0014","0182","404","289","115","2","406","1102","0","36.84","26.23"
"10","004","00","020","0015","0000","2377","1589","788","15","2392","6371","0","37.55","24.94"
"10","004","00","020","0015","0184","382","255","127","2","384","1078","0","35.62","23.65"
"10","004","00","020","0015","0185","313","208","105","3","316","1061","0","29.78","19.60"
"10","004","00","020","0015","0186","381","241","140","3","384","977","0","39.30","24.67"
"10","004","00","020","0015","0187","396","264","132","0","396","1090","0","36.33","24.22"
"10","004","00","020","0015","0188","445","295","150","3","448","1086","0","41.25","27.16"
"10","004","00","020","0015","0189","460","326","134","4","464","1079","0","43.00","30.21"
"10","004","00","020","0016","0000","1890","1238","652","21","1911","4492","0","42.54","27.56"
"10","004","00","020","0016","0200","478","309","169","5","483","1108","0","43.59","27.89"
"10","004","00","020","0016","0201","499","331","168","3","502","1181","0","42.51","28.03"
"10","004","00","020","0016","0202","470","302","168","7","477","1124","0","42.44","26.87"
"10","004","00","020","0016","0203","443","296","147","6","449","1079","0","41.61","27.43"
"10","004","00","020","0017","0000","778","492","286","4","782","1905","0","41.05","25.83"
"10","004","00","020","0017","0204","374","223","151","4","378","989","0","38.22","22.55"
"10","004","00","020","0017","0205","404","269","135","0","404","916","0","44.10","29.37"
"10","004","00","020","0018","0000","231","142","89","4","235","585","0","40.17","24.27"
"10","004","00","020","0018","0206","231","142","89","4","235","585","0","40.17","24.27"
"10","004","00","020","0019","0000","4409","2822","1587","36","4445","11579","0","38.39","24.37"
"10","004","00","020","0019","0190","509","343","166","4","513","1184","0","43.33","28.97"
"10","004","00","020","0019","0191","320","198","122","3","323","907","0","35.61","21.83"
"10","004","00","020","0019","0192","808","505","303","6","814","1559","0","52.21","32.39"
"10","004","00","020","0019","0193","266","161","105","2","268","847","0","31.64","19.01"
"10","004","00","020","0019","0194","312","179","133","4","316","946","0","33.40","18.92"
"10","004","00","020","0019","0195","485","274","211","4","489","1282","0","38.14","21.37"
"10","004","00","020","0019","0196","427","288","139","1","428","1186","0","36.09","24.28"
"10","004","00","020","0019","0197","333","217","116","1","334","1228","0","27.20","17.67"
"10","004","00","020","0019","0198","441","308","133","4","445","1202","0","37.02","25.62"
"10","004","00","020","0019","0199","508","349","159","7","515","1238","0","41.60","28.19"
"10","004","00","020","0020","0000","644","479","165","7","651","1672","0","38.94","28.65"
"10","004","00","020","0020","0151","289","223","66","5","294","812","0","36.21","27.46"
"10","004","00","020","0020","0152","355","256","99","2","357","860","0","41.51","29.77"
"10","004","00","020","0021","0000","833","534","299","14","847","2198","0","38.54","24.29"
"10","004","00","020","0021","0145","347","237","110","8","355","895","0","39.66","26.48"
"10","004","00","020","0021","0146","486","297","189","6","492","1303","0","37.76","22.79"
"10","004","00","020","0022","0000","434","291","143","2","436","1002","0","43.51","29.04"
"10","004","00","020","0022","0153","434","291","143","2","436","1002","0","43.51","29.04"
"10","004","00","020","0023","0000","2718","1942","776","27","2745","6974","0","39.36","27.85"
"10","004","00","020","0023","0171","447","339","108","4","451","1165","0","38.71","29.10"
"10","004","00","020","0023","0172","464","330","134","5","469","1119","0","41.91","29.49"
"10","004","00","020","0023","0173","449","324","125","4","453","1135","0","39.91","28.55"
"10","004","00","020","0023","0174","483","341","142","7","490","1219","0","40.20","27.97"
"10","004","00","020","0023","0175","452","313","139","4","456","1213","0","37.59","25.80"
"10","004","00","020","0023","0176","423","295","128","3","426","1123","0","37.93","26.27"
"10","004","00","020","0024","0000","558","387","171","8","566","1533","0","36.92","25.24"
"10","004","00","020","0024","0160","273","181","92","4","277","730","0","37.95","24.79"
"10","004","00","020","0024","0161","285","206","79","4","289","803","0","35.99","25.65"
"10","004","00","020","0025","0000","245","166","79","3","248","579","0","42.83","28.67"
"10","004","00","020","0025","0183","245","166","79","3","248","579","0","42.83","28.67"
"10","004","00","030","0000","0000","11861","7127","4734","126","11987","29144","32991","41.13","24.45"
"10","004","00","030","0001","0000","410","230","180","7","417","1106","0","37.70","20.80"
"10","004","00","030","0001","0227","410","230","180","7","417","1106","0","37.70","20.80"
"10","004","00","030","0002","0000","366","228","138","7","373","857","0","43.52","26.60"
"10","004","00","030","0002","0228","366","228","138","7","373","857","0","43.52","26.60"
"10","004","00","030","0003","0000","1817","1163","654","12","1829","4469","0","40.93","26.02"
"10","004","00","030","0003","0229","380","232","148","3","383","1052","0","36.41","22.05"
"10","004","00","030","0003","0230","429","280","149","5","434","1008","0","43.06","27.78"
"10","004","00","030","0003","0231","390","277","113","2","392","1010","0","38.81","27.43"
"10","004","00","030","0003","0232","618","374","244","2","620","1399","0","44.32","26.73"
"10","004","00","030","0004","0000","724","454","270","7","731","1976","0","36.99","22.98"
"10","004","00","030","0004","0216","376","241","135","3","379","979","0","38.71","24.62"
"10","004","00","030","0004","0217","348","213","135","4","352","997","0","35.31","21.36"
"10","004","00","030","0005","0000","1386","772","614","7","1393","3266","0","42.65","23.64"
"10","004","00","030","0005","0218","543","323","220","5","548","1174","0","46.68","27.51"
"10","004","00","030","0005","0219","458","258","200","1","459","1110","0","41.35","23.24"
"10","004","00","030","0005","0220","385","191","194","1","386","982","0","39.31","19.45"
"10","004","00","030","0006","0000","684","416","268","5","689","1753","0","39.30","23.73"
"10","004","00","030","0006","0214","348","228","120","1","349","894","0","39.04","25.50"
"10","004","00","030","0006","0215","336","188","148","4","340","859","0","39.58","21.89"
"10","004","00","030","0007","0000","1259","820","439","8","1267","3147","0","40.26","26.06"
"10","004","00","030","0007","0210","365","255","110","3","368","908","0","40.53","28.08"
"10","004","00","030","0007","0211","279","188","91","1","280","707","0","39.60","26.59"
"10","004","00","030","0007","0212","402","243","159","4","406","1025","0","39.61","23.71"
"10","004","00","030","0007","0213","213","134","79","0","213","507","0","42.01","26.43"
"10","004","00","030","0008","0000","402","251","151","5","407","964","0","42.22","26.04"
"10","004","00","030","0008","0207","402","251","151","5","407","964","0","42.22","26.04"
"10","004","00","030","0009","0000","251","138","113","2","253","558","0","45.34","24.73"
"10","004","00","030","0009","0208","251","138","113","2","253","558","0","45.34","24.73"
"10","004","00","030","0010","0000","453","321","132","4","457","1011","0","45.20","31.75"
"10","004","00","030","0010","0209","453","321","132","4","457","1011","0","45.20","31.75"
"10","004","00","030","0011","0000","700","436","264","15","715","1823","0","39.22","23.92"
"10","004","00","030","0011","0233","390","228","162","4","394","960","0","41.04","23.75"
"10","004","00","030","0011","0234","310","208","102","11","321","863","0","37.20","24.10"
"10","004","00","030","0012","0000","1050","632","418","13","1063","2507","0","42.40","25.21"
"10","004","00","030","0012","0235","369","221","148","2","371","828","0","44.81","26.69"
"10","004","00","030","0012","0236","350","206","144","4","354","807","0","43.87","25.53"
"10","004","00","030","0012","0237","331","205","126","7","338","872","0","38.76","23.51"
"10","004","00","030","0013","0000","430","246","184","6","436","977","0","44.63","25.18"
"10","004","00","030","0013","0238","430","246","184","6","436","977","0","44.63","25.18"
"10","004","00","030","0014","0000","257","147","110","3","260","642","0","40.50","22.90"
"10","004","00","030","0014","0239","257","147","110","3","260","642","0","40.50","22.90"
"10","004","00","030","0015","0000","490","241","249","7","497","1082","0","45.93","22.27"
"10","004","00","030","0015","0226","490","241","249","7","497","1082","0","45.93","22.27"
"10","004","00","030","0016","0000","476","269","207","10","486","1332","0","36.49","20.20"
"10","004","00","030","0016","0221","237","117","120","6","243","730","0","33.29","16.03"
"10","004","00","030","0016","0222","239","152","87","4","243","602","0","40.37","25.25"
"10","004","00","030","0017","0000","189","99","90","1","190","403","0","47.15","24.57"
"10","004","00","030","0017","0223","189","99","90","1","190","403","0","47.15","24.57"
"10","004","00","030","0018","0000","276","130","146","4","280","701","0","39.94","18.54"
"10","004","00","030","0018","0224","276","130","146","4","280","701","0","39.94","18.54"
"10","004","00","030","0019","0000","241","134","107","3","244","570","0","42.81","23.51"
"10","004","00","030","0019","0225","241","134","107","3","244","570","0","42.81","23.51"
"10","004","00","040","0000","0000","9239","5898","3341","122","9361","24047","27521","38.93","24.53"
"10","004","00","040","0001","0000","222","165","57","2","224","472","0","47.46","34.96"
"10","004","00","040","0001","0240","222","165","57","2","224","472","0","47.46","34.96"
"10","004","00","040","0002","0000","768","556","212","3","771","1896","0","40.66","29.32"
"10","004","00","040","0002","0241","361","263","98","3","364","896","0","40.63","29.35"
"10","004","00","040","0002","0242","407","293","114","0","407","1000","0","40.70","29.30"
"10","004","00","040","0003","0000","291","199","92","3","294","677","0","43.43","29.39"
"10","004","00","040","0003","0243","291","199","92","3","294","677","0","43.43","29.39"
"10","004","00","040","0004","0000","1446","961","485","18","1464","3579","0","40.91","26.85"
"10","004","00","040","0004","0244","514","339","175","4","518","1144","0","45.28","29.63"
"10","004","00","040","0004","0245","485","315","170","7","492","1170","0","42.05","26.92"
"10","004","00","040","0004","0246","447","307","140","7","454","1265","0","35.89","24.27"
"10","004","00","040","0005","0000","400","245","155","7","407","960","0","42.40","25.52"
"10","004","00","040","0005","0248","400","245","155","7","407","960","0","42.40","25.52"
"10","004","00","040","0006","0000","322","185","137","2","324","756","0","42.86","24.47"
"10","004","00","040","0006","0247","322","185","137","2","324","756","0","42.86","24.47"
"10","004","00","040","0007","0000","352","213","139","7","359","1025","0","35.02","20.78"
"10","004","00","040","0007","0249","352","213","139","7","359","1025","0","35.02","20.78"
"10","004","00","040","0008","0000","1308","852","456","13","1321","3726","0","35.45","22.87"
"10","004","00","040","0008","0250","418","269","149","5","423","1200","0","35.25","22.42"
"10","004","00","040","0008","0251","472","311","161","1","473","1290","0","36.67","24.11"
"10","004","00","040","0008","0252","418","272","146","7","425","1236","0","34.39","22.01"
"10","004","00","040","0009","0000","446","275","171","7","453","1248","0","36.30","22.04"
"10","004","00","040","0009","0254","446","275","171","7","453","1248","0","36.30","22.04"
"10","004","00","040","0010","0000","170","93","77","3","173","529","0","32.70","17.58"
"10","004","00","040","0010","0256","170","93","77","3","173","529","0","32.70","17.58"
"10","004","00","040","0011","0000","208","137","71","1","209","549","0","38.07","24.95"
"10","004","00","040","0011","0258","208","137","71","1","209","549","0","38.07","24.95"
"10","004","00","040","0012","0000","286","194","92","2","288","904","0","31.86","21.46"
"10","004","00","040","0012","0259","286","194","92","2","288","904","0","31.86","21.46"
"10","004","00","040","0013","0000","129","68","61","3","132","431","0","30.63","15.78"
"10","004","00","040","0013","0257","129","68","61","3","132","431","0","30.63","15.78"
"10","004","00","040","0014","0000","345","163","182","5","350","787","0","44.47","20.71"
"10","004","00","040","0014","0260","345","163","182","5","350","787","0","44.47","20.71"
"10","004","00","040","0015","0000","654","407","247","8","662","1735","0","38.16","23.46"
"10","004","00","040","0015","0261","354","238","116","3","357","861","0","41.46","27.64"
"10","004","00","040","0015","0262","300","169","131","5","305","874","0","34.90","19.34"
"10","004","00","040","0016","0000","324","210","114","7","331","798","0","41.48","26.32"
"10","004","00","040","0016","0264","324","210","114","7","331","798","0","41.48","26.32"
"10","004","00","040","0017","0000","213","155","58","4","217","537","0","40.41","28.86"
"10","004","00","040","0017","0265","213","155","58","4","217","537","0","40.41","28.86"
"10","004","00","040","0018","0000","309","182","127","11","320","799","0","40.05","22.78"
"10","004","00","040","0018","0266","309","182","127","11","320","799","0","40.05","22.78"
"10","004","00","040","0019","0000","325","186","139","5","330","824","0","40.05","22.57"
"10","004","00","040","0019","0253","325","186","139","5","330","824","0","40.05","22.57"
"10","004","00","040","0020","0000","316","210","106","3","319","889","0","35.88","23.62"
"10","004","00","040","0020","0255","316","210","106","3","319","889","0","35.88","23.62"
"10","004","00","040","0021","0000","405","242","163","8","413","926","0","44.60","26.13"
"10","004","00","040","0021","0263","405","242","163","8","413","926","0","44.60","26.13"
"10","004","00","050","0000","0000","23508","15402","8106","232","23740","65720","79420","36.12","23.44"
"10","004","00","050","0001","0000","519","349","170","4","523","1181","0","44.28","29.55"
"10","004","00","050","0001","0280","519","349","170","4","523","1181","0","44.28","29.55"
"10","004","00","050","0002","0000","379","235","144","3","382","855","0","44.68","27.49"
"10","004","00","050","0002","0279","379","235","144","3","382","855","0","44.68","27.49"
"10","004","00","050","0003","0000","1556","988","568","25","1581","3959","0","39.93","24.96"
"10","004","00","050","0003","0276","498","294","204","7","505","1347","0","37.49","21.83"
"10","004","00","050","0003","0277","547","383","164","12","559","1295","0","43.17","29.58"
"10","004","00","050","0003","0278","511","311","200","6","517","1317","0","39.26","23.61"
"10","004","00","050","0004","0000","1943","1266","677","19","1962","5246","0","37.40","24.13"
"10","004","00","050","0004","0285","499","319","180","8","507","1441","0","35.18","22.14"
"10","004","00","050","0004","0286","468","310","158","1","469","1148","0","40.85","27.00"
"10","004","00","050","0004","0287","452","285","167","5","457","1367","0","33.43","20.85"
"10","004","00","050","0004","0288","524","352","172","5","529","1290","0","41.01","27.29"
"10","004","00","050","0005","0000","1245","799","446","13","1258","3221","0","39.06","24.81"
"10","004","00","050","0005","0281","719","479","240","11","730","1946","0","37.51","24.61"
"10","004","00","050","0005","0282","526","320","206","2","528","1275","0","41.41","25.10"
"10","004","00","050","0006","0000","1673","1059","614","12","1685","4921","0","34.24","21.52"
"10","004","00","050","0006","0272","404","264","140","6","410","1124","0","36.48","23.49"
"10","004","00","050","0006","0273","484","296","188","2","486","1307","0","37.18","22.65"
"10","004","00","050","0006","0274","372","243","129","1","373","1200","0","31.08","20.25"
"10","004","00","050","0006","0275","413","256","157","3","416","1290","0","32.25","19.84"
"10","004","00","050","0007","0000","1024","604","420","4","1028","2816","0","36.51","21.45"
"10","004","00","050","0007","0267","465","262","203","1","466","1317","0","35.38","19.89"
"10","004","00","050","0007","0268","559","342","217","3","562","1499","0","37.49","22.82"
"10","004","00","050","0008","0000","1115","722","393","12","1127","3163","0","35.63","22.83"
"10","004","00","050","0008","0294","425","286","139","6","431","1177","0","36.62","24.30"
"10","004","00","050","0008","0295","308","198","110","5","313","785","0","39.87","25.22"
"10","004","00","050","0008","0296","382","238","144","1","383","1201","0","31.89","19.82"
"10","004","00","050","0009","0000","370","220","150","2","372","1045","0","35.60","21.05"
"10","004","00","050","0009","0297","370","220","150","2","372","1045","0","35.60","21.05"
"10","004","00","050","0010","0000","1059","669","390","15","1074","2753","0","39.01","24.30"
"10","004","00","050","0010","0298","472","314","158","7","479","1302","0","36.79","24.12"
"10","004","00","050","0010","0299","587","355","232","8","595","1451","0","41.01","24.47"
"10","004","00","050","0011","0000","1003","746","257","14","1017","2452","0","41.48","30.42"
"10","004","00","050","0011","0300","517","382","135","9","526","1227","0","42.87","31.13"
"10","004","00","050","0011","0301","486","364","122","5","491","1225","0","40.08","29.71"
"10","004","00","050","0012","0000","610","414","196","2","612","1495","0","40.94","27.69"
"10","004","00","050","0012","0302","610","414","196","2","612","1495","0","40.94","27.69"
"10","004","00","050","0013","0000","745","450","295","7","752","2217","0","33.92","20.30"
"10","004","00","050","0013","0292","356","192","164","7","363","1088","0","33.36","17.65"
"10","004","00","050","0013","0293","389","258","131","0","389","1129","0","34.46","22.85"
"10","004","00","050","0014","0000","1626","1058","568","14","1640","5086","0","32.25","20.80"
"10","004","00","050","0014","0308","340","244","96","1","341","1050","0","32.48","23.24"
"10","004","00","050","0014","0309","372","228","144","6","378","1289","0","29.33","17.69"
"10","004","00","050","0014","0310","448","305","143","3","451","1279","0","35.26","23.85"
"10","004","00","050","0014","0311","466","281","185","4","470","1468","0","32.02","19.14"
"10","004","00","050","0015","0000","1172","857","315","10","1182","3248","0","36.39","26.39"
"10","004","00","050","0015","0315","345","231","114","2","347","1076","0","32.25","21.47"
"10","004","00","050","0015","0316","480","380","100","6","486","1196","0","40.64","31.77"
"10","004","00","050","0015","0317","347","246","101","2","349","976","0","35.76","25.20"
"10","004","00","050","0016","0000","1887","1370","517","17","1904","6149","0","30.96","22.28"
"10","004","00","050","0016","0303","436","345","91","3","439","1387","0","31.65","24.87"
"10","004","00","050","0016","0304","336","272","64","4","340","1016","0","33.46","26.77"
"10","004","00","050","0016","0305","370","249","121","7","377","1196","0","31.52","20.82"
"10","004","00","050","0016","0306","404","283","121","2","406","1403","0","28.94","20.17"
"10","004","00","050","0016","0307","341","221","120","1","342","1147","0","29.82","19.27"
"10","004","00","050","0017","0000","1414","888","526","14","1428","3854","0","37.05","23.04"
"10","004","00","050","0017","0289","390","238","152","3","393","966","0","40.68","24.64"
"10","004","00","050","0017","0290","391","246","145","2","393","1164","0","33.76","21.13"
"10","004","00","050","0017","0291","633","404","229","9","642","1724","0","37.24","23.43"
"10","004","00","050","0018","0000","1341","846","495","17","1358","3485","0","38.97","24.28"
"10","004","00","050","0018","0283","611","367","244","6","617","1458","0","42.32","25.17"
"10","004","00","050","0018","0284","730","479","251","11","741","2027","0","36.56","23.63"
"10","004","00","050","0019","0000","1466","914","552","11","1477","4375","0","33.76","20.89"
"10","004","00","050","0019","0269","398","244","154","1","399","1220","0","32.70","20.00"
"10","004","00","050","0019","0270","486","304","182","4","490","1551","0","31.59","19.60"
"10","004","00","050","0019","0271","582","366","216","6","588","1604","0","36.66","22.82"
"10","004","00","050","0020","0000","1361","948","413","17","1378","4199","0","32.82","22.58"
"10","004","00","050","0020","0312","512","334","178","3","515","1475","0","34.92","22.64"
"10","004","00","050","0020","0313","431","300","131","4","435","1439","0","30.23","20.85"
"10","004","00","050","0020","0314","418","314","104","10","428","1285","0","33.31","24.44"
"10","004","00","060","0000","0000","16888","10362","6526","174","17062","46779","57654","36.47","22.15"
"10","004","00","060","0001","0000","401","230","171","8","409","1086","0","37.66","21.18"
"10","004","00","060","0001","0318","401","230","171","8","409","1086","0","37.66","21.18"
"10","004","00","060","0002","0000","626","347","279","10","636","1798","0","35.37","19.30"
"10","004","00","060","0002","0326","266","143","123","5","271","795","0","34.09","17.99"
"10","004","00","060","0002","0327","360","204","156","5","365","1003","0","36.39","20.34"
"10","004","00","060","0003","0000","649","400","249","9","658","1867","0","35.24","21.42"
"10","004","00","060","0003","0319","290","188","102","4","294","883","0","33.30","21.29"
"10","004","00","060","0003","0320","359","212","147","5","364","984","0","36.99","21.54"
"10","004","00","060","0004","0000","1020","469","551","4","1024","2772","0","36.94","16.92"
"10","004","00","060","0004","0329","334","164","170","2","336","995","0","33.77","16.48"
"10","004","00","060","0004","0330","332","147","185","2","334","858","0","38.93","17.13"
"10","004","00","060","0004","0331","354","158","196","0","354","919","0","38.52","17.19"
"10","004","00","060","0005","0000","573","344","229","6","579","1847","0","31.35","18.62"
"10","004","00","060","0005","0324","331","195","136","2","333","956","0","34.83","20.40"
"10","004","00","060","0005","0325","242","149","93","4","246","891","0","27.61","16.72"
"10","004","00","060","0006","0000","307","123","184","6","313","833","0","37.58","14.77"
"10","004","00","060","0006","0328","307","123","184","6","313","833","0","37.58","14.77"
"10","004","00","060","0007","0000","1090","688","402","16","1106","3202","0","34.54","21.49"
"10","004","00","060","0007","0321","374","240","134","5","379","990","0","38.28","24.24"
"10","004","00","060","0007","0322","368","235","133","6","374","1123","0","33.30","20.93"
"10","004","00","060","0007","0323","348","213","135","5","353","1089","0","32.42","19.56"
"10","004","00","060","0008","0000","1763","1129","634","15","1778","5247","0","33.89","21.52"
"10","004","00","060","0008","0346","363","226","137","5","368","977","0","37.67","23.13"
"10","004","00","060","0008","0347","408","263","145","3","411","1054","0","38.99","24.95"
"10","004","00","060","0008","0348","302","199","103","2","304","1062","0","28.63","18.74"
"10","004","00","060","0008","0349","319","202","117","2","321","1013","0","31.69","19.94"
"10","004","00","060","0008","0350","371","239","132","3","374","1141","0","32.78","20.95"
"10","004","00","060","0009","0000","728","328","400","5","733","2073","0","35.36","15.82"
"10","004","00","060","0009","0332","331","135","196","2","333","1022","0","32.58","13.21"
"10","004","00","060","0009","0333","397","193","204","3","400","1051","0","38.06","18.36"
"10","004","00","060","0010","0000","986","661","325","6","992","2634","0","37.66","25.09"
"10","004","00","060","0010","0334","505","343","162","5","510","1352","0","37.72","25.37"
"10","004","00","060","0010","0335","481","318","163","1","482","1282","0","37.60","24.80"
"10","004","00","060","0011","0000","1709","1124","585","14","1723","4372","0","39.41","25.71"
"10","004","00","060","0011","0354","451","303","148","5","456","1117","0","40.82","27.13"
"10","004","00","060","0011","0355","390","263","127","3","393","1052","0","37.36","25.00"
"10","004","00","060","0011","0356","448","289","159","4","452","1201","0","37.64","24.06"
"10","004","00","060","0011","0357","420","269","151","2","422","1002","0","42.12","26.85"
"10","004","00","060","0012","0000","574","373","201","9","583","1508","0","38.66","24.73"
"10","004","00","060","0012","0343","276","170","106","6","282","758","0","37.20","22.43"
"10","004","00","060","0012","0344","298","203","95","3","301","750","0","40.13","27.07"
"10","004","00","060","0013","0000","398","244","154","5","403","1044","0","38.60","23.37"
"10","004","00","060","0013","0345","398","244","154","5","403","1044","0","38.60","23.37"
"10","004","00","060","0014","0000","1342","871","471","13","1355","3558","0","38.08","24.48"
"10","004","00","060","0014","0336","472","309","163","2","474","1308","0","36.24","23.62"
"10","004","00","060","0014","0337","453","285","168","4","457","1124","0","40.66","25.36"
"10","004","00","060","0014","0338","417","277","140","7","424","1126","0","37.66","24.60"
"10","004","00","060","0015","0000","1707","1106","601","16","1723","4427","0","38.92","24.98"
"10","004","00","060","0015","0339","389","255","134","6","395","1114","0","35.46","22.89"
"10","004","00","060","0015","0340","387","249","138","2","389","1007","0","38.63","24.73"
"10","004","00","060","0015","0341","430","277","153","2","432","1065","0","40.56","26.01"
"10","004","00","060","0015","0342","501","325","176","6","507","1241","0","40.85","26.19"
"10","004","00","060","0016","0000","2023","1291","732","15","2038","5803","0","35.12","22.25"
"10","004","00","060","0016","0358","428","261","167","5","433","1107","0","39.11","23.58"
"10","004","00","060","0016","0359","428","260","168","2","430","1175","0","36.60","22.13"
"10","004","00","060","0016","0360","418","292","126","2","420","1184","0","35.47","24.66"
"10","004","00","060","0016","0361","346","236","110","2","348","1016","0","34.25","23.23"
"10","004","00","060","0016","0362","403","242","161","4","407","1321","0","30.81","18.32"
"10","004","00","060","0017","0000","992","634","358","17","1009","2708","0","37.26","23.41"
"10","004","00","060","0017","0351","307","206","101","3","310","926","0","33.48","22.25"
"10","004","00","060","0017","0352","282","179","103","5","287","820","0","35.00","21.83"
"10","004","00","060","0017","0353","403","249","154","9","412","962","0","42.83","25.88"
"10","004","00","070","0000","0000","7102","4724","2378","67","7169","17504","19888","40.96","26.99"
"10","004","00","070","0001","0000","199","147","52","1","200","491","0","40.73","29.94"
"10","004","00","070","0001","0364","199","147","52","1","200","491","0","40.73","29.94"
"10","004","00","070","0002","0000","167","118","49","2","169","384","0","44.01","30.73"
"10","004","00","070","0002","0363","167","118","49","2","169","384","0","44.01","30.73"
"10","004","00","070","0003","0000","366","280","86","2","368","934","0","39.40","29.98"
"10","004","00","070","0003","0365","366","280","86","2","368","934","0","39.40","29.98"
"10","004","00","070","0004","0000","156","118","38","3","159","409","0","38.88","28.85"
"10","004","00","070","0004","0366","156","118","38","3","159","409","0","38.88","28.85"
"10","004","00","070","0005","0000","1016","678","338","9","1025","2655","0","38.61","25.54"
"10","004","00","070","0005","0367","507","348","159","3","510","1267","0","40.25","27.47"
"10","004","00","070","0005","0368","509","330","179","6","515","1388","0","37.10","23.78"
"10","004","00","070","0006","0000","588","377","211","9","597","1577","0","37.86","23.91"
"10","004","00","070","0006","0369","301","185","116","5","306","787","0","38.88","23.51"
"10","004","00","070","0006","0370","287","192","95","4","291","790","0","36.84","24.30"
"10","004","00","070","0007","0000","239","168","71","4","243","626","0","38.82","26.84"
"10","004","00","070","0007","0371","239","168","71","4","243","626","0","38.82","26.84"
"10","004","00","070","0008","0000","308","197","111","6","314","779","0","40.31","25.29"
"10","004","00","070","0008","0372","308","197","111","6","314","779","0","40.31","25.29"
"10","004","00","070","0009","0000","927","647","280","9","936","2349","0","39.85","27.54"
"10","004","00","070","0009","0373","447","292","155","4","451","1261","0","35.77","23.16"
"10","004","00","070","0009","0374","480","355","125","5","485","1088","0","44.58","32.63"
"10","004","00","070","0010","0000","657","414","243","8","665","1559","0","42.66","26.56"
"10","004","00","070","0010","0375","290","179","111","7","297","681","0","43.61","26.28"
"10","004","00","070","0010","0376","367","235","132","1","368","878","0","41.91","26.77"
"10","004","00","070","0011","0000","1995","1272","723","11","2006","4643","0","43.20","27.40"
"10","004","00","070","0011","0377","510","343","167","4","514","1165","0","44.12","29.44"
"10","004","00","070","0011","0378","578","373","205","2","580","1366","0","42.46","27.31"
"10","004","00","070","0011","0379","523","303","220","3","526","1047","0","50.24","28.94"
"10","004","00","070","0011","0380","384","253","131","2","386","1065","0","36.24","23.76"
"10","004","00","070","0012","0000","484","308","176","3","487","1098","0","44.35","28.05"
"10","004","00","070","0012","0381","484","308","176","3","487","1098","0","44.35","28.05"
"10","004","00","080","0000","0000","4318","3049","1269","68","4386","11007","12408","39.85","27.70"
"10","004","00","080","0001","0000","1219","855","364","19","1238","3300","0","37.52","25.91"
"10","004","00","080","0001","0382","479","333","146","7","486","1176","0","41.33","28.32"
"10","004","00","080","0001","0383","369","260","109","7","376","1021","0","36.83","25.47"
"10","004","00","080","0001","0384","371","262","109","5","376","1103","0","34.09","23.75"
"10","004","00","080","0002","0000","341","217","124","6","347","847","0","40.97","25.62"
"10","004","00","080","0002","0385","341","217","124","6","347","847","0","40.97","25.62"
"10","004","00","080","0003","0000","78","56","22","2","80","180","0","44.44","31.11"
"10","004","00","080","0003","0386","78","56","22","2","80","180","0","44.44","31.11"
"10","004","00","080","0004","0000","75","42","33","2","77","203","0","37.93","20.69"
"10","004","00","080","0004","0387","75","42","33","2","77","203","0","37.93","20.69"
"10","004","00","080","0005","0000","119","78","41","3","122","320","0","38.13","24.38"
"10","004","00","080","0005","0388","119","78","41","3","122","320","0","38.13","24.38"
"10","004","00","080","0006","0000","343","247","96","7","350","882","0","39.68","28.00"
"10","004","00","080","0006","0389","343","247","96","7","350","882","0","39.68","28.00"
"10","004","00","080","0007","0000","164","106","58","2","166","419","0","39.62","25.30"
"10","004","00","080","0007","0392","164","106","58","2","166","419","0","39.62","25.30"
"10","004","00","080","0008","0000","410","265","145","8","418","938","0","44.56","28.25"
"10","004","00","080","0008","0393","292","191","101","8","300","675","0","44.44","28.30"
"10","004","00","080","0008","0394","118","74","44","0","118","263","0","44.87","28.14"
"10","004","00","080","0009","0000","624","464","160","10","634","1488","0","42.61","31.18"
"10","004","00","080","0009","0395","271","207","64","4","275","661","0","41.60","31.32"
"10","004","00","080","0009","0396","353","257","96","6","359","827","0","43.41","31.08"
"10","004","00","080","0010","0000","605","469","136","7","612","1628","0","37.59","28.81"
"10","004","00","080","0010","0397","313","252","61","5","318","832","0","38.22","30.29"
"10","004","00","080","0010","0398","292","217","75","2","294","796","0","36.93","27.26"
"10","004","00","080","0011","0000","340","250","90","2","342","802","0","42.64","31.17"
"10","004","00","080","0011","0390","141","101","40","1","142","273","0","52.01","37.00"
"10","004","00","080","0011","0391","199","149","50","1","200","529","0","37.81","28.17"
"10","004","00","090","0000","0000","2938","2006","932","30","2968","7870","8864","37.71","25.49"
"10","004","00","090","0001","0000","412","275","137","3","415","1117","0","37.15","24.62"
"10","004","00","090","0001","0399","412","275","137","3","415","1117","0","37.15","24.62"
"10","004","00","090","0002","0000","416","292","124","6","422","1142","0","36.95","25.57"
"10","004","00","090","0002","0400","416","292","124","6","422","1142","0","36.95","25.57"
"10","004","00","090","0003","0000","934","636","298","9","943","2547","0","37.02","24.97"
"10","004","00","090","0003","0402","355","239","116","6","361","918","0","39.32","26.03"
"10","004","00","090","0003","0403","287","203","84","2","289","793","0","36.44","25.60"
"10","004","00","090","0003","0404","292","194","98","1","293","836","0","35.05","23.21"
"10","004","00","090","0004","0000","279","172","107","3","282","818","0","34.47","21.03"
"10","004","00","090","0004","0405","279","172","107","3","282","818","0","34.47","21.03"
"10","004","00","090","0005","0000","179","131","48","2","181","363","0","49.86","36.09"
"10","004","00","090","0005","0406","179","131","48","2","181","363","0","49.86","36.09"
"10","004","00","090","0006","0000","270","203","67","2","272","720","0","37.78","28.19"
"10","004","00","090","0006","0407","270","203","67","2","272","720","0","37.78","28.19"
"10","004","00","090","0007","0000","185","133","52","2","187","541","0","34.57","24.58"
"10","004","00","090","0007","0401","185","133","52","2","187","541","0","34.57","24.58"
"10","004","00","090","0008","0000","142","93","49","2","144","325","0","44.31","28.62"
"10","004","00","090","0008","0408","142","93","49","2","144","325","0","44.31","28.62"
"10","004","00","090","0009","0000","121","71","50","1","122","297","0","41.08","23.91"
"10","004","00","090","0009","0409","121","71","50","1","122","297","0","41.08","23.91"
"10","004","00","100","0000","0000","5141","3308","1833","43","5184","13015","14570","39.83","25.42"
"10","004","00","100","0001","0000","1011","636","375","11","1022","2659","0","38.44","23.92"
"10","004","00","100","0001","0410","392","248","144","1","393","1101","0","35.69","22.52"
"10","004","00","100","0001","0411","619","388","231","10","629","1558","0","40.37","24.90"
"10","004","00","100","0002","0000","873","562","311","6","879","2006","0","43.82","28.02"
"10","004","00","100","0002","0414","459","304","155","2","461","975","0","47.28","31.18"
"10","004","00","100","0002","0415","414","258","156","4","418","1031","0","40.54","25.02"
"10","004","00","100","0003","0000","397","266","131","7","404","1015","0","39.80","26.21"
"10","004","00","100","0003","0416","397","266","131","7","404","1015","0","39.80","26.21"
"10","004","00","100","0004","0000","427","262","165","3","430","1168","0","36.82","22.43"
"10","004","00","100","0004","0417","427","262","165","3","430","1168","0","36.82","22.43"
"10","004","00","100","0005","0000","324","208","116","3","327","794","0","41.18","26.20"
"10","004","00","100","0005","0419","324","208","116","3","327","794","0","41.18","26.20"
"10","004","00","100","0006","0000","231","152","79","2","233","731","0","31.87","20.79"
"10","004","00","100","0006","0418","231","152","79","2","233","731","0","31.87","20.79"
"10","004","00","100","0007","0000","248","164","84","1","249","541","0","46.03","30.31"
"10","004","00","100","0007","0422","248","164","84","1","249","541","0","46.03","30.31"
"10","004","00","100","0008","0000","344","228","116","3","347","847","0","40.97","26.92"
"10","004","00","100","0008","0420","344","228","116","3","347","847","0","40.97","26.92"
"10","004","00","100","0009","0000","250","168","82","2","252","578","0","43.60","29.07"
"10","004","00","100","0009","0421","250","168","82","2","252","578","0","43.60","29.07"
"10","004","00","100","0010","0000","1036","662","374","5","1041","2676","0","38.90","24.74"
"10","004","00","100","0010","0412","587","365","222","3","590","1507","0","39.15","24.22"
"10","004","00","100","0010","0413","449","297","152","2","451","1169","0","38.58","25.41"
"10","004","00","110","0000","0000","1950","1253","697","18","1968","4838","5323","40.68","25.90"
"10","004","00","110","0001","0000","369","260","109","6","375","815","0","46.01","31.90"
"10","004","00","110","0001","0423","369","260","109","6","375","815","0","46.01","31.90"
"10","004","00","110","0002","0000","271","157","114","2","273","665","0","41.05","23.61"
"10","004","00","110","0002","0424","271","157","114","2","273","665","0","41.05","23.61"
"10","004","00","110","0003","0000","242","162","80","0","242","563","0","42.98","28.77"
"10","004","00","110","0003","0425","242","162","80","0","242","563","0","42.98","28.77"
"10","004","00","110","0004","0000","493","332","161","3","496","1340","0","37.01","24.78"
"10","004","00","110","0004","0428","241","165","76","1","242","646","0","37.46","25.54"
"10","004","00","110","0004","0429","252","167","85","2","254","694","0","36.60","24.06"
"10","004","00","110","0005","0000","247","154","93","2","249","605","0","41.16","25.45"
"10","004","00","110","0005","0426","142","89","53","1","143","343","0","41.69","25.95"
"10","004","00","110","0005","0427","105","65","40","1","106","262","0","40.46","24.81"
"10","004","00","110","0006","0000","328","188","140","5","333","850","0","39.18","22.12"
"10","004","00","110","0006","0430","187","109","78","0","187","448","0","41.74","24.33"
"10","004","00","110","0006","0431","141","79","62","5","146","402","0","36.32","19.65"
"10","004","00","120","0000","0000","1708","1320","388","21","1729","7360","9561","23.49","17.93"
"10","004","00","120","0001","0000","167","121","46","2","169","587","0","28.79","20.61"
"10","004","00","120","0001","0434","69","45","24","0","69","217","0","31.80","20.74"
"10","004","00","120","0001","0435","98","76","22","2","100","370","0","27.03","20.54"
"10","004","00","120","0002","0000","268","206","62","3","271","818","0","33.13","25.18"
"10","004","00","120","0002","0432","144","113","31","3","147","457","0","32.17","24.73"
"10","004","00","120","0002","0433","124","93","31","0","124","361","0","34.35","25.76"
"10","004","00","120","0003","0000","313","262","51","5","318","1210","0","26.28","21.65"
"10","004","00","120","0003","0436","206","171","35","4","210","734","0","28.61","23.30"
"10","004","00","120","0003","0437","107","91","16","1","108","476","0","22.69","19.12"
"10","004","00","120","0004","0000","201","166","35","3","204","626","0","32.59","26.52"
"10","004","00","120","0004","0440","201","166","35","3","204","626","0","32.59","26.52"
"10","004","00","120","0005","0000","257","212","45","1","258","1161","0","22.22","18.26"
"10","004","00","120","0005","0438","110","93","17","1","111","532","0","20.86","17.48"
"10","004","00","120","0005","0439","147","119","28","0","147","629","0","23.37","18.92"
"10","004","00","120","0006","0000","241","161","80","3","244","1329","0","18.36","12.11"
"10","004","00","120","0006","0441","110","83","27","1","111","613","0","18.11","13.54"
"10","004","00","120","0006","0442","84","58","26","2","86","589","0","14.60","9.85"
"10","004","00","120","0006","0443","47","20","27","0","47","127","0","37.01","15.75"
"10","004","00","120","0007","0000","261","192","69","4","265","1629","0","16.27","11.79"
"10","004","00","120","0007","0444","91","79","12","2","93","488","0","19.06","16.19"
"10","004","00","120","0007","0445","110","84","26","2","112","825","0","13.58","10.18"
"10","004","00","120","0007","0446","60","29","31","0","60","316","0","18.99","9.18"
"10","004","00","130","0000","0000","1005","784","221","13","1018","3736","4431","27.25","20.99"
"10","004","00","130","0001","0000","345","297","48","5","350","1281","0","27.32","23.19"
"10","004","00","130","0001","0447","172","153","19","2","174","632","0","27.53","24.21"
"10","004","00","130","0001","0448","173","144","29","3","176","649","0","27.12","22.19"
"10","004","00","130","0002","0000","204","156","48","2","206","711","0","28.97","21.94"
"10","004","00","130","0002","0451","204","156","48","2","206","711","0","28.97","21.94"
"10","004","00","130","0003","0000","100","77","23","0","100","377","0","26.53","20.42"
"10","004","00","130","0003","0452","100","77","23","0","100","377","0","26.53","20.42"
"10","004","00","130","0004","0000","356","254","102","6","362","1367","0","26.48","18.58"
"10","004","00","130","0004","0449","144","105","39","1","145","535","0","27.10","19.63"
"10","004","00","130","0004","0450","212","149","63","5","217","832","0","26.08","17.91"
"10","005","00","000","0000","0000","169955","106243","63712","1580","171535","457991","540312","37.45","23.20"
"10","005","00","010","0000","0000","29578","20688","8890","203","29781","73644","87384","40.44","28.09"
"10","005","00","010","0001","0000","479","344","135","0","479","1116","0","42.92","30.82"
"10","005","00","010","0001","0001","479","344","135","0","479","1116","0","42.92","30.82"
"10","005","00","010","0002","0000","1700","1222","478","6","1706","4048","0","42.14","30.19"
"10","005","00","010","0002","0049","410","287","123","0","410","1004","0","40.84","28.59"
"10","005","00","010","0002","0050","453","303","150","0","453","997","0","45.44","30.39"
"10","005","00","010","0002","0051","393","287","106","4","397","1050","0","37.81","27.33"
"10","005","00","010","0002","0052","444","345","99","2","446","997","0","44.73","34.60"
"10","005","00","010","0003","0000","360","240","120","5","365","1005","0","36.32","23.88"
"10","005","00","010","0003","0002","360","240","120","5","365","1005","0","36.32","23.88"
"10","005","00","010","0004","0000","1032","762","270","7","1039","2166","0","47.97","35.18"
"10","005","00","010","0004","0009","522","389","133","4","526","1082","0","48.61","35.95"
"10","005","00","010","0004","0010","510","373","137","3","513","1084","0","47.32","34.41"
"10","005","00","010","0005","0000","1537","1123","414","9","1546","3579","0","43.20","31.38"
"10","005","00","010","0005","0011","436","293","143","3","439","1096","0","40.05","26.73"
"10","005","00","010","0005","0012","528","401","127","5","533","1248","0","42.71","32.13"
"10","005","00","010","0005","0013","573","429","144","1","574","1235","0","46.48","34.74"
"10","005","00","010","0006","0000","1497","1088","409","14","1511","3590","0","42.09","30.31"
"10","005","00","010","0006","0006","526","382","144","6","532","1189","0","44.74","32.13"
"10","005","00","010","0006","0007","521","398","123","1","522","1272","0","41.04","31.29"
"10","005","00","010","0006","0008","450","308","142","7","457","1129","0","40.48","27.28"
"10","005","00","010","0007","0000","1230","896","334","6","1236","3260","0","37.91","27.48"
"10","005","00","010","0007","0003","412","318","94","2","414","1093","0","37.88","29.09"
"10","005","00","010","0007","0004","413","299","114","3","416","1088","0","38.24","27.48"
"10","005","00","010","0007","0005","405","279","126","1","406","1079","0","37.63","25.86"
"10","005","00","010","0008","0000","321","226","95","2","323","805","0","40.12","28.07"
"10","005","00","010","0008","0014","321","226","95","2","323","805","0","40.12","28.07"
"10","005","00","010","0009","0000","1210","826","384","2","1212","3216","0","37.69","25.68"
"10","005","00","010","0009","0015","352","240","112","1","353","963","0","36.66","24.92"
"10","005","00","010","0009","0016","412","280","132","1","413","1117","0","36.97","25.07"
"10","005","00","010","0009","0017","446","306","140","0","446","1136","0","39.26","26.94"
"10","005","00","010","0010","0000","362","221","141","6","368","856","0","42.99","25.82"
"10","005","00","010","0010","0019","362","221","141","6","368","856","0","42.99","25.82"
"10","005","00","010","0011","0000","229","151","78","5","234","497","0","47.08","30.38"
"10","005","00","010","0011","0020","229","151","78","5","234","497","0","47.08","30.38"
"10","005","00","010","0012","0000","355","216","139","2","357","841","0","42.45","25.68"
"10","005","00","010","0012","0018","355","216","139","2","357","841","0","42.45","25.68"
"10","005","00","010","0013","0000","1646","1142","504","12","1658","3843","0","43.14","29.72"
"10","005","00","010","0013","0024","503","353","150","5","508","1203","0","42.23","29.34"
"10","005","00","010","0013","0025","482","342","140","2","484","1112","0","43.53","30.76"
"10","005","00","010","0013","0026","360","261","99","1","361","772","0","46.76","33.81"
"10","005","00","010","0013","0027","301","186","115","4","305","756","0","40.34","24.60"
"10","005","00","010","0014","0000","504","342","162","4","508","1333","0","38.11","25.66"
"10","005","00","010","0014","0021","504","342","162","4","508","1333","0","38.11","25.66"
"10","005","00","010","0015","0000","669","431","238","10","679","1503","0","45.18","28.68"
"10","005","00","010","0015","0031","273","187","86","5","278","574","0","48.43","32.58"
"10","005","00","010","0015","0032","396","244","152","5","401","929","0","43.16","26.26"
"10","005","00","010","0016","0000","2074","1434","640","16","2090","5025","0","41.59","28.54"
"10","005","00","010","0016","0033","511","352","159","2","513","1192","0","43.04","29.53"
"10","005","00","010","0016","0034","548","371","177","8","556","1433","0","38.80","25.89"
"10","005","00","010","0016","0035","489","344","145","2","491","1165","0","42.15","29.53"
"10","005","00","010","0016","0036","526","367","159","4","530","1235","0","42.91","29.72"
"10","005","00","010","0017","0000","1390","960","430","8","1398","3087","0","45.29","31.10"
"10","005","00","010","0017","0028","418","279","139","1","419","1000","0","41.90","27.90"
"10","005","00","010","0017","0029","515","366","149","5","520","1128","0","46.10","32.45"
"10","005","00","010","0017","0030","457","315","142","2","459","959","0","47.86","32.85"
"10","005","00","010","0018","0000","1384","980","404","9","1393","3365","0","41.40","29.12"
"10","005","00","010","0018","0037","492","348","144","4","496","1177","0","42.14","29.57"
"10","005","00","010","0018","0038","433","302","131","2","435","1042","0","41.75","28.98"
"10","005","00","010","0018","0039","459","330","129","3","462","1146","0","40.31","28.80"
"10","005","00","010","0019","0000","1578","1068","510","9","1587","4152","0","38.22","25.72"
"10","005","00","010","0019","0040","546","369","177","5","551","1409","0","39.11","26.19"
"10","005","00","010","0019","0041","506","347","159","0","506","1342","0","37.70","25.86"
"10","005","00","010","0019","0042","526","352","174","4","530","1401","0","37.83","25.12"
"10","005","00","010","0020","0000","441","294","147","3","444","1166","0","38.08","25.21"
"10","005","00","010","0020","0063","441","294","147","3","444","1166","0","38.08","25.21"
"10","005","00","010","0021","0000","1606","1133","473","7","1613","4041","0","39.92","28.04"
"10","005","00","010","0021","0057","531","372","159","2","533","1307","0","40.78","28.46"
"10","005","00","010","0021","0058","518","345","173","1","519","1350","0","38.44","25.56"
"10","005","00","010","0021","0059","557","416","141","4","561","1384","0","40.53","30.06"
"10","005","00","010","0022","0000","2053","1446","607","12","2065","5344","0","38.64","27.06"
"10","005","00","010","0022","0053","413","291","122","1","414","1079","0","38.37","26.97"
"10","005","00","010","0022","0054","463","340","123","1","464","1165","0","39.83","29.18"
"10","005","00","010","0022","0055","628","438","190","6","634","1484","0","42.72","29.51"
"10","005","00","010","0022","0056","549","377","172","4","553","1616","0","34.22","23.33"
"10","005","00","010","0023","0000","940","650","290","8","948","2448","0","38.73","26.55"
"10","005","00","010","0023","0022","521","349","172","2","523","1382","0","37.84","25.25"
"10","005","00","010","0023","0023","419","301","118","6","425","1066","0","39.87","28.24"
"10","005","00","010","0024","0000","572","394","178","4","576","1664","0","34.62","23.68"
"10","005","00","010","0024","0066","266","201","65","3","269","793","0","33.92","25.35"
"10","005","00","010","0024","0067","306","193","113","1","307","871","0","35.25","22.16"
"10","005","00","010","0025","0000","1259","886","373","8","1267","3443","0","36.80","25.73"
"10","005","00","010","0025","0043","469","312","157","1","470","1250","0","37.60","24.96"
"10","005","00","010","0025","0044","390","274","116","6","396","984","0","40.24","27.85"
"10","005","00","010","0025","0045","400","300","100","1","401","1209","0","33.17","24.81"
"10","005","00","010","0026","0000","1239","892","347","15","1254","2769","0","45.29","32.21"
"10","005","00","010","0026","0046","395","285","110","4","399","998","0","39.98","28.56"
"10","005","00","010","0026","0047","400","295","105","8","408","835","0","48.86","35.33"
"10","005","00","010","0026","0048","444","312","132","3","447","936","0","47.76","33.33"
"10","005","00","010","0027","0000","646","450","196","4","650","1926","0","33.75","23.36"
"10","005","00","010","0027","0064","349","237","112","2","351","1039","0","33.78","22.81"
"10","005","00","010","0027","0065","297","213","84","2","299","887","0","33.71","24.01"
"10","005","00","010","0028","0000","1265","871","394","10","1275","3556","0","35.85","24.49"
"10","005","00","010","0028","0060","494","356","138","2","496","1274","0","38.93","27.94"
"10","005","00","010","0028","0061","474","316","158","2","476","1390","0","34.24","22.73"
"10","005","00","010","0028","0062","297","199","98","6","303","892","0","33.97","22.31"
"10","005","00","020","0000","0000","13646","6034","7612","119","13765","38502","44437","35.75","15.67"
"10","005","00","020","0001","0000","820","396","424","7","827","2145","0","38.55","18.46"
"10","005","00","020","0001","0068","356","180","176","5","361","847","0","42.62","21.25"
"10","005","00","020","0001","0069","464","216","248","2","466","1298","0","35.90","16.64"
"10","005","00","020","0002","0000","603","273","330","2","605","1435","0","42.16","19.02"
"10","005","00","020","0002","0070","353","167","186","2","355","754","0","47.08","22.15"
"10","005","00","020","0002","0071","250","106","144","0","250","681","0","36.71","15.57"
"10","005","00","020","0003","0000","362","153","209","4","366","878","0","41.69","17.43"
"10","005","00","020","0003","0072","362","153","209","4","366","878","0","41.69","17.43"
"10","005","00","020","0004","0000","574","229","345","4","578","1612","0","35.86","14.21"
"10","005","00","020","0004","0073","296","138","158","1","297","832","0","35.70","16.59"
"10","005","00","020","0004","0074","278","91","187","3","281","780","0","36.03","11.67"
"10","005","00","020","0005","0000","419","126","293","4","423","1191","0","35.52","10.58"
"10","005","00","020","0005","0075","419","126","293","4","423","1191","0","35.52","10.58"
"10","005","00","020","0006","0000","710","299","411","5","715","1961","0","36.46","15.25"
"10","005","00","020","0006","0076","423","184","239","3","426","1130","0","37.70","16.28"
"10","005","00","020","0006","0077","287","115","172","2","289","831","0","34.78","13.84"
"10","005","00","020","0007","0000","340","134","206","6","346","1037","0","33.37","12.92"
"10","005","00","020","0007","0078","340","134","206","6","346","1037","0","33.37","12.92"
"10","005","00","020","0008","0000","771","346","425","6","777","2186","0","35.54","15.83"
"10","005","00","020","0008","0079","389","178","211","2","391","1098","0","35.61","16.21"
"10","005","00","020","0008","0080","382","168","214","4","386","1088","0","35.48","15.44"
"10","005","00","020","0009","0000","1518","698","820","11","1529","3952","0","38.69","17.66"
"10","005","00","020","0009","0081","515","227","288","7","522","1415","0","36.89","16.04"
"10","005","00","020","0009","0082","482","227","255","2","484","1285","0","37.67","17.67"
"10","005","00","020","0009","0083","521","244","277","2","523","1252","0","41.77","19.49"
"10","005","00","020","0010","0000","712","306","406","5","717","2128","0","33.69","14.38"
"10","005","00","020","0010","0084","360","151","209","2","362","1054","0","34.35","14.33"
"10","005","00","020","0010","0085","352","155","197","3","355","1074","0","33.05","14.43"
"10","005","00","020","0011","0000","284","100","184","1","285","912","0","31.25","10.96"
"10","005","00","020","0011","0086","284","100","184","1","285","912","0","31.25","10.96"
"10","005","00","020","0012","0000","224","83","141","0","224","628","0","35.67","13.22"
"10","005","00","020","0012","0087","224","83","141","0","224","628","0","35.67","13.22"
"10","005","00","020","0013","0000","534","251","283","7","541","1353","0","39.99","18.55"
"10","005","00","020","0013","0088","534","251","283","7","541","1353","0","39.99","18.55"
"10","005","00","020","0014","0000","484","227","257","2","486","1350","0","36.00","16.81"
"10","005","00","020","0014","0089","241","80","161","1","242","665","0","36.39","12.03"
"10","005","00","020","0014","0090","243","147","96","1","244","685","0","35.62","21.46"
"10","005","00","020","0015","0000","624","295","329","9","633","1788","0","35.40","16.50"
"10","005","00","020","0015","0091","322","149","173","5","327","893","0","36.62","16.69"
"10","005","00","020","0015","0092","302","146","156","4","306","895","0","34.19","16.31"
"10","005","00","020","0016","0000","426","194","232","4","430","1235","0","34.82","15.71"
"10","005","00","020","0016","0093","426","194","232","4","430","1235","0","34.82","15.71"
"10","005","00","020","0017","0000","186","97","89","1","187","546","0","34.25","17.77"
"10","005","00","020","0017","0094","186","97","89","1","187","546","0","34.25","17.77"
"10","005","00","020","0018","0000","276","149","127","1","277","770","0","35.97","19.35"
"10","005","00","020","0018","0095","276","149","127","1","277","770","0","35.97","19.35"
"10","005","00","020","0019","0000","775","335","440","5","780","2413","0","32.32","13.88"
"10","005","00","020","0019","0103","364","166","198","3","367","1137","0","32.28","14.60"
"10","005","00","020","0019","0104","411","169","242","2","413","1276","0","32.37","13.24"
"10","005","00","020","0020","0000","567","207","360","7","574","1649","0","34.81","12.55"
"10","005","00","020","0020","0097","297","114","183","3","300","881","0","34.05","12.94"
"10","005","00","020","0020","0098","270","93","177","4","274","768","0","35.68","12.11"
"10","005","00","020","0021","0000","559","275","284","11","570","1604","0","35.54","17.14"
"10","005","00","020","0021","0099","270","166","104","4","274","781","0","35.08","21.25"
"10","005","00","020","0021","0100","289","109","180","7","296","823","0","35.97","13.24"
"10","005","00","020","0022","0000","555","244","311","7","562","1758","0","31.97","13.88"
"10","005","00","020","0022","0101","273","105","168","1","274","827","0","33.13","12.70"
"10","005","00","020","0022","0102","282","139","143","6","288","931","0","30.93","14.93"
"10","005","00","020","0023","0000","222","82","140","3","225","680","0","33.09","12.06"
"10","005","00","020","0023","0096","222","82","140","3","225","680","0","33.09","12.06"
"10","005","00","020","0024","0000","440","213","227","3","443","1419","0","31.22","15.01"
"10","005","00","020","0024","0105","440","213","227","3","443","1419","0","31.22","15.01"
"10","005","00","020","0025","0000","661","322","339","4","665","1872","0","35.52","17.20"
"10","005","00","020","0025","0106","355","192","163","2","357","987","0","36.17","19.45"
"10","005","00","020","0025","0107","306","130","176","2","308","885","0","34.80","14.69"
"10","005","00","030","0000","0000","9730","4641","5089","110","9840","28819","32701","34.14","16.10"
"10","005","00","030","0001","0000","407","188","219","4","411","1064","0","38.63","17.67"
"10","005","00","030","0001","0108","407","188","219","4","411","1064","0","38.63","17.67"
"10","005","00","030","0002","0000","790","371","419","8","798","1916","0","41.65","19.36"
"10","005","00","030","0002","0109","381","165","216","6","387","864","0","44.79","19.10"
"10","005","00","030","0002","0110","409","206","203","2","411","1052","0","39.07","19.58"
"10","005","00","030","0003","0000","722","330","392","6","728","1805","0","40.33","18.28"
"10","005","00","030","0003","0111","367","158","209","2","369","973","0","37.92","16.24"
"10","005","00","030","0003","0112","355","172","183","4","359","832","0","43.15","20.67"
"10","005","00","030","0004","0000","515","212","303","8","523","1531","0","34.16","13.85"
"10","005","00","030","0004","0116","262","125","137","4","266","737","0","36.09","16.96"
"10","005","00","030","0004","0117","253","87","166","4","257","794","0","32.37","10.96"
"10","005","00","030","0005","0000","247","108","139","3","250","676","0","36.98","15.98"
"10","005","00","030","0005","0115","247","108","139","3","250","676","0","36.98","15.98"
"10","005","00","030","0006","0000","874","419","455","7","881","2637","0","33.41","15.89"
"10","005","00","030","0006","0118","342","170","172","3","345","929","0","37.14","18.30"
"10","005","00","030","0006","0119","304","138","166","4","308","938","0","32.84","14.71"
"10","005","00","030","0006","0120","228","111","117","0","228","770","0","29.61","14.42"
"10","005","00","030","0007","0000","222","108","114","5","227","658","0","34.50","16.41"
"10","005","00","030","0007","0127","222","108","114","5","227","658","0","34.50","16.41"
"10","005","00","030","0008","0000","312","137","175","10","322","903","0","35.66","15.17"
"10","005","00","030","0008","0128","312","137","175","10","322","903","0","35.66","15.17"
"10","005","00","030","0009","0000","292","123","169","2","294","769","0","38.23","15.99"
"10","005","00","030","0009","0129","292","123","169","2","294","769","0","38.23","15.99"
"10","005","00","030","0010","0000","225","119","106","4","229","622","0","36.82","19.13"
"10","005","00","030","0010","0130","225","119","106","4","229","622","0","36.82","19.13"
"10","005","00","030","0011","0000","394","213","181","6","400","1189","0","33.64","17.91"
"10","005","00","030","0011","0131","394","213","181","6","400","1189","0","33.64","17.91"
"10","005","00","030","0012","0000","441","218","223","5","446","1325","0","33.66","16.45"
"10","005","00","030","0012","0132","441","218","223","5","446","1325","0","33.66","16.45"
"10","005","00","030","0013","0000","458","194","264","4","462","1379","0","33.50","14.07"
"10","005","00","030","0013","0133","245","120","125","1","246","628","0","39.17","19.11"
"10","005","00","030","0013","0134","213","74","139","3","216","751","0","28.76","9.85"
"10","005","00","030","0014","0000","528","261","267","4","532","1822","0","29.20","14.32"
"10","005","00","030","0014","0121","204","95","109","2","206","734","0","28.07","12.94"
"10","005","00","030","0014","0122","324","166","158","2","326","1088","0","29.96","15.26"
"10","005","00","030","0015","0000","145","79","66","0","145","415","0","34.94","19.04"
"10","005","00","030","0015","0123","145","79","66","0","145","415","0","34.94","19.04"
"10","005","00","030","0016","0000","293","190","103","3","296","856","0","34.58","22.20"
"10","005","00","030","0016","0124","293","190","103","3","296","856","0","34.58","22.20"
"10","005","00","030","0017","0000","124","86","38","0","124","385","0","32.21","22.34"
"10","005","00","030","0017","0125","124","86","38","0","124","385","0","32.21","22.34"
"10","005","00","030","0018","0000","225","117","108","5","230","770","0","29.87","15.19"
"10","005","00","030","0018","0126","225","117","108","5","230","770","0","29.87","15.19"
"10","005","00","030","0019","0000","627","310","317","6","633","2187","0","28.94","14.17"
"10","005","00","030","0019","0135","320","136","184","4","324","1075","0","30.14","12.65"
"10","005","00","030","0019","0136","307","174","133","2","309","1112","0","27.79","15.65"
"10","005","00","030","0020","0000","337","119","218","3","340","1078","0","31.54","11.04"
"10","005","00","030","0020","0137","337","119","218","3","340","1078","0","31.54","11.04"
"10","005","00","030","0021","0000","222","94","128","1","223","709","0","31.45","13.26"
"10","005","00","030","0021","0138","222","94","128","1","223","709","0","31.45","13.26"
"10","005","00","030","0022","0000","427","226","201","3","430","1405","0","30.60","16.09"
"10","005","00","030","0022","0139","225","117","108","2","227","607","0","37.40","19.28"
"10","005","00","030","0022","0140","202","109","93","1","203","798","0","25.44","13.66"
"10","005","00","030","0023","0000","229","112","117","2","231","709","0","32.58","15.80"
"10","005","00","030","0023","0141","229","112","117","2","231","709","0","32.58","15.80"
"10","005","00","030","0024","0000","674","307","367","11","685","2009","0","34.10","15.28"
"10","005","00","030","0024","0113","355","169","186","2","357","1023","0","34.90","16.52"
"10","005","00","030","0024","0114","319","138","181","9","328","986","0","33.27","14.00"
"10","005","00","040","0000","0000","26339","15002","11337","242","26581","70266","87307","37.83","21.35"
"10","005","00","040","0001","0000","811","482","329","4","815","1893","0","43.05","25.46"
"10","005","00","040","0001","0142","430","255","175","1","431","987","0","43.67","25.84"
"10","005","00","040","0001","0143","381","227","154","3","384","906","0","42.38","25.06"
"10","005","00","040","0002","0000","1436","780","656","18","1454","3293","0","44.15","23.69"
"10","005","00","040","0002","0144","413","228","185","4","417","998","0","41.78","22.85"
"10","005","00","040","0002","0145","584","353","231","8","592","1310","0","45.19","26.95"
"10","005","00","040","0002","0146","439","199","240","6","445","985","0","45.18","20.20"
"10","005","00","040","0003","0000","968","503","465","5","973","2715","0","35.84","18.53"
"10","005","00","040","0003","0147","538","280","258","2","540","1453","0","37.16","19.27"
"10","005","00","040","0003","0148","430","223","207","3","433","1262","0","34.31","17.67"
"10","005","00","040","0004","0000","2005","1166","839","16","2021","4759","0","42.47","24.50"
"10","005","00","040","0004","0149","471","281","190","4","475","1184","0","40.12","23.73"
"10","005","00","040","0004","0150","478","292","186","2","480","1125","0","42.67","25.96"
"10","005","00","040","0004","0151","496","290","206","2","498","1162","0","42.86","24.96"
"10","005","00","040","0004","0152","560","303","257","8","568","1288","0","44.10","23.52"
"10","005","00","040","0005","0000","2099","1317","782","24","2123","5205","0","40.79","25.30"
"10","005","00","040","0005","0153","523","305","218","3","526","1227","0","42.87","24.86"
"10","005","00","040","0005","0154","467","291","176","4","471","1235","0","38.14","23.56"
"10","005","00","040","0005","0155","318","211","107","6","324","667","0","48.58","31.63"
"10","005","00","040","0005","0156","439","271","168","6","445","1123","0","39.63","24.13"
"10","005","00","040","0005","0157","352","239","113","5","357","953","0","37.46","25.08"
"10","005","00","040","0006","0000","1328","695","633","12","1340","3484","0","38.46","19.95"
"10","005","00","040","0006","0158","389","189","200","3","392","1039","0","37.73","18.19"
"10","005","00","040","0006","0159","470","250","220","5","475","1134","0","41.89","22.05"
"10","005","00","040","0006","0160","469","256","213","4","473","1311","0","36.08","19.53"
"10","005","00","040","0007","0000","1363","808","555","12","1375","3366","0","40.85","24.00"
"10","005","00","040","0007","0161","471","270","201","3","474","1179","0","40.20","22.90"
"10","005","00","040","0007","0162","412","262","150","4","416","1066","0","39.02","24.58"
"10","005","00","040","0007","0163","480","276","204","5","485","1121","0","43.26","24.62"
"10","005","00","040","0008","0000","1049","584","465","7","1056","3259","0","32.40","17.92"
"10","005","00","040","0008","0164","409","253","156","3","412","1246","0","33.07","20.30"
"10","005","00","040","0008","0165","301","161","140","2","303","956","0","31.69","16.84"
"10","005","00","040","0008","0166","339","170","169","2","341","1057","0","32.26","16.08"
"10","005","00","040","0009","0000","753","423","330","3","756","2041","0","37.04","20.73"
"10","005","00","040","0009","0171","367","205","162","0","367","1040","0","35.29","19.71"
"10","005","00","040","0009","0172","386","218","168","3","389","1001","0","38.86","21.78"
"10","005","00","040","0010","0000","1657","1019","638","16","1673","4916","0","34.03","20.73"
"10","005","00","040","0010","0173","379","227","152","4","383","1238","0","30.94","18.34"
"10","005","00","040","0010","0174","429","266","163","8","437","1034","0","42.26","25.73"
"10","005","00","040","0010","0175","405","258","147","1","406","1376","0","29.51","18.75"
"10","005","00","040","0010","0176","444","268","176","3","447","1268","0","35.25","21.14"
"10","005","00","040","0011","0000","404","233","171","4","408","1080","0","37.78","21.57"
"10","005","00","040","0011","0180","404","233","171","4","408","1080","0","37.78","21.57"
"10","005","00","040","0012","0000","1161","653","508","5","1166","2759","0","42.26","23.67"
"10","005","00","040","0012","0181","333","168","165","0","333","817","0","40.76","20.56"
"10","005","00","040","0012","0182","295","188","107","3","298","795","0","37.48","23.65"
"10","005","00","040","0012","0183","533","297","236","2","535","1147","0","46.64","25.89"
"10","005","00","040","0013","0000","538","314","224","1","539","1520","0","35.46","20.66"
"10","005","00","040","0013","0184","294","166","128","1","295","820","0","35.98","20.24"
"10","005","00","040","0013","0185","244","148","96","0","244","700","0","34.86","21.14"
"10","005","00","040","0014","0000","720","423","297","5","725","1941","0","37.35","21.79"
"10","005","00","040","0014","0186","377","224","153","0","377","973","0","38.75","23.02"
"10","005","00","040","0014","0187","343","199","144","5","348","968","0","35.95","20.56"
"10","005","00","040","0015","0000","437","241","196","4","441","1207","0","36.54","19.97"
"10","005","00","040","0015","0188","437","241","196","4","441","1207","0","36.54","19.97"
"10","005","00","040","0016","0000","1356","772","584","5","1361","4107","0","33.14","18.80"
"10","005","00","040","0016","0189","502","280","222","0","502","1463","0","34.31","19.14"
"10","005","00","040","0016","0190","443","251","192","2","445","1404","0","31.70","17.88"
"10","005","00","040","0016","0191","411","241","170","3","414","1240","0","33.39","19.44"
"10","005","00","040","0017","0000","826","438","388","8","834","2198","0","37.94","19.93"
"10","005","00","040","0017","0192","309","178","131","3","312","892","0","34.98","19.96"
"10","005","00","040","0017","0193","310","165","145","2","312","767","0","40.68","21.51"
"10","005","00","040","0017","0194","207","95","112","3","210","539","0","38.96","17.63"
"10","005","00","040","0018","0000","375","245","130","6","381","1138","0","33.48","21.53"
"10","005","00","040","0018","0195","375","245","130","6","381","1138","0","33.48","21.53"
"10","005","00","040","0019","0000","1554","870","684","16","1570","4771","0","32.91","18.24"
"10","005","00","040","0019","0196","701","417","284","7","708","2138","0","33.12","19.50"
"10","005","00","040","0019","0197","468","262","206","4","472","1483","0","31.83","17.67"
"10","005","00","040","0019","0198","385","191","194","5","390","1150","0","33.91","16.61"
"10","005","00","040","0020","0000","794","403","391","16","810","2066","0","39.21","19.51"
"10","005","00","040","0020","0199","414","193","221","10","424","1091","0","38.86","17.69"
"10","005","00","040","0020","0200","380","210","170","6","386","975","0","39.59","21.54"
"10","005","00","040","0021","0000","1401","797","604","16","1417","3817","0","37.12","20.88"
"10","005","00","040","0021","0201","211","125","86","3","214","529","0","40.45","23.63"
"10","005","00","040","0021","0202","389","243","146","6","395","1074","0","36.78","22.63"
"10","005","00","040","0021","0203","328","144","184","2","330","845","0","39.05","17.04"
"10","005","00","040","0021","0204","473","285","188","5","478","1369","0","34.92","20.82"
"10","005","00","040","0022","0000","364","193","171","5","369","1009","0","36.57","19.13"
"10","005","00","040","0022","0205","364","193","171","5","369","1009","0","36.57","19.13"
"10","005","00","040","0023","0000","1191","634","557","20","1211","3241","0","37.37","19.56"
"10","005","00","040","0023","0177","442","240","202","5","447","1141","0","39.18","21.03"
"10","005","00","040","0023","0178","393","211","182","8","401","1104","0","36.32","19.11"
"10","005","00","040","0023","0179","356","183","173","7","363","996","0","36.45","18.37"
"10","005","00","040","0024","0000","841","532","309","4","845","2154","0","39.23","24.70"
"10","005","00","040","0024","0169","495","321","174","1","496","1297","0","38.24","24.75"
"10","005","00","040","0024","0170","346","211","135","3","349","857","0","40.72","24.62"
"10","005","00","040","0025","0000","908","477","431","10","918","2327","0","39.45","20.50"
"10","005","00","040","0025","0167","461","250","211","3","464","1178","0","39.39","21.22"
"10","005","00","040","0025","0168","447","227","220","7","454","1149","0","39.51","19.76"
"10","005","00","050","0000","0000","31916","21650","10266","247","32163","85736","104902","37.51","25.25"
"10","005","00","050","0001","0000","710","480","230","7","717","2182","0","32.86","22.00"
"10","005","00","050","0001","0206","361","227","134","2","363","1109","0","32.73","20.47"
"10","005","00","050","0001","0207","349","253","96","5","354","1073","0","32.99","23.58"
"10","005","00","050","0002","0000","621","424","197","3","624","1710","0","36.49","24.80"
"10","005","00","050","0002","0208","317","238","79","2","319","886","0","36.00","26.86"
"10","005","00","050","0002","0209","304","186","118","1","305","824","0","37.01","22.57"
"10","005","00","050","0003","0000","1084","778","306","9","1093","2890","0","37.82","26.92"
"10","005","00","050","0003","0210","397","294","103","3","400","1058","0","37.81","27.79"
"10","005","00","050","0003","0211","368","272","96","2","370","934","0","39.61","29.12"
"10","005","00","050","0003","0212","319","212","107","4","323","898","0","35.97","23.61"
"10","005","00","050","0004","0000","1419","1041","378","8","1427","3743","0","38.12","27.81"
"10","005","00","050","0004","0213","477","339","138","3","480","1160","0","41.38","29.22"
"10","005","00","050","0004","0214","338","253","85","1","339","1030","0","32.91","24.56"
"10","005","00","050","0004","0215","604","449","155","4","608","1553","0","39.15","28.91"
"10","005","00","050","0005","0000","1629","1112","517","14","1643","4464","0","36.81","24.91"
"10","005","00","050","0005","0216","333","235","98","6","339","915","0","37.05","25.68"
"10","005","00","050","0005","0217","390","249","141","1","391","1209","0","32.34","20.60"
"10","005","00","050","0005","0218","537","384","153","6","543","1474","0","36.84","26.05"
"10","005","00","050","0005","0219","369","244","125","1","370","866","0","42.73","28.18"
"10","005","00","050","0006","0000","918","667","251","10","928","2565","0","36.18","26.00"
"10","005","00","050","0006","0220","548","405","143","2","550","1360","0","40.44","29.78"
"10","005","00","050","0006","0221","370","262","108","8","378","1205","0","31.37","21.74"
"10","005","00","050","0007","0000","370","230","140","3","373","1018","0","36.64","22.59"
"10","005","00","050","0007","0222","370","230","140","3","373","1018","0","36.64","22.59"
"10","005","00","050","0008","0000","1179","811","368","12","1191","3264","0","36.49","24.85"
"10","005","00","050","0008","0223","358","233","125","1","359","1061","0","33.84","21.96"
"10","005","00","050","0008","0224","415","321","94","7","422","1049","0","40.23","30.60"
"10","005","00","050","0008","0225","406","257","149","4","410","1154","0","35.53","22.27"
"10","005","00","050","0009","0000","1289","928","361","12","1301","3066","0","42.43","30.27"
"10","005","00","050","0009","0226","471","347","124","7","478","1018","0","46.95","34.09"
"10","005","00","050","0009","0227","423","299","124","2","425","1043","0","40.75","28.67"
"10","005","00","050","0009","0228","395","282","113","3","398","1005","0","39.60","28.06"
"10","005","00","050","0010","0000","577","375","202","3","580","1574","0","36.85","23.82"
"10","005","00","050","0010","0232","267","170","97","1","268","773","0","34.67","21.99"
"10","005","00","050","0010","0233","310","205","105","2","312","801","0","38.95","25.59"
"10","005","00","050","0011","0000","335","224","111","6","341","977","0","34.90","22.93"
"10","005","00","050","0011","0231","335","224","111","6","341","977","0","34.90","22.93"
"10","005","00","050","0012","0000","488","305","183","5","493","1036","0","47.59","29.44"
"10","005","00","050","0012","0238","488","305","183","5","493","1036","0","47.59","29.44"
"10","005","00","050","0013","0000","791","575","216","9","800","2007","0","39.86","28.65"
"10","005","00","050","0013","0261","394","295","99","4","398","998","0","39.88","29.56"
"10","005","00","050","0013","0262","397","280","117","5","402","1009","0","39.84","27.75"
"10","005","00","050","0014","0000","1542","1044","498","6","1548","4392","0","35.25","23.77"
"10","005","00","050","0014","0265","545","384","161","3","548","1497","0","36.61","25.65"
"10","005","00","050","0014","0266","490","348","142","3","493","1434","0","34.38","24.27"
"10","005","00","050","0014","0267","507","312","195","0","507","1461","0","34.70","21.36"
"10","005","00","050","0015","0000","1722","1092","630","10","1732","4339","0","39.92","25.17"
"10","005","00","050","0015","0242","566","354","212","4","570","1356","0","42.04","26.11"
"10","005","00","050","0015","0243","569","383","186","2","571","1486","0","38.43","25.77"
"10","005","00","050","0015","0244","587","355","232","4","591","1497","0","39.48","23.71"
"10","005","00","050","0016","0000","1539","1032","507","13","1552","4022","0","38.59","25.66"
"10","005","00","050","0016","0239","558","375","183","4","562","1294","0","43.43","28.98"
"10","005","00","050","0016","0240","505","328","177","4","509","1424","0","35.74","23.03"
"10","005","00","050","0016","0241","476","329","147","5","481","1304","0","36.89","25.23"
"10","005","00","050","0017","0000","1179","796","383","8","1187","3306","0","35.90","24.08"
"10","005","00","050","0017","0252","435","279","156","3","438","1129","0","38.80","24.71"
"10","005","00","050","0017","0253","414","299","115","2","416","1152","0","36.11","25.95"
"10","005","00","050","0017","0254","330","218","112","3","333","1025","0","32.49","21.27"
"10","005","00","050","0018","0000","1413","942","471","5","1418","3987","0","35.57","23.63"
"10","005","00","050","0018","0268","449","317","132","2","451","1266","0","35.62","25.04"
"10","005","00","050","0018","0269","482","308","174","2","484","1341","0","36.09","22.97"
"10","005","00","050","0018","0270","482","317","165","1","483","1380","0","35.00","22.97"
"10","005","00","050","0019","0000","503","287","216","4","507","1289","0","39.33","22.27"
"10","005","00","050","0019","0273","503","287","216","4","507","1289","0","39.33","22.27"
"10","005","00","050","0020","0000","646","421","225","8","654","2144","0","30.50","19.64"
"10","005","00","050","0020","0234","355","237","118","5","360","938","0","38.38","25.27"
"10","005","00","050","0020","0235","291","184","107","3","294","1206","0","24.38","15.26"
"10","005","00","050","0021","0000","886","596","290","9","895","2511","0","35.64","23.74"
"10","005","00","050","0021","0236","405","271","134","8","413","1185","0","34.85","22.87"
"10","005","00","050","0021","0237","481","325","156","1","482","1326","0","36.35","24.51"
"10","005","00","050","0022","0000","521","363","158","6","527","1295","0","40.69","28.03"
"10","005","00","050","0022","0274","521","363","158","6","527","1295","0","40.69","28.03"
"10","005","00","050","0023","0000","918","646","272","4","922","2511","0","36.72","25.73"
"10","005","00","050","0023","0276","475","348","127","1","476","1278","0","37.25","27.23"
"10","005","00","050","0023","0277","443","298","145","3","446","1233","0","36.17","24.17"
"10","005","00","050","0024","0000","367","258","109","5","372","878","0","42.37","29.38"
"10","005","00","050","0024","0275","367","258","109","5","372","878","0","42.37","29.38"
"10","005","00","050","0025","0000","825","591","234","12","837","2216","0","37.77","26.67"
"10","005","00","050","0025","0278","399","292","107","6","405","1068","0","37.92","27.34"
"10","005","00","050","0025","0279","426","299","127","6","432","1148","0","37.63","26.05"
"10","005","00","050","0026","0000","863","529","334","4","867","2277","0","38.08","23.23"
"10","005","00","050","0026","0263","447","283","164","0","447","1137","0","39.31","24.89"
"10","005","00","050","0026","0264","416","246","170","4","420","1140","0","36.84","21.58"
"10","005","00","050","0027","0000","824","552","272","9","833","2362","0","35.27","23.37"
"10","005","00","050","0027","0271","394","277","117","6","400","1222","0","32.73","22.67"
"10","005","00","050","0027","0272","430","275","155","3","433","1140","0","37.98","24.12"
"10","005","00","050","0028","0000","1382","931","451","9","1391","3387","0","41.07","27.49"
"10","005","00","050","0028","0255","489","324","165","0","489","1261","0","38.78","25.69"
"10","005","00","050","0028","0256","458","310","148","1","459","1115","0","41.17","27.80"
"10","005","00","050","0028","0257","435","297","138","8","443","1011","0","43.82","29.38"
"10","005","00","050","0029","0000","1317","956","361","13","1330","3570","0","37.25","26.78"
"10","005","00","050","0029","0258","449","336","113","4","453","1144","0","39.60","29.37"
"10","005","00","050","0029","0259","466","324","142","3","469","1278","0","36.70","25.35"
"10","005","00","050","0029","0260","402","296","106","6","408","1148","0","35.54","25.78"
"10","005","00","050","0030","0000","782","516","266","2","784","1951","0","40.18","26.45"
"10","005","00","050","0030","0229","413","265","148","0","413","948","0","43.57","27.95"
"10","005","00","050","0030","0230","369","251","118","2","371","1003","0","36.99","25.02"
"10","005","00","050","0031","0000","921","625","296","5","926","2514","0","36.83","24.86"
"10","005","00","050","0031","0245","419","291","128","3","422","1206","0","34.99","24.13"
"10","005","00","050","0031","0246","502","334","168","2","504","1308","0","38.53","25.54"
"10","005","00","050","0032","0000","1343","839","504","11","1354","3515","0","38.52","23.87"
"10","005","00","050","0032","0247","400","262","138","2","402","1115","0","36.05","23.50"
"10","005","00","050","0032","0248","472","275","197","5","477","1131","0","42.18","24.31"
"10","005","00","050","0032","0249","471","302","169","4","475","1269","0","37.43","23.80"
"10","005","00","050","0033","0000","1013","684","329","3","1016","2774","0","36.63","24.66"
"10","005","00","050","0033","0250","527","383","144","2","529","1400","0","37.79","27.36"
"10","005","00","050","0033","0251","486","301","185","1","487","1374","0","35.44","21.91"
"10","005","00","060","0000","0000","10179","5474","4705","132","10311","30244","34941","34.09","18.10"
"10","005","00","060","0001","0000","461","248","213","5","466","1399","0","33.31","17.73"
"10","005","00","060","0001","0280","177","101","76","1","178","573","0","31.06","17.63"
"10","005","00","060","0001","0281","284","147","137","4","288","826","0","34.87","17.80"
"10","005","00","060","0002","0000","314","163","151","4","318","731","0","43.50","22.30"
"10","005","00","060","0002","0282","314","163","151","4","318","731","0","43.50","22.30"
"10","005","00","060","0003","0000","499","242","257","5","504","1248","0","40.38","19.39"
"10","005","00","060","0003","0283","247","106","141","4","251","623","0","40.29","17.01"
"10","005","00","060","0003","0284","252","136","116","1","253","625","0","40.48","21.76"
"10","005","00","060","0004","0000","1474","828","646","8","1482","4216","0","35.15","19.64"
"10","005","00","060","0004","0285","383","219","164","1","384","1108","0","34.66","19.77"
"10","005","00","060","0004","0286","431","233","198","4","435","1258","0","34.58","18.52"
"10","005","00","060","0004","0287","350","192","158","3","353","983","0","35.91","19.53"
"10","005","00","060","0004","0288","310","184","126","0","310","867","0","35.76","21.22"
"10","005","00","060","0005","0000","690","399","291","11","701","2258","0","31.05","17.67"
"10","005","00","060","0005","0303","329","195","134","4","333","1062","0","31.36","18.36"
"10","005","00","060","0005","0304","361","204","157","7","368","1196","0","30.77","17.06"
"10","005","00","060","0006","0000","510","351","159","6","516","1219","0","42.33","28.79"
"10","005","00","060","0006","0293","510","351","159","6","516","1219","0","42.33","28.79"
"10","005","00","060","0007","0000","394","261","133","4","398","1026","0","38.79","25.44"
"10","005","00","060","0007","0294","394","261","133","4","398","1026","0","38.79","25.44"
"10","005","00","060","0008","0000","844","470","374","17","861","2669","0","32.26","17.61"
"10","005","00","060","0008","0295","296","162","134","5","301","936","0","32.16","17.31"
"10","005","00","060","0008","0296","305","160","145","6","311","899","0","34.59","17.80"
"10","005","00","060","0008","0297","243","148","95","6","249","834","0","29.86","17.75"
"10","005","00","060","0009","0000","493","289","204","3","496","1304","0","38.04","22.16"
"10","005","00","060","0009","0298","265","154","111","1","266","685","0","38.83","22.48"
"10","005","00","060","0009","0299","228","135","93","2","230","619","0","37.16","21.81"
"10","005","00","060","0010","0000","239","119","120","4","243","679","0","35.79","17.53"
"10","005","00","060","0010","0300","239","119","120","4","243","679","0","35.79","17.53"
"10","005","00","060","0011","0000","445","220","225","4","449","1462","0","30.71","15.05"
"10","005","00","060","0011","0289","197","92","105","3","200","649","0","30.82","14.18"
"10","005","00","060","0011","0290","248","128","120","1","249","813","0","30.63","15.74"
"10","005","00","060","0012","0000","495","240","255","5","500","1503","0","33.27","15.97"
"10","005","00","060","0012","0301","246","119","127","2","248","723","0","34.30","16.46"
"10","005","00","060","0012","0302","249","121","128","3","252","780","0","32.31","15.51"
"10","005","00","060","0013","0000","375","169","206","13","388","1231","0","31.52","13.73"
"10","005","00","060","0013","0291","375","169","206","13","388","1231","0","31.52","13.73"
"10","005","00","060","0014","0000","308","145","163","3","311","957","0","32.50","15.15"
"10","005","00","060","0014","0292","308","145","163","3","311","957","0","32.50","15.15"
"10","005","00","060","0015","0000","301","183","118","4","305","982","0","31.06","18.64"
"10","005","00","060","0015","0305","301","183","118","4","305","982","0","31.06","18.64"
"10","005","00","060","0016","0000","268","128","140","6","274","897","0","30.55","14.27"
"10","005","00","060","0016","0306","268","128","140","6","274","897","0","30.55","14.27"
"10","005","00","060","0017","0000","240","119","121","3","243","682","0","35.63","17.45"
"10","005","00","060","0017","0307","240","119","121","3","243","682","0","35.63","17.45"
"10","005","00","060","0018","0000","338","166","172","5","343","1023","0","33.53","16.23"
"10","005","00","060","0018","0308","338","166","172","5","343","1023","0","33.53","16.23"
"10","005","00","060","0019","0000","207","106","101","6","213","591","0","36.04","17.94"
"10","005","00","060","0019","0309","207","106","101","6","213","591","0","36.04","17.94"
"10","005","00","060","0020","0000","411","181","230","2","413","1251","0","33.01","14.47"
"10","005","00","060","0020","0310","411","181","230","2","413","1251","0","33.01","14.47"
"10","005","00","060","0021","0000","214","111","103","2","216","718","0","30.08","15.46"
"10","005","00","060","0021","0311","214","111","103","2","216","718","0","30.08","15.46"
"10","005","00","060","0022","0000","301","163","138","9","310","1010","0","30.69","16.14"
"10","005","00","060","0022","0312","115","57","58","4","119","405","0","29.38","14.07"
"10","005","00","060","0022","0313","186","106","80","5","191","605","0","31.57","17.52"
"10","005","00","060","0023","0000","358","173","185","3","361","1188","0","30.39","14.56"
"10","005","00","060","0023","0314","219","120","99","3","222","720","0","30.83","16.67"
"10","005","00","060","0023","0315","139","53","86","0","139","468","0","29.70","11.32"
"10","005","00","070","0000","0000","5309","2722","2587","46","5355","14189","16007","37.74","19.18"
"10","005","00","070","0001","0000","317","165","152","1","318","698","0","45.56","23.64"
"10","005","00","070","0001","0319","317","165","152","1","318","698","0","45.56","23.64"
"10","005","00","070","0002","0000","598","323","275","8","606","1479","0","40.97","21.84"
"10","005","00","070","0002","0320","310","173","137","3","313","765","0","40.92","22.61"
"10","005","00","070","0002","0321","288","150","138","5","293","714","0","41.04","21.01"
"10","005","00","070","0003","0000","757","357","400","4","761","1991","0","38.22","17.93"
"10","005","00","070","0003","0325","297","137","160","2","299","842","0","35.51","16.27"
"10","005","00","070","0003","0326","299","127","172","1","300","787","0","38.12","16.14"
"10","005","00","070","0003","0327","161","93","68","1","162","362","0","44.75","25.69"
"10","005","00","070","0004","0000","351","166","185","6","357","937","0","38.10","17.72"
"10","005","00","070","0004","0322","351","166","185","6","357","937","0","38.10","17.72"
"10","005","00","070","0005","0000","238","134","104","1","239","674","0","35.46","19.88"
"10","005","00","070","0005","0323","238","134","104","1","239","674","0","35.46","19.88"
"10","005","00","070","0006","0000","271","162","109","4","275","923","0","29.79","17.55"
"10","005","00","070","0006","0333","271","162","109","4","275","923","0","29.79","17.55"
"10","005","00","070","0007","0000","745","374","371","5","750","1876","0","39.98","19.94"
"10","005","00","070","0007","0316","374","188","186","3","377","895","0","42.12","21.01"
"10","005","00","070","0007","0317","371","186","185","2","373","981","0","38.02","18.96"
"10","005","00","070","0008","0000","422","195","227","7","429","1056","0","40.63","18.47"
"10","005","00","070","0008","0318","422","195","227","7","429","1056","0","40.63","18.47"
"10","005","00","070","0009","0000","744","365","379","0","744","2071","0","35.92","17.62"
"10","005","00","070","0009","0328","238","108","130","0","238","640","0","37.19","16.88"
"10","005","00","070","0009","0329","257","113","144","0","257","746","0","34.45","15.15"
"10","005","00","070","0009","0330","249","144","105","0","249","685","0","36.35","21.02"
"10","005","00","070","0010","0000","266","127","139","4","270","702","0","38.46","18.09"
"10","005","00","070","0010","0324","266","127","139","4","270","702","0","38.46","18.09"
"10","005","00","070","0011","0000","346","194","152","3","349","1067","0","32.71","18.18"
"10","005","00","070","0011","0331","346","194","152","3","349","1067","0","32.71","18.18"
"10","005","00","070","0012","0000","254","160","94","3","257","715","0","35.94","22.38"
"10","005","00","070","0012","0332","254","160","94","3","257","715","0","35.94","22.38"
"10","005","00","080","0000","0000","4113","2873","1240","47","4160","12068","13686","34.47","23.81"
"10","005","00","080","0001","0000","635","464","171","3","638","1539","0","41.46","30.15"
"10","005","00","080","0001","0334","308","223","85","1","309","696","0","44.40","32.04"
"10","005","00","080","0001","0335","327","241","86","2","329","843","0","39.03","28.59"
"10","005","00","080","0002","0000","255","203","52","2","257","557","0","46.14","36.45"
"10","005","00","080","0002","0336","255","203","52","2","257","557","0","46.14","36.45"
"10","005","00","080","0003","0000","594","456","138","9","603","1714","0","35.18","26.60"
"10","005","00","080","0003","0338","261","207","54","6","267","840","0","31.79","24.64"
"10","005","00","080","0003","0339","333","249","84","3","336","874","0","38.44","28.49"
"10","005","00","080","0004","0000","389","243","146","7","396","1323","0","29.93","18.37"
"10","005","00","080","0004","0340","389","243","146","7","396","1323","0","29.93","18.37"
"10","005","00","080","0005","0000","171","131","40","4","175","529","0","33.08","24.76"
"10","005","00","080","0005","0341","171","131","40","4","175","529","0","33.08","24.76"
"10","005","00","080","0006","0000","424","299","125","3","427","1155","0","36.97","25.89"
"10","005","00","080","0006","0337","424","299","125","3","427","1155","0","36.97","25.89"
"10","005","00","080","0007","0000","219","143","76","3","222","599","0","37.06","23.87"
"10","005","00","080","0007","0342","219","143","76","3","222","599","0","37.06","23.87"
"10","005","00","080","0008","0000","430","277","153","6","436","1448","0","30.11","19.13"
"10","005","00","080","0008","0345","186","107","79","0","186","621","0","29.95","17.23"
"10","005","00","080","0008","0346","244","170","74","6","250","827","0","30.23","20.56"
"10","005","00","080","0009","0000","233","161","72","4","237","739","0","32.07","21.79"
"10","005","00","080","0009","0343","233","161","72","4","237","739","0","32.07","21.79"
"10","005","00","080","0010","0000","183","135","48","1","184","484","0","38.02","27.89"
"10","005","00","080","0010","0344","183","135","48","1","184","484","0","38.02","27.89"
"10","005","00","080","0011","0000","280","187","93","2","282","988","0","28.54","18.93"
"10","005","00","080","0011","0347","280","187","93","2","282","988","0","28.54","18.93"
"10","005","00","080","0012","0000","300","174","126","3","303","993","0","30.51","17.52"
"10","005","00","080","0012","0348","300","174","126","3","303","993","0","30.51","17.52"
"10","005","00","090","0000","0000","10622","7099","3523","102","10724","27661","32119","38.77","25.66"
"10","005","00","090","0001","0000","646","399","247","2","648","1507","0","43.00","26.48"
"10","005","00","090","0001","0349","338","202","136","1","339","751","0","45.14","26.90"
"10","005","00","090","0001","0350","308","197","111","1","309","756","0","40.87","26.06"
"10","005","00","090","0002","0000","934","662","272","5","939","2286","0","41.08","28.96"
"10","005","00","090","0002","0351","427","312","115","3","430","1064","0","40.41","29.32"
"10","005","00","090","0002","0352","507","350","157","2","509","1222","0","41.65","28.64"
"10","005","00","090","0003","0000","1259","862","397","15","1274","3412","0","37.34","25.26"
"10","005","00","090","0003","0353","434","310","124","6","440","1142","0","38.53","27.15"
"10","005","00","090","0003","0354","420","275","145","5","425","1176","0","36.14","23.38"
"10","005","00","090","0003","0355","405","277","128","4","409","1094","0","37.39","25.32"
"10","005","00","090","0004","0000","348","211","137","6","354","921","0","38.44","22.91"
"10","005","00","090","0004","0360","348","211","137","6","354","921","0","38.44","22.91"
"10","005","00","090","0005","0000","762","500","262","13","775","2259","0","34.31","22.13"
"10","005","00","090","0005","0356","416","291","125","8","424","1175","0","36.09","24.77"
"10","005","00","090","0005","0357","346","209","137","5","351","1084","0","32.38","19.28"
"10","005","00","090","0006","0000","924","605","319","3","927","2296","0","40.37","26.35"
"10","005","00","090","0006","0358","508","334","174","3","511","1248","0","40.95","26.76"
"10","005","00","090","0006","0359","416","271","145","0","416","1048","0","39.69","25.86"
"10","005","00","090","0007","0000","523","373","150","1","524","1448","0","36.19","25.76"
"10","005","00","090","0007","0365","273","192","81","0","273","684","0","39.91","28.07"
"10","005","00","090","0007","0366","250","181","69","1","251","764","0","32.85","23.69"
"10","005","00","090","0008","0000","394","286","108","3","397","995","0","39.90","28.74"
"10","005","00","090","0008","0361","394","286","108","3","397","995","0","39.90","28.74"
"10","005","00","090","0009","0000","781","527","254","16","797","2019","0","39.47","26.10"
"10","005","00","090","0009","0363","322","222","100","7","329","820","0","40.12","27.07"
"10","005","00","090","0009","0364","459","305","154","9","468","1199","0","39.03","25.44"
"10","005","00","090","0010","0000","105","78","27","1","106","280","0","37.86","27.86"
"10","005","00","090","0010","0367","105","78","27","1","106","280","0","37.86","27.86"
"10","005","00","090","0011","0000","161","88","73","1","162","339","0","47.79","25.96"
"10","005","00","090","0011","0362","161","88","73","1","162","339","0","47.79","25.96"
"10","005","00","090","0012","0000","863","548","315","11","874","2213","0","39.49","24.76"
"10","005","00","090","0012","0368","511","330","181","7","518","1304","0","39.72","25.31"
"10","005","00","090","0012","0369","352","218","134","4","356","909","0","39.16","23.98"
"10","005","00","090","0013","0000","531","363","168","9","540","1453","0","37.16","24.98"
"10","005","00","090","0013","0370","302","212","90","6","308","731","0","42.13","29.00"
"10","005","00","090","0013","0371","229","151","78","3","232","722","0","32.13","20.91"
"10","005","00","090","0014","0000","647","453","194","3","650","1579","0","41.17","28.69"
"10","005","00","090","0014","0372","337","237","100","2","339","871","0","38.92","27.21"
"10","005","00","090","0014","0373","310","216","94","1","311","708","0","43.93","30.51"
"10","005","00","090","0015","0000","534","344","190","6","540","1427","0","37.84","24.11"
"10","005","00","090","0015","0374","222","142","80","3","225","678","0","33.19","20.94"
"10","005","00","090","0015","0375","312","202","110","3","315","749","0","42.06","26.97"
"10","005","00","090","0016","0000","481","325","156","1","482","1270","0","37.95","25.59"
"10","005","00","090","0016","0378","481","325","156","1","482","1270","0","37.95","25.59"
"10","005","00","090","0017","0000","539","336","203","3","542","1415","0","38.30","23.75"
"10","005","00","090","0017","0376","273","166","107","2","275","705","0","39.01","23.55"
"10","005","00","090","0017","0377","266","170","96","1","267","710","0","37.61","23.94"
"10","005","00","090","0018","0000","87","72","15","2","89","213","0","41.78","33.80"
"10","005","00","090","0018","0379","87","72","15","2","89","213","0","41.78","33.80"
"10","005","00","090","0019","0000","103","67","36","1","104","329","0","31.61","20.36"
"10","005","00","090","0019","0380","103","67","36","1","104","329","0","31.61","20.36"
"10","005","00","100","0000","0000","5629","3954","1675","54","5683","14892","17039","38.16","26.55"
"10","005","00","100","0001","0000","407","364","43","5","412","940","0","43.83","38.72"
"10","005","00","100","0001","0387","407","364","43","5","412","940","0","43.83","38.72"
"10","005","00","100","0002","0000","1726","1198","528","12","1738","4334","0","40.10","27.64"
"10","005","00","100","0002","0381","384","270","114","5","389","850","0","45.76","31.76"
"10","005","00","100","0002","0382","453","296","157","1","454","1006","0","45.13","29.42"
"10","005","00","100","0002","0383","489","358","131","1","490","1293","0","37.90","27.69"
"10","005","00","100","0002","0384","400","274","126","5","405","1185","0","34.18","23.12"
"10","005","00","100","0003","0000","681","487","194","5","686","1617","0","42.42","30.12"
"10","005","00","100","0003","0388","379","286","93","3","382","909","0","42.02","31.46"
"10","005","00","100","0003","0389","302","201","101","2","304","708","0","42.94","28.39"
"10","005","00","100","0004","0000","406","276","130","7","413","1247","0","33.12","22.13"
"10","005","00","100","0004","0385","406","276","130","7","413","1247","0","33.12","22.13"
"10","005","00","100","0005","0000","416","296","120","6","422","1142","0","36.95","25.92"
"10","005","00","100","0005","0386","416","296","120","6","422","1142","0","36.95","25.92"
"10","005","00","100","0006","0000","330","241","89","1","331","1021","0","32.42","23.60"
"10","005","00","100","0006","0390","330","241","89","1","331","1021","0","32.42","23.60"
"10","005","00","100","0007","0000","1104","722","382","11","1115","3115","0","35.79","23.18"
"10","005","00","100","0007","0391","419","267","152","6","425","1070","0","39.72","24.95"
"10","005","00","100","0007","0392","279","182","97","1","280","830","0","33.73","21.93"
"10","005","00","100","0007","0393","406","273","133","4","410","1215","0","33.74","22.47"
"10","005","00","100","0008","0000","188","120","68","3","191","540","0","35.37","22.22"
"10","005","00","100","0008","0394","188","120","68","3","191","540","0","35.37","22.22"
"10","005","00","100","0009","0000","143","96","47","2","145","411","0","35.28","23.36"
"10","005","00","100","0009","0395","143","96","47","2","145","411","0","35.28","23.36"
"10","005","00","100","0010","0000","228","154","74","2","230","525","0","43.81","29.33"
"10","005","00","100","0010","0396","228","154","74","2","230","525","0","43.81","29.33"
"10","005","00","110","0000","0000","2854","2091","763","34","2888","8353","9430","34.57","25.03"
"10","005","00","110","0001","0000","417","307","110","4","421","1102","0","38.20","27.86"
"10","005","00","110","0001","0397","417","307","110","4","421","1102","0","38.20","27.86"
"10","005","00","110","0002","0000","222","156","66","3","225","609","0","36.95","25.62"
"10","005","00","110","0002","0398","222","156","66","3","225","609","0","36.95","25.62"
"10","005","00","110","0003","0000","369","281","88","5","374","1283","0","29.15","21.90"
"10","005","00","110","0003","0399","369","281","88","5","374","1283","0","29.15","21.90"
"10","005","00","110","0004","0000","274","183","91","3","277","793","0","34.93","23.08"
"10","005","00","110","0004","0400","274","183","91","3","277","793","0","34.93","23.08"
"10","005","00","110","0005","0000","264","181","83","4","268","793","0","33.80","22.82"
"10","005","00","110","0005","0401","264","181","83","4","268","793","0","33.80","22.82"
"10","005","00","110","0006","0000","468","337","131","4","472","1037","0","45.52","32.50"
"10","005","00","110","0006","0402","468","337","131","4","472","1037","0","45.52","32.50"
"10","005","00","110","0007","0000","383","267","116","2","385","986","0","39.05","27.08"
"10","005","00","110","0007","0403","383","267","116","2","385","986","0","39.05","27.08"
"10","005","00","110","0008","0000","230","190","40","4","234","838","0","27.92","22.67"
"10","005","00","110","0008","0404","230","190","40","4","234","838","0","27.92","22.67"
"10","005","00","110","0009","0000","227","189","38","5","232","912","0","25.44","20.72"
"10","005","00","110","0009","0405","227","189","38","5","232","912","0","25.44","20.72"
"10","005","00","120","0000","0000","3672","2570","1102","37","3709","9023","10112","41.11","28.48"
"10","005","00","120","0001","0000","982","707","275","6","988","2420","0","40.83","29.21"
"10","005","00","120","0001","0406","477","345","132","3","480","1287","0","37.30","26.81"
"10","005","00","120","0001","0407","505","362","143","3","508","1133","0","44.84","31.95"
"10","005","00","120","0002","0000","684","447","237","9","693","1786","0","38.80","25.03"
"10","005","00","120","0002","0413","305","204","101","1","306","817","0","37.45","24.97"
"10","005","00","120","0002","0414","379","243","136","8","387","969","0","39.94","25.08"
"10","005","00","120","0003","0000","243","183","60","3","246","687","0","35.81","26.64"
"10","005","00","120","0003","0410","243","183","60","3","246","687","0","35.81","26.64"
"10","005","00","120","0004","0000","652","469","183","8","660","1635","0","40.37","28.69"
"10","005","00","120","0004","0408","308","222","86","4","312","756","0","41.27","29.37"
"10","005","00","120","0004","0409","344","247","97","4","348","879","0","39.59","28.10"
"10","005","00","120","0005","0000","397","272","125","2","399","848","0","47.05","32.08"
"10","005","00","120","0005","0411","397","272","125","2","399","848","0","47.05","32.08"
"10","005","00","120","0006","0000","162","115","47","3","165","377","0","43.77","30.50"
"10","005","00","120","0006","0412","162","115","47","3","165","377","0","43.77","30.50"
"10","005","00","120","0007","0000","427","298","129","3","430","968","0","44.42","30.79"
"10","005","00","120","0007","0415","330","242","88","2","332","758","0","43.80","31.93"
"10","005","00","120","0007","0416","97","56","41","1","98","210","0","46.67","26.67"
"10","005","00","120","0008","0000","125","79","46","3","128","302","0","42.38","26.16"
"10","005","00","120","0008","0417","125","79","46","3","128","302","0","42.38","26.16"
"10","005","00","130","0000","0000","5287","3562","1725","65","5352","13373","15480","40.02","26.64"
"10","005","00","130","0001","0000","1588","1108","480","18","1606","3909","0","41.08","28.34"
"10","005","00","130","0001","0418","314","235","79","1","315","793","0","39.72","29.63"
"10","005","00","130","0001","0419","400","278","122","4","404","935","0","43.21","29.73"
"10","005","00","130","0001","0420","406","270","136","4","410","1024","0","40.04","26.37"
"10","005","00","130","0001","0421","468","325","143","9","477","1157","0","41.23","28.09"
"10","005","00","130","0002","0000","688","471","217","7","695","1787","0","38.89","26.36"
"10","005","00","130","0002","0427","362","247","115","5","367","979","0","37.49","25.23"
"10","005","00","130","0002","0428","326","224","102","2","328","808","0","40.59","27.72"
"10","005","00","130","0003","0000","485","329","156","5","490","1321","0","37.09","24.91"
"10","005","00","130","0003","0425","269","181","88","2","271","727","0","37.28","24.90"
"10","005","00","130","0003","0426","216","148","68","3","219","594","0","36.87","24.92"
"10","005","00","130","0004","0000","1321","857","464","21","1342","3286","0","40.84","26.08"
"10","005","00","130","0004","0422","357","247","110","12","369","994","0","37.12","24.85"
"10","005","00","130","0004","0423","455","285","170","0","455","1094","0","41.59","26.05"
"10","005","00","130","0004","0424","509","325","184","9","518","1198","0","43.24","27.13"
"10","005","00","130","0005","0000","570","434","136","7","577","1427","0","40.43","30.41"
"10","005","00","130","0005","0429","288","224","64","4","292","684","0","42.69","32.75"
"10","005","00","130","0005","0430","282","210","72","3","285","743","0","38.36","28.26"
"10","005","00","130","0006","0000","170","131","39","0","170","402","0","42.29","32.59"
"10","005","00","130","0006","0431","170","131","39","0","170","402","0","42.29","32.59"
"10","005","00","130","0007","0000","465","232","233","7","472","1241","0","38.03","18.69"
"10","005","00","130","0007","0432","220","116","104","1","221","619","0","35.70","18.74"
"10","005","00","130","0007","0433","245","116","129","6","251","622","0","40.35","18.65"
"10","005","00","140","0000","0000","2107","1548","559","27","2134","6133","6635","34.80","25.24"
"10","005","00","140","0001","0000","229","187","42","5","234","595","0","39.33","31.43"
"10","005","00","140","0001","0434","229","187","42","5","234","595","0","39.33","31.43"
"10","005","00","140","0002","0000","197","156","41","1","198","564","0","35.11","27.66"
"10","005","00","140","0002","0435","197","156","41","1","198","564","0","35.11","27.66"
"10","005","00","140","0003","0000","279","208","71","4","283","790","0","35.82","26.33"
"10","005","00","140","0003","0436","279","208","71","4","283","790","0","35.82","26.33"
"10","005","00","140","0004","0000","205","158","47","2","207","627","0","33.01","25.20"
"10","005","00","140","0004","0437","205","158","47","2","207","627","0","33.01","25.20"
"10","005","00","140","0005","0000","182","137","45","0","182","482","0","37.76","28.42"
"10","005","00","140","0005","0440","182","137","45","0","182","482","0","37.76","28.42"
"10","005","00","140","0006","0000","148","97","51","4","152","446","0","34.08","21.75"
"10","005","00","140","0006","0439","148","97","51","4","152","446","0","34.08","21.75"
"10","005","00","140","0007","0000","315","218","97","3","318","871","0","36.51","25.03"
"10","005","00","140","0007","0438","315","218","97","3","318","871","0","36.51","25.03"
"10","005","00","140","0008","0000","338","239","99","5","343","1112","0","30.85","21.49"
"10","005","00","140","0008","0441","338","239","99","5","343","1112","0","30.85","21.49"
"10","005","00","140","0009","0000","214","148","66","3","217","646","0","33.59","22.91"
"10","005","00","140","0009","0442","214","148","66","3","217","646","0","33.59","22.91"
"10","005","00","150","0000","0000","3907","2557","1350","37","3944","10732","12084","36.75","23.83"
"10","005","00","150","0001","0000","757","535","222","5","762","2010","0","37.91","26.62"
"10","005","00","150","0001","0443","427","297","130","2","429","1135","0","37.80","26.17"
"10","005","00","150","0001","0444","330","238","92","3","333","875","0","38.06","27.20"
"10","005","00","150","0002","0000","174","128","46","2","176","442","0","39.82","28.96"
"10","005","00","150","0002","0445","174","128","46","2","176","442","0","39.82","28.96"
"10","005","00","150","0003","0000","377","258","119","4","381","969","0","39.32","26.63"
"10","005","00","150","0003","0446","377","258","119","4","381","969","0","39.32","26.63"
"10","005","00","150","0004","0000","1200","796","404","12","1212","3315","0","36.56","24.01"
"10","005","00","150","0004","0447","417","252","165","4","421","1163","0","36.20","21.67"
"10","005","00","150","0004","0448","402","295","107","6","408","1043","0","39.12","28.28"
"10","005","00","150","0004","0449","381","249","132","2","383","1109","0","34.54","22.45"
"10","005","00","150","0005","0000","183","125","58","2","185","479","0","38.62","26.10"
"10","005","00","150","0005","0450","183","125","58","2","185","479","0","38.62","26.10"
"10","005","00","150","0006","0000","191","129","62","1","192","485","0","39.59","26.60"
"10","005","00","150","0006","0451","191","129","62","1","192","485","0","39.59","26.60"
"10","005","00","150","0007","0000","436","241","195","4","440","1252","0","35.14","19.25"
"10","005","00","150","0007","0452","436","241","195","4","440","1252","0","35.14","19.25"
"10","005","00","150","0008","0000","290","188","102","3","293","837","0","35.01","22.46"
"10","005","00","150","0008","0453","290","188","102","3","293","837","0","35.01","22.46"
"10","005","00","150","0009","0000","299","157","142","4","303","943","0","32.13","16.65"
"10","005","00","150","0009","0454","299","157","142","4","303","943","0","32.13","16.65"
"10","005","00","160","0000","0000","2131","1483","648","34","2165","5579","6259","38.81","26.58"
"10","005","00","160","0001","0000","769","537","232","6","775","2118","0","36.59","25.35"
"10","005","00","160","0001","0455","388","270","118","3","391","965","0","40.52","27.98"
"10","005","00","160","0001","0456","381","267","114","3","384","1153","0","33.30","23.16"
"10","005","00","160","0002","0000","268","190","78","5","273","613","0","44.54","31.00"
"10","005","00","160","0002","0457","268","190","78","5","273","613","0","44.54","31.00"
"10","005","00","160","0003","0000","318","228","90","7","325","822","0","39.54","27.74"
"10","005","00","160","0003","0458","318","228","90","7","325","822","0","39.54","27.74"
"10","005","00","160","0004","0000","72","47","25","2","74","227","0","32.60","20.70"
"10","005","00","160","0004","0459","72","47","25","2","74","227","0","32.60","20.70"
"10","005","00","160","0005","0000","162","99","63","4","166","517","0","32.11","19.15"
"10","005","00","160","0005","0460","162","99","63","4","166","517","0","32.11","19.15"
"10","005","00","160","0006","0000","201","140","61","3","204","523","0","39.01","26.77"
"10","005","00","160","0006","0461","201","140","61","3","204","523","0","39.01","26.77"
"10","005","00","160","0007","0000","181","117","64","3","184","391","0","47.06","29.92"
"10","005","00","160","0007","0462","181","117","64","3","184","391","0","47.06","29.92"
"10","005","00","160","0008","0000","160","125","35","4","164","368","0","44.57","33.97"
"10","005","00","160","0008","0463","160","125","35","4","164","368","0","44.57","33.97"
"10","005","00","170","0000","0000","1417","1025","392","22","1439","3782","4094","38.05","27.10"
"10","005","00","170","0001","0000","94","80","14","1","95","322","0","29.50","24.84"
"10","005","00","170","0001","0464","94","80","14","1","95","322","0","29.50","24.84"
"10","005","00","170","0002","0000","202","142","60","6","208","531","0","39.17","26.74"
"10","005","00","170","0002","0465","202","142","60","6","208","531","0","39.17","26.74"
"10","005","00","170","0003","0000","318","222","96","6","324","869","0","37.28","25.55"
"10","005","00","170","0003","0466","318","222","96","6","324","869","0","37.28","25.55"
"10","005","00","170","0004","0000","199","135","64","1","200","539","0","37.11","25.05"
"10","005","00","170","0004","0467","199","135","64","1","200","539","0","37.11","25.05"
"10","005","00","170","0005","0000","201","154","47","4","205","548","0","37.41","28.10"
"10","005","00","170","0005","0468","201","154","47","4","205","548","0","37.41","28.10"
"10","005","00","170","0006","0000","124","91","33","2","126","323","0","39.01","28.17"
"10","005","00","170","0006","0469","124","91","33","2","126","323","0","39.01","28.17"
"10","005","00","170","0007","0000","279","201","78","2","281","650","0","43.23","30.92"
"10","005","00","170","0007","0470","279","201","78","2","281","650","0","43.23","30.92"
"10","005","00","180","0000","0000","1519","1270","249","22","1541","4995","5695","30.85","25.43"
"10","005","00","180","0001","0000","85","65","20","1","86","336","0","25.60","19.35"
"10","005","00","180","0001","0471","85","65","20","1","86","336","0","25.60","19.35"
"10","005","00","180","0002","0000","313","263","50","3","316","1070","0","29.53","24.58"
"10","005","00","180","0002","0472","109","93","16","0","109","455","0","23.96","20.44"
"10","005","00","180","0002","0473","204","170","34","3","207","615","0","33.66","27.64"
"10","005","00","180","0003","0000","288","232","56","5","293","871","0","33.64","26.64"
"10","005","00","180","0003","0474","197","156","41","3","200","567","0","35.27","27.51"
"10","005","00","180","0003","0475","91","76","15","2","93","304","0","30.59","25.00"
"10","005","00","180","0004","0000","190","168","22","2","192","480","0","40.00","35.00"
"10","005","00","180","0004","0476","190","168","22","2","192","480","0","40.00","35.00"
"10","005","00","180","0005","0000","131","109","22","0","131","501","0","26.15","21.76"
"10","005","00","180","0005","0477","131","109","22","0","131","501","0","26.15","21.76"
"10","005","00","180","0006","0000","135","109","26","2","137","481","0","28.48","22.66"
"10","005","00","180","0006","0478","135","109","26","2","137","481","0","28.48","22.66"
"10","005","00","180","0007","0000","180","146","34","3","183","666","0","27.48","21.92"
"10","005","00","180","0007","0479","180","146","34","3","183","666","0","27.48","21.92"
"10","005","00","180","0008","0000","197","178","19","6","203","590","0","34.41","30.17"
"10","005","00","180","0008","0480","197","178","19","6","203","590","0","34.41","30.17"
"10","007","00","000","0000","0000","390449","190195","200254","4054","394503","1061571","1260388","37.16","17.92"
"10","007","00","010","0000","0000","79718","40245","39473","656","80374","189909","229765","42.32","21.19"
"10","007","00","010","0001","0000","530","273","257","6","536","1253","0","42.78","21.79"
"10","007","00","010","0001","0119","295","142","153","3","298","666","0","44.74","21.32"
"10","007","00","010","0001","0120","235","131","104","3","238","587","0","40.55","22.32"
"10","007","00","010","0002","0000","2125","1092","1033","13","2138","4972","0","43.00","21.96"
"10","007","00","010","0002","0127","433","225","208","0","433","1101","0","39.33","20.44"
"10","007","00","010","0002","0128","415","217","198","0","415","1020","0","40.69","21.27"
"10","007","00","010","0002","0129","451","229","222","4","455","1012","0","44.96","22.63"
"10","007","00","010","0002","0130","389","216","173","3","392","898","0","43.65","24.05"
"10","007","00","010","0002","0131","437","205","232","6","443","941","0","47.08","21.79"
"10","007","00","010","0003","0000","678","331","347","4","682","1603","0","42.55","20.65"
"10","007","00","010","0003","0114","328","167","161","2","330","753","0","43.82","22.18"
"10","007","00","010","0003","0115","350","164","186","2","352","850","0","41.41","19.29"
"10","007","00","010","0004","0000","375","180","195","5","380","760","0","50.00","23.68"
"10","007","00","010","0004","0116","375","180","195","5","380","760","0","50.00","23.68"
"10","007","00","010","0005","0000","575","305","270","4","579","1331","0","43.50","22.92"
"10","007","00","010","0005","0117","282","137","145","4","286","639","0","44.76","21.44"
"10","007","00","010","0005","0118","293","168","125","0","293","692","0","42.34","24.28"
"10","007","00","010","0006","0000","747","350","397","6","753","1723","0","43.70","20.31"
"10","007","00","010","0006","0121","383","176","207","5","388","906","0","42.83","19.43"
"10","007","00","010","0006","0122","364","174","190","1","365","817","0","44.68","21.30"
"10","007","00","010","0007","0000","1719","840","879","14","1733","3835","0","45.19","21.90"
"10","007","00","010","0007","0123","448","213","235","2","450","976","0","46.11","21.82"
"10","007","00","010","0007","0124","440","234","206","3","443","944","0","46.93","24.79"
"10","007","00","010","0007","0125","378","168","210","4","382","827","0","46.19","20.31"
"10","007","00","010","0007","0126","453","225","228","5","458","1088","0","42.10","20.68"
"10","007","00","010","0008","0000","2259","1072","1187","23","2282","5212","0","43.78","20.57"
"10","007","00","010","0008","0107","521","233","288","8","529","1170","0","45.21","19.91"
"10","007","00","010","0008","0108","397","188","209","1","398","919","0","43.31","20.46"
"10","007","00","010","0008","0109","397","158","239","5","402","943","0","42.63","16.76"
"10","007","00","010","0008","0110","397","195","202","4","401","965","0","41.55","20.21"
"10","007","00","010","0008","0111","547","298","249","5","552","1215","0","45.43","24.53"
"10","007","00","010","0009","0000","769","402","367","5","774","1718","0","45.05","23.40"
"10","007","00","010","0009","0112","365","176","189","1","366","849","0","43.11","20.73"
"10","007","00","010","0009","0113","404","226","178","4","408","869","0","46.95","26.01"
"10","007","00","010","0010","0000","833","403","430","2","835","1895","0","44.06","21.27"
"10","007","00","010","0010","0105","434","219","215","0","434","1001","0","43.36","21.88"
"10","007","00","010","0010","0106","399","184","215","2","401","894","0","44.85","20.58"
"10","007","00","010","0011","0000","346","205","141","1","347","762","0","45.54","26.90"
"10","007","00","010","0011","0104","346","205","141","1","347","762","0","45.54","26.90"
"10","007","00","010","0012","0000","644","336","308","5","649","1377","0","47.13","24.40"
"10","007","00","010","0012","0102","318","153","165","0","318","646","0","49.23","23.68"
"10","007","00","010","0012","0103","326","183","143","5","331","731","0","45.28","25.03"
"10","007","00","010","0013","0000","396","165","231","2","398","862","0","46.17","19.14"
"10","007","00","010","0013","0100","396","165","231","2","398","862","0","46.17","19.14"
"10","007","00","010","0014","0000","262","101","161","4","266","642","0","41.43","15.73"
"10","007","00","010","0014","0099","262","101","161","4","266","642","0","41.43","15.73"
"10","007","00","010","0015","0000","360","165","195","2","362","706","0","51.27","23.37"
"10","007","00","010","0015","0101","360","165","195","2","362","706","0","51.27","23.37"
"10","007","00","010","0016","0000","382","135","247","2","384","864","0","44.44","15.63"
"10","007","00","010","0016","0054","382","135","247","2","384","864","0","44.44","15.63"
"10","007","00","010","0017","0000","374","156","218","3","377","748","0","50.40","20.86"
"10","007","00","010","0017","0051","374","156","218","3","377","748","0","50.40","20.86"
"10","007","00","010","0018","0000","392","161","231","1","393","863","0","45.54","18.66"
"10","007","00","010","0018","0052","392","161","231","1","393","863","0","45.54","18.66"
"10","007","00","010","0019","0000","466","207","259","4","470","1067","0","44.05","19.40"
"10","007","00","010","0019","0053","466","207","259","4","470","1067","0","44.05","19.40"
"10","007","00","010","0020","0000","1472","746","726","7","1479","3304","0","44.76","22.58"
"10","007","00","010","0020","0056","465","218","247","2","467","1035","0","45.12","21.06"
"10","007","00","010","0020","0057","570","293","277","3","573","1251","0","45.80","23.42"
"10","007","00","010","0020","0058","437","235","202","2","439","1018","0","43.12","23.08"
"10","007","00","010","0021","0000","1554","855","699","15","1569","3585","0","43.77","23.85"
"10","007","00","010","0021","0059","534","293","241","3","537","1147","0","46.82","25.54"
"10","007","00","010","0021","0060","501","257","244","7","508","1260","0","40.32","20.40"
"10","007","00","010","0021","0061","519","305","214","5","524","1178","0","44.48","25.89"
"10","007","00","010","0022","0000","529","269","260","3","532","1129","0","47.12","23.83"
"10","007","00","010","0022","0065","529","269","260","3","532","1129","0","47.12","23.83"
"10","007","00","010","0023","0000","1329","699","630","15","1344","3158","0","42.56","22.13"
"10","007","00","010","0023","0062","457","227","230","6","463","1037","0","44.65","21.89"
"10","007","00","010","0023","0063","476","245","231","5","481","1078","0","44.62","22.73"
"10","007","00","010","0023","0064","396","227","169","4","400","1043","0","38.35","21.76"
"10","007","00","010","0024","0000","1525","789","736","15","1540","4175","0","36.89","18.90"
"10","007","00","010","0024","0066","380","192","188","4","384","1010","0","38.02","19.01"
"10","007","00","010","0024","0067","387","193","194","1","388","1081","0","35.89","17.85"
"10","007","00","010","0024","0068","351","179","172","3","354","943","0","37.54","18.98"
"10","007","00","010","0024","0069","407","225","182","7","414","1141","0","36.28","19.72"
"10","007","00","010","0025","0000","456","179","277","4","460","930","0","49.46","19.25"
"10","007","00","010","0025","0055","456","179","277","4","460","930","0","49.46","19.25"
"10","007","00","010","0026","0000","1387","672","715","16","1403","3505","0","40.03","19.17"
"10","007","00","010","0026","0091","420","196","224","2","422","1182","0","35.70","16.58"
"10","007","00","010","0026","0092","467","222","245","8","475","1074","0","44.23","20.67"
"10","007","00","010","0026","0093","500","254","246","6","506","1249","0","40.51","20.34"
"10","007","00","010","0027","0000","886","446","440","7","893","2137","0","41.79","20.87"
"10","007","00","010","0027","0089","465","237","228","5","470","1166","0","40.31","20.33"
"10","007","00","010","0027","0090","421","209","212","2","423","971","0","43.56","21.52"
"10","007","00","010","0028","0000","733","354","379","6","739","1884","0","39.23","18.79"
"10","007","00","010","0028","0087","321","138","183","3","324","839","0","38.62","16.45"
"10","007","00","010","0028","0088","412","216","196","3","415","1045","0","39.71","20.67"
"10","007","00","010","0029","0000","1322","630","692","13","1335","3079","0","43.36","20.46"
"10","007","00","010","0029","0084","370","180","190","2","372","885","0","42.03","20.34"
"10","007","00","010","0029","0085","485","239","246","7","492","1109","0","44.36","21.55"
"10","007","00","010","0029","0086","467","211","256","4","471","1085","0","43.41","19.45"
"10","007","00","010","0030","0000","1268","671","597","8","1276","3285","0","38.84","20.43"
"10","007","00","010","0030","0094","437","231","206","2","439","1190","0","36.89","19.41"
"10","007","00","010","0030","0095","443","235","208","4","447","1024","0","43.65","22.95"
"10","007","00","010","0030","0096","388","205","183","2","390","1071","0","36.41","19.14"
"10","007","00","010","0031","0000","1681","837","844","16","1697","4235","0","40.07","19.76"
"10","007","00","010","0031","0070","392","199","193","5","397","973","0","40.80","20.45"
"10","007","00","010","0031","0071","446","203","243","3","449","1136","0","39.52","17.87"
"10","007","00","010","0031","0072","428","230","198","3","431","1079","0","39.94","21.32"
"10","007","00","010","0031","0073","415","205","210","5","420","1047","0","40.11","19.58"
"10","007","00","010","0032","0000","963","485","478","5","968","2424","0","39.93","20.01"
"10","007","00","010","0032","0001","387","206","181","1","388","881","0","44.04","23.38"
"10","007","00","010","0032","0002","204","102","102","1","205","663","0","30.92","15.38"
"10","007","00","010","0032","0003","372","177","195","3","375","880","0","42.61","20.11"
"10","007","00","010","0033","0000","1091","606","485","11","1102","2437","0","45.22","24.87"
"10","007","00","010","0033","0097","516","268","248","6","522","1196","0","43.65","22.41"
"10","007","00","010","0033","0098","575","338","237","5","580","1241","0","46.74","27.24"
"10","007","00","010","0034","0000","676","327","349","7","683","1511","0","45.20","21.64"
"10","007","00","010","0034","0004","329","152","177","6","335","751","0","44.61","20.24"
"10","007","00","010","0034","0005","347","175","172","1","348","760","0","45.79","23.03"
"10","007","00","010","0035","0000","451","213","238","7","458","974","0","47.02","21.87"
"10","007","00","010","0035","0010","451","213","238","7","458","974","0","47.02","21.87"
"10","007","00","010","0036","0000","543","262","281","4","547","1169","0","46.79","22.41"
"10","007","00","010","0036","0011","543","262","281","4","547","1169","0","46.79","22.41"
"10","007","00","010","0037","0000","745","428","317","7","752","1770","0","42.49","24.18"
"10","007","00","010","0037","0008","313","196","117","3","316","741","0","42.65","26.45"
"10","007","00","010","0037","0009","432","232","200","4","436","1029","0","42.37","22.55"
"10","007","00","010","0038","0000","634","338","296","6","640","1426","0","44.88","23.70"
"10","007","00","010","0038","0006","300","178","122","2","302","699","0","43.20","25.46"
"10","007","00","010","0038","0007","334","160","174","4","338","727","0","46.49","22.01"
"10","007","00","010","0039","0000","3241","1639","1602","15","3256","7458","0","43.66","21.98"
"10","007","00","010","0039","0035","401","215","186","2","403","1022","0","39.43","21.04"
"10","007","00","010","0039","0036","490","244","246","2","492","1090","0","45.14","22.39"
"10","007","00","010","0039","0037","539","274","265","1","540","1193","0","45.26","22.97"
"10","007","00","010","0039","0038","485","240","245","3","488","1094","0","44.61","21.94"
"10","007","00","010","0039","0039","488","253","235","1","489","1105","0","44.25","22.90"
"10","007","00","010","0039","0040","403","199","204","1","404","1013","0","39.88","19.64"
"10","007","00","010","0039","0041","435","214","221","5","440","941","0","46.76","22.74"
"10","007","00","010","0040","0000","654","333","321","6","660","1470","0","44.90","22.65"
"10","007","00","010","0040","0042","330","162","168","3","333","694","0","47.98","23.34"
"10","007","00","010","0040","0043","324","171","153","3","327","776","0","42.14","22.04"
"10","007","00","010","0041","0000","2087","1072","1015","16","2103","4938","0","42.59","21.71"
"10","007","00","010","0041","0025","460","253","207","3","463","1173","0","39.47","21.57"
"10","007","00","010","0041","0026","417","228","189","2","419","1040","0","40.29","21.92"
"10","007","00","010","0041","0027","584","260","324","8","592","1350","0","43.85","19.26"
"10","007","00","010","0041","0028","626","331","295","3","629","1375","0","45.75","24.07"
"10","007","00","010","0042","0000","3132","1597","1535","22","3154","7515","0","41.97","21.25"
"10","007","00","010","0042","0029","585","284","301","8","593","1363","0","43.51","20.84"
"10","007","00","010","0042","0030","420","199","221","3","423","1063","0","39.79","18.72"
"10","007","00","010","0042","0031","486","249","237","1","487","1222","0","39.85","20.38"
"10","007","00","010","0042","0032","578","282","296","4","582","1267","0","45.94","22.26"
"10","007","00","010","0042","0033","536","299","237","2","538","1323","0","40.67","22.60"
"10","007","00","010","0042","0034","527","284","243","4","531","1277","0","41.58","22.24"
"10","007","00","010","0043","0000","1220","614","606","11","1231","2775","0","44.36","22.13"
"10","007","00","010","0043","0045","379","189","190","3","382","835","0","45.75","22.63"
"10","007","00","010","0043","0046","398","204","194","5","403","899","0","44.83","22.69"
"10","007","00","010","0043","0047","443","221","222","3","446","1041","0","42.84","21.23"
"10","007","00","010","0044","0000","1252","585","667","14","1266","2845","0","44.50","20.56"
"10","007","00","010","0044","0048","416","192","224","8","424","1011","0","41.94","18.99"
"10","007","00","010","0044","0049","380","157","223","2","382","855","0","44.68","18.36"
"10","007","00","010","0044","0050","456","236","220","4","460","979","0","46.99","24.11"
"10","007","00","010","0045","0000","639","332","307","2","641","1419","0","45.17","23.40"
"10","007","00","010","0045","0014","351","186","165","0","351","797","0","44.04","23.34"
"10","007","00","010","0045","0015","288","146","142","2","290","622","0","46.62","23.47"
"10","007","00","010","0046","0000","958","590","368","6","964","2598","0","37.11","22.71"
"10","007","00","010","0046","0016","574","397","177","4","578","1206","0","47.93","32.92"
"10","007","00","010","0046","0017","384","193","191","2","386","1392","0","27.73","13.86"
"10","007","00","010","0047","0000","3771","1973","1798","23","3794","8962","0","42.33","22.02"
"10","007","00","010","0047","0018","535","294","241","3","538","1315","0","40.91","22.36"
"10","007","00","010","0047","0019","523","271","252","4","527","1214","0","43.41","22.32"
"10","007","00","010","0047","0020","472","260","212","6","478","1157","0","41.31","22.47"
"10","007","00","010","0047","0021","492","207","285","4","496","1274","0","38.93","16.25"
"10","007","00","010","0047","0022","686","362","324","3","689","1518","0","45.39","23.85"
"10","007","00","010","0047","0023","510","258","252","2","512","1167","0","43.87","22.11"
"10","007","00","010","0047","0024","553","321","232","1","554","1317","0","42.07","24.37"
"10","007","00","010","0048","0000","1017","572","445","11","1028","2240","0","45.89","25.54"
"10","007","00","010","0048","0012","495","268","227","5","500","1082","0","46.21","24.77"
"10","007","00","010","0048","0013","522","304","218","6","528","1158","0","45.60","26.25"
"10","007","00","010","0049","0000","447","207","240","12","459","981","0","46.79","21.10"
"10","007","00","010","0049","0044","447","207","240","12","459","981","0","46.79","21.10"
"10","007","00","010","0050","0000","1314","658","656","10","1324","3193","0","41.47","20.61"
"10","007","00","010","0050","0180","420","188","232","4","424","994","0","42.66","18.91"
"10","007","00","010","0050","0181","458","260","198","2","460","1095","0","42.01","23.74"
"10","007","00","010","0050","0182","436","210","226","4","440","1104","0","39.86","19.02"
"10","007","00","010","0051","0000","637","343","294","7","644","1653","0","38.96","20.75"
"10","007","00","010","0051","0156","314","195","119","2","316","782","0","40.41","24.94"
"10","007","00","010","0051","0157","323","148","175","5","328","871","0","37.66","16.99"
"10","007","00","010","0052","0000","788","409","379","7","795","1899","0","41.86","21.54"
"10","007","00","010","0052","0177","362","201","161","5","367","930","0","39.46","21.61"
"10","007","00","010","0052","0178","426","208","218","2","428","969","0","44.17","21.47"
"10","007","00","010","0053","0000","1300","623","677","20","1320","3295","0","40.06","18.91"
"10","007","00","010","0053","0158","404","194","210","5","409","972","0","42.08","19.96"
"10","007","00","010","0053","0159","451","199","252","11","462","1172","0","39.42","16.98"
"10","007","00","010","0053","0160","445","230","215","4","449","1151","0","39.01","19.98"
"10","007","00","010","0054","0000","1238","559","679","17","1255","2951","0","42.53","18.94"
"10","007","00","010","0054","0161","394","164","230","3","397","889","0","44.66","18.45"
"10","007","00","010","0054","0162","448","218","230","7","455","1071","0","42.48","20.35"
"10","007","00","010","0054","0163","396","177","219","7","403","991","0","40.67","17.86"
"10","007","00","010","0055","0000","2716","1249","1467","28","2744","6731","0","40.77","18.56"
"10","007","00","010","0055","0171","437","219","218","3","440","1123","0","39.18","19.50"
"10","007","00","010","0055","0172","449","237","212","4","453","1253","0","36.15","18.91"
"10","007","00","010","0055","0173","487","218","269","3","490","1155","0","42.42","18.87"
"10","007","00","010","0055","0174","485","208","277","6","491","1188","0","41.33","17.51"
"10","007","00","010","0055","0175","472","201","271","9","481","1091","0","44.09","18.42"
"10","007","00","010","0055","0176","386","166","220","3","389","921","0","42.24","18.02"
"10","007","00","010","0056","0000","962","449","513","10","972","2426","0","40.07","18.51"
"10","007","00","010","0056","0154","458","228","230","5","463","1331","0","34.79","17.13"
"10","007","00","010","0056","0155","504","221","283","5","509","1095","0","46.48","20.18"
"10","007","00","010","0057","0000","434","205","229","5","439","1183","0","37.11","17.33"
"10","007","00","010","0057","0179","434","205","229","5","439","1183","0","37.11","17.33"
"10","007","00","010","0058","0000","1019","481","538","11","1030","2414","0","42.67","19.93"
"10","007","00","010","0058","0168","329","146","183","3","332","754","0","44.03","19.36"
"10","007","00","010","0058","0169","378","180","198","4","382","881","0","43.36","20.43"
"10","007","00","010","0058","0170","312","155","157","4","316","779","0","40.56","19.90"
"10","007","00","010","0059","0000","481","220","261","7","488","1222","0","39.93","18.00"
"10","007","00","010","0059","0136","481","220","261","7","488","1222","0","39.93","18.00"
"10","007","00","010","0060","0000","383","191","192","5","388","936","0","41.45","20.41"
"10","007","00","010","0060","0132","383","191","192","5","388","936","0","41.45","20.41"
"10","007","00","010","0061","0000","1243","635","608","12","1255","2915","0","43.05","21.78"
"10","007","00","010","0061","0133","408","218","190","5","413","941","0","43.89","23.17"
"10","007","00","010","0061","0134","397","176","221","5","402","956","0","42.05","18.41"
"10","007","00","010","0061","0135","438","241","197","2","440","1018","0","43.22","23.67"
"10","007","00","010","0062","0000","3345","1778","1567","23","3368","8423","0","39.99","21.11"
"10","007","00","010","0062","0140","520","288","232","1","521","1160","0","44.91","24.83"
"10","007","00","010","0062","0141","456","248","208","3","459","1317","0","34.85","18.83"
"10","007","00","010","0062","0142","466","238","228","1","467","1191","0","39.21","19.98"
"10","007","00","010","0062","0143","457","268","189","1","458","1123","0","40.78","23.86"
"10","007","00","010","0062","0144","492","264","228","5","497","1278","0","38.89","20.66"
"10","007","00","010","0062","0145","431","217","214","5","436","1157","0","37.68","18.76"
"10","007","00","010","0062","0146","523","255","268","7","530","1197","0","44.28","21.30"
"10","007","00","010","0063","0000","928","416","512","6","934","2377","0","39.29","17.50"
"10","007","00","010","0063","0137","344","153","191","4","348","799","0","43.55","19.15"
"10","007","00","010","0063","0138","329","146","183","1","330","878","0","37.59","16.63"
"10","007","00","010","0063","0139","255","117","138","1","256","700","0","36.57","16.71"
"10","007","00","010","0064","0000","1776","923","853","18","1794","4046","0","44.34","22.81"
"10","007","00","010","0064","0150","409","211","198","10","419","969","0","43.24","21.78"
"10","007","00","010","0064","0151","420","208","212","3","423","920","0","45.98","22.61"
"10","007","00","010","0064","0152","463","259","204","2","465","1095","0","42.47","23.65"
"10","007","00","010","0064","0153","484","245","239","3","487","1062","0","45.86","23.07"
"10","007","00","010","0065","0000","1127","595","532","5","1132","2634","0","42.98","22.59"
"10","007","00","010","0065","0147","403","200","203","0","403","855","0","47.13","23.39"
"10","007","00","010","0065","0148","343","183","160","3","346","851","0","40.66","21.50"
"10","007","00","010","0065","0149","381","212","169","2","383","928","0","41.27","22.84"
"10","007","00","010","0066","0000","419","210","209","4","423","1132","0","37.37","18.55"
"10","007","00","010","0066","0187","419","210","209","4","423","1132","0","37.37","18.55"
"10","007","00","010","0067","0000","470","230","240","3","473","1249","0","37.87","18.41"
"10","007","00","010","0067","0186","470","230","240","3","473","1249","0","37.87","18.41"
"10","007","00","010","0068","0000","321","144","177","2","323","840","0","38.45","17.14"
"10","007","00","010","0068","0185","321","144","177","2","323","840","0","38.45","17.14"
"10","007","00","010","0069","0000","359","178","181","1","360","885","0","40.68","20.11"
"10","007","00","010","0069","0183","359","178","181","1","360","885","0","40.68","20.11"
"10","007","00","010","0070","0000","457","222","235","4","461","1114","0","41.38","19.93"
"10","007","00","010","0070","0184","457","222","235","4","461","1114","0","41.38","19.93"
"10","007","00","010","0071","0000","1667","938","729","9","1676","4349","0","38.54","21.57"
"10","007","00","010","0071","0164","415","241","174","3","418","1032","0","40.50","23.35"
"10","007","00","010","0071","0165","401","203","198","1","402","1129","0","35.61","17.98"
"10","007","00","010","0071","0166","429","255","174","3","432","1123","0","38.47","22.71"
"10","007","00","010","0071","0167","422","239","183","2","424","1065","0","39.81","22.44"
"10","007","00","010","0072","0000","2258","1185","1073","12","2270","5297","0","42.85","22.37"
"10","007","00","010","0072","0074","522","287","235","2","524","1231","0","42.57","23.31"
"10","007","00","010","0072","0075","473","233","240","0","473","1067","0","44.33","21.84"
"10","007","00","010","0072","0076","426","233","193","5","431","1025","0","42.05","22.73"
"10","007","00","010","0072","0077","420","194","226","2","422","969","0","43.55","20.02"
"10","007","00","010","0072","0078","417","238","179","3","420","1005","0","41.79","23.68"
"10","007","00","010","0073","0000","2181","1205","976","14","2195","5234","0","41.94","23.02"
"10","007","00","010","0073","0079","513","312","201","2","515","1147","0","44.90","27.20"
"10","007","00","010","0073","0080","369","190","179","1","370","933","0","39.66","20.36"
"10","007","00","010","0073","0081","415","197","218","1","416","988","0","42.11","19.94"
"10","007","00","010","0073","0082","437","260","177","6","443","1012","0","43.77","25.69"
"10","007","00","010","0073","0083","447","246","201","4","451","1154","0","39.08","21.32"
"10","007","00","020","0000","0000","25949","11408","14541","258","26207","70613","86115","37.11","16.16"
"10","007","00","020","0001","0000","465","183","282","4","469","1109","0","42.29","16.50"
"10","007","00","020","0001","0247","465","183","282","4","469","1109","0","42.29","16.50"
"10","007","00","020","0002","0000","219","77","142","2","221","506","0","43.68","15.22"
"10","007","00","020","0002","0248","219","77","142","2","221","506","0","43.68","15.22"
"10","007","00","020","0003","0000","314","122","192","1","315","847","0","37.19","14.40"
"10","007","00","020","0003","0249","314","122","192","1","315","847","0","37.19","14.40"
"10","007","00","020","0004","0000","378","154","224","1","379","906","0","41.83","17.00"
"10","007","00","020","0004","0250","378","154","224","1","379","906","0","41.83","17.00"
"10","007","00","020","0005","0000","2882","1250","1632","22","2904","7832","0","37.08","15.96"
"10","007","00","020","0005","0308","470","175","295","6","476","1330","0","35.79","13.16"
"10","007","00","020","0005","0309","525","236","289","2","527","1348","0","39.09","17.51"
"10","007","00","020","0005","0310","502","238","264","5","507","1535","0","33.03","15.50"
"10","007","00","020","0005","0311","477","204","273","5","482","1129","0","42.69","18.07"
"10","007","00","020","0005","0312","439","187","252","0","439","1209","0","36.31","15.47"
"10","007","00","020","0005","0313","469","210","259","4","473","1281","0","36.92","16.39"
"10","007","00","020","0006","0000","1816","787","1029","15","1831","5195","0","35.25","15.15"
"10","007","00","020","0006","0304","391","196","195","4","395","1207","0","32.73","16.24"
"10","007","00","020","0006","0305","445","195","250","7","452","1192","0","37.92","16.36"
"10","007","00","020","0006","0306","454","153","301","1","455","1297","0","35.08","11.80"
"10","007","00","020","0006","0307","526","243","283","3","529","1499","0","35.29","16.21"
"10","007","00","020","0007","0000","1927","752","1175","20","1947","5046","0","38.59","14.90"
"10","007","00","020","0007","0251","361","130","231","2","363","973","0","37.31","13.36"
"10","007","00","020","0007","0252","463","174","289","4","467","1104","0","42.30","15.76"
"10","007","00","020","0007","0253","288","108","180","4","292","829","0","35.22","13.03"
"10","007","00","020","0007","0254","282","133","149","4","286","731","0","39.12","18.19"
"10","007","00","020","0007","0255","533","207","326","6","539","1409","0","38.25","14.69"
"10","007","00","020","0008","0000","1594","565","1029","18","1612","4391","0","36.71","12.87"
"10","007","00","020","0008","0258","390","123","267","5","395","1033","0","38.24","11.91"
"10","007","00","020","0008","0259","450","143","307","5","455","1098","0","41.44","13.02"
"10","007","00","020","0008","0260","361","130","231","2","363","1072","0","33.86","12.13"
"10","007","00","020","0008","0261","393","169","224","6","399","1188","0","33.59","14.23"
"10","007","00","020","0009","0000","217","80","137","1","218","521","0","41.84","15.36"
"10","007","00","020","0009","0262","217","80","137","1","218","521","0","41.84","15.36"
"10","007","00","020","0010","0000","397","128","269","3","400","837","0","47.79","15.29"
"10","007","00","020","0010","0256","397","128","269","3","400","837","0","47.79","15.29"
"10","007","00","020","0011","0000","447","157","290","5","452","1126","0","40.14","13.94"
"10","007","00","020","0011","0257","447","157","290","5","452","1126","0","40.14","13.94"
"10","007","00","020","0012","0000","469","232","237","6","475","1084","0","43.82","21.40"
"10","007","00","020","0012","0267","469","232","237","6","475","1084","0","43.82","21.40"
"10","007","00","020","0013","0000","497","208","289","2","499","1130","0","44.16","18.41"
"10","007","00","020","0013","0268","497","208","289","2","499","1130","0","44.16","18.41"
"10","007","00","020","0014","0000","124","58","66","0","124","267","0","46.44","21.72"
"10","007","00","020","0014","0269","124","58","66","0","124","267","0","46.44","21.72"
"10","007","00","020","0015","0000","278","111","167","6","284","618","0","45.95","17.96"
"10","007","00","020","0015","0271","278","111","167","6","284","618","0","45.95","17.96"
"10","007","00","020","0016","0000","250","99","151","1","251","574","0","43.73","17.25"
"10","007","00","020","0016","0270","250","99","151","1","251","574","0","43.73","17.25"
"10","007","00","020","0017","0000","405","117","288","8","413","877","0","47.09","13.34"
"10","007","00","020","0017","0272","405","117","288","8","413","877","0","47.09","13.34"
"10","007","00","020","0018","0000","997","393","604","10","1007","2170","0","46.41","18.11"
"10","007","00","020","0018","0273","503","166","337","6","509","1047","0","48.62","15.85"
"10","007","00","020","0018","0274","494","227","267","4","498","1123","0","44.35","20.21"
"10","007","00","020","0019","0000","1328","705","623","12","1340","3879","0","34.54","18.17"
"10","007","00","020","0019","0291","497","256","241","4","501","1529","0","32.77","16.74"
"10","007","00","020","0019","0292","429","234","195","6","435","1101","0","39.51","21.25"
"10","007","00","020","0019","0293","402","215","187","2","404","1249","0","32.35","17.21"
"10","007","00","020","0020","0000","902","446","456","14","916","2598","0","35.26","17.17"
"10","007","00","020","0020","0294","259","114","145","5","264","858","0","30.77","13.29"
"10","007","00","020","0020","0295","259","156","103","3","262","704","0","37.22","22.16"
"10","007","00","020","0020","0296","384","176","208","6","390","1036","0","37.64","16.99"
"10","007","00","020","0021","0000","1329","701","628","10","1339","4105","0","32.62","17.08"
"10","007","00","020","0021","0301","486","250","236","4","490","1431","0","34.24","17.47"
"10","007","00","020","0021","0302","377","220","157","3","380","1223","0","31.07","17.99"
"10","007","00","020","0021","0303","466","231","235","3","469","1451","0","32.32","15.92"
"10","007","00","020","0022","0000","1453","765","688","18","1471","4124","0","35.67","18.55"
"10","007","00","020","0022","0297","321","192","129","9","330","928","0","35.56","20.69"
"10","007","00","020","0022","0298","370","168","202","4","374","1102","0","33.94","15.25"
"10","007","00","020","0022","0299","358","208","150","2","360","882","0","40.82","23.58"
"10","007","00","020","0022","0300","404","197","207","3","407","1212","0","33.58","16.25"
"10","007","00","020","0023","0000","1168","636","532","8","1176","3189","0","36.88","19.94"
"10","007","00","020","0023","0283","380","220","160","3","383","1006","0","38.07","21.87"
"10","007","00","020","0023","0284","384","206","178","1","385","1026","0","37.52","20.08"
"10","007","00","020","0023","0285","404","210","194","4","408","1157","0","35.26","18.15"
"10","007","00","020","0024","0000","716","397","319","12","728","2191","0","33.23","18.12"
"10","007","00","020","0024","0286","340","199","141","6","346","1181","0","29.30","16.85"
"10","007","00","020","0024","0287","376","198","178","6","382","1010","0","37.82","19.60"
"10","007","00","020","0025","0000","1059","475","584","9","1068","3032","0","35.22","15.67"
"10","007","00","020","0025","0288","368","150","218","5","373","1051","0","35.49","14.27"
"10","007","00","020","0025","0289","355","161","194","3","358","1006","0","35.59","16.00"
"10","007","00","020","0025","0290","336","164","172","1","337","975","0","34.56","16.82"
"10","007","00","020","0026","0000","1184","498","686","10","1194","3575","0","33.40","13.93"
"10","007","00","020","0026","0277","429","185","244","5","434","1154","0","37.61","16.03"
"10","007","00","020","0026","0278","401","187","214","3","404","1208","0","33.44","15.48"
"10","007","00","020","0026","0279","354","126","228","2","356","1213","0","29.35","10.39"
"10","007","00","020","0027","0000","664","278","386","9","673","2076","0","32.42","13.39"
"10","007","00","020","0027","0275","412","179","233","6","418","1326","0","31.52","13.50"
"10","007","00","020","0027","0276","252","99","153","3","255","750","0","34.00","13.20"
"10","007","00","020","0028","0000","900","373","527","16","916","2425","0","37.77","15.38"
"10","007","00","020","0028","0280","308","164","144","5","313","950","0","32.95","17.26"
"10","007","00","020","0028","0281","302","112","190","8","310","735","0","42.18","15.24"
"10","007","00","020","0028","0282","290","97","193","3","293","740","0","39.59","13.11"
"10","007","00","020","0029","0000","1570","661","909","15","1585","4383","0","36.16","15.08"
"10","007","00","020","0029","0263","401","183","218","6","407","1153","0","35.30","15.87"
"10","007","00","020","0029","0264","406","164","242","5","411","1138","0","36.12","14.41"
"10","007","00","020","0029","0265","390","180","210","1","391","1066","0","36.68","16.89"
"10","007","00","020","0029","0266","373","134","239","3","376","1026","0","36.65","13.06"
"10","007","00","030","0000","0000","27388","13453","13935","241","27629","75185","89825","36.75","17.89"
"10","007","00","030","0001","0000","2148","1115","1033","12","2160","6113","0","35.33","18.24"
"10","007","00","030","0001","0386","398","201","197","2","400","1157","0","34.57","17.37"
"10","007","00","030","0001","0387","426","192","234","1","427","1327","0","32.18","14.47"
"10","007","00","030","0001","0388","474","269","205","0","474","1318","0","35.96","20.41"
"10","007","00","030","0001","0389","480","274","206","5","485","1301","0","37.28","21.06"
"10","007","00","030","0001","0390","370","179","191","4","374","1010","0","37.03","17.72"
"10","007","00","030","0002","0000","1645","807","838","13","1658","4323","0","38.35","18.67"
"10","007","00","030","0002","0391","363","175","188","3","366","1064","0","34.40","16.45"
"10","007","00","030","0002","0392","397","189","208","3","400","1007","0","39.72","18.77"
"10","007","00","030","0002","0393","398","195","203","3","401","1004","0","39.94","19.42"
"10","007","00","030","0002","0394","487","248","239","4","491","1248","0","39.34","19.87"
"10","007","00","030","0003","0000","181","103","78","0","181","398","0","45.48","25.88"
"10","007","00","030","0003","0395","181","103","78","0","181","398","0","45.48","25.88"
"10","007","00","030","0004","0000","624","305","319","6","630","1796","0","35.08","16.98"
"10","007","00","030","0004","0396","319","155","164","1","320","816","0","39.22","19.00"
"10","007","00","030","0004","0397","305","150","155","5","310","980","0","31.63","15.31"
"10","007","00","030","0005","0000","1216","584","632","13","1229","3164","0","38.84","18.46"
"10","007","00","030","0005","0398","424","202","222","4","428","1035","0","41.35","19.52"
"10","007","00","030","0005","0399","400","193","207","5","405","1094","0","37.02","17.64"
"10","007","00","030","0005","0400","392","189","203","4","396","1035","0","38.26","18.26"
"10","007","00","030","0006","0000","1016","496","520","10","1026","2785","0","36.84","17.81"
"10","007","00","030","0006","0401","523","217","306","5","528","1406","0","37.55","15.43"
"10","007","00","030","0006","0402","493","279","214","5","498","1379","0","36.11","20.23"
"10","007","00","030","0007","0000","546","279","267","4","550","1672","0","32.89","16.69"
"10","007","00","030","0007","0403","266","132","134","2","268","816","0","32.84","16.18"
"10","007","00","030","0007","0404","280","147","133","2","282","856","0","32.94","17.17"
"10","007","00","030","0008","0000","340","179","161","3","343","847","0","40.50","21.13"
"10","007","00","030","0008","0444","340","179","161","3","343","847","0","40.50","21.13"
"10","007","00","030","0009","0000","803","408","395","7","810","2119","0","38.23","19.25"
"10","007","00","030","0009","0405","504","252","252","5","509","1351","0","37.68","18.65"
"10","007","00","030","0009","0406","299","156","143","2","301","768","0","39.19","20.31"
"10","007","00","030","0010","0000","1059","533","526","11","1070","2869","0","37.30","18.58"
"10","007","00","030","0010","0407","500","248","252","6","506","1457","0","34.73","17.02"
"10","007","00","030","0010","0408","559","285","274","5","564","1412","0","39.94","20.18"
"10","007","00","030","0011","0000","466","237","229","2","468","1464","0","31.97","16.19"
"10","007","00","030","0011","0409","208","88","120","2","210","673","0","31.20","13.08"
"10","007","00","030","0011","0410","258","149","109","0","258","791","0","32.62","18.84"
"10","007","00","030","0012","0000","615","308","307","10","625","1857","0","33.66","16.59"
"10","007","00","030","0012","0411","324","166","158","5","329","970","0","33.92","17.11"
"10","007","00","030","0012","0412","291","142","149","5","296","887","0","33.37","16.01"
"10","007","00","030","0013","0000","813","388","425","5","818","2204","0","37.11","17.60"
"10","007","00","030","0013","0413","426","189","237","3","429","1151","0","37.27","16.42"
"10","007","00","030","0013","0414","387","199","188","2","389","1053","0","36.94","18.90"
"10","007","00","030","0014","0000","459","201","258","4","463","1318","0","35.13","15.25"
"10","007","00","030","0014","0415","459","201","258","4","463","1318","0","35.13","15.25"
"10","007","00","030","0015","0000","2005","1016","989","10","2015","5228","0","38.54","19.43"
"10","007","00","030","0015","0416","447","235","212","4","451","1162","0","38.81","20.22"
"10","007","00","030","0015","0417","494","228","266","0","494","1285","0","38.44","17.74"
"10","007","00","030","0015","0418","490","252","238","3","493","1248","0","39.50","20.19"
"10","007","00","030","0015","0419","574","301","273","3","577","1533","0","37.64","19.63"
"10","007","00","030","0016","0000","728","385","343","4","732","1959","0","37.37","19.65"
"10","007","00","030","0016","0422","414","213","201","2","416","1029","0","40.43","20.70"
"10","007","00","030","0016","0423","314","172","142","2","316","930","0","33.98","18.49"
"10","007","00","030","0017","0000","1065","499","566","8","1073","2669","0","40.20","18.70"
"10","007","00","030","0017","0426","522","238","284","7","529","1322","0","40.02","18.00"
"10","007","00","030","0017","0427","543","261","282","1","544","1347","0","40.39","19.38"
"10","007","00","030","0018","0000","765","369","396","8","773","2034","0","38.00","18.14"
"10","007","00","030","0018","0424","398","171","227","5","403","1016","0","39.67","16.83"
"10","007","00","030","0018","0425","367","198","169","3","370","1018","0","36.35","19.45"
"10","007","00","030","0019","0000","1187","550","637","14","1201","3450","0","34.81","15.94"
"10","007","00","030","0019","0428","400","188","212","5","405","1157","0","35.00","16.25"
"10","007","00","030","0019","0429","388","169","219","5","393","1105","0","35.57","15.29"
"10","007","00","030","0019","0430","399","193","206","4","403","1188","0","33.92","16.25"
"10","007","00","030","0020","0000","355","140","215","9","364","868","0","41.94","16.13"
"10","007","00","030","0020","0431","355","140","215","9","364","868","0","41.94","16.13"
"10","007","00","030","0021","0000","970","489","481","13","983","2388","0","41.16","20.48"
"10","007","00","030","0021","0432","443","200","243","6","449","1115","0","40.27","17.94"
"10","007","00","030","0021","0433","527","289","238","7","534","1273","0","41.95","22.70"
"10","007","00","030","0022","0000","916","407","509","12","928","2277","0","40.76","17.87"
"10","007","00","030","0022","0434","427","190","237","6","433","1077","0","40.20","17.64"
"10","007","00","030","0022","0435","489","217","272","6","495","1200","0","41.25","18.08"
"10","007","00","030","0023","0000","359","167","192","9","368","1109","0","33.18","15.06"
"10","007","00","030","0023","0436","359","167","192","9","368","1109","0","33.18","15.06"
"10","007","00","030","0024","0000","1055","495","560","5","1060","2845","0","37.26","17.40"
"10","007","00","030","0024","0437","340","162","178","1","341","914","0","37.31","17.72"
"10","007","00","030","0024","0438","360","159","201","2","362","972","0","37.24","16.36"
"10","007","00","030","0024","0439","355","174","181","2","357","959","0","37.23","18.14"
"10","007","00","030","0025","0000","1554","825","729","15","1569","4308","0","36.42","19.15"
"10","007","00","030","0025","0440","360","205","155","5","365","985","0","37.06","20.81"
"10","007","00","030","0025","0441","420","240","180","6","426","1054","0","40.42","22.77"
"10","007","00","030","0025","0442","404","199","205","1","405","1160","0","34.91","17.16"
"10","007","00","030","0025","0443","370","181","189","3","373","1109","0","33.63","16.32"
"10","007","00","030","0026","0000","591","319","272","4","595","1748","0","34.04","18.25"
"10","007","00","030","0026","0445","289","154","135","1","290","865","0","33.53","17.80"
"10","007","00","030","0026","0446","302","165","137","3","305","883","0","34.54","18.69"
"10","007","00","030","0027","0000","245","141","104","2","247","842","0","29.33","16.75"
"10","007","00","030","0027","0447","245","141","104","2","247","842","0","29.33","16.75"
"10","007","00","030","0028","0000","450","184","266","2","452","1196","0","37.79","15.38"
"10","007","00","030","0028","0448","450","184","266","2","452","1196","0","37.79","15.38"
"10","007","00","030","0029","0000","629","307","322","3","632","2038","0","31.01","15.06"
"10","007","00","030","0029","0449","379","183","196","1","380","1088","0","34.93","16.82"
"10","007","00","030","0029","0450","250","124","126","2","252","950","0","26.53","13.05"
"10","007","00","030","0030","0000","1124","512","612","13","1137","3033","0","37.49","16.88"
"10","007","00","030","0030","0451","368","169","199","7","375","1022","0","36.69","16.54"
"10","007","00","030","0030","0452","404","179","225","4","408","1006","0","40.56","17.79"
"10","007","00","030","0030","0453","352","164","188","2","354","1005","0","35.22","16.32"
"10","007","00","030","0031","0000","566","257","309","4","570","1548","0","36.82","16.60"
"10","007","00","030","0031","0454","238","118","120","1","239","684","0","34.94","17.25"
"10","007","00","030","0031","0455","328","139","189","3","331","864","0","38.31","16.09"
"10","007","00","030","0032","0000","893","448","445","6","899","2716","0","33.10","16.49"
"10","007","00","030","0032","0420","458","210","248","0","458","1363","0","33.60","15.41"
"10","007","00","030","0032","0421","435","238","197","6","441","1353","0","32.59","17.59"
"10","007","00","040","0000","0000","4841","2653","2188","54","4895","14031","16573","34.89","18.91"
"10","007","00","040","0001","0000","435","274","161","1","436","1187","0","36.73","23.08"
"10","007","00","040","0001","0485","435","274","161","1","436","1187","0","36.73","23.08"
"10","007","00","040","0002","0000","826","503","323","13","839","2276","0","36.86","22.10"
"10","007","00","040","0002","0484","388","216","172","5","393","1042","0","37.72","20.73"
"10","007","00","040","0002","0486","438","287","151","8","446","1234","0","36.14","23.26"
"10","007","00","040","0003","0000","776","423","353","12","788","2324","0","33.91","18.20"
"10","007","00","040","0003","0487","384","214","170","3","387","1195","0","32.38","17.91"
"10","007","00","040","0003","0488","392","209","183","9","401","1129","0","35.52","18.51"
"10","007","00","040","0004","0000","440","222","218","3","443","1240","0","35.73","17.90"
"10","007","00","040","0004","0489","440","222","218","3","443","1240","0","35.73","17.90"
"10","007","00","040","0005","0000","383","194","189","3","386","1223","0","31.56","15.86"
"10","007","00","040","0005","0490","383","194","189","3","386","1223","0","31.56","15.86"
"10","007","00","040","0006","0000","679","323","356","10","689","1914","0","36.00","16.88"
"10","007","00","040","0006","0491","346","159","187","3","349","966","0","36.13","16.46"
"10","007","00","040","0006","0492","333","164","169","7","340","948","0","35.86","17.30"
"10","007","00","040","0007","0000","798","439","359","5","803","2519","0","31.88","17.43"
"10","007","00","040","0007","0493","418","244","174","2","420","1233","0","34.06","19.79"
"10","007","00","040","0007","0494","380","195","185","3","383","1286","0","29.78","15.16"
"10","007","00","040","0008","0000","504","275","229","7","511","1348","0","37.91","20.40"
"10","007","00","040","0008","0495","504","275","229","7","511","1348","0","37.91","20.40"
"10","007","00","050","0000","0000","10267","5196","5071","88","10355","31273","37802","33.11","16.61"
"10","007","00","050","0001","0000","529","243","286","7","536","1748","0","30.66","13.90"
"10","007","00","050","0001","0471","295","112","183","6","301","883","0","34.09","12.68"
"10","007","00","050","0001","0472","234","131","103","1","235","865","0","27.17","15.14"
"10","007","00","050","0002","0000","418","130","288","3","421","1157","0","36.39","11.24"
"10","007","00","050","0002","0473","418","130","288","3","421","1157","0","36.39","11.24"
"10","007","00","050","0003","0000","483","243","240","3","486","1484","0","32.75","16.37"
"10","007","00","050","0003","0478","483","243","240","3","486","1484","0","32.75","16.37"
"10","007","00","050","0004","0000","694","308","386","3","697","2048","0","34.03","15.04"
"10","007","00","050","0004","0462","285","121","164","1","286","927","0","30.85","13.05"
"10","007","00","050","0004","0463","409","187","222","2","411","1121","0","36.66","16.68"
"10","007","00","050","0005","0000","673","381","292","8","681","1990","0","34.22","19.15"
"10","007","00","050","0005","0468","354","188","166","3","357","1078","0","33.12","17.44"
"10","007","00","050","0005","0469","319","193","126","5","324","912","0","35.53","21.16"
"10","007","00","050","0006","0000","456","234","222","5","461","1273","0","36.21","18.38"
"10","007","00","050","0006","0470","456","234","222","5","461","1273","0","36.21","18.38"
"10","007","00","050","0007","0000","663","338","325","8","671","1826","0","36.75","18.51"
"10","007","00","050","0007","0458","365","200","165","3","368","948","0","38.82","21.10"
"10","007","00","050","0007","0459","298","138","160","5","303","878","0","34.51","15.72"
"10","007","00","050","0008","0000","499","335","164","7","506","1714","0","29.52","19.54"
"10","007","00","050","0008","0460","250","171","79","4","254","818","0","31.05","20.90"
"10","007","00","050","0008","0461","249","164","85","3","252","896","0","28.13","18.30"
"10","007","00","050","0009","0000","844","443","401","13","857","2652","0","32.32","16.70"
"10","007","00","050","0009","0464","478","257","221","9","487","1365","0","35.68","18.83"
"10","007","00","050","0009","0465","366","186","180","4","370","1287","0","28.75","14.45"
"10","007","00","050","0010","0000","1718","831","887","8","1726","5173","0","33.37","16.06"
"10","007","00","050","0010","0474","501","242","259","1","502","1359","0","36.94","17.81"
"10","007","00","050","0010","0475","429","204","225","0","429","1345","0","31.90","15.17"
"10","007","00","050","0010","0476","372","166","206","3","375","1170","0","32.05","14.19"
"10","007","00","050","0010","0477","416","219","197","4","420","1299","0","32.33","16.86"
"10","007","00","050","0011","0000","623","372","251","3","626","2344","0","26.71","15.87"
"10","007","00","050","0011","0466","303","193","110","2","305","1101","0","27.70","17.53"
"10","007","00","050","0011","0467","320","179","141","1","321","1243","0","25.82","14.40"
"10","007","00","050","0012","0000","959","454","505","3","962","2622","0","36.69","17.32"
"10","007","00","050","0012","0456","487","239","248","1","488","1194","0","40.87","20.02"
"10","007","00","050","0012","0457","472","215","257","2","474","1428","0","33.19","15.06"
"10","007","00","050","0013","0000","984","505","479","5","989","3002","0","32.94","16.82"
"10","007","00","050","0013","0479","347","164","183","2","349","992","0","35.18","16.53"
"10","007","00","050","0013","0480","327","194","133","3","330","1008","0","32.74","19.25"
"10","007","00","050","0013","0481","310","147","163","0","310","1002","0","30.94","14.67"
"10","007","00","050","0014","0000","724","379","345","12","736","2240","0","32.86","16.92"
"10","007","00","050","0014","0482","341","170","171","8","349","1098","0","31.79","15.48"
"10","007","00","050","0014","0483","383","209","174","4","387","1142","0","33.89","18.30"
"10","007","00","060","0000","0000","13160","5813","7347","157","13317","39495","46114","33.72","14.72"
"10","007","00","060","0001","0000","529","164","365","2","531","1480","0","35.88","11.08"
"10","007","00","060","0001","0326","529","164","365","2","531","1480","0","35.88","11.08"
"10","007","00","060","0002","0000","491","196","295","4","495","1453","0","34.07","13.49"
"10","007","00","060","0002","0325","491","196","295","4","495","1453","0","34.07","13.49"
"10","007","00","060","0003","0000","449","211","238","6","455","1237","0","36.78","17.06"
"10","007","00","060","0003","0320","449","211","238","6","455","1237","0","36.78","17.06"
"10","007","00","060","0004","0000","505","218","287","8","513","1505","0","34.09","14.49"
"10","007","00","060","0004","0318","231","97","134","1","232","708","0","32.77","13.70"
"10","007","00","060","0004","0319","274","121","153","7","281","797","0","35.26","15.18"
"10","007","00","060","0005","0000","423","163","260","2","425","1168","0","36.39","13.96"
"10","007","00","060","0005","0317","423","163","260","2","425","1168","0","36.39","13.96"
"10","007","00","060","0006","0000","450","188","262","5","455","1273","0","35.74","14.77"
"10","007","00","060","0006","0316","450","188","262","5","455","1273","0","35.74","14.77"
"10","007","00","060","0007","0000","533","207","326","10","543","1360","0","39.93","15.22"
"10","007","00","060","0007","0314","533","207","326","10","543","1360","0","39.93","15.22"
"10","007","00","060","0008","0000","365","144","221","4","369","832","0","44.35","17.31"
"10","007","00","060","0008","0315","365","144","221","4","369","832","0","44.35","17.31"
"10","007","00","060","0009","0000","725","360","365","6","731","2397","0","30.50","15.02"
"10","007","00","060","0009","0321","451","218","233","4","455","1453","0","31.31","15.00"
"10","007","00","060","0009","0322","274","142","132","2","276","944","0","29.24","15.04"
"10","007","00","060","0010","0000","932","446","486","11","943","2653","0","35.54","16.81"
"10","007","00","060","0010","0323","444","220","224","8","452","1302","0","34.72","16.90"
"10","007","00","060","0010","0324","488","226","262","3","491","1351","0","36.34","16.73"
"10","007","00","060","0011","0000","813","350","463","10","823","2550","0","32.27","13.73"
"10","007","00","060","0011","0331","329","144","185","4","333","1082","0","30.78","13.31"
"10","007","00","060","0011","0332","484","206","278","6","490","1468","0","33.38","14.03"
"10","007","00","060","0012","0000","369","194","175","4","373","1172","0","31.83","16.55"
"10","007","00","060","0012","0338","369","194","175","4","373","1172","0","31.83","16.55"
"10","007","00","060","0013","0000","380","123","257","7","387","1047","0","36.96","11.75"
"10","007","00","060","0013","0339","380","123","257","7","387","1047","0","36.96","11.75"
"10","007","00","060","0014","0000","628","250","378","16","644","2180","0","29.54","11.47"
"10","007","00","060","0014","0346","312","121","191","3","315","1041","0","30.26","11.62"
"10","007","00","060","0014","0347","316","129","187","13","329","1139","0","28.88","11.33"
"10","007","00","060","0015","0000","584","293","291","9","593","1856","0","31.95","15.79"
"10","007","00","060","0015","0344","299","138","161","2","301","891","0","33.78","15.49"
"10","007","00","060","0015","0345","285","155","130","7","292","965","0","30.26","16.06"
"10","007","00","060","0016","0000","644","350","294","11","655","2276","0","28.78","15.38"
"10","007","00","060","0016","0342","295","159","136","6","301","992","0","30.34","16.03"
"10","007","00","060","0016","0343","349","191","158","5","354","1284","0","27.57","14.88"
"10","007","00","060","0017","0000","331","187","144","5","336","1276","0","26.33","14.66"
"10","007","00","060","0017","0341","331","187","144","5","336","1276","0","26.33","14.66"
"10","007","00","060","0018","0000","458","193","265","3","461","1275","0","36.16","15.14"
"10","007","00","060","0018","0340","458","193","265","3","461","1275","0","36.16","15.14"
"10","007","00","060","0019","0000","1292","554","738","11","1303","3643","0","35.77","15.21"
"10","007","00","060","0019","0333","465","185","280","3","468","1255","0","37.29","14.74"
"10","007","00","060","0019","0334","443","214","229","8","451","1273","0","35.43","16.81"
"10","007","00","060","0019","0335","384","155","229","0","384","1115","0","34.44","13.90"
"10","007","00","060","0020","0000","817","368","449","12","829","2581","0","32.12","14.26"
"10","007","00","060","0020","0336","358","160","198","6","364","1154","0","31.54","13.86"
"10","007","00","060","0020","0337","459","208","251","6","465","1427","0","32.59","14.58"
"10","007","00","060","0021","0000","749","330","419","4","753","2364","0","31.85","13.96"
"10","007","00","060","0021","0329","304","127","177","1","305","1038","0","29.38","12.24"
"10","007","00","060","0021","0330","445","203","242","3","448","1326","0","33.79","15.31"
"10","007","00","060","0022","0000","693","324","369","7","700","1917","0","36.52","16.90"
"10","007","00","060","0022","0327","298","128","170","2","300","886","0","33.86","14.45"
"10","007","00","060","0022","0328","395","196","199","5","400","1031","0","38.80","19.01"
"10","007","00","070","0000","0000","12482","5960","6522","106","12588","32451","38830","38.79","18.37"
"10","007","00","070","0001","0000","685","288","397","6","691","1676","0","41.23","17.18"
"10","007","00","070","0001","0348","314","147","167","3","317","810","0","39.14","18.15"
"10","007","00","070","0001","0349","371","141","230","3","374","866","0","43.19","16.28"
"10","007","00","070","0002","0000","853","363","490","7","860","2038","0","42.20","17.81"
"10","007","00","070","0002","0350","429","176","253","2","431","1028","0","41.93","17.12"
"10","007","00","070","0002","0351","424","187","237","5","429","1010","0","42.48","18.51"
"10","007","00","070","0003","0000","1037","570","467","10","1047","2642","0","39.63","21.57"
"10","007","00","070","0003","0352","380","197","183","5","385","981","0","39.25","20.08"
"10","007","00","070","0003","0353","302","173","129","2","304","802","0","37.91","21.57"
"10","007","00","070","0003","0354","355","200","155","3","358","859","0","41.68","23.28"
"10","007","00","070","0004","0000","635","331","304","9","644","1828","0","35.23","18.11"
"10","007","00","070","0004","0357","323","176","147","1","324","930","0","34.84","18.92"
"10","007","00","070","0004","0358","312","155","157","8","320","898","0","35.63","17.26"
"10","007","00","070","0005","0000","506","277","229","2","508","1438","0","35.33","19.26"
"10","007","00","070","0005","0355","242","120","122","1","243","680","0","35.74","17.65"
"10","007","00","070","0005","0356","264","157","107","1","265","758","0","34.96","20.71"
"10","007","00","070","0006","0000","1486","736","750","14","1500","3871","0","38.75","19.01"
"10","007","00","070","0006","0359","360","181","179","3","363","861","0","42.16","21.02"
"10","007","00","070","0006","0360","327","181","146","2","329","857","0","38.39","21.12"
"10","007","00","070","0006","0361","407","183","224","5","412","1050","0","39.24","17.43"
"10","007","00","070","0006","0362","392","191","201","4","396","1103","0","35.90","17.32"
"10","007","00","070","0007","0000","1269","598","671","10","1279","3154","0","40.55","18.96"
"10","007","00","070","0007","0363","302","143","159","1","303","717","0","42.26","19.94"
"10","007","00","070","0007","0364","397","163","234","3","400","1011","0","39.56","16.12"
"10","007","00","070","0007","0365","317","159","158","3","320","783","0","40.87","20.31"
"10","007","00","070","0007","0366","253","133","120","3","256","643","0","39.81","20.68"
"10","007","00","070","0008","0000","895","393","502","9","904","2279","0","39.67","17.24"
"10","007","00","070","0008","0367","286","124","162","3","289","732","0","39.48","16.94"
"10","007","00","070","0008","0368","259","121","138","1","260","661","0","39.33","18.31"
"10","007","00","070","0008","0369","350","148","202","5","355","886","0","40.07","16.70"
"10","007","00","070","0009","0000","510","256","254","4","514","1479","0","34.75","17.31"
"10","007","00","070","0009","0370","234","123","111","2","236","723","0","32.64","17.01"
"10","007","00","070","0009","0371","276","133","143","2","278","756","0","36.77","17.59"
"10","007","00","070","0010","0000","1687","833","854","10","1697","4523","0","37.52","18.42"
"10","007","00","070","0010","0372","325","149","176","0","325","907","0","35.83","16.43"
"10","007","00","070","0010","0373","292","150","142","4","296","827","0","35.79","18.14"
"10","007","00","070","0010","0374","297","162","135","3","300","842","0","35.63","19.24"
"10","007","00","070","0010","0375","393","186","207","1","394","1004","0","39.24","18.53"
"10","007","00","070","0010","0376","380","186","194","2","382","943","0","40.51","19.72"
"10","007","00","070","0011","0000","846","395","451","6","852","1939","0","43.94","20.37"
"10","007","00","070","0011","0377","355","154","201","3","358","855","0","41.87","18.01"
"10","007","00","070","0011","0378","491","241","250","3","494","1084","0","45.57","22.23"
"10","007","00","070","0012","0000","633","322","311","7","640","1677","0","38.16","19.20"
"10","007","00","070","0012","0379","322","160","162","2","324","892","0","36.32","17.94"
"10","007","00","070","0012","0380","311","162","149","5","316","785","0","40.25","20.64"
"10","007","00","070","0013","0000","668","275","393","5","673","1737","0","38.74","15.83"
"10","007","00","070","0013","0381","326","147","179","1","327","810","0","40.37","18.15"
"10","007","00","070","0013","0382","342","128","214","4","346","927","0","37.32","13.81"
"10","007","00","070","0014","0000","772","323","449","7","779","2170","0","35.90","14.88"
"10","007","00","070","0014","0383","229","117","112","1","230","672","0","34.23","17.41"
"10","007","00","070","0014","0384","232","118","114","3","235","660","0","35.61","17.88"
"10","007","00","070","0014","0385","311","88","223","3","314","838","0","37.47","10.50"
"10","007","00","080","0000","0000","14498","7513","6985","158","14656","38651","45018","37.92","19.44"
"10","007","00","080","0001","0000","1326","683","643","11","1337","3179","0","42.06","21.48"
"10","007","00","080","0001","0188","354","177","177","4","358","895","0","40.00","19.78"
"10","007","00","080","0001","0189","405","226","179","3","408","964","0","42.32","23.44"
"10","007","00","080","0001","0190","567","280","287","4","571","1320","0","43.26","21.21"
"10","007","00","080","0002","0000","681","340","341","8","689","1758","0","39.19","19.34"
"10","007","00","080","0002","0191","306","146","160","6","312","783","0","39.85","18.65"
"10","007","00","080","0002","0192","375","194","181","2","377","975","0","38.67","19.90"
"10","007","00","080","0003","0000","920","470","450","7","927","2329","0","39.80","20.18"
"10","007","00","080","0003","0193","436","206","230","3","439","1108","0","39.62","18.59"
"10","007","00","080","0003","0194","484","264","220","4","488","1221","0","39.97","21.62"
"10","007","00","080","0004","0000","455","198","257","9","464","1069","0","43.41","18.52"
"10","007","00","080","0004","0196","455","198","257","9","464","1069","0","43.41","18.52"
"10","007","00","080","0005","0000","559","254","305","5","564","1419","0","39.75","17.90"
"10","007","00","080","0005","0195","559","254","305","5","564","1419","0","39.75","17.90"
"10","007","00","080","0006","0000","747","385","362","16","763","1892","0","40.33","20.35"
"10","007","00","080","0006","0197","334","159","175","6","340","901","0","37.74","17.65"
"10","007","00","080","0006","0198","413","226","187","10","423","991","0","42.68","22.81"
"10","007","00","080","0007","0000","295","140","155","2","297","721","0","41.19","19.42"
"10","007","00","080","0007","0201","295","140","155","2","297","721","0","41.19","19.42"
"10","007","00","080","0008","0000","730","370","360","7","737","1803","0","40.88","20.52"
"10","007","00","080","0008","0199","477","246","231","4","481","1114","0","43.18","22.08"
"10","007","00","080","0008","0200","253","124","129","3","256","689","0","37.16","18.00"
"10","007","00","080","0009","0000","1887","1039","848","21","1908","4928","0","38.72","21.08"
"10","007","00","080","0009","0210","440","255","185","2","442","1127","0","39.22","22.63"
"10","007","00","080","0009","0211","493","244","249","7","500","1291","0","38.73","18.90"
"10","007","00","080","0009","0212","505","290","215","8","513","1279","0","40.11","22.67"
"10","007","00","080","0009","0213","449","250","199","4","453","1231","0","36.80","20.31"
"10","007","00","080","0010","0000","1132","570","562","14","1146","3092","0","37.06","18.43"
"10","007","00","080","0010","0202","368","184","184","5","373","980","0","38.06","18.78"
"10","007","00","080","0010","0203","344","182","162","1","345","956","0","36.09","19.04"
"10","007","00","080","0010","0204","420","204","216","8","428","1156","0","37.02","17.65"
"10","007","00","080","0011","0000","1707","909","798","20","1727","4602","0","37.53","19.75"
"10","007","00","080","0011","0205","406","236","170","4","410","1129","0","36.32","20.90"
"10","007","00","080","0011","0206","375","206","169","4","379","1118","0","33.90","18.43"
"10","007","00","080","0011","0207","469","224","245","6","475","1237","0","38.40","18.11"
"10","007","00","080","0011","0208","457","243","214","6","463","1118","0","41.41","21.74"
"10","007","00","080","0012","0000","516","225","291","7","523","1340","0","39.03","16.79"
"10","007","00","080","0012","0209","516","225","291","7","523","1340","0","39.03","16.79"
"10","007","00","080","0013","0000","1159","631","528","8","1167","3298","0","35.39","19.13"
"10","007","00","080","0013","0214","368","207","161","1","369","1153","0","32.00","17.95"
"10","007","00","080","0013","0215","370","204","166","1","371","1019","0","36.41","20.02"
"10","007","00","080","0013","0216","421","220","201","6","427","1126","0","37.92","19.54"
"10","007","00","080","0014","0000","312","179","133","0","312","890","0","35.06","20.11"
"10","007","00","080","0014","0217","312","179","133","0","312","890","0","35.06","20.11"
"10","007","00","080","0015","0000","338","166","172","4","342","932","0","36.70","17.81"
"10","007","00","080","0015","0218","338","166","172","4","342","932","0","36.70","17.81"
"10","007","00","080","0016","0000","664","362","302","6","670","1906","0","35.15","18.99"
"10","007","00","080","0016","0219","354","204","150","2","356","967","0","36.81","21.10"
"10","007","00","080","0016","0220","310","158","152","4","314","939","0","33.44","16.83"
"10","007","00","080","0017","0000","578","318","260","5","583","1888","0","30.88","16.84"
"10","007","00","080","0017","0221","417","224","193","5","422","1369","0","30.83","16.36"
"10","007","00","080","0017","0222","161","94","67","0","161","519","0","31.02","18.11"
"10","007","00","080","0018","0000","492","274","218","8","500","1605","0","31.15","17.07"
"10","007","00","080","0018","0223","279","162","117","6","285","891","0","31.99","18.18"
"10","007","00","080","0018","0224","213","112","101","2","215","714","0","30.11","15.69"
"10","007","00","090","0000","0000","7212","3288","3924","100","7312","20114","22927","36.35","16.35"
"10","007","00","090","0001","0000","590","297","293","6","596","1743","0","34.19","17.04"
"10","007","00","090","0001","0225","323","174","149","1","324","945","0","34.29","18.41"
"10","007","00","090","0001","0226","267","123","144","5","272","798","0","34.09","15.41"
"10","007","00","090","0002","0000","471","238","233","5","476","1387","0","34.32","17.16"
"10","007","00","090","0002","0227","229","122","107","3","232","678","0","34.22","17.99"
"10","007","00","090","0002","0228","242","116","126","2","244","709","0","34.41","16.36"
"10","007","00","090","0003","0000","674","334","340","10","684","1754","0","39.00","19.04"
"10","007","00","090","0003","0229","396","188","208","3","399","920","0","43.37","20.43"
"10","007","00","090","0003","0230","278","146","132","7","285","834","0","34.17","17.51"
"10","007","00","090","0004","0000","863","421","442","8","871","2452","0","35.52","17.17"
"10","007","00","090","0004","0232","427","205","222","5","432","1210","0","35.70","16.94"
"10","007","00","090","0004","0233","436","216","220","3","439","1242","0","35.35","17.39"
"10","007","00","090","0005","0000","894","383","511","8","902","2344","0","38.48","16.34"
"10","007","00","090","0005","0234","416","189","227","3","419","1186","0","35.33","15.94"
"10","007","00","090","0005","0235","478","194","284","5","483","1158","0","41.71","16.75"
"10","007","00","090","0006","0000","648","352","296","19","667","1622","0","41.12","21.70"
"10","007","00","090","0006","0236","411","205","206","11","422","1045","0","40.38","19.62"
"10","007","00","090","0006","0237","237","147","90","8","245","577","0","42.46","25.48"
"10","007","00","090","0007","0000","303","142","161","1","304","877","0","34.66","16.19"
"10","007","00","090","0007","0238","303","142","161","1","304","877","0","34.66","16.19"
"10","007","00","090","0008","0000","414","152","262","3","417","1142","0","36.51","13.31"
"10","007","00","090","0008","0239","414","152","262","3","417","1142","0","36.51","13.31"
"10","007","00","090","0009","0000","217","88","129","6","223","647","0","34.47","13.60"
"10","007","00","090","0009","0240","217","88","129","6","223","647","0","34.47","13.60"
"10","007","00","090","0010","0000","628","259","369","8","636","1646","0","38.64","15.74"
"10","007","00","090","0010","0241","299","120","179","4","303","807","0","37.55","14.87"
"10","007","00","090","0010","0242","329","139","190","4","333","839","0","39.69","16.57"
"10","007","00","090","0011","0000","346","168","178","3","349","965","0","36.17","17.41"
"10","007","00","090","0011","0243","346","168","178","3","349","965","0","36.17","17.41"
"10","007","00","090","0012","0000","381","154","227","8","389","1139","0","34.15","13.52"
"10","007","00","090","0012","0244","381","154","227","8","389","1139","0","34.15","13.52"
"10","007","00","090","0013","0000","256","97","159","7","263","854","0","30.80","11.36"
"10","007","00","090","0013","0245","256","97","159","7","263","854","0","30.80","11.36"
"10","007","00","090","0014","0000","326","100","226","3","329","966","0","34.06","10.35"
"10","007","00","090","0014","0246","326","100","226","3","329","966","0","34.06","10.35"
"10","007","00","090","0015","0000","201","103","98","5","206","576","0","35.76","17.88"
"10","007","00","090","0015","0231","201","103","98","5","206","576","0","35.76","17.88"
"10","007","00","100","0000","0000","40154","20225","19929","368","40522","101543","123460","39.91","19.92"
"10","007","00","100","0001","0000","409","233","176","5","414","1051","0","39.39","22.17"
"10","007","00","100","0001","0519","409","233","176","5","414","1051","0","39.39","22.17"
"10","007","00","100","0002","0000","1082","562","520","7","1089","2683","0","40.59","20.95"
"10","007","00","100","0002","0520","359","191","168","3","362","894","0","40.49","21.36"
"10","007","00","100","0002","0521","352","165","187","0","352","910","0","38.68","18.13"
"10","007","00","100","0002","0522","371","206","165","4","375","879","0","42.66","23.44"
"10","007","00","100","0003","0000","1309","685","624","7","1316","3068","0","42.89","22.33"
"10","007","00","100","0003","0543","363","207","156","3","366","835","0","43.83","24.79"
"10","007","00","100","0003","0544","493","260","233","2","495","1166","0","42.45","22.30"
"10","007","00","100","0003","0545","453","218","235","2","455","1067","0","42.64","20.43"
"10","007","00","100","0004","0000","1099","574","525","8","1107","2540","0","43.58","22.60"
"10","007","00","100","0004","0546","354","172","182","3","357","834","0","42.81","20.62"
"10","007","00","100","0004","0547","395","219","176","2","397","887","0","44.76","24.69"
"10","007","00","100","0004","0548","350","183","167","3","353","819","0","43.10","22.34"
"10","007","00","100","0005","0000","335","149","186","4","339","695","0","48.78","21.44"
"10","007","00","100","0005","0549","335","149","186","4","339","695","0","48.78","21.44"
"10","007","00","100","0006","0000","1102","567","535","10","1112","2785","0","39.93","20.36"
"10","007","00","100","0006","0550","360","195","165","4","364","860","0","42.33","22.67"
"10","007","00","100","0006","0551","360","187","173","3","363","872","0","41.63","21.44"
"10","007","00","100","0006","0552","382","185","197","3","385","1053","0","36.56","17.57"
"10","007","00","100","0007","0000","349","178","171","2","351","754","0","46.55","23.61"
"10","007","00","100","0007","0553","349","178","171","2","351","754","0","46.55","23.61"
"10","007","00","100","0008","0000","288","146","142","0","288","571","0","50.44","25.57"
"10","007","00","100","0008","0554","288","146","142","0","288","571","0","50.44","25.57"
"10","007","00","100","0009","0000","684","335","349","5","689","1808","0","38.11","18.53"
"10","007","00","100","0009","0523","307","144","163","4","311","844","0","36.85","17.06"
"10","007","00","100","0009","0524","377","191","186","1","378","964","0","39.21","19.81"
"10","007","00","100","0010","0000","2272","1106","1166","19","2291","5571","0","41.12","19.85"
"10","007","00","100","0010","0525","396","184","212","2","398","1075","0","37.02","17.12"
"10","007","00","100","0010","0526","461","221","240","7","468","1084","0","43.17","20.39"
"10","007","00","100","0010","0527","422","202","220","2","424","1048","0","40.46","19.27"
"10","007","00","100","0010","0528","533","265","268","6","539","1261","0","42.74","21.02"
"10","007","00","100","0010","0529","460","234","226","2","462","1103","0","41.89","21.21"
"10","007","00","100","0011","0000","951","497","454","10","961","2460","0","39.07","20.20"
"10","007","00","100","0011","0577","457","249","208","4","461","1206","0","38.23","20.65"
"10","007","00","100","0011","0578","494","248","246","6","500","1254","0","39.87","19.78"
"10","007","00","100","0012","0000","1747","861","886","14","1761","4122","0","42.72","20.89"
"10","007","00","100","0012","0579","559","250","309","6","565","1347","0","41.95","18.56"
"10","007","00","100","0012","0580","467","235","232","4","471","1083","0","43.49","21.70"
"10","007","00","100","0012","0581","362","187","175","2","364","802","0","45.39","23.32"
"10","007","00","100","0012","0582","359","189","170","2","361","890","0","40.56","21.24"
"10","007","00","100","0013","0000","2124","1071","1053","12","2136","5313","0","40.20","20.16"
"10","007","00","100","0013","0583","670","347","323","2","672","1640","0","40.98","21.16"
"10","007","00","100","0013","0584","496","237","259","5","501","1297","0","38.63","18.27"
"10","007","00","100","0013","0585","476","251","225","1","477","1323","0","36.05","18.97"
"10","007","00","100","0013","0586","482","236","246","4","486","1053","0","46.15","22.41"
"10","007","00","100","0014","0000","1826","964","862","16","1842","4646","0","39.65","20.75"
"10","007","00","100","0014","0587","354","145","209","1","355","835","0","42.51","17.37"
"10","007","00","100","0014","0588","317","172","145","3","320","802","0","39.90","21.45"
"10","007","00","100","0014","0589","375","219","156","2","377","931","0","40.49","23.52"
"10","007","00","100","0014","0590","364","210","154","7","371","981","0","37.82","21.41"
"10","007","00","100","0014","0591","416","218","198","3","419","1097","0","38.20","19.87"
"10","007","00","100","0015","0000","572","239","333","6","578","1675","0","34.51","14.27"
"10","007","00","100","0015","0592","311","121","190","3","314","868","0","36.18","13.94"
"10","007","00","100","0015","0593","261","118","143","3","264","807","0","32.71","14.62"
"10","007","00","100","0016","0000","739","368","371","12","751","2088","0","35.97","17.62"
"10","007","00","100","0016","0594","455","216","239","5","460","1207","0","38.11","17.90"
"10","007","00","100","0016","0595","284","152","132","7","291","881","0","33.03","17.25"
"10","007","00","100","0017","0000","1054","529","525","15","1069","2693","0","39.70","19.64"
"10","007","00","100","0017","0555","490","246","244","5","495","1307","0","37.87","18.82"
"10","007","00","100","0017","0556","564","283","281","10","574","1386","0","41.41","20.42"
"10","007","00","100","0018","0000","2370","1267","1103","18","2388","6107","0","39.10","20.75"
"10","007","00","100","0018","0561","511","281","230","2","513","1118","0","45.89","25.13"
"10","007","00","100","0018","0562","290","169","121","2","292","843","0","34.64","20.05"
"10","007","00","100","0018","0563","416","215","201","6","422","1115","0","37.85","19.28"
"10","007","00","100","0018","0564","414","219","195","4","418","1186","0","35.24","18.47"
"10","007","00","100","0018","0565","390","219","171","0","390","953","0","40.92","22.98"
"10","007","00","100","0018","0566","349","164","185","4","353","892","0","39.57","18.39"
"10","007","00","100","0019","0000","1188","628","560","11","1199","2880","0","41.63","21.81"
"10","007","00","100","0019","0567","405","189","216","2","407","952","0","42.75","19.85"
"10","007","00","100","0019","0568","423","244","179","4","427","984","0","43.39","24.80"
"10","007","00","100","0019","0569","360","195","165","5","365","944","0","38.67","20.66"
"10","007","00","100","0020","0000","686","333","353","14","700","1929","0","36.29","17.26"
"10","007","00","100","0020","0530","358","203","155","8","366","1067","0","34.30","19.03"
"10","007","00","100","0020","0531","328","130","198","6","334","862","0","38.75","15.08"
"10","007","00","100","0021","0000","1052","520","532","15","1067","2485","0","42.94","20.93"
"10","007","00","100","0021","0532","526","240","286","5","531","1303","0","40.75","18.42"
"10","007","00","100","0021","0533","526","280","246","10","536","1182","0","45.35","23.69"
"10","007","00","100","0022","0000","1375","697","678","12","1387","3290","0","42.16","21.19"
"10","007","00","100","0022","0534","413","198","215","2","415","1028","0","40.37","19.26"
"10","007","00","100","0022","0535","442","225","217","4","446","1030","0","43.30","21.84"
"10","007","00","100","0022","0536","520","274","246","6","526","1232","0","42.69","22.24"
"10","007","00","100","0023","0000","890","382","508","12","902","2363","0","38.17","16.17"
"10","007","00","100","0023","0537","507","207","300","6","513","1280","0","40.08","16.17"
"10","007","00","100","0023","0538","383","175","208","6","389","1083","0","35.92","16.16"
"10","007","00","100","0024","0000","1524","816","708","15","1539","3631","0","42.39","22.47"
"10","007","00","100","0024","0539","299","148","151","5","304","847","0","35.89","17.47"
"10","007","00","100","0024","0540","455","261","194","3","458","1097","0","41.75","23.79"
"10","007","00","100","0024","0541","387","190","197","5","392","818","0","47.92","23.23"
"10","007","00","100","0024","0542","383","217","166","2","385","869","0","44.30","24.97"
"10","007","00","100","0025","0000","873","481","392","11","884","2304","0","38.37","20.88"
"10","007","00","100","0025","0496","384","245","139","7","391","1018","0","38.41","24.07"
"10","007","00","100","0025","0497","489","236","253","4","493","1286","0","38.34","18.35"
"10","007","00","100","0026","0000","1026","565","461","1","1027","2698","0","38.07","20.94"
"10","007","00","100","0026","0498","530","265","265","1","531","1375","0","38.62","19.27"
"10","007","00","100","0026","0499","496","300","196","0","496","1323","0","37.49","22.68"
"10","007","00","100","0027","0000","966","463","503","18","984","2788","0","35.29","16.61"
"10","007","00","100","0027","0500","355","175","180","6","361","1061","0","34.02","16.49"
"10","007","00","100","0027","0501","319","168","151","7","326","955","0","34.14","17.59"
"10","007","00","100","0027","0502","292","120","172","5","297","772","0","38.47","15.54"
"10","007","00","100","0028","0000","584","222","362","5","589","1640","0","35.91","13.54"
"10","007","00","100","0028","0503","298","127","171","1","299","826","0","36.20","15.38"
"10","007","00","100","0028","0504","286","95","191","4","290","814","0","35.63","11.67"
"10","007","00","100","0029","0000","430","155","275","5","435","1187","0","36.65","13.06"
"10","007","00","100","0029","0505","430","155","275","5","435","1187","0","36.65","13.06"
"10","007","00","100","0030","0000","279","163","116","2","281","713","0","39.41","22.86"
"10","007","00","100","0030","0506","279","163","116","2","281","713","0","39.41","22.86"
"10","007","00","100","0031","0000","714","335","379","6","720","1974","0","36.47","16.97"
"10","007","00","100","0031","0507","409","205","204","3","412","1122","0","36.72","18.27"
"10","007","00","100","0031","0508","305","130","175","3","308","852","0","36.15","15.26"
"10","007","00","100","0032","0000","770","369","401","9","779","2175","0","35.82","16.97"
"10","007","00","100","0032","0509","401","195","206","5","406","1083","0","37.49","18.01"
"10","007","00","100","0032","0510","369","174","195","4","373","1092","0","34.16","15.93"
"10","007","00","100","0033","0000","717","288","429","6","723","1938","0","37.31","14.86"
"10","007","00","100","0033","0511","331","124","207","1","332","961","0","34.55","12.90"
"10","007","00","100","0033","0512","386","164","222","5","391","977","0","40.02","16.79"
"10","007","00","100","0034","0000","610","280","330","4","614","1738","0","35.33","16.11"
"10","007","00","100","0034","0513","342","161","181","4","346","980","0","35.31","16.43"
"10","007","00","100","0034","0514","268","119","149","0","268","758","0","35.36","15.70"
"10","007","00","100","0035","0000","606","323","283","7","613","1748","0","35.07","18.48"
"10","007","00","100","0035","0515","300","179","121","3","303","871","0","34.79","20.55"
"10","007","00","100","0035","0516","306","144","162","4","310","877","0","35.35","16.42"
"10","007","00","100","0036","0000","829","397","432","14","843","2262","0","37.27","17.55"
"10","007","00","100","0036","0517","402","195","207","7","409","1044","0","39.18","18.68"
"10","007","00","100","0036","0518","427","202","225","7","434","1218","0","35.63","16.58"
"10","007","00","100","0037","0000","1241","657","584","11","1252","2953","0","42.40","22.25"
"10","007","00","100","0037","0570","368","205","163","4","372","961","0","38.71","21.33"
"10","007","00","100","0037","0571","407","214","193","2","409","880","0","46.48","24.32"
"10","007","00","100","0037","0572","466","238","228","5","471","1112","0","42.36","21.40"
"10","007","00","100","0038","0000","988","542","446","6","994","2262","0","43.94","23.96"
"10","007","00","100","0038","0573","512","300","212","3","515","1213","0","42.46","24.73"
"10","007","00","100","0038","0574","476","242","234","3","479","1049","0","45.66","23.07"
"10","007","00","100","0039","0000","1108","548","560","7","1115","2449","0","45.53","22.38"
"10","007","00","100","0039","0575","556","290","266","3","559","1294","0","43.20","22.41"
"10","007","00","100","0039","0576","552","258","294","4","556","1155","0","48.14","22.34"
"10","007","00","100","0040","0000","564","295","269","2","566","1328","0","42.62","22.21"
"10","007","00","100","0040","0559","300","165","135","1","301","721","0","41.75","22.88"
"10","007","00","100","0040","0560","264","130","134","1","265","607","0","43.66","21.42"
"10","007","00","100","0041","0000","822","435","387","5","827","2178","0","37.97","19.97"
"10","007","00","100","0041","0557","499","255","244","4","503","1289","0","39.02","19.78"
"10","007","00","100","0041","0558","323","180","143","1","324","889","0","36.45","20.25"
"10","007","00","110","0000","0000","15736","7954","7782","121","15857","44726","54577","35.45","17.78"
"10","007","00","110","0001","0000","491","237","254","2","493","1156","0","42.65","20.50"
"10","007","00","110","0001","0661","491","237","254","2","493","1156","0","42.65","20.50"
"10","007","00","110","0002","0000","296","153","143","0","296","623","0","47.51","24.56"
"10","007","00","110","0002","0662","296","153","143","0","296","623","0","47.51","24.56"
"10","007","00","110","0003","0000","645","342","303","1","646","1780","0","36.29","19.21"
"10","007","00","110","0003","0663","303","149","154","1","304","801","0","37.95","18.60"
"10","007","00","110","0003","0664","342","193","149","0","342","979","0","34.93","19.71"
"10","007","00","110","0004","0000","177","103","74","1","178","420","0","42.38","24.52"
"10","007","00","110","0004","0665","177","103","74","1","178","420","0","42.38","24.52"
"10","007","00","110","0005","0000","1192","664","528","7","1199","3356","0","35.73","19.79"
"10","007","00","110","0005","0675","383","201","182","3","386","1111","0","34.74","18.09"
"10","007","00","110","0005","0676","409","239","170","1","410","1128","0","36.35","21.19"
"10","007","00","110","0005","0677","400","224","176","3","403","1117","0","36.08","20.05"
"10","007","00","110","0006","0000","841","451","390","12","853","2176","0","39.20","20.73"
"10","007","00","110","0006","0678","459","240","219","7","466","1193","0","39.06","20.12"
"10","007","00","110","0006","0679","382","211","171","5","387","983","0","39.37","21.46"
"10","007","00","110","0007","0000","1179","679","500","7","1186","3446","0","34.42","19.70"
"10","007","00","110","0007","0680","386","221","165","1","387","1189","0","32.55","18.59"
"10","007","00","110","0007","0681","343","183","160","3","346","1021","0","33.89","17.92"
"10","007","00","110","0007","0682","450","275","175","3","453","1236","0","36.65","22.25"
"10","007","00","110","0008","0000","450","209","241","4","454","1421","0","31.95","14.71"
"10","007","00","110","0008","0683","450","209","241","4","454","1421","0","31.95","14.71"
"10","007","00","110","0009","0000","994","487","507","12","1006","3018","0","33.33","16.14"
"10","007","00","110","0009","0684","327","138","189","6","333","1025","0","32.49","13.46"
"10","007","00","110","0009","0685","330","167","163","5","335","998","0","33.57","16.73"
"10","007","00","110","0009","0686","337","182","155","1","338","995","0","33.97","18.29"
"10","007","00","110","0010","0000","908","485","423","7","915","2433","0","37.61","19.93"
"10","007","00","110","0010","0687","499","263","236","4","503","1280","0","39.30","20.55"
"10","007","00","110","0010","0688","409","222","187","3","412","1153","0","35.73","19.25"
"10","007","00","110","0011","0000","829","429","400","4","833","2297","0","36.26","18.68"
"10","007","00","110","0011","0689","491","248","243","4","495","1327","0","37.30","18.69"
"10","007","00","110","0011","0690","338","181","157","0","338","970","0","34.85","18.66"
"10","007","00","110","0012","0000","285","113","172","5","290","814","0","35.63","13.88"
"10","007","00","110","0012","0691","285","113","172","5","290","814","0","35.63","13.88"
"10","007","00","110","0013","0000","608","291","317","4","612","1829","0","33.46","15.91"
"10","007","00","110","0013","0692","274","132","142","1","275","920","0","29.89","14.35"
"10","007","00","110","0013","0693","334","159","175","3","337","909","0","37.07","17.49"
"10","007","00","110","0014","0000","759","402","357","5","764","2278","0","33.54","17.65"
"10","007","00","110","0014","0670","397","216","181","1","398","1107","0","35.95","19.51"
"10","007","00","110","0014","0671","362","186","176","4","366","1171","0","31.26","15.88"
"10","007","00","110","0015","0000","299","131","168","1","300","817","0","36.72","16.03"
"10","007","00","110","0015","0674","299","131","168","1","300","817","0","36.72","16.03"
"10","007","00","110","0016","0000","459","179","280","1","460","1353","0","34.00","13.23"
"10","007","00","110","0016","0703","459","179","280","1","460","1353","0","34.00","13.23"
"10","007","00","110","0017","0000","702","355","347","6","708","1836","0","38.56","19.34"
"10","007","00","110","0017","0672","299","158","141","4","303","920","0","32.93","17.17"
"10","007","00","110","0017","0673","403","197","206","2","405","916","0","44.21","21.51"
"10","007","00","110","0018","0000","1604","789","815","12","1616","4595","0","35.17","17.17"
"10","007","00","110","0018","0666","346","153","193","3","349","1065","0","32.77","14.37"
"10","007","00","110","0018","0667","388","187","201","2","390","1129","0","34.54","16.56"
"10","007","00","110","0018","0668","416","225","191","5","421","1160","0","36.29","19.40"
"10","007","00","110","0018","0669","454","224","230","2","456","1241","0","36.74","18.05"
"10","007","00","110","0019","0000","207","110","97","0","207","641","0","32.29","17.16"
"10","007","00","110","0019","0694","207","110","97","0","207","641","0","32.29","17.16"
"10","007","00","110","0020","0000","474","252","222","4","478","1250","0","38.24","20.16"
"10","007","00","110","0020","0695","474","252","222","4","478","1250","0","38.24","20.16"
"10","007","00","110","0021","0000","237","114","123","3","240","694","0","34.58","16.43"
"10","007","00","110","0021","0696","237","114","123","3","240","694","0","34.58","16.43"
"10","007","00","110","0022","0000","443","242","201","6","449","1362","0","32.97","17.77"
"10","007","00","110","0022","0697","443","242","201","6","449","1362","0","32.97","17.77"
"10","007","00","110","0023","0000","386","147","239","4","390","1250","0","31.20","11.76"
"10","007","00","110","0023","0698","386","147","239","4","390","1250","0","31.20","11.76"
"10","007","00","110","0024","0000","704","322","382","10","714","2168","0","32.93","14.85"
"10","007","00","110","0024","0701","342","158","184","5","347","1074","0","32.31","14.71"
"10","007","00","110","0024","0702","362","164","198","5","367","1094","0","33.55","14.99"
"10","007","00","110","0025","0000","567","268","299","3","570","1713","0","33.27","15.65"
"10","007","00","110","0025","0699","326","143","183","2","328","956","0","34.31","14.96"
"10","007","00","110","0025","0700","241","125","116","1","242","757","0","31.97","16.51"
"10","007","00","120","0000","0000","12945","6352","6593","124","13069","34682","40379","37.68","18.31"
"10","007","00","120","0001","0000","269","122","147","1","270","816","0","33.09","14.95"
"10","007","00","120","0001","0766","269","122","147","1","270","816","0","33.09","14.95"
"10","007","00","120","0002","0000","365","213","152","6","371","1037","0","35.78","20.54"
"10","007","00","120","0002","0767","365","213","152","6","371","1037","0","35.78","20.54"
"10","007","00","120","0003","0000","280","146","134","2","282","748","0","37.70","19.52"
"10","007","00","120","0003","0768","280","146","134","2","282","748","0","37.70","19.52"
"10","007","00","120","0004","0000","533","296","237","8","541","1496","0","36.16","19.79"
"10","007","00","120","0004","0769","254","124","130","3","257","757","0","33.95","16.38"
"10","007","00","120","0004","0770","279","172","107","5","284","739","0","38.43","23.27"
"10","007","00","120","0005","0000","523","299","224","7","530","1448","0","36.60","20.65"
"10","007","00","120","0005","0771","262","152","110","5","267","717","0","37.24","21.20"
"10","007","00","120","0005","0772","261","147","114","2","263","731","0","35.98","20.11"
"10","007","00","120","0006","0000","462","218","244","8","470","1226","0","38.34","17.78"
"10","007","00","120","0006","0773","462","218","244","8","470","1226","0","38.34","17.78"
"10","007","00","120","0007","0000","643","291","352","5","648","1756","0","36.90","16.57"
"10","007","00","120","0007","0776","313","138","175","2","315","835","0","37.72","16.53"
"10","007","00","120","0007","0777","330","153","177","3","333","921","0","36.16","16.61"
"10","007","00","120","0008","0000","255","107","148","1","256","580","0","44.14","18.45"
"10","007","00","120","0008","0778","255","107","148","1","256","580","0","44.14","18.45"
"10","007","00","120","0009","0000","1309","693","616","8","1317","3269","0","40.29","21.20"
"10","007","00","120","0009","0779","390","195","195","1","391","1047","0","37.34","18.62"
"10","007","00","120","0009","0780","463","247","216","2","465","1116","0","41.67","22.13"
"10","007","00","120","0009","0781","456","251","205","5","461","1106","0","41.68","22.69"
"10","007","00","120","0010","0000","931","436","495","5","936","2363","0","39.61","18.45"
"10","007","00","120","0010","0782","504","235","269","2","506","1270","0","39.84","18.50"
"10","007","00","120","0010","0783","427","201","226","3","430","1093","0","39.34","18.39"
"10","007","00","120","0011","0000","404","184","220","2","406","1041","0","39.00","17.68"
"10","007","00","120","0011","0784","404","184","220","2","406","1041","0","39.00","17.68"
"10","007","00","120","0012","0000","451","210","241","3","454","1106","0","41.05","18.99"
"10","007","00","120","0012","0785","451","210","241","3","454","1106","0","41.05","18.99"
"10","007","00","120","0013","0000","806","418","388","7","813","1942","0","41.86","21.52"
"10","007","00","120","0013","0786","399","203","196","0","399","938","0","42.54","21.64"
"10","007","00","120","0013","0787","407","215","192","7","414","1004","0","41.24","21.41"
"10","007","00","120","0014","0000","939","481","458","4","943","2399","0","39.31","20.05"
"10","007","00","120","0014","0774","390","204","186","2","392","1055","0","37.16","19.34"
"10","007","00","120","0014","0775","549","277","272","2","551","1344","0","41.00","20.61"
"10","007","00","120","0015","0000","571","206","365","5","576","1560","0","36.92","13.21"
"10","007","00","120","0015","0789","311","113","198","4","315","797","0","39.52","14.18"
"10","007","00","120","0015","0790","260","93","167","1","261","763","0","34.21","12.19"
"10","007","00","120","0016","0000","442","211","231","6","448","1292","0","34.67","16.33"
"10","007","00","120","0016","0791","442","211","231","6","448","1292","0","34.67","16.33"
"10","007","00","120","0017","0000","634","299","335","9","643","1814","0","35.45","16.48"
"10","007","00","120","0017","0792","309","144","165","5","314","879","0","35.72","16.38"
"10","007","00","120","0017","0793","325","155","170","4","329","935","0","35.19","16.58"
"10","007","00","120","0018","0000","1528","779","749","16","1544","4178","0","36.96","18.65"
"10","007","00","120","0018","0794","377","207","170","5","382","1049","0","36.42","19.73"
"10","007","00","120","0018","0795","355","170","185","2","357","996","0","35.84","17.07"
"10","007","00","120","0018","0796","370","183","187","5","375","1058","0","35.44","17.30"
"10","007","00","120","0018","0797","426","219","207","4","430","1075","0","40.00","20.37"
"10","007","00","120","0019","0000","434","191","243","9","443","1271","0","34.85","15.03"
"10","007","00","120","0019","0788","434","191","243","9","443","1271","0","34.85","15.03"
"10","007","00","120","0020","0000","516","267","249","2","518","1561","0","33.18","17.10"
"10","007","00","120","0020","0798","245","128","117","2","247","766","0","32.25","16.71"
"10","007","00","120","0020","0799","271","139","132","0","271","795","0","34.09","17.48"
"10","007","00","120","0021","0000","325","151","174","4","329","913","0","36.04","16.54"
"10","007","00","120","0021","0800","325","151","174","4","329","913","0","36.04","16.54"
"10","007","00","120","0022","0000","325","134","191","6","331","866","0","38.22","15.47"
"10","007","00","120","0022","0801","325","134","191","6","331","866","0","38.22","15.47"
"10","007","00","130","0000","0000","11818","5763","6055","115","11933","33111","39085","36.04","17.41"
"10","007","00","130","0001","0000","1254","610","644","16","1270","3428","0","37.05","17.79"
"10","007","00","130","0001","0596","367","194","173","3","370","1055","0","35.07","18.39"
"10","007","00","130","0001","0597","408","177","231","3","411","1063","0","38.66","16.65"
"10","007","00","130","0001","0598","479","239","240","10","489","1310","0","37.33","18.24"
"10","007","00","130","0002","0000","579","271","308","5","584","1546","0","37.77","17.53"
"10","007","00","130","0002","0599","287","134","153","2","289","816","0","35.42","16.42"
"10","007","00","130","0002","0600","292","137","155","3","295","730","0","40.41","18.77"
"10","007","00","130","0003","0000","524","235","289","4","528","1493","0","35.37","15.74"
"10","007","00","130","0003","0604","524","235","289","4","528","1493","0","35.37","15.74"
"10","007","00","130","0004","0000","435","218","217","5","440","1209","0","36.39","18.03"
"10","007","00","130","0004","0601","435","218","217","5","440","1209","0","36.39","18.03"
"10","007","00","130","0005","0000","383","164","219","5","388","1172","0","33.11","13.99"
"10","007","00","130","0005","0611","383","164","219","5","388","1172","0","33.11","13.99"
"10","007","00","130","0006","0000","1589","851","738","13","1602","4186","0","38.27","20.33"
"10","007","00","130","0006","0614","468","286","182","4","472","1144","0","41.26","25.00"
"10","007","00","130","0006","0615","296","140","156","3","299","875","0","34.17","16.00"
"10","007","00","130","0006","0616","417","237","180","2","419","1139","0","36.79","20.81"
"10","007","00","130","0006","0618","408","188","220","4","412","1028","0","40.08","18.29"
"10","007","00","130","0007","0000","760","387","373","3","763","2092","0","36.47","18.50"
"10","007","00","130","0007","0619","433","214","219","2","435","1078","0","40.35","19.85"
"10","007","00","130","0007","0620","327","173","154","1","328","1014","0","32.35","17.06"
"10","007","00","130","0008","0000","863","413","450","11","874","2569","0","34.02","16.08"
"10","007","00","130","0008","0625","443","213","230","7","450","1232","0","36.53","17.29"
"10","007","00","130","0008","0626","420","200","220","4","424","1337","0","31.71","14.96"
"10","007","00","130","0009","0000","578","295","283","6","584","1569","0","37.22","18.80"
"10","007","00","130","0009","0602","265","131","134","4","269","692","0","38.87","18.93"
"10","007","00","130","0009","0603","313","164","149","2","315","877","0","35.92","18.70"
"10","007","00","130","0010","0000","537","260","277","4","541","1528","0","35.41","17.02"
"10","007","00","130","0010","0607","275","135","140","2","277","718","0","38.58","18.80"
"10","007","00","130","0010","0608","262","125","137","2","264","810","0","32.59","15.43"
"10","007","00","130","0011","0000","543","274","269","3","546","1420","0","38.45","19.30"
"10","007","00","130","0011","0617","543","274","269","3","546","1420","0","38.45","19.30"
"10","007","00","130","0012","0000","698","373","325","9","707","2033","0","34.78","18.35"
"10","007","00","130","0012","0605","311","189","122","5","316","832","0","37.98","22.72"
"10","007","00","130","0012","0606","387","184","203","4","391","1201","0","32.56","15.32"
"10","007","00","130","0013","0000","555","257","298","8","563","1624","0","34.67","15.83"
"10","007","00","130","0013","0609","294","149","145","4","298","806","0","36.97","18.49"
"10","007","00","130","0013","0610","261","108","153","4","265","818","0","32.40","13.20"
"10","007","00","130","0014","0000","974","457","517","10","984","2635","0","37.34","17.34"
"10","007","00","130","0014","0612","509","259","250","4","513","1353","0","37.92","19.14"
"10","007","00","130","0014","0613","465","198","267","6","471","1282","0","36.74","15.44"
"10","007","00","130","0015","0000","788","371","417","7","795","2428","0","32.74","15.28"
"10","007","00","130","0015","0621","359","164","195","4","363","1096","0","33.12","14.96"
"10","007","00","130","0015","0622","429","207","222","3","432","1332","0","32.43","15.54"
"10","007","00","130","0016","0000","758","327","431","6","764","2179","0","35.06","15.01"
"10","007","00","130","0016","0623","387","155","232","2","389","1054","0","36.91","14.71"
"10","007","00","130","0016","0624","371","172","199","4","375","1125","0","33.33","15.29"
"10","007","00","140","0000","0000","9450","5212","4238","121","9571","27733","31833","34.51","18.79"
"10","007","00","140","0001","0000","670","363","307","8","678","1664","0","40.75","21.81"
"10","007","00","140","0001","0704","357","185","172","5","362","906","0","39.96","20.42"
"10","007","00","140","0001","0705","313","178","135","3","316","758","0","41.69","23.48"
"10","007","00","140","0002","0000","546","292","254","7","553","1536","0","36.00","19.01"
"10","007","00","140","0002","0706","283","156","127","1","284","746","0","38.07","20.91"
"10","007","00","140","0002","0707","263","136","127","6","269","790","0","34.05","17.22"
"10","007","00","140","0003","0000","454","258","196","5","459","1251","0","36.69","20.62"
"10","007","00","140","0003","0708","454","258","196","5","459","1251","0","36.69","20.62"
"10","007","00","140","0004","0000","338","202","136","3","341","889","0","38.36","22.72"
"10","007","00","140","0004","0709","338","202","136","3","341","889","0","38.36","22.72"
"10","007","00","140","0005","0000","607","317","290","5","612","1750","0","34.97","18.11"
"10","007","00","140","0005","0710","319","176","143","1","320","882","0","36.28","19.95"
"10","007","00","140","0005","0711","288","141","147","4","292","868","0","33.64","16.24"
"10","007","00","140","0006","0000","328","163","165","6","334","939","0","35.57","17.36"
"10","007","00","140","0006","0712","328","163","165","6","334","939","0","35.57","17.36"
"10","007","00","140","0007","0000","447","218","229","10","457","1306","0","34.99","16.69"
"10","007","00","140","0007","0713","447","218","229","10","457","1306","0","34.99","16.69"
"10","007","00","140","0008","0000","384","202","182","3","387","1086","0","35.64","18.60"
"10","007","00","140","0008","0714","384","202","182","3","387","1086","0","35.64","18.60"
"10","007","00","140","0009","0000","273","174","99","3","276","656","0","42.07","26.52"
"10","007","00","140","0009","0715","273","174","99","3","276","656","0","42.07","26.52"
"10","007","00","140","0010","0000","422","219","203","4","426","1199","0","35.53","18.27"
"10","007","00","140","0010","0716","422","219","203","4","426","1199","0","35.53","18.27"
"10","007","00","140","0011","0000","556","311","245","1","557","1781","0","31.27","17.46"
"10","007","00","140","0011","0717","287","155","132","1","288","870","0","33.10","17.82"
"10","007","00","140","0011","0718","269","156","113","0","269","911","0","29.53","17.12"
"10","007","00","140","0012","0000","638","348","290","8","646","2059","0","31.37","16.90"
"10","007","00","140","0012","0719","300","135","165","7","307","1001","0","30.67","13.49"
"10","007","00","140","0012","0720","338","213","125","1","339","1058","0","32.04","20.13"
"10","007","00","140","0013","0000","394","188","206","6","400","1194","0","33.50","15.75"
"10","007","00","140","0013","0721","394","188","206","6","400","1194","0","33.50","15.75"
"10","007","00","140","0014","0000","184","118","66","4","188","456","0","41.23","25.88"
"10","007","00","140","0014","0722","184","118","66","4","188","456","0","41.23","25.88"
"10","007","00","140","0015","0000","373","207","166","6","379","1101","0","34.42","18.80"
"10","007","00","140","0015","0723","373","207","166","6","379","1101","0","34.42","18.80"
"10","007","00","140","0016","0000","308","156","152","8","316","848","0","37.26","18.40"
"10","007","00","140","0016","0724","308","156","152","8","316","848","0","37.26","18.40"
"10","007","00","140","0017","0000","396","194","202","3","399","1437","0","27.77","13.50"
"10","007","00","140","0017","0725","198","99","99","2","200","753","0","26.56","13.15"
"10","007","00","140","0017","0726","198","95","103","1","199","684","0","29.09","13.89"
"10","007","00","140","0018","0000","255","159","96","5","260","838","0","31.03","18.97"
"10","007","00","140","0018","0727","255","159","96","5","260","838","0","31.03","18.97"
"10","007","00","140","0019","0000","471","257","214","11","482","1538","0","31.34","16.71"
"10","007","00","140","0019","0728","230","130","100","5","235","813","0","28.91","15.99"
"10","007","00","140","0019","0729","241","127","114","6","247","725","0","34.07","17.52"
"10","007","00","140","0020","0000","507","338","169","7","514","1523","0","33.75","22.19"
"10","007","00","140","0020","0730","244","167","77","3","247","735","0","33.61","22.72"
"10","007","00","140","0020","0731","263","171","92","4","267","788","0","33.88","21.70"
"10","007","00","140","0021","0000","450","238","212","6","456","1368","0","33.33","17.40"
"10","007","00","140","0021","0732","253","130","123","4","257","709","0","36.25","18.34"
"10","007","00","140","0021","0733","197","108","89","2","199","659","0","30.20","16.39"
"10","007","00","140","0022","0000","449","290","159","2","451","1314","0","34.32","22.07"
"10","007","00","140","0022","0734","449","290","159","2","451","1314","0","34.32","22.07"
"10","007","00","150","0000","0000","10854","4946","5908","115","10969","29651","34223","36.99","16.68"
"10","007","00","150","0001","0000","1365","650","715","6","1371","3555","0","38.57","18.28"
"10","007","00","150","0001","0735","426","191","235","3","429","1109","0","38.68","17.22"
"10","007","00","150","0001","0736","447","204","243","2","449","1176","0","38.18","17.35"
"10","007","00","150","0001","0737","492","255","237","1","493","1270","0","38.82","20.08"
"10","007","00","150","0002","0000","463","194","269","4","467","1250","0","37.36","15.52"
"10","007","00","150","0002","0738","463","194","269","4","467","1250","0","37.36","15.52"
"10","007","00","150","0003","0000","613","310","303","5","618","1556","0","39.72","19.92"
"10","007","00","150","0003","0739","334","166","168","3","337","903","0","37.32","18.38"
"10","007","00","150","0003","0740","279","144","135","2","281","653","0","43.03","22.05"
"10","007","00","150","0004","0000","451","241","210","4","455","1258","0","36.17","19.16"
"10","007","00","150","0004","0741","451","241","210","4","455","1258","0","36.17","19.16"
"10","007","00","150","0005","0000","658","275","383","4","662","1740","0","38.05","15.80"
"10","007","00","150","0005","0742","217","96","121","1","218","610","0","35.74","15.74"
"10","007","00","150","0005","0743","441","179","262","3","444","1130","0","39.29","15.84"
"10","007","00","150","0006","0000","764","363","401","8","772","1976","0","39.07","18.37"
"10","007","00","150","0006","0744","416","197","219","6","422","1065","0","39.62","18.50"
"10","007","00","150","0006","0745","348","166","182","2","350","911","0","38.42","18.22"
"10","007","00","150","0007","0000","558","234","324","7","565","1422","0","39.73","16.46"
"10","007","00","150","0007","0746","291","104","187","2","293","762","0","38.45","13.65"
"10","007","00","150","0007","0747","267","130","137","5","272","660","0","41.21","19.70"
"10","007","00","150","0008","0000","656","308","348","5","661","1976","0","33.45","15.59"
"10","007","00","150","0008","0750","294","133","161","1","295","950","0","31.05","14.00"
"10","007","00","150","0008","0751","362","175","187","4","366","1026","0","35.67","17.06"
"10","007","00","150","0009","0000","888","384","504","11","899","2348","0","38.29","16.35"
"10","007","00","150","0009","0748","484","223","261","6","490","1354","0","36.19","16.47"
"10","007","00","150","0009","0749","404","161","243","5","409","994","0","41.15","16.20"
"10","007","00","150","0010","0000","227","104","123","2","229","658","0","34.80","15.81"
"10","007","00","150","0010","0752","227","104","123","2","229","658","0","34.80","15.81"
"10","007","00","150","0011","0000","436","212","224","7","443","1265","0","35.02","16.76"
"10","007","00","150","0011","0753","436","212","224","7","443","1265","0","35.02","16.76"
"10","007","00","150","0012","0000","574","256","318","3","577","1491","0","38.70","17.17"
"10","007","00","150","0012","0754","290","116","174","3","293","754","0","38.86","15.38"
"10","007","00","150","0012","0755","284","140","144","0","284","737","0","38.53","19.00"
"10","007","00","150","0013","0000","366","156","210","4","370","1065","0","34.74","14.65"
"10","007","00","150","0013","0756","366","156","210","4","370","1065","0","34.74","14.65"
"10","007","00","150","0014","0000","338","166","172","3","341","963","0","35.41","17.24"
"10","007","00","150","0014","0757","338","166","172","3","341","963","0","35.41","17.24"
"10","007","00","150","0015","0000","429","162","267","5","434","1305","0","33.26","12.41"
"10","007","00","150","0015","0760","226","87","139","2","228","667","0","34.18","13.04"
"10","007","00","150","0015","0761","203","75","128","3","206","638","0","32.29","11.76"
"10","007","00","150","0016","0000","662","258","404","9","671","1842","0","36.43","14.01"
"10","007","00","150","0016","0758","325","120","205","2","327","909","0","35.97","13.20"
"10","007","00","150","0016","0759","337","138","199","7","344","933","0","36.87","14.79"
"10","007","00","150","0017","0000","520","215","305","11","531","1436","0","36.98","14.97"
"10","007","00","150","0017","0763","520","215","305","11","531","1436","0","36.98","14.97"
"10","007","00","150","0018","0000","314","153","161","8","322","893","0","36.06","17.13"
"10","007","00","150","0018","0762","314","153","161","8","322","893","0","36.06","17.13"
"10","007","00","150","0019","0000","251","121","130","1","252","736","0","34.24","16.44"
"10","007","00","150","0019","0764","251","121","130","1","252","736","0","34.24","16.44"
"10","007","00","150","0020","0000","321","184","137","8","329","916","0","35.92","20.09"
"10","007","00","150","0020","0765","321","184","137","8","329","916","0","35.92","20.09"
"10","007","00","160","0000","0000","11388","5321","6067","131","11519","30808","36061","37.39","17.27"
"10","007","00","160","0001","0000","327","178","149","2","329","761","0","43.23","23.39"
"10","007","00","160","0001","0637","327","178","149","2","329","761","0","43.23","23.39"
"10","007","00","160","0002","0000","607","274","333","0","607","1503","0","40.39","18.23"
"10","007","00","160","0002","0638","286","122","164","0","286","695","0","41.15","17.55"
"10","007","00","160","0002","0639","321","152","169","0","321","808","0","39.73","18.81"
"10","007","00","160","0003","0000","729","375","354","9","738","1800","0","41.00","20.83"
"10","007","00","160","0003","0640","417","209","208","6","423","994","0","42.56","21.03"
"10","007","00","160","0003","0641","312","166","146","3","315","806","0","39.08","20.60"
"10","007","00","160","0004","0000","784","391","393","5","789","2147","0","36.75","18.21"
"10","007","00","160","0004","0642","416","207","209","1","417","1095","0","38.08","18.90"
"10","007","00","160","0004","0643","368","184","184","4","372","1052","0","35.36","17.49"
"10","007","00","160","0005","0000","661","306","355","7","668","1704","0","39.20","17.96"
"10","007","00","160","0005","0644","365","161","204","6","371","914","0","40.59","17.61"
"10","007","00","160","0005","0645","296","145","151","1","297","790","0","37.59","18.35"
"10","007","00","160","0006","0000","533","267","266","7","540","1438","0","37.55","18.57"
"10","007","00","160","0006","0646","310","164","146","4","314","813","0","38.62","20.17"
"10","007","00","160","0006","0647","223","103","120","3","226","625","0","36.16","16.48"
"10","007","00","160","0007","0000","382","122","260","6","388","1059","0","36.64","11.52"
"10","007","00","160","0007","0648","382","122","260","6","388","1059","0","36.64","11.52"
"10","007","00","160","0008","0000","354","207","147","7","361","1065","0","33.90","19.44"
"10","007","00","160","0008","0649","354","207","147","7","361","1065","0","33.90","19.44"
"10","007","00","160","0009","0000","977","491","486","12","989","2670","0","37.04","18.39"
"10","007","00","160","0009","0650","541","274","267","7","548","1429","0","38.35","19.17"
"10","007","00","160","0009","0651","436","217","219","5","441","1241","0","35.54","17.49"
"10","007","00","160","0010","0000","562","207","355","9","571","1368","0","41.74","15.13"
"10","007","00","160","0010","0632","251","88","163","6","257","653","0","39.36","13.48"
"10","007","00","160","0010","0633","311","119","192","3","314","715","0","43.92","16.64"
"10","007","00","160","0011","0000","363","174","189","2","365","1220","0","29.92","14.26"
"10","007","00","160","0011","0627","363","174","189","2","365","1220","0","29.92","14.26"
"10","007","00","160","0012","0000","553","222","331","8","561","1624","0","34.54","13.67"
"10","007","00","160","0012","0630","229","94","135","3","232","700","0","33.14","13.43"
"10","007","00","160","0012","0631","324","128","196","5","329","924","0","35.61","13.85"
"10","007","00","160","0013","0000","665","306","359","10","675","1908","0","35.38","16.04"
"10","007","00","160","0013","0628","322","147","175","5","327","883","0","37.03","16.65"
"10","007","00","160","0013","0629","343","159","184","5","348","1025","0","33.95","15.51"
"10","007","00","160","0014","0000","607","314","293","9","616","1558","0","39.54","20.15"
"10","007","00","160","0014","0634","269","108","161","5","274","742","0","36.93","14.56"
"10","007","00","160","0014","0635","338","206","132","4","342","816","0","41.91","25.25"
"10","007","00","160","0015","0000","515","236","279","6","521","1400","0","37.21","16.86"
"10","007","00","160","0015","0636","515","236","279","6","521","1400","0","37.21","16.86"
"10","007","00","160","0016","0000","259","130","129","3","262","825","0","31.76","15.76"
"10","007","00","160","0016","0652","259","130","129","3","262","825","0","31.76","15.76"
"10","007","00","160","0017","0000","244","117","127","1","245","710","0","34.51","16.48"
"10","007","00","160","0017","0653","244","117","127","1","245","710","0","34.51","16.48"
"10","007","00","160","0018","0000","304","123","181","5","309","736","0","41.98","16.71"
"10","007","00","160","0018","0654","304","123","181","5","309","736","0","41.98","16.71"
"10","007","00","160","0019","0000","252","104","148","4","256","654","0","39.14","15.90"
"10","007","00","160","0019","0655","252","104","148","4","256","654","0","39.14","15.90"
"10","007","00","160","0020","0000","312","151","161","3","315","847","0","37.19","17.83"
"10","007","00","160","0020","0656","312","151","161","3","315","847","0","37.19","17.83"
"10","007","00","160","0021","0000","294","135","159","5","299","809","0","36.96","16.69"
"10","007","00","160","0021","0657","294","135","159","5","299","809","0","36.96","16.69"
"10","007","00","160","0022","0000","240","132","108","6","246","637","0","38.62","20.72"
"10","007","00","160","0022","0658","240","132","108","6","246","637","0","38.62","20.72"
"10","007","00","160","0023","0000","356","184","172","3","359","1075","0","33.40","17.12"
"10","007","00","160","0023","0659","356","184","172","3","359","1075","0","33.40","17.12"
"10","007","00","160","0024","0000","508","175","333","2","510","1290","0","39.53","13.57"
"10","007","00","160","0024","0660","508","175","333","2","510","1290","0","39.53","13.57"
"10","007","00","170","0000","0000","13029","5862","7167","148","13177","35988","42279","36.61","16.29"
"10","007","00","170","0001","0000","1042","440","602","2","1044","2749","0","37.98","16.01"
"10","007","00","170","0001","0802","303","120","183","0","303","783","0","38.70","15.33"
"10","007","00","170","0001","0803","403","177","226","1","404","994","0","40.64","17.81"
"10","007","00","170","0001","0804","336","143","193","1","337","972","0","34.67","14.71"
"10","007","00","170","0002","0000","504","253","251","7","511","1460","0","35.00","17.33"
"10","007","00","170","0002","0809","268","133","135","3","271","765","0","35.42","17.39"
"10","007","00","170","0002","0810","236","120","116","4","240","695","0","34.53","17.27"
"10","007","00","170","0003","0000","424","152","272","5","429","1121","0","38.27","13.56"
"10","007","00","170","0003","0829","424","152","272","5","429","1121","0","38.27","13.56"
"10","007","00","170","0004","0000","1574","661","913","17","1591","4439","0","35.84","14.89"
"10","007","00","170","0004","0805","356","147","209","4","360","1002","0","35.93","14.67"
"10","007","00","170","0004","0806","345","152","193","5","350","1078","0","32.47","14.10"
"10","007","00","170","0004","0807","454","186","268","4","458","1191","0","38.46","15.62"
"10","007","00","170","0004","0808","419","176","243","4","423","1168","0","36.22","15.07"
"10","007","00","170","0005","0000","342","140","202","5","347","914","0","37.96","15.32"
"10","007","00","170","0005","0814","342","140","202","5","347","914","0","37.96","15.32"
"10","007","00","170","0006","0000","423","188","235","6","429","1096","0","39.14","17.15"
"10","007","00","170","0006","0836","423","188","235","6","429","1096","0","39.14","17.15"
"10","007","00","170","0007","0000","1045","529","516","7","1052","2717","0","38.72","19.47"
"10","007","00","170","0007","0822","306","163","143","4","310","704","0","44.03","23.15"
"10","007","00","170","0007","0823","333","166","167","1","334","901","0","37.07","18.42"
"10","007","00","170","0007","0824","406","200","206","2","408","1112","0","36.69","17.99"
"10","007","00","170","0008","0000","758","335","423","12","770","2068","0","37.23","16.20"
"10","007","00","170","0008","0815","392","161","231","6","398","996","0","39.96","16.16"
"10","007","00","170","0008","0816","366","174","192","6","372","1072","0","34.70","16.23"
"10","007","00","170","0009","0000","235","129","106","3","238","754","0","31.56","17.11"
"10","007","00","170","0009","0831","235","129","106","3","238","754","0","31.56","17.11"
"10","007","00","170","0010","0000","333","173","160","6","339","905","0","37.46","19.12"
"10","007","00","170","0010","0827","333","173","160","6","339","905","0","37.46","19.12"
"10","007","00","170","0011","0000","567","233","334","7","574","1712","0","33.53","13.61"
"10","007","00","170","0011","0820","265","101","164","3","268","728","0","36.81","13.87"
"10","007","00","170","0011","0821","302","132","170","4","306","984","0","31.10","13.41"
"10","007","00","170","0012","0000","298","160","138","6","304","968","0","31.40","16.53"
"10","007","00","170","0012","0835","298","160","138","6","304","968","0","31.40","16.53"
"10","007","00","170","0013","0000","458","215","243","6","464","1252","0","37.06","17.17"
"10","007","00","170","0013","0826","458","215","243","6","464","1252","0","37.06","17.17"
"10","007","00","170","0014","0000","543","251","292","8","551","1401","0","39.33","17.92"
"10","007","00","170","0014","0817","279","140","139","7","286","730","0","39.18","19.18"
"10","007","00","170","0014","0818","264","111","153","1","265","671","0","39.49","16.54"
"10","007","00","170","0015","0000","362","171","191","0","362","961","0","37.67","17.79"
"10","007","00","170","0015","0832","362","171","191","0","362","961","0","37.67","17.79"
"10","007","00","170","0016","0000","376","195","181","3","379","980","0","38.67","19.90"
"10","007","00","170","0016","0825","376","195","181","3","379","980","0","38.67","19.90"
"10","007","00","170","0017","0000","460","200","260","11","471","1204","0","39.12","16.61"
"10","007","00","170","0017","0819","460","200","260","11","471","1204","0","39.12","16.61"
"10","007","00","170","0018","0000","271","104","167","1","272","806","0","33.75","12.90"
"10","007","00","170","0018","0837","271","104","167","1","272","806","0","33.75","12.90"
"10","007","00","170","0019","0000","623","277","346","11","634","1581","0","40.10","17.52"
"10","007","00","170","0019","0812","348","138","210","9","357","867","0","41.18","15.92"
"10","007","00","170","0019","0813","275","139","136","2","277","714","0","38.80","19.47"
"10","007","00","170","0020","0000","340","139","201","3","343","977","0","35.11","14.23"
"10","007","00","170","0020","0830","340","139","201","3","343","977","0","35.11","14.23"
"10","007","00","170","0021","0000","510","207","303","6","516","1487","0","34.70","13.92"
"10","007","00","170","0021","0838","279","117","162","2","281","759","0","37.02","15.42"
"10","007","00","170","0021","0839","231","90","141","4","235","728","0","32.28","12.36"
"10","007","00","170","0022","0000","380","160","220","4","384","1028","0","37.35","15.56"
"10","007","00","170","0022","0811","380","160","220","4","384","1028","0","37.35","15.56"
"10","007","00","170","0023","0000","419","239","180","6","425","1260","0","33.73","18.97"
"10","007","00","170","0023","0828","419","239","180","6","425","1260","0","33.73","18.97"
"10","007","00","170","0024","0000","742","311","431","6","748","2148","0","34.82","14.48"
"10","007","00","170","0024","0833","389","182","207","4","393","1096","0","35.86","16.61"
"10","007","00","170","0024","0834","353","129","224","2","355","1052","0","33.75","12.26"
"10","007","00","180","0000","0000","5045","2362","2683","64","5109","12827","14488","39.83","18.41"
"10","007","00","180","0001","0000","311","146","165","0","311","821","0","37.88","17.78"
"10","007","00","180","0001","0842","311","146","165","0","311","821","0","37.88","17.78"
"10","007","00","180","0002","0000","370","159","211","8","378","916","0","41.27","17.36"
"10","007","00","180","0002","0843","370","159","211","8","378","916","0","41.27","17.36"
"10","007","00","180","0003","0000","234","115","119","7","241","610","0","39.51","18.85"
"10","007","00","180","0003","0844","234","115","119","7","241","610","0","39.51","18.85"
"10","007","00","180","0004","0000","254","120","134","1","255","609","0","41.87","19.70"
"10","007","00","180","0004","0845","254","120","134","1","255","609","0","41.87","19.70"
"10","007","00","180","0005","0000","380","184","196","1","381","883","0","43.15","20.84"
"10","007","00","180","0005","0847","380","184","196","1","381","883","0","43.15","20.84"
"10","007","00","180","0006","0000","364","200","164","2","366","933","0","39.23","21.44"
"10","007","00","180","0006","0846","364","200","164","2","366","933","0","39.23","21.44"
"10","007","00","180","0007","0000","317","145","172","6","323","776","0","41.62","18.69"
"10","007","00","180","0007","0849","317","145","172","6","323","776","0","41.62","18.69"
"10","007","00","180","0008","0000","196","122","74","4","200","438","0","45.66","27.85"
"10","007","00","180","0008","0848","196","122","74","4","200","438","0","45.66","27.85"
"10","007","00","180","0009","0000","369","179","190","3","372","996","0","37.35","17.97"
"10","007","00","180","0009","0851","369","179","190","3","372","996","0","37.35","17.97"
"10","007","00","180","0010","0000","336","140","196","4","340","801","0","42.45","17.48"
"10","007","00","180","0010","0850","336","140","196","4","340","801","0","42.45","17.48"
"10","007","00","180","0011","0000","264","98","166","3","267","776","0","34.41","12.63"
"10","007","00","180","0011","0852","264","98","166","3","267","776","0","34.41","12.63"
"10","007","00","180","0012","0000","288","154","134","3","291","779","0","37.36","19.77"
"10","007","00","180","0012","0853","288","154","134","3","291","779","0","37.36","19.77"
"10","007","00","180","0013","0000","263","110","153","5","268","665","0","40.30","16.54"
"10","007","00","180","0013","0854","263","110","153","5","268","665","0","40.30","16.54"
"10","007","00","180","0014","0000","235","115","120","4","239","597","0","40.03","19.26"
"10","007","00","180","0014","0855","235","115","120","4","239","597","0","40.03","19.26"
"10","007","00","180","0015","0000","217","105","112","2","219","562","0","38.97","18.68"
"10","007","00","180","0015","0856","217","105","112","2","219","562","0","38.97","18.68"
"10","007","00","180","0016","0000","378","150","228","9","387","1000","0","38.70","15.00"
"10","007","00","180","0016","0840","378","150","228","9","387","1000","0","38.70","15.00"
"10","007","00","180","0017","0000","269","120","149","2","271","665","0","40.75","18.05"
"10","007","00","180","0017","0841","269","120","149","2","271","665","0","40.75","18.05"
"10","007","00","190","0000","0000","10035","4877","5158","85","10120","27801","33351","36.40","17.54"
"10","007","00","190","0001","0000","683","365","318","4","687","1771","0","38.79","20.61"
"10","007","00","190","0001","0868","334","159","175","2","336","799","0","42.05","19.90"
"10","007","00","190","0001","0869","349","206","143","2","351","972","0","36.11","21.19"
"10","007","00","190","0002","0000","301","155","146","3","304","770","0","39.48","20.13"
"10","007","00","190","0002","0870","301","155","146","3","304","770","0","39.48","20.13"
"10","007","00","190","0003","0000","226","88","138","1","227","535","0","42.43","16.45"
"10","007","00","190","0003","0871","226","88","138","1","227","535","0","42.43","16.45"
"10","007","00","190","0004","0000","281","135","146","1","282","656","0","42.99","20.58"
"10","007","00","190","0004","0872","281","135","146","1","282","656","0","42.99","20.58"
"10","007","00","190","0005","0000","520","215","305","4","524","1406","0","37.27","15.29"
"10","007","00","190","0005","0873","272","111","161","2","274","648","0","42.28","17.13"
"10","007","00","190","0005","0874","248","104","144","2","250","758","0","32.98","13.72"
"10","007","00","190","0006","0000","538","314","224","2","540","1257","0","42.96","24.98"
"10","007","00","190","0006","0875","271","152","119","1","272","624","0","43.59","24.36"
"10","007","00","190","0006","0876","267","162","105","1","268","633","0","42.34","25.59"
"10","007","00","190","0007","0000","827","380","447","8","835","2278","0","36.65","16.68"
"10","007","00","190","0007","0877","411","191","220","1","412","1131","0","36.43","16.89"
"10","007","00","190","0007","0878","416","189","227","7","423","1147","0","36.88","16.48"
"10","007","00","190","0008","0000","1117","552","565","15","1132","3114","0","36.35","17.73"
"10","007","00","190","0008","0879","378","192","186","7","385","989","0","38.93","19.41"
"10","007","00","190","0008","0880","386","208","178","3","389","1068","0","36.42","19.48"
"10","007","00","190","0008","0881","353","152","201","5","358","1057","0","33.87","14.38"
"10","007","00","190","0009","0000","411","188","223","4","415","1307","0","31.75","14.38"
"10","007","00","190","0009","0882","411","188","223","4","415","1307","0","31.75","14.38"
"10","007","00","190","0010","0000","1743","852","891","14","1757","4588","0","38.30","18.57"
"10","007","00","190","0010","0862","416","233","183","1","417","1109","0","37.60","21.01"
"10","007","00","190","0010","0863","465","238","227","4","469","1080","0","43.43","22.04"
"10","007","00","190","0010","0864","467","202","265","5","472","1195","0","39.50","16.90"
"10","007","00","190","0010","0865","395","179","216","4","399","1204","0","33.14","14.87"
"10","007","00","190","0011","0000","553","295","258","3","556","1694","0","32.82","17.41"
"10","007","00","190","0011","0866","226","120","106","1","227","750","0","30.27","16.00"
"10","007","00","190","0011","0867","327","175","152","2","329","944","0","34.85","18.54"
"10","007","00","190","0012","0000","950","416","534","8","958","2702","0","35.46","15.40"
"10","007","00","190","0012","0857","334","140","194","2","336","915","0","36.72","15.30"
"10","007","00","190","0012","0858","303","135","168","4","307","918","0","33.44","14.71"
"10","007","00","190","0012","0859","313","141","172","2","315","869","0","36.25","16.23"
"10","007","00","190","0013","0000","703","296","407","5","708","1904","0","37.18","15.55"
"10","007","00","190","0013","0860","403","193","210","2","405","1103","0","36.72","17.50"
"10","007","00","190","0013","0861","300","103","197","3","303","801","0","37.83","12.86"
"10","007","00","190","0014","0000","592","301","291","6","598","2028","0","29.49","14.84"
"10","007","00","190","0014","0883","302","141","161","5","307","1086","0","28.27","12.98"
"10","007","00","190","0014","0884","290","160","130","1","291","942","0","30.89","16.99"
"10","007","00","190","0015","0000","590","325","265","7","597","1791","0","33.33","18.15"
"10","007","00","190","0015","0885","280","152","128","3","283","841","0","33.65","18.07"
"10","007","00","190","0015","0886","310","173","137","4","314","950","0","33.05","18.21"
"10","007","00","200","0000","0000","13326","7108","6218","226","13552","42339","49337","32.01","16.79"
"10","007","00","200","0001","0000","674","322","352","8","682","2094","0","32.57","15.38"
"10","007","00","200","0001","0971","285","135","150","2","287","838","0","34.25","16.11"
"10","007","00","200","0001","0972","389","187","202","6","395","1256","0","31.45","14.89"
"10","007","00","200","0002","0000","1114","646","468","13","1127","3227","0","34.92","20.02"
"10","007","00","200","0002","0973","369","206","163","5","374","1020","0","36.67","20.20"
"10","007","00","200","0002","0974","397","248","149","5","402","1125","0","35.73","22.04"
"10","007","00","200","0002","0975","348","192","156","3","351","1082","0","32.44","17.74"
"10","007","00","200","0003","0000","486","259","227","3","489","1498","0","32.64","17.29"
"10","007","00","200","0003","0976","486","259","227","3","489","1498","0","32.64","17.29"
"10","007","00","200","0004","0000","953","457","496","15","968","2966","0","32.64","15.41"
"10","007","00","200","0004","0977","323","154","169","7","330","985","0","33.50","15.63"
"10","007","00","200","0004","0978","300","130","170","5","305","1016","0","30.02","12.80"
"10","007","00","200","0004","0979","330","173","157","3","333","965","0","34.51","17.93"
"10","007","00","200","0005","0000","440","274","166","12","452","1610","0","28.07","17.02"
"10","007","00","200","0005","0980","203","127","76","3","206","660","0","31.21","19.24"
"10","007","00","200","0005","0981","237","147","90","9","246","950","0","25.89","15.47"
"10","007","00","200","0006","0000","385","204","181","8","393","1341","0","29.31","15.21"
"10","007","00","200","0006","0982","385","204","181","8","393","1341","0","29.31","15.21"
"10","007","00","200","0007","0000","302","128","174","0","302","1010","0","29.90","12.67"
"10","007","00","200","0007","0983","302","128","174","0","302","1010","0","29.90","12.67"
"10","007","00","200","0008","0000","268","139","129","7","275","976","0","28.18","14.24"
"10","007","00","200","0008","0984","268","139","129","7","275","976","0","28.18","14.24"
"10","007","00","200","0009","0000","389","225","164","8","397","1145","0","34.67","19.65"
"10","007","00","200","0009","0985","389","225","164","8","397","1145","0","34.67","19.65"
"10","007","00","200","0010","0000","520","289","231","7","527","1598","0","32.98","18.09"
"10","007","00","200","0010","0986","233","116","117","2","235","779","0","30.17","14.89"
"10","007","00","200","0010","0987","287","173","114","5","292","819","0","35.65","21.12"
"10","007","00","200","0011","0000","1120","650","470","16","1136","3312","0","34.30","19.63"
"10","007","00","200","0011","0988","298","162","136","7","305","987","0","30.90","16.41"
"10","007","00","200","0011","0989","374","227","147","5","379","1053","0","35.99","21.56"
"10","007","00","200","0011","0990","448","261","187","4","452","1272","0","35.53","20.52"
"10","007","00","200","0012","0000","742","396","346","6","748","2497","0","29.96","15.86"
"10","007","00","200","0012","0968","191","92","99","4","195","721","0","27.05","12.76"
"10","007","00","200","0012","0969","279","148","131","2","281","1003","0","28.02","14.76"
"10","007","00","200","0012","0970","272","156","116","0","272","773","0","35.19","20.18"
"10","007","00","200","0013","0000","361","201","160","11","372","1309","0","28.42","15.36"
"10","007","00","200","0013","0991","361","201","160","11","372","1309","0","28.42","15.36"
"10","007","00","200","0014","0000","461","252","209","20","481","1557","0","30.89","16.18"
"10","007","00","200","0014","0992","225","114","111","9","234","720","0","32.50","15.83"
"10","007","00","200","0014","0993","236","138","98","11","247","837","0","29.51","16.49"
"10","007","00","200","0015","0000","332","174","158","7","339","1180","0","28.73","14.75"
"10","007","00","200","0015","0994","332","174","158","7","339","1180","0","28.73","14.75"
"10","007","00","200","0016","0000","261","152","109","4","265","770","0","34.42","19.74"
"10","007","00","200","0016","0995","261","152","109","4","265","770","0","34.42","19.74"
"10","007","00","200","0017","0000","507","257","250","2","509","1485","0","34.28","17.31"
"10","007","00","200","0017","0996","320","159","161","0","320","837","0","38.23","19.00"
"10","007","00","200","0017","0997","187","98","89","2","189","648","0","29.17","15.12"
"10","007","00","200","0018","0000","355","161","194","2","357","1259","0","28.36","12.79"
"10","007","00","200","0018","0998","355","161","194","2","357","1259","0","28.36","12.79"
"10","007","00","200","0019","0000","333","182","151","7","340","1071","0","31.75","16.99"
"10","007","00","200","0019","0999","333","182","151","7","340","1071","0","31.75","16.99"
"10","007","00","200","0020","0000","1117","657","460","21","1138","3551","0","32.05","18.50"
"10","007","00","200","0020","1000","345","214","131","12","357","1171","0","30.49","18.27"
"10","007","00","200","0020","1001","438","250","188","5","443","1323","0","33.48","18.90"
"10","007","00","200","0020","1002","334","193","141","4","338","1057","0","31.98","18.26"
"10","007","00","200","0021","0000","296","147","149","7","303","958","0","31.63","15.34"
"10","007","00","200","0021","1004","296","147","149","7","303","958","0","31.63","15.34"
"10","007","00","200","0022","0000","286","172","114","13","299","1107","0","27.01","15.54"
"10","007","00","200","0022","1003","286","172","114","13","299","1107","0","27.01","15.54"
"10","007","00","200","0023","0000","245","118","127","5","250","886","0","28.22","13.32"
"10","007","00","200","0023","1005","245","118","127","5","250","886","0","28.22","13.32"
"10","007","00","200","0024","0000","483","241","242","7","490","1220","0","40.16","19.75"
"10","007","00","200","0024","1006","483","241","242","7","490","1220","0","40.16","19.75"
"10","007","00","200","0025","0000","334","170","164","6","340","1041","0","32.66","16.33"
"10","007","00","200","0025","1007","334","170","164","6","340","1041","0","32.66","16.33"
"10","007","00","200","0026","0000","360","144","216","7","367","967","0","37.95","14.89"
"10","007","00","200","0026","1008","360","144","216","7","367","967","0","37.95","14.89"
"10","007","00","200","0027","0000","202","91","111","4","206","704","0","29.26","12.93"
"10","007","00","200","0027","1009","202","91","111","4","206","704","0","29.26","12.93"
"10","007","00","210","0000","0000","8365","3947","4418","119","8484","22884","26569","37.07","17.25"
"10","007","00","210","0001","0000","493","238","255","7","500","1279","0","39.09","18.61"
"10","007","00","210","0001","0887","493","238","255","7","500","1279","0","39.09","18.61"
"10","007","00","210","0002","0000","270","146","124","3","273","793","0","34.43","18.41"
"10","007","00","210","0002","0897","270","146","124","3","273","793","0","34.43","18.41"
"10","007","00","210","0003","0000","957","507","450","10","967","2570","0","37.63","19.73"
"10","007","00","210","0003","0895","553","305","248","7","560","1396","0","40.11","21.85"
"10","007","00","210","0003","0896","404","202","202","3","407","1174","0","34.67","17.21"
"10","007","00","210","0004","0000","357","166","191","7","364","1054","0","34.54","15.75"
"10","007","00","210","0004","0906","357","166","191","7","364","1054","0","34.54","15.75"
"10","007","00","210","0005","0000","282","123","159","6","288","751","0","38.35","16.38"
"10","007","00","210","0005","0910","282","123","159","6","288","751","0","38.35","16.38"
"10","007","00","210","0006","0000","417","176","241","5","422","1022","0","41.29","17.22"
"10","007","00","210","0006","0911","417","176","241","5","422","1022","0","41.29","17.22"
"10","007","00","210","0007","0000","370","183","187","5","375","1202","0","31.20","15.22"
"10","007","00","210","0007","0908","370","183","187","5","375","1202","0","31.20","15.22"
"10","007","00","210","0008","0000","227","97","130","0","227","613","0","37.03","15.82"
"10","007","00","210","0008","0909","227","97","130","0","227","613","0","37.03","15.82"
"10","007","00","210","0009","0000","481","218","263","6","487","1329","0","36.64","16.40"
"10","007","00","210","0009","0907","481","218","263","6","487","1329","0","36.64","16.40"
"10","007","00","210","0010","0000","455","190","265","9","464","1280","0","36.25","14.84"
"10","007","00","210","0010","0894","455","190","265","9","464","1280","0","36.25","14.84"
"10","007","00","210","0011","0000","576","240","336","14","590","1535","0","38.44","15.64"
"10","007","00","210","0011","0892","249","109","140","5","254","658","0","38.60","16.57"
"10","007","00","210","0011","0893","327","131","196","9","336","877","0","38.31","14.94"
"10","007","00","210","0012","0000","441","199","242","3","444","1216","0","36.51","16.37"
"10","007","00","210","0012","0888","441","199","242","3","444","1216","0","36.51","16.37"
"10","007","00","210","0013","0000","664","324","340","14","678","1724","0","39.33","18.79"
"10","007","00","210","0013","0889","407","177","230","6","413","1027","0","40.21","17.23"
"10","007","00","210","0013","0890","257","147","110","8","265","697","0","38.02","21.09"
"10","007","00","210","0014","0000","418","213","205","3","421","941","0","44.74","22.64"
"10","007","00","210","0014","0902","418","213","205","3","421","941","0","44.74","22.64"
"10","007","00","210","0015","0000","299","144","155","4","303","870","0","34.83","16.55"
"10","007","00","210","0015","0903","299","144","155","4","303","870","0","34.83","16.55"
"10","007","00","210","0016","0000","455","213","242","3","458","1365","0","33.55","15.60"
"10","007","00","210","0016","0904","267","126","141","1","268","790","0","33.92","15.95"
"10","007","00","210","0016","0905","188","87","101","2","190","575","0","33.04","15.13"
"10","007","00","210","0017","0000","548","267","281","9","557","1594","0","34.94","16.75"
"10","007","00","210","0017","0898","222","126","96","4","226","635","0","35.59","19.84"
"10","007","00","210","0017","0899","326","141","185","5","331","959","0","34.52","14.70"
"10","007","00","210","0018","0000","93","47","46","1","94","258","0","36.43","18.22"
"10","007","00","210","0018","0900","93","47","46","1","94","258","0","36.43","18.22"
"10","007","00","210","0019","0000","220","88","132","6","226","613","0","36.87","14.36"
"10","007","00","210","0019","0901","220","88","132","6","226","613","0","36.87","14.36"
"10","007","00","210","0020","0000","342","168","174","4","346","875","0","39.54","19.20"
"10","007","00","210","0020","0891","342","168","174","4","346","875","0","39.54","19.20"
"10","007","00","220","0000","0000","8394","3944","4450","124","8518","25354","29860","33.60","15.56"
"10","007","00","220","0001","0000","773","367","406","9","782","2433","0","32.14","15.08"
"10","007","00","220","0001","0912","398","166","232","4","402","1127","0","35.67","14.73"
"10","007","00","220","0001","0913","375","201","174","5","380","1306","0","29.10","15.39"
"10","007","00","220","0002","0000","577","273","304","7","584","1785","0","32.72","15.29"
"10","007","00","220","0002","0914","328","165","163","7","335","973","0","34.43","16.96"
"10","007","00","220","0002","0915","249","108","141","0","249","812","0","30.67","13.30"
"10","007","00","220","0003","0000","573","225","348","11","584","1565","0","37.32","14.38"
"10","007","00","220","0003","0916","257","100","157","7","264","693","0","38.10","14.43"
"10","007","00","220","0003","0917","316","125","191","4","320","872","0","36.70","14.33"
"10","007","00","220","0004","0000","644","386","258","12","656","2256","0","29.08","17.11"
"10","007","00","220","0004","0918","287","163","124","3","290","1110","0","26.13","14.68"
"10","007","00","220","0004","0919","357","223","134","9","366","1146","0","31.94","19.46"
"10","007","00","220","0005","0000","408","200","208","3","411","1230","0","33.41","16.26"
"10","007","00","220","0005","0920","408","200","208","3","411","1230","0","33.41","16.26"
"10","007","00","220","0006","0000","518","241","277","13","531","1561","0","34.02","15.44"
"10","007","00","220","0006","0921","277","134","143","8","285","888","0","32.09","15.09"
"10","007","00","220","0006","0922","241","107","134","5","246","673","0","36.55","15.90"
"10","007","00","220","0007","0000","1179","666","513","6","1185","3254","0","36.42","20.47"
"10","007","00","220","0007","0923","411","224","187","2","413","1034","0","39.94","21.66"
"10","007","00","220","0007","0924","432","264","168","4","436","1319","0","33.06","20.02"
"10","007","00","220","0007","0925","336","178","158","0","336","901","0","37.29","19.76"
"10","007","00","220","0008","0000","675","360","315","11","686","2210","0","31.04","16.29"
"10","007","00","220","0008","0926","289","154","135","2","291","995","0","29.25","15.48"
"10","007","00","220","0008","0927","386","206","180","9","395","1215","0","32.51","16.95"
"10","007","00","220","0009","0000","234","99","135","6","240","710","0","33.80","13.94"
"10","007","00","220","0009","0928","234","99","135","6","240","710","0","33.80","13.94"
"10","007","00","220","0010","0000","206","98","108","0","206","558","0","36.92","17.56"
"10","007","00","220","0010","0929","206","98","108","0","206","558","0","36.92","17.56"
"10","007","00","220","0011","0000","491","253","238","6","497","1486","0","33.45","17.03"
"10","007","00","220","0011","0930","229","129","100","4","233","750","0","31.07","17.20"
"10","007","00","220","0011","0931","262","124","138","2","264","736","0","35.87","16.85"
"10","007","00","220","0012","0000","336","107","229","5","341","1021","0","33.40","10.48"
"10","007","00","220","0012","0932","336","107","229","5","341","1021","0","33.40","10.48"
"10","007","00","220","0013","0000","245","98","147","5","250","807","0","30.98","12.14"
"10","007","00","220","0013","0933","245","98","147","5","250","807","0","30.98","12.14"
"10","007","00","220","0014","0000","354","114","240","6","360","1052","0","34.22","10.84"
"10","007","00","220","0014","0934","354","114","240","6","360","1052","0","34.22","10.84"
"10","007","00","220","0015","0000","509","216","293","4","513","1457","0","35.21","14.82"
"10","007","00","220","0015","0935","254","103","151","1","255","729","0","34.98","14.13"
"10","007","00","220","0015","0936","255","113","142","3","258","728","0","35.44","15.52"
"10","007","00","220","0016","0000","331","122","209","12","343","1056","0","32.48","11.55"
"10","007","00","220","0016","0937","331","122","209","12","343","1056","0","32.48","11.55"
"10","007","00","220","0017","0000","341","119","222","8","349","913","0","38.23","13.03"
"10","007","00","220","0017","0938","341","119","222","8","349","913","0","38.23","13.03"
"10","007","00","230","0000","0000","8276","3654","4622","121","8397","28593","32372","29.37","12.78"
"10","007","00","230","0001","0000","252","86","166","5","257","928","0","27.69","9.27"
"10","007","00","230","0001","1027","252","86","166","5","257","928","0","27.69","9.27"
"10","007","00","230","0002","0000","145","64","81","4","149","395","0","37.72","16.20"
"10","007","00","230","0002","1028","145","64","81","4","149","395","0","37.72","16.20"
"10","007","00","230","0003","0000","224","124","100","2","226","735","0","30.75","16.87"
"10","007","00","230","0003","1029","224","124","100","2","226","735","0","30.75","16.87"
"10","007","00","230","0004","0000","132","61","71","2","134","522","0","25.67","11.69"
"10","007","00","230","0004","1030","132","61","71","2","134","522","0","25.67","11.69"
"10","007","00","230","0005","0000","231","128","103","3","234","949","0","24.66","13.49"
"10","007","00","230","0005","1031","231","128","103","3","234","949","0","24.66","13.49"
"10","007","00","230","0006","0000","673","313","360","7","680","2090","0","32.54","14.98"
"10","007","00","230","0006","1032","396","188","208","5","401","1248","0","32.13","15.06"
"10","007","00","230","0006","1033","277","125","152","2","279","842","0","33.14","14.85"
"10","007","00","230","0007","0000","407","203","204","3","410","1329","0","30.85","15.27"
"10","007","00","230","0007","1034","195","107","88","1","196","696","0","28.16","15.37"
"10","007","00","230","0007","1035","212","96","116","2","214","633","0","33.81","15.17"
"10","007","00","230","0008","0000","102","47","55","2","104","475","0","21.89","9.89"
"10","007","00","230","0008","1051","102","47","55","2","104","475","0","21.89","9.89"
"10","007","00","230","0009","0000","175","87","88","6","181","630","0","28.73","13.81"
"10","007","00","230","0009","1037","175","87","88","6","181","630","0","28.73","13.81"
"10","007","00","230","0010","0000","218","131","87","3","221","785","0","28.15","16.69"
"10","007","00","230","0010","1038","218","131","87","3","221","785","0","28.15","16.69"
"10","007","00","230","0011","0000","226","115","111","7","233","973","0","23.95","11.82"
"10","007","00","230","0011","1039","226","115","111","7","233","973","0","23.95","11.82"
"10","007","00","230","0012","0000","181","84","97","3","184","575","0","32.00","14.61"
"10","007","00","230","0012","1040","181","84","97","3","184","575","0","32.00","14.61"
"10","007","00","230","0013","0000","171","78","93","3","174","557","0","31.24","14.00"
"10","007","00","230","0013","1041","171","78","93","3","174","557","0","31.24","14.00"
"10","007","00","230","0014","0000","197","71","126","5","202","769","0","26.27","9.23"
"10","007","00","230","0014","1036","197","71","126","5","202","769","0","26.27","9.23"
"10","007","00","230","0015","0000","641","206","435","9","650","2116","0","30.72","9.74"
"10","007","00","230","0015","1042","340","93","247","7","347","1068","0","32.49","8.71"
"10","007","00","230","0015","1043","301","113","188","2","303","1048","0","28.91","10.78"
"10","007","00","230","0016","0000","243","70","173","5","248","673","0","36.85","10.40"
"10","007","00","230","0016","1044","243","70","173","5","248","673","0","36.85","10.40"
"10","007","00","230","0017","0000","210","86","124","5","215","727","0","29.57","11.83"
"10","007","00","230","0017","1045","210","86","124","5","215","727","0","29.57","11.83"
"10","007","00","230","0018","0000","214","78","136","2","216","665","0","32.48","11.73"
"10","007","00","230","0018","1048","214","78","136","2","216","665","0","32.48","11.73"
"10","007","00","230","0019","0000","375","124","251","4","379","1278","0","29.66","9.70"
"10","007","00","230","0019","1046","157","54","103","2","159","572","0","27.80","9.44"
"10","007","00","230","0019","1047","218","70","148","2","220","706","0","31.16","9.92"
"10","007","00","230","0020","0000","490","192","298","5","495","1656","0","29.89","11.59"
"10","007","00","230","0020","1049","226","109","117","3","229","897","0","25.53","12.15"
"10","007","00","230","0020","1050","264","83","181","2","266","759","0","35.05","10.94"
"10","007","00","230","0021","0000","448","223","225","2","450","1420","0","31.69","15.70"
"10","007","00","230","0021","1052","348","162","186","2","350","1103","0","31.73","14.69"
"10","007","00","230","0021","1053","100","61","39","0","100","317","0","31.55","19.24"
"10","007","00","230","0022","0000","234","107","127","3","237","1062","0","22.32","10.08"
"10","007","00","230","0022","1057","234","107","127","3","237","1062","0","22.32","10.08"
"10","007","00","230","0023","0000","589","261","328","3","592","2059","0","28.75","12.68"
"10","007","00","230","0023","1054","299","140","159","2","301","1100","0","27.36","12.73"
"10","007","00","230","0023","1055","290","121","169","1","291","959","0","30.34","12.62"
"10","007","00","230","0024","0000","215","116","99","7","222","762","0","29.13","15.22"
"10","007","00","230","0024","1056","215","116","99","7","222","762","0","29.13","15.22"
"10","007","00","230","0025","0000","331","142","189","8","339","1304","0","26.00","10.89"
"10","007","00","230","0025","1058","159","85","74","4","163","558","0","29.21","15.23"
"10","007","00","230","0025","1059","172","57","115","4","176","746","0","23.59","7.64"
"10","007","00","230","0026","0000","952","457","495","13","965","3159","0","30.55","14.47"
"10","007","00","230","0026","1060","271","129","142","2","273","865","0","31.56","14.91"
"10","007","00","230","0026","1061","376","172","204","5","381","1194","0","31.91","14.41"
"10","007","00","230","0026","1062","305","156","149","6","311","1100","0","28.27","14.18"
"10","007","00","240","0000","0000","3801","2111","1690","86","3887","14194","15893","27.38","14.87"
"10","007","00","240","0001","0000","313","125","188","5","318","1065","0","29.86","11.74"
"10","007","00","240","0001","1011","313","125","188","5","318","1065","0","29.86","11.74"
"10","007","00","240","0002","0000","313","189","124","8","321","1069","0","30.03","17.68"
"10","007","00","240","0002","1015","137","82","55","5","142","516","0","27.52","15.89"
"10","007","00","240","0002","1016","176","107","69","3","179","553","0","32.37","19.35"
"10","007","00","240","0003","0000","375","216","159","8","383","1296","0","29.55","16.67"
"10","007","00","240","0003","1013","375","216","159","8","383","1296","0","29.55","16.67"
"10","007","00","240","0004","0000","222","124","98","4","226","798","0","28.32","15.54"
"10","007","00","240","0004","1014","222","124","98","4","226","798","0","28.32","15.54"
"10","007","00","240","0005","0000","337","198","139","4","341","929","0","36.71","21.31"
"10","007","00","240","0005","1012","337","198","139","4","341","929","0","36.71","21.31"
"10","007","00","240","0006","0000","225","132","93","6","231","1048","0","22.04","12.60"
"10","007","00","240","0006","1022","225","132","93","6","231","1048","0","22.04","12.60"
"10","007","00","240","0007","0000","315","167","148","3","318","1256","0","25.32","13.30"
"10","007","00","240","0007","1010","315","167","148","3","318","1256","0","25.32","13.30"
"10","007","00","240","0008","0000","163","92","71","6","169","662","0","25.53","13.90"
"10","007","00","240","0008","1017","163","92","71","6","169","662","0","25.53","13.90"
"10","007","00","240","0009","0000","182","98","84","1","183","663","0","27.60","14.78"
"10","007","00","240","0009","1025","182","98","84","1","183","663","0","27.60","14.78"
"10","007","00","240","0010","0000","301","182","119","9","310","1045","0","29.67","17.42"
"10","007","00","240","0010","1018","108","70","38","2","110","373","0","29.49","18.77"
"10","007","00","240","0010","1019","193","112","81","7","200","672","0","29.76","16.67"
"10","007","00","240","0011","0000","223","113","110","7","230","861","0","26.71","13.12"
"10","007","00","240","0011","1026","223","113","110","7","230","861","0","26.71","13.12"
"10","007","00","240","0012","0000","275","172","103","3","278","1164","0","23.88","14.78"
"10","007","00","240","0012","1023","275","172","103","3","278","1164","0","23.88","14.78"
"10","007","00","240","0013","0000","236","152","84","8","244","867","0","28.14","17.53"
"10","007","00","240","0013","1024","236","152","84","8","244","867","0","28.14","17.53"
"10","007","00","240","0014","0000","213","88","125","7","220","845","0","26.04","10.41"
"10","007","00","240","0014","1020","213","88","125","7","220","845","0","26.04","10.41"
"10","007","00","240","0015","0000","108","63","45","7","115","626","0","18.37","10.06"
"10","007","00","240","0015","1021","108","63","45","7","115","626","0","18.37","10.06"
"10","007","00","250","0000","0000","4030","1743","2287","48","4078","12543","14669","32.51","13.90"
"10","007","00","250","0001","0000","385","202","183","5","390","1148","0","33.97","17.60"
"10","007","00","250","0001","1063","385","202","183","5","390","1148","0","33.97","17.60"
"10","007","00","250","0002","0000","643","355","288","5","648","1936","0","33.47","18.34"
"10","007","00","250","0002","1064","312","162","150","3","315","968","0","32.54","16.74"
"10","007","00","250","0002","1065","331","193","138","2","333","968","0","34.40","19.94"
"10","007","00","250","0003","0000","230","108","122","7","237","699","0","33.91","15.45"
"10","007","00","250","0003","1066","230","108","122","7","237","699","0","33.91","15.45"
"10","007","00","250","0004","0000","220","120","100","1","221","753","0","29.35","15.94"
"10","007","00","250","0004","1067","220","120","100","1","221","753","0","29.35","15.94"
"10","007","00","250","0005","0000","464","160","304","7","471","1527","0","30.84","10.48"
"10","007","00","250","0005","1068","233","76","157","3","236","771","0","30.61","9.86"
"10","007","00","250","0005","1069","231","84","147","4","235","756","0","31.08","11.11"
"10","007","00","250","0006","0000","210","72","138","1","211","641","0","32.92","11.23"
"10","007","00","250","0006","1070","210","72","138","1","211","641","0","32.92","11.23"
"10","007","00","250","0007","0000","325","149","176","3","328","1052","0","31.18","14.16"
"10","007","00","250","0007","1071","325","149","176","3","328","1052","0","31.18","14.16"
"10","007","00","250","0008","0000","349","138","211","3","352","1083","0","32.50","12.74"
"10","007","00","250","0008","1072","349","138","211","3","352","1083","0","32.50","12.74"
"10","007","00","250","0009","0000","173","61","112","1","174","471","0","36.94","12.95"
"10","007","00","250","0009","1073","173","61","112","1","174","471","0","36.94","12.95"
"10","007","00","250","0010","0000","236","102","134","2","238","785","0","30.32","12.99"
"10","007","00","250","0010","1074","236","102","134","2","238","785","0","30.32","12.99"
"10","007","00","250","0011","0000","217","95","122","3","220","626","0","35.14","15.18"
"10","007","00","250","0011","1075","217","95","122","3","220","626","0","35.14","15.18"
"10","007","00","250","0012","0000","186","52","134","3","189","536","0","35.26","9.70"
"10","007","00","250","0012","1076","186","52","134","3","189","536","0","35.26","9.70"
"10","007","00","250","0013","0000","245","79","166","6","251","750","0","33.47","10.53"
"10","007","00","250","0013","1077","245","79","166","6","251","750","0","33.47","10.53"
"10","007","00","250","0014","0000","147","50","97","1","148","536","0","27.61","9.33"
"10","007","00","250","0014","1078","147","50","97","1","148","536","0","27.61","9.33"
"10","007","00","260","0000","0000","8288","3285","5003","120","8408","25072","28983","33.54","13.10"
"10","007","00","260","0001","0000","600","258","342","4","604","1828","0","33.04","14.11"
"10","007","00","260","0001","0939","282","128","154","2","284","777","0","36.55","16.47"
"10","007","00","260","0001","0940","318","130","188","2","320","1051","0","30.45","12.37"
"10","007","00","260","0002","0000","498","212","286","6","504","1430","0","35.24","14.83"
"10","007","00","260","0002","0949","271","124","147","3","274","702","0","39.03","17.66"
"10","007","00","260","0002","0950","227","88","139","3","230","728","0","31.59","12.09"
"10","007","00","260","0003","0000","299","145","154","3","302","1131","0","26.70","12.82"
"10","007","00","260","0003","0955","299","145","154","3","302","1131","0","26.70","12.82"
"10","007","00","260","0004","0000","487","131","356","7","494","1499","0","32.96","8.74"
"10","007","00","260","0004","0966","193","50","143","2","195","675","0","28.89","7.41"
"10","007","00","260","0004","0967","294","81","213","5","299","824","0","36.29","9.83"
"10","007","00","260","0005","0000","247","95","152","6","253","699","0","36.19","13.59"
"10","007","00","260","0005","0941","247","95","152","6","253","699","0","36.19","13.59"
"10","007","00","260","0006","0000","464","202","262","5","469","1461","0","32.10","13.83"
"10","007","00","260","0006","0951","252","124","128","3","255","786","0","32.44","15.78"
"10","007","00","260","0006","0952","212","78","134","2","214","675","0","31.70","11.56"
"10","007","00","260","0007","0000","249","113","136","5","254","813","0","31.24","13.90"
"10","007","00","260","0007","0961","249","113","136","5","254","813","0","31.24","13.90"
"10","007","00","260","0008","0000","364","116","248","0","364","839","0","43.38","13.83"
"10","007","00","260","0008","0942","364","116","248","0","364","839","0","43.38","13.83"
"10","007","00","260","0009","0000","572","219","353","13","585","1977","0","29.59","11.08"
"10","007","00","260","0009","0953","327","120","207","8","335","1065","0","31.46","11.27"
"10","007","00","260","0009","0954","245","99","146","5","250","912","0","27.41","10.86"
"10","007","00","260","0010","0000","197","74","123","4","201","693","0","29.00","10.68"
"10","007","00","260","0010","0962","197","74","123","4","201","693","0","29.00","10.68"
"10","007","00","260","0011","0000","584","261","323","7","591","1516","0","38.98","17.22"
"10","007","00","260","0011","0943","260","113","147","1","261","632","0","41.30","17.88"
"10","007","00","260","0011","0944","324","148","176","6","330","884","0","37.33","16.74"
"10","007","00","260","0012","0000","512","210","302","2","514","1799","0","28.57","11.67"
"10","007","00","260","0012","0956","242","90","152","1","243","937","0","25.93","9.61"
"10","007","00","260","0012","0957","270","120","150","1","271","862","0","31.44","13.92"
"10","007","00","260","0013","0000","251","101","150","6","257","831","0","30.93","12.15"
"10","007","00","260","0013","0963","251","101","150","6","257","831","0","30.93","12.15"
"10","007","00","260","0014","0000","660","307","353","9","669","1827","0","36.62","16.80"
"10","007","00","260","0014","0945","340","164","176","5","345","959","0","35.97","17.10"
"10","007","00","260","0014","0946","320","143","177","4","324","868","0","37.33","16.47"
"10","007","00","260","0015","0000","546","181","365","12","558","1863","0","29.95","9.72"
"10","007","00","260","0015","0958","262","94","168","7","269","852","0","31.57","11.03"
"10","007","00","260","0015","0959","284","87","197","5","289","1011","0","28.59","8.61"
"10","007","00","260","0016","0000","435","183","252","11","446","1255","0","35.54","14.58"
"10","007","00","260","0016","0965","435","183","252","11","446","1255","0","35.54","14.58"
"10","007","00","260","0017","0000","716","257","459","9","725","1915","0","37.86","13.42"
"10","007","00","260","0017","0947","388","100","288","3","391","1077","0","36.30","9.29"
"10","007","00","260","0017","0948","328","157","171","6","334","838","0","39.86","18.74"
"10","007","00","260","0018","0000","279","152","127","8","287","850","0","33.76","17.88"
"10","007","00","260","0018","0960","279","152","127","8","287","850","0","33.76","17.88"
"10","007","00","260","0019","0000","328","68","260","3","331","846","0","39.13","8.04"
"10","007","00","260","0019","0964","328","68","260","3","331","846","0","39.13","8.04"
"10","008","00","000","0000","0000","155893","84360","71533","1669","157562","420687","487743","37.45","20.05"
"10","008","00","010","0000","0000","34693","19495","15198","298","34991","83549","98736","41.88","23.33"
"10","008","00","010","0001","0000","379","196","183","2","381","910","0","41.87","21.54"
"10","008","00","010","0001","0001","379","196","183","2","381","910","0","41.87","21.54"
"10","008","00","010","0002","0000","638","345","293","2","640","1370","0","46.72","25.18"
"10","008","00","010","0002","0002","312","176","136","1","313","624","0","50.16","28.21"
"10","008","00","010","0002","0003","326","169","157","1","327","746","0","43.83","22.65"
"10","008","00","010","0003","0000","333","177","156","0","333","772","0","43.13","22.93"
"10","008","00","010","0003","0004","333","177","156","0","333","772","0","43.13","22.93"
"10","008","00","010","0004","0000","258","109","149","2","260","486","0","53.50","22.43"
"10","008","00","010","0004","0005","258","109","149","2","260","486","0","53.50","22.43"
"10","008","00","010","0005","0000","262","118","144","1","263","574","0","45.82","20.56"
"10","008","00","010","0005","0006","262","118","144","1","263","574","0","45.82","20.56"
"10","008","00","010","0006","0000","194","86","108","2","196","366","0","53.55","23.50"
"10","008","00","010","0006","0007","194","86","108","2","196","366","0","53.55","23.50"
"10","008","00","010","0007","0000","426","218","208","3","429","933","0","45.98","23.37"
"10","008","00","010","0007","0008","426","218","208","3","429","933","0","45.98","23.37"
"10","008","00","010","0008","0000","1090","553","537","8","1098","2566","0","42.79","21.55"
"10","008","00","010","0008","0058","563","269","294","2","565","1347","0","41.95","19.97"
"10","008","00","010","0008","0059","527","284","243","6","533","1219","0","43.72","23.30"
"10","008","00","010","0009","0000","2824","1560","1264","27","2851","7006","0","40.69","22.27"
"10","008","00","010","0009","0060","512","315","197","4","516","1201","0","42.96","26.23"
"10","008","00","010","0009","0061","484","261","223","3","487","1305","0","37.32","20.00"
"10","008","00","010","0009","0062","430","211","219","4","434","1047","0","41.45","20.15"
"10","008","00","010","0009","0063","420","222","198","4","424","1029","0","41.21","21.57"
"10","008","00","010","0009","0064","503","304","199","9","512","1311","0","39.05","23.19"
"10","008","00","010","0009","0065","475","247","228","3","478","1113","0","42.95","22.19"
"10","008","00","010","0010","0000","1711","945","766","14","1725","4577","0","37.69","20.65"
"10","008","00","010","0010","0032","486","262","224","3","489","1326","0","36.88","19.76"
"10","008","00","010","0010","0033","546","294","252","5","551","1402","0","39.30","20.97"
"10","008","00","010","0010","0034","537","302","235","5","542","1497","0","36.21","20.17"
"10","008","00","010","0010","0035","142","87","55","1","143","352","0","40.63","24.72"
"10","008","00","010","0011","0000","146","70","76","4","150","376","0","39.89","18.62"
"10","008","00","010","0011","0036","146","70","76","4","150","376","0","39.89","18.62"
"10","008","00","010","0012","0000","2441","1346","1095","15","2456","6024","0","40.77","22.34"
"10","008","00","010","0012","0022","367","190","177","2","369","983","0","37.54","19.33"
"10","008","00","010","0012","0023","337","217","120","4","341","843","0","40.45","25.74"
"10","008","00","010","0012","0024","405","218","187","3","408","931","0","43.82","23.42"
"10","008","00","010","0012","0025","462","235","227","2","464","1121","0","41.39","20.96"
"10","008","00","010","0012","0026","428","227","201","2","430","980","0","43.88","23.16"
"10","008","00","010","0012","0027","442","259","183","2","444","1166","0","38.08","22.21"
"10","008","00","010","0013","0000","850","367","483","11","861","2053","0","41.94","17.88"
"10","008","00","010","0013","0028","240","109","131","5","245","597","0","41.04","18.26"
"10","008","00","010","0013","0029","301","119","182","6","307","745","0","41.21","15.97"
"10","008","00","010","0013","0030","309","139","170","0","309","711","0","43.46","19.55"
"10","008","00","010","0014","0000","405","205","200","5","410","1008","0","40.67","20.34"
"10","008","00","010","0014","0031","405","205","200","5","410","1008","0","40.67","20.34"
"10","008","00","010","0015","0000","2211","1282","929","23","2234","5330","0","41.91","24.05"
"10","008","00","010","0015","0009","501","253","248","4","505","1174","0","43.02","21.55"
"10","008","00","010","0015","0010","598","371","227","10","608","1511","0","40.24","24.55"
"10","008","00","010","0015","0011","486","288","198","4","490","1193","0","41.07","24.14"
"10","008","00","010","0015","0012","626","370","256","5","631","1452","0","43.46","25.48"
"10","008","00","010","0016","0000","1248","679","569","11","1259","2691","0","46.79","25.23"
"10","008","00","010","0016","0013","444","249","195","8","452","1023","0","44.18","24.34"
"10","008","00","010","0016","0014","299","175","124","2","301","653","0","46.09","26.80"
"10","008","00","010","0016","0015","505","255","250","1","506","1015","0","49.85","25.12"
"10","008","00","010","0017","0000","794","334","460","5","799","2109","0","37.89","15.84"
"10","008","00","010","0017","0016","424","171","253","1","425","1134","0","37.48","15.08"
"10","008","00","010","0017","0017","370","163","207","4","374","975","0","38.36","16.72"
"10","008","00","010","0018","0000","1667","901","766","18","1685","4405","0","38.25","20.45"
"10","008","00","010","0018","0018","502","291","211","6","508","1080","0","47.04","26.94"
"10","008","00","010","0018","0019","366","217","149","2","368","992","0","37.10","21.88"
"10","008","00","010","0018","0020","416","188","228","5","421","1115","0","37.76","16.86"
"10","008","00","010","0018","0021","383","205","178","5","388","1218","0","31.86","16.83"
"10","008","00","010","0019","0000","677","361","316","7","684","1866","0","36.66","19.35"
"10","008","00","010","0019","0083","333","154","179","4","337","977","0","34.49","15.76"
"10","008","00","010","0019","0084","344","207","137","3","347","889","0","39.03","23.28"
"10","008","00","010","0020","0000","254","118","136","7","261","779","0","33.50","15.15"
"10","008","00","010","0020","0081","254","118","136","7","261","779","0","33.50","15.15"
"10","008","00","010","0021","0000","196","63","133","6","202","606","0","33.33","10.40"
"10","008","00","010","0021","0082","196","63","133","6","202","606","0","33.33","10.40"
"10","008","00","010","0022","0000","341","121","220","4","345","1073","0","32.15","11.28"
"10","008","00","010","0022","0080","341","121","220","4","345","1073","0","32.15","11.28"
"10","008","00","010","0023","0000","2039","1075","964","11","2050","5387","0","38.05","19.96"
"10","008","00","010","0023","0066","568","298","270","2","570","1398","0","40.77","21.32"
"10","008","00","010","0023","0067","422","220","202","1","423","1058","0","39.98","20.79"
"10","008","00","010","0023","0068","592","316","276","4","596","1529","0","38.98","20.67"
"10","008","00","010","0023","0069","457","241","216","4","461","1402","0","32.88","17.19"
"10","008","00","010","0024","0000","1782","971","811","14","1796","4997","0","35.94","19.43"
"10","008","00","010","0024","0070","415","218","197","4","419","1057","0","39.64","20.62"
"10","008","00","010","0024","0071","458","228","230","2","460","1248","0","36.86","18.27"
"10","008","00","010","0024","0072","369","200","169","5","374","1272","0","29.40","15.72"
"10","008","00","010","0024","0073","540","325","215","3","543","1420","0","38.24","22.89"
"10","008","00","010","0025","0000","1100","567","533","4","1104","2815","0","39.22","20.14"
"10","008","00","010","0025","0074","346","189","157","1","347","823","0","42.16","22.96"
"10","008","00","010","0025","0075","377","191","186","0","377","973","0","38.75","19.63"
"10","008","00","010","0025","0076","377","187","190","3","380","1019","0","37.29","18.35"
"10","008","00","010","0026","0000","1133","546","587","9","1142","3015","0","37.88","18.11"
"10","008","00","010","0026","0077","365","178","187","1","366","957","0","38.24","18.60"
"10","008","00","010","0026","0078","389","182","207","4","393","997","0","39.42","18.25"
"10","008","00","010","0026","0079","379","186","193","4","383","1061","0","36.10","17.53"
"10","008","00","010","0027","0000","3077","2119","958","27","3104","5877","0","52.82","36.06"
"10","008","00","010","0027","0039","454","277","177","5","459","926","0","49.57","29.91"
"10","008","00","010","0027","0040","480","308","172","5","485","944","0","51.38","32.63"
"10","008","00","010","0027","0041","542","392","150","5","547","1015","0","53.89","38.62"
"10","008","00","010","0027","0042","576","425","151","2","578","1058","0","54.63","40.17"
"10","008","00","010","0027","0043","576","406","170","5","581","1079","0","53.85","37.63"
"10","008","00","010","0027","0044","449","311","138","5","454","855","0","53.10","36.37"
"10","008","00","010","0028","0000","1074","617","457","10","1084","2381","0","45.53","25.91"
"10","008","00","010","0028","0037","515","290","225","4","519","1124","0","46.17","25.80"
"10","008","00","010","0028","0038","559","327","232","6","565","1257","0","44.95","26.01"
"10","008","00","010","0029","0000","2960","1877","1083","23","2983","6642","0","44.91","28.26"
"10","008","00","010","0029","0045","489","274","215","4","493","1203","0","40.98","22.78"
"10","008","00","010","0029","0046","505","313","192","9","514","1115","0","46.10","28.07"
"10","008","00","010","0029","0047","585","354","231","5","590","1266","0","46.60","27.96"
"10","008","00","010","0029","0048","476","325","151","1","477","1095","0","43.56","29.68"
"10","008","00","010","0029","0049","625","453","172","1","626","1318","0","47.50","34.37"
"10","008","00","010","0029","0050","280","158","122","3","283","645","0","43.88","24.50"
"10","008","00","010","0030","0000","566","292","274","8","574","1402","0","40.94","20.83"
"10","008","00","010","0030","0051","277","130","147","4","281","688","0","40.84","18.90"
"10","008","00","010","0030","0052","289","162","127","4","293","714","0","41.04","22.69"
"10","008","00","010","0031","0000","360","292","68","3","363","738","0","49.19","39.57"
"10","008","00","010","0031","0057","360","292","68","3","363","738","0","49.19","39.57"
"10","008","00","010","0032","0000","502","410","92","7","509","993","0","51.26","41.29"
"10","008","00","010","0032","0054","224","186","38","2","226","469","0","48.19","39.66"
"10","008","00","010","0032","0055","278","224","54","5","283","524","0","54.01","42.75"
"10","008","00","010","0033","0000","468","387","81","2","470","908","0","51.76","42.62"
"10","008","00","010","0033","0056","468","387","81","2","470","908","0","51.76","42.62"
"10","008","00","010","0034","0000","287","188","99","3","290","514","0","56.42","36.58"
"10","008","00","010","0034","0053","287","188","99","3","290","514","0","56.42","36.58"
"10","008","00","020","0000","0000","24669","13897","10772","253","24922","67679","78732","36.82","20.53"
"10","008","00","020","0001","0000","1088","610","478","17","1105","2573","0","42.95","23.71"
"10","008","00","020","0001","0085","319","175","144","4","323","788","0","40.99","22.21"
"10","008","00","020","0001","0086","329","196","133","5","334","757","0","44.12","25.89"
"10","008","00","020","0001","0087","440","239","201","8","448","1028","0","43.58","23.25"
"10","008","00","020","0002","0000","405","207","198","3","408","785","0","51.97","26.37"
"10","008","00","020","0002","0106","405","207","198","3","408","785","0","51.97","26.37"
"10","008","00","020","0003","0000","1102","600","502","6","1108","2927","0","37.85","20.50"
"10","008","00","020","0003","0103","358","187","171","1","359","840","0","42.74","22.26"
"10","008","00","020","0003","0104","318","159","159","2","320","957","0","33.44","16.61"
"10","008","00","020","0003","0105","426","254","172","3","429","1130","0","37.96","22.48"
"10","008","00","020","0004","0000","833","509","324","5","838","2457","0","34.11","20.72"
"10","008","00","020","0004","0107","373","228","145","3","376","1216","0","30.92","18.75"
"10","008","00","020","0004","0108","460","281","179","2","462","1241","0","37.23","22.64"
"10","008","00","020","0005","0000","803","471","332","14","817","2163","0","37.77","21.78"
"10","008","00","020","0005","0122","412","231","181","9","421","1106","0","38.07","20.89"
"10","008","00","020","0005","0123","391","240","151","5","396","1057","0","37.46","22.71"
"10","008","00","020","0006","0000","474","274","200","1","475","997","0","47.64","27.48"
"10","008","00","020","0006","0127","474","274","200","1","475","997","0","47.64","27.48"
"10","008","00","020","0007","0000","1275","737","538","10","1285","3608","0","35.62","20.43"
"10","008","00","020","0007","0124","446","271","175","3","449","1103","0","40.71","24.57"
"10","008","00","020","0007","0125","461","274","187","3","464","1244","0","37.30","22.03"
"10","008","00","020","0007","0126","368","192","176","4","372","1261","0","29.50","15.23"
"10","008","00","020","0008","0000","2128","1241","887","21","2149","5729","0","37.51","21.66"
"10","008","00","020","0008","0128","295","168","127","5","300","927","0","32.36","18.12"
"10","008","00","020","0008","0129","342","199","143","1","343","955","0","35.92","20.84"
"10","008","00","020","0008","0130","427","257","170","6","433","1008","0","42.96","25.50"
"10","008","00","020","0008","0131","334","179","155","2","336","859","0","39.12","20.84"
"10","008","00","020","0008","0132","369","228","141","3","372","972","0","38.27","23.46"
"10","008","00","020","0008","0133","361","210","151","4","365","1008","0","36.21","20.83"
"10","008","00","020","0009","0000","401","183","218","3","404","931","0","43.39","19.66"
"10","008","00","020","0009","0134","401","183","218","3","404","931","0","43.39","19.66"
"10","008","00","020","0010","0000","2613","1591","1022","24","2637","7501","0","35.16","21.21"
"10","008","00","020","0010","0090","448","276","172","1","449","1276","0","35.19","21.63"
"10","008","00","020","0010","0091","328","214","114","5","333","864","0","38.54","24.77"
"10","008","00","020","0010","0092","418","224","194","5","423","1323","0","31.97","16.93"
"10","008","00","020","0010","0093","522","340","182","3","525","1310","0","40.08","25.95"
"10","008","00","020","0010","0094","449","281","168","5","454","1424","0","31.88","19.73"
"10","008","00","020","0010","0095","448","256","192","5","453","1304","0","34.74","19.63"
"10","008","00","020","0011","0000","1123","599","524","8","1131","3785","0","29.88","15.83"
"10","008","00","020","0011","0096","319","165","154","2","321","1138","0","28.21","14.50"
"10","008","00","020","0011","0097","345","187","158","3","348","1195","0","29.12","15.65"
"10","008","00","020","0011","0098","177","96","81","2","179","522","0","34.29","18.39"
"10","008","00","020","0011","0099","282","151","131","1","283","930","0","30.43","16.24"
"10","008","00","020","0012","0000","326","170","156","3","329","1019","0","32.29","16.68"
"10","008","00","020","0012","0100","326","170","156","3","329","1019","0","32.29","16.68"
"10","008","00","020","0013","0000","373","192","181","8","381","1106","0","34.45","17.36"
"10","008","00","020","0013","0101","373","192","181","8","381","1106","0","34.45","17.36"
"10","008","00","020","0014","0000","393","221","172","6","399","1116","0","35.75","19.80"
"10","008","00","020","0014","0102","393","221","172","6","399","1116","0","35.75","19.80"
"10","008","00","020","0015","0000","352","214","138","4","356","1007","0","35.35","21.25"
"10","008","00","020","0015","0135","352","214","138","4","356","1007","0","35.35","21.25"
"10","008","00","020","0016","0000","111","57","54","0","111","298","0","37.25","19.13"
"10","008","00","020","0016","0136","111","57","54","0","111","298","0","37.25","19.13"
"10","008","00","020","0017","0000","412","232","180","3","415","1324","0","31.34","17.52"
"10","008","00","020","0017","0137","412","232","180","3","415","1324","0","31.34","17.52"
"10","008","00","020","0018","0000","493","298","195","3","496","1412","0","35.13","21.10"
"10","008","00","020","0018","0138","249","153","96","2","251","691","0","36.32","22.14"
"10","008","00","020","0018","0139","244","145","99","1","245","721","0","33.98","20.11"
"10","008","00","020","0019","0000","602","329","273","9","611","1701","0","35.92","19.34"
"10","008","00","020","0019","0140","281","147","134","5","286","769","0","37.19","19.12"
"10","008","00","020","0019","0141","321","182","139","4","325","932","0","34.87","19.53"
"10","008","00","020","0020","0000","457","267","190","2","459","1348","0","34.05","19.81"
"10","008","00","020","0020","0142","321","192","129","1","322","952","0","33.82","20.17"
"10","008","00","020","0020","0143","136","75","61","1","137","396","0","34.60","18.94"
"10","008","00","020","0021","0000","259","128","131","6","265","661","0","40.09","19.36"
"10","008","00","020","0021","0144","259","128","131","6","265","661","0","40.09","19.36"
"10","008","00","020","0022","0000","394","265","129","4","398","988","0","40.28","26.82"
"10","008","00","020","0022","0145","394","265","129","4","398","988","0","40.28","26.82"
"10","008","00","020","0023","0000","361","210","151","5","366","1132","0","32.33","18.55"
"10","008","00","020","0023","0148","361","210","151","5","366","1132","0","32.33","18.55"
"10","008","00","020","0024","0000","221","136","85","1","222","580","0","38.28","23.45"
"10","008","00","020","0024","0149","221","136","85","1","222","580","0","38.28","23.45"
"10","008","00","020","0025","0000","333","130","203","6","339","962","0","35.24","13.51"
"10","008","00","020","0025","0150","333","130","203","6","339","962","0","35.24","13.51"
"10","008","00","020","0026","0000","1009","500","509","10","1019","2818","0","36.16","17.74"
"10","008","00","020","0026","0151","345","166","179","4","349","924","0","37.77","17.97"
"10","008","00","020","0026","0152","314","163","151","4","318","898","0","35.41","18.15"
"10","008","00","020","0026","0153","350","171","179","2","352","996","0","35.34","17.17"
"10","008","00","020","0027","0000","618","336","282","5","623","1661","0","37.51","20.23"
"10","008","00","020","0027","0117","267","117","150","3","270","734","0","36.78","15.94"
"10","008","00","020","0027","0118","351","219","132","2","353","927","0","38.08","23.62"
"10","008","00","020","0028","0000","866","464","402","9","875","2570","0","34.05","18.05"
"10","008","00","020","0028","0119","403","244","159","4","407","1185","0","34.35","20.59"
"10","008","00","020","0028","0120","311","153","158","4","315","938","0","33.58","16.31"
"10","008","00","020","0028","0121","152","67","85","1","153","447","0","34.23","14.99"
"10","008","00","020","0029","0000","572","246","326","7","579","1597","0","36.26","15.40"
"10","008","00","020","0029","0146","461","201","260","6","467","1300","0","35.92","15.46"
"10","008","00","020","0029","0147","111","45","66","1","112","297","0","37.71","15.15"
"10","008","00","020","0030","0000","1296","760","536","17","1313","3098","0","42.38","24.53"
"10","008","00","020","0030","0109","400","243","157","5","405","972","0","41.67","25.00"
"10","008","00","020","0030","0110","457","274","183","4","461","1099","0","41.95","24.93"
"10","008","00","020","0030","0111","439","243","196","8","447","1027","0","43.52","23.66"
"10","008","00","020","0031","0000","1001","539","462","13","1014","2585","0","39.23","20.85"
"10","008","00","020","0031","0088","535","282","253","5","540","1326","0","40.72","21.27"
"10","008","00","020","0031","0089","466","257","209","8","474","1259","0","37.65","20.41"
"10","008","00","020","0032","0000","1117","665","452","14","1131","3170","0","35.68","20.98"
"10","008","00","020","0032","0112","378","236","142","9","387","1003","0","38.58","23.53"
"10","008","00","020","0032","0113","360","217","143","2","362","1062","0","34.09","20.43"
"10","008","00","020","0032","0114","379","212","167","3","382","1105","0","34.57","19.19"
"10","008","00","020","0033","0000","858","516","342","6","864","2070","0","41.74","24.93"
"10","008","00","020","0033","0115","419","262","157","2","421","1065","0","39.53","24.60"
"10","008","00","020","0033","0116","439","254","185","4","443","1005","0","44.08","25.27"
"10","008","00","030","0000","0000","33856","17840","16016","292","34148","83201","97262","41.04","21.44"
"10","008","00","030","0001","0000","901","528","373","11","912","2084","0","43.76","25.34"
"10","008","00","030","0001","0154","414","218","196","5","419","974","0","43.02","22.38"
"10","008","00","030","0001","0155","487","310","177","6","493","1110","0","44.41","27.93"
"10","008","00","030","0002","0000","923","501","422","5","928","2059","0","45.07","24.33"
"10","008","00","030","0002","0159","458","252","206","2","460","1055","0","43.60","23.89"
"10","008","00","030","0002","0160","465","249","216","3","468","1004","0","46.61","24.80"
"10","008","00","030","0003","0000","508","247","261","4","512","1084","0","47.23","22.79"
"10","008","00","030","0003","0162","508","247","261","4","512","1084","0","47.23","22.79"
"10","008","00","030","0004","0000","2490","1369","1121","24","2514","6414","0","39.20","21.34"
"10","008","00","030","0004","0165","473","257","216","11","484","1243","0","38.94","20.68"
"10","008","00","030","0004","0166","414","250","164","1","415","1222","0","33.96","20.46"
"10","008","00","030","0004","0167","483","242","241","5","488","1232","0","39.61","19.64"
"10","008","00","030","0004","0168","562","300","262","5","567","1456","0","38.94","20.60"
"10","008","00","030","0004","0169","558","320","238","2","560","1261","0","44.41","25.38"
"10","008","00","030","0005","0000","3343","2029","1314","22","3365","7515","0","44.78","27.00"
"10","008","00","030","0005","0170","593","330","263","8","601","1196","0","50.25","27.59"
"10","008","00","030","0005","0171","472","299","173","2","474","1226","0","38.66","24.39"
"10","008","00","030","0005","0172","536","328","208","4","540","1186","0","45.53","27.66"
"10","008","00","030","0005","0173","500","314","186","2","502","1172","0","42.83","26.79"
"10","008","00","030","0005","0174","636","408","228","3","639","1373","0","46.54","29.72"
"10","008","00","030","0005","0175","606","350","256","3","609","1362","0","44.71","25.70"
"10","008","00","030","0006","0000","2537","1308","1229","16","2553","6652","0","38.38","19.66"
"10","008","00","030","0006","0209","555","281","274","2","557","1568","0","35.52","17.92"
"10","008","00","030","0006","0210","495","261","234","3","498","1229","0","40.52","21.24"
"10","008","00","030","0006","0211","396","199","197","1","397","1022","0","38.85","19.47"
"10","008","00","030","0006","0212","336","158","178","2","338","1036","0","32.63","15.25"
"10","008","00","030","0006","0213","483","271","212","5","488","1141","0","42.77","23.75"
"10","008","00","030","0006","0214","272","138","134","3","275","656","0","41.92","21.04"
"10","008","00","030","0007","0000","2390","1211","1179","25","2415","6108","0","39.54","19.83"
"10","008","00","030","0007","0191","554","306","248","5","559","1372","0","40.74","22.30"
"10","008","00","030","0007","0192","491","257","234","6","497","1157","0","42.96","22.21"
"10","008","00","030","0007","0193","537","274","263","7","544","1334","0","40.78","20.54"
"10","008","00","030","0007","0194","324","155","169","1","325","868","0","37.44","17.86"
"10","008","00","030","0007","0195","484","219","265","6","490","1377","0","35.58","15.90"
"10","008","00","030","0008","0000","1594","798","796","25","1619","4032","0","40.15","19.79"
"10","008","00","030","0008","0196","418","231","187","7","425","1000","0","42.50","23.10"
"10","008","00","030","0008","0197","434","246","188","3","437","1068","0","40.92","23.03"
"10","008","00","030","0008","0198","344","153","191","8","352","1002","0","35.13","15.27"
"10","008","00","030","0008","0199","398","168","230","7","405","962","0","42.10","17.46"
"10","008","00","030","0009","0000","1677","829","848","16","1693","4524","0","37.42","18.32"
"10","008","00","030","0009","0182","379","189","190","6","385","1062","0","36.25","17.80"
"10","008","00","030","0009","0183","438","213","225","4","442","1070","0","41.31","19.91"
"10","008","00","030","0009","0184","412","209","203","2","414","1149","0","36.03","18.19"
"10","008","00","030","0009","0185","448","218","230","4","452","1243","0","36.36","17.54"
"10","008","00","030","0010","0000","1044","615","429","4","1048","2446","0","42.85","25.14"
"10","008","00","030","0010","0186","621","364","257","2","623","1415","0","44.03","25.72"
"10","008","00","030","0010","0187","423","251","172","2","425","1031","0","41.22","24.35"
"10","008","00","030","0011","0000","1209","644","565","13","1222","2862","0","42.70","22.50"
"10","008","00","030","0011","0188","479","257","222","3","482","1057","0","45.60","24.31"
"10","008","00","030","0011","0189","354","186","168","5","359","856","0","41.94","21.73"
"10","008","00","030","0011","0190","376","201","175","5","381","949","0","40.15","21.18"
"10","008","00","030","0012","0000","1427","823","604","9","1436","3175","0","45.23","25.92"
"10","008","00","030","0012","0179","531","302","229","5","536","1141","0","46.98","26.47"
"10","008","00","030","0012","0180","433","259","174","2","435","1011","0","43.03","25.62"
"10","008","00","030","0012","0181","463","262","201","2","465","1023","0","45.45","25.61"
"10","008","00","030","0013","0000","1450","788","662","9","1459","3702","0","39.41","21.29"
"10","008","00","030","0013","0200","441","220","221","2","443","1183","0","37.45","18.60"
"10","008","00","030","0013","0201","499","291","208","5","504","1114","0","45.24","26.12"
"10","008","00","030","0013","0202","510","277","233","2","512","1405","0","36.44","19.72"
"10","008","00","030","0014","0000","1186","513","673","13","1199","2951","0","40.63","17.38"
"10","008","00","030","0014","0206","408","175","233","4","412","950","0","43.37","18.42"
"10","008","00","030","0014","0207","320","146","174","5","325","965","0","33.68","15.13"
"10","008","00","030","0014","0208","458","192","266","4","462","1036","0","44.59","18.53"
"10","008","00","030","0015","0000","583","297","286","3","586","1502","0","39.01","19.77"
"10","008","00","030","0015","0205","583","297","286","3","586","1502","0","39.01","19.77"
"10","008","00","030","0016","0000","940","423","517","4","944","2217","0","42.58","19.08"
"10","008","00","030","0016","0203","390","182","208","1","391","919","0","42.55","19.80"
"10","008","00","030","0016","0204","550","241","309","3","553","1298","0","42.60","18.57"
"10","008","00","030","0017","0000","726","335","391","9","735","1858","0","39.56","18.03"
"10","008","00","030","0017","0215","285","140","145","3","288","689","0","41.80","20.32"
"10","008","00","030","0017","0216","260","103","157","1","261","668","0","39.07","15.42"
"10","008","00","030","0017","0217","181","92","89","5","186","501","0","37.13","18.36"
"10","008","00","030","0018","0000","895","348","547","9","904","2029","0","44.55","17.15"
"10","008","00","030","0018","0218","469","179","290","6","475","1159","0","40.98","15.44"
"10","008","00","030","0018","0219","426","169","257","3","429","870","0","49.31","19.43"
"10","008","00","030","0019","0000","1556","726","830","4","1560","4072","0","38.31","17.83"
"10","008","00","030","0019","0220","419","198","221","1","420","1100","0","38.18","18.00"
"10","008","00","030","0019","0221","373","165","208","1","374","933","0","40.09","17.68"
"10","008","00","030","0019","0222","353","181","172","1","354","956","0","37.03","18.93"
"10","008","00","030","0019","0223","411","182","229","1","412","1083","0","38.04","16.81"
"10","008","00","030","0020","0000","597","354","243","6","603","1658","0","36.37","21.35"
"10","008","00","030","0020","0225","241","156","85","4","245","641","0","38.22","24.34"
"10","008","00","030","0020","0226","356","198","158","2","358","1017","0","35.20","19.47"
"10","008","00","030","0021","0000","396","203","193","3","399","1017","0","39.23","19.96"
"10","008","00","030","0021","0224","396","203","193","3","399","1017","0","39.23","19.96"
"10","008","00","030","0022","0000","692","332","360","13","705","2247","0","31.38","14.78"
"10","008","00","030","0022","0228","359","170","189","8","367","1160","0","31.64","14.66"
"10","008","00","030","0022","0229","333","162","171","5","338","1087","0","31.09","14.90"
"10","008","00","030","0023","0000","404","230","174","7","411","1070","0","38.41","21.50"
"10","008","00","030","0023","0227","404","230","174","7","411","1070","0","38.41","21.50"
"10","008","00","030","0024","0000","309","165","144","3","312","664","0","46.99","24.85"
"10","008","00","030","0024","0161","309","165","144","3","312","664","0","46.99","24.85"
"10","008","00","030","0025","0000","1099","538","561","5","1104","2330","0","47.38","23.09"
"10","008","00","030","0025","0163","462","251","211","1","463","939","0","49.31","26.73"
"10","008","00","030","0025","0164","637","287","350","4","641","1391","0","46.08","20.63"
"10","008","00","030","0026","0000","1556","841","715","15","1571","3714","0","42.30","22.64"
"10","008","00","030","0026","0156","634","317","317","4","638","1402","0","45.51","22.61"
"10","008","00","030","0026","0157","402","197","205","3","405","1071","0","37.82","18.39"
"10","008","00","030","0026","0158","520","327","193","8","528","1241","0","42.55","26.35"
"10","008","00","030","0027","0000","1424","845","579","15","1439","3215","0","44.76","26.28"
"10","008","00","030","0027","0176","435","237","198","3","438","974","0","44.97","24.33"
"10","008","00","030","0027","0177","585","389","196","7","592","1331","0","44.48","29.23"
"10","008","00","030","0027","0178","404","219","185","5","409","910","0","44.95","24.07"
"10","008","00","040","0000","0000","16490","8254","8236","197","16687","46058","53033","36.23","17.92"
"10","008","00","040","0001","0000","848","449","399","8","856","1957","0","43.74","22.94"
"10","008","00","040","0001","0230","484","268","216","5","489","1155","0","42.34","23.20"
"10","008","00","040","0001","0231","364","181","183","3","367","802","0","45.76","22.57"
"10","008","00","040","0002","0000","231","114","117","2","233","614","0","37.95","18.57"
"10","008","00","040","0002","0232","231","114","117","2","233","614","0","37.95","18.57"
"10","008","00","040","0003","0000","1686","870","816","13","1699","4553","0","37.32","19.11"
"10","008","00","040","0003","0233","357","172","185","2","359","884","0","40.61","19.46"
"10","008","00","040","0003","0234","392","190","202","1","393","1127","0","34.87","16.86"
"10","008","00","040","0003","0235","419","234","185","7","426","1196","0","35.62","19.57"
"10","008","00","040","0003","0236","518","274","244","3","521","1346","0","38.71","20.36"
"10","008","00","040","0004","0000","1330","709","621","10","1340","3463","0","38.69","20.47"
"10","008","00","040","0004","0237","449","248","201","3","452","1131","0","39.96","21.93"
"10","008","00","040","0004","0238","413","203","210","3","416","1073","0","38.77","18.92"
"10","008","00","040","0004","0239","468","258","210","4","472","1259","0","37.49","20.49"
"10","008","00","040","0005","0000","645","326","319","7","652","1752","0","37.21","18.61"
"10","008","00","040","0005","0271","290","148","142","1","291","790","0","36.84","18.73"
"10","008","00","040","0005","0272","355","178","177","6","361","962","0","37.53","18.50"
"10","008","00","040","0006","0000","459","253","206","13","472","1189","0","39.70","21.28"
"10","008","00","040","0006","0245","198","101","97","7","205","490","0","41.84","20.61"
"10","008","00","040","0006","0246","261","152","109","6","267","699","0","38.20","21.75"
"10","008","00","040","0007","0000","1272","626","646","14","1286","3652","0","35.21","17.14"
"10","008","00","040","0007","0242","461","222","239","5","466","1279","0","36.43","17.36"
"10","008","00","040","0007","0243","443","241","202","7","450","1324","0","33.99","18.20"
"10","008","00","040","0007","0244","368","163","205","2","370","1049","0","35.27","15.54"
"10","008","00","040","0008","0000","325","103","222","4","329","894","0","36.80","11.52"
"10","008","00","040","0008","0247","325","103","222","4","329","894","0","36.80","11.52"
"10","008","00","040","0009","0000","449","231","218","6","455","1401","0","32.48","16.49"
"10","008","00","040","0009","0248","449","231","218","6","455","1401","0","32.48","16.49"
"10","008","00","040","0010","0000","333","178","155","6","339","878","0","38.61","20.27"
"10","008","00","040","0010","0273","141","65","76","4","145","367","0","39.51","17.71"
"10","008","00","040","0010","0274","192","113","79","2","194","511","0","37.96","22.11"
"10","008","00","040","0011","0000","955","433","522","14","969","2802","0","34.58","15.45"
"10","008","00","040","0011","0261","399","193","206","4","403","1293","0","31.17","14.93"
"10","008","00","040","0011","0262","356","180","176","6","362","944","0","38.35","19.07"
"10","008","00","040","0011","0263","200","60","140","4","204","565","0","36.11","10.62"
"10","008","00","040","0012","0000","536","255","281","7","543","1678","0","32.36","15.20"
"10","008","00","040","0012","0259","270","128","142","4","274","891","0","30.75","14.37"
"10","008","00","040","0012","0260","266","127","139","3","269","787","0","34.18","16.14"
"10","008","00","040","0013","0000","315","158","157","5","320","839","0","38.14","18.83"
"10","008","00","040","0013","0264","315","158","157","5","320","839","0","38.14","18.83"
"10","008","00","040","0014","0000","1718","865","853","14","1732","4860","0","35.64","17.80"
"10","008","00","040","0014","0252","481","247","234","1","482","1435","0","33.59","17.21"
"10","008","00","040","0014","0253","456","238","218","3","459","1289","0","35.61","18.46"
"10","008","00","040","0014","0254","395","203","192","4","399","1085","0","36.77","18.71"
"10","008","00","040","0014","0255","386","177","209","6","392","1051","0","37.30","16.84"
"10","008","00","040","0015","0000","594","280","314","8","602","1818","0","33.11","15.40"
"10","008","00","040","0015","0265","390","175","215","4","394","1171","0","33.65","14.94"
"10","008","00","040","0015","0266","204","105","99","4","208","647","0","32.15","16.23"
"10","008","00","040","0016","0000","471","224","247","7","478","1312","0","36.43","17.07"
"10","008","00","040","0016","0267","471","224","247","7","478","1312","0","36.43","17.07"
"10","008","00","040","0017","0000","377","169","208","7","384","1132","0","33.92","14.93"
"10","008","00","040","0017","0268","377","169","208","7","384","1132","0","33.92","14.93"
"10","008","00","040","0018","0000","233","123","110","2","235","595","0","39.50","20.67"
"10","008","00","040","0018","0269","233","123","110","2","235","595","0","39.50","20.67"
"10","008","00","040","0019","0000","131","75","56","1","132","422","0","31.28","17.77"
"10","008","00","040","0019","0251","131","75","56","1","132","422","0","31.28","17.77"
"10","008","00","040","0020","0000","178","84","94","5","183","577","0","31.72","14.56"
"10","008","00","040","0020","0270","178","84","94","5","183","577","0","31.72","14.56"
"10","008","00","040","0021","0000","219","136","83","4","223","591","0","37.73","23.01"
"10","008","00","040","0021","0275","75","57","18","2","77","194","0","39.69","29.38"
"10","008","00","040","0021","0276","144","79","65","2","146","397","0","36.78","19.90"
"10","008","00","040","0022","0000","214","107","107","2","216","733","0","29.47","14.60"
"10","008","00","040","0022","0277","133","71","62","0","133","454","0","29.30","15.64"
"10","008","00","040","0022","0278","81","36","45","2","83","279","0","29.75","12.90"
"10","008","00","040","0023","0000","179","95","84","1","180","562","0","32.03","16.90"
"10","008","00","040","0023","0280","179","95","84","1","180","562","0","32.03","16.90"
"10","008","00","040","0024","0000","161","88","73","1","162","446","0","36.32","19.73"
"10","008","00","040","0024","0279","161","88","73","1","162","446","0","36.32","19.73"
"10","008","00","040","0025","0000","223","103","120","10","233","865","0","26.94","11.91"
"10","008","00","040","0025","0281","129","61","68","7","136","486","0","27.98","12.55"
"10","008","00","040","0025","0282","94","42","52","3","97","379","0","25.59","11.08"
"10","008","00","040","0026","0000","262","119","143","4","266","674","0","39.47","17.66"
"10","008","00","040","0026","0249","80","41","39","0","80","217","0","36.87","18.89"
"10","008","00","040","0026","0250","182","78","104","4","186","457","0","40.70","17.07"
"10","008","00","040","0027","0000","1319","653","666","11","1330","3551","0","37.45","18.39"
"10","008","00","040","0027","0256","469","231","238","4","473","1284","0","36.84","17.99"
"10","008","00","040","0027","0257","377","178","199","3","380","1034","0","36.75","17.21"
"10","008","00","040","0027","0258","473","244","229","4","477","1233","0","38.69","19.79"
"10","008","00","040","0028","0000","827","428","399","11","838","2248","0","37.28","19.04"
"10","008","00","040","0028","0240","424","226","198","6","430","1079","0","39.85","20.95"
"10","008","00","040","0028","0241","403","202","201","5","408","1169","0","34.90","17.28"
"10","008","00","050","0000","0000","3390","1823","1567","48","3438","9241","10350","37.20","19.73"
"10","008","00","050","0001","0000","444","265","179","9","453","1076","0","42.10","24.63"
"10","008","00","050","0001","0283","444","265","179","9","453","1076","0","42.10","24.63"
"10","008","00","050","0002","0000","331","188","143","6","337","872","0","38.65","21.56"
"10","008","00","050","0002","0284","331","188","143","6","337","872","0","38.65","21.56"
"10","008","00","050","0003","0000","197","94","103","2","199","549","0","36.25","17.12"
"10","008","00","050","0003","0285","197","94","103","2","199","549","0","36.25","17.12"
"10","008","00","050","0004","0000","385","189","196","7","392","1141","0","34.36","16.56"
"10","008","00","050","0004","0286","205","103","102","6","211","611","0","34.53","16.86"
"10","008","00","050","0004","0287","180","86","94","1","181","530","0","34.15","16.23"
"10","008","00","050","0005","0000","161","67","94","3","164","463","0","35.42","14.47"
"10","008","00","050","0005","0288","161","67","94","3","164","463","0","35.42","14.47"
"10","008","00","050","0006","0000","173","91","82","1","174","472","0","36.86","19.28"
"10","008","00","050","0006","0289","173","91","82","1","174","472","0","36.86","19.28"
"10","008","00","050","0007","0000","339","202","137","7","346","877","0","39.45","23.03"
"10","008","00","050","0007","0290","339","202","137","7","346","877","0","39.45","23.03"
"10","008","00","050","0008","0000","520","279","241","5","525","1415","0","37.10","19.72"
"10","008","00","050","0008","0291","306","167","139","2","308","756","0","40.74","22.09"
"10","008","00","050","0008","0292","214","112","102","3","217","659","0","32.93","17.00"
"10","008","00","050","0009","0000","353","172","181","4","357","943","0","37.86","18.24"
"10","008","00","050","0009","0293","353","172","181","4","357","943","0","37.86","18.24"
"10","008","00","050","0010","0000","193","105","88","1","194","544","0","35.66","19.30"
"10","008","00","050","0010","0296","193","105","88","1","194","544","0","35.66","19.30"
"10","008","00","050","0011","0000","294","171","123","3","297","889","0","33.41","19.24"
"10","008","00","050","0011","0294","170","102","68","3","173","489","0","35.38","20.86"
"10","008","00","050","0011","0295","124","69","55","0","124","400","0","31.00","17.25"
"10","008","00","060","0000","0000","12248","5399","6849","160","12408","32758","37230","37.88","16.48"
"10","008","00","060","0001","0000","420","210","210","3","423","1008","0","41.96","20.83"
"10","008","00","060","0001","0297","420","210","210","3","423","1008","0","41.96","20.83"
"10","008","00","060","0002","0000","1320","623","697","14","1334","3391","0","39.34","18.37"
"10","008","00","060","0002","0298","364","166","198","5","369","906","0","40.73","18.32"
"10","008","00","060","0002","0299","284","127","157","5","289","701","0","41.23","18.12"
"10","008","00","060","0002","0300","332","155","177","4","336","862","0","38.98","17.98"
"10","008","00","060","0002","0301","340","175","165","0","340","922","0","36.88","18.98"
"10","008","00","060","0003","0000","764","376","388","11","775","2202","0","35.20","17.08"
"10","008","00","060","0003","0302","340","178","162","7","347","1043","0","33.27","17.07"
"10","008","00","060","0003","0303","424","198","226","4","428","1159","0","36.93","17.08"
"10","008","00","060","0004","0000","608","281","327","6","614","1540","0","39.87","18.25"
"10","008","00","060","0004","0304","300","139","161","2","302","788","0","38.32","17.64"
"10","008","00","060","0004","0305","308","142","166","4","312","752","0","41.49","18.88"
"10","008","00","060","0005","0000","316","137","179","6","322","978","0","32.92","14.01"
"10","008","00","060","0005","0307","316","137","179","6","322","978","0","32.92","14.01"
"10","008","00","060","0006","0000","367","147","220","11","378","957","0","39.50","15.36"
"10","008","00","060","0006","0306","367","147","220","11","378","957","0","39.50","15.36"
"10","008","00","060","0007","0000","1587","699","888","22","1609","4169","0","38.59","16.77"
"10","008","00","060","0007","0308","332","137","195","2","334","896","0","37.28","15.29"
"10","008","00","060","0007","0309","393","175","218","7","400","1011","0","39.56","17.31"
"10","008","00","060","0007","0310","383","164","219","3","386","1003","0","38.48","16.35"
"10","008","00","060","0007","0311","479","223","256","10","489","1259","0","38.84","17.71"
"10","008","00","060","0008","0000","589","269","320","13","602","1625","0","37.05","16.55"
"10","008","00","060","0008","0312","279","114","165","6","285","734","0","38.83","15.53"
"10","008","00","060","0008","0313","310","155","155","7","317","891","0","35.58","17.40"
"10","008","00","060","0009","0000","365","141","224","7","372","922","0","40.35","15.29"
"10","008","00","060","0009","0315","365","141","224","7","372","922","0","40.35","15.29"
"10","008","00","060","0010","0000","438","181","257","1","439","1233","0","35.60","14.68"
"10","008","00","060","0010","0316","438","181","257","1","439","1233","0","35.60","14.68"
"10","008","00","060","0011","0000","711","238","473","13","724","1828","0","39.61","13.02"
"10","008","00","060","0011","0318","355","109","246","8","363","949","0","38.25","11.49"
"10","008","00","060","0011","0319","356","129","227","5","361","879","0","41.07","14.68"
"10","008","00","060","0012","0000","308","108","200","2","310","900","0","34.44","12.00"
"10","008","00","060","0012","0320","308","108","200","2","310","900","0","34.44","12.00"
"10","008","00","060","0013","0000","251","88","163","0","251","729","0","34.43","12.07"
"10","008","00","060","0013","0317","251","88","163","0","251","729","0","34.43","12.07"
"10","008","00","060","0014","0000","344","132","212","4","348","911","0","38.20","14.49"
"10","008","00","060","0014","0323","344","132","212","4","348","911","0","38.20","14.49"
"10","008","00","060","0015","0000","456","190","266","4","460","1160","0","39.66","16.38"
"10","008","00","060","0015","0321","280","125","155","2","282","641","0","43.99","19.50"
"10","008","00","060","0015","0322","176","65","111","2","178","519","0","34.30","12.52"
"10","008","00","060","0016","0000","533","220","313","6","539","1538","0","35.05","14.30"
"10","008","00","060","0016","0324","371","165","206","5","376","1102","0","34.12","14.97"
"10","008","00","060","0016","0325","162","55","107","1","163","436","0","37.39","12.61"
"10","008","00","060","0017","0000","571","234","337","5","576","1468","0","39.24","15.94"
"10","008","00","060","0017","0326","347","139","208","4","351","868","0","40.44","16.01"
"10","008","00","060","0017","0327","224","95","129","1","225","600","0","37.50","15.83"
"10","008","00","060","0018","0000","420","172","248","6","426","1137","0","37.47","15.13"
"10","008","00","060","0018","0328","420","172","248","6","426","1137","0","37.47","15.13"
"10","008","00","060","0019","0000","325","131","194","3","328","845","0","38.82","15.50"
"10","008","00","060","0019","0330","325","131","194","3","328","845","0","38.82","15.50"
"10","008","00","060","0020","0000","317","198","119","4","321","874","0","36.73","22.65"
"10","008","00","060","0020","0329","317","198","119","4","321","874","0","36.73","22.65"
"10","008","00","060","0021","0000","294","156","138","9","303","739","0","41.00","21.11"
"10","008","00","060","0021","0331","294","156","138","9","303","739","0","41.00","21.11"
"10","008","00","060","0022","0000","611","278","333","7","618","1737","0","35.58","16.00"
"10","008","00","060","0022","0332","285","116","169","2","287","761","0","37.71","15.24"
"10","008","00","060","0022","0333","326","162","164","5","331","976","0","33.91","16.60"
"10","008","00","060","0023","0000","333","190","143","3","336","867","0","38.75","21.91"
"10","008","00","060","0023","0314","333","190","143","3","336","867","0","38.75","21.91"
"10","008","00","070","0000","0000","5317","2915","2402","68","5385","15417","16983","34.93","18.91"
"10","008","00","070","0001","0000","658","339","319","5","663","1813","0","36.57","18.70"
"10","008","00","070","0001","0334","333","194","139","3","336","910","0","36.92","21.32"
"10","008","00","070","0001","0335","325","145","180","2","327","903","0","36.21","16.06"
"10","008","00","070","0002","0000","489","276","213","9","498","1402","0","35.52","19.69"
"10","008","00","070","0002","0350","235","140","95","5","240","709","0","33.85","19.75"
"10","008","00","070","0002","0351","254","136","118","4","258","693","0","37.23","19.62"
"10","008","00","070","0003","0000","465","284","181","5","470","1294","0","36.32","21.95"
"10","008","00","070","0003","0336","319","197","122","3","322","854","0","37.70","23.07"
"10","008","00","070","0003","0337","146","87","59","2","148","440","0","33.64","19.77"
"10","008","00","070","0004","0000","688","402","286","6","694","1909","0","36.35","21.06"
"10","008","00","070","0004","0338","310","191","119","1","311","807","0","38.54","23.67"
"10","008","00","070","0004","0339","378","211","167","5","383","1102","0","34.75","19.15"
"10","008","00","070","0005","0000","327","187","140","9","336","997","0","33.70","18.76"
"10","008","00","070","0005","0344","166","94","72","6","172","559","0","30.77","16.82"
"10","008","00","070","0005","0345","161","93","68","3","164","438","0","37.44","21.23"
"10","008","00","070","0006","0000","464","255","209","6","470","1463","0","32.13","17.43"
"10","008","00","070","0006","0347","208","102","106","2","210","700","0","30.00","14.57"
"10","008","00","070","0006","0348","256","153","103","4","260","763","0","34.08","20.05"
"10","008","00","070","0007","0000","329","200","129","4","333","902","0","36.92","22.17"
"10","008","00","070","0007","0349","329","200","129","4","333","902","0","36.92","22.17"
"10","008","00","070","0008","0000","221","154","67","4","225","620","0","36.29","24.84"
"10","008","00","070","0008","0346","221","154","67","4","225","620","0","36.29","24.84"
"10","008","00","070","0009","0000","463","220","243","3","466","1309","0","35.60","16.81"
"10","008","00","070","0009","0342","287","149","138","2","289","769","0","37.58","19.38"
"10","008","00","070","0009","0343","176","71","105","1","177","540","0","32.78","13.15"
"10","008","00","070","0010","0000","546","298","248","6","552","1562","0","35.34","19.08"
"10","008","00","070","0010","0340","262","159","103","3","265","726","0","36.50","21.90"
"10","008","00","070","0010","0341","284","139","145","3","287","836","0","34.33","16.63"
"10","008","00","070","0011","0000","214","93","121","6","220","747","0","29.45","12.45"
"10","008","00","070","0011","0352","214","93","121","6","220","747","0","29.45","12.45"
"10","008","00","070","0012","0000","255","125","130","2","257","689","0","37.30","18.14"
"10","008","00","070","0012","0353","255","125","130","2","257","689","0","37.30","18.14"
"10","008","00","070","0013","0000","198","82","116","3","201","710","0","28.31","11.55"
"10","008","00","070","0013","0354","198","82","116","3","201","710","0","28.31","11.55"
"10","008","00","080","0000","0000","4264","2122","2142","73","4337","12820","14137","33.83","16.55"
"10","008","00","080","0001","0000","260","99","161","2","262","773","0","33.89","12.81"
"10","008","00","080","0001","0355","260","99","161","2","262","773","0","33.89","12.81"
"10","008","00","080","0002","0000","169","94","75","5","174","470","0","37.02","20.00"
"10","008","00","080","0002","0356","93","44","49","3","96","251","0","38.25","17.53"
"10","008","00","080","0002","0357","76","50","26","2","78","219","0","35.62","22.83"
"10","008","00","080","0003","0000","268","136","132","2","270","773","0","34.93","17.59"
"10","008","00","080","0003","0358","141","68","73","2","143","344","0","41.57","19.77"
"10","008","00","080","0003","0359","127","68","59","0","127","429","0","29.60","15.85"
"10","008","00","080","0004","0000","196","96","100","3","199","639","0","31.14","15.02"
"10","008","00","080","0004","0362","196","96","100","3","199","639","0","31.14","15.02"
"10","008","00","080","0005","0000","219","116","103","4","223","683","0","32.65","16.98"
"10","008","00","080","0005","0360","111","60","51","3","114","373","0","30.56","16.09"
"10","008","00","080","0005","0361","108","56","52","1","109","310","0","35.16","18.06"
"10","008","00","080","0006","0000","543","285","258","10","553","1678","0","32.96","16.98"
"10","008","00","080","0006","0364","291","154","137","9","300","948","0","31.65","16.24"
"10","008","00","080","0006","0365","252","131","121","1","253","730","0","34.66","17.95"
"10","008","00","080","0007","0000","103","52","51","1","104","287","0","36.24","18.12"
"10","008","00","080","0007","0363","103","52","51","1","104","287","0","36.24","18.12"
"10","008","00","080","0008","0000","217","129","88","2","219","624","0","35.10","20.67"
"10","008","00","080","0008","0366","217","129","88","2","219","624","0","35.10","20.67"
"10","008","00","080","0009","0000","151","57","94","2","153","491","0","31.16","11.61"
"10","008","00","080","0009","0367","151","57","94","2","153","491","0","31.16","11.61"
"10","008","00","080","0010","0000","418","246","172","7","425","1319","0","32.22","18.65"
"10","008","00","080","0010","0368","103","58","45","1","104","325","0","32.00","17.85"
"10","008","00","080","0010","0369","315","188","127","6","321","994","0","32.29","18.91"
"10","008","00","080","0011","0000","368","174","194","5","373","1049","0","35.56","16.59"
"10","008","00","080","0011","0370","156","66","90","1","157","442","0","35.52","14.93"
"10","008","00","080","0011","0371","212","108","104","4","216","607","0","35.58","17.79"
"10","008","00","080","0012","0000","239","115","124","11","250","847","0","29.52","13.58"
"10","008","00","080","0012","0372","239","115","124","11","250","847","0","29.52","13.58"
"10","008","00","080","0013","0000","234","86","148","6","240","666","0","36.04","12.91"
"10","008","00","080","0013","0374","234","86","148","6","240","666","0","36.04","12.91"
"10","008","00","080","0014","0000","221","108","113","2","223","637","0","35.01","16.95"
"10","008","00","080","0014","0376","221","108","113","2","223","637","0","35.01","16.95"
"10","008","00","080","0015","0000","169","88","81","4","173","499","0","34.67","17.64"
"10","008","00","080","0015","0378","169","88","81","4","173","499","0","34.67","17.64"
"10","008","00","080","0016","0000","164","81","83","1","165","454","0","36.34","17.84"
"10","008","00","080","0016","0373","164","81","83","1","165","454","0","36.34","17.84"
"10","008","00","080","0017","0000","148","73","75","6","154","454","0","33.92","16.08"
"10","008","00","080","0017","0377","148","73","75","6","154","454","0","33.92","16.08"
"10","008","00","080","0018","0000","177","87","90","0","177","477","0","37.11","18.24"
"10","008","00","080","0018","0375","177","87","90","0","177","477","0","37.11","18.24"
"10","008","00","090","0000","0000","4471","2324","2147","53","4524","13636","15251","33.18","17.04"
"10","008","00","090","0001","0000","543","295","248","7","550","1550","0","35.48","19.03"
"10","008","00","090","0001","0381","228","134","94","4","232","724","0","32.04","18.51"
"10","008","00","090","0001","0382","315","161","154","3","318","826","0","38.50","19.49"
"10","008","00","090","0002","0000","664","355","309","6","670","1908","0","35.12","18.61"
"10","008","00","090","0002","0379","291","153","138","3","294","893","0","32.92","17.13"
"10","008","00","090","0002","0380","373","202","171","3","376","1015","0","37.04","19.90"
"10","008","00","090","0003","0000","306","143","163","5","311","994","0","31.29","14.39"
"10","008","00","090","0003","0397","159","73","86","3","162","573","0","28.27","12.74"
"10","008","00","090","0003","0398","147","70","77","2","149","421","0","35.39","16.63"
"10","008","00","090","0004","0000","451","216","235","4","455","1333","0","34.13","16.20"
"10","008","00","090","0004","0390","257","130","127","2","259","784","0","33.04","16.58"
"10","008","00","090","0004","0391","94","34","60","1","95","282","0","33.69","12.06"
"10","008","00","090","0004","0392","100","52","48","1","101","267","0","37.83","19.48"
"10","008","00","090","0005","0000","341","148","193","8","349","1061","0","32.89","13.95"
"10","008","00","090","0005","0383","169","68","101","4","173","485","0","35.67","14.02"
"10","008","00","090","0005","0384","172","80","92","4","176","576","0","30.56","13.89"
"10","008","00","090","0006","0000","333","170","163","2","335","1242","0","26.97","13.69"
"10","008","00","090","0006","0385","145","72","73","1","146","603","0","24.21","11.94"
"10","008","00","090","0006","0386","188","98","90","1","189","639","0","29.58","15.34"
"10","008","00","090","0007","0000","154","65","89","1","155","501","0","30.94","12.97"
"10","008","00","090","0007","0387","98","33","65","1","99","299","0","33.11","11.04"
"10","008","00","090","0007","0389","56","32","24","0","56","202","0","27.72","15.84"
"10","008","00","090","0008","0000","204","103","101","3","207","625","0","33.12","16.48"
"10","008","00","090","0008","0393","87","41","46","2","89","268","0","33.21","15.30"
"10","008","00","090","0008","0394","117","62","55","1","118","357","0","33.05","17.37"
"10","008","00","090","0009","0000","232","123","109","3","235","718","0","32.73","17.13"
"10","008","00","090","0009","0395","153","79","74","3","156","546","0","28.57","14.47"
"10","008","00","090","0009","0396","79","44","35","0","79","172","0","45.93","25.58"
"10","008","00","090","0010","0000","302","209","93","0","302","823","0","36.70","25.39"
"10","008","00","090","0010","0399","302","209","93","0","302","823","0","36.70","25.39"
"10","008","00","090","0011","0000","256","120","136","5","261","917","0","28.46","13.09"
"10","008","00","090","0011","0401","108","58","50","0","108","396","0","27.27","14.65"
"10","008","00","090","0011","0402","148","62","86","5","153","521","0","29.37","11.90"
"10","008","00","090","0012","0000","187","118","69","4","191","574","0","33.28","20.56"
"10","008","00","090","0012","0403","105","67","38","3","108","335","0","32.24","20.00"
"10","008","00","090","0012","0404","82","51","31","1","83","239","0","34.73","21.34"
"10","008","00","090","0013","0000","308","162","146","3","311","849","0","36.63","19.08"
"10","008","00","090","0013","0400","308","162","146","3","311","849","0","36.63","19.08"
"10","008","00","090","0014","0000","190","97","93","2","192","541","0","35.49","17.93"
"10","008","00","090","0014","0388","190","97","93","2","192","541","0","35.49","17.93"
"10","008","00","100","0000","0000","4979","2801","2178","87","5066","15914","17685","31.83","17.60"
"10","008","00","100","0001","0000","545","268","277","17","562","1641","0","34.25","16.33"
"10","008","00","100","0001","0405","301","144","157","13","314","942","0","33.33","15.29"
"10","008","00","100","0001","0406","244","124","120","4","248","699","0","35.48","17.74"
"10","008","00","100","0002","0000","551","335","216","9","560","1676","0","33.41","19.99"
"10","008","00","100","0002","0407","252","147","105","8","260","777","0","33.46","18.92"
"10","008","00","100","0002","0408","299","188","111","1","300","899","0","33.37","20.91"
"10","008","00","100","0003","0000","183","91","92","3","186","641","0","29.02","14.20"
"10","008","00","100","0003","0409","183","91","92","3","186","641","0","29.02","14.20"
"10","008","00","100","0004","0000","529","242","287","3","532","1823","0","29.18","13.27"
"10","008","00","100","0004","0414","294","139","155","2","296","987","0","29.99","14.08"
"10","008","00","100","0004","0415","235","103","132","1","236","836","0","28.23","12.32"
"10","008","00","100","0005","0000","368","230","138","7","375","1346","0","27.86","17.09"
"10","008","00","100","0005","0410","180","111","69","3","183","645","0","28.37","17.21"
"10","008","00","100","0005","0411","188","119","69","4","192","701","0","27.39","16.98"
"10","008","00","100","0006","0000","218","124","94","0","218","688","0","31.69","18.02"
"10","008","00","100","0006","0413","218","124","94","0","218","688","0","31.69","18.02"
"10","008","00","100","0007","0000","605","346","259","10","615","1766","0","34.82","19.59"
"10","008","00","100","0007","0416","315","183","132","5","320","877","0","36.49","20.87"
"10","008","00","100","0007","0417","290","163","127","5","295","889","0","33.18","18.34"
"10","008","00","100","0008","0000","249","136","113","7","256","789","0","32.45","17.24"
"10","008","00","100","0008","0418","249","136","113","7","256","789","0","32.45","17.24"
"10","008","00","100","0009","0000","367","231","136","5","372","1117","0","33.30","20.68"
"10","008","00","100","0009","0419","367","231","136","5","372","1117","0","33.30","20.68"
"10","008","00","100","0010","0000","499","254","245","10","509","1459","0","34.89","17.41"
"10","008","00","100","0010","0421","349","182","167","8","357","1056","0","33.81","17.23"
"10","008","00","100","0010","0422","150","72","78","2","152","403","0","37.72","17.87"
"10","008","00","100","0011","0000","475","303","172","11","486","1547","0","31.42","19.59"
"10","008","00","100","0011","0423","317","206","111","9","326","1002","0","32.53","20.56"
"10","008","00","100","0011","0424","158","97","61","2","160","545","0","29.36","17.80"
"10","008","00","100","0012","0000","208","117","91","2","210","691","0","30.39","16.93"
"10","008","00","100","0012","0420","208","117","91","2","210","691","0","30.39","16.93"
"10","008","00","100","0013","0000","182","124","58","3","185","730","0","25.34","16.99"
"10","008","00","100","0013","0412","182","124","58","3","185","730","0","25.34","16.99"
"10","008","00","110","0000","0000","5065","2784","2281","63","5128","14915","16810","34.38","18.67"
"10","008","00","110","0001","0000","219","122","97","2","221","726","0","30.44","16.80"
"10","008","00","110","0001","0425","219","122","97","2","221","726","0","30.44","16.80"
"10","008","00","110","0002","0000","186","90","96","1","187","420","0","44.52","21.43"
"10","008","00","110","0002","0430","186","90","96","1","187","420","0","44.52","21.43"
"10","008","00","110","0003","0000","450","227","223","4","454","1475","0","30.78","15.39"
"10","008","00","110","0003","0426","176","80","96","1","177","518","0","34.17","15.44"
"10","008","00","110","0003","0427","274","147","127","3","277","957","0","28.94","15.36"
"10","008","00","110","0004","0000","232","149","83","3","235","596","0","39.43","25.00"
"10","008","00","110","0004","0428","232","149","83","3","235","596","0","39.43","25.00"
"10","008","00","110","0005","0000","342","208","134","3","345","839","0","41.12","24.79"
"10","008","00","110","0005","0429","342","208","134","3","345","839","0","41.12","24.79"
"10","008","00","110","0006","0000","366","215","151","4","370","1004","0","36.85","21.41"
"10","008","00","110","0006","0433","366","215","151","4","370","1004","0","36.85","21.41"
"10","008","00","110","0007","0000","366","205","161","1","367","922","0","39.80","22.23"
"10","008","00","110","0007","0436","366","205","161","1","367","922","0","39.80","22.23"
"10","008","00","110","0008","0000","429","230","199","13","442","1346","0","32.84","17.09"
"10","008","00","110","0008","0437","235","107","128","7","242","759","0","31.88","14.10"
"10","008","00","110","0008","0438","194","123","71","6","200","587","0","34.07","20.95"
"10","008","00","110","0009","0000","377","191","186","4","381","1172","0","32.51","16.30"
"10","008","00","110","0009","0440","377","191","186","4","381","1172","0","32.51","16.30"
"10","008","00","110","0010","0000","163","100","63","6","169","436","0","38.76","22.94"
"10","008","00","110","0010","0431","163","100","63","6","169","436","0","38.76","22.94"
"10","008","00","110","0011","0000","155","105","50","3","158","621","0","25.44","16.91"
"10","008","00","110","0011","0432","155","105","50","3","158","621","0","25.44","16.91"
"10","008","00","110","0012","0000","73","36","37","0","73","203","0","35.96","17.73"
"10","008","00","110","0012","0441","73","36","37","0","73","203","0","35.96","17.73"
"10","008","00","110","0013","0000","127","83","44","1","128","318","0","40.25","26.10"
"10","008","00","110","0013","0442","127","83","44","1","128","318","0","40.25","26.10"
"10","008","00","110","0014","0000","345","211","134","5","350","1065","0","32.86","19.81"
"10","008","00","110","0014","0443","345","211","134","5","350","1065","0","32.86","19.81"
"10","008","00","110","0015","0000","248","112","136","5","253","841","0","30.08","13.32"
"10","008","00","110","0015","0439","248","112","136","5","253","841","0","30.08","13.32"
"10","008","00","110","0016","0000","124","50","74","3","127","313","0","40.58","15.97"
"10","008","00","110","0016","0445","124","50","74","3","127","313","0","40.58","15.97"
"10","008","00","110","0017","0000","252","106","146","2","254","813","0","31.24","13.04"
"10","008","00","110","0017","0446","252","106","146","2","254","813","0","31.24","13.04"
"10","008","00","110","0018","0000","96","53","43","1","97","278","0","34.89","19.06"
"10","008","00","110","0018","0444","96","53","43","1","97","278","0","34.89","19.06"
"10","008","00","110","0019","0000","515","291","224","2","517","1527","0","33.86","19.06"
"10","008","00","110","0019","0434","242","139","103","1","243","725","0","33.52","19.17"
"10","008","00","110","0019","0435","273","152","121","1","274","802","0","34.16","18.95"
"10","008","00","120","0000","0000","3297","2173","1124","44","3341","13002","15798","25.70","16.71"
"10","008","00","120","0001","0000","225","173","52","7","232","1166","0","19.90","14.84"
"10","008","00","120","0001","0464","168","142","26","4","172","906","0","18.98","15.67"
"10","008","00","120","0001","0465","57","31","26","3","60","260","0","23.08","11.92"
"10","008","00","120","0002","0000","256","210","46","2","258","920","0","28.04","22.83"
"10","008","00","120","0002","0466","256","210","46","2","258","920","0","28.04","22.83"
"10","008","00","120","0003","0000","123","107","16","2","125","558","0","22.40","19.18"
"10","008","00","120","0003","0468","123","107","16","2","125","558","0","22.40","19.18"
"10","008","00","120","0004","0000","506","345","161","3","509","1469","0","34.65","23.49"
"10","008","00","120","0004","0447","192","138","54","1","193","548","0","35.22","25.18"
"10","008","00","120","0004","0448","212","141","71","0","212","607","0","34.93","23.23"
"10","008","00","120","0004","0449","102","66","36","2","104","314","0","33.12","21.02"
"10","008","00","120","0005","0000","139","79","60","1","140","481","0","29.11","16.42"
"10","008","00","120","0005","0450","139","79","60","1","140","481","0","29.11","16.42"
"10","008","00","120","0006","0000","208","104","104","6","214","713","0","30.01","14.59"
"10","008","00","120","0006","0451","112","63","49","5","117","408","0","28.68","15.44"
"10","008","00","120","0006","0452","96","41","55","1","97","305","0","31.80","13.44"
"10","008","00","120","0007","0000","338","246","92","4","342","1338","0","25.56","18.39"
"10","008","00","120","0007","0455","144","94","50","3","147","658","0","22.34","14.29"
"10","008","00","120","0007","0456","194","152","42","1","195","680","0","28.68","22.35"
"10","008","00","120","0008","0000","327","203","124","3","330","1516","0","21.77","13.39"
"10","008","00","120","0008","0457","224","144","80","2","226","981","0","23.04","14.68"
"10","008","00","120","0008","0458","103","59","44","1","104","535","0","19.44","11.03"
"10","008","00","120","0009","0000","410","218","192","7","417","1399","0","29.81","15.58"
"10","008","00","120","0009","0459","294","155","139","5","299","925","0","32.32","16.76"
"10","008","00","120","0009","0460","116","63","53","2","118","474","0","24.89","13.29"
"10","008","00","120","0010","0000","162","94","68","3","165","629","0","26.23","14.94"
"10","008","00","120","0010","0461","109","57","52","3","112","484","0","23.14","11.78"
"10","008","00","120","0010","0462","53","37","16","0","53","145","0","36.55","25.52"
"10","008","00","120","0011","0000","218","144","74","2","220","988","0","22.27","14.57"
"10","008","00","120","0011","0463","218","144","74","2","220","988","0","22.27","14.57"
"10","008","00","120","0012","0000","78","58","20","1","79","610","0","12.95","9.51"
"10","008","00","120","0012","0467","78","58","20","1","79","610","0","12.95","9.51"
"10","008","00","120","0013","0000","149","112","37","2","151","587","0","25.72","19.08"
"10","008","00","120","0013","0454","149","112","37","2","151","587","0","25.72","19.08"
"10","008","00","120","0014","0000","158","80","78","1","159","628","0","25.32","12.74"
"10","008","00","120","0014","0453","158","80","78","1","159","628","0","25.32","12.74"
"10","008","00","130","0000","0000","3154","2533","621","33","3187","12497","15736","25.50","20.27"
"10","008","00","130","0001","0000","168","127","41","3","171","801","0","21.35","15.86"
"10","008","00","130","0001","0488","168","127","41","3","171","801","0","21.35","15.86"
"10","008","00","130","0002","0000","214","182","32","2","216","907","0","23.81","20.07"
"10","008","00","130","0002","0489","214","182","32","2","216","907","0","23.81","20.07"
"10","008","00","130","0003","0000","352","311","41","6","358","1143","0","31.32","27.21"
"10","008","00","130","0003","0490","197","174","23","4","201","693","0","29.00","25.11"
"10","008","00","130","0003","0491","155","137","18","2","157","450","0","34.89","30.44"
"10","008","00","130","0004","0000","163","145","18","0","163","398","0","40.95","36.43"
"10","008","00","130","0004","0492","163","145","18","0","163","398","0","40.95","36.43"
"10","008","00","130","0005","0000","98","78","20","2","100","504","0","19.84","15.48"
"10","008","00","130","0005","0481","98","78","20","2","100","504","0","19.84","15.48"
"10","008","00","130","0006","0000","141","117","24","2","143","749","0","19.09","15.62"
"10","008","00","130","0006","0479","97","78","19","2","99","376","0","26.33","20.74"
"10","008","00","130","0006","0480","44","39","5","0","44","373","0","11.80","10.46"
"10","008","00","130","0008","0000","247","205","42","3","250","1118","0","22.36","18.34"
"10","008","00","130","0008","0484","141","119","22","1","142","595","0","23.87","20.00"
"10","008","00","130","0008","0485","55","44","11","2","57","387","0","14.73","11.37"
"10","008","00","130","0008","0486","51","42","9","0","51","136","0","37.50","30.88"
"10","008","00","130","0009","0000","545","416","129","3","548","1616","0","33.91","25.74"
"10","008","00","130","0009","0471","232","173","59","3","235","838","0","28.04","20.64"
"10","008","00","130","0009","0472","177","140","37","0","177","470","0","37.66","29.79"
"10","008","00","130","0009","0473","136","103","33","0","136","308","0","44.16","33.44"
"10","008","00","130","0010","0000","378","288","90","3","381","1223","0","31.15","23.55"
"10","008","00","130","0010","0469","269","224","45","2","271","856","0","31.66","26.17"
"10","008","00","130","0010","0470","109","64","45","1","110","367","0","29.97","17.44"
"10","008","00","130","0011","0000","241","200","41","2","243","955","0","25.45","20.94"
"10","008","00","130","0011","0475","241","200","41","2","243","955","0","25.45","20.94"
"10","008","00","130","0012","0000","166","113","53","1","167","647","0","25.81","17.47"
"10","008","00","130","0012","0476","166","113","53","1","167","647","0","25.81","17.47"
"10","008","00","130","0013","0000","110","80","30","1","111","633","0","17.54","12.64"
"10","008","00","130","0013","0487","110","80","30","1","111","633","0","17.54","12.64"
"10","008","00","130","0014","0000","22","21","1","0","22","55","0","40.00","38.18"
"10","008","00","130","0014","0474","22","21","1","0","22","55","0","40.00","38.18"
"10","008","00","130","0015","0000","106","76","30","2","108","507","0","21.30","14.99"
"10","008","00","130","0015","0482","61","52","9","1","62","331","0","18.73","15.71"
"10","008","00","130","0015","0483","45","24","21","1","46","176","0","26.14","13.64"
"10","008","00","130","0016","0000","110","99","11","3","113","627","0","18.02","15.79"
"10","008","00","130","0016","0477","110","99","11","3","113","627","0","18.02","15.79"
"10","008","00","130","0017","0000","93","75","18","0","93","614","0","15.15","12.21"
"10","008","00","130","0017","0478","93","75","18","0","93","614","0","15.15","12.21"
"10","009","00","000","0000","0000","201103","86539","114564","2487","203590","577564","673309","35.25","14.98"
"10","009","00","010","0000","0000","36367","18839","17528","311","36678","90244","108508","40.64","20.88"
"10","009","00","010","0001","0000","629","330","299","6","635","1390","0","45.68","23.74"
"10","009","00","010","0001","0470","629","330","299","6","635","1390","0","45.68","23.74"
"10","009","00","010","0002","0000","478","219","259","3","481","1065","0","45.16","20.56"
"10","009","00","010","0002","0471","478","219","259","3","481","1065","0","45.16","20.56"
"10","009","00","010","0003","0000","307","145","162","2","309","609","0","50.74","23.81"
"10","009","00","010","0003","0445","307","145","162","2","309","609","0","50.74","23.81"
"10","009","00","010","0004","0000","274","128","146","7","281","599","0","46.91","21.37"
"10","009","00","010","0004","0446","274","128","146","7","281","599","0","46.91","21.37"
"10","009","00","010","0005","0000","340","187","153","1","341","756","0","45.11","24.74"
"10","009","00","010","0005","0447","340","187","153","1","341","756","0","45.11","24.74"
"10","009","00","010","0006","0000","342","146","196","1","343","767","0","44.72","19.04"
"10","009","00","010","0006","0448","342","146","196","1","343","767","0","44.72","19.04"
"10","009","00","010","0007","0000","309","155","154","5","314","707","0","44.41","21.92"
"10","009","00","010","0007","0449","309","155","154","5","314","707","0","44.41","21.92"
"10","009","00","010","0008","0000","1993","1131","862","17","2010","4843","0","41.50","23.35"
"10","009","00","010","0008","0458","514","301","213","5","519","1194","0","43.47","25.21"
"10","009","00","010","0008","0459","572","319","253","7","579","1309","0","44.23","24.37"
"10","009","00","010","0008","0460","482","288","194","4","486","1284","0","37.85","22.43"
"10","009","00","010","0008","0461","425","223","202","1","426","1056","0","40.34","21.12"
"10","009","00","010","0009","0000","1248","658","590","18","1266","3154","0","40.14","20.86"
"10","009","00","010","0009","0472","377","205","172","11","388","855","0","45.38","23.98"
"10","009","00","010","0009","0473","467","244","223","6","473","1272","0","37.19","19.18"
"10","009","00","010","0009","0474","404","209","195","1","405","1027","0","39.44","20.35"
"10","009","00","010","0010","0000","1162","646","516","12","1174","2723","0","43.11","23.72"
"10","009","00","010","0010","0465","504","250","254","7","511","1183","0","43.20","21.13"
"10","009","00","010","0010","0466","373","211","162","2","375","895","0","41.90","23.58"
"10","009","00","010","0010","0467","285","185","100","3","288","645","0","44.65","28.68"
"10","009","00","010","0011","0000","772","413","359","7","779","1734","0","44.93","23.82"
"10","009","00","010","0011","0489","365","179","186","3","368","804","0","45.77","22.26"
"10","009","00","010","0011","0490","407","234","173","4","411","930","0","44.19","25.16"
"10","009","00","010","0012","0000","1510","855","655","7","1517","3444","0","44.05","24.83"
"10","009","00","010","0012","0484","505","284","221","3","508","1061","0","47.88","26.77"
"10","009","00","010","0012","0485","533","307","226","1","534","1249","0","42.75","24.58"
"10","009","00","010","0012","0486","472","264","208","3","475","1134","0","41.89","23.28"
"10","009","00","010","0013","0000","1569","837","732","13","1582","4187","0","37.78","19.99"
"10","009","00","010","0013","0479","589","304","285","4","593","1461","0","40.59","20.81"
"10","009","00","010","0013","0480","475","257","218","4","479","1314","0","36.45","19.56"
"10","009","00","010","0013","0481","505","276","229","5","510","1412","0","36.12","19.55"
"10","009","00","010","0014","0000","822","353","469","5","827","2303","0","35.91","15.33"
"10","009","00","010","0014","0477","444","172","272","4","448","1153","0","38.86","14.92"
"10","009","00","010","0014","0478","378","181","197","1","379","1150","0","32.96","15.74"
"10","009","00","010","0015","0000","303","186","117","3","306","657","0","46.58","28.31"
"10","009","00","010","0015","0494","303","186","117","3","306","657","0","46.58","28.31"
"10","009","00","010","0016","0000","806","406","400","7","813","2185","0","37.21","18.58"
"10","009","00","010","0016","0495","290","128","162","4","294","750","0","39.20","17.07"
"10","009","00","010","0016","0496","516","278","238","3","519","1435","0","36.17","19.37"
"10","009","00","010","0017","0000","210","88","122","3","213","538","0","39.59","16.36"
"10","009","00","010","0017","0497","210","88","122","3","213","538","0","39.59","16.36"
"10","009","00","010","0018","0000","986","597","389","7","993","2450","0","40.53","24.37"
"10","009","00","010","0018","0492","444","278","166","2","446","1135","0","39.30","24.49"
"10","009","00","010","0018","0493","542","319","223","5","547","1315","0","41.60","24.26"
"10","009","00","010","0019","0000","572","265","307","6","578","1451","0","39.83","18.26"
"10","009","00","010","0019","0491","572","265","307","6","578","1451","0","39.83","18.26"
"10","009","00","010","0020","0000","979","545","434","12","991","2391","0","41.45","22.79"
"10","009","00","010","0020","0498","565","311","254","7","572","1426","0","40.11","21.81"
"10","009","00","010","0020","0499","414","234","180","5","419","965","0","43.42","24.25"
"10","009","00","010","0021","0000","729","333","396","13","742","1873","0","39.62","17.78"
"10","009","00","010","0021","0508","518","227","291","10","528","1363","0","38.74","16.65"
"10","009","00","010","0021","0509","211","106","105","3","214","510","0","41.96","20.78"
"10","009","00","010","0022","0000","2273","1179","1094","14","2287","5409","0","42.28","21.80"
"10","009","00","010","0022","0504","574","318","256","2","576","1447","0","39.81","21.98"
"10","009","00","010","0022","0505","634","317","317","2","636","1399","0","45.46","22.66"
"10","009","00","010","0022","0506","526","275","251","5","531","1246","0","42.62","22.07"
"10","009","00","010","0022","0507","539","269","270","5","544","1317","0","41.31","20.43"
"10","009","00","010","0023","0000","1245","609","636","8","1253","3399","0","36.86","17.92"
"10","009","00","010","0023","0502","631","327","304","4","635","1734","0","36.62","18.86"
"10","009","00","010","0023","0503","614","282","332","4","618","1665","0","37.12","16.94"
"10","009","00","010","0024","0000","712","325","387","13","725","1849","0","39.21","17.58"
"10","009","00","010","0024","0517","270","113","157","5","275","698","0","39.40","16.19"
"10","009","00","010","0024","0518","442","212","230","8","450","1151","0","39.10","18.42"
"10","009","00","010","0025","0000","416","174","242","2","418","1112","0","37.59","15.65"
"10","009","00","010","0025","0519","416","174","242","2","418","1112","0","37.59","15.65"
"10","009","00","010","0026","0000","1685","821","864","19","1704","4461","0","38.20","18.40"
"10","009","00","010","0026","0510","460","212","248","8","468","1232","0","37.99","17.21"
"10","009","00","010","0026","0511","438","194","244","2","440","1110","0","39.64","17.48"
"10","009","00","010","0026","0512","431","220","211","6","437","1132","0","38.60","19.43"
"10","009","00","010","0026","0513","356","195","161","3","359","987","0","36.37","19.76"
"10","009","00","010","0027","0000","376","165","211","4","380","1076","0","35.32","15.33"
"10","009","00","010","0027","0514","376","165","211","4","380","1076","0","35.32","15.33"
"10","009","00","010","0028","0000","689","337","352","9","698","2144","0","32.56","15.72"
"10","009","00","010","0028","0515","321","157","164","7","328","910","0","36.04","17.25"
"10","009","00","010","0028","0516","368","180","188","2","370","1234","0","29.98","14.59"
"10","009","00","010","0029","0000","1185","598","587","11","1196","3219","0","37.15","18.58"
"10","009","00","010","0029","0523","419","192","227","4","423","1089","0","38.84","17.63"
"10","009","00","010","0029","0524","275","116","159","3","278","818","0","33.99","14.18"
"10","009","00","010","0029","0525","491","290","201","4","495","1312","0","37.73","22.10"
"10","009","00","010","0030","0000","1113","510","603","9","1122","3070","0","36.55","16.61"
"10","009","00","010","0030","0520","517","233","284","2","519","1317","0","39.41","17.69"
"10","009","00","010","0030","0521","353","175","178","3","356","1062","0","33.52","16.48"
"10","009","00","010","0030","0522","243","102","141","4","247","691","0","35.75","14.76"
"10","009","00","010","0031","0000","425","134","291","6","431","1106","0","38.97","12.12"
"10","009","00","010","0031","0526","425","134","291","6","431","1106","0","38.97","12.12"
"10","009","00","010","0032","0000","1032","590","442","0","1032","2279","0","45.28","25.89"
"10","009","00","010","0032","0454","569","311","258","0","569","1217","0","46.75","25.55"
"10","009","00","010","0032","0455","463","279","184","0","463","1062","0","43.60","26.27"
"10","009","00","010","0033","0000","1439","732","707","7","1446","3722","0","38.85","19.67"
"10","009","00","010","0033","0450","471","271","200","1","472","1132","0","41.70","23.94"
"10","009","00","010","0033","0451","312","149","163","3","315","766","0","41.12","19.45"
"10","009","00","010","0033","0452","374","191","183","2","376","846","0","44.44","22.58"
"10","009","00","010","0033","0453","282","121","161","1","283","978","0","28.94","12.37"
"10","009","00","010","0034","0000","1159","646","513","12","1171","2734","0","42.83","23.63"
"10","009","00","010","0034","0475","573","337","236","8","581","1359","0","42.75","24.80"
"10","009","00","010","0034","0476","586","309","277","4","590","1375","0","42.91","22.47"
"10","009","00","010","0035","0000","956","519","437","12","968","2247","0","43.08","23.10"
"10","009","00","010","0035","0487","360","186","174","5","365","840","0","43.45","22.14"
"10","009","00","010","0035","0488","596","333","263","7","603","1407","0","42.86","23.67"
"10","009","00","010","0036","0000","863","480","383","4","867","2111","0","41.07","22.74"
"10","009","00","010","0036","0468","396","201","195","2","398","974","0","40.86","20.64"
"10","009","00","010","0036","0469","467","279","188","2","469","1137","0","41.25","24.54"
"10","009","00","010","0037","0000","1486","767","719","11","1497","3620","0","41.35","21.19"
"10","009","00","010","0037","0462","566","291","275","7","573","1302","0","44.01","22.35"
"10","009","00","010","0037","0463","434","235","199","3","437","1094","0","39.95","21.48"
"10","009","00","010","0037","0464","486","241","245","1","487","1224","0","39.79","19.69"
"10","009","00","010","0038","0000","1184","621","563","7","1191","2596","0","45.88","23.92"
"10","009","00","010","0038","0482","554","301","253","2","556","1189","0","46.76","25.32"
"10","009","00","010","0038","0483","630","320","310","5","635","1407","0","45.13","22.74"
"10","009","00","010","0039","0000","965","555","410","5","970","2294","0","42.28","24.19"
"10","009","00","010","0039","0456","476","248","228","1","477","1140","0","41.84","21.75"
"10","009","00","010","0039","0457","489","307","182","4","493","1154","0","42.72","26.60"
"10","009","00","010","0040","0000","824","454","370","3","827","1970","0","41.98","23.05"
"10","009","00","010","0040","0500","453","244","209","1","454","1040","0","43.65","23.46"
"10","009","00","010","0040","0501","371","210","161","2","373","930","0","40.11","22.58"
"10","009","00","020","0000","0000","14547","6576","7971","155","14702","37622","43841","39.08","17.48"
"10","009","00","020","0001","0000","507","238","269","6","513","1125","0","45.60","21.16"
"10","009","00","020","0001","0547","507","238","269","6","513","1125","0","45.60","21.16"
"10","009","00","020","0002","0000","888","452","436","5","893","2068","0","43.18","21.86"
"10","009","00","020","0002","0548","503","278","225","3","506","1100","0","46.00","25.27"
"10","009","00","020","0002","0549","385","174","211","2","387","968","0","39.98","17.98"
"10","009","00","020","0003","0000","812","355","457","14","826","2193","0","37.67","16.19"
"10","009","00","020","0003","0553","402","184","218","6","408","1177","0","34.66","15.63"
"10","009","00","020","0003","0554","410","171","239","8","418","1016","0","41.14","16.83"
"10","009","00","020","0004","0000","613","317","296","5","618","1430","0","43.22","22.17"
"10","009","00","020","0004","0555","613","317","296","5","618","1430","0","43.22","22.17"
"10","009","00","020","0005","0000","497","213","284","4","501","1217","0","41.17","17.50"
"10","009","00","020","0005","0556","497","213","284","4","501","1217","0","41.17","17.50"
"10","009","00","020","0006","0000","1015","450","565","6","1021","2651","0","38.51","16.97"
"10","009","00","020","0006","0565","527","235","292","5","532","1310","0","40.61","17.94"
"10","009","00","020","0006","0566","488","215","273","1","489","1341","0","36.47","16.03"
"10","009","00","020","0007","0000","503","209","294","6","509","1321","0","38.53","15.82"
"10","009","00","020","0007","0557","503","209","294","6","509","1321","0","38.53","15.82"
"10","009","00","020","0008","0000","317","136","181","4","321","738","0","43.50","18.43"
"10","009","00","020","0008","0558","317","136","181","4","321","738","0","43.50","18.43"
"10","009","00","020","0009","0000","284","133","151","2","286","860","0","33.26","15.47"
"10","009","00","020","0009","0560","284","133","151","2","286","860","0","33.26","15.47"
"10","009","00","020","0010","0000","261","112","149","5","266","705","0","37.73","15.89"
"10","009","00","020","0010","0561","261","112","149","5","266","705","0","37.73","15.89"
"10","009","00","020","0011","0000","386","168","218","7","393","1113","0","35.31","15.09"
"10","009","00","020","0011","0562","386","168","218","7","393","1113","0","35.31","15.09"
"10","009","00","020","0012","0000","624","253","371","6","630","1683","0","37.43","15.03"
"10","009","00","020","0012","0563","338","136","202","4","342","833","0","41.06","16.33"
"10","009","00","020","0012","0564","286","117","169","2","288","850","0","33.88","13.76"
"10","009","00","020","0013","0000","384","157","227","5","389","970","0","40.10","16.19"
"10","009","00","020","0013","0577","384","157","227","5","389","970","0","40.10","16.19"
"10","009","00","020","0014","0000","1051","411","640","12","1063","2768","0","38.40","14.85"
"10","009","00","020","0014","0578","532","191","341","9","541","1355","0","39.93","14.10"
"10","009","00","020","0014","0579","519","220","299","3","522","1413","0","36.94","15.57"
"10","009","00","020","0015","0000","796","344","452","7","803","2175","0","36.92","15.82"
"10","009","00","020","0015","0580","461","190","271","5","466","1212","0","38.45","15.68"
"10","009","00","020","0015","0581","335","154","181","2","337","963","0","34.99","15.99"
"10","009","00","020","0016","0000","1289","633","656","12","1301","3315","0","39.25","19.10"
"10","009","00","020","0016","0567","439","242","197","6","445","1065","0","41.78","22.72"
"10","009","00","020","0016","0568","428","214","214","2","430","1142","0","37.65","18.74"
"10","009","00","020","0016","0569","422","177","245","4","426","1108","0","38.45","15.97"
"10","009","00","020","0017","0000","319","149","170","6","325","854","0","38.06","17.45"
"10","009","00","020","0017","0572","319","149","170","6","325","854","0","38.06","17.45"
"10","009","00","020","0018","0000","304","155","149","6","310","792","0","39.14","19.57"
"10","009","00","020","0018","0573","304","155","149","6","310","792","0","39.14","19.57"
"10","009","00","020","0019","0000","310","167","143","2","312","823","0","37.91","20.29"
"10","009","00","020","0019","0574","310","167","143","2","312","823","0","37.91","20.29"
"10","009","00","020","0020","0000","525","218","307","5","530","1470","0","36.05","14.83"
"10","009","00","020","0020","0575","291","126","165","3","294","827","0","35.55","15.24"
"10","009","00","020","0020","0576","234","92","142","2","236","643","0","36.70","14.31"
"10","009","00","020","0021","0000","559","178","381","10","569","1433","0","39.71","12.42"
"10","009","00","020","0021","0582","559","178","381","10","569","1433","0","39.71","12.42"
"10","009","00","020","0022","0000","330","136","194","7","337","851","0","39.60","15.98"
"10","009","00","020","0022","0559","330","136","194","7","337","851","0","39.60","15.98"
"10","009","00","020","0023","0000","1138","589","549","8","1146","2831","0","40.48","20.81"
"10","009","00","020","0023","0550","359","202","157","4","363","933","0","38.91","21.65"
"10","009","00","020","0023","0551","370","167","203","1","371","963","0","38.53","17.34"
"10","009","00","020","0023","0552","409","220","189","3","412","935","0","44.06","23.53"
"10","009","00","020","0024","0000","835","403","432","5","840","2236","0","37.57","18.02"
"10","009","00","020","0024","0570","333","134","199","0","333","918","0","36.27","14.60"
"10","009","00","020","0024","0571","502","269","233","5","507","1318","0","38.47","20.41"
"10","009","00","030","0000","0000","21351","10486","10865","191","21542","58416","70772","36.88","17.95"
"10","009","00","030","0001","0000","366","180","186","2","368","914","0","40.26","19.69"
"10","009","00","030","0001","0129","366","180","186","2","368","914","0","40.26","19.69"
"10","009","00","030","0002","0000","648","339","309","2","650","1655","0","39.27","20.48"
"10","009","00","030","0002","0123","344","182","162","1","345","756","0","45.63","24.07"
"10","009","00","030","0002","0124","304","157","147","1","305","899","0","33.93","17.46"
"10","009","00","030","0003","0000","1018","532","486","10","1028","2525","0","40.71","21.07"
"10","009","00","030","0003","0121","520","262","258","6","526","1301","0","40.43","20.14"
"10","009","00","030","0003","0122","498","270","228","4","502","1224","0","41.01","22.06"
"10","009","00","030","0004","0000","1183","624","559","8","1191","2771","0","42.98","22.52"
"10","009","00","030","0004","0125","610","306","304","5","615","1400","0","43.93","21.86"
"10","009","00","030","0004","0126","573","318","255","3","576","1371","0","42.01","23.19"
"10","009","00","030","0005","0000","940","539","401","10","950","2473","0","38.41","21.80"
"10","009","00","030","0005","0127","454","245","209","3","457","1209","0","37.80","20.26"
"10","009","00","030","0005","0128","486","294","192","7","493","1264","0","39.00","23.26"
"10","009","00","030","0006","0000","1190","657","533","5","1195","3168","0","37.72","20.74"
"10","009","00","030","0006","0130","411","236","175","2","413","1002","0","41.22","23.55"
"10","009","00","030","0006","0131","400","225","175","2","402","1051","0","38.25","21.41"
"10","009","00","030","0006","0132","379","196","183","1","380","1115","0","34.08","17.58"
"10","009","00","030","0007","0000","614","329","285","3","617","1361","0","45.33","24.17"
"10","009","00","030","0007","0136","614","329","285","3","617","1361","0","45.33","24.17"
"10","009","00","030","0008","0000","1623","850","773","9","1632","4499","0","36.27","18.89"
"10","009","00","030","0008","0137","461","245","216","2","463","1396","0","33.17","17.55"
"10","009","00","030","0008","0138","496","251","245","5","501","1487","0","33.69","16.88"
"10","009","00","030","0008","0139","666","354","312","2","668","1616","0","41.34","21.91"
"10","009","00","030","0009","0000","870","447","423","9","879","2323","0","37.84","19.24"
"10","009","00","030","0009","0140","529","286","243","2","531","1305","0","40.69","21.92"
"10","009","00","030","0009","0141","341","161","180","7","348","1018","0","34.18","15.82"
"10","009","00","030","0010","0000","1444","702","742","13","1457","3807","0","38.27","18.44"
"10","009","00","030","0010","0142","499","216","283","5","504","1319","0","38.21","16.38"
"10","009","00","030","0010","0143","484","271","213","2","486","1333","0","36.46","20.33"
"10","009","00","030","0010","0144","461","215","246","6","467","1155","0","40.43","18.61"
"10","009","00","030","0011","0000","776","402","374","5","781","2017","0","38.72","19.93"
"10","009","00","030","0011","0145","408","204","204","2","410","1112","0","36.87","18.35"
"10","009","00","030","0011","0146","368","198","170","3","371","905","0","40.99","21.88"
"10","009","00","030","0012","0000","417","212","205","4","421","1123","0","37.49","18.88"
"10","009","00","030","0012","0147","417","212","205","4","421","1123","0","37.49","18.88"
"10","009","00","030","0013","0000","476","243","233","6","482","1313","0","36.71","18.51"
"10","009","00","030","0013","0170","476","243","233","6","482","1313","0","36.71","18.51"
"10","009","00","030","0014","0000","298","142","156","5","303","828","0","36.59","17.15"
"10","009","00","030","0014","0169","298","142","156","5","303","828","0","36.59","17.15"
"10","009","00","030","0015","0000","580","244","336","8","588","1952","0","30.12","12.50"
"10","009","00","030","0015","0168","580","244","336","8","588","1952","0","30.12","12.50"
"10","009","00","030","0016","0000","506","205","301","2","508","1478","0","34.37","13.87"
"10","009","00","030","0016","0166","506","205","301","2","508","1478","0","34.37","13.87"
"10","009","00","030","0017","0000","261","80","181","2","263","872","0","30.16","9.17"
"10","009","00","030","0017","0167","261","80","181","2","263","872","0","30.16","9.17"
"10","009","00","030","0018","0000","930","368","562","8","938","2607","0","35.98","14.12"
"10","009","00","030","0018","0149","503","221","282","4","507","1365","0","37.14","16.19"
"10","009","00","030","0018","0150","427","147","280","4","431","1242","0","34.70","11.84"
"10","009","00","030","0019","0000","297","154","143","4","301","844","0","35.66","18.25"
"10","009","00","030","0019","0151","297","154","143","4","301","844","0","35.66","18.25"
"10","009","00","030","0020","0000","578","247","331","13","591","1767","0","33.45","13.98"
"10","009","00","030","0020","0152","278","113","165","7","285","870","0","32.76","12.99"
"10","009","00","030","0020","0153","300","134","166","6","306","897","0","34.11","14.94"
"10","009","00","030","0021","0000","585","287","298","9","594","1633","0","36.37","17.58"
"10","009","00","030","0021","0154","306","168","138","6","312","848","0","36.79","19.81"
"10","009","00","030","0021","0155","279","119","160","3","282","785","0","35.92","15.16"
"10","009","00","030","0022","0000","1198","500","698","6","1204","3437","0","35.03","14.55"
"10","009","00","030","0022","0156","423","179","244","1","424","1271","0","33.36","14.08"
"10","009","00","030","0022","0157","344","119","225","2","346","958","0","36.12","12.42"
"10","009","00","030","0022","0158","431","202","229","3","434","1208","0","35.93","16.72"
"10","009","00","030","0023","0000","754","333","421","19","773","2304","0","33.55","14.45"
"10","009","00","030","0023","0159","379","182","197","11","390","1247","0","31.28","14.60"
"10","009","00","030","0023","0160","375","151","224","8","383","1057","0","36.23","14.29"
"10","009","00","030","0024","0000","826","334","492","11","837","2528","0","33.11","13.21"
"10","009","00","030","0024","0161","407","167","240","5","412","1281","0","32.16","13.04"
"10","009","00","030","0024","0162","419","167","252","6","425","1247","0","34.08","13.39"
"10","009","00","030","0025","0000","486","215","271","1","487","1339","0","36.37","16.06"
"10","009","00","030","0025","0163","486","215","271","1","487","1339","0","36.37","16.06"
"10","009","00","030","0026","0000","547","268","279","7","554","1501","0","36.91","17.85"
"10","009","00","030","0026","0164","547","268","279","7","554","1501","0","36.91","17.85"
"10","009","00","030","0027","0000","165","92","73","3","168","515","0","32.62","17.86"
"10","009","00","030","0027","0148","165","92","73","3","168","515","0","32.62","17.86"
"10","009","00","030","0028","0000","1397","788","609","3","1400","3651","0","38.35","21.58"
"10","009","00","030","0028","0133","449","275","174","1","450","1145","0","39.30","24.02"
"10","009","00","030","0028","0134","485","238","247","1","486","1254","0","38.76","18.98"
"10","009","00","030","0028","0135","463","275","188","1","464","1252","0","37.06","21.96"
"10","009","00","030","0029","0000","378","173","205","4","382","1211","0","31.54","14.29"
"10","009","00","030","0029","0165","378","173","205","4","382","1211","0","31.54","14.29"
"10","009","00","040","0000","0000","13638","4900","8738","141","13779","37855","45246","36.40","12.94"
"10","009","00","040","0001","0000","534","169","365","4","538","1509","0","35.65","11.20"
"10","009","00","040","0001","0364","268","70","198","1","269","760","0","35.39","9.21"
"10","009","00","040","0001","0365","266","99","167","3","269","749","0","35.91","13.22"
"10","009","00","040","0002","0000","655","272","383","7","662","1720","0","38.49","15.81"
"10","009","00","040","0002","0366","324","138","186","5","329","823","0","39.98","16.77"
"10","009","00","040","0002","0367","331","134","197","2","333","897","0","37.12","14.94"
"10","009","00","040","0003","0000","752","372","380","6","758","2061","0","36.78","18.05"
"10","009","00","040","0003","0368","381","186","195","4","385","1041","0","36.98","17.87"
"10","009","00","040","0003","0369","371","186","185","2","373","1020","0","36.57","18.24"
"10","009","00","040","0004","0000","1110","490","620","7","1117","2893","0","38.61","16.94"
"10","009","00","040","0004","0370","376","164","212","2","378","967","0","39.09","16.96"
"10","009","00","040","0004","0371","345","128","217","0","345","844","0","40.88","15.17"
"10","009","00","040","0004","0372","389","198","191","5","394","1082","0","36.41","18.30"
"10","009","00","040","0005","0000","151","53","98","0","151","325","0","46.46","16.31"
"10","009","00","040","0005","0373","151","53","98","0","151","325","0","46.46","16.31"
"10","009","00","040","0006","0000","236","96","140","0","236","549","0","42.99","17.49"
"10","009","00","040","0006","0374","236","96","140","0","236","549","0","42.99","17.49"
"10","009","00","040","0007","0000","225","88","137","1","226","568","0","39.79","15.49"
"10","009","00","040","0007","0375","225","88","137","1","226","568","0","39.79","15.49"
"10","009","00","040","0008","0000","374","157","217","5","379","1004","0","37.75","15.64"
"10","009","00","040","0008","0376","374","157","217","5","379","1004","0","37.75","15.64"
"10","009","00","040","0009","0000","1067","444","623","7","1074","2870","0","37.42","15.47"
"10","009","00","040","0009","0377","580","252","328","4","584","1447","0","40.36","17.42"
"10","009","00","040","0009","0378","487","192","295","3","490","1423","0","34.43","13.49"
"10","009","00","040","0010","0000","1597","593","1004","13","1610","4547","0","35.41","13.04"
"10","009","00","040","0010","0379","410","164","246","1","411","1080","0","38.06","15.19"
"10","009","00","040","0010","0380","343","134","209","5","348","1110","0","31.35","12.07"
"10","009","00","040","0010","0381","419","145","274","5","424","1098","0","38.62","13.21"
"10","009","00","040","0010","0382","425","150","275","2","427","1259","0","33.92","11.91"
"10","009","00","040","0011","0000","458","107","351","5","463","1277","0","36.26","8.38"
"10","009","00","040","0011","0383","458","107","351","5","463","1277","0","36.26","8.38"
"10","009","00","040","0012","0000","525","150","375","8","533","1475","0","36.14","10.17"
"10","009","00","040","0012","0384","525","150","375","8","533","1475","0","36.14","10.17"
"10","009","00","040","0013","0000","372","151","221","8","380","972","0","39.09","15.53"
"10","009","00","040","0013","0397","372","151","221","8","380","972","0","39.09","15.53"
"10","009","00","040","0014","0000","344","119","225","4","348","1105","0","31.49","10.77"
"10","009","00","040","0014","0398","344","119","225","4","348","1105","0","31.49","10.77"
"10","009","00","040","0015","0000","552","160","392","4","556","1776","0","31.31","9.01"
"10","009","00","040","0015","0399","273","90","183","2","275","909","0","30.25","9.90"
"10","009","00","040","0015","0400","279","70","209","2","281","867","0","32.41","8.07"
"10","009","00","040","0016","0000","503","135","368","11","514","1499","0","34.29","9.01"
"10","009","00","040","0016","0401","503","135","368","11","514","1499","0","34.29","9.01"
"10","009","00","040","0017","0000","564","176","388","4","568","1573","0","36.11","11.19"
"10","009","00","040","0017","0385","268","87","181","2","270","807","0","33.46","10.78"
"10","009","00","040","0017","0386","296","89","207","2","298","766","0","38.90","11.62"
"10","009","00","040","0018","0000","320","88","232","6","326","872","0","37.39","10.09"
"10","009","00","040","0018","0387","320","88","232","6","326","872","0","37.39","10.09"
"10","009","00","040","0019","0000","389","87","302","4","393","935","0","42.03","9.30"
"10","009","00","040","0019","0388","389","87","302","4","393","935","0","42.03","9.30"
"10","009","00","040","0020","0000","327","149","178","4","331","854","0","38.76","17.45"
"10","009","00","040","0020","0390","327","149","178","4","331","854","0","38.76","17.45"
"10","009","00","040","0021","0000","528","151","377","4","532","1477","0","36.02","10.22"
"10","009","00","040","0021","0389","528","151","377","4","532","1477","0","36.02","10.22"
"10","009","00","040","0022","0000","381","111","270","8","389","963","0","40.39","11.53"
"10","009","00","040","0022","0391","381","111","270","8","389","963","0","40.39","11.53"
"10","009","00","040","0023","0000","243","134","109","3","246","809","0","30.41","16.56"
"10","009","00","040","0023","0394","243","134","109","3","246","809","0","30.41","16.56"
"10","009","00","040","0024","0000","276","83","193","4","280","727","0","38.51","11.42"
"10","009","00","040","0024","0393","276","83","193","4","280","727","0","38.51","11.42"
"10","009","00","040","0025","0000","386","127","259","2","388","1287","0","30.15","9.87"
"10","009","00","040","0025","0392","386","127","259","2","388","1287","0","30.15","9.87"
"10","009","00","040","0026","0000","310","96","214","5","315","862","0","36.54","11.14"
"10","009","00","040","0026","0395","310","96","214","5","315","862","0","36.54","11.14"
"10","009","00","040","0027","0000","459","142","317","7","466","1346","0","34.62","10.55"
"10","009","00","040","0027","0396","459","142","317","7","466","1346","0","34.62","10.55"
"10","009","00","050","0000","0000","8207","3426","4781","116","8323","24096","28137","34.54","14.22"
"10","009","00","050","0001","0000","316","137","179","4","320","765","0","41.83","17.91"
"10","009","00","050","0001","0091","316","137","179","4","320","765","0","41.83","17.91"
"10","009","00","050","0002","0000","329","142","187","2","331","868","0","38.13","16.36"
"10","009","00","050","0002","0092","329","142","187","2","331","868","0","38.13","16.36"
"10","009","00","050","0003","0000","568","262","306","5","573","1345","0","42.60","19.48"
"10","009","00","050","0003","0093","263","101","162","3","266","649","0","40.99","15.56"
"10","009","00","050","0003","0094","305","161","144","2","307","696","0","44.11","23.13"
"10","009","00","050","0004","0000","451","237","214","0","451","1052","0","42.87","22.53"
"10","009","00","050","0004","0095","451","237","214","0","451","1052","0","42.87","22.53"
"10","009","00","050","0005","0000","337","138","199","7","344","1083","0","31.76","12.74"
"10","009","00","050","0005","0096","196","72","124","6","202","664","0","30.42","10.84"
"10","009","00","050","0005","0097","141","66","75","1","142","419","0","33.89","15.75"
"10","009","00","050","0006","0000","497","201","296","5","502","1401","0","35.83","14.35"
"10","009","00","050","0006","0101","213","87","126","3","216","629","0","34.34","13.83"
"10","009","00","050","0006","0102","284","114","170","2","286","772","0","37.05","14.77"
"10","009","00","050","0007","0000","400","172","228","10","410","1267","0","32.36","13.58"
"10","009","00","050","0007","0103","212","73","139","7","219","716","0","30.59","10.20"
"10","009","00","050","0007","0104","188","99","89","3","191","551","0","34.66","17.97"
"10","009","00","050","0008","0000","419","183","236","6","425","1221","0","34.81","14.99"
"10","009","00","050","0008","0105","246","88","158","5","251","707","0","35.50","12.45"
"10","009","00","050","0008","0106","173","95","78","1","174","514","0","33.85","18.48"
"10","009","00","050","0009","0000","311","125","186","4","315","854","0","36.89","14.64"
"10","009","00","050","0009","0111","311","125","186","4","315","854","0","36.89","14.64"
"10","009","00","050","0010","0000","907","423","484","13","920","2844","0","32.35","14.87"
"10","009","00","050","0010","0098","271","123","148","6","277","901","0","30.74","13.65"
"10","009","00","050","0010","0099","319","159","160","5","324","988","0","32.79","16.09"
"10","009","00","050","0010","0100","317","141","176","2","319","955","0","33.40","14.76"
"10","009","00","050","0011","0000","634","208","426","12","646","1845","0","35.01","11.27"
"10","009","00","050","0011","0112","294","96","198","6","300","886","0","33.86","10.84"
"10","009","00","050","0011","0113","340","112","228","6","346","959","0","36.08","11.68"
"10","009","00","050","0012","0000","609","264","345","12","621","1750","0","35.49","15.09"
"10","009","00","050","0012","0114","341","142","199","6","347","884","0","39.25","16.06"
"10","009","00","050","0012","0115","268","122","146","6","274","866","0","31.64","14.09"
"10","009","00","050","0013","0000","282","93","189","5","287","830","0","34.58","11.20"
"10","009","00","050","0013","0118","282","93","189","5","287","830","0","34.58","11.20"
"10","009","00","050","0014","0000","573","212","361","9","582","1773","0","32.83","11.96"
"10","009","00","050","0014","0116","305","115","190","3","308","890","0","34.61","12.92"
"10","009","00","050","0014","0117","268","97","171","6","274","883","0","31.03","10.99"
"10","009","00","050","0015","0000","682","280","402","7","689","2272","0","30.33","12.32"
"10","009","00","050","0015","0107","348","146","202","4","352","1177","0","29.91","12.40"
"10","009","00","050","0015","0108","334","134","200","3","337","1095","0","30.78","12.24"
"10","009","00","050","0016","0000","439","180","259","7","446","1501","0","29.71","11.99"
"10","009","00","050","0016","0109","256","101","155","5","261","811","0","32.18","12.45"
"10","009","00","050","0016","0110","183","79","104","2","185","690","0","26.81","11.45"
"10","009","00","050","0017","0000","453","169","284","8","461","1425","0","32.35","11.86"
"10","009","00","050","0017","0119","247","86","161","4","251","751","0","33.42","11.45"
"10","009","00","050","0017","0120","206","83","123","4","210","674","0","31.16","12.31"
"10","009","00","060","0000","0000","12546","4725","7821","133","12679","33096","38748","38.31","14.28"
"10","009","00","060","0001","0000","310","102","208","3","313","692","0","45.23","14.74"
"10","009","00","060","0001","0274","310","102","208","3","313","692","0","45.23","14.74"
"10","009","00","060","0002","0000","276","82","194","2","278","655","0","42.44","12.52"
"10","009","00","060","0002","0275","276","82","194","2","278","655","0","42.44","12.52"
"10","009","00","060","0003","0000","180","81","99","2","182","437","0","41.65","18.54"
"10","009","00","060","0003","0276","180","81","99","2","182","437","0","41.65","18.54"
"10","009","00","060","0004","0000","373","135","238","6","379","831","0","45.61","16.25"
"10","009","00","060","0004","0277","373","135","238","6","379","831","0","45.61","16.25"
"10","009","00","060","0005","0000","147","49","98","2","149","329","0","45.29","14.89"
"10","009","00","060","0005","0278","147","49","98","2","149","329","0","45.29","14.89"
"10","009","00","060","0006","0000","155","68","87","2","157","385","0","40.78","17.66"
"10","009","00","060","0006","0279","155","68","87","2","157","385","0","40.78","17.66"
"10","009","00","060","0007","0000","152","44","108","2","154","355","0","43.38","12.39"
"10","009","00","060","0007","0280","152","44","108","2","154","355","0","43.38","12.39"
"10","009","00","060","0008","0000","368","140","228","2","370","907","0","40.79","15.44"
"10","009","00","060","0008","0281","368","140","228","2","370","907","0","40.79","15.44"
"10","009","00","060","0009","0000","200","81","119","2","202","469","0","43.07","17.27"
"10","009","00","060","0009","0282","200","81","119","2","202","469","0","43.07","17.27"
"10","009","00","060","0010","0000","143","58","85","1","144","312","0","46.15","18.59"
"10","009","00","060","0010","0283","143","58","85","1","144","312","0","46.15","18.59"
"10","009","00","060","0011","0000","206","87","119","0","206","525","0","39.24","16.57"
"10","009","00","060","0011","0284","206","87","119","0","206","525","0","39.24","16.57"
"10","009","00","060","0012","0000","436","158","278","4","440","1132","0","38.87","13.96"
"10","009","00","060","0012","0285","188","68","120","2","190","415","0","45.78","16.39"
"10","009","00","060","0012","0286","248","90","158","2","250","717","0","34.87","12.55"
"10","009","00","060","0013","0000","204","100","104","3","207","425","0","48.71","23.53"
"10","009","00","060","0013","0287","204","100","104","3","207","425","0","48.71","23.53"
"10","009","00","060","0014","0000","1910","757","1153","23","1933","4762","0","40.59","15.90"
"10","009","00","060","0014","0288","450","181","269","7","457","1131","0","40.41","16.00"
"10","009","00","060","0014","0289","487","194","293","4","491","1181","0","41.57","16.43"
"10","009","00","060","0014","0290","408","164","244","6","414","1161","0","35.66","14.13"
"10","009","00","060","0014","0291","565","218","347","6","571","1289","0","44.30","16.91"
"10","009","00","060","0015","0000","631","309","322","4","635","1679","0","37.82","18.40"
"10","009","00","060","0015","0292","279","134","145","3","282","708","0","39.83","18.93"
"10","009","00","060","0015","0293","352","175","177","1","353","971","0","36.35","18.02"
"10","009","00","060","0016","0000","2357","1042","1315","21","2378","6248","0","38.06","16.68"
"10","009","00","060","0016","0296","508","232","276","6","514","1328","0","38.70","17.47"
"10","009","00","060","0016","0297","408","161","247","6","414","1075","0","38.51","14.98"
"10","009","00","060","0016","0298","605","294","311","5","610","1553","0","39.28","18.93"
"10","009","00","060","0016","0299","444","200","244","0","444","1144","0","38.81","17.48"
"10","009","00","060","0016","0300","392","155","237","4","396","1148","0","34.49","13.50"
"10","009","00","060","0017","0000","400","121","279","3","403","1122","0","35.92","10.78"
"10","009","00","060","0017","0301","400","121","279","3","403","1122","0","35.92","10.78"
"10","009","00","060","0018","0000","232","105","127","3","235","794","0","29.60","13.22"
"10","009","00","060","0018","0305","232","105","127","3","235","794","0","29.60","13.22"
"10","009","00","060","0019","0000","393","107","286","8","401","1344","0","29.84","7.96"
"10","009","00","060","0019","0306","191","57","134","4","195","614","0","31.76","9.28"
"10","009","00","060","0019","0307","202","50","152","4","206","730","0","28.22","6.85"
"10","009","00","060","0020","0000","384","119","265","4","388","1120","0","34.64","10.63"
"10","009","00","060","0020","0308","384","119","265","4","388","1120","0","34.64","10.63"
"10","009","00","060","0021","0000","338","100","238","5","343","969","0","35.40","10.32"
"10","009","00","060","0021","0302","145","43","102","4","149","541","0","27.54","7.95"
"10","009","00","060","0021","0303","193","57","136","1","194","428","0","45.33","13.32"
"10","009","00","060","0022","0000","229","68","161","8","237","760","0","31.18","8.95"
"10","009","00","060","0022","0309","229","68","161","8","237","760","0","31.18","8.95"
"10","009","00","060","0023","0000","173","48","125","4","177","537","0","32.96","8.94"
"10","009","00","060","0023","0310","173","48","125","4","177","537","0","32.96","8.94"
"10","009","00","060","0024","0000","534","185","349","9","543","1571","0","34.56","11.78"
"10","009","00","060","0024","0311","326","102","224","4","330","1009","0","32.71","10.11"
"10","009","00","060","0024","0312","208","83","125","5","213","562","0","37.90","14.77"
"10","009","00","060","0025","0000","1113","411","702","5","1118","2928","0","38.18","14.04"
"10","009","00","060","0025","0313","351","77","274","1","352","895","0","39.33","8.60"
"10","009","00","060","0025","0314","361","165","196","4","365","1007","0","36.25","16.39"
"10","009","00","060","0025","0315","401","169","232","0","401","1026","0","39.08","16.47"
"10","009","00","060","0026","0000","418","72","346","3","421","958","0","43.95","7.52"
"10","009","00","060","0026","0294","418","72","346","3","421","958","0","43.95","7.52"
"10","009","00","060","0027","0000","153","49","104","0","153","470","0","32.55","10.43"
"10","009","00","060","0027","0295","153","49","104","0","153","470","0","32.55","10.43"
"10","009","00","060","0028","0000","131","47","84","2","133","380","0","35.00","12.37"
"10","009","00","060","0028","0304","131","47","84","2","133","380","0","35.00","12.37"
"10","009","00","070","0000","0000","9507","4137","5370","136","9643","27042","30632","35.66","15.30"
"10","009","00","070","0001","0000","432","206","226","4","436","1190","0","36.64","17.31"
"10","009","00","070","0001","0593","432","206","226","4","436","1190","0","36.64","17.31"
"10","009","00","070","0002","0000","416","230","186","5","421","1080","0","38.98","21.30"
"10","009","00","070","0002","0594","416","230","186","5","421","1080","0","38.98","21.30"
"10","009","00","070","0003","0000","399","146","253","5","404","1106","0","36.53","13.20"
"10","009","00","070","0003","0592","399","146","253","5","404","1106","0","36.53","13.20"
"10","009","00","070","0004","0000","490","230","260","9","499","1397","0","35.72","16.46"
"10","009","00","070","0004","0590","396","173","223","7","403","1086","0","37.11","15.93"
"10","009","00","070","0004","0591","94","57","37","2","96","311","0","30.87","18.33"
"10","009","00","070","0005","0000","1046","459","587","12","1058","3146","0","33.63","14.59"
"10","009","00","070","0005","0587","352","155","197","5","357","938","0","38.06","16.52"
"10","009","00","070","0005","0588","379","171","208","6","385","1150","0","33.48","14.87"
"10","009","00","070","0005","0589","315","133","182","1","316","1058","0","29.87","12.57"
"10","009","00","070","0006","0000","582","212","370","11","593","1472","0","40.29","14.40"
"10","009","00","070","0006","0585","334","127","207","6","340","863","0","39.40","14.72"
"10","009","00","070","0006","0586","248","85","163","5","253","609","0","41.54","13.96"
"10","009","00","070","0007","0000","692","249","443","17","709","2048","0","34.62","12.16"
"10","009","00","070","0007","0583","362","142","220","4","366","1080","0","33.89","13.15"
"10","009","00","070","0007","0584","330","107","223","13","343","968","0","35.43","11.05"
"10","009","00","070","0008","0000","217","84","133","1","218","708","0","30.79","11.86"
"10","009","00","070","0008","0608","217","84","133","1","218","708","0","30.79","11.86"
"10","009","00","070","0009","0000","105","30","75","0","105","278","0","37.77","10.79"
"10","009","00","070","0009","0607","105","30","75","0","105","278","0","37.77","10.79"
"10","009","00","070","0010","0000","684","300","384","9","693","2109","0","32.86","14.22"
"10","009","00","070","0010","0601","330","146","184","4","334","976","0","34.22","14.96"
"10","009","00","070","0010","0602","354","154","200","5","359","1133","0","31.69","13.59"
"10","009","00","070","0011","0000","342","104","238","2","344","1061","0","32.42","9.80"
"10","009","00","070","0011","0609","342","104","238","2","344","1061","0","32.42","9.80"
"10","009","00","070","0012","0000","358","177","181","8","366","1155","0","31.69","15.32"
"10","009","00","070","0012","0606","358","177","181","8","366","1155","0","31.69","15.32"
"10","009","00","070","0013","0000","104","46","58","1","105","429","0","24.48","10.72"
"10","009","00","070","0013","0610","104","46","58","1","105","429","0","24.48","10.72"
"10","009","00","070","0014","0000","198","82","116","1","199","543","0","36.65","15.10"
"10","009","00","070","0014","0611","198","82","116","1","199","543","0","36.65","15.10"
"10","009","00","070","0015","0000","746","331","415","14","760","2065","0","36.80","16.03"
"10","009","00","070","0015","0603","399","172","227","11","410","1116","0","36.74","15.41"
"10","009","00","070","0015","0604","347","159","188","3","350","949","0","36.88","16.75"
"10","009","00","070","0016","0000","326","118","208","9","335","761","0","44.02","15.51"
"10","009","00","070","0016","0605","326","118","208","9","335","761","0","44.02","15.51"
"10","009","00","070","0017","0000","781","381","400","7","788","2241","0","35.16","17.00"
"10","009","00","070","0017","0595","407","204","203","4","411","1131","0","36.34","18.04"
"10","009","00","070","0017","0596","374","177","197","3","377","1110","0","33.96","15.95"
"10","009","00","070","0018","0000","763","375","388","12","775","2080","0","37.26","18.03"
"10","009","00","070","0018","0597","345","167","178","4","349","948","0","36.81","17.62"
"10","009","00","070","0018","0598","418","208","210","8","426","1132","0","37.63","18.37"
"10","009","00","070","0019","0000","579","264","315","5","584","1501","0","38.91","17.59"
"10","009","00","070","0019","0599","579","264","315","5","584","1501","0","38.91","17.59"
"10","009","00","070","0020","0000","247","113","134","4","251","672","0","37.35","16.82"
"10","009","00","070","0020","0600","247","113","134","4","251","672","0","37.35","16.82"
"10","009","00","080","0000","0000","5800","2288","3512","85","5885","16313","18555","36.08","14.03"
"10","009","00","080","0001","0000","289","122","167","2","291","737","0","39.48","16.55"
"10","009","00","080","0001","0527","289","122","167","2","291","737","0","39.48","16.55"
"10","009","00","080","0002","0000","805","302","503","12","817","2148","0","38.04","14.06"
"10","009","00","080","0002","0531","373","165","208","8","381","957","0","39.81","17.24"
"10","009","00","080","0002","0532","209","65","144","3","212","593","0","35.75","10.96"
"10","009","00","080","0002","0533","223","72","151","1","224","598","0","37.46","12.04"
"10","009","00","080","0003","0000","350","164","186","5","355","959","0","37.02","17.10"
"10","009","00","080","0003","0534","350","164","186","5","355","959","0","37.02","17.10"
"10","009","00","080","0004","0000","327","90","237","3","330","908","0","36.34","9.91"
"10","009","00","080","0004","0535","327","90","237","3","330","908","0","36.34","9.91"
"10","009","00","080","0005","0000","661","249","412","15","676","1893","0","35.71","13.15"
"10","009","00","080","0005","0538","500","177","323","10","510","1443","0","35.34","12.27"
"10","009","00","080","0005","0539","161","72","89","5","166","450","0","36.89","16.00"
"10","009","00","080","0006","0000","674","286","388","7","681","1830","0","37.21","15.63"
"10","009","00","080","0006","0540","481","215","266","4","485","1321","0","36.71","16.28"
"10","009","00","080","0006","0541","193","71","122","3","196","509","0","38.51","13.95"
"10","009","00","080","0007","0000","577","244","333","8","585","1532","0","38.19","15.93"
"10","009","00","080","0007","0536","238","85","153","6","244","555","0","43.96","15.32"
"10","009","00","080","0007","0537","339","159","180","2","341","977","0","34.90","16.27"
"10","009","00","080","0008","0000","384","136","248","6","390","1179","0","33.08","11.54"
"10","009","00","080","0008","0542","384","136","248","6","390","1179","0","33.08","11.54"
"10","009","00","080","0009","0000","237","79","158","6","243","716","0","33.94","11.03"
"10","009","00","080","0009","0528","237","79","158","6","243","716","0","33.94","11.03"
"10","009","00","080","0010","0000","198","98","100","2","200","583","0","34.31","16.81"
"10","009","00","080","0010","0529","198","98","100","2","200","583","0","34.31","16.81"
"10","009","00","080","0011","0000","324","133","191","5","329","1045","0","31.48","12.73"
"10","009","00","080","0011","0530","324","133","191","5","329","1045","0","31.48","12.73"
"10","009","00","080","0012","0000","273","124","149","3","276","743","0","37.15","16.69"
"10","009","00","080","0012","0543","273","124","149","3","276","743","0","37.15","16.69"
"10","009","00","080","0013","0000","244","85","159","4","248","670","0","37.01","12.69"
"10","009","00","080","0013","0544","244","85","159","4","248","670","0","37.01","12.69"
"10","009","00","080","0014","0000","237","90","147","2","239","669","0","35.72","13.45"
"10","009","00","080","0014","0545","237","90","147","2","239","669","0","35.72","13.45"
"10","009","00","080","0015","0000","220","86","134","5","225","701","0","32.10","12.27"
"10","009","00","080","0015","0546","220","86","134","5","225","701","0","32.10","12.27"
"10","009","00","090","0000","0000","9278","3416","5862","122","9400","24348","28143","38.61","14.03"
"10","009","00","090","0001","0000","1672","550","1122","15","1687","4116","0","40.99","13.36"
"10","009","00","090","0001","0402","377","164","213","6","383","989","0","38.73","16.58"
"10","009","00","090","0001","0403","316","110","206","1","317","895","0","35.42","12.29"
"10","009","00","090","0001","0404","433","171","262","1","434","943","0","46.02","18.13"
"10","009","00","090","0001","0405","546","105","441","7","553","1289","0","42.90","8.15"
"10","009","00","090","0002","0000","332","101","231","7","339","864","0","39.24","11.69"
"10","009","00","090","0002","0406","332","101","231","7","339","864","0","39.24","11.69"
"10","009","00","090","0003","0000","590","169","421","6","596","1530","0","38.95","11.05"
"10","009","00","090","0003","0407","334","84","250","4","338","774","0","43.67","10.85"
"10","009","00","090","0003","0408","256","85","171","2","258","756","0","34.13","11.24"
"10","009","00","090","0004","0000","500","183","317","7","507","1177","0","43.08","15.55"
"10","009","00","090","0004","0409","233","86","147","3","236","572","0","41.26","15.03"
"10","009","00","090","0004","0410","267","97","170","4","271","605","0","44.79","16.03"
"10","009","00","090","0005","0000","377","118","259","6","383","1068","0","35.86","11.05"
"10","009","00","090","0005","0411","377","118","259","6","383","1068","0","35.86","11.05"
"10","009","00","090","0006","0000","746","260","486","12","758","2015","0","37.62","12.90"
"10","009","00","090","0006","0412","380","147","233","8","388","1023","0","37.93","14.37"
"10","009","00","090","0006","0413","366","113","253","4","370","992","0","37.30","11.39"
"10","009","00","090","0007","0000","1189","516","673","10","1199","3053","0","39.27","16.90"
"10","009","00","090","0007","0414","419","194","225","4","423","1071","0","39.50","18.11"
"10","009","00","090","0007","0415","345","146","199","3","348","925","0","37.62","15.78"
"10","009","00","090","0007","0416","425","176","249","3","428","1057","0","40.49","16.65"
"10","009","00","090","0008","0000","523","206","317","7","530","1250","0","42.40","16.48"
"10","009","00","090","0008","0417","523","206","317","7","530","1250","0","42.40","16.48"
"10","009","00","090","0009","0000","396","155","241","5","401","1135","0","35.33","13.66"
"10","009","00","090","0009","0420","396","155","241","5","401","1135","0","35.33","13.66"
"10","009","00","090","0010","0000","687","266","421","10","697","1882","0","37.04","14.13"
"10","009","00","090","0010","0418","297","151","146","5","302","875","0","34.51","17.26"
"10","009","00","090","0010","0419","390","115","275","5","395","1007","0","39.23","11.42"
"10","009","00","090","0011","0000","626","262","364","9","635","1725","0","36.81","15.19"
"10","009","00","090","0011","0421","301","113","188","5","306","852","0","35.92","13.26"
"10","009","00","090","0011","0422","325","149","176","4","329","873","0","37.69","17.07"
"10","009","00","090","0012","0000","497","207","290","11","508","1453","0","34.96","14.25"
"10","009","00","090","0012","0423","301","118","183","5","306","932","0","32.83","12.66"
"10","009","00","090","0012","0424","196","89","107","6","202","521","0","38.77","17.08"
"10","009","00","090","0013","0000","468","158","310","4","472","1313","0","35.95","12.03"
"10","009","00","090","0013","0425","186","46","140","0","186","448","0","41.52","10.27"
"10","009","00","090","0013","0426","282","112","170","4","286","865","0","33.06","12.95"
"10","009","00","090","0014","0000","675","265","410","13","688","1767","0","38.94","15.00"
"10","009","00","090","0014","0427","435","170","265","7","442","1133","0","39.01","15.00"
"10","009","00","090","0014","0428","240","95","145","6","246","634","0","38.80","14.98"
"10","009","00","100","0000","0000","5295","2353","2942","78","5373","15106","17408","35.57","15.58"
"10","009","00","100","0001","0000","359","165","194","5","364","1004","0","36.25","16.43"
"10","009","00","100","0001","0429","359","165","194","5","364","1004","0","36.25","16.43"
"10","009","00","100","0002","0000","1292","591","701","21","1313","3548","0","37.01","16.66"
"10","009","00","100","0002","0430","457","192","265","9","466","1210","0","38.51","15.87"
"10","009","00","100","0002","0431","291","140","151","7","298","836","0","35.65","16.75"
"10","009","00","100","0002","0432","286","145","141","1","287","835","0","34.37","17.37"
"10","009","00","100","0002","0433","258","114","144","4","262","667","0","39.28","17.09"
"10","009","00","100","0003","0000","762","315","447","11","773","2097","0","36.86","15.02"
"10","009","00","100","0003","0434","484","238","246","8","492","1377","0","35.73","17.28"
"10","009","00","100","0003","0435","278","77","201","3","281","720","0","39.03","10.69"
"10","009","00","100","0004","0000","173","91","82","2","175","505","0","34.65","18.02"
"10","009","00","100","0004","0436","173","91","82","2","175","505","0","34.65","18.02"
"10","009","00","100","0005","0000","289","137","152","3","292","802","0","36.41","17.08"
"10","009","00","100","0005","0437","289","137","152","3","292","802","0","36.41","17.08"
"10","009","00","100","0006","0000","828","367","461","12","840","2594","0","32.38","14.15"
"10","009","00","100","0006","0438","416","192","224","9","425","1305","0","32.57","14.71"
"10","009","00","100","0006","0439","412","175","237","3","415","1289","0","32.20","13.58"
"10","009","00","100","0007","0000","227","90","137","1","228","627","0","36.36","14.35"
"10","009","00","100","0007","0440","227","90","137","1","228","627","0","36.36","14.35"
"10","009","00","100","0008","0000","380","183","197","11","391","1115","0","35.07","16.41"
"10","009","00","100","0008","0441","380","183","197","11","391","1115","0","35.07","16.41"
"10","009","00","100","0009","0000","344","188","156","5","349","1016","0","34.35","18.50"
"10","009","00","100","0009","0442","344","188","156","5","349","1016","0","34.35","18.50"
"10","009","00","100","0010","0000","641","226","415","7","648","1798","0","36.04","12.57"
"10","009","00","100","0010","0443","345","109","236","3","348","950","0","36.63","11.47"
"10","009","00","100","0010","0444","296","117","179","4","300","848","0","35.38","13.80"
"10","009","00","110","0000","0000","7900","2584","5316","96","7996","22786","25808","35.09","11.34"
"10","009","00","110","0001","0000","528","212","316","4","532","1442","0","36.89","14.70"
"10","009","00","110","0001","0337","292","124","168","2","294","838","0","35.08","14.80"
"10","009","00","110","0001","0338","236","88","148","2","238","604","0","39.40","14.57"
"10","009","00","110","0002","0000","627","256","371","6","633","1698","0","37.28","15.08"
"10","009","00","110","0002","0339","350","147","203","5","355","922","0","38.50","15.94"
"10","009","00","110","0002","0340","277","109","168","1","278","776","0","35.82","14.05"
"10","009","00","110","0003","0000","523","174","349","7","530","1596","0","33.21","10.90"
"10","009","00","110","0003","0341","162","58","104","0","162","603","0","26.87","9.62"
"10","009","00","110","0003","0342","361","116","245","7","368","993","0","37.06","11.68"
"10","009","00","110","0004","0000","503","159","344","11","514","1474","0","34.87","10.79"
"10","009","00","110","0004","0343","161","52","109","0","161","441","0","36.51","11.79"
"10","009","00","110","0004","0344","342","107","235","11","353","1033","0","34.17","10.36"
"10","009","00","110","0005","0000","411","185","226","7","418","1126","0","37.12","16.43"
"10","009","00","110","0005","0345","411","185","226","7","418","1126","0","37.12","16.43"
"10","009","00","110","0006","0000","646","221","425","5","651","1839","0","35.40","12.02"
"10","009","00","110","0006","0346","354","111","243","3","357","1019","0","35.03","10.89"
"10","009","00","110","0006","0347","292","110","182","2","294","820","0","35.85","13.41"
"10","009","00","110","0007","0000","302","95","207","5","307","861","0","35.66","11.03"
"10","009","00","110","0007","0348","302","95","207","5","307","861","0","35.66","11.03"
"10","009","00","110","0008","0000","343","94","249","1","344","873","0","39.40","10.77"
"10","009","00","110","0008","0351","343","94","249","1","344","873","0","39.40","10.77"
"10","009","00","110","0009","0000","281","57","224","2","283","748","0","37.83","7.62"
"10","009","00","110","0009","0352","281","57","224","2","283","748","0","37.83","7.62"
"10","009","00","110","0010","0000","455","117","338","8","463","1464","0","31.63","7.99"
"10","009","00","110","0010","0353","214","66","148","3","217","652","0","33.28","10.12"
"10","009","00","110","0010","0354","241","51","190","5","246","812","0","30.30","6.28"
"10","009","00","110","0011","0000","615","172","443","10","625","1782","0","35.07","9.65"
"10","009","00","110","0011","0355","369","84","285","6","375","1127","0","33.27","7.45"
"10","009","00","110","0011","0356","246","88","158","4","250","655","0","38.17","13.44"
"10","009","00","110","0012","0000","273","81","192","3","276","821","0","33.62","9.87"
"10","009","00","110","0012","0357","273","81","192","3","276","821","0","33.62","9.87"
"10","009","00","110","0013","0000","651","224","427","7","658","1719","0","38.28","13.03"
"10","009","00","110","0013","0358","436","179","257","6","442","1042","0","42.42","17.18"
"10","009","00","110","0013","0359","215","45","170","1","216","677","0","31.91","6.65"
"10","009","00","110","0014","0000","405","124","281","10","415","1223","0","33.93","10.14"
"10","009","00","110","0014","0360","405","124","281","10","415","1223","0","33.93","10.14"
"10","009","00","110","0015","0000","231","69","162","1","232","907","0","25.58","7.61"
"10","009","00","110","0015","0361","231","69","162","1","232","907","0","25.58","7.61"
"10","009","00","110","0016","0000","279","84","195","4","283","824","0","34.34","10.19"
"10","009","00","110","0016","0362","279","84","195","4","283","824","0","34.34","10.19"
"10","009","00","110","0017","0000","267","91","176","1","268","983","0","27.26","9.26"
"10","009","00","110","0017","0363","267","91","176","1","268","983","0","27.26","9.26"
"10","009","00","110","0018","0000","560","169","391","4","564","1406","0","40.11","12.02"
"10","009","00","110","0018","0349","322","95","227","2","324","798","0","40.60","11.90"
"10","009","00","110","0018","0350","238","74","164","2","240","608","0","39.47","12.17"
"10","009","00","120","0000","0000","6799","2729","4070","101","6900","20647","23741","33.42","13.22"
"10","009","00","120","0001","0000","420","172","248","4","424","1134","0","37.39","15.17"
"10","009","00","120","0001","0316","420","172","248","4","424","1134","0","37.39","15.17"
"10","009","00","120","0002","0000","506","226","280","6","512","1437","0","35.63","15.73"
"10","009","00","120","0002","0317","506","226","280","6","512","1437","0","35.63","15.73"
"10","009","00","120","0003","0000","833","396","437","3","836","2263","0","36.94","17.50"
"10","009","00","120","0003","0318","399","173","226","2","401","1093","0","36.69","15.83"
"10","009","00","120","0003","0319","434","223","211","1","435","1170","0","37.18","19.06"
"10","009","00","120","0004","0000","731","251","480","11","742","2078","0","35.71","12.08"
"10","009","00","120","0004","0320","408","142","266","3","411","1082","0","37.99","13.12"
"10","009","00","120","0004","0321","323","109","214","8","331","996","0","33.23","10.94"
"10","009","00","120","0005","0000","741","267","474","13","754","2042","0","36.92","13.08"
"10","009","00","120","0005","0322","347","145","202","9","356","958","0","37.16","15.14"
"10","009","00","120","0005","0323","394","122","272","4","398","1084","0","36.72","11.25"
"10","009","00","120","0006","0000","421","126","295","7","428","1250","0","34.24","10.08"
"10","009","00","120","0006","0324","421","126","295","7","428","1250","0","34.24","10.08"
"10","009","00","120","0007","0000","588","261","327","10","598","2022","0","29.57","12.91"
"10","009","00","120","0007","0325","238","122","116","5","243","1023","0","23.75","11.93"
"10","009","00","120","0007","0326","350","139","211","5","355","999","0","35.54","13.91"
"10","009","00","120","0008","0000","261","165","96","4","265","782","0","33.89","21.10"
"10","009","00","120","0008","0327","261","165","96","4","265","782","0","33.89","21.10"
"10","009","00","120","0009","0000","429","179","250","16","445","1484","0","29.99","12.06"
"10","009","00","120","0009","0328","178","68","110","5","183","686","0","26.68","9.91"
"10","009","00","120","0009","0329","251","111","140","11","262","798","0","32.83","13.91"
"10","009","00","120","0010","0000","502","187","315","6","508","1710","0","29.71","10.94"
"10","009","00","120","0010","0330","272","94","178","2","274","859","0","31.90","10.94"
"10","009","00","120","0010","0331","230","93","137","4","234","851","0","27.50","10.93"
"10","009","00","120","0011","0000","424","189","235","7","431","1413","0","30.50","13.38"
"10","009","00","120","0011","0332","202","90","112","3","205","668","0","30.69","13.47"
"10","009","00","120","0011","0333","222","99","123","4","226","745","0","30.34","13.29"
"10","009","00","120","0012","0000","267","98","169","5","272","1102","0","24.68","8.89"
"10","009","00","120","0012","0334","267","98","169","5","272","1102","0","24.68","8.89"
"10","009","00","120","0013","0000","441","121","320","7","448","1181","0","37.93","10.25"
"10","009","00","120","0013","0335","441","121","320","7","448","1181","0","37.93","10.25"
"10","009","00","120","0014","0000","235","91","144","2","237","749","0","31.64","12.15"
"10","009","00","120","0014","0336","235","91","144","2","237","749","0","31.64","12.15"
"10","009","00","130","0000","0000","9787","4801","4986","136","9923","39270","48001","25.27","12.23"
"10","009","00","130","0001","0000","1122","607","515","11","1133","4277","0","26.49","14.19"
"10","009","00","130","0001","0007","320","164","156","5","325","1135","0","28.63","14.45"
"10","009","00","130","0001","0008","264","145","119","2","266","957","0","27.80","15.15"
"10","009","00","130","0001","0009","303","170","133","3","306","1158","0","26.42","14.68"
"10","009","00","130","0001","0010","235","128","107","1","236","1027","0","22.98","12.46"
"10","009","00","130","0002","0000","1938","1050","888","16","1954","7460","0","26.19","14.08"
"10","009","00","130","0002","0001","319","175","144","1","320","1356","0","23.60","12.91"
"10","009","00","130","0002","0002","286","165","121","2","288","1247","0","23.10","13.23"
"10","009","00","130","0002","0003","380","203","177","4","384","1260","0","30.48","16.11"
"10","009","00","130","0002","0004","389","198","191","3","392","1494","0","26.24","13.25"
"10","009","00","130","0002","0005","315","168","147","2","317","1082","0","29.30","15.53"
"10","009","00","130","0002","0006","249","141","108","4","253","1021","0","24.78","13.81"
"10","009","00","130","0003","0000","513","200","313","10","523","1968","0","26.58","10.16"
"10","009","00","130","0003","0011","182","65","117","2","184","739","0","24.90","8.80"
"10","009","00","130","0003","0012","331","135","196","8","339","1229","0","27.58","10.98"
"10","009","00","130","0004","0000","755","322","433","10","765","2867","0","26.68","11.23"
"10","009","00","130","0004","0013","321","148","173","3","324","1178","0","27.50","12.56"
"10","009","00","130","0004","0014","261","101","160","3","264","1013","0","26.06","9.97"
"10","009","00","130","0004","0015","173","73","100","4","177","676","0","26.18","10.80"
"10","009","00","130","0005","0000","635","345","290","7","642","2721","0","23.59","12.68"
"10","009","00","130","0005","0025","320","185","135","4","324","1339","0","24.20","13.82"
"10","009","00","130","0005","0026","315","160","155","3","318","1382","0","23.01","11.58"
"10","009","00","130","0006","0000","657","377","280","11","668","3051","0","21.89","12.36"
"10","009","00","130","0006","0018","252","132","120","3","255","1075","0","23.72","12.28"
"10","009","00","130","0006","0019","204","136","68","5","209","942","0","22.19","14.44"
"10","009","00","130","0006","0020","201","109","92","3","204","1034","0","19.73","10.54"
"10","009","00","130","0007","0000","506","248","258","8","514","2216","0","23.19","11.19"
"10","009","00","130","0007","0016","246","131","115","6","252","1215","0","20.74","10.78"
"10","009","00","130","0007","0017","260","117","143","2","262","1001","0","26.17","11.69"
"10","009","00","130","0008","0000","513","217","296","11","524","2141","0","24.47","10.14"
"10","009","00","130","0008","0023","233","102","131","7","240","1001","0","23.98","10.19"
"10","009","00","130","0008","0024","280","115","165","4","284","1140","0","24.91","10.09"
"10","009","00","130","0009","0000","1008","464","544","13","1021","4026","0","25.36","11.53"
"10","009","00","130","0009","0027","285","149","136","3","288","1218","0","23.65","12.23"
"10","009","00","130","0009","0028","232","101","131","5","237","951","0","24.92","10.62"
"10","009","00","130","0009","0029","239","93","146","1","240","908","0","26.43","10.24"
"10","009","00","130","0009","0030","252","121","131","4","256","949","0","26.98","12.75"
"10","009","00","130","0010","0000","303","137","166","2","305","1156","0","26.38","11.85"
"10","009","00","130","0010","0031","303","137","166","2","305","1156","0","26.38","11.85"
"10","009","00","130","0011","0000","926","394","532","21","947","3617","0","26.18","10.89"
"10","009","00","130","0011","0032","357","157","200","6","363","1244","0","29.18","12.62"
"10","009","00","130","0011","0033","301","105","196","9","310","1255","0","24.70","8.37"
"10","009","00","130","0011","0034","268","132","136","6","274","1118","0","24.51","11.81"
"10","009","00","130","0012","0000","543","260","283","13","556","2222","0","25.02","11.70"
"10","009","00","130","0012","0035","323","168","155","7","330","1193","0","27.66","14.08"
"10","009","00","130","0012","0036","220","92","128","6","226","1029","0","21.96","8.94"
"10","009","00","130","0013","0000","368","180","188","3","371","1548","0","23.97","11.63"
"10","009","00","130","0013","0021","183","99","84","2","185","808","0","22.90","12.25"
"10","009","00","130","0013","0022","185","81","104","1","186","740","0","25.14","10.95"
"10","009","00","140","0000","0000","4006","1749","2257","62","4068","12612","13963","32.25","13.87"
"10","009","00","140","0001","0000","559","300","259","6","565","1442","0","39.18","20.80"
"10","009","00","140","0001","0065","328","176","152","4","332","863","0","38.47","20.39"
"10","009","00","140","0001","0066","231","124","107","2","233","579","0","40.24","21.42"
"10","009","00","140","0002","0000","384","185","199","4","388","1155","0","33.59","16.02"
"10","009","00","140","0002","0067","384","185","199","4","388","1155","0","33.59","16.02"
"10","009","00","140","0003","0000","439","177","262","4","443","1536","0","28.84","11.52"
"10","009","00","140","0003","0063","214","72","142","2","216","864","0","25.00","8.33"
"10","009","00","140","0003","0064","225","105","120","2","227","672","0","33.78","15.63"
"10","009","00","140","0004","0000","199","90","109","1","200","511","0","39.14","17.61"
"10","009","00","140","0004","0062","199","90","109","1","200","511","0","39.14","17.61"
"10","009","00","140","0005","0000","341","114","227","2","343","1160","0","29.57","9.83"
"10","009","00","140","0005","0061","341","114","227","2","343","1160","0","29.57","9.83"
"10","009","00","140","0006","0000","182","73","109","2","184","532","0","34.59","13.72"
"10","009","00","140","0006","0069","182","73","109","2","184","532","0","34.59","13.72"
"10","009","00","140","0007","0000","264","79","185","7","271","778","0","34.83","10.15"
"10","009","00","140","0007","0068","264","79","185","7","271","778","0","34.83","10.15"
"10","009","00","140","0008","0000","211","83","128","3","214","812","0","26.35","10.22"
"10","009","00","140","0008","0071","211","83","128","3","214","812","0","26.35","10.22"
"10","009","00","140","0009","0000","279","116","163","4","283","825","0","34.30","14.06"
"10","009","00","140","0009","0070","279","116","163","4","283","825","0","34.30","14.06"
"10","009","00","140","0010","0000","549","262","287","18","567","1857","0","30.53","14.11"
"10","009","00","140","0010","0072","265","128","137","10","275","888","0","30.97","14.41"
"10","009","00","140","0010","0073","284","134","150","8","292","969","0","30.13","13.83"
"10","009","00","140","0011","0000","312","137","175","3","315","1015","0","31.03","13.50"
"10","009","00","140","0011","0076","312","137","175","3","315","1015","0","31.03","13.50"
"10","009","00","140","0012","0000","287","133","154","8","295","989","0","29.83","13.45"
"10","009","00","140","0012","0074","161","95","66","5","166","590","0","28.14","16.10"
"10","009","00","140","0012","0075","126","38","88","3","129","399","0","32.33","9.52"
"10","009","00","150","0000","0000","3950","1617","2333","60","4010","10933","12368","36.68","14.79"
"10","009","00","150","0001","0000","699","315","384","7","706","1848","0","38.20","17.05"
"10","009","00","150","0001","0077","333","151","182","5","338","882","0","38.32","17.12"
"10","009","00","150","0001","0078","366","164","202","2","368","966","0","38.10","16.98"
"10","009","00","150","0002","0000","524","232","292","6","530","1415","0","37.46","16.40"
"10","009","00","150","0002","0079","268","116","152","4","272","726","0","37.47","15.98"
"10","009","00","150","0002","0080","256","116","140","2","258","689","0","37.45","16.84"
"10","009","00","150","0003","0000","519","205","314","5","524","1455","0","36.01","14.09"
"10","009","00","150","0003","0081","250","92","158","2","252","733","0","34.38","12.55"
"10","009","00","150","0003","0082","269","113","156","3","272","722","0","37.67","15.65"
"10","009","00","150","0004","0000","436","155","281","9","445","1158","0","38.43","13.39"
"10","009","00","150","0004","0085","177","64","113","3","180","453","0","39.74","14.13"
"10","009","00","150","0004","0086","259","91","168","6","265","705","0","37.59","12.91"
"10","009","00","150","0005","0000","503","187","316","12","515","1437","0","35.84","13.01"
"10","009","00","150","0005","0083","178","71","107","3","181","468","0","38.68","15.17"
"10","009","00","150","0005","0084","325","116","209","9","334","969","0","34.47","11.97"
"10","009","00","150","0006","0000","296","109","187","3","299","806","0","37.10","13.52"
"10","009","00","150","0006","0087","296","109","187","3","299","806","0","37.10","13.52"
"10","009","00","150","0007","0000","280","114","166","2","282","774","0","36.43","14.73"
"10","009","00","150","0007","0088","280","114","166","2","282","774","0","36.43","14.73"
"10","009","00","150","0008","0000","388","181","207","6","394","1187","0","33.19","15.25"
"10","009","00","150","0008","0089","388","181","207","6","394","1187","0","33.19","15.25"
"10","009","00","150","0009","0000","305","119","186","10","315","853","0","36.93","13.95"
"10","009","00","150","0009","0090","305","119","186","10","315","853","0","36.93","13.95"
"10","009","00","160","0000","0000","5486","2830","2656","107","5593","20367","22792","27.46","13.90"
"10","009","00","160","0001","0000","416","258","158","6","422","1177","0","35.85","21.92"
"10","009","00","160","0001","0037","416","258","158","6","422","1177","0","35.85","21.92"
"10","009","00","160","0002","0000","324","182","142","3","327","1060","0","30.85","17.17"
"10","009","00","160","0002","0039","324","182","142","3","327","1060","0","30.85","17.17"
"10","009","00","160","0003","0000","311","171","140","6","317","1093","0","29.00","15.65"
"10","009","00","160","0003","0038","311","171","140","6","317","1093","0","29.00","15.65"
"10","009","00","160","0004","0000","489","269","220","12","501","1980","0","25.30","13.59"
"10","009","00","160","0004","0040","226","110","116","4","230","988","0","23.28","11.13"
"10","009","00","160","0004","0041","263","159","104","8","271","992","0","27.32","16.03"
"10","009","00","160","0005","0000","361","168","193","10","371","1449","0","25.60","11.59"
"10","009","00","160","0005","0043","174","88","86","7","181","706","0","25.64","12.46"
"10","009","00","160","0005","0044","187","80","107","3","190","743","0","25.57","10.77"
"10","009","00","160","0006","0000","453","193","260","14","467","1828","0","25.55","10.56"
"10","009","00","160","0006","0045","302","108","194","8","310","1133","0","27.36","9.53"
"10","009","00","160","0006","0046","151","85","66","6","157","695","0","22.59","12.23"
"10","009","00","160","0007","0000","156","74","82","4","160","592","0","27.03","12.50"
"10","009","00","160","0007","0047","156","74","82","4","160","592","0","27.03","12.50"
"10","009","00","160","0008","0000","221","108","113","3","224","672","0","33.33","16.07"
"10","009","00","160","0008","0049","221","108","113","3","224","672","0","33.33","16.07"
"10","009","00","160","0009","0000","139","39","100","4","143","450","0","31.78","8.67"
"10","009","00","160","0009","0048","139","39","100","4","143","450","0","31.78","8.67"
"10","009","00","160","0010","0000","211","126","85","2","213","811","0","26.26","15.54"
"10","009","00","160","0010","0042","211","126","85","2","213","811","0","26.26","15.54"
"10","009","00","160","0011","0000","385","191","194","5","390","1466","0","26.60","13.03"
"10","009","00","160","0011","0052","278","121","157","2","280","1020","0","27.45","11.86"
"10","009","00","160","0011","0053","107","70","37","3","110","446","0","24.66","15.70"
"10","009","00","160","0012","0000","369","196","173","4","373","1332","0","28.00","14.71"
"10","009","00","160","0012","0054","215","124","91","3","218","775","0","28.13","16.00"
"10","009","00","160","0012","0055","154","72","82","1","155","557","0","27.83","12.93"
"10","009","00","160","0013","0000","758","355","403","20","778","2935","0","26.51","12.10"
"10","009","00","160","0013","0056","298","164","134","11","309","1031","0","29.97","15.91"
"10","009","00","160","0013","0057","260","112","148","4","264","960","0","27.50","11.67"
"10","009","00","160","0013","0058","200","79","121","5","205","944","0","21.72","8.37"
"10","009","00","160","0014","0000","431","250","181","7","438","1741","0","25.16","14.36"
"10","009","00","160","0014","0059","289","145","144","7","296","1162","0","25.47","12.48"
"10","009","00","160","0014","0060","142","105","37","0","142","579","0","24.53","18.13"
"10","009","00","160","0015","0000","462","250","212","7","469","1781","0","26.33","14.04"
"10","009","00","160","0015","0050","326","169","157","6","332","1214","0","27.35","13.92"
"10","009","00","160","0015","0051","136","81","55","1","137","567","0","24.16","14.29"
"10","009","00","170","0000","0000","6679","2394","4285","100","6779","21835","24426","31.05","10.96"
"10","009","00","170","0001","0000","1021","390","631","9","1030","3218","0","32.01","12.12"
"10","009","00","170","0001","0196","282","92","190","3","285","882","0","32.31","10.43"
"10","009","00","170","0001","0197","390","159","231","4","394","1238","0","31.83","12.84"
"10","009","00","170","0001","0198","349","139","210","2","351","1098","0","31.97","12.66"
"10","009","00","170","0002","0000","491","179","312","4","495","1454","0","34.04","12.31"
"10","009","00","170","0002","0199","237","84","153","0","237","698","0","33.95","12.03"
"10","009","00","170","0002","0200","254","95","159","4","258","756","0","34.13","12.57"
"10","009","00","170","0003","0000","409","132","277","5","414","1308","0","31.65","10.09"
"10","009","00","170","0003","0201","409","132","277","5","414","1308","0","31.65","10.09"
"10","009","00","170","0004","0000","227","72","155","8","235","705","0","33.33","10.21"
"10","009","00","170","0004","0202","227","72","155","8","235","705","0","33.33","10.21"
"10","009","00","170","0005","0000","289","118","171","5","294","936","0","31.41","12.61"
"10","009","00","170","0005","0203","289","118","171","5","294","936","0","31.41","12.61"
"10","009","00","170","0006","0000","296","99","197","6","302","1030","0","29.32","9.61"
"10","009","00","170","0006","0204","296","99","197","6","302","1030","0","29.32","9.61"
"10","009","00","170","0007","0000","284","129","155","8","292","890","0","32.81","14.49"
"10","009","00","170","0007","0205","284","129","155","8","292","890","0","32.81","14.49"
"10","009","00","170","0008","0000","258","66","192","8","266","715","0","37.20","9.23"
"10","009","00","170","0008","0206","258","66","192","8","266","715","0","37.20","9.23"
"10","009","00","170","0009","0000","176","86","90","3","179","570","0","31.40","15.09"
"10","009","00","170","0009","0207","176","86","90","3","179","570","0","31.40","15.09"
"10","009","00","170","0010","0000","222","110","112","0","222","836","0","26.56","13.16"
"10","009","00","170","0010","0208","222","110","112","0","222","836","0","26.56","13.16"
"10","009","00","170","0011","0000","138","31","107","2","140","351","0","39.89","8.83"
"10","009","00","170","0011","0209","138","31","107","2","140","351","0","39.89","8.83"
"10","009","00","170","0012","0000","294","97","197","3","297","1112","0","26.71","8.72"
"10","009","00","170","0012","0210","294","97","197","3","297","1112","0","26.71","8.72"
"10","009","00","170","0013","0000","441","175","266","5","446","1457","0","30.61","12.01"
"10","009","00","170","0013","0211","145","50","95","2","147","565","0","26.02","8.85"
"10","009","00","170","0013","0212","296","125","171","3","299","892","0","33.52","14.01"
"10","009","00","170","0014","0000","315","74","241","2","317","958","0","33.09","7.72"
"10","009","00","170","0014","0213","315","74","241","2","317","958","0","33.09","7.72"
"10","009","00","170","0015","0000","243","81","162","10","253","813","0","31.12","9.96"
"10","009","00","170","0015","0214","243","81","162","10","253","813","0","31.12","9.96"
"10","009","00","170","0016","0000","310","107","203","1","311","1127","0","27.60","9.49"
"10","009","00","170","0016","0215","310","107","203","1","311","1127","0","27.60","9.49"
"10","009","00","170","0017","0000","263","98","165","5","268","816","0","32.84","12.01"
"10","009","00","170","0017","0216","263","98","165","5","268","816","0","32.84","12.01"
"10","009","00","170","0018","0000","414","138","276","3","417","1472","0","28.33","9.38"
"10","009","00","170","0018","0217","181","60","121","1","182","645","0","28.22","9.30"
"10","009","00","170","0018","0218","233","78","155","2","235","827","0","28.42","9.43"
"10","009","00","170","0019","0000","172","48","124","1","173","578","0","29.93","8.30"
"10","009","00","170","0019","0219","172","48","124","1","173","578","0","29.93","8.30"
"10","009","00","170","0020","0000","191","76","115","9","200","803","0","24.91","9.46"
"10","009","00","170","0020","0220","191","76","115","9","200","803","0","24.91","9.46"
"10","009","00","170","0021","0000","225","88","137","3","228","686","0","33.24","12.83"
"10","009","00","170","0021","0221","225","88","137","3","228","686","0","33.24","12.83"
"10","009","00","180","0000","0000","5445","2312","3133","105","5550","20121","22100","27.58","11.49"
"10","009","00","180","0001","0000","583","270","313","6","589","1728","0","34.09","15.63"
"10","009","00","180","0001","0171","326","147","179","4","330","1061","0","31.10","13.85"
"10","009","00","180","0001","0172","257","123","134","2","259","667","0","38.83","18.44"
"10","009","00","180","0002","0000","183","73","110","3","186","626","0","29.71","11.66"
"10","009","00","180","0002","0176","183","73","110","3","186","626","0","29.71","11.66"
"10","009","00","180","0003","0000","259","106","153","0","259","902","0","28.71","11.75"
"10","009","00","180","0003","0177","259","106","153","0","259","902","0","28.71","11.75"
"10","009","00","180","0004","0000","258","98","160","5","263","883","0","29.78","11.10"
"10","009","00","180","0004","0178","258","98","160","5","263","883","0","29.78","11.10"
"10","009","00","180","0005","0000","749","391","358","15","764","2201","0","34.71","17.76"
"10","009","00","180","0005","0173","303","180","123","5","308","846","0","36.41","21.28"
"10","009","00","180","0005","0174","131","26","105","4","135","459","0","29.41","5.66"
"10","009","00","180","0005","0175","315","185","130","6","321","896","0","35.83","20.65"
"10","009","00","180","0006","0000","294","146","148","0","294","1152","0","25.52","12.67"
"10","009","00","180","0006","0181","294","146","148","0","294","1152","0","25.52","12.67"
"10","009","00","180","0007","0000","183","75","108","8","191","712","0","26.83","10.53"
"10","009","00","180","0007","0180","183","75","108","8","191","712","0","26.83","10.53"
"10","009","00","180","0008","0000","210","87","123","3","213","828","0","25.72","10.51"
"10","009","00","180","0008","0179","210","87","123","3","213","828","0","25.72","10.51"
"10","009","00","180","0009","0000","227","110","117","0","227","846","0","26.83","13.00"
"10","009","00","180","0009","0185","227","110","117","0","227","846","0","26.83","13.00"
"10","009","00","180","0010","0000","83","34","49","3","86","352","0","24.43","9.66"
"10","009","00","180","0010","0186","83","34","49","3","86","352","0","24.43","9.66"
"10","009","00","180","0011","0000","189","66","123","3","192","743","0","25.84","8.88"
"10","009","00","180","0011","0183","189","66","123","3","192","743","0","25.84","8.88"
"10","009","00","180","0012","0000","220","96","124","7","227","898","0","25.28","10.69"
"10","009","00","180","0012","0182","220","96","124","7","227","898","0","25.28","10.69"
"10","009","00","180","0013","0000","379","162","217","5","384","1669","0","23.01","9.71"
"10","009","00","180","0013","0187","179","75","104","4","183","872","0","20.99","8.60"
"10","009","00","180","0013","0188","200","87","113","1","201","797","0","25.22","10.92"
"10","009","00","180","0014","0000","177","83","94","3","180","782","0","23.02","10.61"
"10","009","00","180","0014","0189","177","83","94","3","180","782","0","23.02","10.61"
"10","009","00","180","0015","0000","134","63","71","4","138","683","0","20.20","9.22"
"10","009","00","180","0015","0190","134","63","71","4","138","683","0","20.20","9.22"
"10","009","00","180","0016","0000","238","71","167","6","244","878","0","27.79","8.09"
"10","009","00","180","0016","0191","238","71","167","6","244","878","0","27.79","8.09"
"10","009","00","180","0017","0000","275","95","180","9","284","1016","0","27.95","9.35"
"10","009","00","180","0017","0193","275","95","180","9","284","1016","0","27.95","9.35"
"10","009","00","180","0018","0000","215","103","112","10","225","958","0","23.49","10.75"
"10","009","00","180","0018","0194","215","103","112","10","225","958","0","23.49","10.75"
"10","009","00","180","0019","0000","164","77","87","5","169","724","0","23.34","10.64"
"10","009","00","180","0019","0195","164","77","87","5","169","724","0","23.34","10.64"
"10","009","00","180","0020","0000","155","51","104","5","160","533","0","30.02","9.57"
"10","009","00","180","0020","0184","155","51","104","5","160","533","0","30.02","9.57"
"10","009","00","180","0021","0000","270","55","215","5","275","1007","0","27.31","5.46"
"10","009","00","180","0021","0192","270","55","215","5","275","1007","0","27.31","5.46"
"10","009","00","190","0000","0000","7430","2292","5138","123","7553","23413","26186","32.26","9.79"
"10","009","00","190","0001","0000","379","165","214","4","383","1198","0","31.97","13.77"
"10","009","00","190","0001","0223","379","165","214","4","383","1198","0","31.97","13.77"
"10","009","00","190","0002","0000","350","150","200","5","355","1068","0","33.24","14.04"
"10","009","00","190","0002","0222","350","150","200","5","355","1068","0","33.24","14.04"
"10","009","00","190","0003","0000","167","68","99","0","167","614","0","27.20","11.07"
"10","009","00","190","0003","0224","167","68","99","0","167","614","0","27.20","11.07"
"10","009","00","190","0004","0000","261","78","183","4","265","851","0","31.14","9.17"
"10","009","00","190","0004","0226","261","78","183","4","265","851","0","31.14","9.17"
"10","009","00","190","0005","0000","250","80","170","8","258","694","0","37.18","11.53"
"10","009","00","190","0005","0225","250","80","170","8","258","694","0","37.18","11.53"
"10","009","00","190","0006","0000","347","87","260","6","353","973","0","36.28","8.94"
"10","009","00","190","0006","0227","347","87","260","6","353","973","0","36.28","8.94"
"10","009","00","190","0007","0000","402","99","303","13","415","1405","0","29.54","7.05"
"10","009","00","190","0007","0228","402","99","303","13","415","1405","0","29.54","7.05"
"10","009","00","190","0008","0000","547","173","374","7","554","2020","0","27.43","8.56"
"10","009","00","190","0008","0229","213","60","153","0","213","843","0","25.27","7.12"
"10","009","00","190","0008","0230","334","113","221","7","341","1177","0","28.97","9.60"
"10","009","00","190","0009","0000","403","129","274","8","411","1473","0","27.90","8.76"
"10","009","00","190","0009","0231","205","64","141","4","209","729","0","28.67","8.78"
"10","009","00","190","0009","0232","198","65","133","4","202","744","0","27.15","8.74"
"10","009","00","190","0010","0000","399","155","244","5","404","1410","0","28.65","10.99"
"10","009","00","190","0010","0233","399","155","244","5","404","1410","0","28.65","10.99"
"10","009","00","190","0011","0000","142","36","106","2","144","511","0","28.18","7.05"
"10","009","00","190","0011","0234","142","36","106","2","144","511","0","28.18","7.05"
"10","009","00","190","0012","0000","426","159","267","8","434","1493","0","29.07","10.65"
"10","009","00","190","0012","0235","426","159","267","8","434","1493","0","29.07","10.65"
"10","009","00","190","0013","0000","256","87","169","4","260","806","0","32.26","10.79"
"10","009","00","190","0013","0236","256","87","169","4","260","806","0","32.26","10.79"
"10","009","00","190","0014","0000","639","97","542","7","646","1888","0","34.22","5.14"
"10","009","00","190","0014","0237","130","26","104","1","131","361","0","36.29","7.20"
"10","009","00","190","0014","0238","234","36","198","3","237","754","0","31.43","4.77"
"10","009","00","190","0014","0239","275","35","240","3","278","773","0","35.96","4.53"
"10","009","00","190","0015","0000","282","107","175","5","287","896","0","32.03","11.94"
"10","009","00","190","0015","0240","282","107","175","5","287","896","0","32.03","11.94"
"10","009","00","190","0016","0000","296","66","230","6","302","980","0","30.82","6.73"
"10","009","00","190","0016","0246","296","66","230","6","302","980","0","30.82","6.73"
"10","009","00","190","0017","0000","326","120","206","11","337","925","0","36.43","12.97"
"10","009","00","190","0017","0244","326","120","206","11","337","925","0","36.43","12.97"
"10","009","00","190","0018","0000","231","73","158","1","232","686","0","33.82","10.64"
"10","009","00","190","0018","0245","231","73","158","1","232","686","0","33.82","10.64"
"10","009","00","190","0019","0000","662","199","463","6","668","1773","0","37.68","11.22"
"10","009","00","190","0019","0241","363","92","271","5","368","920","0","40.00","10.00"
"10","009","00","190","0019","0242","299","107","192","1","300","853","0","35.17","12.54"
"10","009","00","190","0020","0000","482","104","378","7","489","1154","0","42.37","9.01"
"10","009","00","190","0020","0243","482","104","378","7","489","1154","0","42.37","9.01"
"10","009","00","190","0021","0000","183","60","123","6","189","595","0","31.76","10.08"
"10","009","00","190","0021","0247","183","60","123","6","189","595","0","31.76","10.08"
"10","009","00","200","0000","0000","7085","2085","5000","129","7214","21442","23934","33.64","9.72"
"10","009","00","200","0001","0000","646","218","428","12","658","2131","0","30.88","10.23"
"10","009","00","200","0001","0248","365","123","242","7","372","1274","0","29.20","9.65"
"10","009","00","200","0001","0249","281","95","186","5","286","857","0","33.37","11.09"
"10","009","00","200","0002","0000","722","235","487","9","731","1971","0","37.09","11.92"
"10","009","00","200","0002","0250","448","152","296","3","451","1238","0","36.43","12.28"
"10","009","00","200","0002","0251","274","83","191","6","280","733","0","38.20","11.32"
"10","009","00","200","0003","0000","356","78","278","5","361","969","0","37.25","8.05"
"10","009","00","200","0003","0271","356","78","278","5","361","969","0","37.25","8.05"
"10","009","00","200","0004","0000","405","85","320","8","413","1149","0","35.94","7.40"
"10","009","00","200","0004","0272","405","85","320","8","413","1149","0","35.94","7.40"
"10","009","00","200","0005","0000","318","93","225","3","321","944","0","34.00","9.85"
"10","009","00","200","0005","0258","318","93","225","3","321","944","0","34.00","9.85"
"10","009","00","200","0006","0000","194","82","112","5","199","598","0","33.28","13.71"
"10","009","00","200","0006","0259","194","82","112","5","199","598","0","33.28","13.71"
"10","009","00","200","0007","0000","183","65","118","3","186","597","0","31.16","10.89"
"10","009","00","200","0007","0260","183","65","118","3","186","597","0","31.16","10.89"
"10","009","00","200","0008","0000","296","74","222","7","303","943","0","32.13","7.85"
"10","009","00","200","0008","0261","296","74","222","7","303","943","0","32.13","7.85"
"10","009","00","200","0009","0000","178","88","90","4","182","603","0","30.18","14.59"
"10","009","00","200","0009","0262","178","88","90","4","182","603","0","30.18","14.59"
"10","009","00","200","0010","0000","287","104","183","4","291","905","0","32.15","11.49"
"10","009","00","200","0010","0263","287","104","183","4","291","905","0","32.15","11.49"
"10","009","00","200","0011","0000","211","52","159","3","214","680","0","31.47","7.65"
"10","009","00","200","0011","0252","211","52","159","3","214","680","0","31.47","7.65"
"10","009","00","200","0012","0000","203","44","159","1","204","627","0","32.54","7.02"
"10","009","00","200","0012","0253","203","44","159","1","204","627","0","32.54","7.02"
"10","009","00","200","0013","0000","363","103","260","4","367","1006","0","36.48","10.24"
"10","009","00","200","0013","0256","363","103","260","4","367","1006","0","36.48","10.24"
"10","009","00","200","0014","0000","340","100","240","7","347","967","0","35.88","10.34"
"10","009","00","200","0014","0254","340","100","240","7","347","967","0","35.88","10.34"
"10","009","00","200","0015","0000","266","66","200","5","271","803","0","33.75","8.22"
"10","009","00","200","0015","0255","266","66","200","5","271","803","0","33.75","8.22"
"10","009","00","200","0016","0000","320","98","222","5","325","927","0","35.06","10.57"
"10","009","00","200","0016","0264","320","98","222","5","325","927","0","35.06","10.57"
"10","009","00","200","0017","0000","243","70","173","8","251","776","0","32.35","9.02"
"10","009","00","200","0017","0265","243","70","173","8","251","776","0","32.35","9.02"
"10","009","00","200","0018","0000","286","111","175","5","291","989","0","29.42","11.22"
"10","009","00","200","0018","0266","286","111","175","5","291","989","0","29.42","11.22"
"10","009","00","200","0019","0000","188","44","144","1","189","484","0","39.05","9.09"
"10","009","00","200","0019","0267","188","44","144","1","189","484","0","39.05","9.09"
"10","009","00","200","0020","0000","197","41","156","3","200","647","0","30.91","6.34"
"10","009","00","200","0020","0268","197","41","156","3","200","647","0","30.91","6.34"
"10","009","00","200","0021","0000","223","36","187","6","229","655","0","34.96","5.50"
"10","009","00","200","0021","0269","223","36","187","6","229","655","0","34.96","5.50"
"10","009","00","200","0022","0000","188","42","146","5","193","653","0","29.56","6.43"
"10","009","00","200","0022","0270","188","42","146","5","193","653","0","29.56","6.43"
"10","009","00","200","0023","0000","228","71","157","3","231","653","0","35.38","10.87"
"10","009","00","200","0023","0257","228","71","157","3","231","653","0","35.38","10.87"
"10","009","00","200","0024","0000","244","85","159","13","257","765","0","33.59","11.11"
"10","009","00","200","0024","0273","244","85","159","13","257","765","0","33.59","11.11"
"10","010","00","000","0000","0000","163921","62465","101456","2020","165941","436894","496440","37.98","14.30"
"10","010","00","010","0000","0000","12463","4730","7733","127","12590","32207","38651","39.09","14.69"
"10","010","00","010","0001","0000","865","385","480","16","881","2315","0","38.06","16.63"
"10","010","00","010","0001","0094","468","233","235","8","476","1259","0","37.81","18.51"
"10","010","00","010","0001","0095","397","152","245","8","405","1056","0","38.35","14.39"
"10","010","00","010","0002","0000","189","44","145","1","190","466","0","40.77","9.44"
"10","010","00","010","0002","0096","189","44","145","1","190","466","0","40.77","9.44"
"10","010","00","010","0003","0000","610","205","405","12","622","1453","0","42.81","14.11"
"10","010","00","010","0003","0097","317","108","209","4","321","719","0","44.65","15.02"
"10","010","00","010","0003","0098","293","97","196","8","301","734","0","41.01","13.22"
"10","010","00","010","0004","0000","727","283","444","9","736","1685","0","43.68","16.80"
"10","010","00","010","0004","0099","358","129","229","4","362","754","0","48.01","17.11"
"10","010","00","010","0004","0100","369","154","215","5","374","931","0","40.17","16.54"
"10","010","00","010","0005","0000","470","175","295","11","481","1133","0","42.45","15.45"
"10","010","00","010","0005","0101","319","123","196","6","325","748","0","43.45","16.44"
"10","010","00","010","0005","0102","151","52","99","5","156","385","0","40.52","13.51"
"10","010","00","010","0006","0000","383","125","258","3","386","1105","0","34.93","11.31"
"10","010","00","010","0006","0103","383","125","258","3","386","1105","0","34.93","11.31"
"10","010","00","010","0007","0000","329","135","194","4","333","817","0","40.76","16.52"
"10","010","00","010","0007","0104","329","135","194","4","333","817","0","40.76","16.52"
"10","010","00","010","0008","0000","766","336","430","7","773","1799","0","42.97","18.68"
"10","010","00","010","0008","0109","372","138","234","2","374","916","0","40.83","15.07"
"10","010","00","010","0008","0110","394","198","196","5","399","883","0","45.19","22.42"
"10","010","00","010","0009","0000","491","163","328","6","497","1244","0","39.95","13.10"
"10","010","00","010","0009","0111","241","86","155","2","243","631","0","38.51","13.63"
"10","010","00","010","0009","0112","250","77","173","4","254","613","0","41.44","12.56"
"10","010","00","010","0010","0000","909","342","567","7","916","2556","0","35.84","13.38"
"10","010","00","010","0010","0113","295","99","196","2","297","818","0","36.31","12.10"
"10","010","00","010","0010","0114","614","243","371","5","619","1738","0","35.62","13.98"
"10","010","00","010","0011","0000","292","104","188","2","294","724","0","40.61","14.36"
"10","010","00","010","0011","0115","190","63","127","2","192","483","0","39.75","13.04"
"10","010","00","010","0011","0116","102","41","61","0","102","241","0","42.32","17.01"
"10","010","00","010","0012","0000","217","89","128","4","221","547","0","40.40","16.27"
"10","010","00","010","0012","0117","120","39","81","4","124","300","0","41.33","13.00"
"10","010","00","010","0012","0118","97","50","47","0","97","247","0","39.27","20.24"
"10","010","00","010","0013","0000","1396","500","896","8","1404","3489","0","40.24","14.33"
"10","010","00","010","0013","0119","455","124","331","4","459","1084","0","42.34","11.44"
"10","010","00","010","0013","0120","330","138","192","1","331","824","0","40.17","16.75"
"10","010","00","010","0013","0121","357","136","221","2","359","968","0","37.09","14.05"
"10","010","00","010","0013","0122","254","102","152","1","255","613","0","41.60","16.64"
"10","010","00","010","0014","0000","1676","639","1037","17","1693","4625","0","36.61","13.82"
"10","010","00","010","0014","0123","308","114","194","2","310","945","0","32.80","12.06"
"10","010","00","010","0014","0124","385","135","250","3","388","893","0","43.45","15.12"
"10","010","00","010","0014","0125","350","143","207","5","355","936","0","37.93","15.28"
"10","010","00","010","0014","0126","328","131","197","3","331","971","0","34.09","13.49"
"10","010","00","010","0014","0127","305","116","189","4","309","880","0","35.11","13.18"
"10","010","00","010","0015","0000","711","217","494","5","716","1819","0","39.36","11.93"
"10","010","00","010","0015","0128","316","87","229","2","318","811","0","39.21","10.73"
"10","010","00","010","0015","0129","395","130","265","3","398","1008","0","39.48","12.90"
"10","010","00","010","0016","0000","1118","393","725","9","1127","3112","0","36.21","12.63"
"10","010","00","010","0016","0130","446","128","318","3","449","1189","0","37.76","10.77"
"10","010","00","010","0016","0131","379","169","210","3","382","1142","0","33.45","14.80"
"10","010","00","010","0016","0132","293","96","197","3","296","781","0","37.90","12.29"
"10","010","00","010","0017","0000","272","108","164","2","274","679","0","40.35","15.91"
"10","010","00","010","0017","0133","272","108","164","2","274","679","0","40.35","15.91"
"10","010","00","010","0018","0000","1042","487","555","4","1046","2639","0","39.64","18.45"
"10","010","00","010","0018","0105","65","24","41","1","66","212","0","31.13","11.32"
"10","010","00","010","0018","0106","287","89","198","1","288","706","0","40.79","12.61"
"10","010","00","010","0018","0107","350","192","158","2","352","893","0","39.42","21.50"
"10","010","00","010","0018","0108","340","182","158","0","340","828","0","41.06","21.98"
"10","010","00","020","0000","0000","13473","5139","8334","154","13627","34834","41439","39.12","14.75"
"10","010","00","020","0001","0000","720","351","369","7","727","1887","0","38.53","18.60"
"10","010","00","020","0001","0058","439","224","215","3","442","1140","0","38.77","19.65"
"10","010","00","020","0001","0059","281","127","154","4","285","747","0","38.15","17.00"
"10","010","00","020","0002","0000","948","434","514","4","952","2322","0","41.00","18.69"
"10","010","00","020","0002","0060","477","223","254","1","478","1219","0","39.21","18.29"
"10","010","00","020","0002","0061","471","211","260","3","474","1103","0","42.97","19.13"
"10","010","00","020","0003","0000","482","170","312","2","484","1092","0","44.32","15.57"
"10","010","00","020","0003","0062","482","170","312","2","484","1092","0","44.32","15.57"
"10","010","00","020","0004","0000","177","63","114","2","179","377","0","47.48","16.71"
"10","010","00","020","0004","0063","177","63","114","2","179","377","0","47.48","16.71"
"10","010","00","020","0005","0000","262","102","160","1","263","610","0","43.11","16.72"
"10","010","00","020","0005","0064","262","102","160","1","263","610","0","43.11","16.72"
"10","010","00","020","0006","0000","293","134","159","5","298","618","0","48.22","21.68"
"10","010","00","020","0006","0065","293","134","159","5","298","618","0","48.22","21.68"
"10","010","00","020","0007","0000","325","121","204","3","328","819","0","40.05","14.77"
"10","010","00","020","0007","0066","325","121","204","3","328","819","0","40.05","14.77"
"10","010","00","020","0008","0000","704","307","397","5","709","1676","0","42.30","18.32"
"10","010","00","020","0008","0067","310","122","188","3","313","748","0","41.84","16.31"
"10","010","00","020","0008","0068","394","185","209","2","396","928","0","42.67","19.94"
"10","010","00","020","0009","0000","935","317","618","8","943","2498","0","37.75","12.69"
"10","010","00","020","0009","0069","442","175","267","4","446","1110","0","40.18","15.77"
"10","010","00","020","0009","0070","493","142","351","4","497","1388","0","35.81","10.23"
"10","010","00","020","0010","0000","1728","772","956","19","1747","4243","0","41.17","18.19"
"10","010","00","020","0010","0071","580","289","291","6","586","1536","0","38.15","18.82"
"10","010","00","020","0010","0072","494","206","288","7","501","1222","0","41.00","16.86"
"10","010","00","020","0010","0073","654","277","377","6","660","1485","0","44.44","18.65"
"10","010","00","020","0011","0000","241","82","159","0","241","669","0","36.02","12.26"
"10","010","00","020","0011","0074","241","82","159","0","241","669","0","36.02","12.26"
"10","010","00","020","0012","0000","190","68","122","2","192","608","0","31.58","11.18"
"10","010","00","020","0012","0075","190","68","122","2","192","608","0","31.58","11.18"
"10","010","00","020","0013","0000","273","91","182","2","275","768","0","35.81","11.85"
"10","010","00","020","0013","0076","273","91","182","2","275","768","0","35.81","11.85"
"10","010","00","020","0014","0000","407","97","310","7","414","1015","0","40.79","9.56"
"10","010","00","020","0014","0077","407","97","310","7","414","1015","0","40.79","9.56"
"10","010","00","020","0015","0000","669","302","367","7","676","1769","0","38.21","17.07"
"10","010","00","020","0015","0078","669","302","367","7","676","1769","0","38.21","17.07"
"10","010","00","020","0016","0000","1105","408","697","18","1123","3190","0","35.20","12.79"
"10","010","00","020","0016","0079","473","191","282","10","483","1385","0","34.87","13.79"
"10","010","00","020","0016","0080","321","132","189","2","323","888","0","36.37","14.86"
"10","010","00","020","0016","0081","311","85","226","6","317","917","0","34.57","9.27"
"10","010","00","020","0017","0000","1085","442","643","10","1095","2926","0","37.42","15.11"
"10","010","00","020","0017","0082","548","169","379","8","556","1583","0","35.12","10.68"
"10","010","00","020","0017","0083","537","273","264","2","539","1343","0","40.13","20.33"
"10","010","00","020","0018","0000","247","88","159","5","252","742","0","33.96","11.86"
"10","010","00","020","0018","0084","247","88","159","5","252","742","0","33.96","11.86"
"10","010","00","020","0019","0000","413","157","256","3","416","1040","0","40.00","15.10"
"10","010","00","020","0019","0085","413","157","256","3","416","1040","0","40.00","15.10"
"10","010","00","020","0020","0000","326","108","218","8","334","870","0","38.39","12.41"
"10","010","00","020","0020","0086","326","108","218","8","334","870","0","38.39","12.41"
"10","010","00","020","0021","0000","112","36","76","3","115","246","0","46.75","14.63"
"10","010","00","020","0021","0088","112","36","76","3","115","246","0","46.75","14.63"
"10","010","00","020","0022","0000","269","80","189","6","275","709","0","38.79","11.28"
"10","010","00","020","0022","0087","269","80","189","6","275","709","0","38.79","11.28"
"10","010","00","020","0023","0000","262","81","181","4","266","767","0","34.68","10.56"
"10","010","00","020","0023","0089","262","81","181","4","266","767","0","34.68","10.56"
"10","010","00","020","0024","0000","268","120","148","5","273","678","0","40.27","17.70"
"10","010","00","020","0024","0090","268","120","148","5","273","678","0","40.27","17.70"
"10","010","00","020","0025","0000","415","85","330","7","422","1019","0","41.41","8.34"
"10","010","00","020","0025","0091","415","85","330","7","422","1019","0","41.41","8.34"
"10","010","00","020","0026","0000","422","96","326","7","429","1190","0","36.05","8.07"
"10","010","00","020","0026","0092","422","96","326","7","429","1190","0","36.05","8.07"
"10","010","00","020","0027","0000","195","27","168","4","199","486","0","40.95","5.56"
"10","010","00","020","0027","0093","195","27","168","4","199","486","0","40.95","5.56"
"10","010","00","030","0000","0000","8327","3212","5115","132","8459","23144","25692","36.55","13.88"
"10","010","00","030","0001","0000","227","118","109","5","232","593","0","39.12","19.90"
"10","010","00","030","0001","0134","227","118","109","5","232","593","0","39.12","19.90"
"10","010","00","030","0002","0000","144","72","72","3","147","356","0","41.29","20.22"
"10","010","00","030","0002","0135","144","72","72","3","147","356","0","41.29","20.22"
"10","010","00","030","0003","0000","793","350","443","9","802","2143","0","37.42","16.33"
"10","010","00","030","0003","0136","344","156","188","7","351","918","0","38.24","16.99"
"10","010","00","030","0003","0137","449","194","255","2","451","1225","0","36.82","15.84"
"10","010","00","030","0004","0000","386","166","220","3","389","1064","0","36.56","15.60"
"10","010","00","030","0004","0138","386","166","220","3","389","1064","0","36.56","15.60"
"10","010","00","030","0005","0000","678","313","365","12","690","1593","0","43.31","19.65"
"10","010","00","030","0005","0139","390","179","211","8","398","939","0","42.39","19.06"
"10","010","00","030","0005","0140","288","134","154","4","292","654","0","44.65","20.49"
"10","010","00","030","0006","0000","302","104","198","0","302","860","0","35.12","12.09"
"10","010","00","030","0006","0141","302","104","198","0","302","860","0","35.12","12.09"
"10","010","00","030","0007","0000","200","99","101","5","205","683","0","30.01","14.49"
"10","010","00","030","0007","0142","200","99","101","5","205","683","0","30.01","14.49"
"10","010","00","030","0008","0000","228","94","134","4","232","742","0","31.27","12.67"
"10","010","00","030","0008","0143","228","94","134","4","232","742","0","31.27","12.67"
"10","010","00","030","0009","0000","392","102","290","9","401","920","0","43.59","11.09"
"10","010","00","030","0009","0158","392","102","290","9","401","920","0","43.59","11.09"
"10","010","00","030","0010","0000","381","139","242","4","385","1287","0","29.91","10.80"
"10","010","00","030","0010","0159","381","139","242","4","385","1287","0","29.91","10.80"
"10","010","00","030","0011","0000","757","277","480","8","765","2276","0","33.61","12.17"
"10","010","00","030","0011","0160","356","132","224","3","359","1070","0","33.55","12.34"
"10","010","00","030","0011","0161","401","145","256","5","406","1206","0","33.67","12.02"
"10","010","00","030","0012","0000","331","121","210","9","340","1106","0","30.74","10.94"
"10","010","00","030","0012","0162","331","121","210","9","340","1106","0","30.74","10.94"
"10","010","00","030","0013","0000","362","172","190","7","369","1090","0","33.85","15.78"
"10","010","00","030","0013","0151","362","172","190","7","369","1090","0","33.85","15.78"
"10","010","00","030","0014","0000","685","245","440","11","696","1861","0","37.40","13.16"
"10","010","00","030","0014","0152","342","107","235","5","347","924","0","37.55","11.58"
"10","010","00","030","0014","0153","343","138","205","6","349","937","0","37.25","14.73"
"10","010","00","030","0015","0000","105","40","65","1","106","281","0","37.72","14.23"
"10","010","00","030","0015","0154","105","40","65","1","106","281","0","37.72","14.23"
"10","010","00","030","0016","0000","140","58","82","3","143","385","0","37.14","15.06"
"10","010","00","030","0016","0155","140","58","82","3","143","385","0","37.14","15.06"
"10","010","00","030","0017","0000","125","40","85","2","127","288","0","44.10","13.89"
"10","010","00","030","0017","0156","57","22","35","0","57","117","0","48.72","18.80"
"10","010","00","030","0017","0157","68","18","50","2","70","171","0","40.94","10.53"
"10","010","00","030","0018","0000","241","124","117","1","242","713","0","33.94","17.39"
"10","010","00","030","0018","0144","241","124","117","1","242","713","0","33.94","17.39"
"10","010","00","030","0019","0000","418","160","258","8","426","1117","0","38.14","14.32"
"10","010","00","030","0019","0145","418","160","258","8","426","1117","0","38.14","14.32"
"10","010","00","030","0020","0000","537","157","380","9","546","1286","0","42.46","12.21"
"10","010","00","030","0020","0147","537","157","380","9","546","1286","0","42.46","12.21"
"10","010","00","030","0021","0000","468","139","329","8","476","1350","0","35.26","10.30"
"10","010","00","030","0021","0146","468","139","329","8","476","1350","0","35.26","10.30"
"10","010","00","030","0022","0000","191","63","128","8","199","518","0","38.42","12.16"
"10","010","00","030","0022","0148","114","39","75","4","118","270","0","43.70","14.44"
"10","010","00","030","0022","0149","77","24","53","4","81","248","0","32.66","9.68"
"10","010","00","030","0023","0000","236","59","177","3","239","632","0","37.82","9.34"
"10","010","00","030","0023","0150","236","59","177","3","239","632","0","37.82","9.34"
"10","010","00","040","0000","0000","10588","4333","6255","118","10706","26546","30237","40.33","16.32"
"10","010","00","040","0001","0000","214","91","123","3","217","467","0","46.47","19.49"
"10","010","00","040","0001","0274","214","91","123","3","217","467","0","46.47","19.49"
"10","010","00","040","0002","0000","812","340","472","6","818","1816","0","45.04","18.72"
"10","010","00","040","0002","0275","375","159","216","3","378","892","0","42.38","17.83"
"10","010","00","040","0002","0276","437","181","256","3","440","924","0","47.62","19.59"
"10","010","00","040","0003","0000","384","188","196","3","387","885","0","43.73","21.24"
"10","010","00","040","0003","0277","384","188","196","3","387","885","0","43.73","21.24"
"10","010","00","040","0004","0000","2379","1079","1300","16","2395","5889","0","40.67","18.32"
"10","010","00","040","0004","0278","594","237","357","1","595","1407","0","42.29","16.84"
"10","010","00","040","0004","0279","546","250","296","5","551","1394","0","39.53","17.93"
"10","010","00","040","0004","0280","610","264","346","4","614","1520","0","40.39","17.37"
"10","010","00","040","0004","0281","629","328","301","6","635","1568","0","40.50","20.92"
"10","010","00","040","0005","0000","476","158","318","10","486","1127","0","43.12","14.02"
"10","010","00","040","0005","0282","476","158","318","10","486","1127","0","43.12","14.02"
"10","010","00","040","0006","0000","659","308","351","6","665","1783","0","37.30","17.27"
"10","010","00","040","0006","0283","659","308","351","6","665","1783","0","37.30","17.27"
"10","010","00","040","0007","0000","269","64","205","0","269","595","0","45.21","10.76"
"10","010","00","040","0007","0284","269","64","205","0","269","595","0","45.21","10.76"
"10","010","00","040","0008","0000","259","66","193","3","262","703","0","37.27","9.39"
"10","010","00","040","0008","0285","259","66","193","3","262","703","0","37.27","9.39"
"10","010","00","040","0009","0000","263","83","180","6","269","612","0","43.95","13.56"
"10","010","00","040","0009","0286","263","83","180","6","269","612","0","43.95","13.56"
"10","010","00","040","0010","0000","73","40","33","2","75","184","0","40.76","21.74"
"10","010","00","040","0010","0287","73","40","33","2","75","184","0","40.76","21.74"
"10","010","00","040","0011","0000","553","247","306","4","557","1563","0","35.64","15.80"
"10","010","00","040","0011","0288","553","247","306","4","557","1563","0","35.64","15.80"
"10","010","00","040","0012","0000","523","206","317","9","532","1405","0","37.86","14.66"
"10","010","00","040","0012","0289","523","206","317","9","532","1405","0","37.86","14.66"
"10","010","00","040","0013","0000","529","203","326","5","534","1327","0","40.24","15.30"
"10","010","00","040","0013","0290","399","161","238","5","404","979","0","41.27","16.45"
"10","010","00","040","0013","0291","130","42","88","0","130","348","0","37.36","12.07"
"10","010","00","040","0014","0000","318","124","194","5","323","793","0","40.73","15.64"
"10","010","00","040","0014","0292","318","124","194","5","323","793","0","40.73","15.64"
"10","010","00","040","0015","0000","640","199","441","12","652","1546","0","42.17","12.87"
"10","010","00","040","0015","0293","640","199","441","12","652","1546","0","42.17","12.87"
"10","010","00","040","0016","0000","732","306","426","8","740","2009","0","36.83","15.23"
"10","010","00","040","0016","0294","365","169","196","6","371","961","0","38.61","17.59"
"10","010","00","040","0016","0295","367","137","230","2","369","1048","0","35.21","13.07"
"10","010","00","040","0017","0000","347","123","224","3","350","905","0","38.67","13.59"
"10","010","00","040","0017","0296","347","123","224","3","350","905","0","38.67","13.59"
"10","010","00","040","0018","0000","253","122","131","5","258","656","0","39.33","18.60"
"10","010","00","040","0018","0297","253","122","131","5","258","656","0","39.33","18.60"
"10","010","00","040","0019","0000","270","120","150","7","277","644","0","43.01","18.63"
"10","010","00","040","0019","0298","270","120","150","7","277","644","0","43.01","18.63"
"10","010","00","040","0020","0000","294","134","160","2","296","817","0","36.23","16.40"
"10","010","00","040","0020","0299","294","134","160","2","296","817","0","36.23","16.40"
"10","010","00","040","0021","0000","341","132","209","3","344","820","0","41.95","16.10"
"10","010","00","040","0021","0300","341","132","209","3","344","820","0","41.95","16.10"
"10","010","00","050","0000","0000","24062","9591","14471","241","24303","61483","71044","39.53","15.60"
"10","010","00","050","0001","0000","938","405","533","6","944","2300","0","41.04","17.61"
"10","010","00","050","0001","0358","558","242","316","4","562","1280","0","43.91","18.91"
"10","010","00","050","0001","0359","380","163","217","2","382","1020","0","37.45","15.98"
"10","010","00","050","0002","0000","675","326","349","8","683","1528","0","44.70","21.34"
"10","010","00","050","0002","0360","675","326","349","8","683","1528","0","44.70","21.34"
"10","010","00","050","0003","0000","1396","550","846","11","1407","3338","0","42.15","16.48"
"10","010","00","050","0003","0361","737","286","451","6","743","1664","0","44.65","17.19"
"10","010","00","050","0003","0362","659","264","395","5","664","1674","0","39.67","15.77"
"10","010","00","050","0004","0000","875","336","539","8","883","2158","0","40.92","15.57"
"10","010","00","050","0004","0363","475","149","326","4","479","1080","0","44.35","13.80"
"10","010","00","050","0004","0364","400","187","213","4","404","1078","0","37.48","17.35"
"10","010","00","050","0005","0000","678","221","457","7","685","1567","0","43.71","14.10"
"10","010","00","050","0005","0365","678","221","457","7","685","1567","0","43.71","14.10"
"10","010","00","050","0006","0000","642","267","375","7","649","1827","0","35.52","14.61"
"10","010","00","050","0006","0366","237","94","143","4","241","701","0","34.38","13.41"
"10","010","00","050","0006","0367","405","173","232","3","408","1126","0","36.23","15.36"
"10","010","00","050","0007","0000","566","237","329","7","573","1469","0","39.01","16.13"
"10","010","00","050","0007","0368","566","237","329","7","573","1469","0","39.01","16.13"
"10","010","00","050","0008","0000","685","172","513","14","699","1708","0","40.93","10.07"
"10","010","00","050","0008","0369","386","101","285","9","395","956","0","41.32","10.56"
"10","010","00","050","0008","0370","299","71","228","5","304","752","0","40.43","9.44"
"10","010","00","050","0009","0000","365","161","204","4","369","962","0","38.36","16.74"
"10","010","00","050","0009","0371","365","161","204","4","369","962","0","38.36","16.74"
"10","010","00","050","0010","0000","349","120","229","4","353","817","0","43.21","14.69"
"10","010","00","050","0010","0372","349","120","229","4","353","817","0","43.21","14.69"
"10","010","00","050","0011","0000","347","103","244","2","349","821","0","42.51","12.55"
"10","010","00","050","0011","0373","347","103","244","2","349","821","0","42.51","12.55"
"10","010","00","050","0012","0000","836","384","452","8","844","2163","0","39.02","17.75"
"10","010","00","050","0012","0374","663","312","351","4","667","1752","0","38.07","17.81"
"10","010","00","050","0012","0375","173","72","101","4","177","411","0","43.07","17.52"
"10","010","00","050","0013","0000","599","255","344","9","608","1346","0","45.17","18.95"
"10","010","00","050","0013","0376","599","255","344","9","608","1346","0","45.17","18.95"
"10","010","00","050","0014","0000","207","84","123","2","209","523","0","39.96","16.06"
"10","010","00","050","0014","0377","207","84","123","2","209","523","0","39.96","16.06"
"10","010","00","050","0015","0000","458","187","271","12","470","1154","0","40.73","16.20"
"10","010","00","050","0015","0378","458","187","271","12","470","1154","0","40.73","16.20"
"10","010","00","050","0016","0000","670","270","400","3","673","1837","0","36.64","14.70"
"10","010","00","050","0016","0396","318","127","191","1","319","955","0","33.40","13.30"
"10","010","00","050","0016","0397","352","143","209","2","354","882","0","40.14","16.21"
"10","010","00","050","0017","0000","933","371","562","10","943","2740","0","34.42","13.54"
"10","010","00","050","0017","0398","467","181","286","5","472","1292","0","36.53","14.01"
"10","010","00","050","0017","0399","466","190","276","5","471","1448","0","32.53","13.12"
"10","010","00","050","0018","0000","851","320","531","7","858","1995","0","43.01","16.04"
"10","010","00","050","0018","0402","418","160","258","3","421","907","0","46.42","17.64"
"10","010","00","050","0018","0403","433","160","273","4","437","1088","0","40.17","14.71"
"10","010","00","050","0019","0000","995","438","557","10","1005","2450","0","41.02","17.88"
"10","010","00","050","0019","0404","555","215","340","5","560","1361","0","41.15","15.80"
"10","010","00","050","0019","0405","440","223","217","5","445","1089","0","40.86","20.48"
"10","010","00","050","0020","0000","1379","488","891","19","1398","3513","0","39.80","13.89"
"10","010","00","050","0020","0406","471","152","319","7","478","1232","0","38.80","12.34"
"10","010","00","050","0020","0407","472","175","297","5","477","1148","0","41.55","15.24"
"10","010","00","050","0020","0408","436","161","275","7","443","1133","0","39.10","14.21"
"10","010","00","050","0021","0000","515","162","353","5","520","1281","0","40.59","12.65"
"10","010","00","050","0021","0409","515","162","353","5","520","1281","0","40.59","12.65"
"10","010","00","050","0022","0000","1937","794","1143","12","1949","5279","0","36.92","15.04"
"10","010","00","050","0022","0379","616","235","381","2","618","1494","0","41.37","15.73"
"10","010","00","050","0022","0380","588","243","345","8","596","1633","0","36.50","14.88"
"10","010","00","050","0022","0381","270","102","168","1","271","750","0","36.13","13.60"
"10","010","00","050","0022","0382","463","214","249","1","464","1402","0","33.10","15.26"
"10","010","00","050","0023","0000","954","467","487","10","964","2449","0","39.36","19.07"
"10","010","00","050","0023","0383","470","222","248","8","478","1211","0","39.47","18.33"
"10","010","00","050","0023","0384","484","245","239","2","486","1238","0","39.26","19.79"
"10","010","00","050","0024","0000","885","365","520","8","893","2361","0","37.82","15.46"
"10","010","00","050","0024","0390","384","150","234","2","386","1014","0","38.07","14.79"
"10","010","00","050","0024","0391","501","215","286","6","507","1347","0","37.64","15.96"
"10","010","00","050","0025","0000","1027","348","679","18","1045","2602","0","40.16","13.37"
"10","010","00","050","0025","0392","628","210","418","12","640","1639","0","39.05","12.81"
"10","010","00","050","0025","0393","399","138","261","6","405","963","0","42.06","14.33"
"10","010","00","050","0026","0000","590","228","362","6","596","1690","0","35.27","13.49"
"10","010","00","050","0026","0394","387","143","244","5","392","1051","0","37.30","13.61"
"10","010","00","050","0026","0395","203","85","118","1","204","639","0","31.92","13.30"
"10","010","00","050","0027","0000","1136","465","671","9","1145","2956","0","38.73","15.73"
"10","010","00","050","0027","0400","521","186","335","4","525","1372","0","38.27","13.56"
"10","010","00","050","0027","0401","615","279","336","5","620","1584","0","39.14","17.61"
"10","010","00","050","0028","0000","2574","1067","1507","15","2589","6649","0","38.94","16.05"
"10","010","00","050","0028","0385","488","214","274","2","490","1301","0","37.66","16.45"
"10","010","00","050","0028","0386","518","236","282","1","519","1338","0","38.79","17.64"
"10","010","00","050","0028","0387","535","224","311","2","537","1390","0","38.63","16.12"
"10","010","00","050","0028","0388","491","214","277","2","493","1281","0","38.49","16.71"
"10","010","00","050","0028","0389","542","179","363","8","550","1339","0","41.08","13.37"
"10","010","00","060","0000","0000","4781","1420","3361","71","4852","12575","13890","38.58","11.29"
"10","010","00","060","0001","0000","509","193","316","9","518","1277","0","40.56","15.11"
"10","010","00","060","0001","0257","509","193","316","9","518","1277","0","40.56","15.11"
"10","010","00","060","0002","0000","291","96","195","4","295","653","0","45.18","14.70"
"10","010","00","060","0002","0258","291","96","195","4","295","653","0","45.18","14.70"
"10","010","00","060","0003","0000","230","72","158","6","236","636","0","37.11","11.32"
"10","010","00","060","0003","0259","134","35","99","4","138","382","0","36.13","9.16"
"10","010","00","060","0003","0260","96","37","59","2","98","254","0","38.58","14.57"
"10","010","00","060","0004","0000","396","96","300","3","399","952","0","41.91","10.08"
"10","010","00","060","0004","0273","396","96","300","3","399","952","0","41.91","10.08"
"10","010","00","060","0005","0000","260","55","205","3","263","656","0","40.09","8.38"
"10","010","00","060","0005","0272","260","55","205","3","263","656","0","40.09","8.38"
"10","010","00","060","0006","0000","279","74","205","5","284","758","0","37.47","9.76"
"10","010","00","060","0006","0266","279","74","205","5","284","758","0","37.47","9.76"
"10","010","00","060","0007","0000","260","62","198","4","264","803","0","32.88","7.72"
"10","010","00","060","0007","0267","260","62","198","4","264","803","0","32.88","7.72"
"10","010","00","060","0008","0000","364","86","278","9","373","1113","0","33.51","7.73"
"10","010","00","060","0008","0268","364","86","278","9","373","1113","0","33.51","7.73"
"10","010","00","060","0009","0000","331","103","228","4","335","971","0","34.50","10.61"
"10","010","00","060","0009","0269","331","103","228","4","335","971","0","34.50","10.61"
"10","010","00","060","0010","0000","366","127","239","7","373","921","0","40.50","13.79"
"10","010","00","060","0010","0270","215","64","151","4","219","538","0","40.71","11.90"
"10","010","00","060","0010","0271","151","63","88","3","154","383","0","40.21","16.45"
"10","010","00","060","0011","0000","500","159","341","7","507","1264","0","40.11","12.58"
"10","010","00","060","0011","0261","341","130","211","6","347","885","0","39.21","14.69"
"10","010","00","060","0011","0262","159","29","130","1","160","379","0","42.22","7.65"
"10","010","00","060","0012","0000","394","115","279","4","398","1013","0","39.29","11.35"
"10","010","00","060","0012","0263","394","115","279","4","398","1013","0","39.29","11.35"
"10","010","00","060","0013","0000","242","74","168","3","245","680","0","36.03","10.88"
"10","010","00","060","0013","0264","242","74","168","3","245","680","0","36.03","10.88"
"10","010","00","060","0014","0000","359","108","251","3","362","878","0","41.23","12.30"
"10","010","00","060","0014","0265","359","108","251","3","362","878","0","41.23","12.30"
"10","010","00","070","0000","0000","10844","3408","7436","144","10988","27120","30952","40.52","12.57"
"10","010","00","070","0001","0000","985","432","553","7","992","2204","0","45.01","19.60"
"10","010","00","070","0001","0324","477","194","283","5","482","1059","0","45.51","18.32"
"10","010","00","070","0001","0325","508","238","270","2","510","1145","0","44.54","20.79"
"10","010","00","070","0002","0000","652","229","423","8","660","1541","0","42.83","14.86"
"10","010","00","070","0002","0326","310","118","192","3","313","701","0","44.65","16.83"
"10","010","00","070","0002","0327","342","111","231","5","347","840","0","41.31","13.21"
"10","010","00","070","0003","0000","585","210","375","6","591","1424","0","41.50","14.75"
"10","010","00","070","0003","0328","269","105","164","2","271","666","0","40.69","15.77"
"10","010","00","070","0003","0329","316","105","211","4","320","758","0","42.22","13.85"
"10","010","00","070","0004","0000","632","246","386","10","642","1618","0","39.68","15.20"
"10","010","00","070","0004","0330","320","131","189","3","323","783","0","41.25","16.73"
"10","010","00","070","0004","0331","312","115","197","7","319","835","0","38.20","13.77"
"10","010","00","070","0005","0000","531","120","411","6","537","1375","0","39.05","8.73"
"10","010","00","070","0005","0332","259","68","191","5","264","689","0","38.32","9.87"
"10","010","00","070","0005","0333","272","52","220","1","273","686","0","39.80","7.58"
"10","010","00","070","0006","0000","643","178","465","10","653","1582","0","41.28","11.25"
"10","010","00","070","0006","0334","307","93","214","3","310","742","0","41.78","12.53"
"10","010","00","070","0006","0335","336","85","251","7","343","840","0","40.83","10.12"
"10","010","00","070","0007","0000","625","175","450","13","638","1618","0","39.43","10.82"
"10","010","00","070","0007","0336","306","81","225","8","314","782","0","40.15","10.36"
"10","010","00","070","0007","0337","319","94","225","5","324","836","0","38.76","11.24"
"10","010","00","070","0008","0000","379","141","238","5","384","931","0","41.25","15.15"
"10","010","00","070","0008","0338","379","141","238","5","384","931","0","41.25","15.15"
"10","010","00","070","0009","0000","215","53","162","2","217","549","0","39.53","9.65"
"10","010","00","070","0009","0339","215","53","162","2","217","549","0","39.53","9.65"
"10","010","00","070","0010","0000","361","52","309","6","367","886","0","41.42","5.87"
"10","010","00","070","0010","0340","361","52","309","6","367","886","0","41.42","5.87"
"10","010","00","070","0011","0000","166","32","134","6","172","465","0","36.99","6.88"
"10","010","00","070","0011","0341","166","32","134","6","172","465","0","36.99","6.88"
"10","010","00","070","0012","0000","195","64","131","2","197","486","0","40.53","13.17"
"10","010","00","070","0012","0342","195","64","131","2","197","486","0","40.53","13.17"
"10","010","00","070","0013","0000","749","196","553","14","763","1627","0","46.90","12.05"
"10","010","00","070","0013","0343","348","83","265","6","354","785","0","45.10","10.57"
"10","010","00","070","0013","0344","401","113","288","8","409","842","0","48.57","13.42"
"10","010","00","070","0014","0000","585","145","440","8","593","1538","0","38.56","9.43"
"10","010","00","070","0014","0345","282","63","219","6","288","798","0","36.09","7.89"
"10","010","00","070","0014","0346","303","82","221","2","305","740","0","41.22","11.08"
"10","010","00","070","0015","0000","508","141","367","6","514","1308","0","39.30","10.78"
"10","010","00","070","0015","0347","257","70","187","2","259","624","0","41.51","11.22"
"10","010","00","070","0015","0348","251","71","180","4","255","684","0","37.28","10.38"
"10","010","00","070","0016","0000","557","230","327","4","561","1492","0","37.60","15.42"
"10","010","00","070","0016","0351","245","90","155","3","248","599","0","41.40","15.03"
"10","010","00","070","0016","0352","312","140","172","1","313","893","0","35.05","15.68"
"10","010","00","070","0017","0000","407","150","257","4","411","1023","0","40.18","14.66"
"10","010","00","070","0017","0350","407","150","257","4","411","1023","0","40.18","14.66"
"10","010","00","070","0018","0000","373","125","248","4","377","947","0","39.81","13.20"
"10","010","00","070","0018","0349","373","125","248","4","377","947","0","39.81","13.20"
"10","010","00","070","0019","0000","355","90","265","7","362","985","0","36.75","9.14"
"10","010","00","070","0019","0353","355","90","265","7","362","985","0","36.75","9.14"
"10","010","00","070","0020","0000","423","122","301","10","433","1118","0","38.73","10.91"
"10","010","00","070","0020","0354","423","122","301","10","433","1118","0","38.73","10.91"
"10","010","00","070","0021","0000","382","115","267","3","385","1017","0","37.86","11.31"
"10","010","00","070","0021","0355","382","115","267","3","385","1017","0","37.86","11.31"
"10","010","00","070","0022","0000","208","61","147","1","209","548","0","38.14","11.13"
"10","010","00","070","0022","0356","208","61","147","1","209","548","0","38.14","11.13"
"10","010","00","070","0023","0000","328","101","227","2","330","838","0","39.38","12.05"
"10","010","00","070","0023","0357","328","101","227","2","330","838","0","39.38","12.05"
"10","010","00","080","0000","0000","7351","2243","5108","108","7459","20088","21914","37.13","11.17"
"10","010","00","080","0001","0000","437","178","259","3","440","1127","0","39.04","15.79"
"10","010","00","080","0001","0001","437","178","259","3","440","1127","0","39.04","15.79"
"10","010","00","080","0002","0000","271","93","178","5","276","788","0","35.03","11.80"
"10","010","00","080","0002","0002","271","93","178","5","276","788","0","35.03","11.80"
"10","010","00","080","0003","0000","322","89","233","3","325","829","0","39.20","10.74"
"10","010","00","080","0003","0003","322","89","233","3","325","829","0","39.20","10.74"
"10","010","00","080","0004","0000","99","67","32","1","100","211","0","47.39","31.75"
"10","010","00","080","0004","0004","99","67","32","1","100","211","0","47.39","31.75"
"10","010","00","080","0005","0000","423","143","280","7","430","1153","0","37.29","12.40"
"10","010","00","080","0005","0005","423","143","280","7","430","1153","0","37.29","12.40"
"10","010","00","080","0006","0000","366","151","215","7","373","1165","0","32.02","12.96"
"10","010","00","080","0006","0006","366","151","215","7","373","1165","0","32.02","12.96"
"10","010","00","080","0007","0000","325","77","248","10","335","861","0","38.91","8.94"
"10","010","00","080","0007","0007","325","77","248","10","335","861","0","38.91","8.94"
"10","010","00","080","0008","0000","243","65","178","8","251","615","0","40.81","10.57"
"10","010","00","080","0008","0008","243","65","178","8","251","615","0","40.81","10.57"
"10","010","00","080","0009","0000","262","60","202","3","265","725","0","36.55","8.28"
"10","010","00","080","0009","0009","200","47","153","2","202","557","0","36.27","8.44"
"10","010","00","080","0009","0010","62","13","49","1","63","168","0","37.50","7.74"
"10","010","00","080","0010","0000","267","43","224","3","270","677","0","39.88","6.35"
"10","010","00","080","0010","0016","267","43","224","3","270","677","0","39.88","6.35"
"10","010","00","080","0011","0000","397","117","280","2","399","996","0","40.06","11.75"
"10","010","00","080","0011","0017","397","117","280","2","399","996","0","40.06","11.75"
"10","010","00","080","0012","0000","308","107","201","4","312","905","0","34.48","11.82"
"10","010","00","080","0012","0018","308","107","201","4","312","905","0","34.48","11.82"
"10","010","00","080","0013","0000","359","110","249","3","362","1019","0","35.53","10.79"
"10","010","00","080","0013","0019","359","110","249","3","362","1019","0","35.53","10.79"
"10","010","00","080","0014","0000","483","136","347","7","490","1433","0","34.19","9.49"
"10","010","00","080","0014","0020","483","136","347","7","490","1433","0","34.19","9.49"
"10","010","00","080","0015","0000","202","61","141","2","204","594","0","34.34","10.27"
"10","010","00","080","0015","0021","202","61","141","2","204","594","0","34.34","10.27"
"10","010","00","080","0016","0000","146","28","118","4","150","467","0","32.12","6.00"
"10","010","00","080","0016","0022","146","28","118","4","150","467","0","32.12","6.00"
"10","010","00","080","0017","0000","213","61","152","2","215","611","0","35.19","9.98"
"10","010","00","080","0017","0023","213","61","152","2","215","611","0","35.19","9.98"
"10","010","00","080","0018","0000","291","93","198","3","294","838","0","35.08","11.10"
"10","010","00","080","0018","0024","291","93","198","3","294","838","0","35.08","11.10"
"10","010","00","080","0019","0000","593","151","442","9","602","1392","0","43.25","10.85"
"10","010","00","080","0019","0011","103","14","89","1","104","204","0","50.98","6.86"
"10","010","00","080","0019","0012","115","29","86","1","116","235","0","49.36","12.34"
"10","010","00","080","0019","0013","133","33","100","1","134","362","0","37.02","9.12"
"10","010","00","080","0019","0014","242","75","167","6","248","591","0","41.96","12.69"
"10","010","00","080","0020","0000","215","64","151","6","221","578","0","38.24","11.07"
"10","010","00","080","0020","0015","215","64","151","6","221","578","0","38.24","11.07"
"10","010","00","080","0021","0000","267","108","159","4","271","734","0","36.92","14.71"
"10","010","00","080","0021","0025","267","108","159","4","271","734","0","36.92","14.71"
"10","010","00","080","0022","0000","169","59","110","5","174","521","0","33.40","11.32"
"10","010","00","080","0022","0026","169","59","110","5","174","521","0","33.40","11.32"
"10","010","00","080","0023","0000","237","70","167","2","239","627","0","38.12","11.16"
"10","010","00","080","0023","0027","237","70","167","2","239","627","0","38.12","11.16"
"10","010","00","080","0024","0000","262","51","211","4","266","659","0","40.36","7.74"
"10","010","00","080","0024","0028","262","51","211","4","266","659","0","40.36","7.74"
"10","010","00","080","0025","0000","194","61","133","1","195","563","0","34.64","10.83"
"10","010","00","080","0025","0029","155","47","108","1","156","440","0","35.45","10.68"
"10","010","00","080","0025","0030","39","14","25","0","39","123","0","31.71","11.38"
"10","010","00","090","0000","0000","7237","2694","4543","132","7369","21235","23594","34.70","12.69"
"10","010","00","090","0001","0000","673","245","428","9","682","1898","0","35.93","12.91"
"10","010","00","090","0001","0031","673","245","428","9","682","1898","0","35.93","12.91"
"10","010","00","090","0002","0000","301","110","191","5","306","922","0","33.19","11.93"
"10","010","00","090","0002","0032","301","110","191","5","306","922","0","33.19","11.93"
"10","010","00","090","0003","0000","417","159","258","6","423","1320","0","32.05","12.05"
"10","010","00","090","0003","0033","417","159","258","6","423","1320","0","32.05","12.05"
"10","010","00","090","0004","0000","546","235","311","2","548","1622","0","33.79","14.49"
"10","010","00","090","0004","0034","546","235","311","2","548","1622","0","33.79","14.49"
"10","010","00","090","0005","0000","323","121","202","10","333","1120","0","29.73","10.80"
"10","010","00","090","0005","0035","323","121","202","10","333","1120","0","29.73","10.80"
"10","010","00","090","0006","0000","210","86","124","2","212","701","0","30.24","12.27"
"10","010","00","090","0006","0036","210","86","124","2","212","701","0","30.24","12.27"
"10","010","00","090","0007","0000","136","58","78","8","144","388","0","37.11","14.95"
"10","010","00","090","0007","0037","136","58","78","8","144","388","0","37.11","14.95"
"10","010","00","090","0008","0000","294","163","131","9","303","839","0","36.11","19.43"
"10","010","00","090","0008","0038","294","163","131","9","303","839","0","36.11","19.43"
"10","010","00","090","0009","0000","313","96","217","11","324","857","0","37.81","11.20"
"10","010","00","090","0009","0039","313","96","217","11","324","857","0","37.81","11.20"
"10","010","00","090","0010","0000","254","75","179","6","260","714","0","36.41","10.50"
"10","010","00","090","0010","0040","254","75","179","6","260","714","0","36.41","10.50"
"10","010","00","090","0011","0000","143","58","85","1","144","368","0","39.13","15.76"
"10","010","00","090","0011","0041","78","31","47","0","78","169","0","46.15","18.34"
"10","010","00","090","0011","0042","65","27","38","1","66","199","0","33.17","13.57"
"10","010","00","090","0012","0000","259","109","150","5","264","957","0","27.59","11.39"
"10","010","00","090","0012","0043","259","109","150","5","264","957","0","27.59","11.39"
"10","010","00","090","0013","0000","468","165","303","10","478","1185","0","40.34","13.92"
"10","010","00","090","0013","0047","468","165","303","10","478","1185","0","40.34","13.92"
"10","010","00","090","0014","0000","270","95","175","9","279","821","0","33.98","11.57"
"10","010","00","090","0014","0048","270","95","175","9","279","821","0","33.98","11.57"
"10","010","00","090","0015","0000","218","75","143","3","221","650","0","34.00","11.54"
"10","010","00","090","0015","0049","218","75","143","3","221","650","0","34.00","11.54"
"10","010","00","090","0016","0000","245","84","161","7","252","795","0","31.70","10.57"
"10","010","00","090","0016","0050","245","84","161","7","252","795","0","31.70","10.57"
"10","010","00","090","0017","0000","230","84","146","5","235","670","0","35.07","12.54"
"10","010","00","090","0017","0051","123","45","78","4","127","358","0","35.47","12.57"
"10","010","00","090","0017","0052","107","39","68","1","108","312","0","34.62","12.50"
"10","010","00","090","0018","0000","411","142","269","6","417","1074","0","38.83","13.22"
"10","010","00","090","0018","0053","411","142","269","6","417","1074","0","38.83","13.22"
"10","010","00","090","0019","0000","329","74","255","6","335","893","0","37.51","8.29"
"10","010","00","090","0019","0054","329","74","255","6","335","893","0","37.51","8.29"
"10","010","00","090","0020","0000","372","157","215","4","376","1167","0","32.22","13.45"
"10","010","00","090","0020","0055","372","157","215","4","376","1167","0","32.22","13.45"
"10","010","00","090","0021","0000","326","131","195","1","327","757","0","43.20","17.31"
"10","010","00","090","0021","0056","171","56","115","1","172","414","0","41.55","13.53"
"10","010","00","090","0021","0057","155","75","80","0","155","343","0","45.19","21.87"
"10","010","00","090","0022","0000","85","34","51","1","86","284","0","30.28","11.97"
"10","010","00","090","0022","0044","85","34","51","1","86","284","0","30.28","11.97"
"10","010","00","090","0023","0000","414","138","276","6","420","1233","0","34.06","11.19"
"10","010","00","090","0023","0045","317","103","214","5","322","1008","0","31.94","10.22"
"10","010","00","090","0023","0046","97","35","62","1","98","225","0","43.56","15.56"
"10","010","00","100","0000","0000","6189","2257","3932","120","6309","15973","17439","39.50","14.13"
"10","010","00","100","0001","0000","257","98","159","9","266","663","0","40.12","14.78"
"10","010","00","100","0001","0163","164","67","97","7","171","444","0","38.51","15.09"
"10","010","00","100","0001","0164","93","31","62","2","95","219","0","43.38","14.16"
"10","010","00","100","0002","0000","601","201","400","13","614","1416","0","43.36","14.19"
"10","010","00","100","0002","0165","363","118","245","5","368","782","0","47.06","15.09"
"10","010","00","100","0002","0166","238","83","155","8","246","634","0","38.80","13.09"
"10","010","00","100","0003","0000","451","206","245","10","461","1125","0","40.98","18.31"
"10","010","00","100","0003","0167","451","206","245","10","461","1125","0","40.98","18.31"
"10","010","00","100","0004","0000","353","156","197","5","358","829","0","43.18","18.82"
"10","010","00","100","0004","0168","353","156","197","5","358","829","0","43.18","18.82"
"10","010","00","100","0005","0000","280","107","173","7","287","749","0","38.32","14.29"
"10","010","00","100","0005","0169","280","107","173","7","287","749","0","38.32","14.29"
"10","010","00","100","0006","0000","465","149","316","10","475","1195","0","39.75","12.47"
"10","010","00","100","0006","0170","465","149","316","10","475","1195","0","39.75","12.47"
"10","010","00","100","0007","0000","148","54","94","1","149","368","0","40.49","14.67"
"10","010","00","100","0007","0171","148","54","94","1","149","368","0","40.49","14.67"
"10","010","00","100","0008","0000","171","80","91","6","177","412","0","42.96","19.42"
"10","010","00","100","0008","0172","126","58","68","4","130","312","0","41.67","18.59"
"10","010","00","100","0008","0173","45","22","23","2","47","100","0","47.00","22.00"
"10","010","00","100","0009","0000","323","120","203","6","329","721","0","45.63","16.64"
"10","010","00","100","0009","0174","323","120","203","6","329","721","0","45.63","16.64"
"10","010","00","100","0010","0000","173","56","117","1","174","422","0","41.23","13.27"
"10","010","00","100","0010","0175","173","56","117","1","174","422","0","41.23","13.27"
"10","010","00","100","0011","0000","182","85","97","6","188","417","0","45.08","20.38"
"10","010","00","100","0011","0176","182","85","97","6","188","417","0","45.08","20.38"
"10","010","00","100","0012","0000","247","99","148","5","252","591","0","42.64","16.75"
"10","010","00","100","0012","0177","247","99","148","5","252","591","0","42.64","16.75"
"10","010","00","100","0013","0000","477","190","287","8","485","1447","0","33.52","13.13"
"10","010","00","100","0013","0178","180","68","112","4","184","537","0","34.26","12.66"
"10","010","00","100","0013","0179","297","122","175","4","301","910","0","33.08","13.41"
"10","010","00","100","0014","0000","239","89","150","6","245","826","0","29.66","10.77"
"10","010","00","100","0014","0180","239","89","150","6","245","826","0","29.66","10.77"
"10","010","00","100","0015","0000","264","75","189","1","265","777","0","34.11","9.65"
"10","010","00","100","0015","0181","264","75","189","1","265","777","0","34.11","9.65"
"10","010","00","100","0016","0000","290","62","228","7","297","796","0","37.31","7.79"
"10","010","00","100","0016","0182","290","62","228","7","297","796","0","37.31","7.79"
"10","010","00","100","0017","0000","149","49","100","1","150","422","0","35.55","11.61"
"10","010","00","100","0017","0183","149","49","100","1","150","422","0","35.55","11.61"
"10","010","00","100","0018","0000","181","90","91","9","190","520","0","36.54","17.31"
"10","010","00","100","0018","0184","181","90","91","9","190","520","0","36.54","17.31"
"10","010","00","100","0019","0000","294","92","202","1","295","724","0","40.75","12.71"
"10","010","00","100","0019","0185","240","78","162","1","241","589","0","40.92","13.24"
"10","010","00","100","0019","0186","54","14","40","0","54","135","0","40.00","10.37"
"10","010","00","100","0020","0000","151","47","104","1","152","363","0","41.87","12.95"
"10","010","00","100","0020","0187","151","47","104","1","152","363","0","41.87","12.95"
"10","010","00","100","0021","0000","198","72","126","3","201","554","0","36.28","13.00"
"10","010","00","100","0021","0188","198","72","126","3","201","554","0","36.28","13.00"
"10","010","00","100","0022","0000","295","80","215","4","299","636","0","47.01","12.58"
"10","010","00","100","0022","0189","230","71","159","4","234","518","0","45.17","13.71"
"10","010","00","100","0022","0190","65","9","56","0","65","118","0","55.08","7.63"
"10","010","00","110","0000","0000","5035","1695","3340","68","5103","13469","14778","37.89","12.58"
"10","010","00","110","0001","0000","180","51","129","0","180","512","0","35.16","9.96"
"10","010","00","110","0001","0191","180","51","129","0","180","512","0","35.16","9.96"
"10","010","00","110","0002","0000","219","66","153","1","220","540","0","40.74","12.22"
"10","010","00","110","0002","0192","219","66","153","1","220","540","0","40.74","12.22"
"10","010","00","110","0003","0000","465","168","297","1","466","1289","0","36.15","13.03"
"10","010","00","110","0003","0193","465","168","297","1","466","1289","0","36.15","13.03"
"10","010","00","110","0004","0000","478","196","282","6","484","1319","0","36.69","14.86"
"10","010","00","110","0004","0194","478","196","282","6","484","1319","0","36.69","14.86"
"10","010","00","110","0005","0000","180","80","100","0","180","736","0","24.46","10.87"
"10","010","00","110","0005","0195","110","45","65","0","110","322","0","34.16","13.98"
"10","010","00","110","0005","0196","70","35","35","0","70","414","0","16.91","8.45"
"10","010","00","110","0006","0000","393","120","273","6","399","1002","0","39.82","11.98"
"10","010","00","110","0006","0197","393","120","273","6","399","1002","0","39.82","11.98"
"10","010","00","110","0007","0000","157","38","119","4","161","427","0","37.70","8.90"
"10","010","00","110","0007","0198","157","38","119","4","161","427","0","37.70","8.90"
"10","010","00","110","0008","0000","325","84","241","8","333","799","0","41.68","10.51"
"10","010","00","110","0008","0199","325","84","241","8","333","799","0","41.68","10.51"
"10","010","00","110","0009","0000","384","103","281","3","387","982","0","39.41","10.49"
"10","010","00","110","0009","0200","384","103","281","3","387","982","0","39.41","10.49"
"10","010","00","110","0010","0000","328","140","188","7","335","937","0","35.75","14.94"
"10","010","00","110","0010","0201","328","140","188","7","335","937","0","35.75","14.94"
"10","010","00","110","0011","0000","295","130","165","5","300","927","0","32.36","14.02"
"10","010","00","110","0011","0202","295","130","165","5","300","927","0","32.36","14.02"
"10","010","00","110","0012","0000","342","83","259","8","350","895","0","39.11","9.27"
"10","010","00","110","0012","0203","237","58","179","7","244","639","0","38.18","9.08"
"10","010","00","110","0012","0204","105","25","80","1","106","256","0","41.41","9.77"
"10","010","00","110","0013","0000","436","144","292","7","443","1126","0","39.34","12.79"
"10","010","00","110","0013","0205","302","95","207","6","308","842","0","36.58","11.28"
"10","010","00","110","0013","0206","134","49","85","1","135","284","0","47.54","17.25"
"10","010","00","110","0014","0000","578","180","398","7","585","1379","0","42.42","13.05"
"10","010","00","110","0014","0207","416","116","300","7","423","1004","0","42.13","11.55"
"10","010","00","110","0014","0208","162","64","98","0","162","375","0","43.20","17.07"
"10","010","00","110","0015","0000","275","112","163","5","280","599","0","46.74","18.70"
"10","010","00","110","0015","0209","142","68","74","3","145","323","0","44.89","21.05"
"10","010","00","110","0015","0210","133","44","89","2","135","276","0","48.91","15.94"
"10","010","00","120","0000","0000","17337","6770","10567","172","17509","43700","48786","40.07","15.49"
"10","010","00","120","0001","0000","1624","709","915","18","1642","4025","0","40.80","17.61"
"10","010","00","120","0001","0211","374","182","192","6","380","1017","0","37.36","17.90"
"10","010","00","120","0001","0212","451","198","253","6","457","1070","0","42.71","18.50"
"10","010","00","120","0001","0213","403","159","244","3","406","1069","0","37.98","14.87"
"10","010","00","120","0001","0214","396","170","226","3","399","869","0","45.91","19.56"
"10","010","00","120","0002","0000","1056","470","586","5","1061","2466","0","43.03","19.06"
"10","010","00","120","0002","0215","475","200","275","1","476","1129","0","42.16","17.71"
"10","010","00","120","0002","0216","581","270","311","4","585","1337","0","43.75","20.19"
"10","010","00","120","0003","0000","778","231","547","7","785","1615","0","48.61","14.30"
"10","010","00","120","0003","0224","317","107","210","1","318","613","0","51.88","17.46"
"10","010","00","120","0003","0225","310","85","225","3","313","640","0","48.91","13.28"
"10","010","00","120","0003","0226","151","39","112","3","154","362","0","42.54","10.77"
"10","010","00","120","0004","0000","788","263","525","6","794","2073","0","38.30","12.69"
"10","010","00","120","0004","0227","379","116","263","4","383","1025","0","37.37","11.32"
"10","010","00","120","0004","0228","409","147","262","2","411","1048","0","39.22","14.03"
"10","010","00","120","0005","0000","343","109","234","5","348","782","0","44.50","13.94"
"10","010","00","120","0005","0229","343","109","234","5","348","782","0","44.50","13.94"
"10","010","00","120","0006","0000","606","257","349","11","617","1540","0","40.06","16.69"
"10","010","00","120","0006","0217","483","210","273","6","489","1235","0","39.60","17.00"
"10","010","00","120","0006","0218","123","47","76","5","128","305","0","41.97","15.41"
"10","010","00","120","0007","0000","749","319","430","5","754","1867","0","40.39","17.09"
"10","010","00","120","0007","0219","275","111","164","4","279","653","0","42.73","17.00"
"10","010","00","120","0007","0220","474","208","266","1","475","1214","0","39.13","17.13"
"10","010","00","120","0008","0000","681","319","362","4","685","1779","0","38.50","17.93"
"10","010","00","120","0008","0221","354","162","192","3","357","1023","0","34.90","15.84"
"10","010","00","120","0008","0222","327","157","170","1","328","756","0","43.39","20.77"
"10","010","00","120","0009","0000","179","87","92","5","184","427","0","43.09","20.37"
"10","010","00","120","0009","0223","179","87","92","5","184","427","0","43.09","20.37"
"10","010","00","120","0010","0000","241","141","100","4","245","614","0","39.90","22.96"
"10","010","00","120","0010","0233","241","141","100","4","245","614","0","39.90","22.96"
"10","010","00","120","0011","0000","212","98","114","2","214","384","0","55.73","25.52"
"10","010","00","120","0011","0234","212","98","114","2","214","384","0","55.73","25.52"
"10","010","00","120","0012","0000","521","182","339","2","523","1345","0","38.88","13.53"
"10","010","00","120","0012","0235","334","126","208","0","334","758","0","44.06","16.62"
"10","010","00","120","0012","0236","187","56","131","2","189","587","0","32.20","9.54"
"10","010","00","120","0013","0000","838","259","579","5","843","1915","0","44.02","13.52"
"10","010","00","120","0013","0230","450","141","309","2","452","1029","0","43.93","13.70"
"10","010","00","120","0013","0231","388","118","270","3","391","886","0","44.13","13.32"
"10","010","00","120","0014","0000","425","142","283","7","432","1028","0","42.02","13.81"
"10","010","00","120","0014","0232","425","142","283","7","432","1028","0","42.02","13.81"
"10","010","00","120","0015","0000","715","263","452","11","726","2028","0","35.80","12.97"
"10","010","00","120","0015","0239","304","107","197","6","310","893","0","34.71","11.98"
"10","010","00","120","0015","0240","411","156","255","5","416","1135","0","36.65","13.74"
"10","010","00","120","0016","0000","798","267","531","7","805","1983","0","40.60","13.46"
"10","010","00","120","0016","0241","469","154","315","4","473","1068","0","44.29","14.42"
"10","010","00","120","0016","0242","329","113","216","3","332","915","0","36.28","12.35"
"10","010","00","120","0017","0000","685","355","330","7","692","1782","0","38.83","19.92"
"10","010","00","120","0017","0237","330","176","154","2","332","804","0","41.29","21.89"
"10","010","00","120","0017","0238","355","179","176","5","360","978","0","36.81","18.30"
"10","010","00","120","0018","0000","1648","635","1013","20","1668","4357","0","38.28","14.57"
"10","010","00","120","0018","0244","523","180","343","6","529","1373","0","38.53","13.11"
"10","010","00","120","0018","0245","570","223","347","8","578","1473","0","39.24","15.14"
"10","010","00","120","0018","0246","555","232","323","6","561","1511","0","37.13","15.35"
"10","010","00","120","0019","0000","1211","495","716","10","1221","2967","0","41.15","16.68"
"10","010","00","120","0019","0247","633","245","388","7","640","1505","0","42.52","16.28"
"10","010","00","120","0019","0248","578","250","328","3","581","1462","0","39.74","17.10"
"10","010","00","120","0020","0000","712","302","410","7","719","1853","0","38.80","16.30"
"10","010","00","120","0020","0252","431","174","257","3","434","1067","0","40.67","16.31"
"10","010","00","120","0020","0253","281","128","153","4","285","786","0","36.26","16.28"
"10","010","00","120","0021","0000","646","190","456","4","650","1779","0","36.54","10.68"
"10","010","00","120","0021","0250","407","89","318","3","410","1170","0","35.04","7.61"
"10","010","00","120","0021","0251","239","101","138","1","240","609","0","39.41","16.58"
"10","010","00","120","0022","0000","336","123","213","3","339","910","0","37.25","13.52"
"10","010","00","120","0022","0254","336","123","213","3","339","910","0","37.25","13.52"
"10","010","00","120","0023","0000","378","136","242","7","385","971","0","39.65","14.01"
"10","010","00","120","0023","0255","378","136","242","7","385","971","0","39.65","14.01"
"10","010","00","120","0024","0000","426","127","299","5","431","1239","0","34.79","10.25"
"10","010","00","120","0024","0256","426","127","299","5","431","1239","0","34.79","10.25"
"10","010","00","120","0025","0000","434","180","254","2","436","1179","0","36.98","15.27"
"10","010","00","120","0025","0243","434","180","254","2","436","1179","0","36.98","15.27"
"10","010","00","120","0026","0000","307","111","196","3","310","792","0","39.14","14.02"
"10","010","00","120","0026","0249","307","111","196","3","310","792","0","39.14","14.02"
"10","010","00","130","0000","0000","13970","5473","8497","160","14130","38789","43935","36.43","14.11"
"10","010","00","130","0001","0000","614","227","387","7","621","1790","0","34.69","12.68"
"10","010","00","130","0001","0465","249","83","166","3","252","670","0","37.61","12.39"
"10","010","00","130","0001","0466","365","144","221","4","369","1120","0","32.95","12.86"
"10","010","00","130","0002","0000","374","161","213","1","375","935","0","40.11","17.22"
"10","010","00","130","0002","0467","374","161","213","1","375","935","0","40.11","17.22"
"10","010","00","130","0003","0000","323","136","187","3","326","787","0","41.42","17.28"
"10","010","00","130","0003","0479","323","136","187","3","326","787","0","41.42","17.28"
"10","010","00","130","0004","0000","342","92","250","4","346","862","0","40.14","10.67"
"10","010","00","130","0004","0478","342","92","250","4","346","862","0","40.14","10.67"
"10","010","00","130","0005","0000","465","190","275","3","468","1500","0","31.20","12.67"
"10","010","00","130","0005","0468","239","103","136","3","242","770","0","31.43","13.38"
"10","010","00","130","0005","0469","226","87","139","0","226","730","0","30.96","11.92"
"10","010","00","130","0006","0000","1055","407","648","13","1068","2900","0","36.83","14.03"
"10","010","00","130","0006","0448","353","156","197","3","356","1046","0","34.03","14.91"
"10","010","00","130","0006","0449","315","112","203","5","320","816","0","39.22","13.73"
"10","010","00","130","0006","0450","387","139","248","5","392","1038","0","37.76","13.39"
"10","010","00","130","0007","0000","1237","489","748","12","1249","3322","0","37.60","14.72"
"10","010","00","130","0007","0451","515","227","288","6","521","1290","0","40.39","17.60"
"10","010","00","130","0007","0452","346","138","208","0","346","872","0","39.68","15.83"
"10","010","00","130","0007","0453","376","124","252","6","382","1160","0","32.93","10.69"
"10","010","00","130","0008","0000","2667","1180","1487","15","2682","7020","0","38.21","16.81"
"10","010","00","130","0008","0454","491","223","268","4","495","1391","0","35.59","16.03"
"10","010","00","130","0008","0455","519","258","261","2","521","1253","0","41.58","20.59"
"10","010","00","130","0008","0456","393","178","215","5","398","1081","0","36.82","16.47"
"10","010","00","130","0008","0457","505","195","310","3","508","1306","0","38.90","14.93"
"10","010","00","130","0008","0458","285","120","165","0","285","785","0","36.31","15.29"
"10","010","00","130","0008","0459","474","206","268","1","475","1204","0","39.45","17.11"
"10","010","00","130","0009","0000","2019","791","1228","33","2052","5652","0","36.31","14.00"
"10","010","00","130","0009","0460","415","173","242","3","418","1176","0","35.54","14.71"
"10","010","00","130","0009","0461","478","198","280","1","479","1344","0","35.64","14.73"
"10","010","00","130","0009","0462","333","137","196","5","338","981","0","34.45","13.97"
"10","010","00","130","0009","0463","365","156","209","10","375","971","0","38.62","16.07"
"10","010","00","130","0009","0464","428","127","301","14","442","1180","0","37.46","10.76"
"10","010","00","130","0010","0000","641","259","382","10","651","1825","0","35.67","14.19"
"10","010","00","130","0010","0470","256","109","147","6","262","771","0","33.98","14.14"
"10","010","00","130","0010","0471","385","150","235","4","389","1054","0","36.91","14.23"
"10","010","00","130","0011","0000","514","169","345","6","520","1490","0","34.90","11.34"
"10","010","00","130","0011","0472","208","55","153","3","211","574","0","36.76","9.58"
"10","010","00","130","0011","0473","306","114","192","3","309","916","0","33.73","12.45"
"10","010","00","130","0012","0000","716","281","435","7","723","2097","0","34.48","13.40"
"10","010","00","130","0012","0474","136","51","85","0","136","430","0","31.63","11.86"
"10","010","00","130","0012","0475","265","100","165","5","270","770","0","35.06","12.99"
"10","010","00","130","0012","0476","315","130","185","2","317","897","0","35.34","14.49"
"10","010","00","130","0013","0000","320","111","209","3","323","1020","0","31.67","10.88"
"10","010","00","130","0013","0477","320","111","209","3","323","1020","0","31.67","10.88"
"10","010","00","130","0014","0000","414","164","250","6","420","1122","0","37.43","14.62"
"10","010","00","130","0014","0480","99","47","52","0","99","280","0","35.36","16.79"
"10","010","00","130","0014","0481","315","117","198","6","321","842","0","38.12","13.90"
"10","010","00","130","0015","0000","341","104","237","7","348","932","0","37.34","11.16"
"10","010","00","130","0015","0482","341","104","237","7","348","932","0","37.34","11.16"
"10","010","00","130","0016","0000","658","219","439","7","665","1851","0","35.93","11.83"
"10","010","00","130","0016","0483","447","160","287","4","451","1187","0","37.99","13.48"
"10","010","00","130","0016","0484","211","59","152","3","214","664","0","32.23","8.89"
"10","010","00","130","0017","0000","224","100","124","3","227","723","0","31.40","13.83"
"10","010","00","130","0017","0487","224","100","124","3","227","723","0","31.40","13.83"
"10","010","00","130","0018","0000","337","121","216","8","345","966","0","35.71","12.53"
"10","010","00","130","0018","0488","165","70","95","2","167","462","0","36.15","15.15"
"10","010","00","130","0018","0489","172","51","121","6","178","504","0","35.32","10.12"
"10","010","00","130","0019","0000","196","59","137","1","197","634","0","31.07","9.31"
"10","010","00","130","0019","0486","196","59","137","1","197","634","0","31.07","9.31"
"10","010","00","130","0020","0000","257","99","158","5","262","714","0","36.69","13.87"
"10","010","00","130","0020","0485","257","99","158","5","262","714","0","36.69","13.87"
"10","010","00","130","0021","0000","154","63","91","2","156","356","0","43.82","17.70"
"10","010","00","130","0021","0490","154","63","91","2","156","356","0","43.82","17.70"
"10","010","00","130","0022","0000","102","51","51","4","106","291","0","36.43","17.53"
"10","010","00","130","0022","0491","102","51","51","4","106","291","0","36.43","17.53"
"10","010","00","140","0000","0000","10845","4267","6578","128","10973","30617","34503","35.84","13.94"
"10","010","00","140","0001","0000","966","398","568","5","971","2455","0","39.55","16.21"
"10","010","00","140","0001","0410","493","186","307","1","494","1292","0","38.24","14.40"
"10","010","00","140","0001","0411","473","212","261","4","477","1163","0","41.01","18.23"
"10","010","00","140","0002","0000","727","268","459","10","737","2167","0","34.01","12.37"
"10","010","00","140","0002","0412","343","132","211","4","347","973","0","35.66","13.57"
"10","010","00","140","0002","0413","384","136","248","6","390","1194","0","32.66","11.39"
"10","010","00","140","0003","0000","234","98","136","2","236","750","0","31.47","13.07"
"10","010","00","140","0003","0414","234","98","136","2","236","750","0","31.47","13.07"
"10","010","00","140","0004","0000","304","82","222","10","314","813","0","38.62","10.09"
"10","010","00","140","0004","0415","304","82","222","10","314","813","0","38.62","10.09"
"10","010","00","140","0005","0000","502","160","342","8","510","1212","0","42.08","13.20"
"10","010","00","140","0005","0416","502","160","342","8","510","1212","0","42.08","13.20"
"10","010","00","140","0006","0000","293","114","179","6","299","603","0","49.59","18.91"
"10","010","00","140","0006","0417","293","114","179","6","299","603","0","49.59","18.91"
"10","010","00","140","0007","0000","308","114","194","2","310","1025","0","30.24","11.12"
"10","010","00","140","0007","0418","308","114","194","2","310","1025","0","30.24","11.12"
"10","010","00","140","0008","0000","1988","881","1107","19","2007","5214","0","38.49","16.90"
"10","010","00","140","0008","0419","504","206","298","4","508","1289","0","39.41","15.98"
"10","010","00","140","0008","0420","504","229","275","11","515","1341","0","38.40","17.08"
"10","010","00","140","0008","0421","253","114","139","0","253","634","0","39.91","17.98"
"10","010","00","140","0008","0422","516","242","274","4","520","1389","0","37.44","17.42"
"10","010","00","140","0008","0423","211","90","121","0","211","561","0","37.61","16.04"
"10","010","00","140","0009","0000","550","209","341","3","553","1401","0","39.47","14.92"
"10","010","00","140","0009","0424","550","209","341","3","553","1401","0","39.47","14.92"
"10","010","00","140","0010","0000","468","197","271","7","475","1362","0","34.88","14.46"
"10","010","00","140","0010","0425","468","197","271","7","475","1362","0","34.88","14.46"
"10","010","00","140","0011","0000","620","234","386","10","630","1562","0","40.33","14.98"
"10","010","00","140","0011","0426","620","234","386","10","630","1562","0","40.33","14.98"
"10","010","00","140","0012","0000","488","172","316","2","490","1738","0","28.19","9.90"
"10","010","00","140","0012","0427","205","84","121","1","206","759","0","27.14","11.07"
"10","010","00","140","0012","0428","283","88","195","1","284","979","0","29.01","8.99"
"10","010","00","140","0013","0000","178","74","104","2","180","611","0","29.46","12.11"
"10","010","00","140","0013","0431","178","74","104","2","180","611","0","29.46","12.11"
"10","010","00","140","0014","0000","307","131","176","5","312","998","0","31.26","13.13"
"10","010","00","140","0014","0429","100","28","72","2","102","334","0","30.54","8.38"
"10","010","00","140","0014","0430","207","103","104","3","210","664","0","31.63","15.51"
"10","010","00","140","0015","0000","296","146","150","5","301","851","0","35.37","17.16"
"10","010","00","140","0015","0432","176","75","101","2","178","464","0","38.36","16.16"
"10","010","00","140","0015","0433","120","71","49","3","123","387","0","31.78","18.35"
"10","010","00","140","0016","0000","216","92","124","2","218","624","0","34.94","14.74"
"10","010","00","140","0016","0434","216","92","124","2","218","624","0","34.94","14.74"
"10","010","00","140","0017","0000","607","196","411","9","616","1756","0","35.08","11.16"
"10","010","00","140","0017","0435","73","30","43","2","75","211","0","35.55","14.22"
"10","010","00","140","0017","0436","534","166","368","7","541","1545","0","35.02","10.74"
"10","010","00","140","0018","0000","218","82","136","6","224","626","0","35.78","13.10"
"10","010","00","140","0018","0437","218","82","136","6","224","626","0","35.78","13.10"
"10","010","00","140","0019","0000","156","60","96","1","157","416","0","37.74","14.42"
"10","010","00","140","0019","0438","156","60","96","1","157","416","0","37.74","14.42"
"10","010","00","140","0020","0000","637","231","406","5","642","1845","0","34.80","12.52"
"10","010","00","140","0020","0439","345","119","226","2","347","902","0","38.47","13.19"
"10","010","00","140","0020","0440","292","112","180","3","295","943","0","31.28","11.88"
"10","010","00","140","0021","0000","269","122","147","4","273","903","0","30.23","13.51"
"10","010","00","140","0021","0441","234","92","142","3","237","797","0","29.74","11.54"
"10","010","00","140","0021","0442","35","30","5","1","36","106","0","33.96","28.30"
"10","010","00","140","0022","0000","66","14","52","0","66","238","0","27.73","5.88"
"10","010","00","140","0022","0443","66","14","52","0","66","238","0","27.73","5.88"
"10","010","00","140","0023","0000","240","90","150","2","242","766","0","31.59","11.75"
"10","010","00","140","0023","0444","83","37","46","1","84","318","0","26.42","11.64"
"10","010","00","140","0023","0445","157","53","104","1","158","448","0","35.27","11.83"
"10","010","00","140","0024","0000","207","102","105","3","210","681","0","30.84","14.98"
"10","010","00","140","0024","0446","138","66","72","2","140","434","0","32.26","15.21"
"10","010","00","140","0024","0447","69","36","33","1","70","247","0","28.34","14.57"
"10","010","00","150","0000","0000","5621","2350","3271","78","5699","16554","18481","34.43","14.20"
"10","010","00","150","0001","0000","801","310","491","15","816","2182","0","37.40","14.21"
"10","010","00","150","0001","0301","371","152","219","6","377","962","0","39.19","15.80"
"10","010","00","150","0001","0302","430","158","272","9","439","1220","0","35.98","12.95"
"10","010","00","150","0002","0000","354","178","176","2","356","869","0","40.97","20.48"
"10","010","00","150","0002","0303","354","178","176","2","356","869","0","40.97","20.48"
"10","010","00","150","0003","0000","192","71","121","4","196","540","0","36.30","13.15"
"10","010","00","150","0003","0307","192","71","121","4","196","540","0","36.30","13.15"
"10","010","00","150","0004","0000","1546","618","928","18","1564","4337","0","36.06","14.25"
"10","010","00","150","0004","0304","451","175","276","2","453","1142","0","39.67","15.32"
"10","010","00","150","0004","0305","469","183","286","4","473","1353","0","34.96","13.53"
"10","010","00","150","0004","0306","626","260","366","12","638","1842","0","34.64","14.12"
"10","010","00","150","0005","0000","146","56","90","3","149","393","0","37.91","14.25"
"10","010","00","150","0005","0308","146","56","90","3","149","393","0","37.91","14.25"
"10","010","00","150","0006","0000","179","81","98","4","183","500","0","36.60","16.20"
"10","010","00","150","0006","0314","179","81","98","4","183","500","0","36.60","16.20"
"10","010","00","150","0007","0000","108","32","76","2","110","355","0","30.99","9.01"
"10","010","00","150","0007","0315","108","32","76","2","110","355","0","30.99","9.01"
"10","010","00","150","0008","0000","183","69","114","2","185","579","0","31.95","11.92"
"10","010","00","150","0008","0309","183","69","114","2","185","579","0","31.95","11.92"
"10","010","00","150","0009","0000","556","217","339","7","563","1618","0","34.80","13.41"
"10","010","00","150","0009","0311","277","107","170","5","282","848","0","33.25","12.62"
"10","010","00","150","0009","0312","279","110","169","2","281","770","0","36.49","14.29"
"10","010","00","150","0010","0000","205","80","125","5","210","548","0","38.32","14.60"
"10","010","00","150","0010","0310","205","80","125","5","210","548","0","38.32","14.60"
"10","010","00","150","0011","0000","224","94","130","1","225","814","0","27.64","11.55"
"10","010","00","150","0011","0313","224","94","130","1","225","814","0","27.64","11.55"
"10","010","00","150","0012","0000","139","67","72","1","140","488","0","28.69","13.73"
"10","010","00","150","0012","0316","139","67","72","1","140","488","0","28.69","13.73"
"10","010","00","150","0013","0000","83","42","41","1","84","275","0","30.55","15.27"
"10","010","00","150","0013","0319","83","42","41","1","84","275","0","30.55","15.27"
"10","010","00","150","0014","0000","152","90","62","1","153","414","0","36.96","21.74"
"10","010","00","150","0014","0317","152","90","62","1","153","414","0","36.96","21.74"
"10","010","00","150","0015","0000","207","102","105","6","213","703","0","30.30","14.51"
"10","010","00","150","0015","0320","207","102","105","6","213","703","0","30.30","14.51"
"10","010","00","150","0016","0000","182","116","66","2","184","610","0","30.16","19.02"
"10","010","00","150","0016","0321","182","116","66","2","184","610","0","30.16","19.02"
"10","010","00","150","0017","0000","238","98","140","4","242","929","0","26.05","10.55"
"10","010","00","150","0017","0322","137","42","95","3","140","525","0","26.67","8.00"
"10","010","00","150","0017","0323","101","56","45","1","102","404","0","25.25","13.86"
"10","010","00","150","0018","0000","126","29","97","0","126","400","0","31.50","7.25"
"10","010","00","150","0018","0318","126","29","97","0","126","400","0","31.50","7.25"
"10","010","00","160","0000","0000","3353","1479","1874","32","3385","9931","11097","34.09","14.89"
"10","010","00","160","0001","0000","438","227","211","6","444","1143","0","38.85","19.86"
"10","010","00","160","0001","0492","438","227","211","6","444","1143","0","38.85","19.86"
"10","010","00","160","0002","0000","168","74","94","1","169","440","0","38.41","16.82"
"10","010","00","160","0002","0493","168","74","94","1","169","440","0","38.41","16.82"
"10","010","00","160","0003","0000","410","167","243","3","413","1282","0","32.22","13.03"
"10","010","00","160","0003","0494","263","107","156","0","263","749","0","35.11","14.29"
"10","010","00","160","0003","0495","147","60","87","3","150","533","0","28.14","11.26"
"10","010","00","160","0004","0000","671","286","385","4","675","1748","0","38.62","16.36"
"10","010","00","160","0004","0496","330","138","192","2","332","898","0","36.97","15.37"
"10","010","00","160","0004","0497","341","148","193","2","343","850","0","40.35","17.41"
"10","010","00","160","0005","0000","297","120","177","2","299","835","0","35.81","14.37"
"10","010","00","160","0005","0498","297","120","177","2","299","835","0","35.81","14.37"
"10","010","00","160","0006","0000","313","148","165","1","314","849","0","36.98","17.43"
"10","010","00","160","0006","0499","313","148","165","1","314","849","0","36.98","17.43"
"10","010","00","160","0007","0000","408","173","235","5","413","1220","0","33.85","14.18"
"10","010","00","160","0007","0500","209","145","64","4","213","794","0","26.83","18.26"
"10","010","00","160","0007","0501","199","28","171","1","200","426","0","46.95","6.57"
"10","010","00","160","0008","0000","156","57","99","4","160","596","0","26.85","9.56"
"10","010","00","160","0008","0502","156","57","99","4","160","596","0","26.85","9.56"
"10","010","00","160","0009","0000","250","108","142","1","251","956","0","26.26","11.30"
"10","010","00","160","0009","0503","104","43","61","0","104","314","0","33.12","13.69"
"10","010","00","160","0009","0504","146","65","81","1","147","642","0","22.90","10.12"
"10","010","00","160","0010","0000","145","54","91","3","148","498","0","29.72","10.84"
"10","010","00","160","0010","0505","145","54","91","3","148","498","0","29.72","10.84"
"10","010","00","160","0011","0000","97","65","32","2","99","364","0","27.20","17.86"
"10","010","00","160","0011","0506","45","30","15","1","46","160","0","28.75","18.75"
"10","010","00","160","0011","0507","52","35","17","1","53","204","0","25.98","17.16"
"10","010","00","170","0000","0000","1000","419","581","14","1014","4008","4553","25.30","10.45"
"10","010","00","170","0001","0000","353","131","222","4","357","1448","0","24.65","9.05"
"10","010","00","170","0001","0521","190","77","113","2","192","723","0","26.56","10.65"
"10","010","00","170","0001","0522","163","54","109","2","165","725","0","22.76","7.45"
"10","010","00","170","0002","0000","170","57","113","4","174","650","0","26.77","8.77"
"10","010","00","170","0002","0523","75","32","43","3","78","342","0","22.81","9.36"
"10","010","00","170","0002","0524","95","25","70","1","96","308","0","31.17","8.12"
"10","010","00","170","0003","0000","118","62","56","0","118","420","0","28.10","14.76"
"10","010","00","170","0003","0525","44","24","20","0","44","181","0","24.31","13.26"
"10","010","00","170","0003","0526","74","38","36","0","74","239","0","30.96","15.90"
"10","010","00","170","0004","0000","182","78","104","6","188","923","0","20.37","8.45"
"10","010","00","170","0004","0527","92","27","65","2","94","484","0","19.42","5.58"
"10","010","00","170","0004","0528","56","37","19","0","56","196","0","28.57","18.88"
"10","010","00","170","0004","0529","34","14","20","4","38","243","0","15.64","5.76"
"10","010","00","170","0005","0000","177","91","86","0","177","567","0","31.22","16.05"
"10","010","00","170","0005","0530","177","91","86","0","177","567","0","31.22","16.05"
"10","010","00","180","0000","0000","1445","985","460","21","1466","4621","5455","31.72","21.32"
"10","010","00","180","0001","0000","111","63","48","1","112","367","0","30.52","17.17"
"10","010","00","180","0001","0508","111","63","48","1","112","367","0","30.52","17.17"
"10","010","00","180","0002","0000","65","47","18","0","65","184","0","35.33","25.54"
"10","010","00","180","0002","0509","65","47","18","0","65","184","0","35.33","25.54"
"10","010","00","180","0003","0000","42","28","14","0","42","142","0","29.58","19.72"
"10","010","00","180","0003","0510","42","28","14","0","42","142","0","29.58","19.72"
"10","010","00","180","0004","0000","80","50","30","3","83","316","0","26.27","15.82"
"10","010","00","180","0004","0511","54","32","22","3","57","235","0","24.26","13.62"
"10","010","00","180","0004","0512","26","18","8","0","26","81","0","32.10","22.22"
"10","010","00","180","0005","0000","129","99","30","1","130","292","0","44.52","33.90"
"10","010","00","180","0005","0514","129","99","30","1","130","292","0","44.52","33.90"
"10","010","00","180","0006","0000","81","50","31","2","83","303","0","27.39","16.50"
"10","010","00","180","0006","0513","81","50","31","2","83","303","0","27.39","16.50"
"10","010","00","180","0007","0000","247","195","52","4","251","819","0","30.65","23.81"
"10","010","00","180","0007","0516","247","195","52","4","251","819","0","30.65","23.81"
"10","010","00","180","0008","0000","300","184","116","7","307","939","0","32.69","19.60"
"10","010","00","180","0008","0515","300","184","116","7","307","939","0","32.69","19.60"
"10","010","00","180","0009","0000","86","69","17","0","86","244","0","35.25","28.28"
"10","010","00","180","0009","0517","86","69","17","0","86","244","0","35.25","28.28"
"10","010","00","180","0010","0000","131","104","27","0","131","472","0","27.75","22.03"
"10","010","00","180","0010","0518","131","104","27","0","131","472","0","27.75","22.03"
"10","010","00","180","0011","0000","92","64","28","2","94","289","0","32.53","22.15"
"10","010","00","180","0011","0519","92","64","28","2","94","289","0","32.53","22.15"
"10","010","00","180","0012","0000","81","32","49","1","82","254","0","32.28","12.60"
"10","010","00","180","0012","0520","81","32","49","1","82","254","0","32.28","12.60"
"10","013","00","000","0000","0000","278332","111215","167117","2955","281287","700254","807970","40.17","15.88"
"10","013","00","010","0000","0000","72471","33674","38797","624","73095","167496","196653","43.64","20.10"
"10","013","00","010","0012","0000","1141","429","712","10","1151","2604","0","44.20","16.47"
"10","013","00","010","0012","0006","569","192","377","2","571","1339","0","42.64","14.34"
"10","013","00","010","0012","0007","572","237","335","8","580","1265","0","45.85","18.74"
"10","013","00","010","0020","0000","597","266","331","6","603","1528","0","39.46","17.41"
"10","013","00","010","0020","0011","320","121","199","5","325","751","0","43.28","16.11"
"10","013","00","010","0020","0012","277","145","132","1","278","777","0","35.78","18.66"
"10","013","00","010","0021","0000","397","175","222","3","400","843","0","47.45","20.76"
"10","013","00","010","0021","0013","397","175","222","3","400","843","0","47.45","20.76"
"10","013","00","010","0022","0000","824","387","437","4","828","1836","0","45.10","21.08"
"10","013","00","010","0022","0029","416","181","235","3","419","906","0","46.25","19.98"
"10","013","00","010","0022","0030","408","206","202","1","409","930","0","43.98","22.15"
"10","013","00","010","0023","0000","1206","540","666","10","1216","2467","0","49.29","21.89"
"10","013","00","010","0023","0024","642","270","372","4","646","1277","0","50.59","21.14"
"10","013","00","010","0023","0025","564","270","294","6","570","1190","0","47.90","22.69"
"10","013","00","010","0024","0000","1641","830","811","13","1654","3454","0","47.89","24.03"
"10","013","00","010","0024","0026","460","255","205","5","465","1046","0","44.46","24.38"
"10","013","00","010","0024","0027","550","264","286","2","552","1134","0","48.68","23.28"
"10","013","00","010","0024","0028","631","311","320","6","637","1274","0","50.00","24.41"
"10","013","00","010","0025","0000","1719","805","914","7","1726","3905","0","44.20","20.61"
"10","013","00","010","0025","0021","575","261","314","4","579","1258","0","46.03","20.75"
"10","013","00","010","0025","0022","609","289","320","1","610","1325","0","46.04","21.81"
"10","013","00","010","0025","0023","535","255","280","2","537","1322","0","40.62","19.29"
"10","013","00","010","0026","0000","4201","2242","1959","36","4237","9028","0","46.93","24.83"
"10","013","00","010","0026","0014","588","301","287","5","593","1298","0","45.69","23.19"
"10","013","00","010","0026","0015","622","337","285","5","627","1358","0","46.17","24.82"
"10","013","00","010","0026","0016","633","342","291","10","643","1364","0","47.14","25.07"
"10","013","00","010","0026","0017","558","319","239","4","562","1259","0","44.64","25.34"
"10","013","00","010","0026","0018","597","332","265","3","600","1209","0","49.63","27.46"
"10","013","00","010","0026","0019","612","324","288","4","616","1281","0","48.09","25.29"
"10","013","00","010","0026","0020","591","287","304","5","596","1259","0","47.34","22.80"
"10","013","00","010","0027","0000","675","193","482","5","680","1482","0","45.88","13.02"
"10","013","00","010","0027","0037","675","193","482","5","680","1482","0","45.88","13.02"
"10","013","00","010","0028","0000","439","131","308","1","440","1032","0","42.64","12.69"
"10","013","00","010","0028","0036","439","131","308","1","440","1032","0","42.64","12.69"
"10","013","00","010","0029","0000","472","111","361","8","480","1115","0","43.05","9.96"
"10","013","00","010","0029","0038","472","111","361","8","480","1115","0","43.05","9.96"
"10","013","00","010","0030","0000","3127","1544","1583","28","3155","7115","0","44.34","21.70"
"10","013","00","010","0030","0031","635","309","326","6","641","1461","0","43.87","21.15"
"10","013","00","010","0030","0032","603","312","291","8","611","1435","0","42.58","21.74"
"10","013","00","010","0030","0033","690","356","334","4","694","1372","0","50.58","25.95"
"10","013","00","010","0030","0034","564","280","284","9","573","1426","0","40.18","19.64"
"10","013","00","010","0030","0035","635","287","348","1","636","1421","0","44.76","20.20"
"10","013","00","010","0031","0000","2272","986","1286","17","2289","5421","0","42.22","18.19"
"10","013","00","010","0031","0063","664","262","402","5","669","1449","0","46.17","18.08"
"10","013","00","010","0031","0064","581","217","364","6","587","1381","0","42.51","15.71"
"10","013","00","010","0031","0065","356","159","197","0","356","967","0","36.81","16.44"
"10","013","00","010","0031","0066","671","348","323","6","677","1624","0","41.69","21.43"
"10","013","00","010","0032","0000","239","75","164","2","241","510","0","47.25","14.71"
"10","013","00","010","0032","0067","239","75","164","2","241","510","0","47.25","14.71"
"10","013","00","010","0033","0000","1240","419","821","10","1250","2821","0","44.31","14.85"
"10","013","00","010","0033","0077","563","186","377","1","564","1223","0","46.12","15.21"
"10","013","00","010","0033","0078","677","233","444","9","686","1598","0","42.93","14.58"
"10","013","00","010","0034","0000","360","123","237","2","362","796","0","45.48","15.45"
"10","013","00","010","0034","0074","360","123","237","2","362","796","0","45.48","15.45"
"10","013","00","010","0035","0000","408","188","220","5","413","900","0","45.89","20.89"
"10","013","00","010","0035","0075","408","188","220","5","413","900","0","45.89","20.89"
"10","013","00","010","0036","0000","559","304","255","2","561","1173","0","47.83","25.92"
"10","013","00","010","0036","0079","559","304","255","2","561","1173","0","47.83","25.92"
"10","013","00","010","0037","0000","299","105","194","2","301","678","0","44.40","15.49"
"10","013","00","010","0037","0076","299","105","194","2","301","678","0","44.40","15.49"
"10","013","00","010","0038","0000","558","330","228","6","564","1104","0","51.09","29.89"
"10","013","00","010","0038","0080","558","330","228","6","564","1104","0","51.09","29.89"
"10","013","00","010","0039","0000","274","105","169","3","277","655","0","42.29","16.03"
"10","013","00","010","0039","0081","274","105","169","3","277","655","0","42.29","16.03"
"10","013","00","010","0040","0000","2906","1254","1652","25","2931","6960","0","42.11","18.02"
"10","013","00","010","0040","0082","505","186","319","7","512","1289","0","39.72","14.43"
"10","013","00","010","0040","0083","560","219","341","6","566","1403","0","40.34","15.61"
"10","013","00","010","0040","0084","642","313","329","5","647","1446","0","44.74","21.65"
"10","013","00","010","0040","0085","496","218","278","2","498","1314","0","37.90","16.59"
"10","013","00","010","0040","0086","703","318","385","5","708","1508","0","46.95","21.09"
"10","013","00","010","0041","0000","987","364","623","9","996","2467","0","40.37","14.75"
"10","013","00","010","0041","0060","564","163","401","5","569","1262","0","45.09","12.92"
"10","013","00","010","0041","0061","423","201","222","4","427","1205","0","35.44","16.68"
"10","013","00","010","0042","0000","671","208","463","8","679","1488","0","45.63","13.98"
"10","013","00","010","0042","0062","671","208","463","8","679","1488","0","45.63","13.98"
"10","013","00","010","0043","0000","927","317","610","12","939","2203","0","42.62","14.39"
"10","013","00","010","0043","0071","486","165","321","5","491","1183","0","41.50","13.95"
"10","013","00","010","0043","0072","441","152","289","7","448","1020","0","43.92","14.90"
"10","013","00","010","0044","0000","619","136","483","8","627","1481","0","42.34","9.18"
"10","013","00","010","0044","0073","619","136","483","8","627","1481","0","42.34","9.18"
"10","013","00","010","0045","0000","466","146","320","3","469","1083","0","43.31","13.48"
"10","013","00","010","0045","0068","466","146","320","3","469","1083","0","43.31","13.48"
"10","013","00","010","0046","0000","712","262","450","7","719","1791","0","40.15","14.63"
"10","013","00","010","0046","0069","338","148","190","1","339","870","0","38.97","17.01"
"10","013","00","010","0046","0070","374","114","260","6","380","921","0","41.26","12.38"
"10","013","00","010","0049","0000","841","289","552","11","852","1995","0","42.71","14.49"
"10","013","00","010","0049","0052","396","116","280","6","402","946","0","42.49","12.26"
"10","013","00","010","0049","0053","445","173","272","5","450","1049","0","42.90","16.49"
"10","013","00","010","0050","0000","452","183","269","2","454","1004","0","45.22","18.23"
"10","013","00","010","0050","0054","452","183","269","2","454","1004","0","45.22","18.23"
"10","013","00","010","0051","0000","524","135","389","6","530","1166","0","45.45","11.58"
"10","013","00","010","0051","0059","524","135","389","6","530","1166","0","45.45","11.58"
"10","013","00","010","0053","0000","3409","1586","1823","39","3448","8068","0","42.74","19.66"
"10","013","00","010","0053","0042","539","277","262","2","541","1239","0","43.66","22.36"
"10","013","00","010","0053","0043","500","234","266","2","502","1307","0","38.41","17.90"
"10","013","00","010","0053","0044","584","256","328","4","588","1390","0","42.30","18.42"
"10","013","00","010","0053","0045","587","234","353","6","593","1398","0","42.42","16.74"
"10","013","00","010","0053","0046","594","300","294","7","601","1359","0","44.22","22.08"
"10","013","00","010","0053","0047","605","285","320","18","623","1375","0","45.31","20.73"
"10","013","00","010","0054","0000","1215","450","765","9","1224","2872","0","42.62","15.67"
"10","013","00","010","0054","0057","605","240","365","5","610","1412","0","43.20","17.00"
"10","013","00","010","0054","0058","610","210","400","4","614","1460","0","42.05","14.38"
"10","013","00","010","0055","0000","1680","774","906","9","1689","4077","0","41.43","18.98"
"10","013","00","010","0055","0039","580","248","332","1","581","1334","0","43.55","18.59"
"10","013","00","010","0055","0040","530","263","267","3","533","1373","0","38.82","19.16"
"10","013","00","010","0055","0041","570","263","307","5","575","1370","0","41.97","19.20"
"10","013","00","010","0056","0000","839","302","537","6","845","1956","0","43.20","15.44"
"10","013","00","010","0056","0055","416","149","267","4","420","1031","0","40.74","14.45"
"10","013","00","010","0056","0056","423","153","270","2","425","925","0","45.95","16.54"
"10","013","00","010","0059","0000","759","383","376","4","763","1637","0","46.61","23.40"
"10","013","00","010","0059","0116","345","170","175","1","346","814","0","42.51","20.88"
"10","013","00","010","0059","0117","414","213","201","3","417","823","0","50.67","25.88"
"10","013","00","010","0060","0000","2004","1047","957","16","2020","4657","0","43.38","22.48"
"10","013","00","010","0060","0118","517","252","265","4","521","1164","0","44.76","21.65"
"10","013","00","010","0060","0119","428","210","218","0","428","1025","0","41.76","20.49"
"10","013","00","010","0060","0120","514","282","232","7","521","1229","0","42.39","22.95"
"10","013","00","010","0060","0121","545","303","242","5","550","1239","0","44.39","24.46"
"10","013","00","010","0061","0000","340","176","164","2","342","730","0","46.85","24.11"
"10","013","00","010","0061","0138","340","176","164","2","342","730","0","46.85","24.11"
"10","013","00","010","0062","0000","262","128","134","3","265","652","0","40.64","19.63"
"10","013","00","010","0062","0139","262","128","134","3","265","652","0","40.64","19.63"
"10","013","00","010","0063","0000","302","130","172","3","305","626","0","48.72","20.77"
"10","013","00","010","0063","0140","302","130","172","3","305","626","0","48.72","20.77"
"10","013","00","010","0064","0000","1968","1039","929","20","1988","4603","0","43.19","22.57"
"10","013","00","010","0064","0134","523","255","268","5","528","1118","0","47.23","22.81"
"10","013","00","010","0064","0135","489","258","231","6","495","1149","0","43.08","22.45"
"10","013","00","010","0064","0136","508","275","233","6","514","1203","0","42.73","22.86"
"10","013","00","010","0064","0137","448","251","197","3","451","1133","0","39.81","22.15"
"10","013","00","010","0065","0000","2024","1095","929","17","2041","5471","0","37.31","20.01"
"10","013","00","010","0065","0112","443","240","203","5","448","1773","0","25.27","13.54"
"10","013","00","010","0065","0113","500","278","222","2","502","1224","0","41.01","22.71"
"10","013","00","010","0065","0114","610","300","310","8","618","1310","0","47.18","22.90"
"10","013","00","010","0065","0115","471","277","194","2","473","1164","0","40.64","23.80"
"10","013","00","010","0066","0000","770","369","401","13","783","1912","0","40.95","19.30"
"10","013","00","010","0066","0106","378","178","200","9","387","913","0","42.39","19.50"
"10","013","00","010","0066","0107","392","191","201","4","396","999","0","39.64","19.12"
"10","013","00","010","0067","0000","985","458","527","12","997","2231","0","44.69","20.53"
"10","013","00","010","0067","0122","464","207","257","5","469","1085","0","43.23","19.08"
"10","013","00","010","0067","0123","521","251","270","7","528","1146","0","46.07","21.90"
"10","013","00","010","0068","0000","1085","488","597","11","1096","2284","0","47.99","21.37"
"10","013","00","010","0068","0132","612","283","329","6","618","1239","0","49.88","22.84"
"10","013","00","010","0068","0133","473","205","268","5","478","1045","0","45.74","19.62"
"10","013","00","010","0069","0000","2563","1300","1263","15","2578","6059","0","42.55","21.46"
"10","013","00","010","0069","0127","503","248","255","6","509","1220","0","41.72","20.33"
"10","013","00","010","0069","0128","546","295","251","2","548","1204","0","45.51","24.50"
"10","013","00","010","0069","0129","487","254","233","2","489","1196","0","40.89","21.24"
"10","013","00","010","0069","0130","512","276","236","0","512","1232","0","41.56","22.40"
"10","013","00","010","0069","0131","515","227","288","5","520","1207","0","43.08","18.81"
"10","013","00","010","0070","0000","1018","476","542","10","1028","2149","0","47.84","22.15"
"10","013","00","010","0070","0143","457","207","250","4","461","1001","0","46.05","20.68"
"10","013","00","010","0070","0144","561","269","292","6","567","1148","0","49.39","23.43"
"10","013","00","010","0071","0000","876","389","487","6","882","2058","0","42.86","18.90"
"10","013","00","010","0071","0110","465","169","296","4","469","1044","0","44.92","16.19"
"10","013","00","010","0071","0111","411","220","191","2","413","1014","0","40.73","21.70"
"10","013","00","010","0073","0000","5176","2916","2260","36","5212","12298","0","42.38","23.71"
"10","013","00","010","0073","0087","348","208","140","4","352","809","0","43.51","25.71"
"10","013","00","010","0073","0088","516","207","309","7","523","1266","0","41.31","16.35"
"10","013","00","010","0073","0089","502","274","228","1","503","1273","0","39.51","21.52"
"10","013","00","010","0073","0090","547","338","209","4","551","1346","0","40.94","25.11"
"10","013","00","010","0073","0091","519","262","257","4","523","1225","0","42.69","21.39"
"10","013","00","010","0073","0092","394","211","183","1","395","910","0","43.41","23.19"
"10","013","00","010","0073","0093","567","359","208","3","570","1392","0","40.95","25.79"
"10","013","00","010","0073","0094","607","358","249","5","612","1343","0","45.57","26.66"
"10","013","00","010","0073","0095","570","329","241","2","572","1310","0","43.66","25.11"
"10","013","00","010","0073","0096","606","370","236","5","611","1424","0","42.91","25.98"
"10","013","00","010","0074","0000","803","538","265","6","809","1655","0","48.88","32.51"
"10","013","00","010","0074","0108","401","262","139","3","404","810","0","49.88","32.35"
"10","013","00","010","0074","0109","402","276","126","3","405","845","0","47.93","32.66"
"10","013","00","010","0075","0000","4541","2689","1852","34","4575","11543","0","39.63","23.30"
"10","013","00","010","0075","0097","533","325","208","2","535","1434","0","37.31","22.66"
"10","013","00","010","0075","0098","457","274","183","8","465","1184","0","39.27","23.14"
"10","013","00","010","0075","0099","514","293","221","7","521","1320","0","39.47","22.20"
"10","013","00","010","0075","0100","548","330","218","3","551","1300","0","42.38","25.38"
"10","013","00","010","0075","0101","603","336","267","2","605","1430","0","42.31","23.50"
"10","013","00","010","0075","0102","499","292","207","5","504","1245","0","40.48","23.45"
"10","013","00","010","0075","0103","552","332","220","2","554","1388","0","39.91","23.92"
"10","013","00","010","0075","0104","279","174","105","2","281","773","0","36.35","22.51"
"10","013","00","010","0075","0105","556","333","223","3","559","1469","0","38.05","22.67"
"10","013","00","010","0076","0000","570","176","394","8","578","1324","0","43.66","13.29"
"10","013","00","010","0076","0124","570","176","394","8","578","1324","0","43.66","13.29"
"10","013","00","010","0077","0000","373","111","262","2","375","849","0","44.17","13.07"
"10","013","00","010","0077","0125","373","111","262","2","375","849","0","44.17","13.07"
"10","013","00","010","0078","0000","427","130","297","11","438","1089","0","40.22","11.94"
"10","013","00","010","0078","0126","427","130","297","11","438","1089","0","40.22","11.94"
"10","013","00","010","0079","0000","421","122","299","7","428","941","0","45.48","12.96"
"10","013","00","010","0079","0142","421","122","299","7","428","941","0","45.48","12.96"
"10","013","00","010","0080","0000","684","177","507","8","692","1560","0","44.36","11.35"
"10","013","00","010","0080","0141","684","177","507","8","692","1560","0","44.36","11.35"
"10","013","00","010","0081","0000","1254","911","343","10","1264","2890","0","43.74","31.52"
"10","013","00","010","0081","0048","599","488","111","6","605","1352","0","44.75","36.09"
"10","013","00","010","0081","0049","655","423","232","4","659","1538","0","42.85","27.50"
"10","013","00","010","0085","0000","534","183","351","5","539","1053","0","51.19","17.38"
"10","013","00","010","0085","0001","534","183","351","5","539","1053","0","51.19","17.38"
"10","013","00","010","0086","0000","290","156","134","6","296","675","0","43.85","23.11"
"10","013","00","010","0086","0002","290","156","134","6","296","675","0","43.85","23.11"
"10","013","00","010","0087","0000","629","262","367","5","634","1310","0","48.40","20.00"
"10","013","00","010","0087","0003","629","262","367","5","634","1310","0","48.40","20.00"
"10","013","00","010","0088","0000","559","218","341","2","561","1240","0","45.24","17.58"
"10","013","00","010","0088","0004","559","218","341","2","561","1240","0","45.24","17.58"
"10","013","00","010","0089","0000","306","105","201","1","307","654","0","46.94","16.06"
"10","013","00","010","0089","0005","306","105","201","1","307","654","0","46.94","16.06"
"10","013","00","010","0090","0000","601","204","397","6","607","1166","0","52.06","17.50"
"10","013","00","010","0090","0008","601","204","397","6","607","1166","0","52.06","17.50"
"10","013","00","010","0091","0000","488","201","287","1","489","1039","0","47.06","19.35"
"10","013","00","010","0091","0009","488","201","287","1","489","1039","0","47.06","19.35"
"10","013","00","010","0092","0000","510","180","330","5","515","1018","0","50.59","17.68"
"10","013","00","010","0092","0010","510","180","330","5","515","1018","0","50.59","17.68"
"10","013","00","010","0093","0000","214","121","93","3","217","525","0","41.33","23.05"
"10","013","00","010","0093","0050","214","121","93","3","217","525","0","41.33","23.05"
"10","013","00","010","0094","0000","239","102","137","2","241","520","0","46.35","19.62"
"10","013","00","010","0094","0051","239","102","137","2","241","520","0","46.35","19.62"
"10","013","00","020","0000","0000","18710","7545","11165","147","18857","46629","53851","40.44","16.18"
"10","013","00","020","0001","0000","224","122","102","2","226","505","0","44.75","24.16"
"10","013","00","020","0001","0145","224","122","102","2","226","505","0","44.75","24.16"
"10","013","00","020","0002","0000","301","101","200","1","302","582","0","51.89","17.35"
"10","013","00","020","0002","0151","301","101","200","1","302","582","0","51.89","17.35"
"10","013","00","020","0003","0000","552","220","332","3","555","1227","0","45.23","17.93"
"10","013","00","020","0003","0167","552","220","332","3","555","1227","0","45.23","17.93"
"10","013","00","020","0004","0000","415","163","252","2","417","983","0","42.42","16.58"
"10","013","00","020","0004","0166","415","163","252","2","417","983","0","42.42","16.58"
"10","013","00","020","0005","0000","1749","749","1000","7","1756","4770","0","36.81","15.70"
"10","013","00","020","0005","0146","349","132","217","1","350","913","0","38.34","14.46"
"10","013","00","020","0005","0147","314","135","179","1","315","937","0","33.62","14.41"
"10","013","00","020","0005","0148","401","169","232","3","404","991","0","40.77","17.05"
"10","013","00","020","0005","0149","320","128","192","1","321","928","0","34.59","13.79"
"10","013","00","020","0005","0150","365","185","180","1","366","1001","0","36.56","18.48"
"10","013","00","020","0006","0000","377","113","264","1","378","859","0","44.00","13.15"
"10","013","00","020","0006","0152","377","113","264","1","378","859","0","44.00","13.15"
"10","013","00","020","0007","0000","2294","1043","1251","13","2307","5434","0","42.45","19.19"
"10","013","00","020","0007","0153","537","245","292","1","538","1261","0","42.66","19.43"
"10","013","00","020","0007","0154","686","301","385","4","690","1728","0","39.93","17.42"
"10","013","00","020","0007","0155","571","264","307","2","573","1254","0","45.69","21.05"
"10","013","00","020","0007","0156","500","233","267","6","506","1191","0","42.49","19.56"
"10","013","00","020","0008","0000","2764","1215","1549","20","2784","6463","0","43.08","18.80"
"10","013","00","020","0008","0157","508","206","302","4","512","1141","0","44.87","18.05"
"10","013","00","020","0008","0158","546","247","299","3","549","1347","0","40.76","18.34"
"10","013","00","020","0008","0159","586","266","320","5","591","1410","0","41.91","18.87"
"10","013","00","020","0008","0160","476","200","276","5","481","1097","0","43.85","18.23"
"10","013","00","020","0008","0161","648","296","352","3","651","1468","0","44.35","20.16"
"10","013","00","020","0009","0000","880","376","504","6","886","2106","0","42.07","17.85"
"10","013","00","020","0009","0162","359","152","207","3","362","868","0","41.71","17.51"
"10","013","00","020","0009","0163","521","224","297","3","524","1238","0","42.33","18.09"
"10","013","00","020","0010","0000","550","201","349","5","555","1387","0","40.01","14.49"
"10","013","00","020","0010","0168","550","201","349","5","555","1387","0","40.01","14.49"
"10","013","00","020","0011","0000","929","328","601","3","932","2401","0","38.82","13.66"
"10","013","00","020","0011","0169","524","206","318","0","524","1292","0","40.56","15.94"
"10","013","00","020","0011","0170","405","122","283","3","408","1109","0","36.79","11.00"
"10","013","00","020","0012","0000","916","363","553","12","928","2381","0","38.98","15.25"
"10","013","00","020","0012","0171","493","192","301","6","499","1336","0","37.35","14.37"
"10","013","00","020","0012","0172","423","171","252","6","429","1045","0","41.05","16.36"
"10","013","00","020","0013","0000","2666","1143","1523","19","2685","7120","0","37.71","16.05"
"10","013","00","020","0013","0173","422","164","258","2","424","1077","0","39.37","15.23"
"10","013","00","020","0013","0174","453","189","264","4","457","1240","0","36.85","15.24"
"10","013","00","020","0013","0175","473","231","242","3","476","1161","0","41.00","19.90"
"10","013","00","020","0013","0176","410","165","245","3","413","1106","0","37.34","14.92"
"10","013","00","020","0013","0177","466","190","276","3","469","1323","0","35.45","14.36"
"10","013","00","020","0013","0178","442","204","238","4","446","1213","0","36.77","16.82"
"10","013","00","020","0014","0000","451","187","264","4","455","1172","0","38.82","15.96"
"10","013","00","020","0014","0179","451","187","264","4","455","1172","0","38.82","15.96"
"10","013","00","020","0015","0000","554","218","336","7","561","1413","0","39.70","15.43"
"10","013","00","020","0015","0180","554","218","336","7","561","1413","0","39.70","15.43"
"10","013","00","020","0016","0000","312","111","201","2","314","881","0","35.64","12.60"
"10","013","00","020","0016","0181","312","111","201","2","314","881","0","35.64","12.60"
"10","013","00","020","0017","0000","168","60","108","1","169","468","0","36.11","12.82"
"10","013","00","020","0017","0182","168","60","108","1","169","468","0","36.11","12.82"
"10","013","00","020","0018","0000","622","175","447","12","634","1633","0","38.82","10.72"
"10","013","00","020","0018","0164","404","116","288","9","413","1149","0","35.94","10.10"
"10","013","00","020","0018","0165","218","59","159","3","221","484","0","45.66","12.19"
"10","013","00","020","0019","0000","694","248","446","8","702","1615","0","43.47","15.36"
"10","013","00","020","0019","0183","363","140","223","7","370","884","0","41.86","15.84"
"10","013","00","020","0019","0184","331","108","223","1","332","731","0","45.42","14.77"
"10","013","00","020","0020","0000","683","216","467","12","695","1694","0","41.03","12.75"
"10","013","00","020","0020","0185","322","99","223","8","330","900","0","36.67","11.00"
"10","013","00","020","0020","0186","361","117","244","4","365","794","0","45.97","14.74"
"10","013","00","020","0021","0000","609","193","416","7","616","1535","0","40.13","12.57"
"10","013","00","020","0021","0187","445","151","294","5","450","1185","0","37.97","12.74"
"10","013","00","020","0021","0188","164","42","122","2","166","350","0","47.43","12.00"
"10","013","00","030","0000","0000","15318","5094","10224","133","15451","39127","46590","39.49","13.02"
"10","013","00","030","0001","0000","952","296","656","5","957","1975","0","48.46","14.99"
"10","013","00","030","0001","0189","449","145","304","4","453","955","0","47.43","15.18"
"10","013","00","030","0001","0190","503","151","352","1","504","1020","0","49.41","14.80"
"10","013","00","030","0004","0000","242","92","150","1","243","631","0","38.51","14.58"
"10","013","00","030","0004","0192","242","92","150","1","243","631","0","38.51","14.58"
"10","013","00","030","0007","0000","595","171","424","8","603","1575","0","38.29","10.86"
"10","013","00","030","0007","0203","378","119","259","5","383","1022","0","37.48","11.64"
"10","013","00","030","0007","0204","217","52","165","3","220","553","0","39.78","9.40"
"10","013","00","030","0008","0000","333","111","222","0","333","734","0","45.37","15.12"
"10","013","00","030","0008","0205","333","111","222","0","333","734","0","45.37","15.12"
"10","013","00","030","0009","0000","439","145","294","2","441","1192","0","37.00","12.16"
"10","013","00","030","0009","0206","439","145","294","2","441","1192","0","37.00","12.16"
"10","013","00","030","0010","0000","241","79","162","1","242","559","0","43.29","14.13"
"10","013","00","030","0010","0207","241","79","162","1","242","559","0","43.29","14.13"
"10","013","00","030","0011","0000","491","121","370","4","495","1329","0","37.25","9.10"
"10","013","00","030","0011","0208","491","121","370","4","495","1329","0","37.25","9.10"
"10","013","00","030","0012","0000","707","178","529","3","710","1804","0","39.36","9.87"
"10","013","00","030","0012","0209","280","79","201","0","280","729","0","38.41","10.84"
"10","013","00","030","0012","0210","427","99","328","3","430","1075","0","40.00","9.21"
"10","013","00","030","0013","0000","1047","261","786","5","1052","2840","0","37.04","9.19"
"10","013","00","030","0013","0211","524","146","378","1","525","1361","0","38.57","10.73"
"10","013","00","030","0013","0212","523","115","408","4","527","1479","0","35.63","7.78"
"10","013","00","030","0014","0000","664","193","471","4","668","1680","0","39.76","11.49"
"10","013","00","030","0014","0213","332","87","245","4","336","817","0","41.13","10.65"
"10","013","00","030","0014","0214","332","106","226","0","332","863","0","38.47","12.28"
"10","013","00","030","0015","0000","527","201","326","9","536","1562","0","34.31","12.87"
"10","013","00","030","0015","0215","159","67","92","3","162","417","0","38.85","16.07"
"10","013","00","030","0015","0216","368","134","234","6","374","1145","0","32.66","11.70"
"10","013","00","030","0016","0000","2096","743","1353","19","2115","5363","0","39.44","13.85"
"10","013","00","030","0016","0217","411","119","292","5","416","1003","0","41.48","11.86"
"10","013","00","030","0016","0218","433","155","278","3","436","1017","0","42.87","15.24"
"10","013","00","030","0016","0219","353","158","195","5","358","998","0","35.87","15.83"
"10","013","00","030","0016","0220","393","150","243","0","393","1046","0","37.57","14.34"
"10","013","00","030","0016","0221","506","161","345","6","512","1299","0","39.41","12.39"
"10","013","00","030","0017","0000","785","155","630","19","804","1937","0","41.51","8.00"
"10","013","00","030","0017","0222","464","74","390","12","476","1201","0","39.63","6.16"
"10","013","00","030","0017","0223","321","81","240","7","328","736","0","44.57","11.01"
"10","013","00","030","0018","0000","593","184","409","7","600","1532","0","39.16","12.01"
"10","013","00","030","0018","0224","317","94","223","3","320","815","0","39.26","11.53"
"10","013","00","030","0018","0225","276","90","186","4","280","717","0","39.05","12.55"
"10","013","00","030","0019","0000","3482","1329","2153","25","3507","9392","0","37.34","14.15"
"10","013","00","030","0019","0193","344","125","219","1","345","896","0","38.50","13.95"
"10","013","00","030","0019","0194","421","167","254","7","428","1156","0","37.02","14.45"
"10","013","00","030","0019","0195","504","203","301","1","505","1436","0","35.17","14.14"
"10","013","00","030","0019","0196","432","172","260","1","433","1202","0","36.02","14.31"
"10","013","00","030","0019","0197","383","138","245","5","388","1110","0","34.95","12.43"
"10","013","00","030","0019","0198","449","179","270","4","453","1116","0","40.59","16.04"
"10","013","00","030","0019","0199","503","174","329","3","506","1182","0","42.81","14.72"
"10","013","00","030","0019","0200","446","171","275","3","449","1294","0","34.70","13.21"
"10","013","00","030","0020","0000","551","190","361","3","554","1324","0","41.84","14.35"
"10","013","00","030","0020","0201","551","190","361","3","554","1324","0","41.84","14.35"
"10","013","00","030","0021","0000","419","100","319","8","427","1049","0","40.71","9.53"
"10","013","00","030","0021","0226","419","100","319","8","427","1049","0","40.71","9.53"
"10","013","00","030","0022","0000","286","198","88","4","290","664","0","43.67","29.82"
"10","013","00","030","0022","0227","286","198","88","4","290","664","0","43.67","29.82"
"10","013","00","030","0029","0000","381","139","242","1","382","852","0","44.84","16.31"
"10","013","00","030","0029","0191","381","139","242","1","382","852","0","44.84","16.31"
"10","013","00","030","0030","0000","487","208","279","5","492","1133","0","43.42","18.36"
"10","013","00","030","0030","0202","487","208","279","5","492","1133","0","43.42","18.36"
"10","013","00","040","0000","0000","7382","3407","3975","96","7478","25502","30236","29.32","13.36"
"10","013","00","040","0001","0000","295","161","134","2","297","896","0","33.15","17.97"
"10","013","00","040","0001","0228","295","161","134","2","297","896","0","33.15","17.97"
"10","013","00","040","0002","0000","708","351","357","6","714","2205","0","32.38","15.92"
"10","013","00","040","0002","0229","216","103","113","2","218","706","0","30.88","14.59"
"10","013","00","040","0002","0230","258","136","122","2","260","755","0","34.44","18.01"
"10","013","00","040","0002","0231","234","112","122","2","236","744","0","31.72","15.05"
"10","013","00","040","0003","0000","322","168","154","6","328","1109","0","29.58","15.15"
"10","013","00","040","0003","0232","322","168","154","6","328","1109","0","29.58","15.15"
"10","013","00","040","0004","0000","1197","606","591","8","1205","4194","0","28.73","14.45"
"10","013","00","040","0004","0248","262","126","136","1","263","1028","0","25.58","12.26"
"10","013","00","040","0004","0249","355","186","169","1","356","1081","0","32.93","17.21"
"10","013","00","040","0004","0250","314","148","166","3","317","1035","0","30.63","14.30"
"10","013","00","040","0004","0251","266","146","120","3","269","1050","0","25.62","13.90"
"10","013","00","040","0005","0000","893","433","460","13","906","3117","0","29.07","13.89"
"10","013","00","040","0005","0233","284","139","145","3","287","1081","0","26.55","12.86"
"10","013","00","040","0005","0234","299","155","144","3","302","1011","0","29.87","15.33"
"10","013","00","040","0005","0235","310","139","171","7","317","1025","0","30.93","13.56"
"10","013","00","040","0006","0000","227","93","134","3","230","856","0","26.87","10.86"
"10","013","00","040","0006","0236","227","93","134","3","230","856","0","26.87","10.86"
"10","013","00","040","0007","0000","169","56","113","4","173","504","0","34.33","11.11"
"10","013","00","040","0007","0237","169","56","113","4","173","504","0","34.33","11.11"
"10","013","00","040","0008","0000","166","64","102","1","167","473","0","35.31","13.53"
"10","013","00","040","0008","0238","166","64","102","1","167","473","0","35.31","13.53"
"10","013","00","040","0009","0000","273","107","166","5","278","1021","0","27.23","10.48"
"10","013","00","040","0009","0239","273","107","166","5","278","1021","0","27.23","10.48"
"10","013","00","040","0010","0000","247","99","148","7","254","928","0","27.37","10.67"
"10","013","00","040","0010","0240","247","99","148","7","254","928","0","27.37","10.67"
"10","013","00","040","0011","0000","285","136","149","0","285","1079","0","26.41","12.60"
"10","013","00","040","0011","0241","285","136","149","0","285","1079","0","26.41","12.60"
"10","013","00","040","0012","0000","481","153","328","8","489","1560","0","31.35","9.81"
"10","013","00","040","0012","0242","239","57","182","5","244","776","0","31.44","7.35"
"10","013","00","040","0012","0243","242","96","146","3","245","784","0","31.25","12.24"
"10","013","00","040","0013","0000","533","266","267","8","541","2199","0","24.60","12.10"
"10","013","00","040","0013","0244","283","134","149","3","286","1089","0","26.26","12.30"
"10","013","00","040","0013","0245","250","132","118","5","255","1110","0","22.97","11.89"
"10","013","00","040","0014","0000","318","106","212","6","324","1388","0","23.34","7.64"
"10","013","00","040","0014","0246","164","61","103","2","166","683","0","24.30","8.93"
"10","013","00","040","0014","0247","154","45","109","4","158","705","0","22.41","6.38"
"10","013","00","040","0015","0000","478","243","235","6","484","1686","0","28.71","14.41"
"10","013","00","040","0015","0252","222","105","117","0","222","824","0","26.94","12.74"
"10","013","00","040","0015","0253","256","138","118","6","262","862","0","30.39","16.01"
"10","013","00","040","0016","0000","456","199","257","8","464","1205","0","38.51","16.51"
"10","013","00","040","0016","0254","255","123","132","2","257","585","0","43.93","21.03"
"10","013","00","040","0016","0255","201","76","125","6","207","620","0","33.39","12.26"
"10","013","00","040","0017","0000","334","166","168","5","339","1082","0","31.33","15.34"
"10","013","00","040","0017","0256","334","166","168","5","339","1082","0","31.33","15.34"
"10","013","00","050","0000","0000","18011","6004","12007","208","18219","43230","49955","42.14","13.89"
"10","013","00","050","0001","0000","245","73","172","1","246","587","0","41.91","12.44"
"10","013","00","050","0001","0271","245","73","172","1","246","587","0","41.91","12.44"
"10","013","00","050","0002","0000","360","129","231","3","363","817","0","44.43","15.79"
"10","013","00","050","0002","0266","360","129","231","3","363","817","0","44.43","15.79"
"10","013","00","050","0003","0000","1458","528","930","18","1476","3322","0","44.43","15.89"
"10","013","00","050","0003","0267","487","183","304","7","494","1113","0","44.38","16.44"
"10","013","00","050","0003","0268","458","195","263","5","463","1078","0","42.95","18.09"
"10","013","00","050","0003","0269","513","150","363","6","519","1131","0","45.89","13.26"
"10","013","00","050","0004","0000","241","75","166","0","241","711","0","33.90","10.55"
"10","013","00","050","0004","0270","241","75","166","0","241","711","0","33.90","10.55"
"10","013","00","050","0005","0000","613","262","351","4","617","1403","0","43.98","18.67"
"10","013","00","050","0005","0272","613","262","351","4","617","1403","0","43.98","18.67"
"10","013","00","050","0006","0000","860","347","513","7","867","2249","0","38.55","15.43"
"10","013","00","050","0006","0273","400","177","223","3","403","1090","0","36.97","16.24"
"10","013","00","050","0006","0274","460","170","290","4","464","1159","0","40.03","14.67"
"10","013","00","050","0007","0000","822","280","542","11","833","2047","0","40.69","13.68"
"10","013","00","050","0007","0275","400","130","270","7","407","969","0","42.00","13.42"
"10","013","00","050","0007","0276","422","150","272","4","426","1078","0","39.52","13.91"
"10","013","00","050","0008","0000","693","219","474","10","703","1671","0","42.07","13.11"
"10","013","00","050","0008","0277","343","127","216","5","348","862","0","40.37","14.73"
"10","013","00","050","0008","0278","350","92","258","5","355","809","0","43.88","11.37"
"10","013","00","050","0009","0000","1021","314","707","7","1028","2276","0","45.17","13.80"
"10","013","00","050","0009","0299","495","130","365","2","497","1036","0","47.97","12.55"
"10","013","00","050","0009","0300","526","184","342","5","531","1240","0","42.82","14.84"
"10","013","00","050","0010","0000","440","110","330","7","447","973","0","45.94","11.31"
"10","013","00","050","0010","0281","440","110","330","7","447","973","0","45.94","11.31"
"10","013","00","050","0011","0000","713","216","497","9","722","1835","0","39.35","11.77"
"10","013","00","050","0011","0282","375","126","249","9","384","956","0","40.17","13.18"
"10","013","00","050","0011","0283","338","90","248","0","338","879","0","38.45","10.24"
"10","013","00","050","0012","0000","685","191","494","7","692","1593","0","43.44","11.99"
"10","013","00","050","0012","0284","378","95","283","2","380","862","0","44.08","11.02"
"10","013","00","050","0012","0285","307","96","211","5","312","731","0","42.68","13.13"
"10","013","00","050","0013","0000","565","188","377","6","571","1407","0","40.58","13.36"
"10","013","00","050","0013","0286","565","188","377","6","571","1407","0","40.58","13.36"
"10","013","00","050","0014","0000","365","100","265","3","368","822","0","44.77","12.17"
"10","013","00","050","0014","0289","365","100","265","3","368","822","0","44.77","12.17"
"10","013","00","050","0015","0000","541","120","421","6","547","1248","0","43.83","9.62"
"10","013","00","050","0015","0290","541","120","421","6","547","1248","0","43.83","9.62"
"10","013","00","050","0016","0000","555","210","345","13","568","1471","0","38.61","14.28"
"10","013","00","050","0016","0291","555","210","345","13","568","1471","0","38.61","14.28"
"10","013","00","050","0017","0000","417","131","286","7","424","943","0","44.96","13.89"
"10","013","00","050","0017","0292","417","131","286","7","424","943","0","44.96","13.89"
"10","013","00","050","0018","0000","846","281","565","2","848","1968","0","43.09","14.28"
"10","013","00","050","0018","0293","353","109","244","1","354","802","0","44.14","13.59"
"10","013","00","050","0018","0294","493","172","321","1","494","1166","0","42.37","14.75"
"10","013","00","050","0019","0000","712","220","492","9","721","1666","0","43.28","13.21"
"10","013","00","050","0019","0297","416","136","280","2","418","953","0","43.86","14.27"
"10","013","00","050","0019","0298","296","84","212","7","303","713","0","42.50","11.78"
"10","013","00","050","0020","0000","711","194","517","13","724","1692","0","42.79","11.47"
"10","013","00","050","0020","0295","354","98","256","7","361","839","0","43.03","11.68"
"10","013","00","050","0020","0296","357","96","261","6","363","853","0","42.56","11.25"
"10","013","00","050","0021","0000","765","263","502","13","778","1694","0","45.93","15.53"
"10","013","00","050","0021","0279","360","120","240","5","365","800","0","45.63","15.00"
"10","013","00","050","0021","0280","405","143","262","8","413","894","0","46.20","16.00"
"10","013","00","050","0022","0000","869","350","519","9","878","2075","0","42.31","16.87"
"10","013","00","050","0022","0258","487","192","295","7","494","1168","0","42.29","16.44"
"10","013","00","050","0022","0259","382","158","224","2","384","907","0","42.34","17.42"
"10","013","00","050","0023","0000","622","211","411","8","630","1508","0","41.78","13.99"
"10","013","00","050","0023","0257","622","211","411","8","630","1508","0","41.78","13.99"
"10","013","00","050","0024","0000","451","136","315","3","454","977","0","46.47","13.92"
"10","013","00","050","0024","0287","451","136","315","3","454","977","0","46.47","13.92"
"10","013","00","050","0025","0000","725","313","412","8","733","2019","0","36.31","15.50"
"10","013","00","050","0025","0260","369","177","192","3","372","1003","0","37.09","17.65"
"10","013","00","050","0025","0261","356","136","220","5","361","1016","0","35.53","13.39"
"10","013","00","050","0026","0000","526","135","391","8","534","1343","0","39.76","10.05"
"10","013","00","050","0026","0288","526","135","391","8","534","1343","0","39.76","10.05"
"10","013","00","050","0027","0000","472","171","301","9","481","1145","0","42.01","14.93"
"10","013","00","050","0027","0263","472","171","301","9","481","1145","0","42.01","14.93"
"10","013","00","050","0028","0000","354","99","255","2","356","828","0","43.00","11.96"
"10","013","00","050","0028","0264","354","99","255","2","356","828","0","43.00","11.96"
"10","013","00","050","0029","0000","232","91","141","3","235","546","0","43.04","16.67"
"10","013","00","050","0029","0262","232","91","141","3","235","546","0","43.04","16.67"
"10","013","00","050","0030","0000","132","47","85","2","134","394","0","34.01","11.93"
"10","013","00","050","0030","0265","132","47","85","2","134","394","0","34.01","11.93"
"10","013","00","060","0000","0000","10962","4252","6710","98","11060","26079","29381","42.41","16.30"
"10","013","00","060","0001","0000","1106","448","658","15","1121","2655","0","42.22","16.87"
"10","013","00","060","0001","0301","425","147","278","6","431","1004","0","42.93","14.64"
"10","013","00","060","0001","0302","681","301","380","9","690","1651","0","41.79","18.23"
"10","013","00","060","0002","0000","1506","690","816","14","1520","3605","0","42.16","19.14"
"10","013","00","060","0002","0303","770","363","407","5","775","1846","0","41.98","19.66"
"10","013","00","060","0002","0304","736","327","409","9","745","1759","0","42.35","18.59"
"10","013","00","060","0003","0000","889","378","511","5","894","1921","0","46.54","19.68"
"10","013","00","060","0003","0305","435","216","219","1","436","966","0","45.13","22.36"
"10","013","00","060","0003","0306","454","162","292","4","458","955","0","47.96","16.96"
"10","013","00","060","0004","0000","1169","501","668","6","1175","2628","0","44.71","19.06"
"10","013","00","060","0004","0307","354","140","214","3","357","744","0","47.98","18.82"
"10","013","00","060","0004","0308","815","361","454","3","818","1884","0","43.42","19.16"
"10","013","00","060","0005","0000","476","218","258","3","479","1056","0","45.36","20.64"
"10","013","00","060","0005","0309","476","218","258","3","479","1056","0","45.36","20.64"
"10","013","00","060","0006","0000","409","160","249","1","410","859","0","47.73","18.63"
"10","013","00","060","0006","0314","409","160","249","1","410","859","0","47.73","18.63"
"10","013","00","060","0007","0000","470","162","308","2","472","1045","0","45.17","15.50"
"10","013","00","060","0007","0315","470","162","308","2","472","1045","0","45.17","15.50"
"10","013","00","060","0008","0000","667","236","431","7","674","1475","0","45.69","16.00"
"10","013","00","060","0008","0313","667","236","431","7","674","1475","0","45.69","16.00"
"10","013","00","060","0009","0000","701","295","406","4","705","1639","0","43.01","18.00"
"10","013","00","060","0009","0310","701","295","406","4","705","1639","0","43.01","18.00"
"10","013","00","060","0010","0000","524","162","362","5","529","1144","0","46.24","14.16"
"10","013","00","060","0010","0311","524","162","362","5","529","1144","0","46.24","14.16"
"10","013","00","060","0011","0000","270","74","196","3","273","743","0","36.74","9.96"
"10","013","00","060","0011","0312","270","74","196","3","273","743","0","36.74","9.96"
"10","013","00","060","0012","0000","924","234","690","6","930","2349","0","39.59","9.96"
"10","013","00","060","0012","0320","514","138","376","3","517","1218","0","42.45","11.33"
"10","013","00","060","0012","0321","410","96","314","3","413","1131","0","36.52","8.49"
"10","013","00","060","0013","0000","667","208","459","10","677","1719","0","39.38","12.10"
"10","013","00","060","0013","0316","302","94","208","3","305","813","0","37.52","11.56"
"10","013","00","060","0013","0317","365","114","251","7","372","906","0","41.06","12.58"
"10","013","00","060","0014","0000","482","152","330","8","490","1404","0","34.90","10.83"
"10","013","00","060","0014","0318","482","152","330","8","490","1404","0","34.90","10.83"
"10","013","00","060","0015","0000","398","147","251","7","405","1127","0","35.94","13.04"
"10","013","00","060","0015","0319","398","147","251","7","405","1127","0","35.94","13.04"
"10","013","00","060","0016","0000","304","187","117","2","306","710","0","43.10","26.34"
"10","013","00","060","0016","0322","304","187","117","2","306","710","0","43.10","26.34"
"10","013","00","070","0000","0000","4679","1610","3069","39","4718","9689","10711","48.69","16.62"
"10","013","00","070","0001","0000","1002","342","660","11","1013","2127","0","47.63","16.08"
"10","013","00","070","0001","0323","349","110","239","7","356","748","0","47.59","14.71"
"10","013","00","070","0001","0324","653","232","421","4","657","1379","0","47.64","16.82"
"10","013","00","070","0002","0000","436","161","275","3","439","925","0","47.46","17.41"
"10","013","00","070","0002","0325","436","161","275","3","439","925","0","47.46","17.41"
"10","013","00","070","0003","0000","739","257","482","5","744","1484","0","50.13","17.32"
"10","013","00","070","0003","0326","335","116","219","4","339","699","0","48.50","16.60"
"10","013","00","070","0003","0327","404","141","263","1","405","785","0","51.59","17.96"
"10","013","00","070","0004","0000","1178","401","777","12","1190","2480","0","47.98","16.17"
"10","013","00","070","0004","0328","557","170","387","6","563","1186","0","47.47","14.33"
"10","013","00","070","0004","0329","621","231","390","6","627","1294","0","48.45","17.85"
"10","013","00","070","0005","0000","557","176","381","3","560","1156","0","48.44","15.22"
"10","013","00","070","0005","0330","557","176","381","3","560","1156","0","48.44","15.22"
"10","013","00","070","0006","0000","418","154","264","3","421","846","0","49.76","18.20"
"10","013","00","070","0006","0331","418","154","264","3","421","846","0","49.76","18.20"
"10","013","00","070","0007","0000","349","119","230","2","351","671","0","52.31","17.73"
"10","013","00","070","0007","0332","349","119","230","2","351","671","0","52.31","17.73"
"10","013","00","080","0000","0000","8242","2309","5933","91","8333","19063","21784","43.71","12.11"
"10","013","00","080","0001","0000","598","166","432","5","603","1438","0","41.93","11.54"
"10","013","00","080","0001","0333","598","166","432","5","603","1438","0","41.93","11.54"
"10","013","00","080","0002","0000","588","150","438","4","592","1353","0","43.75","11.09"
"10","013","00","080","0002","0334","588","150","438","4","592","1353","0","43.75","11.09"
"10","013","00","080","0003","0000","787","188","599","12","799","1675","0","47.70","11.22"
"10","013","00","080","0003","0335","787","188","599","12","799","1675","0","47.70","11.22"
"10","013","00","080","0004","0000","511","138","373","9","520","1222","0","42.55","11.29"
"10","013","00","080","0004","0337","511","138","373","9","520","1222","0","42.55","11.29"
"10","013","00","080","0005","0000","473","145","328","5","478","1155","0","41.39","12.55"
"10","013","00","080","0005","0336","473","145","328","5","478","1155","0","41.39","12.55"
"10","013","00","080","0006","0000","610","143","467","4","614","1563","0","39.28","9.15"
"10","013","00","080","0006","0345","610","143","467","4","614","1563","0","39.28","9.15"
"10","013","00","080","0007","0000","803","174","629","17","820","1747","0","46.94","9.96"
"10","013","00","080","0007","0347","803","174","629","17","820","1747","0","46.94","9.96"
"10","013","00","080","0008","0000","541","141","400","4","545","1257","0","43.36","11.22"
"10","013","00","080","0008","0346","541","141","400","4","545","1257","0","43.36","11.22"
"10","013","00","080","0009","0000","619","178","441","6","625","1454","0","42.98","12.24"
"10","013","00","080","0009","0348","619","178","441","6","625","1454","0","42.98","12.24"
"10","013","00","080","0010","0000","2003","635","1368","18","2021","4613","0","43.81","13.77"
"10","013","00","080","0010","0340","319","95","224","1","320","666","0","48.05","14.26"
"10","013","00","080","0010","0341","502","135","367","5","507","1081","0","46.90","12.49"
"10","013","00","080","0010","0342","401","127","274","5","406","1001","0","40.56","12.69"
"10","013","00","080","0010","0343","469","155","314","7","476","1140","0","41.75","13.60"
"10","013","00","080","0010","0344","312","123","189","0","312","725","0","43.03","16.97"
"10","013","00","080","0011","0000","709","251","458","7","716","1586","0","45.15","15.83"
"10","013","00","080","0011","0338","416","131","285","4","420","1004","0","41.83","13.05"
"10","013","00","080","0011","0339","293","120","173","3","296","582","0","50.86","20.62"
"10","013","00","090","0000","0000","9163","3137","6026","115","9278","21985","25657","42.20","14.27"
"10","013","00","090","0001","0000","1307","651","656","13","1320","3156","0","41.83","20.63"
"10","013","00","090","0001","0349","650","444","206","3","653","1637","0","39.89","27.12"
"10","013","00","090","0001","0350","657","207","450","10","667","1519","0","43.91","13.63"
"10","013","00","090","0002","0000","472","165","307","9","481","1106","0","43.49","14.92"
"10","013","00","090","0002","0353","472","165","307","9","481","1106","0","43.49","14.92"
"10","013","00","090","0003","0000","342","101","241","2","344","840","0","40.95","12.02"
"10","013","00","090","0003","0354","342","101","241","2","344","840","0","40.95","12.02"
"10","013","00","090","0004","0000","578","185","393","4","582","1323","0","43.99","13.98"
"10","013","00","090","0004","0355","578","185","393","4","582","1323","0","43.99","13.98"
"10","013","00","090","0005","0000","818","239","579","9","827","1992","0","41.52","12.00"
"10","013","00","090","0005","0356","430","119","311","7","437","946","0","46.19","12.58"
"10","013","00","090","0005","0357","388","120","268","2","390","1046","0","37.28","11.47"
"10","013","00","090","0006","0000","600","177","423","3","603","1418","0","42.52","12.48"
"10","013","00","090","0006","0358","600","177","423","3","603","1418","0","42.52","12.48"
"10","013","00","090","0007","0000","634","163","471","11","645","1522","0","42.38","10.71"
"10","013","00","090","0007","0351","634","163","471","11","645","1522","0","42.38","10.71"
"10","013","00","090","0008","0000","595","157","438","6","601","1564","0","38.43","10.04"
"10","013","00","090","0008","0352","595","157","438","6","601","1564","0","38.43","10.04"
"10","013","00","090","0009","0000","658","166","492","8","666","1502","0","44.34","11.05"
"10","013","00","090","0009","0359","133","37","96","2","135","316","0","42.72","11.71"
"10","013","00","090","0009","0360","525","129","396","6","531","1186","0","44.77","10.88"
"10","013","00","090","0010","0000","987","231","756","15","1002","2297","0","43.62","10.06"
"10","013","00","090","0010","0361","398","87","311","10","408","973","0","41.93","8.94"
"10","013","00","090","0010","0362","589","144","445","5","594","1324","0","44.86","10.88"
"10","013","00","090","0011","0000","844","415","429","11","855","1980","0","43.18","20.96"
"10","013","00","090","0011","0363","628","233","395","9","637","1474","0","43.22","15.81"
"10","013","00","090","0011","0364","216","182","34","2","218","506","0","43.08","35.97"
"10","013","00","090","0012","0000","725","295","430","11","736","1815","0","40.55","16.25"
"10","013","00","090","0012","0365","324","146","178","4","328","813","0","40.34","17.96"
"10","013","00","090","0012","0366","401","149","252","7","408","1002","0","40.72","14.87"
"10","013","00","090","0013","0000","349","131","218","4","353","956","0","36.92","13.70"
"10","013","00","090","0013","0367","349","131","218","4","353","956","0","36.92","13.70"
"10","013","00","090","0014","0000","254","61","193","9","263","514","0","51.17","11.87"
"10","013","00","090","0014","0368","254","61","193","9","263","514","0","51.17","11.87"
"10","013","00","100","0000","0000","7678","3053","4625","115","7793","21921","24795","35.55","13.93"
"10","013","00","100","0001","0000","1079","333","746","19","1098","3077","0","35.68","10.82"
"10","013","00","100","0001","0382","354","115","239","8","362","1000","0","36.20","11.50"
"10","013","00","100","0001","0383","357","119","238","8","365","1079","0","33.83","11.03"
"10","013","00","100","0001","0384","368","99","269","3","371","998","0","37.17","9.92"
"10","013","00","100","0002","0000","900","279","621","14","914","2767","0","33.03","10.08"
"10","013","00","100","0002","0376","309","87","222","7","316","926","0","34.13","9.40"
"10","013","00","100","0002","0377","363","125","238","2","365","1031","0","35.40","12.12"
"10","013","00","100","0002","0378","228","67","161","5","233","810","0","28.77","8.27"
"10","013","00","100","0003","0000","580","269","311","9","589","1800","0","32.72","14.94"
"10","013","00","100","0003","0369","298","133","165","7","305","907","0","33.63","14.66"
"10","013","00","100","0003","0370","282","136","146","2","284","893","0","31.80","15.23"
"10","013","00","100","0004","0000","782","357","425","11","793","2311","0","34.31","15.45"
"10","013","00","100","0004","0371","358","176","182","6","364","1105","0","32.94","15.93"
"10","013","00","100","0004","0372","424","181","243","5","429","1206","0","35.57","15.01"
"10","013","00","100","0005","0000","559","256","303","7","566","1683","0","33.63","15.21"
"10","013","00","100","0005","0373","263","115","148","2","265","718","0","36.91","16.02"
"10","013","00","100","0005","0374","296","141","155","5","301","965","0","31.19","14.61"
"10","013","00","100","0006","0000","355","190","165","1","356","1022","0","34.83","18.59"
"10","013","00","100","0006","0375","355","190","165","1","356","1022","0","34.83","18.59"
"10","013","00","100","0007","0000","604","231","373","14","618","1803","0","34.28","12.81"
"10","013","00","100","0007","0379","301","102","199","7","308","874","0","35.24","11.67"
"10","013","00","100","0007","0380","303","129","174","7","310","929","0","33.37","13.89"
"10","013","00","100","0008","0000","215","60","155","1","216","537","0","40.22","11.17"
"10","013","00","100","0008","0391","215","60","155","1","216","537","0","40.22","11.17"
"10","013","00","100","0009","0000","343","143","200","8","351","908","0","38.66","15.75"
"10","013","00","100","0009","0381","343","143","200","8","351","908","0","38.66","15.75"
"10","013","00","100","0010","0000","638","249","389","9","647","1606","0","40.29","15.50"
"10","013","00","100","0010","0389","334","137","197","6","340","808","0","42.08","16.96"
"10","013","00","100","0010","0390","304","112","192","3","307","798","0","38.47","14.04"
"10","013","00","100","0011","0000","1242","524","718","17","1259","3450","0","36.49","15.19"
"10","013","00","100","0011","0385","386","182","204","4","390","1097","0","35.55","16.59"
"10","013","00","100","0011","0386","427","184","243","9","436","1139","0","38.28","16.15"
"10","013","00","100","0011","0387","429","158","271","4","433","1214","0","35.67","13.01"
"10","013","00","100","0012","0000","381","162","219","5","386","957","0","40.33","16.93"
"10","013","00","100","0012","0388","381","162","219","5","386","957","0","40.33","16.93"
"10","013","00","110","0000","0000","8514","2226","6288","121","8635","21162","23583","40.80","10.52"
"10","013","00","110","0001","0000","961","244","717","8","969","2093","0","46.30","11.66"
"10","013","00","110","0001","0392","428","117","311","3","431","877","0","49.14","13.34"
"10","013","00","110","0001","0393","533","127","406","5","538","1216","0","44.24","10.44"
"10","013","00","110","0002","0000","538","112","426","7","545","1236","0","44.09","9.06"
"10","013","00","110","0002","0394","538","112","426","7","545","1236","0","44.09","9.06"
"10","013","00","110","0003","0000","330","64","266","2","332","707","0","46.96","9.05"
"10","013","00","110","0003","0395","330","64","266","2","332","707","0","46.96","9.05"
"10","013","00","110","0004","0000","238","62","176","7","245","578","0","42.39","10.73"
"10","013","00","110","0004","0396","238","62","176","7","245","578","0","42.39","10.73"
"10","013","00","110","0005","0000","439","124","315","6","445","995","0","44.72","12.46"
"10","013","00","110","0005","0397","439","124","315","6","445","995","0","44.72","12.46"
"10","013","00","110","0006","0000","440","99","341","8","448","1135","0","39.47","8.72"
"10","013","00","110","0006","0398","440","99","341","8","448","1135","0","39.47","8.72"
"10","013","00","110","0007","0000","251","75","176","4","255","592","0","43.07","12.67"
"10","013","00","110","0007","0399","251","75","176","4","255","592","0","43.07","12.67"
"10","013","00","110","0008","0000","310","48","262","5","315","727","0","43.33","6.60"
"10","013","00","110","0008","0400","310","48","262","5","315","727","0","43.33","6.60"
"10","013","00","110","0009","0000","210","67","143","7","217","618","0","35.11","10.84"
"10","013","00","110","0009","0401","210","67","143","7","217","618","0","35.11","10.84"
"10","013","00","110","0010","0000","483","132","351","1","484","1183","0","40.91","11.16"
"10","013","00","110","0010","0402","483","132","351","1","484","1183","0","40.91","11.16"
"10","013","00","110","0011","0000","508","134","374","6","514","1416","0","36.30","9.46"
"10","013","00","110","0011","0403","266","63","203","2","268","731","0","36.66","8.62"
"10","013","00","110","0011","0404","242","71","171","4","246","685","0","35.91","10.36"
"10","013","00","110","0012","0000","658","208","450","8","666","1828","0","36.43","11.38"
"10","013","00","110","0012","0405","339","107","232","4","343","897","0","38.24","11.93"
"10","013","00","110","0012","0406","319","101","218","4","323","931","0","34.69","10.85"
"10","013","00","110","0013","0000","468","139","329","6","474","1231","0","38.51","11.29"
"10","013","00","110","0013","0407","468","139","329","6","474","1231","0","38.51","11.29"
"10","013","00","110","0014","0000","439","124","315","5","444","1041","0","42.65","11.91"
"10","013","00","110","0014","0408","439","124","315","5","444","1041","0","42.65","11.91"
"10","013","00","110","0015","0000","357","114","243","8","365","1085","0","33.64","10.51"
"10","013","00","110","0015","0409","357","114","243","8","365","1085","0","33.64","10.51"
"10","013","00","110","0016","0000","392","81","311","9","401","988","0","40.59","8.20"
"10","013","00","110","0016","0410","392","81","311","9","401","988","0","40.59","8.20"
"10","013","00","110","0017","0000","413","109","304","6","419","1054","0","39.75","10.34"
"10","013","00","110","0017","0411","413","109","304","6","419","1054","0","39.75","10.34"
"10","013","00","110","0018","0000","537","140","397","6","543","1172","0","46.33","11.95"
"10","013","00","110","0018","0412","354","68","286","2","356","698","0","51.00","9.74"
"10","013","00","110","0018","0413","183","72","111","4","187","474","0","39.45","15.19"
"10","013","00","110","0019","0000","542","150","392","12","554","1483","0","37.36","10.11"
"10","013","00","110","0019","0414","253","71","182","4","257","668","0","38.47","10.63"
"10","013","00","110","0019","0415","289","79","210","8","297","815","0","36.44","9.69"
"10","013","00","120","0000","0000","7211","2288","4923","81","7292","17504","20028","41.66","13.07"
"10","013","00","120","0001","0000","508","154","354","4","512","1171","0","43.72","13.15"
"10","013","00","120","0001","0416","508","154","354","4","512","1171","0","43.72","13.15"
"10","013","00","120","0002","0000","313","102","211","1","314","715","0","43.92","14.27"
"10","013","00","120","0002","0417","313","102","211","1","314","715","0","43.92","14.27"
"10","013","00","120","0003","0000","766","245","521","8","774","1663","0","46.54","14.73"
"10","013","00","120","0003","0418","397","122","275","2","399","912","0","43.75","13.38"
"10","013","00","120","0003","0419","369","123","246","6","375","751","0","49.93","16.38"
"10","013","00","120","0004","0000","403","112","291","7","410","885","0","46.33","12.66"
"10","013","00","120","0004","0420","403","112","291","7","410","885","0","46.33","12.66"
"10","013","00","120","0005","0000","272","73","199","4","276","530","0","52.08","13.77"
"10","013","00","120","0005","0421","272","73","199","4","276","530","0","52.08","13.77"
"10","013","00","120","0006","0000","483","187","296","9","492","1083","0","45.43","17.27"
"10","013","00","120","0006","0422","483","187","296","9","492","1083","0","45.43","17.27"
"10","013","00","120","0007","0000","477","167","310","6","483","990","0","48.79","16.87"
"10","013","00","120","0007","0423","477","167","310","6","483","990","0","48.79","16.87"
"10","013","00","120","0008","0000","582","198","384","5","587","1392","0","42.17","14.22"
"10","013","00","120","0008","0424","582","198","384","5","587","1392","0","42.17","14.22"
"10","013","00","120","0009","0000","788","229","559","7","795","1976","0","40.23","11.59"
"10","013","00","120","0009","0427","384","118","266","1","385","986","0","39.05","11.97"
"10","013","00","120","0009","0428","404","111","293","6","410","990","0","41.41","11.21"
"10","013","00","120","0010","0000","564","211","353","7","571","1657","0","34.46","12.73"
"10","013","00","120","0010","0425","289","107","182","5","294","829","0","35.46","12.91"
"10","013","00","120","0010","0426","275","104","171","2","277","828","0","33.45","12.56"
"10","013","00","120","0011","0000","621","148","473","7","628","1673","0","37.54","8.85"
"10","013","00","120","0011","0429","381","88","293","2","383","1043","0","36.72","8.44"
"10","013","00","120","0011","0430","240","60","180","5","245","630","0","38.89","9.52"
"10","013","00","120","0012","0000","528","207","321","4","532","1374","0","38.72","15.07"
"10","013","00","120","0012","0431","528","207","321","4","532","1374","0","38.72","15.07"
"10","013","00","120","0013","0000","480","103","377","6","486","1233","0","39.42","8.35"
"10","013","00","120","0013","0432","480","103","377","6","486","1233","0","39.42","8.35"
"10","013","00","120","0014","0000","426","152","274","6","432","1162","0","37.18","13.08"
"10","013","00","120","0014","0433","193","95","98","1","194","588","0","32.99","16.16"
"10","013","00","120","0014","0434","233","57","176","5","238","574","0","41.46","9.93"
"10","013","00","130","0000","0000","19090","6895","12195","206","19296","46892","52910","41.15","14.70"
"10","013","00","130","0001","0000","1620","641","979","13","1633","3943","0","41.42","16.26"
"10","013","00","130","0001","0435","550","207","343","3","553","1228","0","45.03","16.86"
"10","013","00","130","0001","0436","525","204","321","5","530","1259","0","42.10","16.20"
"10","013","00","130","0001","0437","545","230","315","5","550","1456","0","37.77","15.80"
"10","013","00","130","0002","0000","1286","487","799","10","1296","3127","0","41.45","15.57"
"10","013","00","130","0002","0438","596","214","382","4","600","1454","0","41.27","14.72"
"10","013","00","130","0002","0439","690","273","417","6","696","1673","0","41.60","16.32"
"10","013","00","130","0003","0000","596","211","385","8","604","1261","0","47.90","16.73"
"10","013","00","130","0003","0440","596","211","385","8","604","1261","0","47.90","16.73"
"10","013","00","130","0004","0000","248","83","165","1","249","565","0","44.07","14.69"
"10","013","00","130","0004","0441","248","83","165","1","249","565","0","44.07","14.69"
"10","013","00","130","0005","0000","928","342","586","8","936","2169","0","43.15","15.77"
"10","013","00","130","0005","0442","478","170","308","1","479","1113","0","43.04","15.27"
"10","013","00","130","0005","0443","450","172","278","7","457","1056","0","43.28","16.29"
"10","013","00","130","0006","0000","1133","475","658","12","1145","2795","0","40.97","16.99"
"10","013","00","130","0006","0444","563","201","362","6","569","1415","0","40.21","14.20"
"10","013","00","130","0006","0445","570","274","296","6","576","1380","0","41.74","19.86"
"10","013","00","130","0007","0000","1881","711","1170","12","1893","4356","0","43.46","16.32"
"10","013","00","130","0007","0446","668","261","407","4","672","1391","0","48.31","18.76"
"10","013","00","130","0007","0447","580","199","381","5","585","1453","0","40.26","13.70"
"10","013","00","130","0007","0448","633","251","382","3","636","1512","0","42.06","16.60"
"10","013","00","130","0008","0000","1248","439","809","12","1260","3045","0","41.38","14.42"
"10","013","00","130","0008","0449","559","185","374","1","560","1393","0","40.20","13.28"
"10","013","00","130","0008","0450","689","254","435","11","700","1652","0","42.37","15.38"
"10","013","00","130","0009","0000","766","263","503","3","769","1580","0","48.67","16.65"
"10","013","00","130","0009","0451","343","125","218","3","346","733","0","47.20","17.05"
"10","013","00","130","0009","0452","423","138","285","0","423","847","0","49.94","16.29"
"10","013","00","130","0010","0000","827","228","599","6","833","1847","0","45.10","12.34"
"10","013","00","130","0010","0453","405","106","299","1","406","939","0","43.24","11.29"
"10","013","00","130","0010","0454","422","122","300","5","427","908","0","47.03","13.44"
"10","013","00","130","0011","0000","797","251","546","8","805","1835","0","43.87","13.68"
"10","013","00","130","0011","0455","229","71","158","5","234","537","0","43.58","13.22"
"10","013","00","130","0011","0456","568","180","388","3","571","1298","0","43.99","13.87"
"10","013","00","130","0012","0000","1195","342","853","11","1206","2856","0","42.23","11.97"
"10","013","00","130","0012","0457","582","177","405","6","588","1283","0","45.83","13.80"
"10","013","00","130","0012","0458","613","165","448","5","618","1573","0","39.29","10.49"
"10","013","00","130","0013","0000","480","143","337","6","486","920","0","52.83","15.54"
"10","013","00","130","0013","0459","480","143","337","6","486","920","0","52.83","15.54"
"10","013","00","130","0014","0000","497","153","344","7","504","1079","0","46.71","14.18"
"10","013","00","130","0014","0460","497","153","344","7","504","1079","0","46.71","14.18"
"10","013","00","130","0015","0000","753","236","517","9","762","2282","0","33.39","10.34"
"10","013","00","130","0015","0461","367","110","257","5","372","1082","0","34.38","10.17"
"10","013","00","130","0015","0462","386","126","260","4","390","1200","0","32.50","10.50"
"10","013","00","130","0016","0000","554","124","430","5","559","1517","0","36.85","8.17"
"10","013","00","130","0016","0463","554","124","430","5","559","1517","0","36.85","8.17"
"10","013","00","130","0017","0000","881","406","475","15","896","2397","0","37.38","16.94"
"10","013","00","130","0017","0464","478","209","269","10","488","1200","0","40.67","17.42"
"10","013","00","130","0017","0465","403","197","206","5","408","1197","0","34.09","16.46"
"10","013","00","130","0018","0000","760","417","343","13","773","2350","0","32.89","17.74"
"10","013","00","130","0018","0466","425","227","198","8","433","1325","0","32.68","17.13"
"10","013","00","130","0018","0467","335","190","145","5","340","1025","0","33.17","18.54"
"10","013","00","130","0019","0000","359","136","223","8","367","782","0","46.93","17.39"
"10","013","00","130","0019","0468","359","136","223","8","367","782","0","46.93","17.39"
"10","013","00","130","0020","0000","698","269","429","14","712","1726","0","41.25","15.59"
"10","013","00","130","0020","0469","358","101","257","7","365","878","0","41.57","11.50"
"10","013","00","130","0020","0470","340","168","172","7","347","848","0","40.92","19.81"
"10","013","00","130","0021","0000","844","238","606","10","854","2405","0","35.51","9.90"
"10","013","00","130","0021","0471","436","135","301","2","438","1212","0","36.14","11.14"
"10","013","00","130","0021","0472","408","103","305","8","416","1193","0","34.87","8.63"
"10","013","00","130","0022","0000","410","150","260","9","419","1260","0","33.25","11.90"
"10","013","00","130","0022","0473","410","150","260","9","419","1260","0","33.25","11.90"
"10","013","00","130","0023","0000","329","150","179","6","335","795","0","42.14","18.87"
"10","013","00","130","0023","0474","329","150","179","6","335","795","0","42.14","18.87"
"10","013","00","140","0000","0000","6732","2310","4422","67","6799","14893","16409","45.65","15.51"
"10","013","00","140","0001","0000","663","246","417","2","665","1447","0","45.96","17.00"
"10","013","00","140","0001","0475","663","246","417","2","665","1447","0","45.96","17.00"
"10","013","00","140","0002","0000","409","113","296","5","414","868","0","47.70","13.02"
"10","013","00","140","0002","0476","409","113","296","5","414","868","0","47.70","13.02"
"10","013","00","140","0003","0000","331","114","217","7","338","676","0","50.00","16.86"
"10","013","00","140","0003","0477","331","114","217","7","338","676","0","50.00","16.86"
"10","013","00","140","0004","0000","277","88","189","4","281","577","0","48.70","15.25"
"10","013","00","140","0004","0478","277","88","189","4","281","577","0","48.70","15.25"
"10","013","00","140","0005","0000","573","178","395","4","577","1289","0","44.76","13.81"
"10","013","00","140","0005","0479","573","178","395","4","577","1289","0","44.76","13.81"
"10","013","00","140","0006","0000","474","163","311","3","477","969","0","49.23","16.82"
"10","013","00","140","0006","0480","474","163","311","3","477","969","0","49.23","16.82"
"10","013","00","140","0007","0000","315","114","201","3","318","621","0","51.21","18.36"
"10","013","00","140","0007","0481","315","114","201","3","318","621","0","51.21","18.36"
"10","013","00","140","0008","0000","253","76","177","1","254","459","0","55.34","16.56"
"10","013","00","140","0008","0482","253","76","177","1","254","459","0","55.34","16.56"
"10","013","00","140","0009","0000","1097","393","704","10","1107","2368","0","46.75","16.60"
"10","013","00","140","0009","0483","555","214","341","3","558","1201","0","46.46","17.82"
"10","013","00","140","0009","0484","542","179","363","7","549","1167","0","47.04","15.34"
"10","013","00","140","0010","0000","237","77","160","4","241","477","0","50.52","16.14"
"10","013","00","140","0010","0485","237","77","160","4","241","477","0","50.52","16.14"
"10","013","00","140","0011","0000","353","123","230","0","353","881","0","40.07","13.96"
"10","013","00","140","0011","0486","353","123","230","0","353","881","0","40.07","13.96"
"10","013","00","140","0012","0000","361","124","237","5","366","796","0","45.98","15.58"
"10","013","00","140","0012","0487","361","124","237","5","366","796","0","45.98","15.58"
"10","013","00","140","0013","0000","429","155","274","9","438","1099","0","39.85","14.10"
"10","013","00","140","0013","0488","429","155","274","9","438","1099","0","39.85","14.10"
"10","013","00","140","0014","0000","501","152","349","3","504","1186","0","42.50","12.82"
"10","013","00","140","0014","0489","501","152","349","3","504","1186","0","42.50","12.82"
"10","013","00","140","0015","0000","459","194","265","7","466","1180","0","39.49","16.44"
"10","013","00","140","0015","0490","459","194","265","7","466","1180","0","39.49","16.44"
"10","013","00","150","0000","0000","3373","1326","2047","49","3422","8649","9464","39.57","15.33"
"10","013","00","150","0001","0000","829","376","453","10","839","1959","0","42.83","19.19"
"10","013","00","150","0001","0491","317","143","174","3","320","717","0","44.63","19.94"
"10","013","00","150","0001","0492","373","168","205","7","380","938","0","40.51","17.91"
"10","013","00","150","0001","0493","139","65","74","0","139","304","0","45.72","21.38"
"10","013","00","150","0002","0000","529","209","320","6","535","1030","0","51.94","20.29"
"10","013","00","150","0002","0494","362","139","223","5","367","712","0","51.54","19.52"
"10","013","00","150","0002","0495","167","70","97","1","168","318","0","52.83","22.01"
"10","013","00","150","0003","0000","384","169","215","8","392","860","0","45.58","19.65"
"10","013","00","150","0003","0496","384","169","215","8","392","860","0","45.58","19.65"
"10","013","00","150","0004","0000","339","113","226","5","344","734","0","46.87","15.40"
"10","013","00","150","0004","0497","339","113","226","5","344","734","0","46.87","15.40"
"10","013","00","150","0005","0000","566","233","333","6","572","1713","0","33.39","13.60"
"10","013","00","150","0005","0498","161","47","114","1","162","368","0","44.02","12.77"
"10","013","00","150","0005","0499","217","105","112","4","221","665","0","33.23","15.79"
"10","013","00","150","0005","0500","188","81","107","1","189","680","0","27.79","11.91"
"10","013","00","150","0006","0000","359","129","230","9","368","1100","0","33.45","11.73"
"10","013","00","150","0006","0502","166","60","106","4","170","524","0","32.44","11.45"
"10","013","00","150","0006","0503","193","69","124","5","198","576","0","34.38","11.98"
"10","013","00","150","0007","0000","367","97","270","5","372","1253","0","29.69","7.74"
"10","013","00","150","0007","0501","367","97","270","5","372","1253","0","29.69","7.74"
"10","013","00","160","0000","0000","7951","2898","5053","89","8040","20786","23466","38.68","13.94"
"10","013","00","160","0001","0000","461","219","242","5","466","1196","0","38.96","18.31"
"10","013","00","160","0001","0504","461","219","242","5","466","1196","0","38.96","18.31"
"10","013","00","160","0002","0000","323","182","141","4","327","865","0","37.80","21.04"
"10","013","00","160","0002","0505","323","182","141","4","327","865","0","37.80","21.04"
"10","013","00","160","0003","0000","351","113","238","5","356","906","0","39.29","12.47"
"10","013","00","160","0003","0506","351","113","238","5","356","906","0","39.29","12.47"
"10","013","00","160","0004","0000","252","74","178","1","253","573","0","44.15","12.91"
"10","013","00","160","0004","0507","252","74","178","1","253","573","0","44.15","12.91"
"10","013","00","160","0005","0000","616","204","412","4","620","1578","0","39.29","12.93"
"10","013","00","160","0005","0508","315","104","211","2","317","834","0","38.01","12.47"
"10","013","00","160","0005","0509","301","100","201","2","303","744","0","40.73","13.44"
"10","013","00","160","0006","0000","1535","455","1080","15","1550","4151","0","37.34","10.96"
"10","013","00","160","0006","0510","341","103","238","1","342","1005","0","34.03","10.25"
"10","013","00","160","0006","0511","397","112","285","6","403","1033","0","39.01","10.84"
"10","013","00","160","0006","0512","399","119","280","7","406","1079","0","37.63","11.03"
"10","013","00","160","0006","0513","398","121","277","1","399","1034","0","38.59","11.70"
"10","013","00","160","0007","0000","799","268","531","10","809","1866","0","43.35","14.36"
"10","013","00","160","0007","0514","391","123","268","4","395","921","0","42.89","13.36"
"10","013","00","160","0007","0515","408","145","263","6","414","945","0","43.81","15.34"
"10","013","00","160","0008","0000","651","249","402","3","654","1416","0","46.19","17.58"
"10","013","00","160","0008","0516","333","122","211","1","334","694","0","48.13","17.58"
"10","013","00","160","0008","0517","318","127","191","2","320","722","0","44.32","17.59"
"10","013","00","160","0009","0000","829","310","519","7","836","2027","0","41.24","15.29"
"10","013","00","160","0009","0518","399","140","259","5","404","987","0","40.93","14.18"
"10","013","00","160","0009","0519","430","170","260","2","432","1040","0","41.54","16.35"
"10","013","00","160","0010","0000","251","60","191","2","253","695","0","36.40","8.63"
"10","013","00","160","0010","0520","251","60","191","2","253","695","0","36.40","8.63"
"10","013","00","160","0011","0000","235","89","146","2","237","874","0","27.12","10.18"
"10","013","00","160","0011","0521","235","89","146","2","237","874","0","27.12","10.18"
"10","013","00","160","0012","0000","286","126","160","6","292","927","0","31.50","13.59"
"10","013","00","160","0012","0526","286","126","160","6","292","927","0","31.50","13.59"
"10","013","00","160","0013","0000","119","56","63","3","122","428","0","28.50","13.08"
"10","013","00","160","0013","0527","119","56","63","3","122","428","0","28.50","13.08"
"10","013","00","160","0014","0000","1011","420","591","19","1030","2680","0","38.43","15.67"
"10","013","00","160","0014","0522","366","154","212","8","374","963","0","38.84","15.99"
"10","013","00","160","0014","0523","294","128","166","6","300","792","0","37.88","16.16"
"10","013","00","160","0014","0524","351","138","213","5","356","925","0","38.49","14.92"
"10","013","00","160","0015","0000","232","73","159","3","235","604","0","38.91","12.09"
"10","013","00","160","0015","0525","232","73","159","3","235","604","0","38.91","12.09"
"10","013","00","170","0000","0000","11626","3305","8321","140","11766","29974","33639","39.25","11.03"
"10","013","00","170","0001","0000","670","204","466","8","678","1629","0","41.62","12.52"
"10","013","00","170","0001","0528","332","132","200","4","336","809","0","41.53","16.32"
"10","013","00","170","0001","0529","338","72","266","4","342","820","0","41.71","8.78"
"10","013","00","170","0002","0000","913","270","643","6","919","2479","0","37.07","10.89"
"10","013","00","170","0002","0530","445","141","304","3","448","1212","0","36.96","11.63"
"10","013","00","170","0002","0531","468","129","339","3","471","1267","0","37.17","10.18"
"10","013","00","170","0003","0000","818","220","598","10","828","2135","0","38.78","10.30"
"10","013","00","170","0003","0532","381","97","284","5","386","1052","0","36.69","9.22"
"10","013","00","170","0003","0533","437","123","314","5","442","1083","0","40.81","11.36"
"10","013","00","170","0004","0000","307","114","193","1","308","807","0","38.17","14.13"
"10","013","00","170","0004","0534","307","114","193","1","308","807","0","38.17","14.13"
"10","013","00","170","0005","0000","357","118","239","6","363","820","0","44.27","14.39"
"10","013","00","170","0005","0535","357","118","239","6","363","820","0","44.27","14.39"
"10","013","00","170","0006","0000","823","305","518","16","839","2294","0","36.57","13.30"
"10","013","00","170","0006","0536","418","161","257","8","426","1185","0","35.95","13.59"
"10","013","00","170","0006","0537","405","144","261","8","413","1109","0","37.24","12.98"
"10","013","00","170","0007","0000","880","287","593","9","889","2190","0","40.59","13.11"
"10","013","00","170","0007","0538","423","151","272","3","426","1074","0","39.66","14.06"
"10","013","00","170","0007","0539","457","136","321","6","463","1116","0","41.49","12.19"
"10","013","00","170","0008","0000","500","135","365","9","509","1194","0","42.63","11.31"
"10","013","00","170","0008","0542","500","135","365","9","509","1194","0","42.63","11.31"
"10","013","00","170","0009","0000","905","241","664","3","908","2092","0","43.40","11.52"
"10","013","00","170","0009","0543","465","103","362","1","466","1058","0","44.05","9.74"
"10","013","00","170","0009","0544","440","138","302","2","442","1034","0","42.75","13.35"
"10","013","00","170","0010","0000","645","123","522","7","652","1553","0","41.98","7.92"
"10","013","00","170","0010","0545","330","58","272","2","332","843","0","39.38","6.88"
"10","013","00","170","0010","0546","315","65","250","5","320","710","0","45.07","9.15"
"10","013","00","170","0011","0000","568","137","431","8","576","1368","0","42.11","10.01"
"10","013","00","170","0011","0547","568","137","431","8","576","1368","0","42.11","10.01"
"10","013","00","170","0012","0000","797","246","551","10","807","2061","0","39.16","11.94"
"10","013","00","170","0012","0540","377","143","234","4","381","994","0","38.33","14.39"
"10","013","00","170","0012","0541","420","103","317","6","426","1067","0","39.93","9.65"
"10","013","00","170","0013","0000","1058","338","720","12","1070","2733","0","39.15","12.37"
"10","013","00","170","0013","0548","349","88","261","5","354","856","0","41.36","10.28"
"10","013","00","170","0013","0549","368","97","271","4","372","935","0","39.79","10.37"
"10","013","00","170","0013","0550","341","153","188","3","344","942","0","36.52","16.24"
"10","013","00","170","0014","0000","1610","408","1202","22","1632","4335","0","37.65","9.41"
"10","013","00","170","0014","0551","482","109","373","3","485","1398","0","34.69","7.80"
"10","013","00","170","0014","0552","670","171","499","9","679","1695","0","40.06","10.09"
"10","013","00","170","0014","0553","458","128","330","10","468","1242","0","37.68","10.31"
"10","013","00","170","0015","0000","775","159","616","13","788","2284","0","34.50","6.96"
"10","013","00","170","0015","0554","389","84","305","5","394","1080","0","36.48","7.78"
"10","013","00","170","0015","0555","386","75","311","8","394","1204","0","32.72","6.23"
"10","013","00","180","0000","0000","4685","1544","3141","54","4739","11939","15223","39.69","12.93"
"10","013","00","180","0001","0000","842","301","541","10","852","2220","0","38.38","13.56"
"10","013","00","180","0001","0556","456","151","305","4","460","1203","0","38.24","12.55"
"10","013","00","180","0001","0557","386","150","236","6","392","1017","0","38.54","14.75"
"10","013","00","180","0002","0000","796","303","493","6","802","1996","0","40.18","15.18"
"10","013","00","180","0002","0558","298","128","170","3","301","778","0","38.69","16.45"
"10","013","00","180","0002","0559","498","175","323","3","501","1218","0","41.13","14.37"
"10","013","00","180","0003","0000","492","173","319","5","497","1200","0","41.42","14.42"
"10","013","00","180","0003","0561","492","173","319","5","497","1200","0","41.42","14.42"
"10","013","00","180","0004","0000","506","150","356","7","513","1272","0","40.33","11.79"
"10","013","00","180","0004","0560","506","150","356","7","513","1272","0","40.33","11.79"
"10","013","00","180","0005","0000","368","117","251","5","373","1046","0","35.66","11.19"
"10","013","00","180","0005","0562","368","117","251","5","373","1046","0","35.66","11.19"
"10","013","00","180","0006","0000","602","187","415","13","615","1466","0","41.95","12.76"
"10","013","00","180","0006","0563","308","103","205","5","313","758","0","41.29","13.59"
"10","013","00","180","0006","0564","294","84","210","8","302","708","0","42.66","11.86"
"10","013","00","180","0007","0000","355","114","241","3","358","905","0","39.56","12.60"
"10","013","00","180","0007","0565","355","114","241","3","358","905","0","39.56","12.60"
"10","013","00","180","0008","0000","724","199","525","5","729","1834","0","39.75","10.85"
"10","013","00","180","0008","0566","325","90","235","3","328","874","0","37.53","10.30"
"10","013","00","180","0008","0567","399","109","290","2","401","960","0","41.77","11.35"
"10","013","00","190","0000","0000","6265","2052","4213","92","6357","15160","17145","41.93","13.54"
"10","013","00","190","0001","0000","624","197","427","5","629","1392","0","45.19","14.15"
"10","013","00","190","0001","0568","296","96","200","3","299","657","0","45.51","14.61"
"10","013","00","190","0001","0569","328","101","227","2","330","735","0","44.90","13.74"
"10","013","00","190","0002","0000","623","192","431","6","629","1509","0","41.68","12.72"
"10","013","00","190","0002","0570","356","102","254","4","360","856","0","42.06","11.92"
"10","013","00","190","0002","0571","267","90","177","2","269","653","0","41.19","13.78"
"10","013","00","190","0003","0000","691","218","473","9","700","1603","0","43.67","13.60"
"10","013","00","190","0003","0576","363","114","249","4","367","770","0","47.66","14.81"
"10","013","00","190","0003","0577","328","104","224","5","333","833","0","39.98","12.48"
"10","013","00","190","0004","0000","322","125","197","4","326","690","0","47.25","18.12"
"10","013","00","190","0004","0575","322","125","197","4","326","690","0","47.25","18.12"
"10","013","00","190","0005","0000","1372","438","934","18","1390","3098","0","44.87","14.14"
"10","013","00","190","0005","0572","478","147","331","7","485","1015","0","47.78","14.48"
"10","013","00","190","0005","0573","483","151","332","8","491","1126","0","43.61","13.41"
"10","013","00","190","0005","0574","411","140","271","3","414","957","0","43.26","14.63"
"10","013","00","190","0006","0000","641","247","394","13","654","1761","0","37.14","14.03"
"10","013","00","190","0006","0580","292","98","194","2","294","762","0","38.58","12.86"
"10","013","00","190","0006","0581","349","149","200","11","360","999","0","36.04","14.91"
"10","013","00","190","0007","0000","425","140","285","13","438","1241","0","35.29","11.28"
"10","013","00","190","0007","0579","425","140","285","13","438","1241","0","35.29","11.28"
"10","013","00","190","0008","0000","351","112","239","4","355","895","0","39.66","12.51"
"10","013","00","190","0008","0578","351","112","239","4","355","895","0","39.66","12.51"
"10","013","00","190","0009","0000","754","226","528","11","765","1885","0","40.58","11.99"
"10","013","00","190","0009","0582","478","159","319","8","486","1120","0","43.39","14.20"
"10","013","00","190","0009","0583","276","67","209","3","279","765","0","36.47","8.76"
"10","013","00","190","0010","0000","462","157","305","9","471","1086","0","43.37","14.46"
"10","013","00","190","0010","0584","462","157","305","9","471","1086","0","43.37","14.46"
"10","013","00","200","0000","0000","3880","1303","2577","42","3922","9254","10249","42.38","14.08"
"10","013","00","200","0001","0000","691","239","452","4","695","1652","0","42.07","14.47"
"10","013","00","200","0001","0585","352","128","224","3","355","844","0","42.06","15.17"
"10","013","00","200","0001","0586","339","111","228","1","340","808","0","42.08","13.74"
"10","013","00","200","0002","0000","396","140","256","3","399","908","0","43.94","15.42"
"10","013","00","200","0002","0587","396","140","256","3","399","908","0","43.94","15.42"
"10","013","00","200","0003","0000","219","85","134","4","223","487","0","45.79","17.45"
"10","013","00","200","0003","0590","219","85","134","4","223","487","0","45.79","17.45"
"10","013","00","200","0004","0000","309","175","134","2","311","673","0","46.21","26.00"
"10","013","00","200","0004","0591","309","175","134","2","311","673","0","46.21","26.00"
"10","013","00","200","0005","0000","363","128","235","6","369","1011","0","36.50","12.66"
"10","013","00","200","0005","0588","363","128","235","6","369","1011","0","36.50","12.66"
"10","013","00","200","0006","0000","367","133","234","1","368","965","0","38.13","13.78"
"10","013","00","200","0006","0589","367","133","234","1","368","965","0","38.13","13.78"
"10","013","00","200","0007","0000","456","175","281","4","460","1028","0","44.75","17.02"
"10","013","00","200","0007","0592","456","175","281","4","460","1028","0","44.75","17.02"
"10","013","00","200","0008","0000","425","70","355","6","431","1050","0","41.05","6.67"
"10","013","00","200","0008","0593","425","70","355","6","431","1050","0","41.05","6.67"
"10","013","00","200","0009","0000","419","94","325","7","426","965","0","44.15","9.74"
"10","013","00","200","0009","0594","419","94","325","7","426","965","0","44.15","9.74"
"10","013","00","200","0010","0000","235","64","171","5","240","515","0","46.60","12.43"
"10","013","00","200","0010","0595","235","64","171","5","240","515","0","46.60","12.43"
"10","013","00","210","0000","0000","6422","2024","4398","75","6497","16509","18414","39.35","12.26"
"10","013","00","210","0001","0000","586","205","381","4","590","1467","0","40.22","13.97"
"10","013","00","210","0001","0596","586","205","381","4","590","1467","0","40.22","13.97"
"10","013","00","210","0002","0000","542","191","351","6","548","1302","0","42.09","14.67"
"10","013","00","210","0002","0597","542","191","351","6","548","1302","0","42.09","14.67"
"10","013","00","210","0003","0000","343","93","250","2","345","733","0","47.07","12.69"
"10","013","00","210","0003","0598","343","93","250","2","345","733","0","47.07","12.69"
"10","013","00","210","0004","0000","692","241","451","4","696","1793","0","38.82","13.44"
"10","013","00","210","0004","0599","351","113","238","2","353","926","0","38.12","12.20"
"10","013","00","210","0004","0600","341","128","213","2","343","867","0","39.56","14.76"
"10","013","00","210","0005","0000","801","208","593","8","809","1922","0","42.09","10.82"
"10","013","00","210","0005","0601","381","105","276","5","386","928","0","41.59","11.31"
"10","013","00","210","0005","0602","420","103","317","3","423","994","0","42.56","10.36"
"10","013","00","210","0006","0000","794","202","592","12","806","2056","0","39.20","9.82"
"10","013","00","210","0006","0603","343","82","261","4","347","839","0","41.36","9.77"
"10","013","00","210","0006","0604","451","120","331","8","459","1217","0","37.72","9.86"
"10","013","00","210","0007","0000","399","119","280","11","410","936","0","43.80","12.71"
"10","013","00","210","0007","0605","399","119","280","11","410","936","0","43.80","12.71"
"10","013","00","210","0008","0000","273","94","179","4","277","674","0","41.10","13.95"
"10","013","00","210","0008","0606","273","94","179","4","277","674","0","41.10","13.95"
"10","013","00","210","0009","0000","447","113","334","7","454","1138","0","39.89","9.93"
"10","013","00","210","0009","0607","447","113","334","7","454","1138","0","39.89","9.93"
"10","013","00","210","0010","0000","416","105","311","3","419","1061","0","39.49","9.90"
"10","013","00","210","0010","0608","416","105","311","3","419","1061","0","39.49","9.90"
"10","013","00","210","0011","0000","356","121","235","4","360","1072","0","33.58","11.29"
"10","013","00","210","0011","0609","356","121","235","4","360","1072","0","33.58","11.29"
"10","013","00","210","0012","0000","773","332","441","10","783","2355","0","33.25","14.10"
"10","013","00","210","0012","0610","353","154","199","7","360","1229","0","29.29","12.53"
"10","013","00","210","0012","0611","420","178","242","3","423","1126","0","37.57","15.81"
"10","013","00","220","0000","0000","2108","1165","943","16","2124","10595","12095","20.05","11.00"
"10","013","00","220","0001","0000","501","241","260","3","504","2066","0","24.39","11.67"
"10","013","00","220","0001","0612","264","117","147","1","265","1093","0","24.25","10.70"
"10","013","00","220","0001","0613","237","124","113","2","239","973","0","24.56","12.74"
"10","013","00","220","0002","0000","270","138","132","4","274","1247","0","21.97","11.07"
"10","013","00","220","0002","0614","270","138","132","4","274","1247","0","21.97","11.07"
"10","013","00","220","0003","0000","226","152","74","0","226","975","0","23.18","15.59"
"10","013","00","220","0003","0615","226","152","74","0","226","975","0","23.18","15.59"
"10","013","00","220","0004","0000","292","179","113","1","293","1617","0","18.12","11.07"
"10","013","00","220","0004","0616","292","179","113","1","293","1617","0","18.12","11.07"
"10","013","00","220","0005","0000","193","102","91","1","194","1117","0","17.37","9.13"
"10","013","00","220","0005","0617","193","102","91","1","194","1117","0","17.37","9.13"
"10","013","00","220","0006","0000","198","116","82","0","198","1101","0","17.98","10.54"
"10","013","00","220","0006","0618","198","116","82","0","198","1101","0","17.98","10.54"
"10","013","00","220","0007","0000","258","150","108","4","262","1622","0","16.15","9.25"
"10","013","00","220","0007","0619","258","150","108","4","262","1622","0","16.15","9.25"
"10","013","00","220","0008","0000","170","87","83","3","173","850","0","20.35","10.24"
"10","013","00","220","0008","0620","170","87","83","3","173","850","0","20.35","10.24"
"10","013","00","230","0000","0000","2362","950","1412","39","2401","7290","8221","32.94","13.03"
"10","013","00","230","0001","0000","488","208","280","4","492","1315","0","37.41","15.82"
"10","013","00","230","0001","0623","176","68","108","2","178","470","0","37.87","14.47"
"10","013","00","230","0001","0624","312","140","172","2","314","845","0","37.16","16.57"
"10","013","00","230","0002","0000","226","62","164","1","227","534","0","42.51","11.61"
"10","013","00","230","0002","0625","226","62","164","1","227","534","0","42.51","11.61"
"10","013","00","230","0003","0000","157","63","94","1","158","610","0","25.90","10.33"
"10","013","00","230","0003","0622","157","63","94","1","158","610","0","25.90","10.33"
"10","013","00","230","0004","0000","202","87","115","6","208","717","0","29.01","12.13"
"10","013","00","230","0004","0621","202","87","115","6","208","717","0","29.01","12.13"
"10","013","00","230","0005","0000","111","43","68","0","111","370","0","30.00","11.62"
"10","013","00","230","0005","0626","111","43","68","0","111","370","0","30.00","11.62"
"10","013","00","230","0006","0000","269","111","158","4","273","837","0","32.62","13.26"
"10","013","00","230","0006","0627","269","111","158","4","273","837","0","32.62","13.26"
"10","013","00","230","0007","0000","349","147","202","11","360","1197","0","30.08","12.28"
"10","013","00","230","0007","0628","171","66","105","6","177","585","0","30.26","11.28"
"10","013","00","230","0007","0629","178","81","97","5","183","612","0","29.90","13.24"
"10","013","00","230","0008","0000","145","32","113","3","148","418","0","35.41","7.66"
"10","013","00","230","0008","0630","145","32","113","3","148","418","0","35.41","7.66"
"10","013","00","230","0009","0000","111","57","54","1","112","412","0","27.18","13.83"
"10","013","00","230","0009","0631","111","57","54","1","112","412","0","27.18","13.83"
"10","013","00","230","0010","0000","150","74","76","4","154","481","0","32.02","15.38"
"10","013","00","230","0010","0632","150","74","76","4","154","481","0","32.02","15.38"
"10","013","00","230","0011","0000","154","66","88","4","158","399","0","39.60","16.54"
"10","013","00","230","0011","0633","154","66","88","4","158","399","0","39.60","16.54"
"10","013","00","240","0000","0000","1907","832","1075","17","1924","6686","7397","28.78","12.44"
"10","013","00","240","0001","0000","423","205","218","4","427","1429","0","29.88","14.35"
"10","013","00","240","0001","0634","423","205","218","4","427","1429","0","29.88","14.35"
"10","013","00","240","0002","0000","119","58","61","1","120","392","0","30.61","14.80"
"10","013","00","240","0002","0635","119","58","61","1","120","392","0","30.61","14.80"
"10","013","00","240","0003","0000","371","168","203","3","374","1208","0","30.96","13.91"
"10","013","00","240","0003","0637","371","168","203","3","374","1208","0","30.96","13.91"
"10","013","00","240","0004","0000","392","130","262","3","395","1223","0","32.30","10.63"
"10","013","00","240","0004","0638","392","130","262","3","395","1223","0","32.30","10.63"
"10","013","00","240","0005","0000","147","48","99","1","148","526","0","28.14","9.13"
"10","013","00","240","0005","0636","147","48","99","1","148","526","0","28.14","9.13"
"10","013","00","240","0006","0000","267","141","126","5","272","1255","0","21.67","11.24"
"10","013","00","240","0006","0639","267","141","126","5","272","1255","0","21.67","11.24"
"10","013","00","240","0007","0000","90","39","51","0","90","348","0","25.86","11.21"
"10","013","00","240","0007","0640","90","39","51","0","90","348","0","25.86","11.21"
"10","013","00","240","0008","0000","98","43","55","0","98","305","0","32.13","14.10"
"10","013","00","240","0008","0641","98","43","55","0","98","305","0","32.13","14.10"
"10","013","00","250","0000","0000","1583","550","1033","25","1608","4637","5145","34.68","11.86"
"10","013","00","250","0001","0000","352","176","176","9","361","966","0","37.37","18.22"
"10","013","00","250","0001","0642","204","101","103","6","210","548","0","38.32","18.43"
"10","013","00","250","0001","0643","148","75","73","3","151","418","0","36.12","17.94"
"10","013","00","250","0002","0000","697","224","473","5","702","1872","0","37.50","11.97"
"10","013","00","250","0002","0644","336","86","250","2","338","901","0","37.51","9.54"
"10","013","00","250","0002","0645","361","138","223","3","364","971","0","37.49","14.21"
"10","013","00","250","0003","0000","289","73","216","5","294","962","0","30.56","7.59"
"10","013","00","250","0003","0646","289","73","216","5","294","962","0","30.56","7.59"
"10","013","00","250","0004","0000","245","77","168","6","251","837","0","29.99","9.20"
"10","013","00","250","0004","0647","245","77","168","6","251","837","0","29.99","9.20"
"10","013","00","260","0000","0000","1931","1471","460","42","1973","6401","7691","30.82","22.98"
"10","013","00","260","0001","0000","550","434","116","16","566","1460","0","38.77","29.73"
"10","013","00","260","0001","0651","550","434","116","16","566","1460","0","38.77","29.73"
"10","013","00","260","0002","0000","95","57","38","1","96","341","0","28.15","16.72"
"10","013","00","260","0002","0650","95","57","38","1","96","341","0","28.15","16.72"
"10","013","00","260","0003","0000","87","56","31","1","88","566","0","15.55","9.89"
"10","013","00","260","0003","0649","87","56","31","1","88","566","0","15.55","9.89"
"10","013","00","260","0004","0000","170","141","29","8","178","639","0","27.86","22.07"
"10","013","00","260","0004","0648","170","141","29","8","178","639","0","27.86","22.07"
"10","013","00","260","0005","0000","217","160","57","4","221","725","0","30.48","22.07"
"10","013","00","260","0005","0652","217","160","57","4","221","725","0","30.48","22.07"
"10","013","00","260","0006","0000","190","141","49","3","193","550","0","35.09","25.64"
"10","013","00","260","0006","0653","190","141","49","3","193","550","0","35.09","25.64"
"10","013","00","260","0007","0000","101","68","33","0","101","341","0","29.62","19.94"
"10","013","00","260","0007","0654","101","68","33","0","101","341","0","29.62","19.94"
"10","013","00","260","0008","0000","156","112","44","2","158","468","0","33.76","23.93"
"10","013","00","260","0008","0655","156","112","44","2","158","468","0","33.76","23.93"
"10","013","00","260","0009","0000","199","168","31","5","204","694","0","29.39","24.21"
"10","013","00","260","0009","0656","199","168","31","5","204","694","0","29.39","24.21"
"10","013","00","260","0010","0000","166","134","32","2","168","617","0","27.23","21.72"
"10","013","00","260","0010","0657","166","134","32","2","168","617","0","27.23","21.72"
"10","013","00","270","0000","0000","926","665","261","10","936","2842","3230","32.93","23.40"
"10","013","00","270","0001","0000","348","238","110","3","351","1089","0","32.23","21.85"
"10","013","00","270","0001","0658","114","75","39","1","115","314","0","36.62","23.89"
"10","013","00","270","0001","0659","179","135","44","2","181","614","0","29.48","21.99"
"10","013","00","270","0001","0660","55","28","27","0","55","161","0","34.16","17.39"
"10","013","00","270","0002","0000","106","89","17","1","107","297","0","36.03","29.97"
"10","013","00","270","0002","0662","106","89","17","1","107","297","0","36.03","29.97"
"10","013","00","270","0003","0000","72","54","18","0","72","183","0","39.34","29.51"
"10","013","00","270","0003","0661","72","54","18","0","72","183","0","39.34","29.51"
"10","013","00","270","0004","0000","67","45","22","1","68","441","0","15.42","10.20"
"10","013","00","270","0004","0665","67","45","22","1","68","441","0","15.42","10.20"
"10","013","00","270","0005","0000","150","127","23","1","151","356","0","42.42","35.67"
"10","013","00","270","0005","0664","150","127","23","1","151","356","0","42.42","35.67"
"10","013","00","270","0006","0000","183","112","71","4","187","476","0","39.29","23.53"
"10","013","00","270","0006","0663","183","112","71","4","187","476","0","39.29","23.53"
"10","013","00","280","0000","0000","1977","1542","435","15","1992","5610","6706","35.51","27.49"
"10","013","00","280","0001","0000","161","118","43","1","162","443","0","36.57","26.64"
"10","013","00","280","0001","0666","161","118","43","1","162","443","0","36.57","26.64"
"10","013","00","280","0002","0000","311","243","68","2","313","771","0","40.60","31.52"
"10","013","00","280","0002","0667","311","243","68","2","313","771","0","40.60","31.52"
"10","013","00","280","0003","0000","282","224","58","1","283","1041","0","27.19","21.52"
"10","013","00","280","0003","0671","282","224","58","1","283","1041","0","27.19","21.52"
"10","013","00","280","0004","0000","306","206","100","4","310","887","0","34.95","23.22"
"10","013","00","280","0004","0672","306","206","100","4","310","887","0","34.95","23.22"
"10","013","00","280","0005","0000","135","112","23","0","135","419","0","32.22","26.73"
"10","013","00","280","0005","0673","135","112","23","0","135","419","0","32.22","26.73"
"10","013","00","280","0006","0000","782","639","143","7","789","2049","0","38.51","31.19"
"10","013","00","280","0006","0668","239","187","52","3","242","655","0","36.95","28.55"
"10","013","00","280","0006","0669","291","250","41","0","291","711","0","40.93","35.16"
"10","013","00","280","0006","0670","252","202","50","4","256","683","0","37.48","29.58"
"10","013","00","290","0000","0000","1450","1150","300","17","1467","4332","5365","33.86","26.55"
"10","013","00","290","0001","0000","324","271","53","3","327","844","0","38.74","32.11"
"10","013","00","290","0001","0674","232","194","38","2","234","632","0","37.03","30.70"
"10","013","00","290","0001","0675","92","77","15","1","93","212","0","43.87","36.32"
"10","013","00","290","0002","0000","336","254","82","7","343","950","0","36.11","26.74"
"10","013","00","290","0002","0676","336","254","82","7","343","950","0","36.11","26.74"
"10","013","00","290","0003","0000","211","124","87","2","213","610","0","34.92","20.33"
"10","013","00","290","0003","0677","211","124","87","2","213","610","0","34.92","20.33"
"10","013","00","290","0004","0000","118","99","19","0","118","408","0","28.92","24.26"
"10","013","00","290","0004","0679","118","99","19","0","118","408","0","28.92","24.26"
"10","013","00","290","0005","0000","206","176","30","5","211","772","0","27.33","22.80"
"10","013","00","290","0005","0680","206","176","30","5","211","772","0","27.33","22.80"
"10","013","00","290","0006","0000","255","226","29","0","255","748","0","34.09","30.21"
"10","013","00","290","0006","0678","255","226","29","0","255","748","0","34.09","30.21"
"10","013","00","300","0000","0000","2175","1826","349","18","2193","6217","7400","35.27","29.37"
"10","013","00","300","0001","0000","257","215","42","1","258","909","0","28.38","23.65"
"10","013","00","300","0001","0681","257","215","42","1","258","909","0","28.38","23.65"
"10","013","00","300","0002","0000","196","151","45","1","197","586","0","33.62","25.77"
"10","013","00","300","0002","0682","132","104","28","1","133","355","0","37.46","29.30"
"10","013","00","300","0002","0683","64","47","17","0","64","231","0","27.71","20.35"
"10","013","00","300","0003","0000","262","226","36","0","262","709","0","36.95","31.88"
"10","013","00","300","0003","0684","162","141","21","0","162","434","0","37.33","32.49"
"10","013","00","300","0003","0685","100","85","15","0","100","275","0","36.36","30.91"
"10","013","00","300","0004","0000","404","340","64","5","409","1112","0","36.78","30.58"
"10","013","00","300","0004","0686","404","340","64","5","409","1112","0","36.78","30.58"
"10","013","00","300","0005","0000","295","239","56","4","299","840","0","35.60","28.45"
"10","013","00","300","0005","0687","295","239","56","4","299","840","0","35.60","28.45"
"10","013","00","300","0006","0000","350","310","40","0","350","864","0","40.51","35.88"
"10","013","00","300","0006","0688","350","310","40","0","350","864","0","40.51","35.88"
"10","013","00","300","0007","0000","411","345","66","7","418","1197","0","34.92","28.82"
"10","013","00","300","0007","0689","198","170","28","4","202","574","0","35.19","29.62"
"10","013","00","300","0007","0690","213","175","38","3","216","623","0","34.67","28.09"
"10","013","00","310","0000","0000","1006","756","250","33","1039","3975","4912","26.14","19.02"
"10","013","00","310","0001","0000","190","151","39","3","193","923","0","20.91","16.36"
"10","013","00","310","0001","0691","190","151","39","3","193","923","0","20.91","16.36"
"10","013","00","310","0002","0000","188","130","58","1","189","685","0","27.59","18.98"
"10","013","00","310","0002","0692","188","130","58","1","189","685","0","27.59","18.98"
"10","013","00","310","0003","0000","56","38","18","5","61","311","0","19.61","12.22"
"10","013","00","310","0003","0693","56","38","18","5","61","311","0","19.61","12.22"
"10","013","00","310","0004","0000","282","222","60","5","287","940","0","30.53","23.62"
"10","013","00","310","0004","0694","282","222","60","5","287","940","0","30.53","23.62"
"10","013","00","310","0005","0000","166","121","45","11","177","647","0","27.36","18.70"
"10","013","00","310","0005","0695","166","121","45","11","177","647","0","27.36","18.70"
"10","013","00","310","0006","0000","124","94","30","8","132","469","0","28.14","20.04"
"10","013","00","310","0006","0696","124","94","30","8","132","469","0","28.14","20.04"
"10","013","00","320","0000","0000","1291","1062","229","17","1308","4092","4805","31.96","25.95"
"10","013","00","320","0001","0000","224","173","51","2","226","702","0","32.19","24.64"
"10","013","00","320","0001","0697","224","173","51","2","226","702","0","32.19","24.64"
"10","013","00","320","0002","0000","204","170","34","3","207","759","0","27.27","22.40"
"10","013","00","320","0002","0698","204","170","34","3","207","759","0","27.27","22.40"
"10","013","00","320","0003","0000","212","184","28","5","217","626","0","34.66","29.39"
"10","013","00","320","0003","0699","212","184","28","5","217","626","0","34.66","29.39"
"10","013","00","320","0004","0000","73","61","12","0","73","229","0","31.88","26.64"
"10","013","00","320","0004","0700","73","61","12","0","73","229","0","31.88","26.64"
"10","013","00","320","0005","0000","98","74","24","0","98","293","0","33.45","25.26"
"10","013","00","320","0005","0701","98","74","24","0","98","293","0","33.45","25.26"
"10","013","00","320","0006","0000","147","122","25","0","147","490","0","30.00","24.90"
"10","013","00","320","0006","0702","147","122","25","0","147","490","0","30.00","24.90"
"10","013","00","320","0007","0000","220","183","37","5","225","624","0","36.06","29.33"
"10","013","00","320","0007","0703","220","183","37","5","225","624","0","36.06","29.33"
"10","013","00","320","0008","0000","113","95","18","2","115","369","0","31.17","25.75"
"10","013","00","320","0008","0704","113","95","18","2","115","369","0","31.17","25.75"
"10","013","00","330","0000","0000","1251","990","261","24","1275","4134","4860","30.84","23.95"
"10","013","00","330","0001","0000","499","387","112","7","506","1579","0","32.05","24.51"
"10","013","00","330","0001","0705","259","197","62","3","262","732","0","35.79","26.91"
"10","013","00","330","0001","0706","115","91","24","1","116","520","0","22.31","17.50"
"10","013","00","330","0001","0707","125","99","26","3","128","327","0","39.14","30.28"
"10","013","00","330","0002","0000","224","197","27","5","229","645","0","35.50","30.54"
"10","013","00","330","0002","0708","224","197","27","5","229","645","0","35.50","30.54"
"10","013","00","330","0003","0000","147","122","25","3","150","435","0","34.48","28.05"
"10","013","00","330","0003","0709","147","122","25","3","150","435","0","34.48","28.05"
"10","013","00","330","0004","0000","127","94","33","3","130","359","0","36.21","26.18"
"10","013","00","330","0004","0710","127","94","33","3","130","359","0","36.21","26.18"
"10","013","00","330","0005","0000","151","114","37","1","152","567","0","26.81","20.11"
"10","013","00","330","0005","0711","151","114","37","1","152","567","0","26.81","20.11"
"10","013","00","330","0006","0000","103","76","27","5","108","549","0","19.67","13.84"
"10","013","00","330","0006","0712","103","76","27","5","108","549","0","19.67","13.84"
"10","002","00","000","0000","0000","145541","60498","85043","1500","147041","385260","451946","38.17","15.70"
"10","002","00","010","0000","0000","31170","14624","16546","265","31435","78886","95269","39.85","18.54"
"10","002","00","010","0001","0000","1056","555","501","7","1063","2534","0","41.95","21.90"
"10","002","00","010","0001","0024","281","159","122","1","282","625","0","45.12","25.44"
"10","002","00","010","0001","0025","419","211","208","1","420","937","0","44.82","22.52"
"10","002","00","010","0001","0026","356","185","171","5","361","972","0","37.14","19.03"
"10","002","00","010","0002","0000","597","322","275","4","601","1744","0","34.46","18.46"
"10","002","00","010","0002","0022","327","172","155","2","329","1037","0","31.73","16.59"
"10","002","00","010","0002","0023","270","150","120","2","272","707","0","38.47","21.22"
"10","002","00","010","0008","0000","925","464","461","6","931","2115","0","44.02","21.94"
"10","002","00","010","0008","0030","510","247","263","1","511","1130","0","45.22","21.86"
"10","002","00","010","0008","0031","415","217","198","5","420","985","0","42.64","22.03"
"10","002","00","010","0009","0000","523","218","305","7","530","1269","0","41.77","17.18"
"10","002","00","010","0009","0032","523","218","305","7","530","1269","0","41.77","17.18"
"10","002","00","010","0010","0000","843","368","475","8","851","1962","0","43.37","18.76"
"10","002","00","010","0010","0036","460","225","235","3","463","1126","0","41.12","19.98"
"10","002","00","010","0010","0037","383","143","240","5","388","836","0","46.41","17.11"
"10","002","00","010","0011","0000","881","474","407","9","890","2131","0","41.76","22.24"
"10","002","00","010","0011","0034","440","199","241","2","442","1010","0","43.76","19.70"
"10","002","00","010","0011","0035","441","275","166","7","448","1121","0","39.96","24.53"
"10","002","00","010","0012","0000","519","215","304","7","526","1298","0","40.52","16.56"
"10","002","00","010","0012","0033","519","215","304","7","526","1298","0","40.52","16.56"
"10","002","00","010","0013","0000","720","313","407","5","725","1846","0","39.27","16.96"
"10","002","00","010","0013","0052","360","167","193","2","362","938","0","38.59","17.80"
"10","002","00","010","0013","0053","360","146","214","3","363","908","0","39.98","16.08"
"10","002","00","010","0014","0000","845","399","446","7","852","2200","0","38.73","18.14"
"10","002","00","010","0014","0047","404","212","192","1","405","1072","0","37.78","19.78"
"10","002","00","010","0014","0048","441","187","254","6","447","1128","0","39.63","16.58"
"10","002","00","010","0015","0000","1190","599","591","12","1202","3263","0","36.84","18.36"
"10","002","00","010","0015","0041","407","178","229","5","412","1064","0","38.72","16.73"
"10","002","00","010","0015","0042","369","189","180","2","371","1111","0","33.39","17.01"
"10","002","00","010","0015","0043","414","232","182","5","419","1088","0","38.51","21.32"
"10","002","00","010","0016","0000","532","198","334","8","540","1459","0","37.01","13.57"
"10","002","00","010","0016","0054","292","90","202","6","298","765","0","38.95","11.76"
"10","002","00","010","0016","0055","240","108","132","2","242","694","0","34.87","15.56"
"10","002","00","010","0017","0000","604","291","313","7","611","1801","0","33.93","16.16"
"10","002","00","010","0017","0061","286","152","134","3","289","894","0","32.33","17.00"
"10","002","00","010","0017","0062","318","139","179","4","322","907","0","35.50","15.33"
"10","002","00","010","0018","0000","653","264","389","6","659","1464","0","45.01","18.03"
"10","002","00","010","0018","0028","323","131","192","4","327","686","0","47.67","19.10"
"10","002","00","010","0018","0029","330","133","197","2","332","778","0","42.67","17.10"
"10","002","00","010","0019","0000","402","136","266","0","402","951","0","42.27","14.30"
"10","002","00","010","0019","0057","402","136","266","0","402","951","0","42.27","14.30"
"10","002","00","010","0021","0000","636","284","352","5","641","1595","0","40.19","17.81"
"10","002","00","010","0021","0058","295","139","156","3","298","789","0","37.77","17.62"
"10","002","00","010","0021","0059","341","145","196","2","343","806","0","42.56","17.99"
"10","002","00","010","0022","0000","523","239","284","4","527","1334","0","39.51","17.92"
"10","002","00","010","0022","0060","523","239","284","4","527","1334","0","39.51","17.92"
"10","002","00","010","0023","0000","448","164","284","2","450","1122","0","40.11","14.62"
"10","002","00","010","0023","0056","448","164","284","2","450","1122","0","40.11","14.62"
"10","002","00","010","0024","0000","947","356","591","6","953","2678","0","35.59","13.29"
"10","002","00","010","0024","0066","298","112","186","2","300","890","0","33.71","12.58"
"10","002","00","010","0024","0067","277","84","193","3","280","797","0","35.13","10.54"
"10","002","00","010","0024","0068","372","160","212","1","373","991","0","37.64","16.15"
"10","002","00","010","0025","0000","766","333","433","9","775","2080","0","37.26","16.01"
"10","002","00","010","0025","0069","421","210","211","4","425","1103","0","38.53","19.04"
"10","002","00","010","0025","0070","345","123","222","5","350","977","0","35.82","12.59"
"10","002","00","010","0026","0000","824","311","513","11","835","2200","0","37.95","14.14"
"10","002","00","010","0026","0071","389","157","232","6","395","1102","0","35.84","14.25"
"10","002","00","010","0026","0072","435","154","281","5","440","1098","0","40.07","14.03"
"10","002","00","010","0027","0000","1151","415","736","12","1163","3159","0","36.82","13.14"
"10","002","00","010","0027","0073","380","151","229","2","382","972","0","39.30","15.53"
"10","002","00","010","0027","0074","394","141","253","7","401","1164","0","34.45","12.11"
"10","002","00","010","0027","0075","377","123","254","3","380","1023","0","37.15","12.02"
"10","002","00","010","0028","0000","487","182","305","5","492","1112","0","44.24","16.37"
"10","002","00","010","0028","0081","487","182","305","5","492","1112","0","44.24","16.37"
"10","002","00","010","0031","0000","345","157","188","5","350","902","0","38.80","17.41"
"10","002","00","010","0031","0078","345","157","188","5","350","902","0","38.80","17.41"
"10","002","00","010","0032","0000","739","274","465","6","745","1736","0","42.91","15.78"
"10","002","00","010","0032","0079","347","140","207","2","349","817","0","42.72","17.14"
"10","002","00","010","0032","0080","392","134","258","4","396","919","0","43.09","14.58"
"10","002","00","010","0034","0000","553","246","307","3","556","1330","0","41.80","18.50"
"10","002","00","010","0034","0076","279","144","135","1","280","616","0","45.45","23.38"
"10","002","00","010","0034","0077","274","102","172","2","276","714","0","38.66","14.29"
"10","002","00","010","0035","0000","1185","542","643","4","1189","2908","0","40.89","18.64"
"10","002","00","010","0035","0007","372","176","196","2","374","931","0","40.17","18.90"
"10","002","00","010","0035","0008","422","189","233","0","422","1000","0","42.20","18.90"
"10","002","00","010","0035","0009","391","177","214","2","393","977","0","40.23","18.12"
"10","002","00","010","0036","0000","937","492","445","12","949","2157","0","44.00","22.81"
"10","002","00","010","0036","0001","501","245","256","7","508","1107","0","45.89","22.13"
"10","002","00","010","0036","0002","436","247","189","5","441","1050","0","42.00","23.52"
"10","002","00","010","0037","0000","649","319","330","5","654","1576","0","41.50","20.24"
"10","002","00","010","0037","0003","346","168","178","3","349","834","0","41.85","20.14"
"10","002","00","010","0037","0004","303","151","152","2","305","742","0","41.11","20.35"
"10","002","00","010","0038","0000","1763","990","773","13","1776","4247","0","41.82","23.31"
"10","002","00","010","0038","0010","500","272","228","2","502","1055","0","47.58","25.78"
"10","002","00","010","0038","0011","380","226","154","3","383","1020","0","37.55","22.16"
"10","002","00","010","0038","0012","438","262","176","3","441","1056","0","41.76","24.81"
"10","002","00","010","0038","0013","445","230","215","5","450","1116","0","40.32","20.61"
"10","002","00","010","0039","0000","1226","622","604","10","1236","2966","0","41.67","20.97"
"10","002","00","010","0039","0016","368","174","194","1","369","885","0","41.69","19.66"
"10","002","00","010","0039","0017","383","217","166","5","388","944","0","41.10","22.99"
"10","002","00","010","0039","0018","475","231","244","4","479","1137","0","42.13","20.32"
"10","002","00","010","0040","0000","1082","598","484","7","1089","2613","0","41.68","22.89"
"10","002","00","010","0040","0019","375","263","112","4","379","870","0","43.56","30.23"
"10","002","00","010","0040","0020","340","172","168","2","342","779","0","43.90","22.08"
"10","002","00","010","0040","0021","367","163","204","1","368","964","0","38.17","16.91"
"10","002","00","010","0041","0000","1146","552","594","14","1160","3044","0","38.11","18.13"
"10","002","00","010","0041","0044","306","122","184","4","310","812","0","38.18","15.02"
"10","002","00","010","0041","0045","429","230","199","8","437","1146","0","38.13","20.07"
"10","002","00","010","0041","0046","411","200","211","2","413","1086","0","38.03","18.42"
"10","002","00","010","0042","0000","1174","601","573","9","1183","3099","0","38.17","19.39"
"10","002","00","010","0042","0049","455","234","221","4","459","1132","0","40.55","20.67"
"10","002","00","010","0042","0050","360","183","177","1","361","951","0","37.96","19.24"
"10","002","00","010","0042","0051","359","184","175","4","363","1016","0","35.73","18.11"
"10","002","00","010","0043","0000","1097","586","511","5","1102","2533","0","43.51","23.13"
"10","002","00","010","0043","0014","569","337","232","4","573","1294","0","44.28","26.04"
"10","002","00","010","0043","0015","528","249","279","1","529","1239","0","42.70","20.10"
"10","002","00","010","0044","0000","654","348","306","6","660","1969","0","33.52","17.67"
"10","002","00","010","0044","0005","339","181","158","1","340","1017","0","33.43","17.80"
"10","002","00","010","0044","0006","315","167","148","5","320","952","0","33.61","17.54"
"10","002","00","010","0045","0000","303","139","164","4","307","770","0","39.87","18.05"
"10","002","00","010","0045","0027","303","139","164","4","307","770","0","39.87","18.05"
"10","002","00","010","0046","0000","1017","470","547","4","1021","2844","0","35.90","16.53"
"10","002","00","010","0046","0063","440","202","238","2","442","1229","0","35.96","16.44"
"10","002","00","010","0046","0064","304","145","159","2","306","788","0","38.83","18.40"
"10","002","00","010","0046","0065","273","123","150","0","273","827","0","33.01","14.87"
"10","002","00","010","0047","0000","1228","588","640","11","1239","2875","0","43.10","20.45"
"10","002","00","010","0047","0038","432","197","235","4","436","990","0","44.04","19.90"
"10","002","00","010","0047","0039","381","193","188","3","384","905","0","42.43","21.33"
"10","002","00","010","0047","0040","415","198","217","4","419","980","0","42.76","20.20"
"10","002","00","020","0000","0000","23094","9632","13462","201","23295","56993","71097","40.87","16.90"
"10","002","00","020","0004","0000","618","265","353","7","625","1532","0","40.80","17.30"
"10","002","00","020","0004","0084","618","265","353","7","625","1532","0","40.80","17.30"
"10","002","00","020","0005","0000","1289","497","792","17","1306","3501","0","37.30","14.20"
"10","002","00","020","0005","0085","568","179","389","11","579","1443","0","40.12","12.40"
"10","002","00","020","0005","0086","367","167","200","4","371","1118","0","33.18","14.94"
"10","002","00","020","0005","0087","354","151","203","2","356","940","0","37.87","16.06"
"10","002","00","020","0006","0000","1053","375","678","6","1059","2687","0","39.41","13.96"
"10","002","00","020","0006","0088","592","203","389","2","594","1521","0","39.05","13.35"
"10","002","00","020","0006","0089","461","172","289","4","465","1166","0","39.88","14.75"
"10","002","00","020","0007","0000","1188","520","668","9","1197","3002","0","39.87","17.32"
"10","002","00","020","0007","0090","545","227","318","5","550","1304","0","42.18","17.41"
"10","002","00","020","0007","0091","341","154","187","0","341","829","0","41.13","18.58"
"10","002","00","020","0007","0092","302","139","163","4","306","869","0","35.21","16.00"
"10","002","00","020","0008","0000","871","379","492","9","880","2352","0","37.41","16.11"
"10","002","00","020","0008","0093","501","223","278","6","507","1477","0","34.33","15.10"
"10","002","00","020","0008","0094","370","156","214","3","373","875","0","42.63","17.83"
"10","002","00","020","0009","0000","548","230","318","9","557","1294","0","43.04","17.77"
"10","002","00","020","0009","0095","548","230","318","9","557","1294","0","43.04","17.77"
"10","002","00","020","0010","0000","630","268","362","3","633","1501","0","42.17","17.85"
"10","002","00","020","0010","0096","630","268","362","3","633","1501","0","42.17","17.85"
"10","002","00","020","0011","0000","488","207","281","2","490","1123","0","43.63","18.43"
"10","002","00","020","0011","0097","488","207","281","2","490","1123","0","43.63","18.43"
"10","002","00","020","0016","0000","1422","619","803","9","1431","3579","0","39.98","17.30"
"10","002","00","020","0016","0100","420","167","253","2","422","1025","0","41.17","16.29"
"10","002","00","020","0016","0101","539","261","278","3","542","1283","0","42.24","20.34"
"10","002","00","020","0016","0102","463","191","272","4","467","1271","0","36.74","15.03"
"10","002","00","020","0017","0000","1085","455","630","8","1093","2799","0","39.05","16.26"
"10","002","00","020","0017","0106","537","204","333","5","542","1413","0","38.36","14.44"
"10","002","00","020","0017","0107","548","251","297","3","551","1386","0","39.75","18.11"
"10","002","00","020","0018","0000","1085","447","638","17","1102","2795","0","39.43","15.99"
"10","002","00","020","0018","0108","436","159","277","5","441","1069","0","41.25","14.87"
"10","002","00","020","0018","0109","339","154","185","9","348","879","0","39.59","17.52"
"10","002","00","020","0018","0110","310","134","176","3","313","847","0","36.95","15.82"
"10","002","00","020","0019","0000","1389","639","750","14","1403","3502","0","40.06","18.25"
"10","002","00","020","0019","0115","564","263","301","4","568","1399","0","40.60","18.80"
"10","002","00","020","0019","0116","424","201","223","5","429","1083","0","39.61","18.56"
"10","002","00","020","0019","0117","401","175","226","5","406","1020","0","39.80","17.16"
"10","002","00","020","0020","0000","1128","452","676","10","1138","2641","0","43.09","17.11"
"10","002","00","020","0020","0118","576","238","338","5","581","1375","0","42.25","17.31"
"10","002","00","020","0020","0119","552","214","338","5","557","1266","0","44.00","16.90"
"10","002","00","020","0021","0000","369","144","225","5","374","1099","0","34.03","13.10"
"10","002","00","020","0021","0120","369","144","225","5","374","1099","0","34.03","13.10"
"10","002","00","020","0022","0000","1225","522","703","11","1236","2919","0","42.34","17.88"
"10","002","00","020","0022","0121","487","212","275","4","491","1057","0","46.45","20.06"
"10","002","00","020","0022","0122","431","187","244","3","434","1068","0","40.64","17.51"
"10","002","00","020","0022","0123","307","123","184","4","311","794","0","39.17","15.49"
"10","002","00","020","0023","0000","1158","447","711","16","1174","2844","0","41.28","15.72"
"10","002","00","020","0023","0127","370","144","226","5","375","953","0","39.35","15.11"
"10","002","00","020","0023","0128","400","151","249","4","404","952","0","42.44","15.86"
"10","002","00","020","0023","0129","388","152","236","7","395","939","0","42.07","16.19"
"10","002","00","020","0024","0000","1488","609","879","8","1496","3570","0","41.90","17.06"
"10","002","00","020","0024","0130","568","242","326","4","572","1370","0","41.75","17.66"
"10","002","00","020","0024","0131","446","169","277","2","448","1040","0","43.08","16.25"
"10","002","00","020","0024","0132","474","198","276","2","476","1160","0","41.03","17.07"
"10","002","00","020","0025","0000","1553","725","828","14","1567","3337","0","46.96","21.73"
"10","002","00","020","0025","0124","691","337","354","6","697","1354","0","51.48","24.89"
"10","002","00","020","0025","0125","402","181","221","6","408","847","0","48.17","21.37"
"10","002","00","020","0025","0126","460","207","253","2","462","1136","0","40.67","18.22"
"10","002","00","020","0026","0000","1775","788","987","10","1785","4280","0","41.71","18.41"
"10","002","00","020","0026","0111","449","192","257","3","452","1092","0","41.39","17.58"
"10","002","00","020","0026","0112","504","229","275","5","509","1135","0","44.85","20.18"
"10","002","00","020","0026","0113","443","211","232","0","443","1108","0","39.98","19.04"
"10","002","00","020","0026","0114","379","156","223","2","381","945","0","40.32","16.51"
"10","002","00","020","0027","0000","1245","520","725","4","1249","2960","0","42.20","17.57"
"10","002","00","020","0027","0103","415","182","233","1","416","1020","0","40.78","17.84"
"10","002","00","020","0027","0104","418","182","236","2","420","965","0","43.52","18.86"
"10","002","00","020","0027","0105","412","156","256","1","413","975","0","42.36","16.00"
"10","002","00","020","0028","0000","569","209","360","7","576","1355","0","42.51","15.42"
"10","002","00","020","0028","0082","312","118","194","4","316","662","0","47.73","17.82"
"10","002","00","020","0028","0083","257","91","166","3","260","693","0","37.52","13.13"
"10","002","00","020","0029","0000","535","173","362","4","539","1343","0","40.13","12.88"
"10","002","00","020","0029","0099","535","173","362","4","539","1343","0","40.13","12.88"
"10","002","00","020","0030","0000","383","142","241","2","385","978","0","39.37","14.52"
"10","002","00","020","0030","0098","383","142","241","2","385","978","0","39.37","14.52"
"10","002","00","030","0000","0000","12289","4870","7419","155","12444","33916","38592","36.69","14.36"
"10","002","00","030","0001","0000","1201","441","760","18","1219","3347","0","36.42","13.18"
"10","002","00","030","0001","0133","286","113","173","4","290","859","0","33.76","13.15"
"10","002","00","030","0001","0134","287","101","186","4","291","802","0","36.28","12.59"
"10","002","00","030","0001","0135","289","107","182","5","294","797","0","36.89","13.43"
"10","002","00","030","0001","0136","339","120","219","5","344","889","0","38.70","13.50"
"10","002","00","030","0002","0000","381","128","253","4","385","1020","0","37.75","12.55"
"10","002","00","030","0002","0137","381","128","253","4","385","1020","0","37.75","12.55"
"10","002","00","030","0003","0000","1383","513","870","10","1393","3753","0","37.12","13.67"
"10","002","00","030","0003","0138","357","134","223","4","361","1063","0","33.96","12.61"
"10","002","00","030","0003","0139","362","143","219","1","363","970","0","37.42","14.74"
"10","002","00","030","0003","0140","368","132","236","5","373","929","0","40.15","14.21"
"10","002","00","030","0003","0141","296","104","192","0","296","791","0","37.42","13.15"
"10","002","00","030","0004","0000","348","112","236","4","352","861","0","40.88","13.01"
"10","002","00","030","0004","0142","210","81","129","3","213","543","0","39.23","14.92"
"10","002","00","030","0004","0143","138","31","107","1","139","318","0","43.71","9.75"
"10","002","00","030","0005","0000","497","175","322","9","506","1218","0","41.54","14.37"
"10","002","00","030","0005","0144","339","126","213","4","343","804","0","42.66","15.67"
"10","002","00","030","0005","0145","158","49","109","5","163","414","0","39.37","11.84"
"10","002","00","030","0007","0000","1151","443","708","11","1162","3062","0","37.95","14.47"
"10","002","00","030","0007","0146","356","126","230","4","360","1015","0","35.47","12.41"
"10","002","00","030","0007","0147","394","153","241","1","395","1049","0","37.65","14.59"
"10","002","00","030","0007","0148","401","164","237","6","407","998","0","40.78","16.43"
"10","002","00","030","0008","0000","575","214","361","10","585","1452","0","40.29","14.74"
"10","002","00","030","0008","0149","380","137","243","7","387","996","0","38.86","13.76"
"10","002","00","030","0008","0150","195","77","118","3","198","456","0","43.42","16.89"
"10","002","00","030","0009","0000","795","407","388","8","803","2219","0","36.19","18.34"
"10","002","00","030","0009","0154","214","128","86","1","215","557","0","38.60","22.98"
"10","002","00","030","0009","0155","280","144","136","3","283","841","0","33.65","17.12"
"10","002","00","030","0009","0156","301","135","166","4","305","821","0","37.15","16.44"
"10","002","00","030","0010","0000","888","381","507","6","894","2348","0","38.07","16.23"
"10","002","00","030","0010","0157","310","155","155","2","312","875","0","35.66","17.71"
"10","002","00","030","0010","0158","242","103","139","3","245","661","0","37.07","15.58"
"10","002","00","030","0010","0159","336","123","213","1","337","812","0","41.50","15.15"
"10","002","00","030","0011","0000","376","186","190","7","383","953","0","40.19","19.52"
"10","002","00","030","0011","0160","376","186","190","7","383","953","0","40.19","19.52"
"10","002","00","030","0012","0000","217","96","121","0","217","437","0","49.66","21.97"
"10","002","00","030","0012","0161","217","96","121","0","217","437","0","49.66","21.97"
"10","002","00","030","0013","0000","165","81","84","2","167","499","0","33.47","16.23"
"10","002","00","030","0013","0162","165","81","84","2","167","499","0","33.47","16.23"
"10","002","00","030","0014","0000","183","79","104","2","185","521","0","35.51","15.16"
"10","002","00","030","0014","0163","183","79","104","2","185","521","0","35.51","15.16"
"10","002","00","030","0015","0000","184","101","83","1","185","431","0","42.92","23.43"
"10","002","00","030","0015","0164","184","101","83","1","185","431","0","42.92","23.43"
"10","002","00","030","0016","0000","192","73","119","2","194","573","0","33.86","12.74"
"10","002","00","030","0016","0165","192","73","119","2","194","573","0","33.86","12.74"
"10","002","00","030","0017","0000","153","67","86","0","153","439","0","34.85","15.26"
"10","002","00","030","0017","0166","153","67","86","0","153","439","0","34.85","15.26"
"10","002","00","030","0018","0000","330","146","184","4","334","909","0","36.74","16.06"
"10","002","00","030","0018","0167","330","146","184","4","334","909","0","36.74","16.06"
"10","002","00","030","0019","0000","334","109","225","1","335","893","0","37.51","12.21"
"10","002","00","030","0019","0168","334","109","225","1","335","893","0","37.51","12.21"
"10","002","00","030","0020","0000","328","115","213","9","337","1052","0","32.03","10.93"
"10","002","00","030","0020","0169","152","64","88","6","158","485","0","32.58","13.20"
"10","002","00","030","0020","0170","176","51","125","3","179","567","0","31.57","8.99"
"10","002","00","030","0021","0000","425","183","242","13","438","1414","0","30.98","12.94"
"10","002","00","030","0021","0171","232","99","133","7","239","717","0","33.33","13.81"
"10","002","00","030","0021","0172","193","84","109","6","199","697","0","28.55","12.05"
"10","002","00","030","0022","0000","342","146","196","9","351","1011","0","34.72","14.44"
"10","002","00","030","0022","0173","342","146","196","9","351","1011","0","34.72","14.44"
"10","002","00","030","0023","0000","400","126","274","8","408","1165","0","35.02","10.82"
"10","002","00","030","0023","0174","221","86","135","6","227","625","0","36.32","13.76"
"10","002","00","030","0023","0175","179","40","139","2","181","540","0","33.52","7.41"
"10","002","00","030","0024","0000","88","42","46","3","91","330","0","27.58","12.73"
"10","002","00","030","0024","0176","88","42","46","3","91","330","0","27.58","12.73"
"10","002","00","030","0025","0000","221","71","150","5","226","691","0","32.71","10.27"
"10","002","00","030","0025","0177","221","71","150","5","226","691","0","32.71","10.27"
"10","002","00","030","0026","0000","212","59","153","4","216","584","0","36.99","10.10"
"10","002","00","030","0026","0178","119","33","86","1","120","356","0","33.71","9.27"
"10","002","00","030","0026","0179","93","26","67","3","96","228","0","42.11","11.40"
"10","002","00","030","0027","0000","920","376","544","5","925","2734","0","33.83","13.75"
"10","002","00","030","0027","0151","262","111","151","1","263","785","0","33.50","14.14"
"10","002","00","030","0027","0152","301","131","170","3","304","852","0","35.68","15.38"
"10","002","00","030","0027","0153","357","134","223","1","358","1097","0","32.63","12.22"
"10","002","00","040","0000","0000","8198","3892","4306","110","8308","24942","28673","33.31","15.60"
"10","002","00","040","0001","0000","81","29","52","0","81","304","0","26.64","9.54"
"10","002","00","040","0001","0180","81","29","52","0","81","304","0","26.64","9.54"
"10","002","00","040","0002","0000","193","94","99","3","196","676","0","28.99","13.91"
"10","002","00","040","0002","0181","193","94","99","3","196","676","0","28.99","13.91"
"10","002","00","040","0003","0000","262","102","160","5","267","874","0","30.55","11.67"
"10","002","00","040","0003","0183","262","102","160","5","267","874","0","30.55","11.67"
"10","002","00","040","0004","0000","85","39","46","1","86","345","0","24.93","11.30"
"10","002","00","040","0004","0184","85","39","46","1","86","345","0","24.93","11.30"
"10","002","00","040","0005","0000","351","154","197","11","362","1352","0","26.78","11.39"
"10","002","00","040","0005","0185","173","75","98","5","178","624","0","28.53","12.02"
"10","002","00","040","0005","0186","178","79","99","6","184","728","0","25.27","10.85"
"10","002","00","040","0006","0000","238","111","127","5","243","862","0","28.19","12.88"
"10","002","00","040","0006","0187","238","111","127","5","243","862","0","28.19","12.88"
"10","002","00","040","0007","0000","214","81","133","2","216","678","0","31.86","11.95"
"10","002","00","040","0007","0188","214","81","133","2","216","678","0","31.86","11.95"
"10","002","00","040","0008","0000","566","293","273","7","573","1576","0","36.36","18.59"
"10","002","00","040","0008","0189","299","142","157","5","304","853","0","35.64","16.65"
"10","002","00","040","0008","0190","267","151","116","2","269","723","0","37.21","20.89"
"10","002","00","040","0009","0000","473","214","259","9","482","1356","0","35.55","15.78"
"10","002","00","040","0009","0191","249","110","139","6","255","791","0","32.24","13.91"
"10","002","00","040","0009","0192","224","104","120","3","227","565","0","40.18","18.41"
"10","002","00","040","0010","0000","305","161","144","2","307","710","0","43.24","22.68"
"10","002","00","040","0010","0193","305","161","144","2","307","710","0","43.24","22.68"
"10","002","00","040","0011","0000","200","117","83","0","200","488","0","40.98","23.98"
"10","002","00","040","0011","0194","200","117","83","0","200","488","0","40.98","23.98"
"10","002","00","040","0012","0000","194","104","90","1","195","533","0","36.59","19.51"
"10","002","00","040","0012","0195","194","104","90","1","195","533","0","36.59","19.51"
"10","002","00","040","0013","0000","266","146","120","1","267","645","0","41.40","22.64"
"10","002","00","040","0013","0196","266","146","120","1","267","645","0","41.40","22.64"
"10","002","00","040","0014","0000","572","257","315","10","582","2076","0","28.03","12.38"
"10","002","00","040","0014","0197","286","99","187","4","290","1050","0","27.62","9.43"
"10","002","00","040","0014","0198","286","158","128","6","292","1026","0","28.46","15.40"
"10","002","00","040","0015","0000","698","337","361","10","708","2044","0","34.64","16.49"
"10","002","00","040","0015","0199","293","134","159","5","298","863","0","34.53","15.53"
"10","002","00","040","0015","0200","405","203","202","5","410","1181","0","34.72","17.19"
"10","002","00","040","0016","0000","716","353","363","10","726","2076","0","34.97","17.00"
"10","002","00","040","0016","0201","274","139","135","8","282","901","0","31.30","15.43"
"10","002","00","040","0016","0202","442","214","228","2","444","1175","0","37.79","18.21"
"10","002","00","040","0017","0000","294","130","164","5","299","931","0","32.12","13.96"
"10","002","00","040","0017","0203","294","130","164","5","299","931","0","32.12","13.96"
"10","002","00","040","0018","0000","595","305","290","3","598","1711","0","34.95","17.83"
"10","002","00","040","0018","0204","368","213","155","3","371","1025","0","36.20","20.78"
"10","002","00","040","0018","0205","227","92","135","0","227","686","0","33.09","13.41"
"10","002","00","040","0019","0000","225","114","111","2","227","692","0","32.80","16.47"
"10","002","00","040","0019","0206","225","114","111","2","227","692","0","32.80","16.47"
"10","002","00","040","0020","0000","487","239","248","6","493","1301","0","37.89","18.37"
"10","002","00","040","0020","0207","202","88","114","2","204","569","0","35.85","15.47"
"10","002","00","040","0020","0208","285","151","134","4","289","732","0","39.48","20.63"
"10","002","00","040","0021","0000","307","128","179","4","311","909","0","34.21","14.08"
"10","002","00","040","0021","0209","307","128","179","4","311","909","0","34.21","14.08"
"10","002","00","040","0022","0000","309","139","170","4","313","1008","0","31.05","13.79"
"10","002","00","040","0022","0210","309","139","170","4","313","1008","0","31.05","13.79"
"10","002","00","040","0023","0000","340","148","192","6","346","1090","0","31.74","13.58"
"10","002","00","040","0023","0211","340","148","192","6","346","1090","0","31.74","13.58"
"10","002","00","040","0024","0000","227","97","130","3","230","705","0","32.62","13.76"
"10","002","00","040","0024","0182","227","97","130","3","230","705","0","32.62","13.76"
"10","002","00","050","0000","0000","11384","4593","6791","127","11511","30794","35091","37.38","14.92"
"10","002","00","050","0001","0000","526","215","311","7","533","1601","0","33.29","13.43"
"10","002","00","050","0001","0212","367","146","221","5","372","1093","0","34.03","13.36"
"10","002","00","050","0001","0213","159","69","90","2","161","508","0","31.69","13.58"
"10","002","00","050","0002","0000","704","314","390","9","713","1954","0","36.49","16.07"
"10","002","00","050","0002","0214","331","138","193","2","333","987","0","33.74","13.98"
"10","002","00","050","0002","0215","373","176","197","7","380","967","0","39.30","18.20"
"10","002","00","050","0003","0000","1491","795","696","16","1507","3987","0","37.80","19.94"
"10","002","00","050","0003","0216","337","188","149","3","340","956","0","35.56","19.67"
"10","002","00","050","0003","0217","352","200","152","2","354","955","0","37.07","20.94"
"10","002","00","050","0003","0218","400","204","196","6","406","970","0","41.86","21.03"
"10","002","00","050","0003","0219","402","203","199","5","407","1106","0","36.80","18.35"
"10","002","00","050","0004","0000","920","454","466","14","934","2517","0","37.11","18.04"
"10","002","00","050","0004","0220","281","151","130","5","286","815","0","35.09","18.53"
"10","002","00","050","0004","0221","340","156","184","4","344","870","0","39.54","17.93"
"10","002","00","050","0004","0222","299","147","152","5","304","832","0","36.54","17.67"
"10","002","00","050","0005","0000","231","102","129","1","232","620","0","37.42","16.45"
"10","002","00","050","0005","0223","231","102","129","1","232","620","0","37.42","16.45"
"10","002","00","050","0006","0000","576","285","291","6","582","1372","0","42.42","20.77"
"10","002","00","050","0006","0224","261","137","124","2","263","576","0","45.66","23.78"
"10","002","00","050","0006","0225","315","148","167","4","319","796","0","40.08","18.59"
"10","002","00","050","0007","0000","447","159","288","1","448","1198","0","37.40","13.27"
"10","002","00","050","0007","0226","447","159","288","1","448","1198","0","37.40","13.27"
"10","002","00","050","0008","0000","522","151","371","8","530","1460","0","36.30","10.34"
"10","002","00","050","0008","0227","327","110","217","8","335","875","0","38.29","12.57"
"10","002","00","050","0008","0228","195","41","154","0","195","585","0","33.33","7.01"
"10","002","00","050","0009","0000","831","266","565","6","837","2114","0","39.59","12.58"
"10","002","00","050","0009","0229","349","117","232","4","353","920","0","38.37","12.72"
"10","002","00","050","0009","0230","482","149","333","2","484","1194","0","40.54","12.48"
"10","002","00","050","0010","0000","846","314","532","8","854","2406","0","35.49","13.05"
"10","002","00","050","0010","0231","301","107","194","1","302","844","0","35.78","12.68"
"10","002","00","050","0010","0232","231","90","141","2","233","643","0","36.24","14.00"
"10","002","00","050","0010","0233","314","117","197","5","319","919","0","34.71","12.73"
"10","002","00","050","0011","0000","340","107","233","6","346","1132","0","30.57","9.45"
"10","002","00","050","0011","0234","340","107","233","6","346","1132","0","30.57","9.45"
"10","002","00","050","0012","0000","292","116","176","5","297","830","0","35.78","13.98"
"10","002","00","050","0012","0235","292","116","176","5","297","830","0","35.78","13.98"
"10","002","00","050","0013","0000","422","170","252","4","426","1059","0","40.23","16.05"
"10","002","00","050","0013","0236","422","170","252","4","426","1059","0","40.23","16.05"
"10","002","00","050","0014","0000","477","181","296","6","483","1359","0","35.54","13.32"
"10","002","00","050","0014","0237","477","181","296","6","483","1359","0","35.54","13.32"
"10","002","00","050","0015","0000","1030","380","650","12","1042","2526","0","41.25","15.04"
"10","002","00","050","0015","0238","359","163","196","4","363","898","0","40.42","18.15"
"10","002","00","050","0015","0239","332","112","220","5","337","820","0","41.10","13.66"
"10","002","00","050","0015","0240","339","105","234","3","342","808","0","42.33","13.00"
"10","002","00","050","0016","0000","1222","407","815","14","1236","3316","0","37.27","12.27"
"10","002","00","050","0016","0241","435","150","285","6","441","1073","0","41.10","13.98"
"10","002","00","050","0016","0242","459","151","308","4","463","1215","0","38.11","12.43"
"10","002","00","050","0016","0243","328","106","222","4","332","1028","0","32.30","10.31"
"10","002","00","050","0017","0000","328","132","196","2","330","921","0","35.83","14.33"
"10","002","00","050","0017","0244","328","132","196","2","330","921","0","35.83","14.33"
"10","002","00","050","0018","0000","179","45","134","2","181","422","0","42.89","10.66"
"10","002","00","050","0018","0245","179","45","134","2","181","422","0","42.89","10.66"
"10","002","00","060","0000","0000","7790","2883","4907","93","7883","21700","24419","36.33","13.29"
"10","002","00","060","0001","0000","978","409","569","8","986","2606","0","37.84","15.69"
"10","002","00","060","0001","0246","362","154","208","1","363","899","0","40.38","17.13"
"10","002","00","060","0001","0247","288","114","174","4","292","778","0","37.53","14.65"
"10","002","00","060","0001","0248","328","141","187","3","331","929","0","35.63","15.18"
"10","002","00","060","0002","0000","693","298","395","4","697","1928","0","36.15","15.46"
"10","002","00","060","0002","0250","303","132","171","2","305","925","0","32.97","14.27"
"10","002","00","060","0002","0251","390","166","224","2","392","1003","0","39.08","16.55"
"10","002","00","060","0003","0000","364","134","230","7","371","931","0","39.85","14.39"
"10","002","00","060","0003","0252","364","134","230","7","371","931","0","39.85","14.39"
"10","002","00","060","0004","0000","282","90","192","1","283","979","0","28.91","9.19"
"10","002","00","060","0004","0253","282","90","192","1","283","979","0","28.91","9.19"
"10","002","00","060","0005","0000","516","156","360","9","525","1599","0","32.83","9.76"
"10","002","00","060","0005","0254","267","72","195","6","273","805","0","33.91","8.94"
"10","002","00","060","0005","0255","249","84","165","3","252","794","0","31.74","10.58"
"10","002","00","060","0006","0000","484","160","324","6","490","1492","0","32.84","10.72"
"10","002","00","060","0006","0256","268","84","184","6","274","785","0","34.90","10.70"
"10","002","00","060","0006","0257","216","76","140","0","216","707","0","30.55","10.75"
"10","002","00","060","0007","0000","306","96","210","2","308","792","0","38.89","12.12"
"10","002","00","060","0007","0258","306","96","210","2","308","792","0","38.89","12.12"
"10","002","00","060","0008","0000","873","304","569","13","886","2369","0","37.40","12.83"
"10","002","00","060","0008","0259","304","109","195","8","312","889","0","35.10","12.26"
"10","002","00","060","0008","0260","292","100","192","0","292","729","0","40.05","13.72"
"10","002","00","060","0008","0261","277","95","182","5","282","751","0","37.55","12.65"
"10","002","00","060","0009","0000","588","217","371","7","595","1580","0","37.66","13.73"
"10","002","00","060","0009","0262","246","89","157","3","249","661","0","37.67","13.46"
"10","002","00","060","0009","0263","342","128","214","4","346","919","0","37.65","13.93"
"10","002","00","060","0010","0000","498","179","319","8","506","1240","0","40.81","14.44"
"10","002","00","060","0010","0264","498","179","319","8","506","1240","0","40.81","14.44"
"10","002","00","060","0011","0000","849","343","506","11","860","2246","0","38.29","15.27"
"10","002","00","060","0011","0265","387","168","219","5","392","1103","0","35.54","15.23"
"10","002","00","060","0011","0266","462","175","287","6","468","1143","0","40.94","15.31"
"10","002","00","060","0012","0000","379","133","246","8","387","1058","0","36.58","12.57"
"10","002","00","060","0012","0267","379","133","246","8","387","1058","0","36.58","12.57"
"10","002","00","060","0013","0000","559","204","355","8","567","1756","0","32.29","11.62"
"10","002","00","060","0013","0268","273","113","160","3","276","945","0","29.21","11.96"
"10","002","00","060","0013","0269","286","91","195","5","291","811","0","35.88","11.22"
"10","002","00","060","0014","0000","421","160","261","1","422","1124","0","37.54","14.23"
"10","002","00","060","0014","0249","421","160","261","1","422","1124","0","37.54","14.23"
"10","002","00","070","0000","0000","10323","3917","6406","133","10456","28401","32189","36.82","13.79"
"10","002","00","070","0001","0000","2137","929","1208","26","2163","5810","0","37.23","15.99"
"10","002","00","070","0001","0270","584","262","322","5","589","1443","0","40.82","18.16"
"10","002","00","070","0001","0271","301","133","168","4","305","889","0","34.31","14.96"
"10","002","00","070","0001","0272","463","174","289","7","470","1254","0","37.48","13.88"
"10","002","00","070","0001","0273","382","172","210","8","390","1161","0","33.59","14.81"
"10","002","00","070","0001","0274","407","188","219","2","409","1063","0","38.48","17.69"
"10","002","00","070","0002","0000","755","302","453","11","766","2164","0","35.40","13.96"
"10","002","00","070","0002","0275","364","128","236","5","369","1017","0","36.28","12.59"
"10","002","00","070","0002","0276","391","174","217","6","397","1147","0","34.61","15.17"
"10","002","00","070","0003","0000","670","228","442","8","678","1676","0","40.45","13.60"
"10","002","00","070","0003","0277","344","121","223","2","346","904","0","38.27","13.38"
"10","002","00","070","0003","0278","326","107","219","6","332","772","0","43.01","13.86"
"10","002","00","070","0004","0000","554","244","310","4","558","1505","0","37.08","16.21"
"10","002","00","070","0004","0279","271","124","147","3","274","751","0","36.48","16.51"
"10","002","00","070","0004","0280","283","120","163","1","284","754","0","37.67","15.92"
"10","002","00","070","0005","0000","776","307","469","2","778","1941","0","40.08","15.82"
"10","002","00","070","0005","0281","410","157","253","2","412","1032","0","39.92","15.21"
"10","002","00","070","0005","0282","366","150","216","0","366","909","0","40.26","16.50"
"10","002","00","070","0006","0000","439","138","301","8","447","1249","0","35.79","11.05"
"10","002","00","070","0006","0283","439","138","301","8","447","1249","0","35.79","11.05"
"10","002","00","070","0007","0000","448","203","245","13","461","1436","0","32.10","14.14"
"10","002","00","070","0007","0284","196","94","102","5","201","564","0","35.64","16.67"
"10","002","00","070","0007","0285","252","109","143","8","260","872","0","29.82","12.50"
"10","002","00","070","0008","0000","225","75","150","5","230","608","0","37.83","12.34"
"10","002","00","070","0008","0286","151","44","107","3","154","383","0","40.21","11.49"
"10","002","00","070","0008","0287","74","31","43","2","76","225","0","33.78","13.78"
"10","002","00","070","0009","0000","654","243","411","7","661","1818","0","36.36","13.37"
"10","002","00","070","0009","0288","282","118","164","3","285","921","0","30.94","12.81"
"10","002","00","070","0009","0289","372","125","247","4","376","897","0","41.92","13.94"
"10","002","00","070","0010","0000","467","191","276","12","479","1340","0","35.75","14.25"
"10","002","00","070","0010","0290","228","81","147","5","233","613","0","38.01","13.21"
"10","002","00","070","0010","0291","239","110","129","7","246","727","0","33.84","15.13"
"10","002","00","070","0011","0000","869","255","614","6","875","2277","0","38.43","11.20"
"10","002","00","070","0011","0292","286","86","200","2","288","782","0","36.83","11.00"
"10","002","00","070","0011","0293","365","104","261","2","367","923","0","39.76","11.27"
"10","002","00","070","0011","0294","218","65","153","2","220","572","0","38.46","11.36"
"10","002","00","070","0012","0000","888","303","585","10","898","2403","0","37.37","12.61"
"10","002","00","070","0012","0295","341","116","225","3","344","881","0","39.05","13.17"
"10","002","00","070","0012","0296","279","81","198","3","282","734","0","38.42","11.04"
"10","002","00","070","0012","0297","268","106","162","4","272","788","0","34.52","13.45"
"10","002","00","070","0013","0000","308","115","193","1","309","888","0","34.80","12.95"
"10","002","00","070","0013","0298","308","115","193","1","309","888","0","34.80","12.95"
"10","002","00","070","0014","0000","340","110","230","5","345","926","0","37.26","11.88"
"10","002","00","070","0014","0299","340","110","230","5","345","926","0","37.26","11.88"
"10","002","00","070","0015","0000","349","128","221","5","354","997","0","35.51","12.84"
"10","002","00","070","0015","0300","349","128","221","5","354","997","0","35.51","12.84"
"10","002","00","070","0016","0000","444","146","298","10","454","1363","0","33.31","10.71"
"10","002","00","070","0016","0301","213","67","146","4","217","662","0","32.78","10.12"
"10","002","00","070","0016","0302","231","79","152","6","237","701","0","33.81","11.27"
"10","002","00","080","0000","0000","17816","6275","11541","193","18009","45636","52999","39.46","13.75"
"10","002","00","080","0001","0000","469","134","335","4","473","1262","0","37.48","10.62"
"10","002","00","080","0001","0329","469","134","335","4","473","1262","0","37.48","10.62"
"10","002","00","080","0002","0000","694","223","471","11","705","1625","0","43.38","13.72"
"10","002","00","080","0002","0303","354","109","245","4","358","824","0","43.45","13.23"
"10","002","00","080","0002","0304","340","114","226","7","347","801","0","43.32","14.23"
"10","002","00","080","0003","0000","455","169","286","3","458","1136","0","40.32","14.88"
"10","002","00","080","0003","0305","455","169","286","3","458","1136","0","40.32","14.88"
"10","002","00","080","0004","0000","320","120","200","2","322","894","0","36.02","13.42"
"10","002","00","080","0004","0306","320","120","200","2","322","894","0","36.02","13.42"
"10","002","00","080","0005","0000","348","93","255","7","355","867","0","40.95","10.73"
"10","002","00","080","0005","0307","348","93","255","7","355","867","0","40.95","10.73"
"10","002","00","080","0006","0000","546","180","366","4","550","1409","0","39.03","12.78"
"10","002","00","080","0006","0308","546","180","366","4","550","1409","0","39.03","12.78"
"10","002","00","080","0007","0000","1092","385","707","13","1105","2951","0","37.44","13.05"
"10","002","00","080","0007","0309","403","124","279","5","408","953","0","42.81","13.01"
"10","002","00","080","0007","0310","329","122","207","4","333","1060","0","31.42","11.51"
"10","002","00","080","0007","0311","360","139","221","4","364","938","0","38.81","14.82"
"10","002","00","080","0008","0000","1173","418","755","10","1183","2943","0","40.20","14.20"
"10","002","00","080","0008","0312","359","116","243","7","366","963","0","38.01","12.05"
"10","002","00","080","0008","0313","413","145","268","2","415","1073","0","38.68","13.51"
"10","002","00","080","0008","0314","401","157","244","1","402","907","0","44.32","17.31"
"10","002","00","080","0009","0000","313","127","186","7","320","673","0","47.55","18.87"
"10","002","00","080","0009","0316","313","127","186","7","320","673","0","47.55","18.87"
"10","002","00","080","0010","0000","281","71","210","3","284","709","0","40.06","10.01"
"10","002","00","080","0010","0315","281","71","210","3","284","709","0","40.06","10.01"
"10","002","00","080","0011","0000","647","194","453","8","655","1498","0","43.72","12.95"
"10","002","00","080","0011","0317","647","194","453","8","655","1498","0","43.72","12.95"
"10","002","00","080","0012","0000","357","112","245","4","361","870","0","41.49","12.87"
"10","002","00","080","0012","0318","357","112","245","4","361","870","0","41.49","12.87"
"10","002","00","080","0013","0000","546","151","395","3","549","1512","0","36.31","9.99"
"10","002","00","080","0013","0319","274","81","193","2","276","732","0","37.70","11.07"
"10","002","00","080","0013","0320","272","70","202","1","273","780","0","35.00","8.97"
"10","002","00","080","0014","0000","206","68","138","2","208","474","0","43.88","14.35"
"10","002","00","080","0014","0321","206","68","138","2","208","474","0","43.88","14.35"
"10","002","00","080","0015","0000","1828","632","1196","21","1849","4962","0","37.26","12.74"
"10","002","00","080","0015","0322","471","150","321","4","475","1222","0","38.87","12.27"
"10","002","00","080","0015","0323","470","148","322","8","478","1246","0","38.36","11.88"
"10","002","00","080","0015","0324","484","163","321","6","490","1342","0","36.51","12.15"
"10","002","00","080","0015","0325","403","171","232","3","406","1152","0","35.24","14.84"
"10","002","00","080","0016","0000","1193","420","773","12","1205","3096","0","38.92","13.57"
"10","002","00","080","0016","0326","498","180","318","7","505","1283","0","39.36","14.03"
"10","002","00","080","0016","0327","362","126","236","3","365","928","0","39.33","13.58"
"10","002","00","080","0016","0328","333","114","219","2","335","885","0","37.85","12.88"
"10","002","00","080","0017","0000","1897","730","1167","26","1923","4619","0","41.63","15.80"
"10","002","00","080","0017","0330","594","228","366","9","603","1488","0","40.52","15.32"
"10","002","00","080","0017","0331","396","162","234","5","401","900","0","44.56","18.00"
"10","002","00","080","0017","0332","476","190","286","6","482","1095","0","44.02","17.35"
"10","002","00","080","0017","0333","431","150","281","6","437","1136","0","38.47","13.20"
"10","002","00","080","0018","0000","1523","608","915","14","1537","3769","0","40.78","16.13"
"10","002","00","080","0018","0334","536","240","296","5","541","1315","0","41.14","18.25"
"10","002","00","080","0018","0335","525","207","318","3","528","1252","0","42.17","16.53"
"10","002","00","080","0018","0336","462","161","301","6","468","1202","0","38.94","13.39"
"10","002","00","080","0019","0000","881","275","606","13","894","2557","0","34.96","10.75"
"10","002","00","080","0019","0337","444","147","297","6","450","1296","0","34.72","11.34"
"10","002","00","080","0019","0338","437","128","309","7","444","1261","0","35.21","10.15"
"10","002","00","080","0020","0000","367","156","211","4","371","1080","0","34.35","14.44"
"10","002","00","080","0020","0339","367","156","211","4","371","1080","0","34.35","14.44"
"10","002","00","080","0021","0000","927","337","590","10","937","2509","0","37.35","13.43"
"10","002","00","080","0021","0340","513","167","346","5","518","1263","0","41.01","13.22"
"10","002","00","080","0021","0341","414","170","244","5","419","1246","0","33.63","13.64"
"10","002","00","080","0022","0000","693","289","404","5","698","1680","0","41.55","17.20"
"10","002","00","080","0022","0342","418","158","260","4","422","982","0","42.97","16.09"
"10","002","00","080","0022","0343","275","131","144","1","276","698","0","39.54","18.77"
"10","002","00","080","0023","0000","749","287","462","5","754","1761","0","42.82","16.30"
"10","002","00","080","0023","0344","389","141","248","4","393","887","0","44.31","15.90"
"10","002","00","080","0023","0345","360","146","214","1","361","874","0","41.30","16.70"
"10","002","00","080","0024","0000","311","96","215","2","313","780","0","40.13","12.31"
"10","002","00","080","0024","0346","311","96","215","2","313","780","0","40.13","12.31"
"10","002","00","090","0000","0000","13707","5010","8697","109","13816","35466","40343","38.96","14.13"
"10","002","00","090","0001","0000","804","271","533","6","810","2052","0","39.47","13.21"
"10","002","00","090","0001","0347","416","148","268","1","417","1094","0","38.12","13.53"
"10","002","00","090","0001","0348","388","123","265","5","393","958","0","41.02","12.84"
"10","002","00","090","0002","0000","787","337","450","8","795","1872","0","42.47","18.00"
"10","002","00","090","0002","0349","375","176","199","5","380","917","0","41.44","19.19"
"10","002","00","090","0002","0350","412","161","251","3","415","955","0","43.46","16.86"
"10","002","00","090","0003","0000","1085","400","685","16","1101","2629","0","41.88","15.21"
"10","002","00","090","0003","0351","319","128","191","1","320","786","0","40.71","16.28"
"10","002","00","090","0003","0352","343","128","215","7","350","851","0","41.13","15.04"
"10","002","00","090","0003","0353","423","144","279","8","431","992","0","43.45","14.52"
"10","002","00","090","0004","0000","665","272","393","1","666","1563","0","42.61","17.40"
"10","002","00","090","0004","0354","343","147","196","1","344","771","0","44.62","19.07"
"10","002","00","090","0004","0355","322","125","197","0","322","792","0","40.66","15.78"
"10","002","00","090","0005","0000","502","177","325","2","504","1350","0","37.33","13.11"
"10","002","00","090","0005","0356","502","177","325","2","504","1350","0","37.33","13.11"
"10","002","00","090","0006","0000","1108","463","645","11","1119","2551","0","43.87","18.15"
"10","002","00","090","0006","0357","247","107","140","3","250","592","0","42.23","18.07"
"10","002","00","090","0006","0358","430","181","249","4","434","938","0","46.27","19.30"
"10","002","00","090","0006","0359","431","175","256","4","435","1021","0","42.61","17.14"
"10","002","00","090","0007","0000","740","265","475","6","746","1777","0","41.98","14.91"
"10","002","00","090","0007","0360","392","146","246","4","396","943","0","41.99","15.48"
"10","002","00","090","0007","0361","348","119","229","2","350","834","0","41.97","14.27"
"10","002","00","090","0008","0000","1351","539","812","9","1360","3725","0","36.51","14.47"
"10","002","00","090","0008","0362","328","129","199","0","328","951","0","34.49","13.56"
"10","002","00","090","0008","0363","376","157","219","4","380","948","0","40.08","16.56"
"10","002","00","090","0008","0364","312","133","179","2","314","941","0","33.37","14.13"
"10","002","00","090","0008","0365","335","120","215","3","338","885","0","38.19","13.56"
"10","002","00","090","0009","0000","1442","586","856","6","1448","3727","0","38.85","15.72"
"10","002","00","090","0009","0369","371","157","214","0","371","924","0","40.15","16.99"
"10","002","00","090","0009","0370","344","157","187","4","348","943","0","36.90","16.65"
"10","002","00","090","0009","0371","416","158","258","1","417","1038","0","40.17","15.22"
"10","002","00","090","0009","0372","311","114","197","1","312","822","0","37.96","13.87"
"10","002","00","090","0010","0000","1208","405","803","16","1224","3260","0","37.55","12.42"
"10","002","00","090","0010","0366","446","152","294","5","451","1124","0","40.12","13.52"
"10","002","00","090","0010","0367","330","120","210","4","334","912","0","36.62","13.16"
"10","002","00","090","0010","0368","432","133","299","7","439","1224","0","35.87","10.87"
"10","002","00","090","0011","0000","641","204","437","2","643","1654","0","38.88","12.33"
"10","002","00","090","0011","0373","342","83","259","1","343","912","0","37.61","9.10"
"10","002","00","090","0011","0374","299","121","178","1","300","742","0","40.43","16.31"
"10","002","00","090","0012","0000","553","200","353","4","557","1417","0","39.31","14.11"
"10","002","00","090","0012","0375","246","104","142","1","247","625","0","39.52","16.64"
"10","002","00","090","0012","0376","307","96","211","3","310","792","0","39.14","12.12"
"10","002","00","090","0013","0000","674","229","445","8","682","1951","0","34.96","11.74"
"10","002","00","090","0013","0377","330","109","221","3","333","912","0","36.51","11.95"
"10","002","00","090","0013","0378","344","120","224","5","349","1039","0","33.59","11.55"
"10","002","00","090","0014","0000","1147","348","799","8","1155","3177","0","36.36","10.95"
"10","002","00","090","0014","0379","334","106","228","3","337","1003","0","33.60","10.57"
"10","002","00","090","0014","0380","478","144","334","4","482","1257","0","38.35","11.46"
"10","002","00","090","0014","0381","335","98","237","1","336","917","0","36.64","10.69"
"10","002","00","090","0015","0000","1000","314","686","6","1006","2761","0","36.44","11.37"
"10","002","00","090","0015","0382","294","81","213","3","297","852","0","34.86","9.51"
"10","002","00","090","0015","0383","436","136","300","3","439","1221","0","35.95","11.14"
"10","002","00","090","0015","0384","270","97","173","0","270","688","0","39.24","14.10"
"10","002","00","100","0000","0000","7142","2614","4528","74","7216","19047","21219","37.89","13.72"
"10","002","00","100","0001","0000","83","43","40","0","83","207","0","40.10","20.77"
"10","002","00","100","0001","0385","83","43","40","0","83","207","0","40.10","20.77"
"10","002","00","100","0002","0000","147","61","86","3","150","498","0","30.12","12.25"
"10","002","00","100","0002","0386","147","61","86","3","150","498","0","30.12","12.25"
"10","002","00","100","0003","0000","234","80","154","5","239","712","0","33.57","11.24"
"10","002","00","100","0003","0387","234","80","154","5","239","712","0","33.57","11.24"
"10","002","00","100","0004","0000","243","74","169","5","248","553","0","44.85","13.38"
"10","002","00","100","0004","0391","243","74","169","5","248","553","0","44.85","13.38"
"10","002","00","100","0005","0000","158","72","86","1","159","448","0","35.49","16.07"
"10","002","00","100","0005","0392","158","72","86","1","159","448","0","35.49","16.07"
"10","002","00","100","0006","0000","407","178","229","1","408","1133","0","36.01","15.71"
"10","002","00","100","0006","0393","407","178","229","1","408","1133","0","36.01","15.71"
"10","002","00","100","0007","0000","427","171","256","7","434","1145","0","37.90","14.93"
"10","002","00","100","0007","0394","427","171","256","7","434","1145","0","37.90","14.93"
"10","002","00","100","0008","0000","305","124","181","5","310","870","0","35.63","14.25"
"10","002","00","100","0008","0395","305","124","181","5","310","870","0","35.63","14.25"
"10","002","00","100","0009","0000","394","142","252","3","397","1358","0","29.23","10.46"
"10","002","00","100","0009","0396","394","142","252","3","397","1358","0","29.23","10.46"
"10","002","00","100","0010","0000","1541","573","968","10","1551","4328","0","35.84","13.24"
"10","002","00","100","0010","0398","347","122","225","5","352","990","0","35.56","12.32"
"10","002","00","100","0010","0399","383","164","219","2","385","1075","0","35.81","15.26"
"10","002","00","100","0010","0400","418","150","268","1","419","1123","0","37.31","13.36"
"10","002","00","100","0010","0401","393","137","256","2","395","1140","0","34.65","12.02"
"10","002","00","100","0011","0000","331","102","229","6","337","890","0","37.87","11.46"
"10","002","00","100","0011","0397","331","102","229","6","337","890","0","37.87","11.46"
"10","002","00","100","0012","0000","238","82","156","3","241","586","0","41.13","13.99"
"10","002","00","100","0012","0388","238","82","156","3","241","586","0","41.13","13.99"
"10","002","00","100","0013","0000","188","86","102","4","192","525","0","36.57","16.38"
"10","002","00","100","0013","0389","188","86","102","4","192","525","0","36.57","16.38"
"10","002","00","100","0014","0000","280","107","173","5","285","731","0","38.99","14.64"
"10","002","00","100","0014","0390","280","107","173","5","285","731","0","38.99","14.64"
"10","002","00","100","0015","0000","523","172","351","3","526","1266","0","41.55","13.59"
"10","002","00","100","0015","0402","523","172","351","3","526","1266","0","41.55","13.59"
"10","002","00","100","0016","0000","287","108","179","3","290","758","0","38.26","14.25"
"10","002","00","100","0016","0403","287","108","179","3","290","758","0","38.26","14.25"
"10","002","00","100","0017","0000","749","247","502","5","754","1581","0","47.69","15.62"
"10","002","00","100","0017","0404","398","139","259","3","401","813","0","49.32","17.10"
"10","002","00","100","0017","0405","351","108","243","2","353","768","0","45.96","14.06"
"10","002","00","100","0018","0000","607","192","415","5","612","1458","0","41.98","13.17"
"10","002","00","100","0018","0406","269","76","193","2","271","668","0","40.57","11.38"
"10","002","00","100","0018","0407","338","116","222","3","341","790","0","43.16","14.68"
"10","002","00","110","0000","0000","1367","1094","273","20","1387","4915","6099","28.22","22.26"
"10","002","00","110","0001","0000","287","251","36","3","290","923","0","31.42","27.19"
"10","002","00","110","0001","0408","287","251","36","3","290","923","0","31.42","27.19"
"10","002","00","110","0002","0000","187","169","18","2","189","629","0","30.05","26.87"
"10","002","00","110","0002","0409","187","169","18","2","189","629","0","30.05","26.87"
"10","002","00","110","0003","0000","200","139","61","4","204","701","0","29.10","19.83"
"10","002","00","110","0003","0410","200","139","61","4","204","701","0","29.10","19.83"
"10","002","00","110","0004","0000","99","56","43","1","100","262","0","38.17","21.37"
"10","002","00","110","0004","0411","99","56","43","1","100","262","0","38.17","21.37"
"10","002","00","110","0005","0000","98","79","19","1","99","325","0","30.46","24.31"
"10","002","00","110","0005","0412","98","79","19","1","99","325","0","30.46","24.31"
"10","002","00","110","0006","0000","111","97","14","2","113","392","0","28.83","24.74"
"10","002","00","110","0006","0413","111","97","14","2","113","392","0","28.83","24.74"
"10","002","00","110","0007","0000","17","11","6","1","18","54","0","33.33","20.37"
"10","002","00","110","0007","0414","17","11","6","1","18","54","0","33.33","20.37"
"10","002","00","110","0008","0000","184","156","28","4","188","763","0","24.64","20.45"
"10","002","00","110","0008","0416","184","156","28","4","188","763","0","24.64","20.45"
"10","002","00","110","0009","0000","126","93","33","2","128","659","0","19.42","14.11"
"10","002","00","110","0009","0417","126","93","33","2","128","659","0","19.42","14.11"
"10","002","00","110","0010","0000","58","43","15","0","58","207","0","28.02","20.77"
"10","002","00","110","0010","0415","58","43","15","0","58","207","0","28.02","20.77"
"10","002","00","120","0000","0000","1261","1094","167","20","1281","4564","5956","28.07","23.97"
"10","002","00","120","0001","0000","300","255","45","5","305","1156","0","26.38","22.06"
"10","002","00","120","0001","0419","300","255","45","5","305","1156","0","26.38","22.06"
"10","002","00","120","0002","0000","236","208","28","3","239","955","0","25.03","21.78"
"10","002","00","120","0002","0420","236","208","28","3","239","955","0","25.03","21.78"
"10","002","00","120","0003","0000","153","132","21","0","153","435","0","35.17","30.34"
"10","002","00","120","0003","0418","153","132","21","0","153","435","0","35.17","30.34"
"10","002","00","120","0004","0000","86","82","4","2","88","406","0","21.67","20.20"
"10","002","00","120","0004","0421","86","82","4","2","88","406","0","21.67","20.20"
"10","002","00","120","0005","0000","131","107","24","2","133","430","0","30.93","24.88"
"10","002","00","120","0005","0422","131","107","24","2","133","430","0","30.93","24.88"
"10","002","00","120","0006","0000","125","104","21","2","127","475","0","26.74","21.89"
"10","002","00","120","0006","0423","125","104","21","2","127","475","0","26.74","21.89"
"10","002","00","120","0007","0000","230","206","24","6","236","707","0","33.38","29.14"
"10","002","00","120","0007","0424","230","206","24","6","236","707","0","33.38","29.14"
"10","015","00","000","0000","0000","97787","68191","29596","1274","99061","275091","322836","36.01","24.79"
"10","015","00","010","0000","0000","32689","21962","10727","295","32984","83830","101853","39.35","26.20"
"10","015","00","010","0001","0000","624","416","208","2","626","1592","0","39.32","26.13"
"10","015","00","010","0001","0022","369","240","129","0","369","821","0","44.95","29.23"
"10","015","00","010","0001","0023","255","176","79","2","257","771","0","33.33","22.83"
"10","015","00","010","0002","0000","826","565","261","12","838","1985","0","42.22","28.46"
"10","015","00","010","0002","0016","464","313","151","6","470","1114","0","42.19","28.10"
"10","015","00","010","0002","0017","362","252","110","6","368","871","0","42.25","28.93"
"10","015","00","010","0003","0000","169","107","62","0","169","422","0","40.05","25.36"
"10","015","00","010","0003","0027","169","107","62","0","169","422","0","40.05","25.36"
"10","015","00","010","0004","0000","271","162","109","4","275","664","0","41.42","24.40"
"10","015","00","010","0004","0033","271","162","109","4","275","664","0","41.42","24.40"
"10","015","00","010","0005","0000","206","130","76","0","206","558","0","36.92","23.30"
"10","015","00","010","0005","0035","206","130","76","0","206","558","0","36.92","23.30"
"10","015","00","010","0006","0000","1094","697","397","11","1105","2927","0","37.75","23.81"
"10","015","00","010","0006","0037","365","242","123","6","371","901","0","41.18","26.86"
"10","015","00","010","0006","0038","335","214","121","1","336","1036","0","32.43","20.66"
"10","015","00","010","0006","0039","394","241","153","4","398","990","0","40.20","24.34"
"10","015","00","010","0007","0000","577","337","240","6","583","1769","0","32.96","19.05"
"10","015","00","010","0007","0059","256","144","112","2","258","947","0","27.24","15.21"
"10","015","00","010","0007","0060","321","193","128","4","325","822","0","39.54","23.48"
"10","015","00","010","0008","0000","1250","811","439","11","1261","3186","0","39.58","25.46"
"10","015","00","010","0008","0056","417","271","146","4","421","985","0","42.74","27.51"
"10","015","00","010","0008","0057","436","300","136","4","440","1125","0","39.11","26.67"
"10","015","00","010","0008","0058","397","240","157","3","400","1076","0","37.17","22.30"
"10","015","00","010","0009","0000","655","442","213","4","659","1486","0","44.35","29.74"
"10","015","00","010","0009","0001","328","235","93","1","329","736","0","44.70","31.93"
"10","015","00","010","0009","0002","327","207","120","3","330","750","0","44.00","27.60"
"10","015","00","010","0010","0000","805","677","128","14","819","2020","0","40.54","33.51"
"10","015","00","010","0010","0006","164","134","30","0","164","473","0","34.67","28.33"
"10","015","00","010","0010","0007","347","276","71","10","357","842","0","42.40","32.78"
"10","015","00","010","0010","0008","294","267","27","4","298","705","0","42.27","37.87"
"10","015","00","010","0012","0000","197","131","66","1","198","464","0","42.67","28.23"
"10","015","00","010","0012","0034","197","131","66","1","198","464","0","42.67","28.23"
"10","015","00","010","0013","0000","227","135","92","1","228","492","0","46.34","27.44"
"10","015","00","010","0013","0032","227","135","92","1","228","492","0","46.34","27.44"
"10","015","00","010","0014","0000","1331","873","458","11","1342","3477","0","38.60","25.11"
"10","015","00","010","0014","0042","395","258","137","4","399","983","0","40.59","26.25"
"10","015","00","010","0014","0043","334","226","108","1","335","903","0","37.10","25.03"
"10","015","00","010","0014","0044","325","212","113","3","328","796","0","41.21","26.63"
"10","015","00","010","0014","0045","277","177","100","3","280","795","0","35.22","22.26"
"10","015","00","010","0015","0000","304","186","118","1","305","821","0","37.15","22.66"
"10","015","00","010","0015","0061","304","186","118","1","305","821","0","37.15","22.66"
"10","015","00","010","0016","0000","1958","1307","651","18","1976","4822","0","40.98","27.10"
"10","015","00","010","0016","0078","373","242","131","8","381","924","0","41.23","26.19"
"10","015","00","010","0016","0079","355","236","119","1","356","960","0","37.08","24.58"
"10","015","00","010","0016","0080","424","293","131","1","425","958","0","44.36","30.58"
"10","015","00","010","0016","0081","363","237","126","5","368","924","0","39.83","25.65"
"10","015","00","010","0016","0082","443","299","144","3","446","1056","0","42.23","28.31"
"10","015","00","010","0017","0000","1534","1088","446","14","1548","3629","0","42.66","29.98"
"10","015","00","010","0017","0018","392","280","112","1","393","908","0","43.28","30.84"
"10","015","00","010","0017","0019","406","299","107","1","407","906","0","44.92","33.00"
"10","015","00","010","0017","0020","352","234","118","6","358","887","0","40.36","26.38"
"10","015","00","010","0017","0021","384","275","109","6","390","928","0","42.03","29.63"
"10","015","00","010","0018","0000","1257","890","367","12","1269","3092","0","41.04","28.78"
"10","015","00","010","0018","0003","418","299","119","4","422","996","0","42.37","30.02"
"10","015","00","010","0018","0004","395","289","106","3","398","987","0","40.32","29.28"
"10","015","00","010","0018","0005","444","302","142","5","449","1109","0","40.49","27.23"
"10","015","00","010","0019","0000","423","240","183","7","430","1077","0","39.93","22.28"
"10","015","00","010","0019","0028","423","240","183","7","430","1077","0","39.93","22.28"
"10","015","00","010","0020","0000","214","119","95","2","216","537","0","40.22","22.16"
"10","015","00","010","0020","0030","214","119","95","2","216","537","0","40.22","22.16"
"10","015","00","010","0021","0000","713","453","260","10","723","1821","0","39.70","24.88"
"10","015","00","010","0021","0040","333","217","116","6","339","853","0","39.74","25.44"
"10","015","00","010","0021","0041","380","236","144","4","384","968","0","39.67","24.38"
"10","015","00","010","0022","0000","466","321","145","5","471","1214","0","38.80","26.44"
"10","015","00","010","0022","0063","466","321","145","5","471","1214","0","38.80","26.44"
"10","015","00","010","0023","0000","1020","647","373","6","1026","2759","0","37.19","23.45"
"10","015","00","010","0023","0069","289","183","106","0","289","782","0","36.96","23.40"
"10","015","00","010","0023","0070","380","237","143","5","385","977","0","39.41","24.26"
"10","015","00","010","0023","0071","351","227","124","1","352","1000","0","35.20","22.70"
"10","015","00","010","0024","0000","642","440","202","4","646","1757","0","36.77","25.04"
"10","015","00","010","0024","0076","294","207","87","2","296","766","0","38.64","27.02"
"10","015","00","010","0024","0077","348","233","115","2","350","991","0","35.32","23.51"
"10","015","00","010","0025","0000","379","261","118","4","383","932","0","41.09","28.00"
"10","015","00","010","0025","0009","379","261","118","4","383","932","0","41.09","28.00"
"10","015","00","010","0026","0000","239","169","70","1","240","616","0","38.96","27.44"
"10","015","00","010","0026","0024","239","169","70","1","240","616","0","38.96","27.44"
"10","015","00","010","0027","0000","209","153","56","0","209","549","0","38.07","27.87"
"10","015","00","010","0027","0026","209","153","56","0","209","549","0","38.07","27.87"
"10","015","00","010","0028","0000","333","207","126","2","335","763","0","43.91","27.13"
"10","015","00","010","0028","0031","333","207","126","2","335","763","0","43.91","27.13"
"10","015","00","010","0029","0000","1049","658","391","6","1055","2643","0","39.92","24.90"
"10","015","00","010","0029","0053","350","214","136","1","351","828","0","42.39","25.85"
"10","015","00","010","0029","0054","366","223","143","4","370","874","0","42.33","25.51"
"10","015","00","010","0029","0055","333","221","112","1","334","941","0","35.49","23.49"
"10","015","00","010","0030","0000","198","131","67","2","200","496","0","40.32","26.41"
"10","015","00","010","0030","0062","198","131","67","2","200","496","0","40.32","26.41"
"10","015","00","010","0031","0000","775","489","286","12","787","1849","0","42.56","26.45"
"10","015","00","010","0031","0067","378","249","129","7","385","942","0","40.87","26.43"
"10","015","00","010","0031","0068","397","240","157","5","402","907","0","44.32","26.46"
"10","015","00","010","0032","0000","402","237","165","6","408","1069","0","38.17","22.17"
"10","015","00","010","0032","0087","402","237","165","6","408","1069","0","38.17","22.17"
"10","015","00","010","0033","0000","1217","912","305","12","1229","3012","0","40.80","30.28"
"10","015","00","010","0033","0010","360","279","81","5","365","1006","0","36.28","27.73"
"10","015","00","010","0033","0011","411","299","112","2","413","995","0","41.51","30.05"
"10","015","00","010","0033","0012","446","334","112","5","451","1011","0","44.61","33.04"
"10","015","00","010","0034","0000","222","123","99","0","222","584","0","38.01","21.06"
"10","015","00","010","0034","0025","222","123","99","0","222","584","0","38.01","21.06"
"10","015","00","010","0035","0000","173","120","53","0","173","419","0","41.29","28.64"
"10","015","00","010","0035","0029","173","120","53","0","173","419","0","41.29","28.64"
"10","015","00","010","0036","0000","304","203","101","2","306","817","0","37.45","24.85"
"10","015","00","010","0036","0036","304","203","101","2","306","817","0","37.45","24.85"
"10","015","00","010","0037","0000","1974","1320","654","24","1998","5198","0","38.44","25.39"
"10","015","00","010","0037","0048","356","231","125","1","357","903","0","39.53","25.58"
"10","015","00","010","0037","0049","334","237","97","3","337","929","0","36.28","25.51"
"10","015","00","010","0037","0050","400","261","139","12","412","1165","0","35.36","22.40"
"10","015","00","010","0037","0051","442","294","148","3","445","1198","0","37.15","24.54"
"10","015","00","010","0037","0052","442","297","145","5","447","1003","0","44.57","29.61"
"10","015","00","010","0038","0000","869","550","319","5","874","2120","0","41.23","25.94"
"10","015","00","010","0038","0065","407","266","141","1","408","1061","0","38.45","25.07"
"10","015","00","010","0038","0066","462","284","178","4","466","1059","0","44.00","26.82"
"10","015","00","010","0039","0000","317","196","121","0","317","816","0","38.85","24.02"
"10","015","00","010","0039","0064","317","196","121","0","317","816","0","38.85","24.02"
"10","015","00","010","0040","0000","466","330","136","4","470","1480","0","31.76","22.30"
"10","015","00","010","0040","0092","219","164","55","0","219","733","0","29.88","22.37"
"10","015","00","010","0040","0093","247","166","81","4","251","747","0","33.60","22.22"
"10","015","00","010","0041","0000","1616","1124","492","12","1628","4171","0","39.03","26.95"
"10","015","00","010","0041","0083","403","254","149","1","404","1105","0","36.56","22.99"
"10","015","00","010","0041","0084","392","271","121","2","394","1009","0","39.05","26.86"
"10","015","00","010","0041","0085","423","293","130","3","426","1053","0","40.46","27.83"
"10","015","00","010","0041","0086","398","306","92","6","404","1004","0","40.24","30.48"
"10","015","00","010","0042","0000","856","577","279","10","866","2412","0","35.90","23.92"
"10","015","00","010","0042","0046","454","308","146","7","461","1213","0","38.00","25.39"
"10","015","00","010","0042","0047","402","269","133","3","405","1199","0","33.78","22.44"
"10","015","00","010","0043","0000","1235","824","411","10","1245","3671","0","33.91","22.45"
"10","015","00","010","0043","0072","313","216","97","2","315","907","0","34.73","23.81"
"10","015","00","010","0043","0073","314","205","109","2","316","886","0","35.67","23.14"
"10","015","00","010","0043","0074","297","194","103","2","299","938","0","31.88","20.68"
"10","015","00","010","0043","0075","311","209","102","4","315","940","0","33.51","22.23"
"10","015","00","010","0044","0000","1687","1178","509","11","1698","4204","0","40.39","28.02"
"10","015","00","010","0044","0088","465","328","137","1","466","1004","0","46.41","32.67"
"10","015","00","010","0044","0089","428","287","141","3","431","1116","0","38.62","25.72"
"10","015","00","010","0044","0090","392","291","101","4","396","1140","0","34.74","25.53"
"10","015","00","010","0044","0091","402","272","130","3","405","944","0","42.90","28.81"
"10","015","00","010","0045","0000","1406","1026","380","16","1422","3438","0","41.36","29.84"
"10","015","00","010","0045","0013","419","273","146","7","426","1087","0","39.19","25.11"
"10","015","00","010","0045","0014","444","327","117","3","447","1107","0","40.38","29.54"
"10","015","00","010","0045","0015","543","426","117","6","549","1244","0","44.13","34.24"
"10","015","00","020","0000","0000","3571","2539","1032","62","3633","9479","10764","38.33","26.79"
"10","015","00","020","0001","0000","435","307","128","9","444","1166","0","38.08","26.33"
"10","015","00","020","0001","0221","435","307","128","9","444","1166","0","38.08","26.33"
"10","015","00","020","0002","0000","261","206","55","5","266","631","0","42.16","32.65"
"10","015","00","020","0002","0222","261","206","55","5","266","631","0","42.16","32.65"
"10","015","00","020","0003","0000","262","178","84","1","263","575","0","45.74","30.96"
"10","015","00","020","0003","0223","262","178","84","1","263","575","0","45.74","30.96"
"10","015","00","020","0004","0000","408","317","91","4","412","1075","0","38.33","29.49"
"10","015","00","020","0004","0224","408","317","91","4","412","1075","0","38.33","29.49"
"10","015","00","020","0005","0000","466","360","106","11","477","1332","0","35.81","27.03"
"10","015","00","020","0005","0225","230","176","54","10","240","745","0","32.21","23.62"
"10","015","00","020","0005","0226","236","184","52","1","237","587","0","40.37","31.35"
"10","015","00","020","0006","0000","169","129","40","6","175","539","0","32.47","23.93"
"10","015","00","020","0006","0227","95","59","36","6","101","301","0","33.55","19.60"
"10","015","00","020","0006","0228","74","70","4","0","74","238","0","31.09","29.41"
"10","015","00","020","0007","0000","457","305","152","6","463","1250","0","37.04","24.40"
"10","015","00","020","0007","0229","248","150","98","5","253","730","0","34.66","20.55"
"10","015","00","020","0007","0230","209","155","54","1","210","520","0","40.38","29.81"
"10","015","00","020","0008","0000","205","112","93","3","208","538","0","38.66","20.82"
"10","015","00","020","0008","0231","205","112","93","3","208","538","0","38.66","20.82"
"10","015","00","020","0009","0000","210","137","73","1","211","524","0","40.27","26.15"
"10","015","00","020","0009","0232","210","137","73","1","211","524","0","40.27","26.15"
"10","015","00","020","0010","0000","335","237","98","7","342","793","0","43.13","29.89"
"10","015","00","020","0010","0233","335","237","98","7","342","793","0","43.13","29.89"
"10","015","00","020","0011","0000","320","215","105","8","328","959","0","34.20","22.42"
"10","015","00","020","0011","0234","320","215","105","8","328","959","0","34.20","22.42"
"10","015","00","020","0012","0000","43","36","7","1","44","97","0","45.36","37.11"
"10","015","00","020","0012","0235","43","36","7","1","44","97","0","45.36","37.11"
"10","015","00","030","0000","0000","5908","4256","1652","111","6019","19990","23121","30.11","21.29"
"10","015","00","030","0001","0000","1740","1200","540","22","1762","5047","0","34.91","23.78"
"10","015","00","030","0001","0280","322","226","96","5","327","1028","0","31.81","21.98"
"10","015","00","030","0001","0281","320","236","84","3","323","870","0","37.13","27.13"
"10","015","00","030","0001","0282","207","119","88","3","210","607","0","34.60","19.60"
"10","015","00","030","0001","0283","296","207","89","6","302","858","0","35.20","24.13"
"10","015","00","030","0001","0284","257","183","74","1","258","761","0","33.90","24.05"
"10","015","00","030","0001","0285","338","229","109","4","342","923","0","37.05","24.81"
"10","015","00","030","0002","0000","474","341","133","8","482","1587","0","30.37","21.49"
"10","015","00","030","0002","0287","250","185","65","3","253","817","0","30.97","22.64"
"10","015","00","030","0002","0288","224","156","68","5","229","770","0","29.74","20.26"
"10","015","00","030","0003","0000","334","241","93","6","340","1191","0","28.55","20.24"
"10","015","00","030","0003","0291","159","124","35","5","164","508","0","32.28","24.41"
"10","015","00","030","0003","0292","175","117","58","1","176","683","0","25.77","17.13"
"10","015","00","030","0004","0000","339","260","79","1","340","1281","0","26.54","20.30"
"10","015","00","030","0004","0289","184","127","57","1","185","536","0","34.51","23.69"
"10","015","00","030","0004","0290","155","133","22","0","155","745","0","20.81","17.85"
"10","015","00","030","0005","0000","446","289","157","5","451","1150","0","39.22","25.13"
"10","015","00","030","0005","0286","446","289","157","5","451","1150","0","39.22","25.13"
"10","015","00","030","0006","0000","312","223","89","6","318","1204","0","26.41","18.52"
"10","015","00","030","0006","0293","312","223","89","6","318","1204","0","26.41","18.52"
"10","015","00","030","0007","0000","148","113","35","4","152","606","0","25.08","18.65"
"10","015","00","030","0007","0294","148","113","35","4","152","606","0","25.08","18.65"
"10","015","00","030","0008","0000","281","228","53","6","287","963","0","29.80","23.68"
"10","015","00","030","0008","0295","281","228","53","6","287","963","0","29.80","23.68"
"10","015","00","030","0009","0000","153","113","40","3","156","521","0","29.94","21.69"
"10","015","00","030","0009","0296","153","113","40","3","156","521","0","29.94","21.69"
"10","015","00","030","0010","0000","401","305","96","9","410","1500","0","27.33","20.33"
"10","015","00","030","0010","0297","251","195","56","4","255","956","0","26.67","20.40"
"10","015","00","030","0010","0298","150","110","40","5","155","544","0","28.49","20.22"
"10","015","00","030","0011","0000","303","236","67","13","316","1449","0","21.81","16.29"
"10","015","00","030","0011","0299","91","76","15","2","93","412","0","22.57","18.45"
"10","015","00","030","0011","0300","212","160","52","11","223","1037","0","21.50","15.43"
"10","015","00","030","0012","0000","248","176","72","14","262","838","0","31.26","21.00"
"10","015","00","030","0012","0301","248","176","72","14","262","838","0","31.26","21.00"
"10","015","00","030","0013","0000","205","164","41","7","212","750","0","28.27","21.87"
"10","015","00","030","0013","0302","205","164","41","7","212","750","0","28.27","21.87"
"10","015","00","030","0014","0000","241","154","87","5","246","864","0","28.47","17.82"
"10","015","00","030","0014","0303","241","154","87","5","246","864","0","28.47","17.82"
"10","015","00","030","0015","0000","283","213","70","2","285","1039","0","27.43","20.50"
"10","015","00","030","0015","0304","283","213","70","2","285","1039","0","27.43","20.50"
"10","015","00","040","0000","0000","5941","4204","1737","91","6032","17209","20015","35.05","24.43"
"10","015","00","040","0001","0000","503","309","194","8","511","1249","0","40.91","24.74"
"10","015","00","040","0001","0094","130","84","46","1","131","336","0","38.99","25.00"
"10","015","00","040","0001","0095","373","225","148","7","380","913","0","41.62","24.64"
"10","015","00","040","0002","0000","306","138","168","12","318","901","0","35.29","15.32"
"10","015","00","040","0002","0096","196","93","103","8","204","598","0","34.11","15.55"
"10","015","00","040","0002","0097","110","45","65","4","114","303","0","37.62","14.85"
"10","015","00","040","0003","0000","804","557","247","14","818","2413","0","33.90","23.08"
"10","015","00","040","0003","0098","378","269","109","7","385","1128","0","34.13","23.85"
"10","015","00","040","0003","0099","426","288","138","7","433","1285","0","33.70","22.41"
"10","015","00","040","0004","0000","1442","1033","409","15","1457","4113","0","35.42","25.12"
"10","015","00","040","0004","0103","309","226","83","5","314","904","0","34.73","25.00"
"10","015","00","040","0004","0104","396","273","123","3","399","997","0","40.02","27.38"
"10","015","00","040","0004","0105","381","277","104","2","383","1026","0","37.33","27.00"
"10","015","00","040","0004","0106","356","257","99","5","361","1186","0","30.44","21.67"
"10","015","00","040","0005","0000","370","242","128","2","372","992","0","37.50","24.40"
"10","015","00","040","0005","0107","370","242","128","2","372","992","0","37.50","24.40"
"10","015","00","040","0006","0000","1245","932","313","15","1260","3787","0","33.27","24.61"
"10","015","00","040","0006","0108","317","212","105","1","318","988","0","32.19","21.46"
"10","015","00","040","0006","0109","326","258","68","5","331","936","0","35.36","27.56"
"10","015","00","040","0006","0110","310","245","65","6","316","860","0","36.74","28.49"
"10","015","00","040","0006","0111","292","217","75","3","295","1003","0","29.41","21.64"
"10","015","00","040","0007","0000","390","305","85","8","398","1243","0","32.02","24.54"
"10","015","00","040","0007","0112","271","224","47","5","276","887","0","31.12","25.25"
"10","015","00","040","0007","0113","119","81","38","3","122","356","0","34.27","22.75"
"10","015","00","040","0008","0000","881","688","193","17","898","2511","0","35.76","27.40"
"10","015","00","040","0008","0100","359","281","78","11","370","986","0","37.53","28.50"
"10","015","00","040","0008","0101","420","331","89","5","425","1178","0","36.08","28.10"
"10","015","00","040","0008","0102","102","76","26","1","103","347","0","29.68","21.90"
"10","015","00","050","0000","0000","27181","18521","8660","276","27457","72533","83515","37.85","25.53"
"10","015","00","050","0001","0000","2909","1906","1003","25","2934","7104","0","41.30","26.83"
"10","015","00","050","0001","0170","395","249","146","2","397","1059","0","37.49","23.51"
"10","015","00","050","0001","0171","457","319","138","5","462","1027","0","44.99","31.06"
"10","015","00","050","0001","0172","427","272","155","1","428","1042","0","41.07","26.10"
"10","015","00","050","0001","0173","395","237","158","6","401","1013","0","39.59","23.40"
"10","015","00","050","0001","0174","454","317","137","1","455","1049","0","43.37","30.22"
"10","015","00","050","0001","0175","392","256","136","6","398","937","0","42.48","27.32"
"10","015","00","050","0001","0176","389","256","133","4","393","977","0","40.23","26.20"
"10","015","00","050","0002","0000","2015","1297","718","14","2029","4909","0","41.33","26.42"
"10","015","00","050","0002","0177","534","360","174","4","538","1239","0","43.42","29.06"
"10","015","00","050","0002","0178","492","321","171","5","497","1255","0","39.60","25.58"
"10","015","00","050","0002","0179","493","320","173","2","495","1245","0","39.76","25.70"
"10","015","00","050","0002","0180","496","296","200","3","499","1170","0","42.65","25.30"
"10","015","00","050","0003","0000","1271","795","476","30","1301","3726","0","34.92","21.34"
"10","015","00","050","0003","0136","471","274","197","9","480","1232","0","38.96","22.24"
"10","015","00","050","0003","0137","446","268","178","9","455","1309","0","34.76","20.47"
"10","015","00","050","0003","0138","354","253","101","12","366","1185","0","30.89","21.35"
"10","015","00","050","0004","0000","1641","1111","530","12","1653","4253","0","38.87","26.12"
"10","015","00","050","0004","0132","392","250","142","4","396","1039","0","38.11","24.06"
"10","015","00","050","0004","0133","444","310","134","1","445","1027","0","43.33","30.19"
"10","015","00","050","0004","0134","387","271","116","4","391","1045","0","37.42","25.93"
"10","015","00","050","0004","0135","418","280","138","3","421","1142","0","36.87","24.52"
"10","015","00","050","0005","0000","2605","1777","828","22","2627","6951","0","37.79","25.56"
"10","015","00","050","0005","0139","544","390","154","4","548","1273","0","43.05","30.64"
"10","015","00","050","0005","0140","445","300","145","6","451","1141","0","39.53","26.29"
"10","015","00","050","0005","0141","396","269","127","1","397","1166","0","34.05","23.07"
"10","015","00","050","0005","0142","392","236","156","1","393","1014","0","38.76","23.27"
"10","015","00","050","0005","0143","452","316","136","7","459","1373","0","33.43","23.02"
"10","015","00","050","0005","0144","376","266","110","3","379","984","0","38.52","27.03"
"10","015","00","050","0006","0000","2025","1404","621","18","2043","5283","0","38.67","26.58"
"10","015","00","050","0006","0145","473","314","159","1","474","1215","0","39.01","25.84"
"10","015","00","050","0006","0146","508","355","153","2","510","1220","0","41.80","29.10"
"10","015","00","050","0006","0147","314","222","92","2","316","814","0","38.82","27.27"
"10","015","00","050","0006","0148","316","222","94","6","322","954","0","33.75","23.27"
"10","015","00","050","0006","0149","414","291","123","7","421","1080","0","38.98","26.94"
"10","015","00","050","0007","0000","1176","746","430","17","1193","2931","0","40.70","25.45"
"10","015","00","050","0007","0150","397","268","129","9","406","1090","0","37.25","24.59"
"10","015","00","050","0007","0151","368","233","135","5","373","889","0","41.96","26.21"
"10","015","00","050","0007","0152","411","245","166","3","414","952","0","43.49","25.74"
"10","015","00","050","0008","0000","604","355","249","10","614","1568","0","39.16","22.64"
"10","015","00","050","0008","0153","309","164","145","2","311","801","0","38.83","20.47"
"10","015","00","050","0008","0154","295","191","104","8","303","767","0","39.50","24.90"
"10","015","00","050","0009","0000","415","321","94","4","419","1280","0","32.73","25.08"
"10","015","00","050","0009","0155","415","321","94","4","419","1280","0","32.73","25.08"
"10","015","00","050","0010","0000","1008","733","275","10","1018","2922","0","34.84","25.09"
"10","015","00","050","0010","0156","382","268","114","2","384","908","0","42.29","29.52"
"10","015","00","050","0010","0157","266","201","65","6","272","914","0","29.76","21.99"
"10","015","00","050","0010","0158","360","264","96","2","362","1100","0","32.91","24.00"
"10","015","00","050","0011","0000","1218","852","366","12","1230","3170","0","38.80","26.88"
"10","015","00","050","0011","0159","391","278","113","2","393","947","0","41.50","29.36"
"10","015","00","050","0011","0160","392","263","129","4","396","989","0","40.04","26.59"
"10","015","00","050","0011","0161","435","311","124","6","441","1234","0","35.74","25.20"
"10","015","00","050","0012","0000","1477","1033","444","9","1486","4138","0","35.91","24.96"
"10","015","00","050","0012","0162","379","280","99","3","382","1120","0","34.11","25.00"
"10","015","00","050","0012","0163","455","335","120","2","457","1149","0","39.77","29.16"
"10","015","00","050","0012","0164","317","210","107","1","318","967","0","32.89","21.72"
"10","015","00","050","0012","0165","326","208","118","3","329","902","0","36.47","23.06"
"10","015","00","050","0013","0000","1516","1014","502","10","1526","3933","0","38.80","25.78"
"10","015","00","050","0013","0166","396","273","123","4","400","1017","0","39.33","26.84"
"10","015","00","050","0013","0167","358","234","124","2","360","1014","0","35.50","23.08"
"10","015","00","050","0013","0168","375","262","113","3","378","949","0","39.83","27.61"
"10","015","00","050","0013","0169","387","245","142","1","388","953","0","40.71","25.71"
"10","015","00","050","0014","0000","2291","1592","699","22","2313","5995","0","38.58","26.56"
"10","015","00","050","0014","0181","398","279","119","3","401","999","0","40.14","27.93"
"10","015","00","050","0014","0182","421","292","129","5","426","991","0","42.99","29.47"
"10","015","00","050","0014","0183","299","227","72","1","300","772","0","38.86","29.40"
"10","015","00","050","0014","0184","394","257","137","0","394","1130","0","34.87","22.74"
"10","015","00","050","0014","0185","425","304","121","6","431","1111","0","38.79","27.36"
"10","015","00","050","0014","0186","354","233","121","7","361","992","0","36.39","23.49"
"10","015","00","050","0015","0000","2010","1478","532","29","2039","5503","0","37.05","26.86"
"10","015","00","050","0015","0187","451","321","130","8","459","1128","0","40.69","28.46"
"10","015","00","050","0015","0188","324","249","75","2","326","978","0","33.33","25.46"
"10","015","00","050","0015","0189","397","308","89","10","407","1019","0","39.94","30.23"
"10","015","00","050","0015","0190","399","292","107","3","402","1135","0","35.42","25.73"
"10","015","00","050","0015","0191","439","308","131","6","445","1243","0","35.80","24.78"
"10","015","00","050","0016","0000","735","489","246","8","743","2360","0","31.48","20.72"
"10","015","00","050","0016","0192","345","210","135","5","350","1134","0","30.86","18.52"
"10","015","00","050","0016","0193","390","279","111","3","393","1226","0","32.06","22.76"
"10","015","00","050","0017","0000","1510","1026","484","12","1522","4520","0","33.67","22.70"
"10","015","00","050","0017","0194","427","291","136","4","431","1178","0","36.59","24.70"
"10","015","00","050","0017","0195","368","248","120","1","369","1059","0","34.84","23.42"
"10","015","00","050","0017","0196","414","274","140","3","417","1271","0","32.81","21.56"
"10","015","00","050","0017","0197","301","213","88","4","305","1012","0","30.14","21.05"
"10","015","00","050","0018","0000","755","592","163","12","767","1987","0","38.60","29.79"
"10","015","00","050","0018","0198","364","288","76","3","367","965","0","38.03","29.84"
"10","015","00","050","0018","0199","391","304","87","9","400","1022","0","39.14","29.75"
"10","015","00","060","0000","0000","5643","3820","1823","90","5733","15544","17427","36.88","24.58"
"10","015","00","060","0001","0000","136","88","48","3","139","352","0","39.49","25.00"
"10","015","00","060","0001","0201","136","88","48","3","139","352","0","39.49","25.00"
"10","015","00","060","0002","0000","384","261","123","7","391","1019","0","38.37","25.61"
"10","015","00","060","0002","0200","384","261","123","7","391","1019","0","38.37","25.61"
"10","015","00","060","0003","0000","651","438","213","12","663","1879","0","35.28","23.31"
"10","015","00","060","0003","0202","319","207","112","4","323","997","0","32.40","20.76"
"10","015","00","060","0003","0203","332","231","101","8","340","882","0","38.55","26.19"
"10","015","00","060","0004","0000","472","322","150","5","477","1317","0","36.22","24.45"
"10","015","00","060","0004","0204","237","158","79","3","240","640","0","37.50","24.69"
"10","015","00","060","0004","0205","235","164","71","2","237","677","0","35.01","24.22"
"10","015","00","060","0005","0000","294","212","82","5","299","900","0","33.22","23.56"
"10","015","00","060","0005","0206","294","212","82","5","299","900","0","33.22","23.56"
"10","015","00","060","0006","0000","317","223","94","2","319","729","0","43.76","30.59"
"10","015","00","060","0006","0209","317","223","94","2","319","729","0","43.76","30.59"
"10","015","00","060","0007","0000","575","381","194","10","585","1627","0","35.96","23.42"
"10","015","00","060","0007","0207","276","172","104","5","281","734","0","38.28","23.43"
"10","015","00","060","0007","0208","299","209","90","5","304","893","0","34.04","23.40"
"10","015","00","060","0008","0000","281","235","46","7","288","772","0","37.31","30.44"
"10","015","00","060","0008","0210","281","235","46","7","288","772","0","37.31","30.44"
"10","015","00","060","0009","0000","298","194","104","4","302","747","0","40.43","25.97"
"10","015","00","060","0009","0211","298","194","104","4","302","747","0","40.43","25.97"
"10","015","00","060","0010","0000","530","321","209","10","540","1402","0","38.52","22.90"
"10","015","00","060","0010","0212","365","214","151","9","374","981","0","38.12","21.81"
"10","015","00","060","0010","0213","165","107","58","1","166","421","0","39.43","25.42"
"10","015","00","060","0011","0000","935","565","370","6","941","2522","0","37.31","22.40"
"10","015","00","060","0011","0214","380","240","140","4","384","1115","0","34.44","21.52"
"10","015","00","060","0011","0215","388","205","183","1","389","981","0","39.65","20.90"
"10","015","00","060","0011","0216","167","120","47","1","168","426","0","39.44","28.17"
"10","015","00","060","0012","0000","110","83","27","4","114","259","0","44.02","32.05"
"10","015","00","060","0012","0217","110","83","27","4","114","259","0","44.02","32.05"
"10","015","00","060","0013","0000","268","214","54","2","270","816","0","33.09","26.23"
"10","015","00","060","0013","0218","268","214","54","2","270","816","0","33.09","26.23"
"10","015","00","060","0014","0000","225","165","60","12","237","700","0","33.86","23.57"
"10","015","00","060","0014","0220","225","165","60","12","237","700","0","33.86","23.57"
"10","015","00","060","0015","0000","167","118","49","1","168","503","0","33.40","23.46"
"10","015","00","060","0015","0219","167","118","49","1","168","503","0","33.40","23.46"
"10","015","00","070","0000","0000","3537","2616","921","74","3611","10956","12280","32.96","23.88"
"10","015","00","070","0001","0000","321","210","111","0","321","809","0","39.68","25.96"
"10","015","00","070","0001","0237","321","210","111","0","321","809","0","39.68","25.96"
"10","015","00","070","0002","0000","416","263","153","10","426","1258","0","33.86","20.91"
"10","015","00","070","0002","0236","416","263","153","10","426","1258","0","33.86","20.91"
"10","015","00","070","0003","0000","270","209","61","13","283","918","0","30.83","22.77"
"10","015","00","070","0003","0238","270","209","61","13","283","918","0","30.83","22.77"
"10","015","00","070","0004","0000","253","214","39","5","258","970","0","26.60","22.06"
"10","015","00","070","0004","0239","253","214","39","5","258","970","0","26.60","22.06"
"10","015","00","070","0005","0000","352","255","97","5","357","1018","0","35.07","25.05"
"10","015","00","070","0005","0240","352","255","97","5","357","1018","0","35.07","25.05"
"10","015","00","070","0006","0000","178","137","41","2","180","435","0","41.38","31.49"
"10","015","00","070","0006","0247","178","137","41","2","180","435","0","41.38","31.49"
"10","015","00","070","0007","0000","226","147","79","5","231","765","0","30.20","19.22"
"10","015","00","070","0007","0248","192","121","71","5","197","630","0","31.27","19.21"
"10","015","00","070","0007","0249","34","26","8","0","34","135","0","25.19","19.26"
"10","015","00","070","0008","0000","159","134","25","1","160","454","0","35.24","29.52"
"10","015","00","070","0008","0250","159","134","25","1","160","454","0","35.24","29.52"
"10","015","00","070","0009","0000","107","65","42","0","107","302","0","35.43","21.52"
"10","015","00","070","0009","0251","107","65","42","0","107","302","0","35.43","21.52"
"10","015","00","070","0010","0000","141","93","48","6","147","409","0","35.94","22.74"
"10","015","00","070","0010","0252","141","93","48","6","147","409","0","35.94","22.74"
"10","015","00","070","0011","0000","295","254","41","5","300","990","0","30.30","25.66"
"10","015","00","070","0011","0241","226","195","31","3","229","799","0","28.66","24.41"
"10","015","00","070","0011","0242","69","59","10","2","71","191","0","37.17","30.89"
"10","015","00","070","0012","0000","310","239","71","8","318","928","0","34.27","25.75"
"10","015","00","070","0012","0243","159","134","25","5","164","479","0","34.24","27.97"
"10","015","00","070","0012","0244","151","105","46","3","154","449","0","34.30","23.39"
"10","015","00","070","0013","0000","253","182","71","10","263","820","0","32.07","22.20"
"10","015","00","070","0013","0245","253","182","71","10","263","820","0","32.07","22.20"
"10","015","00","070","0014","0000","256","214","42","4","260","880","0","29.55","24.32"
"10","015","00","070","0014","0246","256","214","42","4","260","880","0","29.55","24.32"
"10","015","00","080","0000","0000","1089","851","238","42","1131","3966","4341","28.52","21.46"
"10","015","00","080","0001","0000","404","313","91","16","420","1596","0","26.32","19.61"
"10","015","00","080","0001","0255","180","135","45","7","187","652","0","28.68","20.71"
"10","015","00","080","0001","0256","155","118","37","5","160","608","0","26.32","19.41"
"10","015","00","080","0001","0257","69","60","9","4","73","336","0","21.73","17.86"
"10","015","00","080","0002","0000","162","127","35","6","168","614","0","27.36","20.68"
"10","015","00","080","0002","0258","162","127","35","6","168","614","0","27.36","20.68"
"10","015","00","080","0003","0000","117","96","21","3","120","390","0","30.77","24.62"
"10","015","00","080","0003","0259","117","96","21","3","120","390","0","30.77","24.62"
"10","015","00","080","0004","0000","228","161","67","7","235","721","0","32.59","22.33"
"10","015","00","080","0004","0254","228","161","67","7","235","721","0","32.59","22.33"
"10","015","00","080","0005","0000","178","154","24","10","188","645","0","29.15","23.88"
"10","015","00","080","0005","0253","178","154","24","10","188","645","0","29.15","23.88"
"10","015","00","090","0000","0000","3149","2251","898","69","3218","9935","11248","32.39","22.66"
"10","015","00","090","0001","0000","622","438","184","13","635","1828","0","34.74","23.96"
"10","015","00","090","0001","0267","271","196","75","3","274","778","0","35.22","25.19"
"10","015","00","090","0001","0268","351","242","109","10","361","1050","0","34.38","23.05"
"10","015","00","090","0002","0000","638","442","196","7","645","1800","0","35.83","24.56"
"10","015","00","090","0002","0269","312","228","84","2","314","829","0","37.88","27.50"
"10","015","00","090","0002","0270","326","214","112","5","331","971","0","34.09","22.04"
"10","015","00","090","0003","0000","193","131","62","3","196","520","0","37.69","25.19"
"10","015","00","090","0003","0271","193","131","62","3","196","520","0","37.69","25.19"
"10","015","00","090","0004","0000","296","197","99","1","297","923","0","32.18","21.34"
"10","015","00","090","0004","0272","296","197","99","1","297","923","0","32.18","21.34"
"10","015","00","090","0005","0000","160","123","37","7","167","580","0","28.79","21.21"
"10","015","00","090","0005","0273","160","123","37","7","167","580","0","28.79","21.21"
"10","015","00","090","0006","0000","300","214","86","6","306","941","0","32.52","22.74"
"10","015","00","090","0006","0274","300","214","86","6","306","941","0","32.52","22.74"
"10","015","00","090","0007","0000","250","203","47","3","253","867","0","29.18","23.41"
"10","015","00","090","0007","0275","250","203","47","3","253","867","0","29.18","23.41"
"10","015","00","090","0008","0000","73","60","13","3","76","332","0","22.89","18.07"
"10","015","00","090","0008","0276","73","60","13","3","76","332","0","22.89","18.07"
"10","015","00","090","0009","0000","204","143","61","4","208","740","0","28.11","19.32"
"10","015","00","090","0009","0277","204","143","61","4","208","740","0","28.11","19.32"
"10","015","00","090","0010","0000","216","182","34","13","229","825","0","27.76","22.06"
"10","015","00","090","0010","0278","216","182","34","13","229","825","0","27.76","22.06"
"10","015","00","090","0011","0000","197","118","79","9","206","579","0","35.58","20.38"
"10","015","00","090","0011","0279","197","118","79","9","206","579","0","35.58","20.38"
"10","015","00","100","0000","0000","2511","1778","733","73","2584","8785","9897","29.41","20.24"
"10","015","00","100","0001","0000","126","100","26","3","129","471","0","27.39","21.23"
"10","015","00","100","0001","0305","126","100","26","3","129","471","0","27.39","21.23"
"10","015","00","100","0002","0000","228","145","83","9","237","970","0","24.43","14.95"
"10","015","00","100","0002","0306","228","145","83","9","237","970","0","24.43","14.95"
"10","015","00","100","0003","0000","174","143","31","4","178","613","0","29.04","23.33"
"10","015","00","100","0003","0307","174","143","31","4","178","613","0","29.04","23.33"
"10","015","00","100","0004","0000","143","106","37","6","149","573","0","26.00","18.50"
"10","015","00","100","0004","0308","143","106","37","6","149","573","0","26.00","18.50"
"10","015","00","100","0005","0000","319","242","77","1","320","1040","0","30.77","23.27"
"10","015","00","100","0005","0309","319","242","77","1","320","1040","0","30.77","23.27"
"10","015","00","100","0006","0000","129","90","39","2","131","428","0","30.61","21.03"
"10","015","00","100","0006","0310","129","90","39","2","131","428","0","30.61","21.03"
"10","015","00","100","0007","0000","230","167","63","9","239","864","0","27.66","19.33"
"10","015","00","100","0007","0311","230","167","63","9","239","864","0","27.66","19.33"
"10","015","00","100","0008","0000","132","94","38","2","134","368","0","36.41","25.54"
"10","015","00","100","0008","0312","132","94","38","2","134","368","0","36.41","25.54"
"10","015","00","100","0009","0000","398","252","146","8","406","1306","0","31.09","19.30"
"10","015","00","100","0009","0313","398","252","146","8","406","1306","0","31.09","19.30"
"10","015","00","100","0010","0000","147","106","41","4","151","442","0","34.16","23.98"
"10","015","00","100","0010","0314","147","106","41","4","151","442","0","34.16","23.98"
"10","015","00","100","0011","0000","161","130","31","8","169","597","0","28.31","21.78"
"10","015","00","100","0011","0315","161","130","31","8","169","597","0","28.31","21.78"
"10","015","00","100","0012","0000","132","89","43","6","138","491","0","28.11","18.13"
"10","015","00","100","0012","0316","132","89","43","6","138","491","0","28.11","18.13"
"10","015","00","100","0013","0000","192","114","78","11","203","622","0","32.64","18.33"
"10","015","00","100","0013","0317","192","114","78","11","203","622","0","32.64","18.33"
"10","015","00","110","0000","0000","3925","3106","819","47","3972","12966","16204","30.63","23.95"
"10","015","00","110","0001","0000","382","323","59","2","384","1423","0","26.99","22.70"
"10","015","00","110","0001","0116","190","161","29","1","191","726","0","26.31","22.18"
"10","015","00","110","0001","0117","192","162","30","1","193","697","0","27.69","23.24"
"10","015","00","110","0002","0000","575","411","164","11","586","1842","0","31.81","22.31"
"10","015","00","110","0002","0118","255","218","37","3","258","842","0","30.64","25.89"
"10","015","00","110","0002","0119","262","149","113","7","269","841","0","31.99","17.72"
"10","015","00","110","0002","0120","58","44","14","1","59","159","0","37.11","27.67"
"10","015","00","110","0003","0000","523","392","131","7","530","1790","0","29.61","21.90"
"10","015","00","110","0003","0121","128","106","22","5","133","398","0","33.42","26.63"
"10","015","00","110","0003","0122","247","176","71","1","248","881","0","28.15","19.98"
"10","015","00","110","0003","0123","148","110","38","1","149","511","0","29.16","21.53"
"10","015","00","110","0004","0000","387","327","60","4","391","1188","0","32.91","27.53"
"10","015","00","110","0004","0127","387","327","60","4","391","1188","0","32.91","27.53"
"10","015","00","110","0005","0000","395","330","65","11","406","1217","0","33.36","27.12"
"10","015","00","110","0005","0128","213","169","44","9","222","720","0","30.83","23.47"
"10","015","00","110","0005","0129","182","161","21","2","184","497","0","37.02","32.39"
"10","015","00","110","0006","0000","346","296","50","1","347","1126","0","30.82","26.29"
"10","015","00","110","0006","0130","258","223","35","1","259","802","0","32.29","27.81"
"10","015","00","110","0006","0131","88","73","15","0","88","324","0","27.16","22.53"
"10","015","00","110","0007","0000","503","377","126","6","509","1791","0","28.42","21.05"
"10","015","00","110","0007","0124","328","240","88","2","330","1144","0","28.85","20.98"
"10","015","00","110","0007","0125","175","137","38","4","179","647","0","27.67","21.17"
"10","015","00","110","0008","0000","356","306","50","3","359","1048","0","34.26","29.20"
"10","015","00","110","0008","0126","356","306","50","3","359","1048","0","34.26","29.20"
"10","015","00","110","0009","0000","458","344","114","2","460","1541","0","29.85","22.32"
"10","015","00","110","0009","0114","275","199","76","1","276","914","0","30.20","21.77"
"10","015","00","110","0009","0115","183","145","38","1","184","627","0","29.35","23.13"
"10","015","00","120","0000","0000","1320","1105","215","17","1337","5080","6174","26.32","21.75"
"10","015","00","120","0001","0000","300","254","46","3","303","1044","0","29.02","24.33"
"10","015","00","120","0001","0260","300","254","46","3","303","1044","0","29.02","24.33"
"10","015","00","120","0002","0000","121","106","15","0","121","515","0","23.50","20.58"
"10","015","00","120","0002","0261","121","106","15","0","121","515","0","23.50","20.58"
"10","015","00","120","0003","0000","195","161","34","4","199","757","0","26.29","21.27"
"10","015","00","120","0003","0262","195","161","34","4","199","757","0","26.29","21.27"
"10","015","00","120","0004","0000","181","156","25","3","184","639","0","28.79","24.41"
"10","015","00","120","0004","0263","181","156","25","3","184","639","0","28.79","24.41"
"10","015","00","120","0005","0000","262","209","53","6","268","1075","0","24.93","19.44"
"10","015","00","120","0005","0264","128","98","30","3","131","432","0","30.32","22.69"
"10","015","00","120","0005","0265","134","111","23","3","137","643","0","21.31","17.26"
"10","015","00","120","0006","0000","261","219","42","1","262","1050","0","24.95","20.86"
"10","015","00","120","0006","0266","261","219","42","1","262","1050","0","24.95","20.86"
"10","015","00","130","0000","0000","1323","1182","141","27","1350","4818","5997","28.02","24.53"
"10","015","00","130","0001","0000","141","129","12","1","142","523","0","27.15","24.67"
"10","015","00","130","0001","0318","141","129","12","1","142","523","0","27.15","24.67"
"10","015","00","130","0002","0000","233","207","26","9","242","969","0","24.97","21.36"
"10","015","00","130","0002","0319","122","106","16","4","126","511","0","24.66","20.74"
"10","015","00","130","0002","0320","111","101","10","5","116","458","0","25.33","22.05"
"10","015","00","130","0003","0000","238","213","25","5","243","691","0","35.17","30.82"
"10","015","00","130","0003","0321","238","213","25","5","243","691","0","35.17","30.82"
"10","015","00","130","0004","0000","192","174","18","2","194","721","0","26.91","24.13"
"10","015","00","130","0004","0322","192","174","18","2","194","721","0","26.91","24.13"
"10","015","00","130","0005","0000","231","210","21","5","236","1017","0","23.21","20.65"
"10","015","00","130","0005","0323","145","134","11","5","150","623","0","24.08","21.51"
"10","015","00","130","0005","0324","86","76","10","0","86","394","0","21.83","19.29"
"10","015","00","130","0006","0000","288","249","39","5","293","897","0","32.66","27.76"
"10","015","00","130","0006","0325","106","92","14","2","108","321","0","33.64","28.66"
"10","015","00","130","0006","0326","131","113","18","2","133","393","0","33.84","28.75"
"10","015","00","130","0006","0327","51","44","7","1","52","183","0","28.42","24.04"
"10","014","00","000","0000","0000","58825","38963","19862","871","59696","182958","214132","32.63","21.30"
"10","014","00","010","0000","0000","30777","19467","11310","272","31049","87202","104445","35.61","22.32"
"10","014","00","010","0001","0000","452","309","143","9","461","1446","0","31.88","21.37"
"10","014","00","010","0001","0066","250","156","94","6","256","797","0","32.12","19.57"
"10","014","00","010","0001","0067","202","153","49","3","205","649","0","31.59","23.57"
"10","014","00","010","0002","0000","255","161","94","6","261","865","0","30.17","18.61"
"10","014","00","010","0002","0068","255","161","94","6","261","865","0","30.17","18.61"
"10","014","00","010","0003","0000","759","509","250","8","767","2210","0","34.71","23.03"
"10","014","00","010","0003","0072","537","358","179","4","541","1445","0","37.44","24.78"
"10","014","00","010","0003","0073","222","151","71","4","226","765","0","29.54","19.74"
"10","014","00","010","0004","0000","892","611","281","6","898","2796","0","32.12","21.85"
"10","014","00","010","0004","0077","319","211","108","2","321","943","0","34.04","22.38"
"10","014","00","010","0004","0078","295","223","72","2","297","968","0","30.68","23.04"
"10","014","00","010","0004","0079","278","177","101","2","280","885","0","31.64","20.00"
"10","014","00","010","0005","0000","1243","713","530","2","1245","2822","0","44.12","25.27"
"10","014","00","010","0005","0074","412","258","154","0","412","957","0","43.05","26.96"
"10","014","00","010","0005","0075","406","245","161","1","407","926","0","43.95","26.46"
"10","014","00","010","0005","0076","425","210","215","1","426","939","0","45.37","22.36"
"10","014","00","010","0006","0000","895","614","281","10","905","2707","0","33.43","22.68"
"10","014","00","010","0006","0069","352","236","116","1","353","869","0","40.62","27.16"
"10","014","00","010","0006","0070","248","174","74","2","250","865","0","28.90","20.12"
"10","014","00","010","0006","0071","295","204","91","7","302","973","0","31.04","20.97"
"10","014","00","010","0007","0000","2327","1536","791","13","2340","6528","0","35.85","23.53"
"10","014","00","010","0007","0031","399","272","127","2","401","1125","0","35.64","24.18"
"10","014","00","010","0007","0032","328","200","128","0","328","945","0","34.71","21.16"
"10","014","00","010","0007","0033","375","242","133","2","377","1082","0","34.84","22.37"
"10","014","00","010","0007","0034","376","257","119","4","380","1085","0","35.02","23.69"
"10","014","00","010","0007","0035","387","270","117","2","389","1119","0","34.76","24.13"
"10","014","00","010","0007","0036","462","295","167","3","465","1172","0","39.68","25.17"
"10","014","00","010","0008","0000","1282","758","524","13","1295","3035","0","42.67","24.98"
"10","014","00","010","0008","0008","414","234","180","5","419","984","0","42.58","23.78"
"10","014","00","010","0008","0009","471","287","184","7","478","1028","0","46.50","27.92"
"10","014","00","010","0008","0010","397","237","160","1","398","1023","0","38.91","23.17"
"10","014","00","010","0009","0000","302","167","135","1","303","826","0","36.68","20.22"
"10","014","00","010","0009","0011","302","167","135","1","303","826","0","36.68","20.22"
"10","014","00","010","0010","0000","951","671","280","6","957","2489","0","38.45","26.96"
"10","014","00","010","0010","0040","477","334","143","3","480","1223","0","39.25","27.31"
"10","014","00","010","0010","0041","474","337","137","3","477","1266","0","37.68","26.62"
"10","014","00","010","0011","0000","1200","777","423","10","1210","3004","0","40.28","25.87"
"10","014","00","010","0011","0037","393","260","133","2","395","1055","0","37.44","24.64"
"10","014","00","010","0011","0038","362","237","125","2","364","921","0","39.52","25.73"
"10","014","00","010","0011","0039","445","280","165","6","451","1028","0","43.87","27.24"
"10","014","00","010","0012","0000","1591","999","592","8","1599","3981","0","40.17","25.09"
"10","014","00","010","0012","0004","377","239","138","1","378","953","0","39.66","25.08"
"10","014","00","010","0012","0005","398","251","147","2","400","945","0","42.33","26.56"
"10","014","00","010","0012","0006","367","209","158","2","369","972","0","37.96","21.50"
"10","014","00","010","0012","0007","449","300","149","3","452","1111","0","40.68","27.00"
"10","014","00","010","0013","0000","481","256","225","1","482","1313","0","36.71","19.50"
"10","014","00","010","0013","0002","193","101","92","0","193","526","0","36.69","19.20"
"10","014","00","010","0013","0003","288","155","133","1","289","787","0","36.72","19.70"
"10","014","00","010","0014","0000","220","151","69","2","222","638","0","34.80","23.67"
"10","014","00","010","0014","0013","220","151","69","2","222","638","0","34.80","23.67"
"10","014","00","010","0015","0000","564","320","244","4","568","1628","0","34.89","19.66"
"10","014","00","010","0015","0014","342","188","154","0","342","855","0","40.00","21.99"
"10","014","00","010","0015","0015","222","132","90","4","226","773","0","29.24","17.08"
"10","014","00","010","0016","0000","215","129","86","4","219","620","0","35.32","20.81"
"10","014","00","010","0016","0017","215","129","86","4","219","620","0","35.32","20.81"
"10","014","00","010","0017","0000","399","230","169","2","401","1215","0","33.00","18.93"
"10","014","00","010","0017","0020","399","230","169","2","401","1215","0","33.00","18.93"
"10","014","00","010","0018","0000","327","196","131","1","328","813","0","40.34","24.11"
"10","014","00","010","0018","0012","327","196","131","1","328","813","0","40.34","24.11"
"10","014","00","010","0019","0000","269","146","123","0","269","683","0","39.39","21.38"
"10","014","00","010","0019","0016","269","146","123","0","269","683","0","39.39","21.38"
"10","014","00","010","0020","0000","348","185","163","0","348","768","0","45.31","24.09"
"10","014","00","010","0020","0021","348","185","163","0","348","768","0","45.31","24.09"
"10","014","00","010","0021","0000","270","169","101","5","275","727","0","37.83","23.25"
"10","014","00","010","0021","0018","270","169","101","5","275","727","0","37.83","23.25"
"10","014","00","010","0022","0000","290","152","138","0","290","762","0","38.06","19.95"
"10","014","00","010","0022","0019","290","152","138","0","290","762","0","38.06","19.95"
"10","014","00","010","0023","0000","244","143","101","1","245","941","0","26.04","15.20"
"10","014","00","010","0023","0001","244","143","101","1","245","941","0","26.04","15.20"
"10","014","00","010","0024","0000","318","187","131","1","319","736","0","43.34","25.41"
"10","014","00","010","0024","0022","318","187","131","1","319","736","0","43.34","25.41"
"10","014","00","010","0025","0000","178","111","67","0","178","575","0","30.96","19.30"
"10","014","00","010","0025","0028","178","111","67","0","178","575","0","30.96","19.30"
"10","014","00","010","0026","0000","269","134","135","2","271","711","0","38.12","18.85"
"10","014","00","010","0026","0023","269","134","135","2","271","711","0","38.12","18.85"
"10","014","00","010","0027","0000","135","84","51","1","136","400","0","34.00","21.00"
"10","014","00","010","0027","0029","135","84","51","1","136","400","0","34.00","21.00"
"10","014","00","010","0028","0000","154","83","71","1","155","389","0","39.85","21.34"
"10","014","00","010","0028","0024","154","83","71","1","155","389","0","39.85","21.34"
"10","014","00","010","0029","0000","543","345","198","10","553","1604","0","34.48","21.51"
"10","014","00","010","0029","0082","306","191","115","5","311","799","0","38.92","23.90"
"10","014","00","010","0029","0083","237","154","83","5","242","805","0","30.06","19.13"
"10","014","00","010","0030","0000","724","408","316","15","739","2224","0","33.23","18.35"
"10","014","00","010","0030","0080","307","177","130","7","314","995","0","31.56","17.79"
"10","014","00","010","0030","0081","417","231","186","8","425","1229","0","34.58","18.80"
"10","014","00","010","0031","0000","962","618","344","13","975","3044","0","32.03","20.30"
"10","014","00","010","0031","0044","250","156","94","7","257","961","0","26.74","16.23"
"10","014","00","010","0031","0045","379","231","148","3","382","1126","0","33.93","20.52"
"10","014","00","010","0031","0046","333","231","102","3","336","957","0","35.11","24.14"
"10","014","00","010","0032","0000","975","667","308","5","980","2559","0","38.30","26.06"
"10","014","00","010","0032","0042","536","377","159","3","539","1289","0","41.82","29.25"
"10","014","00","010","0032","0043","439","290","149","2","441","1270","0","34.72","22.83"
"10","014","00","010","0033","0000","488","312","176","4","492","1481","0","33.22","21.07"
"10","014","00","010","0033","0047","288","177","111","1","289","733","0","39.43","24.15"
"10","014","00","010","0033","0048","200","135","65","3","203","748","0","27.14","18.05"
"10","014","00","010","0034","0000","724","449","275","5","729","2117","0","34.44","21.21"
"10","014","00","010","0034","0049","310","184","126","3","313","947","0","33.05","19.43"
"10","014","00","010","0034","0050","414","265","149","2","416","1170","0","35.56","22.65"
"10","014","00","010","0035","0000","393","243","150","7","400","1309","0","30.56","18.56"
"10","014","00","010","0035","0051","393","243","150","7","400","1309","0","30.56","18.56"
"10","014","00","010","0036","0000","1033","658","375","8","1041","2638","0","39.46","24.94"
"10","014","00","010","0036","0025","244","145","99","3","247","718","0","34.40","20.19"
"10","014","00","010","0036","0026","414","257","157","1","415","919","0","45.16","27.97"
"10","014","00","010","0036","0027","375","256","119","4","379","1001","0","37.86","25.57"
"10","014","00","010","0037","0000","328","195","133","2","330","940","0","35.11","20.74"
"10","014","00","010","0037","0030","328","195","133","2","330","940","0","35.11","20.74"
"10","014","00","010","0038","0000","2905","1949","956","18","2923","8103","0","36.07","24.05"
"10","014","00","010","0038","0052","442","288","154","2","444","1195","0","37.15","24.10"
"10","014","00","010","0038","0053","380","268","112","3","383","1176","0","32.57","22.79"
"10","014","00","010","0038","0054","421","287","134","2","423","1217","0","34.76","23.58"
"10","014","00","010","0038","0055","447","285","162","4","451","1259","0","35.82","22.64"
"10","014","00","010","0038","0056","323","200","123","3","326","1035","0","31.50","19.32"
"10","014","00","010","0038","0057","402","276","126","3","405","1084","0","37.36","25.46"
"10","014","00","010","0038","0058","490","345","145","1","491","1137","0","43.18","30.34"
"10","014","00","010","0039","0000","1496","1015","481","12","1508","5024","0","30.02","20.20"
"10","014","00","010","0039","0059","416","276","140","2","418","1349","0","30.99","20.46"
"10","014","00","010","0039","0060","334","216","118","3","337","1284","0","26.25","16.82"
"10","014","00","010","0039","0061","401","283","118","2","403","1270","0","31.73","22.28"
"10","014","00","010","0039","0062","345","240","105","5","350","1121","0","31.22","21.41"
"10","014","00","010","0040","0000","745","430","315","9","754","2362","0","31.92","18.20"
"10","014","00","010","0040","0063","369","223","146","4","373","1127","0","33.10","19.79"
"10","014","00","010","0040","0064","376","207","169","5","381","1235","0","30.85","16.76"
"10","014","00","010","0041","0000","408","215","193","15","423","1214","0","34.84","17.71"
"10","014","00","010","0041","0065","408","215","193","15","423","1214","0","34.84","17.71"
"10","014","00","010","0042","0000","466","315","151","3","469","1392","0","33.69","22.63"
"10","014","00","010","0042","0084","211","123","88","2","213","723","0","29.46","17.01"
"10","014","00","010","0042","0085","255","192","63","1","256","669","0","38.27","28.70"
"10","014","00","010","0043","0000","343","194","149","5","348","952","0","36.55","20.38"
"10","014","00","010","0043","0086","343","194","149","5","348","952","0","36.55","20.38"
"10","014","00","010","0044","0000","384","228","156","4","388","1256","0","30.89","18.15"
"10","014","00","010","0044","0087","384","228","156","4","388","1256","0","30.89","18.15"
"10","014","00","010","0045","0000","460","301","159","5","465","1365","0","34.07","22.05"
"10","014","00","010","0045","0088","252","165","87","1","253","717","0","35.29","23.01"
"10","014","00","010","0045","0089","208","136","72","4","212","648","0","32.72","20.99"
"10","014","00","010","0046","0000","570","424","146","15","585","1990","0","29.40","21.31"
"10","014","00","010","0046","0090","340","260","80","8","348","1087","0","32.01","23.92"
"10","014","00","010","0046","0091","230","164","66","7","237","903","0","26.25","18.16"
"10","014","00","020","0000","0000","3285","2402","883","73","3358","11887","13396","28.25","20.21"
"10","014","00","020","0001","0000","204","169","35","8","212","596","0","35.57","28.36"
"10","014","00","020","0001","0107","112","91","21","7","119","347","0","34.29","26.22"
"10","014","00","020","0001","0108","92","78","14","1","93","249","0","37.35","31.33"
"10","014","00","020","0002","0000","228","155","73","8","236","935","0","25.24","16.58"
"10","014","00","020","0002","0105","120","80","40","5","125","469","0","26.65","17.06"
"10","014","00","020","0002","0106","108","75","33","3","111","466","0","23.82","16.09"
"10","014","00","020","0003","0000","299","219","80","11","310","1337","0","23.19","16.38"
"10","014","00","020","0003","0103","127","88","39","0","127","508","0","25.00","17.32"
"10","014","00","020","0003","0104","172","131","41","11","183","829","0","22.07","15.80"
"10","014","00","020","0004","0000","657","511","146","17","674","2619","0","25.74","19.51"
"10","014","00","020","0004","0101","314","244","70","8","322","1309","0","24.60","18.64"
"10","014","00","020","0004","0102","343","267","76","9","352","1310","0","26.87","20.38"
"10","014","00","020","0005","0000","576","399","177","8","584","1823","0","32.04","21.89"
"10","014","00","020","0005","0099","275","178","97","3","278","882","0","31.52","20.18"
"10","014","00","020","0005","0100","301","221","80","5","306","941","0","32.52","23.49"
"10","014","00","020","0006","0000","633","413","220","6","639","2079","0","30.74","19.87"
"10","014","00","020","0006","0096","92","67","25","1","93","333","0","27.93","20.12"
"10","014","00","020","0006","0097","299","183","116","1","300","938","0","31.98","19.51"
"10","014","00","020","0006","0098","242","163","79","4","246","808","0","30.45","20.17"
"10","014","00","020","0007","0000","188","139","49","5","193","725","0","26.62","19.17"
"10","014","00","020","0007","0095","188","139","49","5","193","725","0","26.62","19.17"
"10","014","00","020","0008","0000","500","397","103","10","510","1773","0","28.76","22.39"
"10","014","00","020","0008","0092","145","109","36","5","150","501","0","29.94","21.76"
"10","014","00","020","0008","0093","255","202","53","3","258","911","0","28.32","22.17"
"10","014","00","020","0008","0094","100","86","14","2","102","361","0","28.25","23.82"
"10","014","00","030","0000","0000","2287","1544","743","59","2346","7211","8330","32.53","21.41"
"10","014","00","030","0001","0000","453","302","151","15","468","1682","0","27.82","17.95"
"10","014","00","030","0001","0115","227","176","51","8","235","915","0","25.68","19.23"
"10","014","00","030","0001","0116","226","126","100","7","233","767","0","30.38","16.43"
"10","014","00","030","0002","0000","381","274","107","1","382","1084","0","35.24","25.28"
"10","014","00","030","0002","0113","381","274","107","1","382","1084","0","35.24","25.28"
"10","014","00","030","0003","0000","271","175","96","18","289","865","0","33.41","20.23"
"10","014","00","030","0003","0112","271","175","96","18","289","865","0","33.41","20.23"
"10","014","00","030","0004","0000","314","191","123","2","316","752","0","42.02","25.40"
"10","014","00","030","0004","0111","314","191","123","2","316","752","0","42.02","25.40"
"10","014","00","030","0005","0000","526","387","139","5","531","1611","0","32.96","24.02"
"10","014","00","030","0005","0109","317","226","91","2","319","864","0","36.92","26.16"
"10","014","00","030","0005","0110","209","161","48","3","212","747","0","28.38","21.55"
"10","014","00","030","0006","0000","157","110","47","9","166","528","0","31.44","20.83"
"10","014","00","030","0006","0117","157","110","47","9","166","528","0","31.44","20.83"
"10","014","00","030","0007","0000","185","105","80","9","194","689","0","28.16","15.24"
"10","014","00","030","0007","0114","185","105","80","9","194","689","0","28.16","15.24"
"10","014","00","040","0000","0000","4793","3038","1755","88","4881","14938","16897","32.68","20.34"
"10","014","00","040","0001","0000","133","86","47","7","140","486","0","28.81","17.70"
"10","014","00","040","0001","0127","59","36","23","4","63","271","0","23.25","13.28"
"10","014","00","040","0001","0128","74","50","24","3","77","215","0","35.81","23.26"
"10","014","00","040","0002","0000","155","119","36","0","155","449","0","34.52","26.50"
"10","014","00","040","0002","0139","155","119","36","0","155","449","0","34.52","26.50"
"10","014","00","040","0003","0000","150","111","39","4","154","467","0","32.98","23.77"
"10","014","00","040","0003","0137","150","111","39","4","154","467","0","32.98","23.77"
"10","014","00","040","0004","0000","119","62","57","1","120","333","0","36.04","18.62"
"10","014","00","040","0004","0138","119","62","57","1","120","333","0","36.04","18.62"
"10","014","00","040","0005","0000","339","194","145","7","346","1149","0","30.11","16.88"
"10","014","00","040","0005","0125","205","108","97","2","207","715","0","28.95","15.10"
"10","014","00","040","0005","0126","134","86","48","5","139","434","0","32.03","19.82"
"10","014","00","040","0006","0000","364","233","131","6","370","1236","0","29.94","18.85"
"10","014","00","040","0006","0123","192","126","66","3","195","741","0","26.32","17.00"
"10","014","00","040","0006","0124","172","107","65","3","175","495","0","35.35","21.62"
"10","014","00","040","0007","0000","357","169","188","8","365","1068","0","34.18","15.82"
"10","014","00","040","0007","0120","62","24","38","2","64","211","0","30.33","11.37"
"10","014","00","040","0007","0121","160","67","93","2","162","466","0","34.76","14.38"
"10","014","00","040","0007","0122","135","78","57","4","139","391","0","35.55","19.95"
"10","014","00","040","0008","0000","729","407","322","7","736","2211","0","33.29","18.41"
"10","014","00","040","0008","0118","341","153","188","4","345","1032","0","33.43","14.83"
"10","014","00","040","0008","0119","388","254","134","3","391","1179","0","33.16","21.54"
"10","014","00","040","0009","0000","323","213","110","6","329","1122","0","29.32","18.98"
"10","014","00","040","0009","0132","323","213","110","6","329","1122","0","29.32","18.98"
"10","014","00","040","0010","0000","994","680","314","14","1008","3124","0","32.27","21.77"
"10","014","00","040","0010","0129","492","315","177","7","499","1334","0","37.41","23.61"
"10","014","00","040","0010","0130","228","164","64","2","230","712","0","32.30","23.03"
"10","014","00","040","0010","0131","274","201","73","5","279","1078","0","25.88","18.65"
"10","014","00","040","0011","0000","396","298","98","12","408","1094","0","37.29","27.24"
"10","014","00","040","0011","0133","396","298","98","12","408","1094","0","37.29","27.24"
"10","014","00","040","0012","0000","388","324","64","12","400","1133","0","35.30","28.60"
"10","014","00","040","0012","0134","388","324","64","12","400","1133","0","35.30","28.60"
"10","014","00","040","0013","0000","346","142","204","4","350","1066","0","32.83","13.32"
"10","014","00","040","0013","0135","294","123","171","3","297","914","0","32.49","13.46"
"10","014","00","040","0013","0136","52","19","33","1","53","152","0","34.87","12.50"
"10","014","00","050","0000","0000","2017","1177","840","32","2049","6713","7514","30.52","17.53"
"10","014","00","050","0001","0000","145","92","53","6","151","650","0","23.23","14.15"
"10","014","00","050","0001","0147","145","92","53","6","151","650","0","23.23","14.15"
"10","014","00","050","0002","0000","319","126","193","4","323","871","0","37.08","14.47"
"10","014","00","050","0002","0148","135","77","58","0","135","413","0","32.69","18.64"
"10","014","00","050","0002","0149","184","49","135","4","188","458","0","41.05","10.70"
"10","014","00","050","0003","0000","222","132","90","5","227","835","0","27.19","15.81"
"10","014","00","050","0003","0146","222","132","90","5","227","835","0","27.19","15.81"
"10","014","00","050","0004","0000","427","280","147","0","427","1440","0","29.65","19.44"
"10","014","00","050","0004","0143","339","211","128","0","339","1099","0","30.85","19.20"
"10","014","00","050","0004","0144","88","69","19","0","88","341","0","25.81","20.23"
"10","014","00","050","0005","0000","217","145","72","4","221","858","0","25.76","16.90"
"10","014","00","050","0005","0145","217","145","72","4","221","858","0","25.76","16.90"
"10","014","00","050","0006","0000","318","228","90","9","327","1026","0","31.87","22.22"
"10","014","00","050","0006","0140","145","119","26","8","153","493","0","31.03","24.14"
"10","014","00","050","0006","0141","173","109","64","1","174","533","0","32.65","20.45"
"10","014","00","050","0007","0000","369","174","195","4","373","1033","0","36.11","16.84"
"10","014","00","050","0007","0142","369","174","195","4","373","1033","0","36.11","16.84"
"10","014","00","060","0000","0000","2158","1307","851","48","2206","7030","8018","31.38","18.59"
"10","014","00","060","0001","0000","299","169","130","5","304","1091","0","27.86","15.49"
"10","014","00","060","0001","0152","135","65","70","4","139","430","0","32.33","15.12"
"10","014","00","060","0001","0153","164","104","60","1","165","661","0","24.96","15.73"
"10","014","00","060","0002","0000","213","140","73","7","220","660","0","33.33","21.21"
"10","014","00","060","0002","0154","213","140","73","7","220","660","0","33.33","21.21"
"10","014","00","060","0003","0000","72","54","18","3","75","322","0","23.29","16.77"
"10","014","00","060","0003","0155","72","54","18","3","75","322","0","23.29","16.77"
"10","014","00","060","0004","0000","253","174","79","5","258","773","0","33.38","22.51"
"10","014","00","060","0004","0156","253","174","79","5","258","773","0","33.38","22.51"
"10","014","00","060","0005","0000","661","390","271","9","670","1890","0","35.45","20.63"
"10","014","00","060","0005","0150","327","209","118","5","332","983","0","33.77","21.26"
"10","014","00","060","0005","0151","334","181","153","4","338","907","0","37.27","19.96"
"10","014","00","060","0006","0000","95","45","50","3","98","337","0","29.08","13.35"
"10","014","00","060","0006","0158","95","45","50","3","98","337","0","29.08","13.35"
"10","014","00","060","0007","0000","253","149","104","5","258","832","0","31.01","17.91"
"10","014","00","060","0007","0157","253","149","104","5","258","832","0","31.01","17.91"
"10","014","00","060","0008","0000","108","50","58","6","114","304","0","37.50","16.45"
"10","014","00","060","0008","0159","108","50","58","6","114","304","0","37.50","16.45"
"10","014","00","060","0009","0000","125","88","37","3","128","393","0","32.57","22.39"
"10","014","00","060","0009","0160","125","88","37","3","128","393","0","32.57","22.39"
"10","014","00","060","0010","0000","79","48","31","2","81","428","0","18.93","11.21"
"10","014","00","060","0010","0161","79","48","31","2","81","428","0","18.93","11.21"
"10","014","00","070","0000","0000","2058","1433","625","42","2100","7358","8123","28.54","19.48"
"10","014","00","070","0001","0000","338","259","79","10","348","1544","0","22.54","16.77"
"10","014","00","070","0001","0169","130","104","26","7","137","813","0","16.85","12.79"
"10","014","00","070","0001","0170","88","74","14","3","91","332","0","27.41","22.29"
"10","014","00","070","0001","0171","120","81","39","0","120","399","0","30.08","20.30"
"10","014","00","070","0002","0000","247","188","59","9","256","1127","0","22.72","16.68"
"10","014","00","070","0002","0168","247","188","59","9","256","1127","0","22.72","16.68"
"10","014","00","070","0003","0000","265","198","67","3","268","951","0","28.18","20.82"
"10","014","00","070","0003","0167","265","198","67","3","268","951","0","28.18","20.82"
"10","014","00","070","0004","0000","81","58","23","1","82","252","0","32.54","23.02"
"10","014","00","070","0004","0172","81","58","23","1","82","252","0","32.54","23.02"
"10","014","00","070","0005","0000","163","113","50","1","164","511","0","32.09","22.11"
"10","014","00","070","0005","0166","163","113","50","1","164","511","0","32.09","22.11"
"10","014","00","070","0006","0000","292","180","112","4","296","886","0","33.41","20.32"
"10","014","00","070","0006","0165","292","180","112","4","296","886","0","33.41","20.32"
"10","014","00","070","0007","0000","672","437","235","14","686","2087","0","32.87","20.94"
"10","014","00","070","0007","0162","198","120","78","5","203","681","0","29.81","17.62"
"10","014","00","070","0007","0163","217","143","74","2","219","618","0","35.44","23.14"
"10","014","00","070","0007","0164","257","174","83","7","264","788","0","33.50","22.08"
"10","014","00","080","0000","0000","1831","1351","480","49","1880","6168","6828","30.48","21.90"
"10","014","00","080","0001","0000","188","143","45","3","191","599","0","31.89","23.87"
"10","014","00","080","0001","0182","16","10","6","0","16","31","0","51.61","32.26"
"10","014","00","080","0001","0183","172","133","39","3","175","568","0","30.81","23.42"
"10","014","00","080","0002","0000","330","278","52","14","344","1145","0","30.04","24.28"
"10","014","00","080","0002","0179","181","151","30","2","183","642","0","28.50","23.52"
"10","014","00","080","0002","0180","106","93","13","7","113","321","0","35.20","28.97"
"10","014","00","080","0002","0181","43","34","9","5","48","182","0","26.37","18.68"
"10","014","00","080","0003","0000","124","83","41","5","129","519","0","24.86","15.99"
"10","014","00","080","0003","0178","124","83","41","5","129","519","0","24.86","15.99"
"10","014","00","080","0004","0000","585","404","181","9","594","1898","0","31.30","21.29"
"10","014","00","080","0004","0176","345","229","116","2","347","1203","0","28.84","19.04"
"10","014","00","080","0004","0177","240","175","65","7","247","695","0","35.54","25.18"
"10","014","00","080","0005","0000","258","161","97","6","264","853","0","30.95","18.87"
"10","014","00","080","0005","0175","258","161","97","6","264","853","0","30.95","18.87"
"10","014","00","080","0006","0000","346","282","64","12","358","1154","0","31.02","24.44"
"10","014","00","080","0006","0173","137","113","24","7","144","495","0","29.09","22.83"
"10","014","00","080","0006","0174","209","169","40","5","214","659","0","32.47","25.64"
"10","014","00","090","0000","0000","2927","1916","1011","61","2988","9526","10806","31.37","20.11"
"10","014","00","090","0001","0000","377","167","210","7","384","1297","0","29.61","12.88"
"10","014","00","090","0001","0184","203","89","114","5","208","641","0","32.45","13.88"
"10","014","00","090","0001","0185","174","78","96","2","176","656","0","26.83","11.89"
"10","014","00","090","0002","0000","194","105","89","3","197","589","0","33.45","17.83"
"10","014","00","090","0002","0186","194","105","89","3","197","589","0","33.45","17.83"
"10","014","00","090","0003","0000","187","93","94","5","192","588","0","32.65","15.82"
"10","014","00","090","0003","0187","187","93","94","5","192","588","0","32.65","15.82"
"10","014","00","090","0004","0000","187","100","87","3","190","564","0","33.69","17.73"
"10","014","00","090","0004","0188","187","100","87","3","190","564","0","33.69","17.73"
"10","014","00","090","0005","0000","443","289","154","10","453","1352","0","33.51","21.38"
"10","014","00","090","0005","0191","220","141","79","3","223","645","0","34.57","21.86"
"10","014","00","090","0005","0192","223","148","75","7","230","707","0","32.53","20.93"
"10","014","00","090","0006","0000","575","388","187","12","587","1720","0","34.13","22.56"
"10","014","00","090","0006","0189","335","255","80","7","342","916","0","37.34","27.84"
"10","014","00","090","0006","0190","240","133","107","5","245","804","0","30.47","16.54"
"10","014","00","090","0007","0000","268","175","93","4","272","811","0","33.54","21.58"
"10","014","00","090","0007","0193","137","101","36","0","137","420","0","32.62","24.05"
"10","014","00","090","0007","0194","131","74","57","4","135","391","0","34.53","18.93"
"10","014","00","090","0008","0000","426","365","61","8","434","1705","0","25.45","21.41"
"10","014","00","090","0008","0195","206","181","25","5","211","832","0","25.36","21.75"
"10","014","00","090","0008","0196","220","184","36","3","223","873","0","25.54","21.08"
"10","014","00","090","0009","0000","270","234","36","9","279","900","0","31.00","26.00"
"10","014","00","090","0009","0197","88","81","7","2","90","228","0","39.47","35.53"
"10","014","00","090","0009","0198","182","153","29","7","189","672","0","28.13","22.77"
"10","014","00","100","0000","0000","1345","1000","345","34","1379","4892","5663","28.19","20.44"
"10","014","00","100","0001","0000","207","174","33","9","216","733","0","29.47","23.74"
"10","014","00","100","0001","0203","109","95","14","6","115","365","0","31.51","26.03"
"10","014","00","100","0001","0204","98","79","19","3","101","368","0","27.45","21.47"
"10","014","00","100","0002","0000","289","264","25","6","295","1061","0","27.80","24.88"
"10","014","00","100","0002","0202","289","264","25","6","295","1061","0","27.80","24.88"
"10","014","00","100","0003","0000","343","248","95","8","351","1229","0","28.56","20.18"
"10","014","00","100","0003","0201","343","248","95","8","351","1229","0","28.56","20.18"
"10","014","00","100","0004","0000","336","176","160","7","343","1341","0","25.58","13.12"
"10","014","00","100","0004","0200","336","176","160","7","343","1341","0","25.58","13.12"
"10","014","00","100","0005","0000","170","138","32","4","174","528","0","32.95","26.14"
"10","014","00","100","0005","0199","170","138","32","4","174","528","0","32.95","26.14"
"10","014","00","110","0000","0000","623","468","155","11","634","3562","4083","17.80","13.14"
"10","014","00","110","0001","0000","196","152","44","6","202","986","0","20.49","15.42"
"10","014","00","110","0001","0207","138","104","34","4","142","782","0","18.16","13.30"
"10","014","00","110","0001","0208","58","48","10","2","60","204","0","29.41","23.53"
"10","014","00","110","0002","0000","171","126","45","1","172","1038","0","16.57","12.14"
"10","014","00","110","0002","0206","171","126","45","1","172","1038","0","16.57","12.14"
"10","014","00","110","0003","0000","256","190","66","4","260","1538","0","16.91","12.35"
"10","014","00","110","0003","0205","256","190","66","4","260","1538","0","16.91","12.35"
"10","014","00","120","0000","0000","897","747","150","11","908","3275","4132","27.73","22.81"
"10","014","00","120","0001","0000","195","168","27","2","197","730","0","26.99","23.01"
"10","014","00","120","0001","0212","195","168","27","2","197","730","0","26.99","23.01"
"10","014","00","120","0002","0000","104","85","19","1","105","251","0","41.83","33.86"
"10","014","00","120","0002","0213","104","85","19","1","105","251","0","41.83","33.86"
"10","014","00","120","0003","0000","67","42","25","1","68","261","0","26.05","16.09"
"10","014","00","120","0003","0214","67","42","25","1","68","261","0","26.05","16.09"
"10","014","00","120","0004","0000","224","189","35","4","228","957","0","23.82","19.75"
"10","014","00","120","0004","0211","224","189","35","4","228","957","0","23.82","19.75"
"10","014","00","120","0005","0000","165","138","27","0","165","575","0","28.70","24.00"
"10","014","00","120","0005","0210","165","138","27","0","165","575","0","28.70","24.00"
"10","014","00","120","0006","0000","142","125","17","3","145","501","0","28.94","24.95"
"10","014","00","120","0006","0209","142","125","17","3","145","501","0","28.94","24.95"
"10","014","00","130","0000","0000","864","703","161","22","886","2912","3575","30.43","24.14"
"10","014","00","130","0001","0000","182","155","27","6","188","593","0","31.70","26.14"
"10","014","00","130","0001","0218","182","155","27","6","188","593","0","31.70","26.14"
"10","014","00","130","0002","0000","111","98","13","2","113","318","0","35.53","30.82"
"10","014","00","130","0002","0217","111","98","13","2","113","318","0","35.53","30.82"
"10","014","00","130","0003","0000","133","117","16","5","138","421","0","32.78","27.79"
"10","014","00","130","0003","0216","133","117","16","5","138","421","0","32.78","27.79"
"10","014","00","130","0004","0000","144","129","15","4","148","577","0","25.65","22.36"
"10","014","00","130","0004","0219","144","129","15","4","148","577","0","25.65","22.36"
"10","014","00","130","0005","0000","294","204","90","5","299","1003","0","29.81","20.34"
"10","014","00","130","0005","0215","294","204","90","5","299","1003","0","29.81","20.34"
"10","014","00","140","0000","0000","1120","996","124","26","1146","3004","3673","38.15","33.16"
"10","014","00","140","0001","0000","243","215","28","6","249","512","0","48.63","41.99"
"10","014","00","140","0001","0223","243","215","28","6","249","512","0","48.63","41.99"
"10","014","00","140","0002","0000","254","233","21","5","259","603","0","42.95","38.64"
"10","014","00","140","0002","0222","254","233","21","5","259","603","0","42.95","38.64"
"10","014","00","140","0003","0000","378","325","53","9","387","1235","0","31.34","26.32"
"10","014","00","140","0003","0220","202","180","22","4","206","650","0","31.69","27.69"
"10","014","00","140","0003","0221","176","145","31","5","181","585","0","30.94","24.79"
"10","014","00","140","0004","0000","122","117","5","2","124","325","0","38.15","36.00"
"10","014","00","140","0004","0224","122","117","5","2","124","325","0","38.15","36.00"
"10","014","00","140","0005","0000","123","106","17","4","127","329","0","38.60","32.22"
"10","014","00","140","0005","0225","123","106","17","4","127","329","0","38.60","32.22"
"10","014","00","150","0000","0000","1059","900","159","13","1072","2990","3450","35.85","30.10"
"10","014","00","150","0001","0000","230","202","28","5","235","589","0","39.90","34.30"
"10","014","00","150","0001","0231","230","202","28","5","235","589","0","39.90","34.30"
"10","014","00","150","0002","0000","274","234","40","2","276","851","0","32.43","27.50"
"10","014","00","150","0002","0232","274","234","40","2","276","851","0","32.43","27.50"
"10","014","00","150","0003","0000","99","82","17","1","100","334","0","29.94","24.55"
"10","014","00","150","0003","0230","99","82","17","1","100","334","0","29.94","24.55"
"10","014","00","150","0004","0000","206","172","34","3","209","548","0","38.14","31.39"
"10","014","00","150","0004","0226","83","65","18","3","86","232","0","37.07","28.02"
"10","014","00","150","0004","0227","123","107","16","0","123","316","0","38.92","33.86"
"10","014","00","150","0005","0000","143","114","29","0","143","359","0","39.83","31.75"
"10","014","00","150","0005","0229","143","114","29","0","143","359","0","39.83","31.75"
"10","014","00","150","0006","0000","107","96","11","2","109","309","0","35.28","31.07"
"10","014","00","150","0006","0228","107","96","11","2","109","309","0","35.28","31.07"
"10","014","00","160","0000","0000","784","514","270","30","814","4290","5199","18.97","11.98"
"10","014","00","160","0001","0000","205","126","79","5","210","1293","0","16.24","9.74"
"10","014","00","160","0001","0235","205","126","79","5","210","1293","0","16.24","9.74"
"10","014","00","160","0002","0000","124","57","67","14","138","773","0","17.85","7.37"
"10","014","00","160","0002","0236","124","57","67","14","138","773","0","17.85","7.37"
"10","014","00","160","0003","0000","271","183","88","6","277","1256","0","22.05","14.57"
"10","014","00","160","0003","0234","271","183","88","6","277","1256","0","22.05","14.57"
"10","014","00","160","0004","0000","184","148","36","5","189","968","0","19.52","15.29"
"10","014","00","160","0004","0233","184","148","36","5","189","968","0","19.52","15.29"
"10","016","00","000","0000","0000","26236","13569","12667","283","26519","92051","105634","28.81","14.74"
"10","016","00","010","0000","0000","17055","9264","7791","158","17213","54139","62912","31.79","17.11"
"10","016","00","010","0002","0000","136","76","60","1","137","496","0","27.62","15.32"
"10","016","00","010","0002","0001","136","76","60","1","137","496","0","27.62","15.32"
"10","016","00","010","0003","0000","219","124","95","1","220","534","0","41.20","23.22"
"10","016","00","010","0003","0002","219","124","95","1","220","534","0","41.20","23.22"
"10","016","00","010","0004","0000","198","99","99","3","201","520","0","38.65","19.04"
"10","016","00","010","0004","0003","198","99","99","3","201","520","0","38.65","19.04"
"10","016","00","010","0005","0000","334","159","175","2","336","872","0","38.53","18.23"
"10","016","00","010","0005","0004","334","159","175","2","336","872","0","38.53","18.23"
"10","016","00","010","0006","0000","377","173","204","4","381","932","0","40.88","18.56"
"10","016","00","010","0006","0005","377","173","204","4","381","932","0","40.88","18.56"
"10","016","00","010","0007","0000","269","163","106","2","271","785","0","34.52","20.76"
"10","016","00","010","0007","0006","269","163","106","2","271","785","0","34.52","20.76"
"10","016","00","010","0008","0000","646","340","306","4","650","1903","0","34.16","17.87"
"10","016","00","010","0008","0007","323","159","164","3","326","935","0","34.87","17.01"
"10","016","00","010","0008","0008","323","181","142","1","324","968","0","33.47","18.70"
"10","016","00","010","0009","0000","1475","1000","475","22","1497","4135","0","36.20","24.18"
"10","016","00","010","0009","0010","500","369","131","11","511","1381","0","37.00","26.72"
"10","016","00","010","0009","0011","505","313","192","4","509","1416","0","35.95","22.10"
"10","016","00","010","0009","0012","470","318","152","7","477","1338","0","35.65","23.77"
"10","016","00","010","0010","0000","411","263","148","5","416","1175","0","35.40","22.38"
"10","016","00","010","0010","0009","411","263","148","5","416","1175","0","35.40","22.38"
"10","016","00","010","0011","0000","1659","938","721","10","1669","5179","0","32.23","18.11"
"10","016","00","010","0011","0013","397","221","176","2","399","1242","0","32.13","17.79"
"10","016","00","010","0011","0014","333","185","148","2","335","1168","0","28.68","15.84"
"10","016","00","010","0011","0015","453","234","219","3","456","1397","0","32.64","16.75"
"10","016","00","010","0011","0016","476","298","178","3","479","1372","0","34.91","21.72"
"10","016","00","010","0012","0000","765","406","359","6","771","2417","0","31.90","16.80"
"10","016","00","010","0012","0017","341","188","153","1","342","1163","0","29.41","16.17"
"10","016","00","010","0012","0018","424","218","206","5","429","1254","0","34.21","17.38"
"10","016","00","010","0013","0000","514","285","229","2","516","1483","0","34.79","19.22"
"10","016","00","010","0013","0019","514","285","229","2","516","1483","0","34.79","19.22"
"10","016","00","010","0014","0000","1783","1020","763","11","1794","5825","0","30.80","17.51"
"10","016","00","010","0014","0020","371","215","156","4","375","1141","0","32.87","18.84"
"10","016","00","010","0014","0021","486","281","205","1","487","1376","0","35.39","20.42"
"10","016","00","010","0014","0022","522","347","175","3","525","1551","0","33.85","22.37"
"10","016","00","010","0014","0023","404","177","227","3","407","1757","0","23.16","10.07"
"10","016","00","010","0015","0000","998","576","422","4","1002","3202","0","31.29","17.99"
"10","016","00","010","0015","0024","312","178","134","1","313","1006","0","31.11","17.69"
"10","016","00","010","0015","0025","358","207","151","2","360","1066","0","33.77","19.42"
"10","016","00","010","0015","0026","328","191","137","1","329","1130","0","29.12","16.90"
"10","016","00","010","0016","0000","985","544","441","11","996","3283","0","30.34","16.57"
"10","016","00","010","0016","0027","339","194","145","4","343","1038","0","33.04","18.69"
"10","016","00","010","0016","0028","327","185","142","5","332","1142","0","29.07","16.20"
"10","016","00","010","0016","0029","319","165","154","2","321","1103","0","29.10","14.96"
"10","016","00","010","0017","0000","561","304","257","8","569","1855","0","30.67","16.39"
"10","016","00","010","0017","0030","263","146","117","5","268","1007","0","26.61","14.50"
"10","016","00","010","0017","0031","298","158","140","3","301","848","0","35.50","18.63"
"10","016","00","010","0018","0000","223","143","80","1","224","979","0","22.88","14.61"
"10","016","00","010","0018","0032","223","143","80","1","224","979","0","22.88","14.61"
"10","016","00","010","0019","0000","290","142","148","1","291","953","0","30.54","14.90"
"10","016","00","010","0019","0033","290","142","148","1","291","953","0","30.54","14.90"
"10","016","00","010","0020","0000","878","532","346","5","883","2661","0","33.18","19.99"
"10","016","00","010","0020","0034","337","208","129","2","339","930","0","36.45","22.37"
"10","016","00","010","0020","0035","295","180","115","2","297","898","0","33.07","20.04"
"10","016","00","010","0020","0036","246","144","102","1","247","833","0","29.65","17.29"
"10","016","00","010","0021","0000","144","71","73","1","145","439","0","33.03","16.17"
"10","016","00","010","0021","0037","144","71","73","1","145","439","0","33.03","16.17"
"10","016","00","010","0022","0000","672","418","254","7","679","2134","0","31.82","19.59"
"10","016","00","010","0022","0038","376","229","147","3","379","1162","0","32.62","19.71"
"10","016","00","010","0022","0039","296","189","107","4","300","972","0","30.86","19.44"
"10","016","00","010","0023","0000","199","105","94","5","204","650","0","31.38","16.15"
"10","016","00","010","0023","0040","199","105","94","5","204","650","0","31.38","16.15"
"10","016","00","010","0024","0000","357","130","227","7","364","1060","0","34.34","12.26"
"10","016","00","010","0024","0042","357","130","227","7","364","1060","0","34.34","12.26"
"10","016","00","010","0025","0000","385","215","170","6","391","1240","0","31.53","17.34"
"10","016","00","010","0025","0041","385","215","170","6","391","1240","0","31.53","17.34"
"10","016","00","010","0026","0000","229","77","152","1","230","677","0","33.97","11.37"
"10","016","00","010","0026","0043","229","77","152","1","230","677","0","33.97","11.37"
"10","016","00","010","0027","0000","514","193","321","7","521","1707","0","30.52","11.31"
"10","016","00","010","0027","0046","230","95","135","2","232","777","0","29.86","12.23"
"10","016","00","010","0027","0047","284","98","186","5","289","930","0","31.08","10.54"
"10","016","00","010","0028","0000","761","254","507","7","768","2539","0","30.25","10.00"
"10","016","00","010","0028","0044","447","156","291","4","451","1454","0","31.02","10.73"
"10","016","00","010","0028","0045","314","98","216","3","317","1085","0","29.22","9.03"
"10","016","00","010","0029","0000","96","51","45","1","97","470","0","20.64","10.85"
"10","016","00","010","0029","0048","96","51","45","1","97","470","0","20.64","10.85"
"10","016","00","010","0030","0000","114","61","53","2","116","378","0","30.69","16.14"
"10","016","00","010","0030","0049","114","61","53","2","116","378","0","30.69","16.14"
"10","016","00","010","0031","0000","305","182","123","4","309","1162","0","26.59","15.66"
"10","016","00","010","0031","0050","305","182","123","4","309","1162","0","26.59","15.66"
"10","016","00","010","0032","0000","382","113","269","5","387","1368","0","28.29","8.26"
"10","016","00","010","0032","0051","382","113","269","5","387","1368","0","28.29","8.26"
"10","016","00","010","0033","0000","133","82","51","1","134","812","0","16.50","10.10"
"10","016","00","010","0033","0052","133","82","51","1","134","812","0","16.50","10.10"
"10","016","00","010","0034","0000","43","25","18","1","44","314","0","14.01","7.96"
"10","016","00","010","0034","0053","43","25","18","1","44","314","0","14.01","7.96"
"10","016","00","020","0000","0000","3982","1817","2165","56","4038","13570","15248","29.76","13.39"
"10","016","00","020","0001","0000","366","201","165","4","370","1199","0","30.86","16.76"
"10","016","00","020","0001","0054","366","201","165","4","370","1199","0","30.86","16.76"
"10","016","00","020","0002","0000","99","55","44","0","99","358","0","27.65","15.36"
"10","016","00","020","0002","0055","99","55","44","0","99","358","0","27.65","15.36"
"10","016","00","020","0003","0000","67","36","31","1","68","243","0","27.98","14.81"
"10","016","00","020","0003","0056","67","36","31","1","68","243","0","27.98","14.81"
"10","016","00","020","0004","0000","87","45","42","4","91","297","0","30.64","15.15"
"10","016","00","020","0004","0057","87","45","42","4","91","297","0","30.64","15.15"
"10","016","00","020","0005","0000","182","53","129","2","184","683","0","26.94","7.76"
"10","016","00","020","0005","0058","182","53","129","2","184","683","0","26.94","7.76"
"10","016","00","020","0006","0000","87","49","38","0","87","327","0","26.61","14.98"
"10","016","00","020","0006","0059","87","49","38","0","87","327","0","26.61","14.98"
"10","016","00","020","0007","0000","217","91","126","5","222","748","0","29.68","12.17"
"10","016","00","020","0007","0060","217","91","126","5","222","748","0","29.68","12.17"
"10","016","00","020","0008","0000","168","83","85","3","171","839","0","20.38","9.89"
"10","016","00","020","0008","0061","168","83","85","3","171","839","0","20.38","9.89"
"10","016","00","020","0009","0000","290","137","153","4","294","860","0","34.19","15.93"
"10","016","00","020","0009","0062","290","137","153","4","294","860","0","34.19","15.93"
"10","016","00","020","0010","0000","49","15","34","1","50","123","0","40.65","12.20"
"10","016","00","020","0010","0063","49","15","34","1","50","123","0","40.65","12.20"
"10","016","00","020","0011","0000","73","35","38","2","75","221","0","33.94","15.84"
"10","016","00","020","0011","0065","73","35","38","2","75","221","0","33.94","15.84"
"10","016","00","020","0012","0000","109","59","50","1","110","300","0","36.67","19.67"
"10","016","00","020","0012","0067","109","59","50","1","110","300","0","36.67","19.67"
"10","016","00","020","0013","0000","131","77","54","3","134","641","0","20.90","12.01"
"10","016","00","020","0013","0066","131","77","54","3","134","641","0","20.90","12.01"
"10","016","00","020","0014","0000","102","55","47","0","102","389","0","26.22","14.14"
"10","016","00","020","0014","0068","102","55","47","0","102","389","0","26.22","14.14"
"10","016","00","020","0015","0000","261","66","195","3","264","807","0","32.71","8.18"
"10","016","00","020","0015","0064","261","66","195","3","264","807","0","32.71","8.18"
"10","016","00","020","0016","0000","122","77","45","1","123","334","0","36.83","23.05"
"10","016","00","020","0016","0069","122","77","45","1","123","334","0","36.83","23.05"
"10","016","00","020","0017","0000","31","15","16","1","32","94","0","34.04","15.96"
"10","016","00","020","0017","0070","31","15","16","1","32","94","0","34.04","15.96"
"10","016","00","020","0018","0000","285","152","133","2","287","911","0","31.50","16.68"
"10","016","00","020","0018","0071","285","152","133","2","287","911","0","31.50","16.68"
"10","016","00","020","0019","0000","296","113","183","7","303","1004","0","30.18","11.25"
"10","016","00","020","0019","0072","296","113","183","7","303","1004","0","30.18","11.25"
"10","016","00","020","0020","0000","195","71","124","0","195","670","0","29.10","10.60"
"10","016","00","020","0020","0073","195","71","124","0","195","670","0","29.10","10.60"
"10","016","00","020","0021","0000","539","257","282","5","544","1760","0","30.91","14.60"
"10","016","00","020","0021","0074","276","143","133","3","279","913","0","30.56","15.66"
"10","016","00","020","0021","0075","263","114","149","2","265","847","0","31.29","13.46"
"10","016","00","020","0022","0000","226","75","151","7","233","762","0","30.58","9.84"
"10","016","00","020","0022","0076","226","75","151","7","233","762","0","30.58","9.84"
"10","016","00","030","0000","0000","2241","1143","1098","27","2268","8798","9915","25.78","12.99"
"10","016","00","030","0001","0000","166","95","71","4","170","525","0","32.38","18.10"
"10","016","00","030","0001","0077","166","95","71","4","170","525","0","32.38","18.10"
"10","016","00","030","0002","0000","207","121","86","0","207","671","0","30.85","18.03"
"10","016","00","030","0002","0078","207","121","86","0","207","671","0","30.85","18.03"
"10","016","00","030","0003","0000","51","27","24","1","52","110","0","47.27","24.55"
"10","016","00","030","0003","0079","51","27","24","1","52","110","0","47.27","24.55"
"10","016","00","030","0004","0000","48","36","12","0","48","156","0","30.77","23.08"
"10","016","00","030","0004","0080","48","36","12","0","48","156","0","30.77","23.08"
"10","016","00","030","0005","0000","79","45","34","1","80","297","0","26.94","15.15"
"10","016","00","030","0005","0081","79","45","34","1","80","297","0","26.94","15.15"
"10","016","00","030","0006","0000","48","32","16","0","48","216","0","22.22","14.81"
"10","016","00","030","0006","0082","48","32","16","0","48","216","0","22.22","14.81"
"10","016","00","030","0007","0000","62","32","30","1","63","168","0","37.50","19.05"
"10","016","00","030","0007","0083","62","32","30","1","63","168","0","37.50","19.05"
"10","016","00","030","0008","0000","466","250","216","4","470","1719","0","27.34","14.54"
"10","016","00","030","0008","0084","272","140","132","1","273","986","0","27.69","14.20"
"10","016","00","030","0008","0085","194","110","84","3","197","733","0","26.88","15.01"
"10","016","00","030","0009","0000","90","48","42","0","90","307","0","29.32","15.64"
"10","016","00","030","0009","0086","90","48","42","0","90","307","0","29.32","15.64"
"10","016","00","030","0010","0000","212","76","136","4","216","766","0","28.20","9.92"
"10","016","00","030","0010","0087","212","76","136","4","216","766","0","28.20","9.92"
"10","016","00","030","0011","0000","203","88","115","3","206","798","0","25.81","11.03"
"10","016","00","030","0011","0088","203","88","115","3","206","798","0","25.81","11.03"
"10","016","00","030","0012","0000","261","49","212","4","265","1412","0","18.77","3.47"
"10","016","00","030","0012","0089","261","49","212","4","265","1412","0","18.77","3.47"
"10","016","00","030","0013","0000","234","174","60","3","237","1110","0","21.35","15.68"
"10","016","00","030","0013","0090","234","174","60","3","237","1110","0","21.35","15.68"
"10","016","00","030","0014","0000","64","55","9","1","65","274","0","23.72","20.07"
"10","016","00","030","0014","0091","64","55","9","1","65","274","0","23.72","20.07"
"10","016","00","030","0015","0000","50","15","35","1","51","269","0","18.96","5.58"
"10","016","00","030","0015","0092","50","15","35","1","51","269","0","18.96","5.58"
"10","016","00","040","0000","0000","1903","859","1044","18","1921","7398","8309","25.97","11.61"
"10","016","00","040","0001","0000","56","19","37","1","57","301","0","18.94","6.31"
"10","016","00","040","0001","0093","56","19","37","1","57","301","0","18.94","6.31"
"10","016","00","040","0002","0000","98","33","65","2","100","415","0","24.10","7.95"
"10","016","00","040","0002","0094","98","33","65","2","100","415","0","24.10","7.95"
"10","016","00","040","0003","0000","97","67","30","0","97","285","0","34.04","23.51"
"10","016","00","040","0003","0096","97","67","30","0","97","285","0","34.04","23.51"
"10","016","00","040","0004","0000","219","84","135","3","222","817","0","27.17","10.28"
"10","016","00","040","0004","0095","219","84","135","3","222","817","0","27.17","10.28"
"10","016","00","040","0005","0000","190","67","123","0","190","665","0","28.57","10.08"
"10","016","00","040","0005","0097","190","67","123","0","190","665","0","28.57","10.08"
"10","016","00","040","0006","0000","56","12","44","1","57","145","0","39.31","8.28"
"10","016","00","040","0006","0098","56","12","44","1","57","145","0","39.31","8.28"
"10","016","00","040","0007","0000","181","81","100","3","184","642","0","28.66","12.62"
"10","016","00","040","0007","0099","181","81","100","3","184","642","0","28.66","12.62"
"10","016","00","040","0008","0000","63","16","47","1","64","225","0","28.44","7.11"
"10","016","00","040","0008","0100","63","16","47","1","64","225","0","28.44","7.11"
"10","016","00","040","0009","0000","142","43","99","0","142","580","0","24.48","7.41"
"10","016","00","040","0009","0101","142","43","99","0","142","580","0","24.48","7.41"
"10","016","00","040","0010","0000","324","104","220","3","327","1265","0","25.85","8.22"
"10","016","00","040","0010","0102","324","104","220","3","327","1265","0","25.85","8.22"
"10","016","00","040","0011","0000","477","333","144","4","481","2058","0","23.37","16.18"
"10","016","00","040","0011","0103","229","160","69","2","231","927","0","24.92","17.26"
"10","016","00","040","0011","0104","248","173","75","2","250","1131","0","22.10","15.30"
"10","016","00","050","0000","0000","657","259","398","14","671","4779","5401","14.04","5.42"
"10","016","00","050","0001","0000","130","57","73","3","133","723","0","18.40","7.88"
"10","016","00","050","0001","0105","130","57","73","3","133","723","0","18.40","7.88"
"10","016","00","050","0002","0000","92","55","37","0","92","436","0","21.10","12.61"
"10","016","00","050","0002","0106","92","55","37","0","92","436","0","21.10","12.61"
"10","016","00","050","0003","0000","53","18","35","2","55","342","0","16.08","5.26"
"10","016","00","050","0003","0107","53","18","35","2","55","342","0","16.08","5.26"
"10","016","00","050","0004","0000","93","33","60","3","96","487","0","19.71","6.78"
"10","016","00","050","0004","0108","93","33","60","3","96","487","0","19.71","6.78"
"10","016","00","050","0005","0000","175","37","138","5","180","1425","0","12.63","2.60"
"10","016","00","050","0005","0109","83","22","61","4","87","669","0","13.00","3.29"
"10","016","00","050","0005","0110","92","15","77","1","93","756","0","12.30","1.98"
"10","016","00","050","0006","0000","18","6","12","0","18","527","0","3.42","1.14"
"10","016","00","050","0006","0112","18","6","12","0","18","527","0","3.42","1.14"
"10","016","00","050","0007","0000","8","4","4","0","8","220","0","3.64","1.82"
"10","016","00","050","0007","0113","8","4","4","0","8","220","0","3.64","1.82"
"10","016","00","050","0008","0000","38","17","21","0","38","296","0","12.84","5.74"
"10","016","00","050","0008","0111","38","17","21","0","38","296","0","12.84","5.74"
"10","016","00","050","0009","0000","50","32","18","1","51","323","0","15.79","9.91"
"10","016","00","050","0009","0114","50","32","18","1","51","323","0","15.79","9.91"
"10","016","00","060","0000","0000","398","227","171","10","408","3367","3849","12.12","6.74"
"10","016","00","060","0001","0000","22","9","13","1","23","259","0","8.88","3.47"
"10","016","00","060","0001","0115","22","9","13","1","23","259","0","8.88","3.47"
"10","016","00","060","0002","0000","62","38","24","1","63","573","0","10.99","6.63"
"10","016","00","060","0002","0116","62","38","24","1","63","573","0","10.99","6.63"
"10","016","00","060","0003","0000","71","45","26","1","72","643","0","11.20","7.00"
"10","016","00","060","0003","0117","71","45","26","1","72","643","0","11.20","7.00"
"10","016","00","060","0004","0000","57","25","32","1","58","367","0","15.80","6.81"
"10","016","00","060","0004","0118","57","25","32","1","58","367","0","15.80","6.81"
"10","016","00","060","0005","0000","45","19","26","1","46","377","0","12.20","5.04"
"10","016","00","060","0005","0119","45","19","26","1","46","377","0","12.20","5.04"
"10","016","00","060","0006","0000","141","91","50","5","146","1148","0","12.72","7.93"
"10","016","00","060","0006","0120","141","91","50","5","146","1148","0","12.72","7.93"
"10","017","00","000","0000","0000","129038","72786","56252","1024","130062","318539","365891","40.83","22.85"
"10","017","00","010","0000","0000","17350","9617","7733","144","17494","45298","50967","38.62","21.23"
"10","017","00","010","0001","0000","307","163","144","2","309","649","0","47.61","25.12"
"10","017","00","010","0001","0040","307","163","144","2","309","649","0","47.61","25.12"
"10","017","00","010","0002","0000","542","312","230","6","548","1166","0","47.00","26.76"
"10","017","00","010","0002","0038","542","312","230","6","548","1166","0","47.00","26.76"
"10","017","00","010","0003","0000","373","196","177","1","374","874","0","42.79","22.43"
"10","017","00","010","0003","0039","373","196","177","1","374","874","0","42.79","22.43"
"10","017","00","010","0004","0000","402","223","179","5","407","991","0","41.07","22.50"
"10","017","00","010","0004","0037","402","223","179","5","407","991","0","41.07","22.50"
"10","017","00","010","0005","0000","582","292","290","5","587","1177","0","49.87","24.81"
"10","017","00","010","0005","0036","582","292","290","5","587","1177","0","49.87","24.81"
"10","017","00","010","0006","0000","465","236","229","2","467","1117","0","41.81","21.13"
"10","017","00","010","0006","0035","465","236","229","2","467","1117","0","41.81","21.13"
"10","017","00","010","0007","0000","537","316","221","3","540","1217","0","44.37","25.97"
"10","017","00","010","0007","0034","537","316","221","3","540","1217","0","44.37","25.97"
"10","017","00","010","0008","0000","320","182","138","8","328","752","0","43.62","24.20"
"10","017","00","010","0008","0033","320","182","138","8","328","752","0","43.62","24.20"
"10","017","00","010","0009","0000","549","318","231","4","553","1594","0","34.69","19.95"
"10","017","00","010","0009","0032","549","318","231","4","553","1594","0","34.69","19.95"
"10","017","00","010","0010","0000","996","612","384","8","1004","2260","0","44.42","27.08"
"10","017","00","010","0010","0030","544","303","241","5","549","1181","0","46.49","25.66"
"10","017","00","010","0010","0031","452","309","143","3","455","1079","0","42.17","28.64"
"10","017","00","010","0011","0000","605","340","265","6","611","1294","0","47.22","26.28"
"10","017","00","010","0011","0029","605","340","265","6","611","1294","0","47.22","26.28"
"10","017","00","010","0012","0000","810","513","297","9","819","1981","0","41.34","25.90"
"10","017","00","010","0012","0027","505","311","194","4","509","1129","0","45.08","27.55"
"10","017","00","010","0012","0028","305","202","103","5","310","852","0","36.38","23.71"
"10","017","00","010","0013","0000","783","527","256","12","795","1945","0","40.87","27.10"
"10","017","00","010","0013","0025","474","320","154","7","481","1103","0","43.61","29.01"
"10","017","00","010","0013","0026","309","207","102","5","314","842","0","37.29","24.58"
"10","017","00","010","0014","0000","511","284","227","3","514","1245","0","41.29","22.81"
"10","017","00","010","0014","0024","511","284","227","3","514","1245","0","41.29","22.81"
"10","017","00","010","0015","0000","393","243","150","3","396","1125","0","35.20","21.60"
"10","017","00","010","0015","0021","393","243","150","3","396","1125","0","35.20","21.60"
"10","017","00","010","0016","0000","678","315","363","6","684","1688","0","40.52","18.66"
"10","017","00","010","0016","0018","380","188","192","5","385","990","0","38.89","18.99"
"10","017","00","010","0016","0019","298","127","171","1","299","698","0","42.84","18.19"
"10","017","00","010","0017","0000","298","179","119","5","303","920","0","32.93","19.46"
"10","017","00","010","0017","0020","298","179","119","5","303","920","0","32.93","19.46"
"10","017","00","010","0018","0000","459","211","248","1","460","1211","0","37.99","17.42"
"10","017","00","010","0018","0017","459","211","248","1","460","1211","0","37.99","17.42"
"10","017","00","010","0019","0000","599","170","429","5","604","1442","0","41.89","11.79"
"10","017","00","010","0019","0006","599","170","429","5","604","1442","0","41.89","11.79"
"10","017","00","010","0020","0000","402","164","238","3","405","1212","0","33.42","13.53"
"10","017","00","010","0020","0007","402","164","238","3","405","1212","0","33.42","13.53"
"10","017","00","010","0021","0000","204","60","144","2","206","439","0","46.92","13.67"
"10","017","00","010","0021","0001","204","60","144","2","206","439","0","46.92","13.67"
"10","017","00","010","0022","0000","1832","1001","831","14","1846","5622","0","32.84","17.81"
"10","017","00","010","0022","0002","428","175","253","2","430","1226","0","35.07","14.27"
"10","017","00","010","0022","0003","416","240","176","8","424","1343","0","31.57","17.87"
"10","017","00","010","0022","0004","531","307","224","1","532","1557","0","34.17","19.72"
"10","017","00","010","0022","0005","457","279","178","3","460","1496","0","30.75","18.65"
"10","017","00","010","0023","0000","576","305","271","2","578","1615","0","35.79","18.89"
"10","017","00","010","0023","0023","576","305","271","2","578","1615","0","35.79","18.89"
"10","017","00","010","0024","0000","354","205","149","7","361","907","0","39.80","22.60"
"10","017","00","010","0024","0022","354","205","149","7","361","907","0","39.80","22.60"
"10","017","00","010","0025","0000","2153","1320","833","11","2164","5731","0","37.76","23.03"
"10","017","00","010","0025","0012","561","330","231","4","565","1473","0","38.36","22.40"
"10","017","00","010","0025","0013","519","324","195","2","521","1463","0","35.61","22.15"
"10","017","00","010","0025","0014","418","253","165","3","421","1100","0","38.27","23.00"
"10","017","00","010","0025","0015","387","249","138","1","388","915","0","42.40","27.21"
"10","017","00","010","0025","0016","268","164","104","1","269","780","0","34.49","21.03"
"10","017","00","010","0026","0000","1620","930","690","11","1631","5124","0","31.83","18.15"
"10","017","00","010","0026","0008","501","274","227","2","503","1435","0","35.05","19.09"
"10","017","00","010","0026","0009","591","348","243","3","594","1580","0","37.59","22.03"
"10","017","00","010","0026","0010","205","128","77","3","208","777","0","26.77","16.47"
"10","017","00","010","0026","0011","323","180","143","3","326","1332","0","24.47","13.51"
"10","017","00","020","0000","0000","18039","9617","8422","157","18196","46431","53534","39.19","20.71"
"10","017","00","020","0001","0000","1404","802","602","10","1414","3732","0","37.89","21.49"
"10","017","00","020","0001","0235","461","250","211","5","466","1219","0","38.23","20.51"
"10","017","00","020","0001","0236","454","268","186","4","458","1182","0","38.75","22.67"
"10","017","00","020","0001","0237","489","284","205","1","490","1331","0","36.81","21.34"
"10","017","00","020","0002","0000","1019","525","494","8","1027","2522","0","40.72","20.82"
"10","017","00","020","0002","0238","476","213","263","5","481","1075","0","44.74","19.81"
"10","017","00","020","0002","0239","543","312","231","3","546","1447","0","37.73","21.56"
"10","017","00","020","0003","0000","1462","840","622","12","1474","3476","0","42.41","24.17"
"10","017","00","020","0003","0242","460","235","225","4","464","1094","0","42.41","21.48"
"10","017","00","020","0003","0243","512","284","228","3","515","1215","0","42.39","23.37"
"10","017","00","020","0003","0244","490","321","169","5","495","1167","0","42.42","27.51"
"10","017","00","020","0004","0000","832","467","365","6","838","1877","0","44.65","24.88"
"10","017","00","020","0004","0245","419","225","194","6","425","934","0","45.50","24.09"
"10","017","00","020","0004","0246","413","242","171","0","413","943","0","43.80","25.66"
"10","017","00","020","0005","0000","936","557","379","11","947","2193","0","43.18","25.40"
"10","017","00","020","0005","0247","514","312","202","8","522","1211","0","43.10","25.76"
"10","017","00","020","0005","0248","422","245","177","3","425","982","0","43.28","24.95"
"10","017","00","020","0006","0000","592","307","285","6","598","1482","0","40.35","20.72"
"10","017","00","020","0006","0249","118","55","63","0","118","284","0","41.55","19.37"
"10","017","00","020","0006","0250","474","252","222","6","480","1198","0","40.07","21.04"
"10","017","00","020","0007","0000","471","218","253","8","479","1165","0","41.12","18.71"
"10","017","00","020","0007","0251","471","218","253","8","479","1165","0","41.12","18.71"
"10","017","00","020","0008","0000","837","432","405","3","840","2268","0","37.04","19.05"
"10","017","00","020","0008","0255","347","179","168","1","348","982","0","35.44","18.23"
"10","017","00","020","0008","0256","490","253","237","2","492","1286","0","38.26","19.67"
"10","017","00","020","0009","0000","1651","913","738","14","1665","4366","0","38.14","20.91"
"10","017","00","020","0009","0252","504","270","234","5","509","1311","0","38.83","20.59"
"10","017","00","020","0009","0253","686","390","296","6","692","1723","0","40.16","22.63"
"10","017","00","020","0009","0254","461","253","208","3","464","1332","0","34.83","18.99"
"10","017","00","020","0010","0000","1386","673","713","10","1396","3616","0","38.61","18.61"
"10","017","00","020","0010","0261","691","353","338","5","696","1791","0","38.86","19.71"
"10","017","00","020","0010","0262","695","320","375","5","700","1825","0","38.36","17.53"
"10","017","00","020","0011","0000","730","368","362","10","740","2070","0","35.75","17.78"
"10","017","00","020","0011","0257","422","201","221","7","429","1076","0","39.87","18.68"
"10","017","00","020","0011","0258","308","167","141","3","311","994","0","31.29","16.80"
"10","017","00","020","0012","0000","164","70","94","2","166","402","0","41.29","17.41"
"10","017","00","020","0012","0270","164","70","94","2","166","402","0","41.29","17.41"
"10","017","00","020","0013","0000","103","53","50","2","105","317","0","33.12","16.72"
"10","017","00","020","0013","0271","103","53","50","2","105","317","0","33.12","16.72"
"10","017","00","020","0014","0000","130","57","73","3","133","325","0","40.92","17.54"
"10","017","00","020","0014","0272","130","57","73","3","133","325","0","40.92","17.54"
"10","017","00","020","0015","0000","917","565","352","4","921","1965","0","46.87","28.75"
"10","017","00","020","0015","0273","404","234","170","1","405","975","0","41.54","24.00"
"10","017","00","020","0015","0274","513","331","182","3","516","990","0","52.12","33.43"
"10","017","00","020","0016","0000","226","90","136","8","234","448","0","52.23","20.09"
"10","017","00","020","0016","0275","226","90","136","8","234","448","0","52.23","20.09"
"10","017","00","020","0017","0000","810","446","364","11","821","1879","0","43.69","23.74"
"10","017","00","020","0017","0240","416","229","187","4","420","968","0","43.39","23.66"
"10","017","00","020","0017","0241","394","217","177","7","401","911","0","44.02","23.82"
"10","017","00","020","0018","0000","2137","1077","1060","12","2149","6051","0","35.51","17.80"
"10","017","00","020","0018","0263","523","254","269","2","525","1502","0","34.95","16.91"
"10","017","00","020","0018","0264","504","243","261","2","506","1474","0","34.33","16.49"
"10","017","00","020","0018","0265","467","223","244","2","469","1450","0","32.34","15.38"
"10","017","00","020","0018","0266","643","357","286","6","649","1625","0","39.94","21.97"
"10","017","00","020","0019","0000","1388","704","684","13","1401","3772","0","37.14","18.66"
"10","017","00","020","0019","0267","488","249","239","6","494","1375","0","35.93","18.11"
"10","017","00","020","0019","0268","380","180","200","4","384","1049","0","36.61","17.16"
"10","017","00","020","0019","0269","520","275","245","3","523","1348","0","38.80","20.40"
"10","017","00","020","0020","0000","844","453","391","4","848","2505","0","33.85","18.08"
"10","017","00","020","0020","0259","410","209","201","4","414","1230","0","33.66","16.99"
"10","017","00","020","0020","0260","434","244","190","0","434","1275","0","34.04","19.14"
"10","017","00","030","0000","0000","13483","7819","5664","102","13585","33447","38494","40.62","23.38"
"10","017","00","030","0001","0000","556","305","251","7","563","1390","0","40.50","21.94"
"10","017","00","030","0001","0205","556","305","251","7","563","1390","0","40.50","21.94"
"10","017","00","030","0002","0000","277","142","135","3","280","641","0","43.68","22.15"
"10","017","00","030","0002","0207","277","142","135","3","280","641","0","43.68","22.15"
"10","017","00","030","0003","0000","268","133","135","0","268","754","0","35.54","17.64"
"10","017","00","030","0003","0208","268","133","135","0","268","754","0","35.54","17.64"
"10","017","00","030","0004","0000","1497","878","619","9","1506","3626","0","41.53","24.21"
"10","017","00","030","0004","0209","425","277","148","3","428","1038","0","41.23","26.69"
"10","017","00","030","0004","0210","515","311","204","4","519","1229","0","42.23","25.31"
"10","017","00","030","0004","0211","557","290","267","2","559","1359","0","41.13","21.34"
"10","017","00","030","0005","0000","1049","627","422","7","1056","2636","0","40.06","23.79"
"10","017","00","030","0005","0221","550","305","245","5","555","1262","0","43.98","24.17"
"10","017","00","030","0005","0222","499","322","177","2","501","1374","0","36.46","23.44"
"10","017","00","030","0006","0000","1278","852","426","2","1280","2957","0","43.29","28.81"
"10","017","00","030","0006","0223","468","389","79","1","469","989","0","47.42","39.33"
"10","017","00","030","0006","0224","395","226","169","0","395","975","0","40.51","23.18"
"10","017","00","030","0006","0225","415","237","178","1","416","993","0","41.89","23.87"
"10","017","00","030","0007","0000","1005","587","418","7","1012","2529","0","40.02","23.21"
"10","017","00","030","0007","0214","460","250","210","6","466","1105","0","42.17","22.62"
"10","017","00","030","0007","0215","545","337","208","1","546","1424","0","38.34","23.67"
"10","017","00","030","0008","0000","1091","600","491","9","1100","2563","0","42.92","23.41"
"10","017","00","030","0008","0212","658","376","282","6","664","1460","0","45.48","25.75"
"10","017","00","030","0008","0213","433","224","209","3","436","1103","0","39.53","20.31"
"10","017","00","030","0009","0000","141","70","71","4","145","405","0","35.80","17.28"
"10","017","00","030","0009","0216","141","70","71","4","145","405","0","35.80","17.28"
"10","017","00","030","0010","0000","1945","1077","868","14","1959","4724","0","41.47","22.80"
"10","017","00","030","0010","0217","620","334","286","5","625","1493","0","41.86","22.37"
"10","017","00","030","0010","0218","436","242","194","3","439","1045","0","42.01","23.16"
"10","017","00","030","0010","0219","460","258","202","4","464","1072","0","43.28","24.07"
"10","017","00","030","0010","0220","429","243","186","2","431","1114","0","38.69","21.81"
"10","017","00","030","0011","0000","174","90","84","1","175","408","0","42.89","22.06"
"10","017","00","030","0011","0206","174","90","84","1","175","408","0","42.89","22.06"
"10","017","00","030","0012","0000","1999","1137","862","17","2016","4877","0","41.34","23.31"
"10","017","00","030","0012","0231","556","321","235","4","560","1327","0","42.20","24.19"
"10","017","00","030","0012","0232","492","274","218","5","497","1219","0","40.77","22.48"
"10","017","00","030","0012","0233","393","233","160","3","396","965","0","41.04","24.15"
"10","017","00","030","0012","0234","558","309","249","5","563","1366","0","41.22","22.62"
"10","017","00","030","0013","0000","2203","1321","882","22","2225","5937","0","37.48","22.25"
"10","017","00","030","0013","0226","436","256","180","4","440","1202","0","36.61","21.30"
"10","017","00","030","0013","0227","388","210","178","5","393","1215","0","32.35","17.28"
"10","017","00","030","0013","0228","476","286","190","3","479","1187","0","40.35","24.09"
"10","017","00","030","0013","0229","558","348","210","8","566","1368","0","41.37","25.44"
"10","017","00","030","0013","0230","345","221","124","2","347","965","0","35.96","22.90"
"10","017","00","040","0000","0000","14756","7804","6952","123","14879","35403","42303","42.03","22.04"
"10","017","00","040","0001","0000","643","348","295","6","649","1698","0","38.22","20.49"
"10","017","00","040","0001","0079","317","165","152","3","320","860","0","37.21","19.19"
"10","017","00","040","0001","0080","326","183","143","3","329","838","0","39.26","21.84"
"10","017","00","040","0002","0000","428","238","190","4","432","1015","0","42.56","23.45"
"10","017","00","040","0002","0081","428","238","190","4","432","1015","0","42.56","23.45"
"10","017","00","040","0003","0000","635","340","295","8","643","1481","0","43.42","22.96"
"10","017","00","040","0003","0082","398","208","190","4","402","936","0","42.95","22.22"
"10","017","00","040","0003","0083","237","132","105","4","241","545","0","44.22","24.22"
"10","017","00","040","0004","0000","700","401","299","1","701","1716","0","40.85","23.37"
"10","017","00","040","0004","0084","362","222","140","1","363","881","0","41.20","25.20"
"10","017","00","040","0004","0085","338","179","159","0","338","835","0","40.48","21.44"
"10","017","00","040","0005","0000","907","522","385","9","916","2263","0","40.48","23.07"
"10","017","00","040","0005","0086","485","290","195","8","493","1213","0","40.64","23.91"
"10","017","00","040","0005","0087","422","232","190","1","423","1050","0","40.29","22.10"
"10","017","00","040","0006","0000","686","397","289","7","693","1653","0","41.92","24.02"
"10","017","00","040","0006","0088","686","397","289","7","693","1653","0","41.92","24.02"
"10","017","00","040","0007","0000","360","175","185","1","361","924","0","39.07","18.94"
"10","017","00","040","0007","0089","360","175","185","1","361","924","0","39.07","18.94"
"10","017","00","040","0008","0000","420","205","215","1","421","945","0","44.55","21.69"
"10","017","00","040","0008","0090","420","205","215","1","421","945","0","44.55","21.69"
"10","017","00","040","0009","0000","383","190","193","1","384","840","0","45.71","22.62"
"10","017","00","040","0009","0091","383","190","193","1","384","840","0","45.71","22.62"
"10","017","00","040","0010","0000","688","372","316","7","695","1413","0","49.19","26.33"
"10","017","00","040","0010","0092","506","265","241","6","512","1002","0","51.10","26.45"
"10","017","00","040","0010","0093","182","107","75","1","183","411","0","44.53","26.03"
"10","017","00","040","0011","0000","329","142","187","7","336","730","0","46.03","19.45"
"10","017","00","040","0011","0094","329","142","187","7","336","730","0","46.03","19.45"
"10","017","00","040","0012","0000","384","182","202","6","390","917","0","42.53","19.85"
"10","017","00","040","0012","0095","384","182","202","6","390","917","0","42.53","19.85"
"10","017","00","040","0013","0000","989","492","497","6","995","2538","0","39.20","19.39"
"10","017","00","040","0013","0096","513","244","269","4","517","1258","0","41.10","19.40"
"10","017","00","040","0013","0097","476","248","228","2","478","1280","0","37.34","19.38"
"10","017","00","040","0014","0000","274","108","166","5","279","710","0","39.30","15.21"
"10","017","00","040","0014","0098","274","108","166","5","279","710","0","39.30","15.21"
"10","017","00","040","0015","0000","475","233","242","3","478","1247","0","38.33","18.68"
"10","017","00","040","0015","0099","236","102","134","0","236","624","0","37.82","16.35"
"10","017","00","040","0015","0100","239","131","108","3","242","623","0","38.84","21.03"
"10","017","00","040","0016","0000","314","128","186","3","317","770","0","41.17","16.62"
"10","017","00","040","0016","0101","314","128","186","3","317","770","0","41.17","16.62"
"10","017","00","040","0017","0000","717","401","316","4","721","1698","0","42.46","23.62"
"10","017","00","040","0017","0102","717","401","316","4","721","1698","0","42.46","23.62"
"10","017","00","040","0018","0000","351","156","195","3","354","790","0","44.81","19.75"
"10","017","00","040","0018","0103","351","156","195","3","354","790","0","44.81","19.75"
"10","017","00","040","0019","0000","390","201","189","2","392","846","0","46.34","23.76"
"10","017","00","040","0019","0104","390","201","189","2","392","846","0","46.34","23.76"
"10","017","00","040","0020","0000","281","129","152","4","285","820","0","34.76","15.73"
"10","017","00","040","0020","0105","281","129","152","4","285","820","0","34.76","15.73"
"10","017","00","040","0021","0000","297","172","125","6","303","670","0","45.22","25.67"
"10","017","00","040","0021","0106","297","172","125","6","303","670","0","45.22","25.67"
"10","017","00","040","0022","0000","341","197","144","4","345","957","0","36.05","20.59"
"10","017","00","040","0022","0107","341","197","144","4","345","957","0","36.05","20.59"
"10","017","00","040","0023","0000","373","186","187","6","379","1056","0","35.89","17.61"
"10","017","00","040","0023","0108","373","186","187","6","379","1056","0","35.89","17.61"
"10","017","00","040","0024","0000","1148","744","404","12","1160","2712","0","42.77","27.43"
"10","017","00","040","0024","0109","401","222","179","3","404","1182","0","34.18","18.78"
"10","017","00","040","0024","0110","747","522","225","9","756","1530","0","49.41","34.12"
"10","017","00","040","0025","0000","313","170","143","2","315","676","0","46.60","25.15"
"10","017","00","040","0025","0113","313","170","143","2","315","676","0","46.60","25.15"
"10","017","00","040","0026","0000","247","119","128","1","248","548","0","45.26","21.72"
"10","017","00","040","0026","0114","247","119","128","1","248","548","0","45.26","21.72"
"10","017","00","040","0027","0000","368","149","219","1","369","692","0","53.32","21.53"
"10","017","00","040","0027","0115","368","149","219","1","369","692","0","53.32","21.53"
"10","017","00","040","0028","0000","281","146","135","1","282","571","0","49.39","25.57"
"10","017","00","040","0028","0116","281","146","135","1","282","571","0","49.39","25.57"
"10","017","00","040","0029","0000","1034","561","473","2","1036","2507","0","41.32","22.38"
"10","017","00","040","0029","0111","452","239","213","1","453","1334","0","33.96","17.92"
"10","017","00","040","0029","0112","582","322","260","1","583","1173","0","49.70","27.45"
"10","017","00","050","0000","0000","16378","9163","7215","164","16542","40977","46058","40.37","22.36"
"10","017","00","050","0001","0000","350","194","156","7","357","769","0","46.42","25.23"
"10","017","00","050","0001","0117","350","194","156","7","357","769","0","46.42","25.23"
"10","017","00","050","0002","0000","493","255","238","5","498","992","0","50.20","25.71"
"10","017","00","050","0002","0118","493","255","238","5","498","992","0","50.20","25.71"
"10","017","00","050","0003","0000","313","161","152","5","318","750","0","42.40","21.47"
"10","017","00","050","0003","0119","313","161","152","5","318","750","0","42.40","21.47"
"10","017","00","050","0004","0000","374","167","207","5","379","962","0","39.40","17.36"
"10","017","00","050","0004","0120","374","167","207","5","379","962","0","39.40","17.36"
"10","017","00","050","0005","0000","346","216","130","4","350","749","0","46.73","28.84"
"10","017","00","050","0005","0121","346","216","130","4","350","749","0","46.73","28.84"
"10","017","00","050","0006","0000","510","300","210","4","514","1221","0","42.10","24.57"
"10","017","00","050","0006","0122","510","300","210","4","514","1221","0","42.10","24.57"
"10","017","00","050","0007","0000","309","201","108","1","310","742","0","41.78","27.09"
"10","017","00","050","0007","0123","309","201","108","1","310","742","0","41.78","27.09"
"10","017","00","050","0008","0000","494","273","221","6","500","1138","0","43.94","23.99"
"10","017","00","050","0008","0124","494","273","221","6","500","1138","0","43.94","23.99"
"10","017","00","050","0009","0000","379","224","155","6","385","961","0","40.06","23.31"
"10","017","00","050","0009","0125","379","224","155","6","385","961","0","40.06","23.31"
"10","017","00","050","0010","0000","477","280","197","11","488","1266","0","38.55","22.12"
"10","017","00","050","0010","0126","477","280","197","11","488","1266","0","38.55","22.12"
"10","017","00","050","0011","0000","686","367","319","8","694","1710","0","40.58","21.46"
"10","017","00","050","0011","0127","288","165","123","4","292","812","0","35.96","20.32"
"10","017","00","050","0011","0128","398","202","196","4","402","898","0","44.77","22.49"
"10","017","00","050","0012","0000","582","303","279","9","591","1512","0","39.09","20.04"
"10","017","00","050","0012","0132","582","303","279","9","591","1512","0","39.09","20.04"
"10","017","00","050","0013","0000","359","197","162","1","360","1271","0","28.32","15.50"
"10","017","00","050","0013","0133","359","197","162","1","360","1271","0","28.32","15.50"
"10","017","00","050","0014","0000","229","122","107","2","231","563","0","41.03","21.67"
"10","017","00","050","0014","0130","229","122","107","2","231","563","0","41.03","21.67"
"10","017","00","050","0015","0000","316","146","170","4","320","864","0","37.04","16.90"
"10","017","00","050","0015","0131","316","146","170","4","320","864","0","37.04","16.90"
"10","017","00","050","0016","0000","273","127","146","7","280","654","0","42.81","19.42"
"10","017","00","050","0016","0153","273","127","146","7","280","654","0","42.81","19.42"
"10","017","00","050","0017","0000","404","202","202","5","409","828","0","49.40","24.40"
"10","017","00","050","0017","0152","404","202","202","5","409","828","0","49.40","24.40"
"10","017","00","050","0018","0000","341","172","169","6","347","904","0","38.38","19.03"
"10","017","00","050","0018","0151","341","172","169","6","347","904","0","38.38","19.03"
"10","017","00","050","0019","0000","569","289","280","11","580","1556","0","37.28","18.57"
"10","017","00","050","0019","0150","569","289","280","11","580","1556","0","37.28","18.57"
"10","017","00","050","0020","0000","2463","1502","961","16","2479","5331","0","46.50","28.17"
"10","017","00","050","0020","0137","563","343","220","1","564","1063","0","53.06","32.27"
"10","017","00","050","0020","0138","615","343","272","6","621","1435","0","43.28","23.90"
"10","017","00","050","0020","0139","718","460","258","4","722","1510","0","47.81","30.46"
"10","017","00","050","0020","0140","567","356","211","5","572","1323","0","43.24","26.91"
"10","017","00","050","0021","0000","2148","1288","860","11","2159","5461","0","39.53","23.59"
"10","017","00","050","0021","0141","503","296","207","3","506","1249","0","40.51","23.70"
"10","017","00","050","0021","0142","359","222","137","1","360","848","0","42.45","26.18"
"10","017","00","050","0021","0143","491","305","186","3","494","1319","0","37.45","23.12"
"10","017","00","050","0021","0144","444","254","190","1","445","1319","0","33.74","19.26"
"10","017","00","050","0021","0145","351","211","140","3","354","726","0","48.76","29.06"
"10","017","00","050","0022","0000","1561","840","721","11","1572","3826","0","41.09","21.96"
"10","017","00","050","0022","0134","499","266","233","2","501","1250","0","40.08","21.28"
"10","017","00","050","0022","0135","543","299","244","5","548","1433","0","38.24","20.87"
"10","017","00","050","0022","0136","519","275","244","4","523","1143","0","45.76","24.06"
"10","017","00","050","0023","0000","205","132","73","4","209","431","0","48.49","30.63"
"10","017","00","050","0023","0129","205","132","73","4","209","431","0","48.49","30.63"
"10","017","00","050","0024","0000","2197","1205","992","15","2212","6516","0","33.95","18.49"
"10","017","00","050","0024","0146","493","285","208","1","494","1635","0","30.21","17.43"
"10","017","00","050","0024","0147","517","294","223","0","517","1589","0","32.54","18.50"
"10","017","00","050","0024","0148","606","327","279","4","610","1670","0","36.53","19.58"
"10","017","00","050","0024","0149","581","299","282","10","591","1622","0","36.44","18.43"
"10","017","00","060","0000","0000","29307","16839","12468","197","29504","70296","81453","41.97","23.95"
"10","017","00","060","0001","0000","450","254","196","2","452","1179","0","38.34","21.54"
"10","017","00","060","0001","0155","450","254","196","2","452","1179","0","38.34","21.54"
"10","017","00","060","0002","0000","404","210","194","3","407","1020","0","39.90","20.59"
"10","017","00","060","0002","0156","404","210","194","3","407","1020","0","39.90","20.59"
"10","017","00","060","0003","0000","485","268","217","1","486","1326","0","36.65","20.21"
"10","017","00","060","0003","0154","485","268","217","1","486","1326","0","36.65","20.21"
"10","017","00","060","0004","0000","477","257","220","1","478","998","0","47.90","25.75"
"10","017","00","060","0004","0157","477","257","220","1","478","998","0","47.90","25.75"
"10","017","00","060","0005","0000","336","138","198","2","338","883","0","38.28","15.63"
"10","017","00","060","0005","0158","336","138","198","2","338","883","0","38.28","15.63"
"10","017","00","060","0006","0000","704","372","332","3","707","1988","0","35.56","18.71"
"10","017","00","060","0006","0159","511","275","236","1","512","1380","0","37.10","19.93"
"10","017","00","060","0006","0160","193","97","96","2","195","608","0","32.07","15.95"
"10","017","00","060","0007","0000","698","350","348","2","700","1900","0","36.84","18.42"
"10","017","00","060","0007","0161","527","251","276","1","528","1446","0","36.51","17.36"
"10","017","00","060","0007","0162","171","99","72","1","172","454","0","37.89","21.81"
"10","017","00","060","0008","0000","1353","653","700","14","1367","3163","0","43.22","20.64"
"10","017","00","060","0008","0165","818","372","446","6","824","1860","0","44.30","20.00"
"10","017","00","060","0008","0166","535","281","254","8","543","1303","0","41.67","21.57"
"10","017","00","060","0009","0000","373","163","210","3","376","821","0","45.80","19.85"
"10","017","00","060","0009","0163","373","163","210","3","376","821","0","45.80","19.85"
"10","017","00","060","0010","0000","220","102","118","2","222","556","0","39.93","18.35"
"10","017","00","060","0010","0164","220","102","118","2","222","556","0","39.93","18.35"
"10","017","00","060","0011","0000","1437","828","609","12","1449","3892","0","37.23","21.27"
"10","017","00","060","0011","0193","739","419","320","6","745","1910","0","39.01","21.94"
"10","017","00","060","0011","0194","698","409","289","6","704","1982","0","35.52","20.64"
"10","017","00","060","0012","0000","691","378","313","4","695","1657","0","41.94","22.81"
"10","017","00","060","0012","0200","691","378","313","4","695","1657","0","41.94","22.81"
"10","017","00","060","0013","0000","2052","1165","887","14","2066","5349","0","38.62","21.78"
"10","017","00","060","0013","0201","488","251","237","4","492","1271","0","38.71","19.75"
"10","017","00","060","0013","0202","547","364","183","3","550","1398","0","39.34","26.04"
"10","017","00","060","0013","0203","544","308","236","3","547","1407","0","38.88","21.89"
"10","017","00","060","0013","0204","473","242","231","4","477","1273","0","37.47","19.01"
"10","017","00","060","0014","0000","1504","831","673","13","1517","4007","0","37.86","20.74"
"10","017","00","060","0014","0195","883","472","411","9","892","2156","0","41.37","21.89"
"10","017","00","060","0014","0196","621","359","262","4","625","1851","0","33.77","19.39"
"10","017","00","060","0015","0000","1063","577","486","2","1065","2451","0","43.45","23.54"
"10","017","00","060","0015","0167","508","268","240","0","508","1156","0","43.94","23.18"
"10","017","00","060","0015","0168","555","309","246","2","557","1295","0","43.01","23.86"
"10","017","00","060","0016","0000","2227","1329","898","12","2239","4656","0","48.09","28.54"
"10","017","00","060","0016","0172","775","470","305","3","778","1539","0","50.55","30.54"
"10","017","00","060","0016","0173","713","429","284","5","718","1709","0","42.01","25.10"
"10","017","00","060","0016","0174","739","430","309","4","743","1408","0","52.77","30.54"
"10","017","00","060","0017","0000","1485","875","610","7","1492","3415","0","43.69","25.62"
"10","017","00","060","0017","0175","726","411","315","3","729","1773","0","41.12","23.18"
"10","017","00","060","0017","0176","759","464","295","4","763","1642","0","46.47","28.26"
"10","017","00","060","0018","0000","1815","1108","707","14","1829","3876","0","47.19","28.59"
"10","017","00","060","0018","0177","703","420","283","5","708","1586","0","44.64","26.48"
"10","017","00","060","0018","0178","559","355","204","6","565","1145","0","49.34","31.00"
"10","017","00","060","0018","0179","553","333","220","3","556","1145","0","48.56","29.08"
"10","017","00","060","0019","0000","1032","543","489","7","1039","2426","0","42.83","22.38"
"10","017","00","060","0019","0180","551","297","254","3","554","1239","0","44.71","23.97"
"10","017","00","060","0019","0181","481","246","235","4","485","1187","0","40.86","20.72"
"10","017","00","060","0020","0000","1039","644","395","4","1043","2796","0","37.30","23.03"
"10","017","00","060","0020","0185","495","312","183","2","497","1411","0","35.22","22.11"
"10","017","00","060","0020","0186","544","332","212","2","546","1385","0","39.42","23.97"
"10","017","00","060","0021","0000","2079","1227","852","11","2090","4808","0","43.47","25.52"
"10","017","00","060","0021","0197","549","299","250","3","552","1546","0","35.71","19.34"
"10","017","00","060","0021","0198","965","574","391","6","971","2100","0","46.24","27.33"
"10","017","00","060","0021","0199","565","354","211","2","567","1162","0","48.80","30.46"
"10","017","00","060","0022","0000","1640","991","649","13","1653","3289","0","50.26","30.13"
"10","017","00","060","0022","0182","855","521","334","6","861","1726","0","49.88","30.19"
"10","017","00","060","0022","0183","360","216","144","2","362","686","0","52.77","31.49"
"10","017","00","060","0022","0184","425","254","171","5","430","877","0","49.03","28.96"
"10","017","00","060","0023","0000","1709","992","717","18","1727","4694","0","36.79","21.13"
"10","017","00","060","0023","0190","615","362","253","3","618","1681","0","36.76","21.53"
"10","017","00","060","0023","0191","389","232","157","7","396","1069","0","37.04","21.70"
"10","017","00","060","0023","0192","705","398","307","8","713","1944","0","36.68","20.47"
"10","017","00","060","0024","0000","2253","1431","822","17","2270","4907","0","46.26","29.16"
"10","017","00","060","0024","0187","730","461","269","7","737","1557","0","47.33","29.61"
"10","017","00","060","0024","0188","623","366","257","6","629","1416","0","44.42","25.85"
"10","017","00","060","0024","0189","900","604","296","4","904","1934","0","46.74","31.23"
"10","017","00","060","0025","0000","1781","1153","628","16","1797","4239","0","42.39","27.20"
"10","017","00","060","0025","0169","719","465","254","11","730","1633","0","44.70","28.48"
"10","017","00","060","0025","0170","746","468","278","5","751","1833","0","40.97","25.53"
"10","017","00","060","0025","0171","316","220","96","0","316","773","0","40.88","28.46"
"10","017","00","070","0000","0000","19725","11927","7798","137","19862","46687","53082","42.54","25.55"
"10","017","00","070","0001","0000","504","290","214","11","515","1024","0","50.29","28.32"
"10","017","00","070","0001","0041","504","290","214","11","515","1024","0","50.29","28.32"
"10","017","00","070","0002","0000","600","397","203","2","602","1165","0","51.67","34.08"
"10","017","00","070","0002","0042","600","397","203","2","602","1165","0","51.67","34.08"
"10","017","00","070","0003","0000","600","350","250","3","603","1243","0","48.51","28.16"
"10","017","00","070","0003","0043","600","350","250","3","603","1243","0","48.51","28.16"
"10","017","00","070","0004","0000","1086","654","432","6","1092","2232","0","48.92","29.30"
"10","017","00","070","0004","0044","557","329","228","5","562","1092","0","51.47","30.13"
"10","017","00","070","0004","0045","529","325","204","1","530","1140","0","46.49","28.51"
"10","017","00","070","0005","0000","297","159","138","3","300","723","0","41.49","21.99"
"10","017","00","070","0005","0046","297","159","138","3","300","723","0","41.49","21.99"
"10","017","00","070","0006","0000","567","345","222","4","571","1508","0","37.86","22.88"
"10","017","00","070","0006","0047","567","345","222","4","571","1508","0","37.86","22.88"
"10","017","00","070","0007","0000","350","215","135","7","357","712","0","50.14","30.20"
"10","017","00","070","0007","0048","350","215","135","7","357","712","0","50.14","30.20"
"10","017","00","070","0008","0000","545","268","277","6","551","1483","0","37.15","18.07"
"10","017","00","070","0008","0049","545","268","277","6","551","1483","0","37.15","18.07"
"10","017","00","070","0009","0000","714","425","289","6","720","1552","0","46.39","27.38"
"10","017","00","070","0009","0050","714","425","289","6","720","1552","0","46.39","27.38"
"10","017","00","070","0010","0000","705","450","255","8","713","1439","0","49.55","31.27"
"10","017","00","070","0010","0051","705","450","255","8","713","1439","0","49.55","31.27"
"10","017","00","070","0011","0000","903","555","348","7","910","1997","0","45.57","27.79"
"10","017","00","070","0011","0052","461","290","171","3","464","987","0","47.01","29.38"
"10","017","00","070","0011","0053","442","265","177","4","446","1010","0","44.16","26.24"
"10","017","00","070","0012","0000","787","457","330","4","791","1817","0","43.53","25.15"
"10","017","00","070","0012","0058","444","274","170","2","446","1068","0","41.76","25.66"
"10","017","00","070","0012","0059","343","183","160","2","345","749","0","46.06","24.43"
"10","017","00","070","0013","0000","1467","953","514","6","1473","3468","0","42.47","27.48"
"10","017","00","070","0013","0060","570","345","225","3","573","1312","0","43.67","26.30"
"10","017","00","070","0013","0061","559","368","191","2","561","1378","0","40.71","26.71"
"10","017","00","070","0013","0062","338","240","98","1","339","778","0","43.57","30.85"
"10","017","00","070","0014","0000","1130","669","461","11","1141","2716","0","42.01","24.63"
"10","017","00","070","0014","0063","622","369","253","8","630","1440","0","43.75","25.63"
"10","017","00","070","0014","0064","508","300","208","3","511","1276","0","40.05","23.51"
"10","017","00","070","0015","0000","483","265","218","2","485","1308","0","37.08","20.26"
"10","017","00","070","0015","0078","483","265","218","2","485","1308","0","37.08","20.26"
"10","017","00","070","0016","0000","1861","1202","659","15","1876","4064","0","46.16","29.58"
"10","017","00","070","0016","0054","311","195","116","1","312","712","0","43.82","27.39"
"10","017","00","070","0016","0055","415","290","125","4","419","914","0","45.84","31.73"
"10","017","00","070","0016","0056","554","359","195","6","560","1108","0","50.54","32.40"
"10","017","00","070","0016","0057","581","358","223","4","585","1330","0","43.98","26.92"
"10","017","00","070","0017","0000","1621","966","655","15","1636","4618","0","35.43","20.92"
"10","017","00","070","0017","0075","529","320","209","4","533","1215","0","43.87","26.34"
"10","017","00","070","0017","0076","514","291","223","6","520","1598","0","32.54","18.21"
"10","017","00","070","0017","0077","578","355","223","5","583","1805","0","32.30","19.67"
"10","017","00","070","0018","0000","1546","949","597","7","1553","3461","0","44.87","27.42"
"10","017","00","070","0018","0065","425","250","175","2","427","944","0","45.23","26.48"
"10","017","00","070","0018","0066","440","253","187","2","442","1047","0","42.22","24.16"
"10","017","00","070","0018","0067","681","446","235","3","684","1470","0","46.53","30.34"
"10","017","00","070","0019","0000","962","541","421","7","969","2604","0","37.21","20.78"
"10","017","00","070","0019","0073","511","286","225","6","517","1471","0","35.15","19.44"
"10","017","00","070","0019","0074","451","255","196","1","452","1133","0","39.89","22.51"
"10","017","00","070","0020","0000","2997","1817","1180","7","3004","7553","0","39.77","24.06"
"10","017","00","070","0020","0068","648","392","256","0","648","1445","0","44.84","27.13"
"10","017","00","070","0020","0069","670","398","272","2","672","1482","0","45.34","26.86"
"10","017","00","070","0020","0070","483","307","176","2","485","1413","0","34.32","21.73"
"10","017","00","070","0020","0071","531","321","210","3","534","1524","0","35.04","21.06"
"10","017","00","070","0020","0072","665","399","266","0","665","1689","0","39.37","23.62"
"10","018","00","000","0000","0000","155060","85746","69314","1806","156866","361353","452807","43.41","23.73"
"10","018","00","010","0000","0000","76403","44490","31913","833","77236","169450","221541","45.58","26.26"
"10","018","00","010","0001","0000","337","145","192","4","341","689","0","49.49","21.04"
"10","018","00","010","0001","0118","337","145","192","4","341","689","0","49.49","21.04"
"10","018","00","010","0002","0000","653","367","286","4","657","1426","0","46.07","25.74"
"10","018","00","010","0002","0120","429","255","174","1","430","977","0","44.01","26.10"
"10","018","00","010","0002","0121","224","112","112","3","227","449","0","50.56","24.94"
"10","018","00","010","0003","0000","362","140","222","8","370","860","0","43.02","16.28"
"10","018","00","010","0003","0119","362","140","222","8","370","860","0","43.02","16.28"
"10","018","00","010","0004","0000","212","83","129","5","217","472","0","45.97","17.58"
"10","018","00","010","0004","0117","212","83","129","5","217","472","0","45.97","17.58"
"10","018","00","010","0005","0000","275","111","164","2","277","527","0","52.56","21.06"
"10","018","00","010","0005","0004","275","111","164","2","277","527","0","52.56","21.06"
"10","018","00","010","0007","0000","281","122","159","3","284","591","0","48.05","20.64"
"10","018","00","010","0007","0005","281","122","159","3","284","591","0","48.05","20.64"
"10","018","00","010","0010","0000","312","146","166","4","316","712","0","44.38","20.51"
"10","018","00","010","0010","0130","312","146","166","4","316","712","0","44.38","20.51"
"10","018","00","010","0011","0000","457","258","199","3","460","1657","0","27.76","15.57"
"10","018","00","010","0011","0001","457","258","199","3","460","1657","0","27.76","15.57"
"10","018","00","010","0012","0000","242","113","129","3","245","544","0","45.04","20.77"
"10","018","00","010","0012","0006","242","113","129","3","245","544","0","45.04","20.77"
"10","018","00","010","0013","0000","1423","848","575","22","1445","3181","0","45.43","26.66"
"10","018","00","010","0013","0030","439","245","194","8","447","1017","0","43.95","24.09"
"10","018","00","010","0013","0031","505","326","179","7","512","1177","0","43.50","27.70"
"10","018","00","010","0013","0032","479","277","202","7","486","987","0","49.24","28.06"
"10","018","00","010","0014","0000","1252","599","653","17","1269","2794","0","45.42","21.44"
"10","018","00","010","0014","0132","366","176","190","7","373","829","0","44.99","21.23"
"10","018","00","010","0014","0133","435","195","240","5","440","934","0","47.11","20.88"
"10","018","00","010","0014","0134","451","228","223","5","456","1031","0","44.23","22.11"
"10","018","00","010","0015","0000","628","292","336","9","637","1360","0","46.84","21.47"
"10","018","00","010","0015","0135","287","127","160","2","289","589","0","49.07","21.56"
"10","018","00","010","0015","0136","341","165","176","7","348","771","0","45.14","21.40"
"10","018","00","010","0016","0000","2179","1212","967","20","2199","5451","0","40.34","22.23"
"10","018","00","010","0016","0122","475","227","248","3","478","1091","0","43.81","20.81"
"10","018","00","010","0016","0123","459","242","217","8","467","1113","0","41.96","21.74"
"10","018","00","010","0016","0124","453","289","164","7","460","1139","0","40.39","25.37"
"10","018","00","010","0016","0125","404","247","157","0","404","1091","0","37.03","22.64"
"10","018","00","010","0016","0126","388","207","181","2","390","1017","0","38.35","20.35"
"10","018","00","010","0017","0000","535","326","209","4","539","1058","0","50.95","30.81"
"10","018","00","010","0017","0002","535","326","209","4","539","1058","0","50.95","30.81"
"10","018","00","010","0018","0000","2029","1173","856","18","2047","4446","0","46.04","26.38"
"10","018","00","010","0018","0009","307","195","112","2","309","642","0","48.13","30.37"
"10","018","00","010","0018","0010","583","310","273","6","589","1260","0","46.75","24.60"
"10","018","00","010","0018","0011","576","344","232","5","581","1334","0","43.55","25.79"
"10","018","00","010","0018","0012","563","324","239","5","568","1210","0","46.94","26.78"
"10","018","00","010","0019","0000","1897","1091","806","17","1914","4120","0","46.46","26.48"
"10","018","00","010","0019","0013","457","293","164","1","458","959","0","47.76","30.55"
"10","018","00","010","0019","0014","477","290","187","3","480","980","0","48.98","29.59"
"10","018","00","010","0019","0015","535","292","243","5","540","1175","0","45.96","24.85"
"10","018","00","010","0019","0016","428","216","212","8","436","1006","0","43.34","21.47"
"10","018","00","010","0020","0000","2063","1094","969","19","2082","4584","0","45.42","23.87"
"10","018","00","010","0020","0021","437","228","209","3","440","1026","0","42.88","22.22"
"10","018","00","010","0020","0022","523","293","230","10","533","1225","0","43.51","23.92"
"10","018","00","010","0020","0023","521","270","251","1","522","1089","0","47.93","24.79"
"10","018","00","010","0020","0024","582","303","279","5","587","1244","0","47.19","24.36"
"10","018","00","010","0021","0000","2660","1504","1156","33","2693","5827","0","46.22","25.81"
"10","018","00","010","0021","0025","497","284","213","8","505","1139","0","44.34","24.93"
"10","018","00","010","0021","0026","589","331","258","6","595","1245","0","47.79","26.59"
"10","018","00","010","0021","0027","446","262","184","8","454","1127","0","40.28","23.25"
"10","018","00","010","0021","0028","548","315","233","5","553","1186","0","46.63","26.56"
"10","018","00","010","0021","0029","580","312","268","6","586","1130","0","51.86","27.61"
"10","018","00","010","0022","0000","1449","808","641","20","1469","3117","0","47.13","25.92"
"10","018","00","010","0022","0044","746","372","374","13","759","1651","0","45.97","22.53"
"10","018","00","010","0022","0045","703","436","267","7","710","1466","0","48.43","29.74"
"10","018","00","010","0023","0000","1312","690","622","18","1330","2796","0","47.57","24.68"
"10","018","00","010","0023","0046","417","190","227","7","424","955","0","44.40","19.90"
"10","018","00","010","0023","0047","421","221","200","7","428","877","0","48.80","25.20"
"10","018","00","010","0023","0048","474","279","195","4","478","964","0","49.59","28.94"
"10","018","00","010","0024","0000","2295","1437","858","17","2312","4392","0","52.64","32.72"
"10","018","00","010","0024","0057","634","358","276","7","641","1196","0","53.60","29.93"
"10","018","00","010","0024","0058","393","273","120","2","395","939","0","42.07","29.07"
"10","018","00","010","0024","0059","592","383","209","2","594","1103","0","53.85","34.72"
"10","018","00","010","0024","0060","676","423","253","6","682","1154","0","59.10","36.66"
"10","018","00","010","0025","0000","2042","1570","472","23","2065","3972","0","51.99","39.53"
"10","018","00","010","0025","0061","679","554","125","10","689","1319","0","52.24","42.00"
"10","018","00","010","0025","0062","689","517","172","10","699","1353","0","51.66","38.21"
"10","018","00","010","0025","0063","674","499","175","3","677","1300","0","52.08","38.38"
"10","018","00","010","0026","0000","2876","1724","1152","34","2910","6185","0","47.05","27.87"
"10","018","00","010","0026","0039","589","361","228","5","594","1306","0","45.48","27.64"
"10","018","00","010","0026","0040","544","350","194","8","552","1222","0","45.17","28.64"
"10","018","00","010","0026","0041","585","343","242","4","589","1220","0","48.28","28.11"
"10","018","00","010","0026","0042","609","345","264","10","619","1302","0","47.54","26.50"
"10","018","00","010","0026","0043","549","325","224","7","556","1135","0","48.99","28.63"
"10","018","00","010","0027","0000","1541","944","597","23","1564","3075","0","50.86","30.70"
"10","018","00","010","0027","0036","444","296","148","10","454","921","0","49.29","32.14"
"10","018","00","010","0027","0037","529","314","215","4","533","1066","0","50.00","29.46"
"10","018","00","010","0027","0038","568","334","234","9","577","1088","0","53.03","30.70"
"10","018","00","010","0028","0000","1514","805","709","14","1528","3537","0","43.20","22.76"
"10","018","00","010","0028","0140","421","227","194","4","425","1043","0","40.75","21.76"
"10","018","00","010","0028","0141","505","268","237","5","510","1047","0","48.71","25.60"
"10","018","00","010","0028","0142","588","310","278","5","593","1447","0","40.98","21.42"
"10","018","00","010","0029","0000","1330","685","645","26","1356","3009","0","45.06","22.77"
"10","018","00","010","0029","0127","416","201","215","8","424","882","0","48.07","22.79"
"10","018","00","010","0029","0128","448","239","209","7","455","1054","0","43.17","22.68"
"10","018","00","010","0029","0129","466","245","221","11","477","1073","0","44.45","22.83"
"10","018","00","010","0030","0000","2313","1302","1011","19","2332","5175","0","45.06","25.16"
"10","018","00","010","0030","0151","355","212","143","3","358","989","0","36.20","21.44"
"10","018","00","010","0030","0152","377","198","179","5","382","867","0","44.06","22.84"
"10","018","00","010","0030","0153","470","285","185","3","473","894","0","52.91","31.88"
"10","018","00","010","0030","0154","414","216","198","6","420","1082","0","38.82","19.96"
"10","018","00","010","0030","0155","697","391","306","2","699","1343","0","52.05","29.11"
"10","018","00","010","0031","0000","2453","1329","1124","23","2476","5610","0","44.14","23.69"
"10","018","00","010","0031","0143","571","267","304","8","579","1285","0","45.06","20.78"
"10","018","00","010","0031","0144","506","287","219","4","510","1080","0","47.22","26.57"
"10","018","00","010","0031","0145","422","250","172","6","428","1103","0","38.80","22.67"
"10","018","00","010","0031","0146","468","252","216","4","472","1099","0","42.95","22.93"
"10","018","00","010","0031","0147","486","273","213","1","487","1043","0","46.69","26.17"
"10","018","00","010","0032","0000","583","353","230","4","587","1240","0","47.34","28.47"
"10","018","00","010","0032","0116","583","353","230","4","587","1240","0","47.34","28.47"
"10","018","00","010","0033","0000","1456","989","467","24","1480","2932","0","50.48","33.73"
"10","018","00","010","0033","0072","488","353","135","6","494","1063","0","46.47","33.21"
"10","018","00","010","0033","0073","386","252","134","7","393","775","0","50.71","32.52"
"10","018","00","010","0033","0074","582","384","198","11","593","1094","0","54.20","35.10"
"10","018","00","010","0035","0000","414","323","91","3","417","887","0","47.01","36.41"
"10","018","00","010","0035","0067","414","323","91","3","417","887","0","47.01","36.41"
"10","018","00","010","0036","0000","1244","861","383","14","1258","2672","0","47.08","32.22"
"10","018","00","010","0036","0064","403","279","124","2","405","971","0","41.71","28.73"
"10","018","00","010","0036","0065","416","283","133","3","419","817","0","51.29","34.64"
"10","018","00","010","0036","0066","425","299","126","9","434","884","0","49.10","33.82"
"10","018","00","010","0037","0000","1965","1470","495","19","1984","3777","0","52.53","38.92"
"10","018","00","010","0037","0068","619","512","107","10","629","1168","0","53.85","43.84"
"10","018","00","010","0037","0069","390","278","112","6","396","802","0","49.38","34.66"
"10","018","00","010","0037","0070","383","301","82","2","385","663","0","58.07","45.40"
"10","018","00","010","0037","0071","573","379","194","1","574","1144","0","50.17","33.13"
"10","018","00","010","0038","0000","1132","551","581","17","1149","2728","0","42.12","20.20"
"10","018","00","010","0038","0049","402","195","207","7","409","936","0","43.70","20.83"
"10","018","00","010","0038","0050","385","204","181","8","393","946","0","41.54","21.56"
"10","018","00","010","0038","0051","345","152","193","2","347","846","0","41.02","17.97"
"10","018","00","010","0039","0000","1443","693","750","24","1467","3260","0","45.00","21.26"
"10","018","00","010","0039","0052","532","255","277","11","543","1277","0","42.52","19.97"
"10","018","00","010","0039","0053","488","261","227","6","494","1055","0","46.82","24.74"
"10","018","00","010","0039","0054","423","177","246","7","430","928","0","46.34","19.07"
"10","018","00","010","0040","0000","882","502","380","10","892","2117","0","42.14","23.71"
"10","018","00","010","0040","0055","450","225","225","9","459","1108","0","41.43","20.31"
"10","018","00","010","0040","0056","432","277","155","1","433","1009","0","42.91","27.45"
"10","018","00","010","0041","0000","2628","1459","1169","32","2660","6204","0","42.88","23.52"
"10","018","00","010","0041","0079","438","261","177","4","442","1033","0","42.79","25.27"
"10","018","00","010","0041","0090","514","273","241","12","526","1218","0","43.19","22.41"
"10","018","00","010","0041","0091","549","281","268","5","554","1367","0","40.53","20.56"
"10","018","00","010","0041","0092","551","315","236","5","556","1254","0","44.34","25.12"
"10","018","00","010","0041","0093","576","329","247","6","582","1332","0","43.69","24.70"
"10","018","00","010","0042","0000","4325","2520","1805","38","4363","9368","0","46.57","26.90"
"10","018","00","010","0042","0075","463","293","170","0","463","1038","0","44.61","28.23"
"10","018","00","010","0042","0076","560","315","245","4","564","1196","0","47.16","26.34"
"10","018","00","010","0042","0077","567","323","244","8","575","1203","0","47.80","26.85"
"10","018","00","010","0042","0078","789","448","341","7","796","1737","0","45.83","25.79"
"10","018","00","010","0042","0080","370","210","160","3","373","864","0","43.17","24.31"
"10","018","00","010","0042","0081","435","252","183","6","441","962","0","45.84","26.20"
"10","018","00","010","0042","0082","622","360","262","5","627","1386","0","45.24","25.97"
"10","018","00","010","0042","0083","519","319","200","5","524","982","0","53.36","32.48"
"10","018","00","010","0043","0000","2322","1402","920","19","2341","5305","0","44.13","26.43"
"10","018","00","010","0043","0094","471","268","203","7","478","1065","0","44.88","25.16"
"10","018","00","010","0043","0095","437","283","154","5","442","1006","0","43.94","28.13"
"10","018","00","010","0043","0096","489","287","202","4","493","1109","0","44.45","25.88"
"10","018","00","010","0043","0097","480","298","182","2","482","1126","0","42.81","26.47"
"10","018","00","010","0043","0098","445","266","179","1","446","999","0","44.64","26.63"
"10","018","00","010","0044","0000","1988","1177","811","25","2013","4355","0","46.22","27.03"
"10","018","00","010","0044","0112","442","266","176","4","446","1165","0","38.28","22.83"
"10","018","00","010","0044","0113","540","296","244","6","546","1079","0","50.60","27.43"
"10","018","00","010","0044","0114","448","247","201","7","455","950","0","47.89","26.00"
"10","018","00","010","0044","0115","558","368","190","8","566","1161","0","48.75","31.70"
"10","018","00","010","0045","0000","2142","1367","775","20","2162","5215","0","41.46","26.21"
"10","018","00","010","0045","0107","420","293","127","4","424","1102","0","38.48","26.59"
"10","018","00","010","0045","0108","484","297","187","11","495","1204","0","41.11","24.67"
"10","018","00","010","0045","0109","415","265","150","1","416","1031","0","40.35","25.70"
"10","018","00","010","0045","0110","350","232","118","3","353","936","0","37.71","24.79"
"10","018","00","010","0045","0111","473","280","193","1","474","942","0","50.32","29.72"
"10","018","00","010","0046","0000","1959","1215","744","20","1979","4835","0","40.93","25.13"
"10","018","00","010","0046","0103","396","264","132","7","403","1117","0","36.08","23.63"
"10","018","00","010","0046","0104","528","350","178","6","534","1299","0","41.11","26.94"
"10","018","00","010","0046","0105","468","264","204","5","473","1175","0","40.26","22.47"
"10","018","00","010","0046","0106","567","337","230","2","569","1244","0","45.74","27.09"
"10","018","00","010","0047","0000","3219","2007","1212","31","3250","6299","0","51.60","31.86"
"10","018","00","010","0047","0084","517","321","196","5","522","1057","0","49.39","30.37"
"10","018","00","010","0047","0085","474","296","178","5","479","1003","0","47.76","29.51"
"10","018","00","010","0047","0086","540","325","215","5","545","1038","0","52.50","31.31"
"10","018","00","010","0047","0087","592","366","226","4","596","1142","0","52.19","32.05"
"10","018","00","010","0047","0088","463","291","172","7","470","900","0","52.22","32.33"
"10","018","00","010","0047","0089","633","408","225","5","638","1159","0","55.05","35.20"
"10","018","00","010","0048","0000","1062","575","487","11","1073","2356","0","45.54","24.41"
"10","018","00","010","0048","0033","342","174","168","4","346","764","0","45.29","22.77"
"10","018","00","010","0048","0034","351","197","154","5","356","790","0","45.06","24.94"
"10","018","00","010","0048","0035","369","204","165","2","371","802","0","46.26","25.44"
"10","018","00","010","0049","0000","1441","769","672","21","1462","3398","0","43.03","22.63"
"10","018","00","010","0049","0137","476","298","178","3","479","1080","0","44.35","27.59"
"10","018","00","010","0049","0138","450","211","239","8","458","1094","0","41.86","19.29"
"10","018","00","010","0049","0139","515","260","255","10","525","1224","0","42.89","21.24"
"10","018","00","010","0050","0000","2149","1251","898","25","2174","4960","0","43.83","25.22"
"10","018","00","010","0050","0017","509","263","246","7","516","1250","0","41.28","21.04"
"10","018","00","010","0050","0018","505","314","191","6","511","1254","0","40.75","25.04"
"10","018","00","010","0050","0019","578","343","235","9","587","1297","0","45.26","26.45"
"10","018","00","010","0050","0020","557","331","226","3","560","1159","0","48.32","28.56"
"10","018","00","010","0051","0000","852","521","331","6","858","1881","0","45.61","27.70"
"10","018","00","010","0051","0007","319","204","115","3","322","756","0","42.59","26.98"
"10","018","00","010","0051","0008","533","317","216","3","536","1125","0","47.64","28.18"
"10","018","00","010","0052","0000","1635","913","722","13","1648","3466","0","47.55","26.34"
"10","018","00","010","0052","0148","548","337","211","4","552","1196","0","46.15","28.18"
"10","018","00","010","0052","0149","566","312","254","4","570","1279","0","44.57","24.39"
"10","018","00","010","0052","0150","521","264","257","5","526","991","0","53.08","26.64"
"10","018","00","010","0053","0000","1757","1044","713","16","1773","4931","0","35.96","21.17"
"10","018","00","010","0053","0156","390","220","170","3","393","995","0","39.50","22.11"
"10","018","00","010","0053","0157","282","175","107","2","284","931","0","30.50","18.80"
"10","018","00","010","0053","0158","354","230","124","0","354","954","0","37.11","24.11"
"10","018","00","010","0053","0159","397","229","168","5","402","1162","0","34.60","19.71"
"10","018","00","010","0053","0160","334","190","144","6","340","889","0","38.25","21.37"
"10","018","00","010","0054","0000","1924","1088","836","16","1940","3964","0","48.94","27.45"
"10","018","00","010","0054","0099","454","273","181","8","462","998","0","46.29","27.35"
"10","018","00","010","0054","0100","454","253","201","3","457","890","0","51.35","28.43"
"10","018","00","010","0054","0101","517","288","229","3","520","1041","0","49.95","27.67"
"10","018","00","010","0054","0102","499","274","225","2","501","1035","0","48.41","26.47"
"10","018","00","010","0055","0000","426","255","171","7","433","958","0","45.20","26.62"
"10","018","00","010","0055","0003","426","255","171","7","433","958","0","45.20","26.62"
"10","018","00","010","0056","0000","533","267","266","6","539","1175","0","45.87","22.72"
"10","018","00","010","0056","0131","533","267","266","6","539","1175","0","45.87","22.72"
"10","018","00","020","0000","0000","53042","28512","24530","623","53665","125506","152490","42.76","22.72"
"10","018","00","020","0001","0000","253","130","123","2","255","555","0","45.95","23.42"
"10","018","00","020","0001","0161","253","130","123","2","255","555","0","45.95","23.42"
"10","018","00","020","0002","0000","320","145","175","1","321","728","0","44.09","19.92"
"10","018","00","020","0002","0165","320","145","175","1","321","728","0","44.09","19.92"
"10","018","00","020","0003","0000","331","146","185","5","336","743","0","45.22","19.65"
"10","018","00","020","0003","0163","331","146","185","5","336","743","0","45.22","19.65"
"10","018","00","020","0004","0000","196","74","122","2","198","464","0","42.67","15.95"
"10","018","00","020","0004","0162","196","74","122","2","198","464","0","42.67","15.95"
"10","018","00","020","0005","0000","472","198","274","6","478","1063","0","44.97","18.63"
"10","018","00","020","0005","0166","472","198","274","6","478","1063","0","44.97","18.63"
"10","018","00","020","0007","0000","525","250","275","11","536","1170","0","45.81","21.37"
"10","018","00","020","0007","0167","525","250","275","11","536","1170","0","45.81","21.37"
"10","018","00","020","0008","0000","441","213","228","4","445","975","0","45.64","21.85"
"10","018","00","020","0008","0197","441","213","228","4","445","975","0","45.64","21.85"
"10","018","00","020","0009","0000","409","199","210","1","410","867","0","47.29","22.95"
"10","018","00","020","0009","0192","409","199","210","1","410","867","0","47.29","22.95"
"10","018","00","020","0010","0000","384","221","163","2","386","775","0","49.81","28.52"
"10","018","00","020","0010","0190","384","221","163","2","386","775","0","49.81","28.52"
"10","018","00","020","0011","0000","380","155","225","2","382","826","0","46.25","18.77"
"10","018","00","020","0011","0191","380","155","225","2","382","826","0","46.25","18.77"
"10","018","00","020","0012","0000","600","281","319","4","604","1365","0","44.25","20.59"
"10","018","00","020","0012","0195","363","162","201","4","367","793","0","46.28","20.43"
"10","018","00","020","0012","0196","237","119","118","0","237","572","0","41.43","20.80"
"10","018","00","020","0013","0000","680","340","340","6","686","1599","0","42.90","21.26"
"10","018","00","020","0013","0193","425","216","209","2","427","936","0","45.62","23.08"
"10","018","00","020","0013","0194","255","124","131","4","259","663","0","39.06","18.70"
"10","018","00","020","0014","0000","1901","928","973","18","1919","4837","0","39.67","19.19"
"10","018","00","020","0014","0198","494","240","254","3","497","1227","0","40.51","19.56"
"10","018","00","020","0014","0199","552","304","248","6","558","1261","0","44.25","24.11"
"10","018","00","020","0014","0200","400","182","218","5","405","1199","0","33.78","15.18"
"10","018","00","020","0014","0201","455","202","253","4","459","1150","0","39.91","17.57"
"10","018","00","020","0015","0000","1346","723","623","10","1356","3018","0","44.93","23.96"
"10","018","00","020","0015","0215","470","256","214","2","472","1007","0","46.87","25.42"
"10","018","00","020","0015","0216","436","238","198","3","439","1010","0","43.47","23.56"
"10","018","00","020","0015","0217","440","229","211","5","445","1001","0","44.46","22.88"
"10","018","00","020","0016","0000","1783","921","862","20","1803","4021","0","44.84","22.90"
"10","018","00","020","0016","0211","471","217","254","4","475","1113","0","42.68","19.50"
"10","018","00","020","0016","0212","461","246","215","7","468","1042","0","44.91","23.61"
"10","018","00","020","0016","0213","451","248","203","5","456","949","0","48.05","26.13"
"10","018","00","020","0016","0214","400","210","190","4","404","917","0","44.06","22.90"
"10","018","00","020","0017","0000","953","532","421","12","965","2080","0","46.39","25.58"
"10","018","00","020","0017","0218","534","296","238","9","543","1129","0","48.10","26.22"
"10","018","00","020","0017","0219","419","236","183","3","422","951","0","44.37","24.82"
"10","018","00","020","0018","0000","791","357","434","11","802","1845","0","43.47","19.35"
"10","018","00","020","0018","0262","516","247","269","7","523","1219","0","42.90","20.26"
"10","018","00","020","0018","0263","275","110","165","4","279","626","0","44.57","17.57"
"10","018","00","020","0019","0000","1720","1023","697","16","1736","3780","0","45.93","27.06"
"10","018","00","020","0019","0254","522","301","221","4","526","1156","0","45.50","26.04"
"10","018","00","020","0019","0255","554","332","222","5","559","1180","0","47.37","28.14"
"10","018","00","020","0019","0256","329","204","125","5","334","722","0","46.26","28.25"
"10","018","00","020","0019","0257","315","186","129","2","317","722","0","43.91","25.76"
"10","018","00","020","0020","0000","350","142","208","11","361","837","0","43.13","16.97"
"10","018","00","020","0020","0264","350","142","208","11","361","837","0","43.13","16.97"
"10","018","00","020","0021","0000","1287","720","567","16","1303","2741","0","47.54","26.27"
"10","018","00","020","0021","0228","386","238","148","4","390","841","0","46.37","28.30"
"10","018","00","020","0021","0229","442","243","199","6","448","886","0","50.56","27.43"
"10","018","00","020","0021","0230","459","239","220","6","465","1014","0","45.86","23.57"
"10","018","00","020","0022","0000","2618","1463","1155","33","2651","5956","0","44.51","24.56"
"10","018","00","020","0022","0239","403","229","174","5","408","869","0","46.95","26.35"
"10","018","00","020","0022","0240","353","193","160","9","362","847","0","42.74","22.79"
"10","018","00","020","0022","0241","406","233","173","2","408","863","0","47.28","27.00"
"10","018","00","020","0022","0242","374","198","176","7","381","967","0","39.40","20.48"
"10","018","00","020","0022","0243","488","262","226","5","493","1166","0","42.28","22.47"
"10","018","00","020","0022","0244","594","348","246","5","599","1244","0","48.15","27.97"
"10","018","00","020","0023","0000","2135","1691","444","24","2159","4508","0","47.89","37.51"
"10","018","00","020","0023","0250","506","406","100","8","514","1085","0","47.37","37.42"
"10","018","00","020","0023","0251","503","415","88","5","508","1122","0","45.28","36.99"
"10","018","00","020","0023","0252","582","443","139","2","584","1208","0","48.34","36.67"
"10","018","00","020","0023","0253","544","427","117","9","553","1093","0","50.59","39.07"
"10","018","00","020","0024","0000","2012","1069","943","26","2038","5777","0","35.28","18.50"
"10","018","00","020","0024","0265","507","268","239","5","512","1307","0","39.17","20.50"
"10","018","00","020","0024","0266","434","262","172","10","444","1220","0","36.39","21.48"
"10","018","00","020","0024","0267","399","188","211","1","400","1169","0","34.22","16.08"
"10","018","00","020","0024","0268","312","169","143","4","316","953","0","33.16","17.73"
"10","018","00","020","0024","0269","360","182","178","6","366","1128","0","32.45","16.13"
"10","018","00","020","0025","0000","222","114","108","5","227","574","0","39.55","19.86"
"10","018","00","020","0025","0282","222","114","108","5","227","574","0","39.55","19.86"
"10","018","00","020","0026","0000","1200","603","597","16","1216","2946","0","41.28","20.47"
"10","018","00","020","0026","0270","310","161","149","5","315","750","0","42.00","21.47"
"10","018","00","020","0026","0271","505","258","247","4","509","1282","0","39.70","20.12"
"10","018","00","020","0026","0272","385","184","201","7","392","914","0","42.89","20.13"
"10","018","00","020","0027","0000","749","329","420","10","759","1982","0","38.29","16.60"
"10","018","00","020","0027","0280","311","127","184","7","318","845","0","37.63","15.03"
"10","018","00","020","0027","0281","438","202","236","3","441","1137","0","38.79","17.77"
"10","018","00","020","0028","0000","1360","732","628","18","1378","3687","0","37.37","19.85"
"10","018","00","020","0028","0273","409","225","184","3","412","1093","0","37.69","20.59"
"10","018","00","020","0028","0274","507","259","248","8","515","1419","0","36.29","18.25"
"10","018","00","020","0028","0275","444","248","196","7","451","1175","0","38.38","21.11"
"10","018","00","020","0029","0000","1429","739","690","11","1440","4195","0","34.33","17.62"
"10","018","00","020","0029","0276","354","163","191","4","358","1068","0","33.52","15.26"
"10","018","00","020","0029","0277","333","197","136","1","334","875","0","38.17","22.51"
"10","018","00","020","0029","0278","374","196","178","2","376","1078","0","34.88","18.18"
"10","018","00","020","0029","0279","368","183","185","4","372","1174","0","31.69","15.59"
"10","018","00","020","0030","0000","700","355","345","6","706","1590","0","44.40","22.33"
"10","018","00","020","0030","0181","437","213","224","5","442","972","0","45.47","21.91"
"10","018","00","020","0030","0182","263","142","121","1","264","618","0","42.72","22.98"
"10","018","00","020","0031","0000","1499","747","752","13","1512","3409","0","44.35","21.91"
"10","018","00","020","0031","0168","459","236","223","4","463","1145","0","40.44","20.61"
"10","018","00","020","0031","0169","525","266","259","5","530","1104","0","48.01","24.09"
"10","018","00","020","0031","0170","515","245","270","4","519","1160","0","44.74","21.12"
"10","018","00","020","0032","0000","1987","1072","915","23","2010","5102","0","39.40","21.01"
"10","018","00","020","0032","0173","335","195","140","5","340","938","0","36.25","20.79"
"10","018","00","020","0032","0174","514","290","224","6","520","1165","0","44.64","24.89"
"10","018","00","020","0032","0175","358","201","157","3","361","1087","0","33.21","18.49"
"10","018","00","020","0032","0176","258","152","106","4","262","735","0","35.65","20.68"
"10","018","00","020","0032","0177","522","234","288","5","527","1177","0","44.77","19.88"
"10","018","00","020","0033","0000","1197","563","634","21","1218","2825","0","43.12","19.93"
"10","018","00","020","0033","0178","403","188","215","3","406","984","0","41.26","19.11"
"10","018","00","020","0033","0179","369","162","207","9","378","903","0","41.86","17.94"
"10","018","00","020","0033","0180","425","213","212","9","434","938","0","46.27","22.71"
"10","018","00","020","0034","0000","1496","617","879","24","1520","3409","0","44.59","18.10"
"10","018","00","020","0034","0186","485","220","265","13","498","1086","0","45.86","20.26"
"10","018","00","020","0034","0187","446","174","272","6","452","1103","0","40.98","15.78"
"10","018","00","020","0034","0188","565","223","342","5","570","1220","0","46.72","18.28"
"10","018","00","020","0036","0000","2103","1152","951","35","2138","4668","0","45.80","24.68"
"10","018","00","020","0036","0258","493","267","226","8","501","1052","0","47.62","25.38"
"10","018","00","020","0036","0259","513","277","236","15","528","1140","0","46.32","24.30"
"10","018","00","020","0036","0260","567","313","254","10","577","1209","0","47.73","25.89"
"10","018","00","020","0036","0261","530","295","235","2","532","1267","0","41.99","23.28"
"10","018","00","020","0037","0000","2322","1172","1150","22","2344","5381","0","43.56","21.78"
"10","018","00","020","0037","0202","446","215","231","1","447","1048","0","42.65","20.52"
"10","018","00","020","0037","0203","460","203","257","2","462","1019","0","45.34","19.92"
"10","018","00","020","0037","0204","478","254","224","6","484","1106","0","43.76","22.97"
"10","018","00","020","0037","0205","498","279","219","10","508","1188","0","42.76","23.48"
"10","018","00","020","0037","0206","440","221","219","3","443","1020","0","43.43","21.67"
"10","018","00","020","0038","0000","1663","822","841","21","1684","4426","0","38.05","18.57"
"10","018","00","020","0038","0207","423","204","219","2","425","1145","0","37.12","17.82"
"10","018","00","020","0038","0208","402","216","186","8","410","1074","0","38.18","20.11"
"10","018","00","020","0038","0209","415","170","245","3","418","1141","0","36.63","14.90"
"10","018","00","020","0038","0210","423","232","191","8","431","1066","0","40.43","21.76"
"10","018","00","020","0039","0000","1496","820","676","11","1507","4165","0","36.18","19.69"
"10","018","00","020","0039","0220","239","125","114","3","242","1264","0","19.15","9.89"
"10","018","00","020","0039","0221","422","220","202","3","425","887","0","47.91","24.80"
"10","018","00","020","0039","0222","405","236","169","2","407","1031","0","39.48","22.89"
"10","018","00","020","0039","0223","430","239","191","3","433","983","0","44.05","24.31"
"10","018","00","020","0040","0000","2183","1201","982","25","2208","4801","0","45.99","25.02"
"10","018","00","020","0040","0224","473","243","230","4","477","1165","0","40.94","20.86"
"10","018","00","020","0040","0225","559","297","262","10","569","1221","0","46.60","24.32"
"10","018","00","020","0040","0226","567","312","255","5","572","1127","0","50.75","27.68"
"10","018","00","020","0040","0227","584","349","235","6","590","1288","0","45.81","27.10"
"10","018","00","020","0041","0000","2415","1417","998","21","2436","5732","0","42.50","24.72"
"10","018","00","020","0041","0245","469","252","217","0","469","1175","0","39.91","21.45"
"10","018","00","020","0041","0246","471","260","211","6","477","1166","0","40.91","22.30"
"10","018","00","020","0041","0247","486","314","172","6","492","1124","0","43.77","27.94"
"10","018","00","020","0041","0248","523","317","206","3","526","1182","0","44.50","26.82"
"10","018","00","020","0041","0249","466","274","192","6","472","1085","0","43.50","25.25"
"10","018","00","020","0042","0000","2961","1753","1208","41","3002","6577","0","45.64","26.65"
"10","018","00","020","0042","0233","495","247","248","8","503","1166","0","43.14","21.18"
"10","018","00","020","0042","0234","428","244","184","10","438","1040","0","42.12","23.46"
"10","018","00","020","0042","0235","511","313","198","4","515","1087","0","47.38","28.79"
"10","018","00","020","0042","0236","476","293","183","5","481","1041","0","46.21","28.15"
"10","018","00","020","0042","0237","504","315","189","11","515","1118","0","46.06","28.18"
"10","018","00","020","0042","0238","547","341","206","3","550","1125","0","48.89","30.31"
"10","018","00","020","0043","0000","1316","681","635","14","1330","2938","0","45.27","23.18"
"10","018","00","020","0043","0231","645","305","340","7","652","1461","0","44.63","20.88"
"10","018","00","020","0043","0232","671","376","295","7","678","1477","0","45.90","25.46"
"10","018","00","020","0044","0000","601","313","288","7","608","1564","0","38.87","20.01"
"10","018","00","020","0044","0171","308","162","146","3","311","829","0","37.52","19.54"
"10","018","00","020","0044","0172","293","151","142","4","297","735","0","40.41","20.54"
"10","018","00","020","0045","0000","1554","1048","506","26","1580","3326","0","47.50","31.51"
"10","018","00","020","0045","0183","620","496","124","11","631","1219","0","51.76","40.69"
"10","018","00","020","0045","0184","446","250","196","9","455","1113","0","40.88","22.46"
"10","018","00","020","0045","0185","488","302","186","6","494","994","0","49.70","30.38"
"10","018","00","020","0046","0000","338","154","184","4","342","684","0","50.00","22.51"
"10","018","00","020","0046","0164","338","154","184","4","342","684","0","50.00","22.51"
"10","018","00","020","0047","0000","364","187","177","6","370","995","0","37.19","18.79"
"10","018","00","020","0047","0189","364","187","177","6","370","995","0","37.19","18.79"
"10","018","00","030","0000","0000","25615","12744","12871","350","25965","66397","78776","39.11","19.19"
"10","018","00","030","0001","0000","1045","397","648","13","1058","2715","0","38.97","14.62"
"10","018","00","030","0001","0313","332","128","204","6","338","857","0","39.44","14.94"
"10","018","00","030","0001","0314","368","137","231","5","373","930","0","40.11","14.73"
"10","018","00","030","0001","0315","345","132","213","2","347","928","0","37.39","14.22"
"10","018","00","030","0002","0000","2068","939","1129","37","2105","5496","0","38.30","17.09"
"10","018","00","030","0002","0308","359","161","198","6","365","1057","0","34.53","15.23"
"10","018","00","030","0002","0309","347","152","195","3","350","925","0","37.84","16.43"
"10","018","00","030","0002","0310","465","236","229","10","475","1310","0","36.26","18.02"
"10","018","00","030","0002","0311","381","172","209","6","387","982","0","39.41","17.52"
"10","018","00","030","0002","0312","516","218","298","12","528","1222","0","43.21","17.84"
"10","018","00","030","0003","0000","901","454","447","13","914","2275","0","40.18","19.96"
"10","018","00","030","0003","0306","359","187","172","1","360","935","0","38.50","20.00"
"10","018","00","030","0003","0307","542","267","275","12","554","1340","0","41.34","19.93"
"10","018","00","030","0004","0000","825","343","482","10","835","2355","0","35.46","14.56"
"10","018","00","030","0004","0304","404","172","232","6","410","1212","0","33.83","14.19"
"10","018","00","030","0004","0305","421","171","250","4","425","1143","0","37.18","14.96"
"10","018","00","030","0005","0000","906","328","578","15","921","2096","0","43.94","15.65"
"10","018","00","030","0005","0302","467","160","307","9","476","1143","0","41.64","14.00"
"10","018","00","030","0005","0303","439","168","271","6","445","953","0","46.69","17.63"
"10","018","00","030","0006","0000","1303","582","721","20","1323","3186","0","41.53","18.27"
"10","018","00","030","0006","0299","445","218","227","6","451","1122","0","40.20","19.43"
"10","018","00","030","0006","0300","370","173","197","7","377","862","0","43.74","20.07"
"10","018","00","030","0006","0301","488","191","297","7","495","1202","0","41.18","15.89"
"10","018","00","030","0007","0000","1277","654","623","15","1292","2869","0","45.03","22.80"
"10","018","00","030","0007","0292","420","199","221","7","427","892","0","47.87","22.31"
"10","018","00","030","0007","0293","470","243","227","4","474","1093","0","43.37","22.23"
"10","018","00","030","0007","0294","387","212","175","4","391","884","0","44.23","23.98"
"10","018","00","030","0008","0000","1721","906","815","20","1741","4595","0","37.89","19.72"
"10","018","00","030","0008","0295","464","226","238","5","469","1134","0","41.36","19.93"
"10","018","00","030","0008","0296","409","203","206","5","414","1141","0","36.28","17.79"
"10","018","00","030","0008","0297","380","206","174","3","383","1182","0","32.40","17.43"
"10","018","00","030","0008","0298","468","271","197","7","475","1138","0","41.74","23.81"
"10","018","00","030","0009","0000","1960","1062","898","21","1981","5017","0","39.49","21.17"
"10","018","00","030","0009","0283","431","218","213","8","439","990","0","44.34","22.02"
"10","018","00","030","0009","0284","352","178","174","7","359","943","0","38.07","18.88"
"10","018","00","030","0009","0285","347","207","140","0","347","968","0","35.85","21.38"
"10","018","00","030","0009","0286","419","231","188","4","423","1030","0","41.07","22.43"
"10","018","00","030","0009","0287","411","228","183","2","413","1086","0","38.03","20.99"
"10","018","00","030","0010","0000","1804","1041","763","33","1837","4051","0","45.35","25.70"
"10","018","00","030","0010","0316","326","169","157","6","332","815","0","40.74","20.74"
"10","018","00","030","0010","0317","551","338","213","10","561","1053","0","53.28","32.10"
"10","018","00","030","0010","0318","376","228","148","4","380","951","0","39.96","23.97"
"10","018","00","030","0010","0319","551","306","245","13","564","1232","0","45.78","24.84"
"10","018","00","030","0011","0000","1406","789","617","21","1427","3559","0","40.10","22.17"
"10","018","00","030","0011","0320","419","205","214","10","429","1215","0","35.31","16.87"
"10","018","00","030","0011","0321","470","265","205","5","475","1156","0","41.09","22.92"
"10","018","00","030","0011","0322","517","319","198","6","523","1188","0","44.02","26.85"
"10","018","00","030","0012","0000","1582","797","785","18","1600","4357","0","36.72","18.29"
"10","018","00","030","0012","0323","440","218","222","2","442","1176","0","37.59","18.54"
"10","018","00","030","0012","0324","370","164","206","5","375","1025","0","36.59","16.00"
"10","018","00","030","0012","0325","393","211","182","4","397","1146","0","34.64","18.41"
"10","018","00","030","0012","0326","379","204","175","7","386","1010","0","38.22","20.20"
"10","018","00","030","0013","0000","1065","452","613","17","1082","2843","0","38.06","15.90"
"10","018","00","030","0013","0327","435","188","247","7","442","1042","0","42.42","18.04"
"10","018","00","030","0013","0328","333","132","201","6","339","897","0","37.79","14.72"
"10","018","00","030","0013","0329","297","132","165","4","301","904","0","33.30","14.60"
"10","018","00","030","0014","0000","431","176","255","5","436","1121","0","38.89","15.70"
"10","018","00","030","0014","0330","431","176","255","5","436","1121","0","38.89","15.70"
"10","018","00","030","0015","0000","777","379","398","6","783","2151","0","36.40","17.62"
"10","018","00","030","0015","0331","411","220","191","2","413","1131","0","36.52","19.45"
"10","018","00","030","0015","0332","366","159","207","4","370","1020","0","36.27","15.59"
"10","018","00","030","0016","0000","878","480","398","12","890","2366","0","37.62","20.29"
"10","018","00","030","0016","0333","407","196","211","5","412","1245","0","33.09","15.74"
"10","018","00","030","0016","0334","471","284","187","7","478","1121","0","42.64","25.33"
"10","018","00","030","0017","0000","271","146","125","6","277","924","0","29.98","15.80"
"10","018","00","030","0017","0346","271","146","125","6","277","924","0","29.98","15.80"
"10","018","00","030","0018","0000","328","161","167","5","333","862","0","38.63","18.68"
"10","018","00","030","0018","0345","328","161","167","5","333","862","0","38.63","18.68"
"10","018","00","030","0019","0000","300","170","130","3","303","770","0","39.35","22.08"
"10","018","00","030","0019","0344","300","170","130","3","303","770","0","39.35","22.08"
"10","018","00","030","0020","0000","631","377","254","6","637","1828","0","34.85","20.62"
"10","018","00","030","0020","0342","276","158","118","0","276","718","0","38.44","22.01"
"10","018","00","030","0020","0343","355","219","136","6","361","1110","0","32.52","19.73"
"10","018","00","030","0021","0000","1483","753","730","21","1504","4280","0","35.14","17.59"
"10","018","00","030","0021","0337","428","249","179","3","431","1083","0","39.80","22.99"
"10","018","00","030","0021","0338","289","147","142","5","294","974","0","30.18","15.09"
"10","018","00","030","0021","0339","431","193","238","3","434","1239","0","35.03","15.58"
"10","018","00","030","0021","0340","335","164","171","10","345","984","0","35.06","16.67"
"10","018","00","030","0022","0000","549","260","289","10","559","1479","0","37.80","17.58"
"10","018","00","030","0022","0335","323","161","162","8","331","863","0","38.35","18.66"
"10","018","00","030","0022","0336","226","99","127","2","228","616","0","37.01","16.07"
"10","018","00","030","0023","0000","335","132","203","6","341","792","0","43.06","16.67"
"10","018","00","030","0023","0341","335","132","203","6","341","792","0","43.06","16.67"
"10","018","00","030","0024","0000","1769","966","803","17","1786","4410","0","40.50","21.90"
"10","018","00","030","0024","0288","338","165","173","6","344","789","0","43.60","20.91"
"10","018","00","030","0024","0289","503","272","231","4","507","1240","0","40.89","21.94"
"10","018","00","030","0024","0290","496","296","200","4","500","1222","0","40.92","24.22"
"10","018","00","030","0024","0291","432","233","199","3","435","1159","0","37.53","20.10"
"10","020","00","000","0000","0000","92241","41437","50804","686","92927","221038","264721","42.04","18.75"
"10","020","00","010","0000","0000","42418","19997","22421","291","42709","100157","119170","42.64","19.97"
"10","020","00","010","0001","0000","1749","745","1004","11","1760","4525","0","38.90","16.46"
"10","020","00","010","0001","0086","526","161","365","6","532","1289","0","41.27","12.49"
"10","020","00","010","0001","0087","386","178","208","2","388","983","0","39.47","18.11"
"10","020","00","010","0001","0088","405","209","196","1","406","1142","0","35.55","18.30"
"10","020","00","010","0001","0089","432","197","235","2","434","1111","0","39.06","17.73"
"10","020","00","010","0002","0000","1367","598","769","6","1373","3379","0","40.63","17.70"
"10","020","00","010","0002","0083","446","186","260","2","448","1094","0","40.95","17.00"
"10","020","00","010","0002","0084","502","226","276","4","506","1209","0","41.85","18.69"
"10","020","00","010","0002","0085","419","186","233","0","419","1076","0","38.94","17.29"
"10","020","00","010","0003","0000","1184","553","631","5","1189","2803","0","42.42","19.73"
"10","020","00","010","0003","0081","570","259","311","3","573","1364","0","42.01","18.99"
"10","020","00","010","0003","0082","614","294","320","2","616","1439","0","42.81","20.43"
"10","020","00","010","0004","0000","1322","652","670","6","1328","3208","0","41.40","20.32"
"10","020","00","010","0004","0074","384","182","202","1","385","1014","0","37.97","17.95"
"10","020","00","010","0004","0075","500","265","235","3","503","1128","0","44.59","23.49"
"10","020","00","010","0004","0076","438","205","233","2","440","1066","0","41.28","19.23"
"10","020","00","010","0005","0000","905","456","449","3","908","2125","0","42.73","21.46"
"10","020","00","010","0005","0077","482","229","253","3","485","1177","0","41.21","19.46"
"10","020","00","010","0005","0078","423","227","196","0","423","948","0","44.62","23.95"
"10","020","00","010","0034","0000","1770","980","790","11","1781","4239","0","42.01","23.12"
"10","020","00","010","0034","0024","481","303","178","5","486","1231","0","39.48","24.61"
"10","020","00","010","0034","0025","555","325","230","4","559","1270","0","44.02","25.59"
"10","020","00","010","0034","0026","358","182","176","1","359","861","0","41.70","21.14"
"10","020","00","010","0034","0027","376","170","206","1","377","877","0","42.99","19.38"
"10","020","00","010","0035","0000","1849","948","901","15","1864","4140","0","45.02","22.90"
"10","020","00","010","0035","0020","481","241","240","3","484","1062","0","45.57","22.69"
"10","020","00","010","0035","0021","490","264","226","4","494","1170","0","42.22","22.56"
"10","020","00","010","0035","0022","420","216","204","3","423","907","0","46.64","23.81"
"10","020","00","010","0035","0023","458","227","231","5","463","1001","0","46.25","22.68"
"10","020","00","010","0036","0000","1698","893","805","11","1709","3945","0","43.32","22.64"
"10","020","00","010","0036","0017","552","244","308","9","561","1433","0","39.15","17.03"
"10","020","00","010","0036","0018","513","278","235","0","513","1055","0","48.63","26.35"
"10","020","00","010","0036","0019","633","371","262","2","635","1457","0","43.58","25.46"
"10","020","00","010","0037","0000","1055","548","507","9","1064","2249","0","47.31","24.37"
"10","020","00","010","0037","0013","536","281","255","3","539","1144","0","47.12","24.56"
"10","020","00","010","0037","0014","519","267","252","6","525","1105","0","47.51","24.16"
"10","020","00","010","0038","0000","806","443","363","3","809","1740","0","46.49","25.46"
"10","020","00","010","0038","0005","341","190","151","1","342","683","0","50.07","27.82"
"10","020","00","010","0038","0006","465","253","212","2","467","1057","0","44.18","23.94"
"10","020","00","010","0039","0000","1777","926","851","15","1792","4209","0","42.58","22.00"
"10","020","00","010","0039","0030","575","326","249","6","581","1472","0","39.47","22.15"
"10","020","00","010","0039","0031","612","308","304","4","616","1352","0","45.56","22.78"
"10","020","00","010","0039","0032","590","292","298","5","595","1385","0","42.96","21.08"
"10","020","00","010","0041","0000","801","376","425","7","808","1933","0","41.80","19.45"
"10","020","00","010","0041","0008","370","165","205","2","372","923","0","40.30","17.88"
"10","020","00","010","0041","0009","431","211","220","5","436","1010","0","43.17","20.89"
"10","020","00","010","0042","0000","379","161","218","3","382","1058","0","36.11","15.22"
"10","020","00","010","0042","0007","379","161","218","3","382","1058","0","36.11","15.22"
"10","020","00","010","0043","0000","1294","633","661","9","1303","2882","0","45.21","21.96"
"10","020","00","010","0043","0015","669","327","342","3","672","1496","0","44.92","21.86"
"10","020","00","010","0043","0016","625","306","319","6","631","1386","0","45.53","22.08"
"10","020","00","010","0044","0000","1082","565","517","6","1088","2346","0","46.38","24.08"
"10","020","00","010","0044","0001","457","230","227","2","459","1021","0","44.96","22.53"
"10","020","00","010","0044","0002","625","335","290","4","629","1325","0","47.47","25.28"
"10","020","00","010","0045","0000","851","410","441","7","858","1953","0","43.93","20.99"
"10","020","00","010","0045","0045","374","180","194","3","377","895","0","42.12","20.11"
"10","020","00","010","0045","0046","477","230","247","4","481","1058","0","45.46","21.74"
"10","020","00","010","0046","0000","492","203","289","5","497","1241","0","40.05","16.36"
"10","020","00","010","0046","0047","492","203","289","5","497","1241","0","40.05","16.36"
"10","020","00","010","0047","0000","636","240","396","6","642","1578","0","40.68","15.21"
"10","020","00","010","0047","0048","363","136","227","4","367","804","0","45.65","16.92"
"10","020","00","010","0047","0049","273","104","169","2","275","774","0","35.53","13.44"
"10","020","00","010","0048","0000","519","224","295","1","520","1231","0","42.24","18.20"
"10","020","00","010","0048","0050","519","224","295","1","520","1231","0","42.24","18.20"
"10","020","00","010","0049","0000","1298","580","718","12","1310","3435","0","38.14","16.89"
"10","020","00","010","0049","0051","433","175","258","3","436","1031","0","42.29","16.97"
"10","020","00","010","0049","0052","437","218","219","3","440","1306","0","33.69","16.69"
"10","020","00","010","0049","0053","428","187","241","6","434","1098","0","39.53","17.03"
"10","020","00","010","0050","0000","947","446","501","10","957","2160","0","44.31","20.65"
"10","020","00","010","0050","0054","436","233","203","6","442","1021","0","43.29","22.82"
"10","020","00","010","0050","0055","511","213","298","4","515","1139","0","45.22","18.70"
"10","020","00","010","0051","0000","1066","442","624","10","1076","2474","0","43.49","17.87"
"10","020","00","010","0051","0056","513","205","308","7","520","1246","0","41.73","16.45"
"10","020","00","010","0051","0057","553","237","316","3","556","1228","0","45.28","19.30"
"10","020","00","010","0052","0000","1128","498","630","8","1136","2693","0","42.18","18.49"
"10","020","00","010","0052","0058","602","270","332","4","606","1409","0","43.01","19.16"
"10","020","00","010","0052","0059","526","228","298","4","530","1284","0","41.28","17.76"
"10","020","00","010","0053","0000","1158","544","614","14","1172","2905","0","40.34","18.73"
"10","020","00","010","0053","0065","423","173","250","5","428","1179","0","36.30","14.67"
"10","020","00","010","0053","0066","735","371","364","9","744","1726","0","43.11","21.49"
"10","020","00","010","0054","0000","1526","729","797","11","1537","3865","0","39.77","18.86"
"10","020","00","010","0054","0062","472","190","282","4","476","1141","0","41.72","16.65"
"10","020","00","010","0054","0063","460","227","233","1","461","1198","0","38.48","18.95"
"10","020","00","010","0054","0064","594","312","282","6","600","1526","0","39.32","20.45"
"10","020","00","010","0055","0000","1519","737","782","10","1529","3606","0","42.40","20.44"
"10","020","00","010","0055","0067","492","214","278","3","495","1173","0","42.20","18.24"
"10","020","00","010","0055","0068","571","313","258","2","573","1272","0","45.05","24.61"
"10","020","00","010","0055","0069","456","210","246","5","461","1161","0","39.71","18.09"
"10","020","00","010","0056","0000","907","366","541","3","910","1993","0","45.66","18.36"
"10","020","00","010","0056","0043","465","191","274","1","466","996","0","46.79","19.18"
"10","020","00","010","0056","0044","442","175","267","2","444","997","0","44.53","17.55"
"10","020","00","010","0057","0000","666","282","384","3","669","1684","0","39.73","16.75"
"10","020","00","010","0057","0041","395","178","217","1","396","902","0","43.90","19.73"
"10","020","00","010","0057","0042","271","104","167","2","273","782","0","34.91","13.30"
"10","020","00","010","0058","0000","844","343","501","8","852","1923","0","44.31","17.84"
"10","020","00","010","0058","0039","421","141","280","2","423","912","0","46.38","15.46"
"10","020","00","010","0058","0040","423","202","221","6","429","1011","0","42.43","19.98"
"10","020","00","010","0059","0000","801","337","464","9","810","1928","0","42.01","17.48"
"10","020","00","010","0059","0035","379","167","212","2","381","906","0","42.05","18.43"
"10","020","00","010","0059","0036","422","170","252","7","429","1022","0","41.98","16.63"
"10","020","00","010","0060","0000","848","373","475","7","855","1797","0","47.58","20.76"
"10","020","00","010","0060","0033","405","212","193","2","407","890","0","45.73","23.82"
"10","020","00","010","0060","0034","443","161","282","5","448","907","0","49.39","17.75"
"10","020","00","010","0061","0000","900","458","442","7","907","1852","0","48.97","24.73"
"10","020","00","010","0061","0028","547","286","261","5","552","1166","0","47.34","24.53"
"10","020","00","010","0061","0029","353","172","181","2","355","686","0","51.75","25.07"
"10","020","00","010","0062","0000","994","379","615","7","1001","2130","0","47.00","17.79"
"10","020","00","010","0062","0037","491","196","295","4","495","1125","0","44.00","17.42"
"10","020","00","010","0062","0038","503","183","320","3","506","1005","0","50.35","18.21"
"10","020","00","010","0063","0000","975","431","544","0","975","2284","0","42.69","18.87"
"10","020","00","010","0063","0072","583","263","320","0","583","1312","0","44.44","20.05"
"10","020","00","010","0063","0073","392","168","224","0","392","972","0","40.33","17.28"
"10","020","00","010","0064","0000","952","380","572","12","964","2085","0","46.24","18.23"
"10","020","00","010","0064","0070","462","190","272","8","470","1097","0","42.84","17.32"
"10","020","00","010","0064","0071","490","190","300","4","494","988","0","50.00","19.23"
"10","020","00","010","0065","0000","910","457","453","3","913","2195","0","41.59","20.82"
"10","020","00","010","0065","0003","375","182","193","2","377","1015","0","37.14","17.93"
"10","020","00","010","0065","0004","535","275","260","1","536","1180","0","45.42","23.31"
"10","020","00","010","0066","0000","1625","806","819","8","1633","3695","0","44.19","21.81"
"10","020","00","010","0066","0010","583","249","334","3","586","1290","0","45.43","19.30"
"10","020","00","010","0066","0011","529","275","254","3","532","1221","0","43.57","22.52"
"10","020","00","010","0066","0012","513","282","231","2","515","1184","0","43.50","23.82"
"10","020","00","010","0067","0000","776","373","403","7","783","1950","0","40.15","19.13"
"10","020","00","010","0067","0060","373","181","192","5","378","963","0","39.25","18.80"
"10","020","00","010","0067","0061","403","192","211","2","405","987","0","41.03","19.45"
"10","020","00","010","0068","0000","1042","482","560","3","1045","2719","0","38.43","17.73"
"10","020","00","010","0068","0079","547","251","296","3","550","1354","0","40.62","18.54"
"10","020","00","010","0068","0080","495","231","264","0","495","1365","0","36.26","16.92"
"10","020","00","020","0000","0000","49823","21440","28383","395","50218","120881","145551","41.54","17.74"
"10","020","00","020","0001","0000","302","120","182","3","305","819","0","37.24","14.65"
"10","020","00","020","0001","0164","302","120","182","3","305","819","0","37.24","14.65"
"10","020","00","020","0002","0000","804","307","497","6","810","2045","0","39.61","15.01"
"10","020","00","020","0002","0169","383","127","256","2","385","1001","0","38.46","12.69"
"10","020","00","020","0002","0170","421","180","241","4","425","1044","0","40.71","17.24"
"10","020","00","020","0003","0000","1021","382","639","10","1031","2205","0","46.76","17.32"
"10","020","00","020","0003","0160","501","188","313","5","506","1127","0","44.90","16.68"
"10","020","00","020","0003","0161","520","194","326","5","525","1078","0","48.70","18.00"
"10","020","00","020","0005","0000","764","306","458","11","775","1945","0","39.85","15.73"
"10","020","00","020","0005","0165","408","177","231","3","411","1104","0","37.23","16.03"
"10","020","00","020","0005","0166","356","129","227","8","364","841","0","43.28","15.34"
"10","020","00","020","0009","0000","1735","722","1013","19","1754","4451","0","39.41","16.22"
"10","020","00","020","0009","0171","543","224","319","6","549","1473","0","37.27","15.21"
"10","020","00","020","0009","0172","612","246","366","9","621","1523","0","40.77","16.15"
"10","020","00","020","0009","0173","580","252","328","4","584","1455","0","40.14","17.32"
"10","020","00","020","0010","0000","1740","623","1117","18","1758","4153","0","42.33","15.00"
"10","020","00","020","0010","0180","610","216","394","4","614","1390","0","44.17","15.54"
"10","020","00","020","0010","0181","535","190","345","6","541","1379","0","39.23","13.78"
"10","020","00","020","0010","0182","595","217","378","8","603","1384","0","43.57","15.68"
"10","020","00","020","0011","0000","1304","560","744","7","1311","3225","0","40.65","17.36"
"10","020","00","020","0011","0177","692","300","392","3","695","1654","0","42.02","18.14"
"10","020","00","020","0011","0178","612","260","352","4","616","1571","0","39.21","16.55"
"10","020","00","020","0012","0000","1175","458","717","6","1181","2954","0","39.98","15.50"
"10","020","00","020","0012","0187","620","242","378","4","624","1562","0","39.95","15.49"
"10","020","00","020","0012","0188","555","216","339","2","557","1392","0","40.01","15.52"
"10","020","00","020","0013","0000","591","228","363","8","599","1556","0","38.50","14.65"
"10","020","00","020","0013","0189","591","228","363","8","599","1556","0","38.50","14.65"
"10","020","00","020","0014","0000","426","182","244","7","433","1125","0","38.49","16.18"
"10","020","00","020","0014","0186","426","182","244","7","433","1125","0","38.49","16.18"
"10","020","00","020","0015","0000","818","301","517","6","824","2143","0","38.45","14.05"
"10","020","00","020","0015","0101","403","153","250","4","407","1040","0","39.13","14.71"
"10","020","00","020","0015","0102","415","148","267","2","417","1103","0","37.81","13.42"
"10","020","00","020","0016","0000","1612","708","904","20","1632","4114","0","39.67","17.21"
"10","020","00","020","0016","0106","496","195","301","10","506","1158","0","43.70","16.84"
"10","020","00","020","0016","0107","507","209","298","5","512","1263","0","40.54","16.55"
"10","020","00","020","0016","0108","609","304","305","5","614","1693","0","36.27","17.96"
"10","020","00","020","0017","0000","1339","561","778","13","1352","3239","0","41.74","17.32"
"10","020","00","020","0017","0119","444","158","286","8","452","1048","0","43.13","15.08"
"10","020","00","020","0017","0120","458","217","241","2","460","1088","0","42.28","19.94"
"10","020","00","020","0017","0121","437","186","251","3","440","1103","0","39.89","16.86"
"10","020","00","020","0018","0000","1395","574","821","11","1406","3497","0","40.21","16.41"
"10","020","00","020","0018","0103","439","168","271","2","441","1023","0","43.11","16.42"
"10","020","00","020","0018","0104","470","196","274","5","475","1182","0","40.19","16.58"
"10","020","00","020","0018","0105","486","210","276","4","490","1292","0","37.93","16.25"
"10","020","00","020","0019","0000","1359","622","737","6","1365","3363","0","40.59","18.50"
"10","020","00","020","0019","0114","399","196","203","2","401","987","0","40.63","19.86"
"10","020","00","020","0019","0115","470","208","262","2","472","1128","0","41.84","18.44"
"10","020","00","020","0019","0116","490","218","272","2","492","1248","0","39.42","17.47"
"10","020","00","020","0020","0000","752","319","433","7","759","1847","0","41.09","17.27"
"10","020","00","020","0020","0117","409","162","247","3","412","970","0","42.47","16.70"
"10","020","00","020","0020","0118","343","157","186","4","347","877","0","39.57","17.90"
"10","020","00","020","0021","0000","2652","1252","1400","21","2673","6843","0","39.06","18.30"
"10","020","00","020","0021","0122","561","257","304","5","566","1437","0","39.39","17.88"
"10","020","00","020","0021","0123","491","225","266","4","495","1253","0","39.51","17.96"
"10","020","00","020","0021","0124","553","277","276","2","555","1460","0","38.01","18.97"
"10","020","00","020","0021","0125","478","224","254","4","482","1255","0","38.41","17.85"
"10","020","00","020","0021","0126","569","269","300","6","575","1438","0","39.99","18.71"
"10","020","00","020","0022","0000","792","335","457","11","803","2010","0","39.95","16.67"
"10","020","00","020","0022","0112","400","163","237","8","408","970","0","42.06","16.80"
"10","020","00","020","0022","0113","392","172","220","3","395","1040","0","37.98","16.54"
"10","020","00","020","0031","0000","869","378","491","9","878","1889","0","46.48","20.01"
"10","020","00","020","0031","0090","393","168","225","4","397","859","0","46.22","19.56"
"10","020","00","020","0031","0091","476","210","266","5","481","1030","0","46.70","20.39"
"10","020","00","020","0045","0000","773","444","329","3","776","1615","0","48.05","27.49"
"10","020","00","020","0045","0151","347","121","226","1","348","755","0","46.09","16.03"
"10","020","00","020","0045","0152","426","323","103","2","428","860","0","49.77","37.56"
"10","020","00","020","0046","0000","680","291","389","11","691","1915","0","36.08","15.20"
"10","020","00","020","0046","0149","349","137","212","3","352","926","0","38.01","14.79"
"10","020","00","020","0046","0150","331","154","177","8","339","989","0","34.28","15.57"
"10","020","00","020","0047","0000","2339","1012","1327","18","2357","5748","0","41.01","17.61"
"10","020","00","020","0047","0145","609","268","341","3","612","1547","0","39.56","17.32"
"10","020","00","020","0047","0146","505","205","300","5","510","1297","0","39.32","15.81"
"10","020","00","020","0047","0147","600","280","320","4","604","1334","0","45.28","20.99"
"10","020","00","020","0047","0148","625","259","366","6","631","1570","0","40.19","16.50"
"10","020","00","020","0048","0000","2122","977","1145","14","2136","5437","0","39.29","17.97"
"10","020","00","020","0048","0141","536","261","275","1","537","1169","0","45.94","22.33"
"10","020","00","020","0048","0142","544","217","327","6","550","1279","0","43.00","16.97"
"10","020","00","020","0048","0143","509","233","276","4","513","1601","0","32.04","14.55"
"10","020","00","020","0048","0144","533","266","267","3","536","1388","0","38.62","19.16"
"10","020","00","020","0049","0000","1768","692","1076","6","1774","4510","0","39.33","15.34"
"10","020","00","020","0049","0131","527","205","322","2","529","1464","0","36.13","14.00"
"10","020","00","020","0049","0132","574","211","363","3","577","1405","0","41.07","15.02"
"10","020","00","020","0049","0133","667","276","391","1","668","1641","0","40.71","16.82"
"10","020","00","020","0050","0000","1534","672","862","7","1541","3560","0","43.29","18.88"
"10","020","00","020","0050","0128","341","107","234","3","344","898","0","38.31","11.92"
"10","020","00","020","0050","0129","705","318","387","1","706","1550","0","45.55","20.52"
"10","020","00","020","0050","0130","488","247","241","3","491","1112","0","44.15","22.21"
"10","020","00","020","0051","0000","778","325","453","2","780","1726","0","45.19","18.83"
"10","020","00","020","0051","0153","424","185","239","1","425","915","0","46.45","20.22"
"10","020","00","020","0051","0154","354","140","214","1","355","811","0","43.77","17.26"
"10","020","00","020","0052","0000","817","610","207","6","823","1739","0","47.33","35.08"
"10","020","00","020","0052","0155","412","306","106","3","415","868","0","47.81","35.25"
"10","020","00","020","0052","0156","405","304","101","3","408","871","0","46.84","34.90"
"10","020","00","020","0053","0000","2151","995","1156","29","2180","5111","0","42.65","19.47"
"10","020","00","020","0053","0137","481","207","274","11","492","1185","0","41.52","17.47"
"10","020","00","020","0053","0138","570","259","311","8","578","1319","0","43.82","19.64"
"10","020","00","020","0053","0139","600","278","322","5","605","1464","0","41.33","18.99"
"10","020","00","020","0053","0140","500","251","249","5","505","1143","0","44.18","21.96"
"10","020","00","020","0054","0000","651","494","157","6","657","1383","0","47.51","35.72"
"10","020","00","020","0054","0157","651","494","157","6","657","1383","0","47.51","35.72"
"10","020","00","020","0055","0000","697","319","378","6","703","1622","0","43.34","19.67"
"10","020","00","020","0055","0127","697","319","378","6","703","1622","0","43.34","19.67"
"10","020","00","020","0056","0000","779","335","444","2","781","1864","0","41.90","17.97"
"10","020","00","020","0056","0092","372","159","213","2","374","951","0","39.33","16.72"
"10","020","00","020","0056","0093","407","176","231","0","407","913","0","44.58","19.28"
"10","020","00","020","0057","0000","734","231","503","5","739","1627","0","45.42","14.20"
"10","020","00","020","0057","0094","734","231","503","5","739","1627","0","45.42","14.20"
"10","020","00","020","0058","0000","1026","397","629","6","1032","2211","0","46.68","17.96"
"10","020","00","020","0058","0095","545","240","305","5","550","1200","0","45.83","20.00"
"10","020","00","020","0058","0096","481","157","324","1","482","1011","0","47.68","15.53"
"10","020","00","020","0059","0000","1001","375","626","10","1011","2209","0","45.77","16.98"
"10","020","00","020","0059","0097","476","167","309","5","481","1109","0","43.37","15.06"
"10","020","00","020","0059","0098","525","208","317","5","530","1100","0","48.18","18.91"
"10","020","00","020","0060","0000","548","240","308","3","551","1253","0","43.97","19.15"
"10","020","00","020","0060","0100","548","240","308","3","551","1253","0","43.97","19.15"
"10","020","00","020","0061","0000","636","242","394","9","645","1355","0","47.60","17.86"
"10","020","00","020","0061","0099","636","242","394","9","645","1355","0","47.60","17.86"
"10","020","00","020","0062","0000","688","277","411","6","694","1512","0","45.90","18.32"
"10","020","00","020","0062","0158","329","122","207","4","333","719","0","46.31","16.97"
"10","020","00","020","0062","0159","359","155","204","2","361","793","0","45.52","19.55"
"10","020","00","020","0063","0000","635","245","390","6","641","1521","0","42.14","16.11"
"10","020","00","020","0063","0162","320","131","189","2","322","743","0","43.34","17.63"
"10","020","00","020","0063","0163","315","114","201","4","319","778","0","41.00","14.65"
"10","020","00","020","0064","0000","805","303","502","6","811","2042","0","39.72","14.84"
"10","020","00","020","0064","0167","455","187","268","3","458","1129","0","40.57","16.56"
"10","020","00","020","0064","0168","350","116","234","3","353","913","0","38.66","12.71"
"10","020","00","020","0065","0000","1711","727","984","7","1718","4195","0","40.95","17.33"
"10","020","00","020","0065","0109","591","219","372","4","595","1364","0","43.62","16.06"
"10","020","00","020","0065","0110","555","246","309","3","558","1386","0","40.26","17.75"
"10","020","00","020","0065","0111","565","262","303","0","565","1445","0","39.10","18.13"
"10","020","00","020","0066","0000","1142","501","641","7","1149","2686","0","42.78","18.65"
"10","020","00","020","0066","0134","562","268","294","4","566","1313","0","43.11","20.41"
"10","020","00","020","0066","0135","580","233","347","3","583","1373","0","42.46","16.97"
"10","020","00","020","0067","0000","648","247","401","3","651","1570","0","41.46","15.73"
"10","020","00","020","0067","0136","648","247","401","3","651","1570","0","41.46","15.73"
"10","020","00","020","0068","0000","1367","605","762","4","1371","3637","0","37.70","16.63"
"10","020","00","020","0068","0183","448","185","263","1","449","1276","0","35.19","14.50"
"10","020","00","020","0068","0184","468","193","275","2","470","1212","0","38.78","15.92"
"10","020","00","020","0068","0185","451","227","224","1","452","1149","0","39.34","19.76"
"10","020","00","020","0069","0000","1836","756","1080","10","1846","4295","0","42.98","17.60"
"10","020","00","020","0069","0174","519","197","322","3","522","1243","0","42.00","15.85"
"10","020","00","020","0069","0175","600","275","325","3","603","1324","0","45.54","20.77"
"10","020","00","020","0069","0176","717","284","433","4","721","1728","0","41.72","16.44"
"10","020","00","020","0070","0000","507","190","317","4","511","1115","0","45.83","17.04"
"10","020","00","020","0070","0179","507","190","317","4","511","1115","0","45.83","17.04"
"09","020","00","000","0000","0000","23127","20027","3100","280","23407","124592","139764","18.79","16.07"
"09","020","00","010","0000","0000","7308","6385","923","67","7375","37667","42770","19.58","16.95"
"09","020","00","010","0001","0000","956","851","105","10","966","4809","0","20.09","17.70"
"09","020","00","010","0001","0001","269","241","28","1","270","1369","0","19.72","17.60"
"09","020","00","010","0001","0002","360","321","39","4","364","1748","0","20.82","18.36"
"09","020","00","010","0001","0003","327","289","38","5","332","1692","0","19.62","17.08"
"09","020","00","010","0002","0000","2026","1811","215","14","2040","9671","0","21.09","18.73"
"09","020","00","010","0002","0007","314","273","41","1","315","1584","0","19.89","17.23"
"09","020","00","010","0002","0008","331","292","39","2","333","1622","0","20.53","18.00"
"09","020","00","010","0002","0009","314","290","24","4","318","1564","0","20.33","18.54"
"09","020","00","010","0002","0010","347","306","41","0","347","1654","0","20.98","18.50"
"09","020","00","010","0002","0011","385","342","43","4","389","1730","0","22.49","19.77"
"09","020","00","010","0002","0012","335","308","27","3","338","1517","0","22.28","20.30"
"09","020","00","010","0003","0000","1067","919","148","13","1080","5344","0","20.21","17.20"
"09","020","00","010","0003","0004","342","297","45","1","343","1870","0","18.34","15.88"
"09","020","00","010","0003","0005","290","253","37","4","294","1608","0","18.28","15.73"
"09","020","00","010","0003","0006","435","369","66","8","443","1866","0","23.74","19.77"
"09","020","00","010","0004","0000","725","636","89","8","733","3979","0","18.42","15.98"
"09","020","00","010","0004","0013","264","222","42","5","269","1334","0","20.16","16.64"
"09","020","00","010","0004","0014","233","219","14","1","234","1174","0","19.93","18.65"
"09","020","00","010","0004","0015","228","195","33","2","230","1471","0","15.64","13.26"
"09","020","00","010","0005","0000","730","625","105","7","737","4023","0","18.32","15.54"
"09","020","00","010","0005","0020","233","209","24","4","237","1334","0","17.77","15.67"
"09","020","00","010","0005","0021","222","176","46","2","224","1229","0","18.23","14.32"
"09","020","00","010","0005","0022","275","240","35","1","276","1460","0","18.90","16.44"
"09","020","00","010","0006","0000","458","399","59","4","462","2226","0","20.75","17.92"
"09","020","00","010","0006","0019","458","399","59","4","462","2226","0","20.75","17.92"
"09","020","00","010","0007","0000","501","440","61","5","506","2885","0","17.54","15.25"
"09","020","00","010","0007","0023","238","206","32","2","240","1590","0","15.09","12.96"
"09","020","00","010","0007","0024","263","234","29","3","266","1295","0","20.54","18.07"
"09","020","00","010","0008","0000","845","704","141","6","851","4730","0","17.99","14.88"
"09","020","00","010","0008","0016","289","240","49","4","293","1565","0","18.72","15.34"
"09","020","00","010","0008","0017","261","220","41","1","262","1530","0","17.12","14.38"
"09","020","00","010","0008","0018","295","244","51","1","296","1635","0","18.10","14.92"
"09","020","00","020","0000","0000","3410","3080","330","46","3456","18724","20622","18.46","16.45"
"09","020","00","020","0001","0000","967","874","93","12","979","5076","0","19.29","17.22"
"09","020","00","020","0001","0070","158","145","13","2","160","895","0","17.88","16.20"
"09","020","00","020","0001","0071","185","164","21","5","190","994","0","19.11","16.50"
"09","020","00","020","0001","0072","301","274","27","2","303","1524","0","19.88","17.98"
"09","020","00","020","0001","0073","323","291","32","3","326","1663","0","19.60","17.50"
"09","020","00","020","0002","0000","335","302","33","8","343","1955","0","17.54","15.45"
"09","020","00","020","0002","0081","154","135","19","4","158","1033","0","15.30","13.07"
"09","020","00","020","0002","0082","181","167","14","4","185","922","0","20.07","18.11"
"09","020","00","020","0003","0000","216","197","19","4","220","1153","0","19.08","17.09"
"09","020","00","020","0003","0083","216","197","19","4","220","1153","0","19.08","17.09"
"09","020","00","020","0004","0000","437","375","62","4","441","2348","0","18.78","15.97"
"09","020","00","020","0004","0084","215","188","27","1","216","1251","0","17.27","15.03"
"09","020","00","020","0004","0085","222","187","35","3","225","1097","0","20.51","17.05"
"09","020","00","020","0005","0000","376","347","29","7","383","2045","0","18.73","16.97"
"09","020","00","020","0005","0074","178","165","13","3","181","960","0","18.85","17.19"
"09","020","00","020","0005","0075","198","182","16","4","202","1085","0","18.62","16.77"
"09","020","00","020","0006","0000","264","245","19","1","265","1592","0","16.65","15.39"
"09","020","00","020","0006","0078","264","245","19","1","265","1592","0","16.65","15.39"
"09","020","00","020","0007","0000","367","336","31","5","372","2210","0","16.83","15.20"
"09","020","00","020","0007","0079","226","211","15","2","228","1233","0","18.49","17.11"
"09","020","00","020","0007","0080","141","125","16","3","144","977","0","14.74","12.79"
"09","020","00","020","0008","0000","448","404","44","5","453","2345","0","19.32","17.23"
"09","020","00","020","0008","0076","246","219","27","2","248","1212","0","20.46","18.07"
"09","020","00","020","0008","0077","202","185","17","3","205","1133","0","18.09","16.33"
"09","020","00","030","0000","0000","5215","4522","693","76","5291","26724","30316","19.80","16.92"
"09","020","00","030","0001","0000","840","750","90","14","854","3969","0","21.52","18.90"
"09","020","00","030","0001","0052","292","256","36","6","298","1248","0","23.88","20.51"
"09","020","00","030","0001","0053","249","227","22","6","255","1260","0","20.24","18.02"
"09","020","00","030","0001","0054","299","267","32","2","301","1461","0","20.60","18.28"
"09","020","00","030","0002","0000","655","572","83","15","670","3328","0","20.13","17.19"
"09","020","00","030","0002","0055","378","331","47","7","385","1882","0","20.46","17.59"
"09","020","00","030","0002","0056","277","241","36","8","285","1446","0","19.71","16.67"
"09","020","00","030","0003","0000","514","452","62","12","526","2699","0","19.49","16.75"
"09","020","00","030","0003","0066","203","172","31","2","205","1279","0","16.03","13.45"
"09","020","00","030","0003","0067","311","280","31","10","321","1420","0","22.61","19.72"
"09","020","00","030","0004","0000","424","362","62","5","429","2132","0","20.12","16.98"
"09","020","00","030","0004","0059","199","182","17","3","202","1061","0","19.04","17.15"
"09","020","00","030","0004","0060","225","180","45","2","227","1071","0","21.20","16.81"
"09","020","00","030","0005","0000","653","566","87","10","663","3259","0","20.34","17.37"
"09","020","00","030","0005","0068","327","280","47","5","332","1652","0","20.10","16.95"
"09","020","00","030","0005","0069","326","286","40","5","331","1607","0","20.60","17.80"
"09","020","00","030","0006","0000","1539","1286","253","10","1549","8073","0","19.19","15.93"
"09","020","00","030","0006","0061","392","316","76","1","393","2006","0","19.59","15.75"
"09","020","00","030","0006","0062","294","259","35","1","295","1672","0","17.64","15.49"
"09","020","00","030","0006","0063","278","239","39","3","281","1459","0","19.26","16.38"
"09","020","00","030","0006","0064","279","231","48","3","282","1502","0","18.77","15.38"
"09","020","00","030","0006","0065","296","241","55","2","298","1434","0","20.78","16.81"
"09","020","00","030","0007","0000","236","218","18","6","242","1560","0","15.51","13.97"
"09","020","00","030","0007","0057","236","218","18","6","242","1560","0","15.51","13.97"
"09","020","00","030","0008","0000","354","316","38","4","358","1704","0","21.01","18.54"
"09","020","00","030","0008","0058","354","316","38","4","358","1704","0","21.01","18.54"
"09","020","00","040","0000","0000","5335","4354","981","59","5394","29252","32749","18.44","14.88"
"09","020","00","040","0001","0000","479","411","68","4","483","3363","0","14.36","12.22"
"09","020","00","040","0001","0025","268","231","37","2","270","1783","0","15.14","12.96"
"09","020","00","040","0001","0026","211","180","31","2","213","1580","0","13.48","11.39"
"09","020","00","040","0002","0000","822","702","120","17","839","5049","0","16.62","13.90"
"09","020","00","040","0002","0027","327","262","65","3","330","2119","0","15.57","12.36"
"09","020","00","040","0002","0028","171","151","20","3","174","1014","0","17.16","14.89"
"09","020","00","040","0002","0029","324","289","35","11","335","1916","0","17.48","15.08"
"09","020","00","040","0003","0000","301","263","38","4","305","1618","0","18.85","16.25"
"09","020","00","040","0003","0041","301","263","38","4","305","1618","0","18.85","16.25"
"09","020","00","040","0004","0000","1523","1228","295","12","1535","7551","0","20.33","16.26"
"09","020","00","040","0004","0030","342","293","49","5","347","1878","0","18.48","15.60"
"09","020","00","040","0004","0031","431","277","154","4","435","1865","0","23.32","14.85"
"09","020","00","040","0004","0032","390","340","50","1","391","1872","0","20.89","18.16"
"09","020","00","040","0004","0033","360","318","42","2","362","1936","0","18.70","16.43"
"09","020","00","040","0005","0000","927","800","127","12","939","5268","0","17.82","15.19"
"09","020","00","040","0005","0034","351","294","57","8","359","1933","0","18.57","15.21"
"09","020","00","040","0005","0035","286","255","31","1","287","1816","0","15.80","14.04"
"09","020","00","040","0005","0036","290","251","39","3","293","1519","0","19.29","16.52"
"09","020","00","040","0006","0000","1283","950","333","10","1293","6403","0","20.19","14.84"
"09","020","00","040","0006","0037","293","254","39","4","297","1570","0","18.92","16.18"
"09","020","00","040","0006","0038","313","273","40","3","316","1874","0","16.86","14.57"
"09","020","00","040","0006","0039","450","231","219","2","452","1681","0","26.89","13.74"
"09","020","00","040","0006","0040","227","192","35","1","228","1278","0","17.84","15.02"
"09","020","00","050","0000","0000","1822","1656","166","32","1854","11656","12646","15.91","14.21"
"09","020","00","050","0001","0000","456","422","34","9","465","2843","0","16.36","14.84"
"09","020","00","050","0001","0048","242","231","11","3","245","1411","0","17.36","16.37"
"09","020","00","050","0001","0049","214","191","23","6","220","1432","0","15.36","13.34"
"09","020","00","050","0002","0000","184","168","16","6","190","1428","0","13.31","11.76"
"09","020","00","050","0002","0047","184","168","16","6","190","1428","0","13.31","11.76"
"09","020","00","050","0003","0000","342","300","42","9","351","2415","0","14.53","12.42"
"09","020","00","050","0003","0045","165","142","23","7","172","1285","0","13.39","11.05"
"09","020","00","050","0003","0046","177","158","19","2","179","1130","0","15.84","13.98"
"09","020","00","050","0004","0000","611","553","58","5","616","3328","0","18.51","16.62"
"09","020","00","050","0004","0042","298","279","19","4","302","1601","0","18.86","17.43"
"09","020","00","050","0004","0043","313","274","39","1","314","1727","0","18.18","15.87"
"09","020","00","050","0005","0000","229","213","16","3","232","1642","0","14.13","12.97"
"09","020","00","050","0005","0044","229","213","16","3","232","1642","0","14.13","12.97"
"09","020","00","060","0000","0000","37","30","7","0","37","569","661","6.50","5.27"
"09","020","00","060","0001","0000","19","15","4","0","19","270","0","7.04","5.56"
"09","020","00","060","0001","0050","19","15","4","0","19","270","0","7.04","5.56"
"09","020","00","060","0002","0000","18","15","3","0","18","299","0","6.02","5.02"
"09","020","00","060","0002","0051","18","15","3","0","18","299","0","6.02","5.02"
"09","007","00","000","0000","0000","3089","2676","413","29","3118","11673","13449","26.71","22.92"
"09","007","00","010","0000","0000","1883","1632","251","17","1900","6505","7644","29.21","25.09"
"09","007","00","010","0001","0000","646","567","79","6","652","1982","0","32.90","28.61"
"09","007","00","010","0001","0001","327","288","39","4","331","1041","0","31.80","27.67"
"09","007","00","010","0001","0002","319","279","40","2","321","941","0","34.11","29.65"
"09","007","00","010","0010","0000","466","399","67","7","473","1682","0","28.12","23.72"
"09","007","00","010","0010","0003","466","399","67","7","473","1682","0","28.12","23.72"
"09","007","00","010","0011","0000","333","279","54","1","334","1223","0","27.31","22.81"
"09","007","00","010","0011","0004","333","279","54","1","334","1223","0","27.31","22.81"
"09","007","00","010","0012","0000","438","387","51","3","441","1618","0","27.26","23.92"
"09","007","00","010","0012","0005","438","387","51","3","441","1618","0","27.26","23.92"
"09","007","00","020","0000","0000","616","528","88","8","624","2537","2846","24.60","20.81"
"09","007","00","020","0007","0000","331","279","52","4","335","1310","0","25.57","21.30"
"09","007","00","020","0007","0006","331","279","52","4","335","1310","0","25.57","21.30"
"09","007","00","020","0008","0000","285","249","36","4","289","1227","0","23.55","20.29"
"09","007","00","020","0008","0007","285","249","36","4","289","1227","0","23.55","20.29"
"09","007","00","030","0000","0000","297","258","39","2","299","1363","1496","21.94","18.93"
"09","007","00","030","0006","0000","157","132","25","1","158","668","0","23.65","19.76"
"09","007","00","030","0006","0008","157","132","25","1","158","668","0","23.65","19.76"
"09","007","00","030","0007","0000","140","126","14","1","141","695","0","20.29","18.13"
"09","007","00","030","0007","0009","140","126","14","1","141","695","0","20.29","18.13"
"09","007","00","040","0000","0000","293","258","35","2","295","1268","1463","23.26","20.35"
"09","007","00","040","0003","0000","293","258","35","2","295","1268","0","23.26","20.35"
"09","007","00","040","0003","0010","293","258","35","2","295","1268","0","23.26","20.35"
