"prv_code","city_code","area_code","dept_code","li_code","tbox_no","valid_ticket","agree_ticket","disagree_ticket","invalid_ticket","vote_ticket","votable_population","population","vote_to_votable","agree_to_votable"
"00","000","00","000","0000","0000","10663529","5647102","5016427","682403","11345932","19239392","23212056","58.97","29.35"
"63","000","00","000","0000","0000","1284407","659798","624609","54613","1339020","2031146","2465610","65.92","32.48"
"63","000","00","010","0000","0000","99216","49397","49819","3672","102888","151284","187993","68.01","32.65"
"63","000","00","010","0002","0000","2624","1292","1332","130","2754","4229","0","65.12","30.55"
"63","000","00","010","0002","0596","652","312","340","39","691","1020","0","67.75","30.59"
"63","000","00","010","0002","0597","679","344","335","30","709","1068","0","66.39","32.21"
"63","000","00","010","0002","0598","704","351","353","31","735","1115","0","65.92","31.48"
"63","000","00","010","0002","0599","589","285","304","30","619","1026","0","60.33","27.78"
"63","000","00","010","0003","0000","4026","2087","1939","130","4156","6017","0","69.07","34.69"
"63","000","00","010","0003","0600","813","383","430","24","837","1191","0","70.28","32.16"
"63","000","00","010","0003","0601","785","376","409","29","814","1229","0","66.23","30.59"
"63","000","00","010","0003","0602","792","445","347","33","825","1187","0","69.50","37.49"
"63","000","00","010","0003","0603","811","442","369","20","831","1181","0","70.36","37.43"
"63","000","00","010","0003","0604","825","441","384","24","849","1229","0","69.08","35.88"
"63","000","00","010","0004","0000","3443","1727","1716","124","3567","5207","0","68.50","33.17"
"63","000","00","010","0004","0605","692","397","295","25","717","1006","0","71.27","39.46"
"63","000","00","010","0004","0606","693","316","377","18","711","1033","0","68.83","30.59"
"63","000","00","010","0004","0607","767","351","416","25","792","1170","0","67.69","30.00"
"63","000","00","010","0004","0608","649","314","335","25","674","1012","0","66.60","31.03"
"63","000","00","010","0004","0609","642","349","293","31","673","986","0","68.26","35.40"
"63","000","00","010","0005","0000","2504","1262","1242","101","2605","3640","0","71.57","34.67"
"63","000","00","010","0005","0610","840","391","449","45","885","1212","0","73.02","32.26"
"63","000","00","010","0005","0611","855","464","391","23","878","1261","0","69.63","36.80"
"63","000","00","010","0005","0612","809","407","402","33","842","1167","0","72.15","34.88"
"63","000","00","010","0006","0000","2678","1327","1351","86","2764","4013","0","68.88","33.07"
"63","000","00","010","0006","0613","652","340","312","28","680","966","0","70.39","35.20"
"63","000","00","010","0006","0614","770","366","404","17","787","1111","0","70.84","32.94"
"63","000","00","010","0006","0615","653","317","336","19","672","1008","0","66.67","31.45"
"63","000","00","010","0006","0616","603","304","299","22","625","928","0","67.35","32.76"
"63","000","00","010","0007","0000","2565","1249","1316","121","2686","3889","0","69.07","32.12"
"63","000","00","010","0007","0617","674","304","370","29","703","1030","0","68.25","29.51"
"63","000","00","010","0007","0618","633","310","323","34","667","952","0","70.06","32.56"
"63","000","00","010","0007","0619","649","327","322","30","679","943","0","72.00","34.68"
"63","000","00","010","0007","0620","609","308","301","28","637","964","0","66.08","31.95"
"63","000","00","010","0008","0000","2361","1085","1276","86","2447","3552","0","68.89","30.55"
"63","000","00","010","0008","0621","754","375","379","40","794","1138","0","69.77","32.95"
"63","000","00","010","0008","0622","866","388","478","25","891","1271","0","70.10","30.53"
"63","000","00","010","0008","0623","741","322","419","21","762","1143","0","66.67","28.17"
"63","000","00","010","0009","0000","2256","1165","1091","71","2327","3302","0","70.47","35.28"
"63","000","00","010","0009","0624","761","408","353","16","777","1105","0","70.32","36.92"
"63","000","00","010","0009","0625","715","359","356","27","742","1059","0","70.07","33.90"
"63","000","00","010","0009","0626","780","398","382","28","808","1138","0","71.00","34.97"
"63","000","00","010","0010","0000","2204","1103","1101","67","2271","3264","0","69.58","33.79"
"63","000","00","010","0010","0627","716","366","350","25","741","1074","0","68.99","34.08"
"63","000","00","010","0010","0628","778","388","390","22","800","1148","0","69.69","33.80"
"63","000","00","010","0010","0629","710","349","361","20","730","1042","0","70.06","33.49"
"63","000","00","010","0011","0000","3652","1713","1939","129","3781","5513","0","68.58","31.07"
"63","000","00","010","0011","0630","625","293","332","11","636","913","0","69.66","32.09"
"63","000","00","010","0011","0631","605","302","303","15","620","935","0","66.31","32.30"
"63","000","00","010","0011","0632","618","282","336","23","641","925","0","69.30","30.49"
"63","000","00","010","0011","0633","625","324","301","24","649","923","0","70.31","35.10"
"63","000","00","010","0011","0634","566","226","340","36","602","903","0","66.67","25.03"
"63","000","00","010","0011","0635","613","286","327","20","633","914","0","69.26","31.29"
"63","000","00","010","0012","0000","5284","2270","3014","135","5419","7840","0","69.12","28.95"
"63","000","00","010","0012","0636","789","271","518","17","806","1098","0","73.41","24.68"
"63","000","00","010","0012","0637","836","432","404","27","863","1214","0","71.09","35.58"
"63","000","00","010","0012","0638","772","376","396","17","789","1126","0","70.07","33.39"
"63","000","00","010","0012","0639","676","277","399","15","691","1089","0","63.45","25.44"
"63","000","00","010","0012","0640","729","231","498","25","754","1120","0","67.32","20.63"
"63","000","00","010","0012","0641","769","344","425","15","784","1119","0","70.06","30.74"
"63","000","00","010","0012","0642","713","339","374","19","732","1074","0","68.16","31.56"
"63","000","00","010","0013","0000","1357","706","651","44","1401","1982","0","70.69","35.62"
"63","000","00","010","0013","0643","670","360","310","25","695","994","0","69.92","36.22"
"63","000","00","010","0013","0644","687","346","341","19","706","988","0","71.46","35.02"
"63","000","00","010","0014","0000","2177","1144","1033","82","2259","3226","0","70.02","35.46"
"63","000","00","010","0014","0645","724","382","342","24","748","1067","0","70.10","35.80"
"63","000","00","010","0014","0646","684","362","322","30","714","1021","0","69.93","35.46"
"63","000","00","010","0014","0647","769","400","369","28","797","1138","0","70.04","35.15"
"63","000","00","010","0015","0000","3150","1494","1656","96","3246","4742","0","68.45","31.51"
"63","000","00","010","0015","0648","820","387","433","32","852","1218","0","69.95","31.77"
"63","000","00","010","0015","0649","776","312","464","18","794","1156","0","68.69","26.99"
"63","000","00","010","0015","0650","728","409","319","26","754","1080","0","69.81","37.87"
"63","000","00","010","0015","0651","826","386","440","20","846","1288","0","65.68","29.97"
"63","000","00","010","0016","0000","4704","2552","2152","123","4827","6787","0","71.12","37.60"
"63","000","00","010","0016","0652","857","478","379","14","871","1182","0","73.69","40.44"
"63","000","00","010","0016","0653","824","452","372","26","850","1171","0","72.59","38.60"
"63","000","00","010","0016","0654","739","393","346","20","759","1060","0","71.60","37.08"
"63","000","00","010","0016","0655","768","405","363","28","796","1148","0","69.34","35.28"
"63","000","00","010","0016","0656","794","433","361","24","818","1140","0","71.75","37.98"
"63","000","00","010","0016","0657","722","391","331","11","733","1086","0","67.50","36.00"
"63","000","00","010","0017","0000","3311","1568","1743","127","3438","4961","0","69.30","31.61"
"63","000","00","010","0017","0658","768","372","396","29","797","1234","0","64.59","30.15"
"63","000","00","010","0017","0659","881","388","493","36","917","1288","0","71.20","30.12"
"63","000","00","010","0017","0660","811","397","414","40","851","1214","0","70.10","32.70"
"63","000","00","010","0017","0661","851","411","440","22","873","1225","0","71.27","33.55"
"63","000","00","010","0018","0000","3640","2040","1600","172","3812","6768","0","56.32","30.14"
"63","000","00","010","0018","0680","923","507","416","40","963","1412","0","68.20","35.91"
"63","000","00","010","0018","0681","665","402","263","38","703","1119","0","62.82","35.92"
"63","000","00","010","0018","0682","753","394","359","28","781","1208","0","64.65","32.62"
"63","000","00","010","0018","0683","614","359","255","32","646","980","0","65.92","36.63"
"63","000","00","010","0018","0684","685","378","307","34","719","2049","0","35.09","18.45"
"63","000","00","010","0019","0000","4393","2273","2120","205","4598","6805","0","67.57","33.40"
"63","000","00","010","0019","0665","983","472","511","43","1026","1451","0","70.71","32.53"
"63","000","00","010","0019","0666","842","439","403","27","869","1308","0","66.44","33.56"
"63","000","00","010","0019","0667","917","459","458","54","971","1411","0","68.82","32.53"
"63","000","00","010","0019","0668","883","499","384","42","925","1425","0","64.91","35.02"
"63","000","00","010","0019","0669","768","404","364","39","807","1210","0","66.69","33.39"
"63","000","00","010","0020","0000","2669","1254","1415","106","2775","4093","0","67.80","30.64"
"63","000","00","010","0020","0670","470","212","258","18","488","763","0","63.96","27.79"
"63","000","00","010","0020","0671","721","337","384","39","760","1125","0","67.56","29.96"
"63","000","00","010","0020","0672","821","409","412","25","846","1156","0","73.18","35.38"
"63","000","00","010","0020","0673","657","296","361","24","681","1049","0","64.92","28.22"
"63","000","00","010","0021","0000","4685","1761","2924","205","4890","7078","0","69.09","24.88"
"63","000","00","010","0021","0674","885","358","527","31","916","1312","0","69.82","27.29"
"63","000","00","010","0021","0675","798","288","510","31","829","1212","0","68.40","23.76"
"63","000","00","010","0021","0676","716","284","432","37","753","1100","0","68.45","25.82"
"63","000","00","010","0021","0677","672","293","379","41","713","1056","0","67.52","27.75"
"63","000","00","010","0021","0678","799","331","468","25","824","1212","0","67.99","27.31"
"63","000","00","010","0021","0679","815","207","608","40","855","1186","0","72.09","17.45"
"63","000","00","010","0022","0000","4159","2060","2099","182","4341","6441","0","67.40","31.98"
"63","000","00","010","0022","0685","708","399","309","38","746","1184","0","63.01","33.70"
"63","000","00","010","0022","0686","722","344","378","39","761","1084","0","70.20","31.73"
"63","000","00","010","0022","0687","652","347","305","22","674","1004","0","67.13","34.56"
"63","000","00","010","0022","0688","707","300","407","25","732","1082","0","67.65","27.73"
"63","000","00","010","0022","0689","663","330","333","28","691","1018","0","67.88","32.42"
"63","000","00","010","0022","0690","707","340","367","30","737","1069","0","68.94","31.81"
"63","000","00","010","0024","0000","4034","2090","1944","158","4192","6279","0","66.76","33.29"
"63","000","00","010","0024","0691","797","402","395","46","843","1298","0","64.95","30.97"
"63","000","00","010","0024","0692","860","451","409","34","894","1296","0","68.98","34.80"
"63","000","00","010","0024","0693","776","398","378","27","803","1195","0","67.20","33.31"
"63","000","00","010","0024","0694","822","440","382","16","838","1256","0","66.72","35.03"
"63","000","00","010","0024","0695","779","399","380","35","814","1234","0","65.96","32.33"
"63","000","00","010","0025","0000","3351","1545","1806","142","3493","4926","0","70.91","31.36"
"63","000","00","010","0025","0696","918","403","515","25","943","1317","0","71.60","30.60"
"63","000","00","010","0025","0697","874","381","493","45","919","1263","0","72.76","30.17"
"63","000","00","010","0025","0698","837","413","424","36","873","1257","0","69.45","32.86"
"63","000","00","010","0025","0699","722","348","374","36","758","1089","0","69.61","31.96"
"63","000","00","010","0026","0000","4473","2431","2042","147","4620","7114","0","64.94","34.17"
"63","000","00","010","0026","0700","754","411","343","26","780","1264","0","61.71","32.52"
"63","000","00","010","0026","0701","821","469","352","25","846","1223","0","69.17","38.35"
"63","000","00","010","0026","0702","704","374","330","25","729","1160","0","62.84","32.24"
"63","000","00","010","0026","0703","786","415","371","22","808","1255","0","64.38","33.07"
"63","000","00","010","0026","0704","809","447","362","31","840","1241","0","67.69","36.02"
"63","000","00","010","0026","0705","599","315","284","18","617","971","0","63.54","32.44"
"63","000","00","010","0027","0000","2040","1072","968","66","2106","3108","0","67.76","34.49"
"63","000","00","010","0027","0706","734","359","375","23","757","1127","0","67.17","31.85"
"63","000","00","010","0027","0707","755","402","353","25","780","1120","0","69.64","35.89"
"63","000","00","010","0027","0708","551","311","240","18","569","861","0","66.09","36.12"
"63","000","00","010","0028","0000","1704","900","804","74","1778","2588","0","68.70","34.78"
"63","000","00","010","0028","0709","518","284","234","19","537","837","0","64.16","33.93"
"63","000","00","010","0028","0710","600","309","291","25","625","902","0","69.29","34.26"
"63","000","00","010","0028","0711","586","307","279","30","616","849","0","72.56","36.16"
"63","000","00","010","0029","0000","1931","1009","922","81","2012","2961","0","67.95","34.08"
"63","000","00","010","0029","0712","693","377","316","36","729","1090","0","66.88","34.59"
"63","000","00","010","0029","0713","605","312","293","20","625","897","0","69.68","34.78"
"63","000","00","010","0029","0714","633","320","313","25","658","974","0","67.56","32.85"
"63","000","00","010","0030","0000","3487","1858","1629","117","3604","5164","0","69.79","35.98"
"63","000","00","010","0030","0715","815","424","391","22","837","1190","0","70.34","35.63"
"63","000","00","010","0030","0716","802","437","365","24","826","1252","0","65.97","34.90"
"63","000","00","010","0030","0717","937","488","449","24","961","1362","0","70.56","35.83"
"63","000","00","010","0030","0718","933","509","424","47","980","1360","0","72.06","37.43"
"63","000","00","010","0031","0000","1715","867","848","59","1774","2577","0","68.84","33.64"
"63","000","00","010","0031","0719","902","454","448","31","933","1358","0","68.70","33.43"
"63","000","00","010","0031","0720","813","413","400","28","841","1219","0","68.99","33.88"
"63","000","00","010","0032","0000","2322","1143","1179","72","2394","3483","0","68.73","32.82"
"63","000","00","010","0032","0721","802","364","438","35","837","1225","0","68.33","29.71"
"63","000","00","010","0032","0722","826","436","390","20","846","1249","0","67.73","34.91"
"63","000","00","010","0032","0723","694","343","351","17","711","1009","0","70.47","33.99"
"63","000","00","010","0033","0000","3166","1658","1508","100","3266","4928","0","66.27","33.64"
"63","000","00","010","0033","0724","782","454","328","20","802","1310","0","61.22","34.66"
"63","000","00","010","0033","0725","753","365","388","29","782","1118","0","69.95","32.65"
"63","000","00","010","0033","0726","804","424","380","24","828","1235","0","67.04","34.33"
"63","000","00","010","0033","0727","827","415","412","27","854","1265","0","67.51","32.81"
"63","000","00","010","0034","0000","1297","681","616","56","1353","1984","0","68.20","34.32"
"63","000","00","010","0034","0728","715","368","347","19","734","1064","0","68.98","34.59"
"63","000","00","010","0034","0729","582","313","269","37","619","920","0","67.28","34.02"
"63","000","00","010","0035","0000","1854","1011","843","78","1932","2823","0","68.44","35.81"
"63","000","00","010","0035","0662","682","369","313","23","705","993","0","71.00","37.16"
"63","000","00","010","0035","0663","572","303","269","28","600","877","0","68.42","34.55"
"63","000","00","010","0035","0664","600","339","261","27","627","953","0","65.79","35.57"
"63","000","00","020","0000","0000","107253","52635","54618","4974","112227","171292","202368","65.52","30.73"
"63","000","00","020","0001","0000","2508","961","1547","115","2623","4634","0","56.60","20.74"
"63","000","00","020","0001","0730","625","237","388","29","654","918","0","71.24","25.82"
"63","000","00","020","0001","0731","653","261","392","28","681","1983","0","34.34","13.16"
"63","000","00","020","0001","0732","662","222","440","26","688","892","0","77.13","24.89"
"63","000","00","020","0001","0733","568","241","327","32","600","841","0","71.34","28.66"
"63","000","00","020","0002","0000","2345","1091","1254","87","2432","3446","0","70.57","31.66"
"63","000","00","020","0002","0734","792","357","435","24","816","1161","0","70.28","30.75"
"63","000","00","020","0002","0735","804","378","426","44","848","1158","0","73.23","32.64"
"63","000","00","020","0002","0736","749","356","393","19","768","1127","0","68.15","31.59"
"63","000","00","020","0003","0000","1233","550","683","63","1296","2017","0","64.25","27.27"
"63","000","00","020","0003","0737","485","208","277","41","526","836","0","62.92","24.88"
"63","000","00","020","0003","0738","748","342","406","22","770","1181","0","65.20","28.96"
"63","000","00","020","0004","0000","1611","811","800","54","1665","2617","0","63.62","30.99"
"63","000","00","020","0004","0739","465","240","225","14","479","748","0","64.04","32.09"
"63","000","00","020","0004","0740","612","318","294","24","636","993","0","64.05","32.02"
"63","000","00","020","0004","0741","534","253","281","16","550","876","0","62.79","28.88"
"63","000","00","020","0005","0000","1619","727","892","61","1680","2526","0","66.51","28.78"
"63","000","00","020","0005","0742","568","239","329","23","591","886","0","66.70","26.98"
"63","000","00","020","0005","0743","496","237","259","18","514","785","0","65.48","30.19"
"63","000","00","020","0005","0744","555","251","304","20","575","855","0","67.25","29.36"
"63","000","00","020","0006","0000","2754","1388","1366","132","2886","4425","0","65.22","31.37"
"63","000","00","020","0006","0745","674","319","355","14","688","1067","0","64.48","29.90"
"63","000","00","020","0006","0746","648","309","339","29","677","1074","0","63.04","28.77"
"63","000","00","020","0006","0747","829","451","378","51","880","1254","0","70.18","35.96"
"63","000","00","020","0006","0748","603","309","294","38","641","1030","0","62.23","30.00"
"63","000","00","020","0007","0000","2546","1288","1258","104","2650","4090","0","64.79","31.49"
"63","000","00","020","0007","0749","594","295","299","28","622","929","0","66.95","31.75"
"63","000","00","020","0007","0750","699","341","358","26","725","1132","0","64.05","30.12"
"63","000","00","020","0007","0751","637","311","326","28","665","1052","0","63.21","29.56"
"63","000","00","020","0007","0752","616","341","275","22","638","977","0","65.30","34.90"
"63","000","00","020","0008","0000","3799","1880","1919","154","3953","5853","0","67.54","32.12"
"63","000","00","020","0008","0753","670","324","346","33","703","1047","0","67.14","30.95"
"63","000","00","020","0008","0754","602","299","303","24","626","943","0","66.38","31.71"
"63","000","00","020","0008","0755","623","304","319","20","643","956","0","67.26","31.80"
"63","000","00","020","0008","0756","692","329","363","31","723","1034","0","69.92","31.82"
"63","000","00","020","0008","0757","642","326","316","21","663","966","0","68.63","33.75"
"63","000","00","020","0008","0758","570","298","272","25","595","907","0","65.60","32.86"
"63","000","00","020","0009","0000","5017","2416","2601","182","5199","7890","0","65.89","30.62"
"63","000","00","020","0009","0759","828","436","392","33","861","1248","0","68.99","34.94"
"63","000","00","020","0009","0760","747","386","361","30","777","1162","0","66.87","33.22"
"63","000","00","020","0009","0761","655","307","348","23","678","984","0","68.90","31.20"
"63","000","00","020","0009","0762","615","280","335","37","652","913","0","71.41","30.67"
"63","000","00","020","0009","0763","654","286","368","26","680","1070","0","63.55","26.73"
"63","000","00","020","0009","0764","745","352","393","15","760","1250","0","60.80","28.16"
"63","000","00","020","0009","0765","773","369","404","18","791","1263","0","62.63","29.22"
"63","000","00","020","0010","0000","1878","1002","876","99","1977","2906","0","68.03","34.48"
"63","000","00","020","0010","0766","697","358","339","38","735","1072","0","68.56","33.40"
"63","000","00","020","0010","0767","546","298","248","22","568","868","0","65.44","34.33"
"63","000","00","020","0010","0768","635","346","289","39","674","966","0","69.77","35.82"
"63","000","00","020","0011","0000","2675","1403","1272","136","2811","4055","0","69.32","34.60"
"63","000","00","020","0011","0769","650","372","278","38","688","1019","0","67.52","36.51"
"63","000","00","020","0011","0770","689","365","324","31","720","1008","0","71.43","36.21"
"63","000","00","020","0011","0771","680","333","347","31","711","1005","0","70.75","33.13"
"63","000","00","020","0011","0772","656","333","323","36","692","1023","0","67.64","32.55"
"63","000","00","020","0012","0000","1833","925","908","100","1933","2914","0","66.33","31.74"
"63","000","00","020","0012","0773","581","295","286","31","612","960","0","63.75","30.73"
"63","000","00","020","0012","0774","590","310","280","47","637","952","0","66.91","32.56"
"63","000","00","020","0012","0775","662","320","342","22","684","1002","0","68.26","31.94"
"63","000","00","020","0013","0000","2536","1354","1182","138","2674","3893","0","68.69","34.78"
"63","000","00","020","0013","0776","592","308","284","32","624","895","0","69.72","34.41"
"63","000","00","020","0013","0777","694","378","316","30","724","1038","0","69.75","36.42"
"63","000","00","020","0013","0778","537","301","236","35","572","871","0","65.67","34.56"
"63","000","00","020","0013","0779","713","367","346","41","754","1089","0","69.24","33.70"
"63","000","00","020","0014","0000","1907","1099","808","117","2024","3190","0","63.45","34.45"
"63","000","00","020","0014","0780","602","327","275","20","622","1052","0","59.13","31.08"
"63","000","00","020","0014","0781","598","341","257","39","637","959","0","66.42","35.56"
"63","000","00","020","0014","0782","707","431","276","58","765","1179","0","64.89","36.56"
"63","000","00","020","0015","0000","2168","1151","1017","149","2317","3490","0","66.39","32.98"
"63","000","00","020","0015","0783","757","401","356","60","817","1189","0","68.71","33.73"
"63","000","00","020","0015","0784","642","320","322","35","677","1095","0","61.83","29.22"
"63","000","00","020","0015","0785","769","430","339","54","823","1206","0","68.24","35.66"
"63","000","00","020","0016","0000","2967","1575","1392","162","3129","4484","0","69.78","35.12"
"63","000","00","020","0016","0786","698","399","299","44","742","1068","0","69.48","37.36"
"63","000","00","020","0016","0787","737","399","338","42","779","1099","0","70.88","36.31"
"63","000","00","020","0016","0788","781","395","386","34","815","1138","0","71.62","34.71"
"63","000","00","020","0016","0789","751","382","369","42","793","1179","0","67.26","32.40"
"63","000","00","020","0017","0000","2732","1328","1404","119","2851","4279","0","66.63","31.04"
"63","000","00","020","0017","0790","579","298","281","29","608","928","0","65.52","32.11"
"63","000","00","020","0017","0791","735","351","384","27","762","1116","0","68.28","31.45"
"63","000","00","020","0017","0792","730","354","376","15","745","1090","0","68.35","32.48"
"63","000","00","020","0017","0793","688","325","363","48","736","1145","0","64.28","28.38"
"63","000","00","020","0018","0000","2516","1320","1196","103","2619","4003","0","65.43","32.98"
"63","000","00","020","0018","0794","598","294","304","20","618","923","0","66.96","31.85"
"63","000","00","020","0018","0795","721","370","351","42","763","1110","0","68.74","33.33"
"63","000","00","020","0018","0796","603","325","278","17","620","1007","0","61.57","32.27"
"63","000","00","020","0018","0797","594","331","263","24","618","963","0","64.17","34.37"
"63","000","00","020","0019","0000","2297","1026","1271","80","2377","3651","0","65.11","28.10"
"63","000","00","020","0019","0798","650","280","370","18","668","1103","0","60.56","25.39"
"63","000","00","020","0019","0799","776","361","415","33","809","1240","0","65.24","29.11"
"63","000","00","020","0019","0800","871","385","486","29","900","1308","0","68.81","29.43"
"63","000","00","020","0020","0000","3691","1836","1855","128","3819","5768","0","66.21","31.83"
"63","000","00","020","0020","0801","613","309","304","21","634","948","0","66.88","32.59"
"63","000","00","020","0020","0802","706","333","373","34","740","1081","0","68.46","30.80"
"63","000","00","020","0020","0803","547","297","250","13","560","907","0","61.74","32.75"
"63","000","00","020","0020","0804","601","275","326","15","616","931","0","66.17","29.54"
"63","000","00","020","0020","0805","651","339","312","14","665","925","0","71.89","36.65"
"63","000","00","020","0020","0806","573","283","290","31","604","976","0","61.89","29.00"
"63","000","00","020","0021","0000","1091","546","545","63","1154","1818","0","63.48","30.03"
"63","000","00","020","0021","0807","580","283","297","29","609","901","0","67.59","31.41"
"63","000","00","020","0021","0808","511","263","248","34","545","917","0","59.43","28.68"
"63","000","00","020","0022","0000","3289","1623","1666","134","3423","5255","0","65.14","30.88"
"63","000","00","020","0022","0809","622","319","303","27","649","1068","0","60.77","29.87"
"63","000","00","020","0022","0810","677","307","370","30","707","1038","0","68.11","29.58"
"63","000","00","020","0022","0811","686","332","354","23","709","1073","0","66.08","30.94"
"63","000","00","020","0022","0812","687","345","342","35","722","1056","0","68.37","32.67"
"63","000","00","020","0022","0813","617","320","297","19","636","1020","0","62.35","31.37"
"63","000","00","020","0023","0000","2435","1220","1215","100","2535","4009","0","63.23","30.43"
"63","000","00","020","0023","0814","573","284","289","32","605","964","0","62.76","29.46"
"63","000","00","020","0023","0815","624","295","329","33","657","1016","0","64.67","29.04"
"63","000","00","020","0023","0816","604","304","300","22","626","961","0","65.14","31.63"
"63","000","00","020","0023","0817","634","337","297","13","647","1068","0","60.58","31.55"
"63","000","00","020","0024","0000","2310","1168","1142","123","2433","3561","0","68.32","32.80"
"63","000","00","020","0024","0818","615","312","303","37","652","938","0","69.51","33.26"
"63","000","00","020","0024","0819","505","268","237","22","527","798","0","66.04","33.58"
"63","000","00","020","0024","0820","534","275","259","26","560","809","0","69.22","33.99"
"63","000","00","020","0024","0821","656","313","343","38","694","1016","0","68.31","30.81"
"63","000","00","020","0025","0000","3917","2044","1873","161","4078","6373","0","63.99","32.07"
"63","000","00","020","0025","0822","535","268","267","20","555","990","0","56.06","27.07"
"63","000","00","020","0025","0823","704","376","328","32","736","1100","0","66.91","34.18"
"63","000","00","020","0025","0824","576","314","262","12","588","973","0","60.43","32.27"
"63","000","00","020","0025","0825","616","309","307","40","656","1003","0","65.40","30.81"
"63","000","00","020","0025","0826","743","397","346","40","783","1113","0","70.35","35.67"
"63","000","00","020","0025","0827","743","380","363","17","760","1194","0","63.65","31.83"
"63","000","00","020","0026","0000","3212","1658","1554","138","3350","4889","0","68.52","33.91"
"63","000","00","020","0026","0828","677","349","328","27","704","1035","0","68.02","33.72"
"63","000","00","020","0026","0829","713","367","346","30","743","1092","0","68.04","33.61"
"63","000","00","020","0026","0830","601","291","310","28","629","922","0","68.22","31.56"
"63","000","00","020","0026","0831","550","298","252","26","576","853","0","67.53","34.94"
"63","000","00","020","0026","0832","671","353","318","27","698","987","0","70.72","35.76"
"63","000","00","020","0027","0000","2267","1207","1060","119","2386","3775","0","63.21","31.97"
"63","000","00","020","0027","0833","624","325","299","29","653","1091","0","59.85","29.79"
"63","000","00","020","0027","0834","675","352","323","35","710","1075","0","66.05","32.74"
"63","000","00","020","0027","0835","681","344","337","37","718","1127","0","63.71","30.52"
"63","000","00","020","0027","0836","287","186","101","18","305","482","0","63.28","38.59"
"63","000","00","020","0028","0000","2588","1163","1425","94","2682","3999","0","67.07","29.08"
"63","000","00","020","0028","0837","716","373","343","36","752","1085","0","69.31","34.38"
"63","000","00","020","0028","0838","643","286","357","15","658","939","0","70.07","30.46"
"63","000","00","020","0028","0839","593","263","330","16","609","961","0","63.37","27.37"
"63","000","00","020","0028","0840","636","241","395","27","663","1014","0","65.38","23.77"
"63","000","00","020","0029","0000","3218","1458","1760","148","3366","5201","0","64.72","28.03"
"63","000","00","020","0029","0841","582","261","321","28","610","960","0","63.54","27.19"
"63","000","00","020","0029","0842","592","277","315","43","635","965","0","65.80","28.70"
"63","000","00","020","0029","0843","668","303","365","42","710","1139","0","62.34","26.60"
"63","000","00","020","0029","0844","657","287","370","28","685","988","0","69.33","29.05"
"63","000","00","020","0029","0845","719","330","389","7","726","1149","0","63.19","28.72"
"63","000","00","020","0030","0000","4429","2049","2380","180","4609","6908","0","66.72","29.66"
"63","000","00","020","0030","0846","665","347","318","27","692","996","0","69.48","34.84"
"63","000","00","020","0030","0847","599","297","302","30","629","992","0","63.41","29.94"
"63","000","00","020","0030","0848","635","292","343","27","662","1004","0","65.94","29.08"
"63","000","00","020","0030","0849","629","281","348","28","657","979","0","67.11","28.70"
"63","000","00","020","0030","0850","689","310","379","21","710","1048","0","67.75","29.58"
"63","000","00","020","0030","0851","606","244","362","26","632","924","0","68.40","26.41"
"63","000","00","020","0030","0852","606","278","328","21","627","965","0","64.97","28.81"
"63","000","00","020","0031","0000","2433","1167","1266","90","2523","4176","0","60.42","27.95"
"63","000","00","020","0031","0853","608","291","317","38","646","1050","0","61.52","27.71"
"63","000","00","020","0031","0854","635","293","342","20","655","1092","0","59.98","26.83"
"63","000","00","020","0031","0855","627","294","333","17","644","1031","0","62.46","28.52"
"63","000","00","020","0031","0856","563","289","274","15","578","1003","0","57.63","28.81"
"63","000","00","020","0032","0000","3378","1542","1836","145","3523","5436","0","64.81","28.37"
"63","000","00","020","0032","0857","703","303","400","32","735","1049","0","70.07","28.88"
"63","000","00","020","0032","0858","692","313","379","32","724","1076","0","67.29","29.09"
"63","000","00","020","0032","0859","662","309","353","25","687","1129","0","60.85","27.37"
"63","000","00","020","0032","0860","575","269","306","24","599","990","0","60.51","27.17"
"63","000","00","020","0032","0861","746","348","398","32","778","1192","0","65.27","29.19"
"63","000","00","020","0033","0000","3682","1754","1928","209","3891","6251","0","62.25","28.06"
"63","000","00","020","0033","0862","450","211","239","30","480","823","0","58.32","25.64"
"63","000","00","020","0033","0863","615","300","315","47","662","1008","0","65.67","29.76"
"63","000","00","020","0033","0864","732","360","372","42","774","1177","0","65.76","30.59"
"63","000","00","020","0033","0865","612","293","319","27","639","1092","0","58.52","26.83"
"63","000","00","020","0033","0866","737","357","380","38","775","1181","0","65.62","30.23"
"63","000","00","020","0033","0867","536","233","303","25","561","970","0","57.84","24.02"
"63","000","00","020","0034","0000","2271","1140","1131","112","2383","3656","0","65.18","31.18"
"63","000","00","020","0034","0868","583","304","279","29","612","959","0","63.82","31.70"
"63","000","00","020","0034","0869","571","279","292","38","609","917","0","66.41","30.43"
"63","000","00","020","0034","0870","610","322","288","17","627","982","0","63.85","32.79"
"63","000","00","020","0034","0871","507","235","272","28","535","798","0","67.04","29.45"
"63","000","00","020","0035","0000","1815","868","947","113","1928","3101","0","62.17","27.99"
"63","000","00","020","0035","0872","565","284","281","31","596","954","0","62.47","29.77"
"63","000","00","020","0035","0873","603","308","295","39","642","1072","0","59.89","28.73"
"63","000","00","020","0035","0874","647","276","371","43","690","1075","0","64.19","25.67"
"63","000","00","020","0036","0000","3685","1759","1926","167","3852","5788","0","66.55","30.39"
"63","000","00","020","0036","0875","779","405","374","34","813","1173","0","69.31","34.53"
"63","000","00","020","0036","0876","720","309","411","39","759","1086","0","69.89","28.45"
"63","000","00","020","0036","0877","798","396","402","34","832","1285","0","64.75","30.82"
"63","000","00","020","0036","0878","728","328","400","29","757","1061","0","71.35","30.91"
"63","000","00","020","0036","0879","660","321","339","31","691","1183","0","58.41","27.13"
"63","000","00","020","0037","0000","1656","818","838","81","1737","2555","0","67.98","32.02"
"63","000","00","020","0037","0880","540","256","284","22","562","794","0","70.78","32.24"
"63","000","00","020","0037","0881","600","305","295","30","630","888","0","70.95","34.35"
"63","000","00","020","0037","0882","516","257","259","29","545","873","0","62.43","29.44"
"63","000","00","020","0038","0000","2025","966","1059","98","2123","3256","0","65.20","29.67"
"63","000","00","020","0038","0883","629","348","281","35","664","1147","0","57.89","30.34"
"63","000","00","020","0038","0884","702","316","386","24","726","1058","0","68.62","29.87"
"63","000","00","020","0038","0885","694","302","392","39","733","1051","0","69.74","28.73"
"63","000","00","020","0039","0000","3530","1679","1851","203","3733","5606","0","66.59","29.95"
"63","000","00","020","0039","0886","764","372","392","49","813","1158","0","70.21","32.12"
"63","000","00","020","0039","0887","703","332","371","31","734","1137","0","64.56","29.20"
"63","000","00","020","0039","0888","613","278","335","29","642","975","0","65.85","28.51"
"63","000","00","020","0039","0889","640","299","341","58","698","1074","0","64.99","27.84"
"63","000","00","020","0039","0890","810","398","412","36","846","1262","0","67.04","31.54"
"63","000","00","020","0040","0000","2516","1259","1257","131","2647","3943","0","67.13","31.93"
"63","000","00","020","0040","0891","647","328","319","31","678","1029","0","65.89","31.88"
"63","000","00","020","0040","0892","585","282","303","26","611","916","0","66.70","30.79"
"63","000","00","020","0040","0893","705","339","366","39","744","1073","0","69.34","31.59"
"63","000","00","020","0040","0894","579","310","269","35","614","925","0","66.38","33.51"
"63","000","00","020","0041","0000","874","416","458","82","956","1605","0","59.56","25.92"
"63","000","00","020","0041","0895","501","263","238","39","540","922","0","58.57","28.52"
"63","000","00","020","0041","0896","373","153","220","43","416","683","0","60.91","22.40"
"63","000","00","030","0000","0000","142292","69594","72698","5268","147560","223677","281411","65.97","31.11"
"63","000","00","030","0001","0000","2598","1232","1366","84","2682","4138","0","64.81","29.77"
"63","000","00","030","0001","1387","633","319","314","21","654","1024","0","63.87","31.15"
"63","000","00","030","0001","1388","588","293","295","20","608","992","0","61.29","29.54"
"63","000","00","030","0001","1389","682","316","366","25","707","1069","0","66.14","29.56"
"63","000","00","030","0001","1390","695","304","391","18","713","1053","0","67.71","28.87"
"63","000","00","030","0002","0000","2519","1340","1179","70","2589","3932","0","65.84","34.08"
"63","000","00","030","0002","1391","829","417","412","24","853","1327","0","64.28","31.42"
"63","000","00","030","0002","1392","753","419","334","15","768","1203","0","63.84","34.83"
"63","000","00","030","0002","1393","937","504","433","31","968","1402","0","69.04","35.95"
"63","000","00","030","0003","0000","3282","1604","1678","135","3417","5017","0","68.11","31.97"
"63","000","00","030","0003","1394","741","387","354","22","763","1134","0","67.28","34.13"
"63","000","00","030","0003","1395","898","481","417","36","934","1353","0","69.03","35.55"
"63","000","00","030","0003","1396","802","373","429","36","838","1232","0","68.02","30.28"
"63","000","00","030","0003","1397","841","363","478","41","882","1298","0","67.95","27.97"
"63","000","00","030","0004","0000","3907","2001","1906","137","4044","6077","0","66.55","32.93"
"63","000","00","030","0004","1398","700","379","321","23","723","1106","0","65.37","34.27"
"63","000","00","030","0004","1399","744","403","341","25","769","1129","0","68.11","35.70"
"63","000","00","030","0004","1400","849","475","374","31","880","1320","0","66.67","35.98"
"63","000","00","030","0004","1401","798","362","436","31","829","1242","0","66.75","29.15"
"63","000","00","030","0004","1402","816","382","434","27","843","1280","0","65.86","29.84"
"63","000","00","030","0005","0000","2287","1107","1180","72","2359","3753","0","62.86","29.50"
"63","000","00","030","0005","1403","624","335","289","22","646","1006","0","64.21","33.30"
"63","000","00","030","0005","1404","576","281","295","8","584","977","0","59.77","28.76"
"63","000","00","030","0005","1405","605","255","350","25","630","959","0","65.69","26.59"
"63","000","00","030","0005","1406","482","236","246","17","499","811","0","61.53","29.10"
"63","000","00","030","0006","0000","2767","1155","1612","82","2849","4292","0","66.38","26.91"
"63","000","00","030","0006","1407","549","197","352","11","560","830","0","67.47","23.73"
"63","000","00","030","0006","1408","784","354","430","16","800","1208","0","66.23","29.30"
"63","000","00","030","0006","1409","713","219","494","34","747","1114","0","67.06","19.66"
"63","000","00","030","0006","1410","721","385","336","21","742","1140","0","65.09","33.77"
"63","000","00","030","0007","0000","3272","1707","1565","114","3386","5232","0","64.72","32.63"
"63","000","00","030","0007","1411","864","445","419","35","899","1399","0","64.26","31.81"
"63","000","00","030","0007","1412","827","452","375","16","843","1261","0","66.85","35.84"
"63","000","00","030","0007","1413","892","470","422","15","907","1418","0","63.96","33.15"
"63","000","00","030","0007","1414","689","340","349","48","737","1154","0","63.86","29.46"
"63","000","00","030","0008","0000","1530","782","748","68","1598","2437","0","65.57","32.09"
"63","000","00","030","0008","1415","809","417","392","37","846","1317","0","64.24","31.66"
"63","000","00","030","0008","1416","721","365","356","31","752","1120","0","67.14","32.59"
"63","000","00","030","0009","0000","1920","953","967","90","2010","3094","0","64.96","30.80"
"63","000","00","030","0009","1417","681","329","352","36","717","1100","0","65.18","29.91"
"63","000","00","030","0009","1418","608","310","298","28","636","1013","0","62.78","30.60"
"63","000","00","030","0009","1419","631","314","317","26","657","981","0","66.97","32.01"
"63","000","00","030","0010","0000","3425","1764","1661","137","3562","5682","0","62.69","31.05"
"63","000","00","030","0010","1420","598","297","301","22","620","1058","0","58.60","28.07"
"63","000","00","030","0010","1421","801","408","393","29","830","1275","0","65.10","32.00"
"63","000","00","030","0010","1422","714","375","339","39","753","1129","0","66.70","33.22"
"63","000","00","030","0010","1423","645","347","298","23","668","1098","0","60.84","31.60"
"63","000","00","030","0010","1424","667","337","330","24","691","1122","0","61.59","30.04"
"63","000","00","030","0011","0000","2774","1367","1407","76","2850","4248","0","67.09","32.18"
"63","000","00","030","0011","1425","616","331","285","16","632","963","0","65.63","34.37"
"63","000","00","030","0011","1426","758","388","370","18","776","1150","0","67.48","33.74"
"63","000","00","030","0011","1427","771","389","382","31","802","1152","0","69.62","33.77"
"63","000","00","030","0011","1428","629","259","370","11","640","983","0","65.11","26.35"
"63","000","00","030","0012","0000","2363","1256","1107","69","2432","3749","0","64.87","33.50"
"63","000","00","030","0012","1429","740","396","344","22","762","1211","0","62.92","32.70"
"63","000","00","030","0012","1430","823","436","387","31","854","1290","0","66.20","33.80"
"63","000","00","030","0012","1431","800","424","376","16","816","1248","0","65.38","33.97"
"63","000","00","030","0013","0000","2190","1080","1110","68","2258","3253","0","69.41","33.20"
"63","000","00","030","0013","1432","685","346","339","25","710","1049","0","67.68","32.98"
"63","000","00","030","0013","1433","805","386","419","22","827","1187","0","69.67","32.52"
"63","000","00","030","0013","1434","700","348","352","21","721","1017","0","70.89","34.22"
"63","000","00","030","0014","0000","3688","1835","1853","155","3843","5718","0","67.21","32.09"
"63","000","00","030","0014","1435","704","352","352","34","738","1137","0","64.91","30.96"
"63","000","00","030","0014","1436","745","322","423","33","778","1140","0","68.25","28.25"
"63","000","00","030","0014","1437","773","387","386","29","802","1133","0","70.79","34.16"
"63","000","00","030","0014","1438","736","379","357","30","766","1145","0","66.90","33.10"
"63","000","00","030","0014","1439","730","395","335","29","759","1163","0","65.26","33.96"
"63","000","00","030","0015","0000","3083","1650","1433","107","3190","6126","0","52.07","26.93"
"63","000","00","030","0015","1440","678","364","314","29","707","2458","0","28.76","14.81"
"63","000","00","030","0015","1441","711","399","312","16","727","1125","0","64.62","35.47"
"63","000","00","030","0015","1442","808","413","395","28","836","1210","0","69.09","34.13"
"63","000","00","030","0015","1443","886","474","412","34","920","1333","0","69.02","35.56"
"63","000","00","030","0016","0000","2892","1475","1417","65","2957","4440","0","66.60","33.22"
"63","000","00","030","0016","1444","657","321","336","13","670","979","0","68.44","32.79"
"63","000","00","030","0016","1445","818","403","415","25","843","1219","0","69.16","33.06"
"63","000","00","030","0016","1446","706","347","359","15","721","1072","0","67.26","32.37"
"63","000","00","030","0016","1447","711","404","307","12","723","1170","0","61.79","34.53"
"63","000","00","030","0017","0000","2881","1507","1374","79","2960","4613","0","64.17","32.67"
"63","000","00","030","0017","1448","710","371","339","21","731","1161","0","62.96","31.96"
"63","000","00","030","0017","1449","715","358","357","18","733","1155","0","63.46","31.00"
"63","000","00","030","0017","1450","758","398","360","16","774","1190","0","65.04","33.45"
"63","000","00","030","0017","1451","698","380","318","24","722","1107","0","65.22","34.33"
"63","000","00","030","0018","0000","1805","840","965","57","1862","2751","0","67.68","30.53"
"63","000","00","030","0018","1452","582","279","303","16","598","898","0","66.59","31.07"
"63","000","00","030","0018","1453","592","255","337","18","610","884","0","69.00","28.85"
"63","000","00","030","0018","1454","631","306","325","23","654","969","0","67.49","31.58"
"63","000","00","030","0019","0000","1873","925","948","51","1924","2823","0","68.15","32.77"
"63","000","00","030","0019","1455","898","414","484","36","934","1385","0","67.44","29.89"
"63","000","00","030","0019","1456","975","511","464","15","990","1438","0","68.85","35.54"
"63","000","00","030","0020","0000","2089","1004","1085","64","2153","2810","0","76.62","35.73"
"63","000","00","030","0020","1457","925","411","514","29","954","1399","0","68.19","29.38"
"63","000","00","030","0020","1458","1164","593","571","35","1199","1411","0","84.98","42.03"
"63","000","00","030","0021","0000","2829","1415","1414","91","2920","4294","0","68.00","32.95"
"63","000","00","030","0021","1459","619","313","306","21","640","937","0","68.30","33.40"
"63","000","00","030","0021","1460","726","349","377","23","749","1056","0","70.93","33.05"
"63","000","00","030","0021","1461","742","389","353","17","759","1122","0","67.65","34.67"
"63","000","00","030","0021","1462","742","364","378","30","772","1179","0","65.48","30.87"
"63","000","00","030","0022","0000","3351","1594","1757","120","3471","5203","0","66.71","30.64"
"63","000","00","030","0022","1463","773","358","415","27","800","1236","0","64.72","28.96"
"63","000","00","030","0022","1464","871","429","442","48","919","1367","0","67.23","31.38"
"63","000","00","030","0022","1465","836","399","437","23","859","1282","0","67.00","31.12"
"63","000","00","030","0022","1466","871","408","463","22","893","1318","0","67.75","30.96"
"63","000","00","030","0023","0000","3454","1447","2007","109","3563","5128","0","69.48","28.22"
"63","000","00","030","0023","1467","832","390","442","14","846","1245","0","67.95","31.33"
"63","000","00","030","0023","1468","875","379","496","27","902","1296","0","69.60","29.24"
"63","000","00","030","0023","1469","845","359","486","18","863","1301","0","66.33","27.59"
"63","000","00","030","0023","1470","902","319","583","50","952","1286","0","74.03","24.81"
"63","000","00","030","0026","0000","1818","856","962","59","1877","2738","0","68.55","31.26"
"63","000","00","030","0026","1471","929","445","484","26","955","1449","0","65.91","30.71"
"63","000","00","030","0026","1472","889","411","478","33","922","1289","0","71.53","31.89"
"63","000","00","030","0027","0000","2304","1119","1185","81","2385","3586","0","66.51","31.20"
"63","000","00","030","0027","1473","784","371","413","21","805","1199","0","67.14","30.94"
"63","000","00","030","0027","1474","786","394","392","20","806","1195","0","67.45","32.97"
"63","000","00","030","0027","1475","734","354","380","40","774","1192","0","64.93","29.70"
"63","000","00","030","0028","0000","3340","1576","1764","127","3467","5010","0","69.20","31.46"
"63","000","00","030","0028","1476","826","415","411","30","856","1274","0","67.19","32.57"
"63","000","00","030","0028","1477","839","403","436","42","881","1279","0","68.88","31.51"
"63","000","00","030","0028","1478","838","384","454","21","859","1222","0","70.29","31.42"
"63","000","00","030","0028","1479","837","374","463","34","871","1235","0","70.53","30.28"
"63","000","00","030","0029","0000","2265","1101","1164","111","2376","3944","0","60.24","27.92"
"63","000","00","030","0029","1480","791","412","379","24","815","1347","0","60.50","30.59"
"63","000","00","030","0029","1481","715","367","348","49","764","1319","0","57.92","27.82"
"63","000","00","030","0029","1482","759","322","437","38","797","1278","0","62.36","25.20"
"63","000","00","030","0030","0000","2584","1189","1395","97","2681","4131","0","64.90","28.78"
"63","000","00","030","0030","1483","668","322","346","30","698","1094","0","63.80","29.43"
"63","000","00","030","0030","1484","621","292","329","22","643","964","0","66.70","30.29"
"63","000","00","030","0030","1485","671","294","377","19","690","1033","0","66.80","28.46"
"63","000","00","030","0030","1486","624","281","343","26","650","1040","0","62.50","27.02"
"63","000","00","030","0031","0000","3085","1612","1473","140","3225","4939","0","65.30","32.64"
"63","000","00","030","0031","1487","795","417","378","33","828","1231","0","67.26","33.87"
"63","000","00","030","0031","1488","788","387","401","32","820","1250","0","65.60","30.96"
"63","000","00","030","0031","1489","766","431","335","35","801","1259","0","63.62","34.23"
"63","000","00","030","0031","1490","736","377","359","40","776","1199","0","64.72","31.44"
"63","000","00","030","0032","0000","2766","1374","1392","145","2911","4263","0","68.29","32.23"
"63","000","00","030","0032","1491","684","322","362","35","719","1020","0","70.49","31.57"
"63","000","00","030","0032","1492","608","329","279","41","649","930","0","69.78","35.38"
"63","000","00","030","0032","1493","756","371","385","28","784","1187","0","66.05","31.26"
"63","000","00","030","0032","1494","718","352","366","41","759","1126","0","67.41","31.26"
"63","000","00","030","0033","0000","2056","1045","1011","118","2174","3348","0","64.93","31.21"
"63","000","00","030","0033","1495","731","372","359","52","783","1216","0","64.39","30.59"
"63","000","00","030","0033","1496","703","364","339","48","751","1140","0","65.88","31.93"
"63","000","00","030","0033","1497","622","309","313","18","640","992","0","64.52","31.15"
"63","000","00","030","0034","0000","2368","1045","1323","109","2477","3507","0","70.63","29.80"
"63","000","00","030","0034","1498","737","339","398","32","769","1082","0","71.07","31.33"
"63","000","00","030","0034","1499","881","355","526","37","918","1290","0","71.16","27.52"
"63","000","00","030","0034","1500","750","351","399","40","790","1135","0","69.60","30.93"
"63","000","00","030","0035","0000","2174","1000","1174","90","2264","3340","0","67.78","29.94"
"63","000","00","030","0035","1501","710","325","385","31","741","1103","0","67.18","29.47"
"63","000","00","030","0035","1502","761","334","427","34","795","1155","0","68.83","28.92"
"63","000","00","030","0035","1503","703","341","362","25","728","1082","0","67.28","31.52"
"63","000","00","030","0036","0000","2842","1290","1552","108","2950","4395","0","67.12","29.35"
"63","000","00","030","0036","1504","791","372","419","27","818","1191","0","68.68","31.23"
"63","000","00","030","0036","1505","644","304","340","26","670","991","0","67.61","30.68"
"63","000","00","030","0036","1506","762","354","408","32","794","1182","0","67.17","29.95"
"63","000","00","030","0036","1507","645","260","385","23","668","1031","0","64.79","25.22"
"63","000","00","030","0037","0000","3638","1368","2270","130","3768","5439","0","69.28","25.15"
"63","000","00","030","0037","1508","701","202","499","34","735","1072","0","68.56","18.84"
"63","000","00","030","0037","1509","676","247","429","25","701","966","0","72.57","25.57"
"63","000","00","030","0037","1510","700","284","416","15","715","1064","0","67.20","26.69"
"63","000","00","030","0037","1511","820","361","459","22","842","1187","0","70.94","30.41"
"63","000","00","030","0037","1512","741","274","467","34","775","1150","0","67.39","23.83"
"63","000","00","030","0038","0000","1801","891","910","59","1860","2861","0","65.01","31.14"
"63","000","00","030","0038","1513","811","410","401","16","827","1286","0","64.31","31.88"
"63","000","00","030","0038","1514","442","210","232","16","458","692","0","66.18","30.35"
"63","000","00","030","0038","1515","548","271","277","27","575","883","0","65.12","30.69"
"63","000","00","030","0039","0000","1015","496","519","36","1051","1561","0","67.33","31.77"
"63","000","00","030","0039","1516","507","245","262","13","520","798","0","65.16","30.70"
"63","000","00","030","0039","1517","508","251","257","23","531","763","0","69.59","32.90"
"63","000","00","030","0040","0000","4336","2238","2098","111","4447","6823","0","65.18","32.80"
"63","000","00","030","0040","1518","796","415","381","33","829","1238","0","66.96","33.52"
"63","000","00","030","0040","1519","772","365","407","13","785","1168","0","67.21","31.25"
"63","000","00","030","0040","1520","649","342","307","16","665","1026","0","64.81","33.33"
"63","000","00","030","0040","1521","702","364","338","13","715","1160","0","61.64","31.38"
"63","000","00","030","0040","1522","698","375","323","21","719","1104","0","65.13","33.97"
"63","000","00","030","0040","1523","719","377","342","15","734","1127","0","65.13","33.45"
"63","000","00","030","0041","0000","2084","1076","1008","70","2154","3221","0","66.87","33.41"
"63","000","00","030","0041","1524","696","360","336","27","723","1109","0","65.19","32.46"
"63","000","00","030","0041","1525","643","340","303","19","662","990","0","66.87","34.34"
"63","000","00","030","0041","1526","745","376","369","24","769","1122","0","68.54","33.51"
"63","000","00","030","0043","0000","4304","2171","2133","111","4415","6484","0","68.09","33.48"
"63","000","00","030","0043","1527","945","473","472","24","969","1375","0","70.47","34.40"
"63","000","00","030","0043","1528","807","416","391","24","831","1263","0","65.80","32.94"
"63","000","00","030","0043","1529","859","429","430","15","874","1265","0","69.09","33.91"
"63","000","00","030","0043","1530","842","417","425","21","863","1324","0","65.18","31.50"
"63","000","00","030","0043","1531","851","436","415","27","878","1257","0","69.85","34.69"
"63","000","00","030","0044","0000","2861","1381","1480","140","3001","4641","0","64.66","29.76"
"63","000","00","030","0044","1532","785","379","406","35","820","1251","0","65.55","30.30"
"63","000","00","030","0044","1533","663","319","344","34","697","1063","0","65.57","30.01"
"63","000","00","030","0044","1534","703","334","369","35","738","1160","0","63.62","28.79"
"63","000","00","030","0044","1535","710","349","361","36","746","1167","0","63.92","29.91"
"63","000","00","030","0046","0000","2725","1375","1350","161","2886","4438","0","65.03","30.98"
"63","000","00","030","0046","1536","785","370","415","58","843","1228","0","68.65","30.13"
"63","000","00","030","0046","1537","606","311","295","28","634","1033","0","61.37","30.11"
"63","000","00","030","0046","1538","613","303","310","40","653","951","0","68.66","31.86"
"63","000","00","030","0046","1539","721","391","330","35","756","1226","0","61.66","31.89"
"63","000","00","030","0047","0000","4011","1974","2037","177","4188","6148","0","68.12","32.11"
"63","000","00","030","0047","1540","887","470","417","23","910","1294","0","70.32","36.32"
"63","000","00","030","0047","1541","778","357","421","46","824","1228","0","67.10","29.07"
"63","000","00","030","0047","1542","784","357","427","32","816","1214","0","67.22","29.41"
"63","000","00","030","0047","1543","774","393","381","37","811","1191","0","68.09","33.00"
"63","000","00","030","0047","1544","788","397","391","39","827","1221","0","67.73","32.51"
"63","000","00","030","0048","0000","2425","1170","1255","147","2572","3831","0","67.14","30.54"
"63","000","00","030","0048","1545","821","419","402","63","884","1353","0","65.34","30.97"
"63","000","00","030","0048","1546","755","361","394","50","805","1200","0","67.08","30.08"
"63","000","00","030","0048","1547","849","390","459","34","883","1278","0","69.09","30.52"
"63","000","00","030","0049","0000","2288","1099","1189","88","2376","3633","0","65.40","30.25"
"63","000","00","030","0049","1548","745","361","384","33","778","1215","0","64.03","29.71"
"63","000","00","030","0049","1549","795","396","399","32","827","1222","0","67.68","32.41"
"63","000","00","030","0049","1550","748","342","406","23","771","1196","0","64.46","28.60"
"63","000","00","030","0050","0000","2675","1272","1403","130","2805","4521","0","62.04","28.14"
"63","000","00","030","0050","1551","575","289","286","24","599","1057","0","56.67","27.34"
"63","000","00","030","0050","1552","739","344","395","31","770","1182","0","65.14","29.10"
"63","000","00","030","0050","1553","669","290","379","46","715","1139","0","62.77","25.46"
"63","000","00","030","0050","1554","692","349","343","29","721","1143","0","63.08","30.53"
"63","000","00","030","0051","0000","2908","1468","1440","93","3001","4610","0","65.10","31.84"
"63","000","00","030","0051","1555","703","345","358","19","722","1116","0","64.70","30.91"
"63","000","00","030","0051","1556","781","419","362","22","803","1196","0","67.14","35.03"
"63","000","00","030","0051","1557","675","326","349","30","705","1128","0","62.50","28.90"
"63","000","00","030","0051","1558","749","378","371","22","771","1170","0","65.90","32.31"
"63","000","00","030","0052","0000","2227","1051","1176","72","2299","3467","0","66.31","30.31"
"63","000","00","030","0052","1559","716","335","381","22","738","1114","0","66.25","30.07"
"63","000","00","030","0052","1560","781","349","432","23","804","1223","0","65.74","28.54"
"63","000","00","030","0052","1561","730","367","363","27","757","1130","0","66.99","32.48"
"63","000","00","030","0053","0000","2818","1434","1384","89","2907","4510","0","64.46","31.80"
"63","000","00","030","0053","1562","694","335","359","20","714","1076","0","66.36","31.13"
"63","000","00","030","0053","1563","658","333","325","19","677","1157","0","58.51","28.78"
"63","000","00","030","0053","1564","754","389","365","23","777","1120","0","69.38","34.73"
"63","000","00","030","0053","1565","712","377","335","27","739","1157","0","63.87","32.58"
"63","000","00","030","0054","0000","1956","995","961","62","2018","3145","0","64.17","31.64"
"63","000","00","030","0054","1566","718","376","342","32","750","1153","0","65.05","32.61"
"63","000","00","030","0054","1567","597","288","309","14","611","1010","0","60.50","28.51"
"63","000","00","030","0054","1568","641","331","310","16","657","982","0","66.90","33.71"
"63","000","00","030","0055","0000","2951","1483","1468","96","3047","4675","0","65.18","31.72"
"63","000","00","030","0055","1569","711","372","339","22","733","1131","0","64.81","32.89"
"63","000","00","030","0055","1570","722","355","367","17","739","1147","0","64.43","30.95"
"63","000","00","030","0055","1571","769","350","419","21","790","1186","0","66.61","29.51"
"63","000","00","030","0055","1572","749","406","343","36","785","1211","0","64.82","33.53"
"63","000","00","030","0056","0000","3713","1834","1879","108","3821","5700","0","67.04","32.18"
"63","000","00","030","0056","1573","852","414","438","25","877","1304","0","67.25","31.75"
"63","000","00","030","0056","1574","655","340","315","14","669","1041","0","64.27","32.66"
"63","000","00","030","0056","1575","711","363","348","28","739","1150","0","64.26","31.57"
"63","000","00","030","0056","1576","728","331","397","14","742","1083","0","68.51","30.56"
"63","000","00","030","0056","1577","767","386","381","27","794","1122","0","70.77","34.40"
"63","000","00","030","0057","0000","1175","571","604","103","1278","1958","0","65.27","29.16"
"63","000","00","030","0057","1578","494","222","272","29","523","803","0","65.13","27.65"
"63","000","00","030","0057","1579","323","168","155","58","381","575","0","66.26","29.22"
"63","000","00","030","0057","1580","358","181","177","16","374","580","0","64.48","31.21"
"63","000","00","040","0000","0000","109727","58572","51155","4340","114067","176657","210776","64.57","33.16"
"63","000","00","040","0001","0000","1771","946","825","65","1836","2672","0","68.71","35.40"
"63","000","00","040","0001","0897","950","503","447","29","979","1470","0","66.60","34.22"
"63","000","00","040","0001","0898","821","443","378","36","857","1202","0","71.30","36.86"
"63","000","00","040","0002","0000","2436","1337","1099","86","2522","4318","0","58.41","30.96"
"63","000","00","040","0002","0899","890","501","389","29","919","1523","0","60.34","32.90"
"63","000","00","040","0002","0900","777","420","357","17","794","1448","0","54.83","29.01"
"63","000","00","040","0002","0901","769","416","353","40","809","1347","0","60.06","30.88"
"63","000","00","040","0003","0000","1799","940","859","96","1895","2969","0","63.83","31.66"
"63","000","00","040","0003","0902","856","432","424","50","906","1430","0","63.36","30.21"
"63","000","00","040","0003","0903","943","508","435","46","989","1539","0","64.26","33.01"
"63","000","00","040","0004","0000","2329","1305","1024","60","2389","3548","0","67.33","36.78"
"63","000","00","040","0004","0904","778","440","338","16","794","1181","0","67.23","37.26"
"63","000","00","040","0004","0905","701","380","321","20","721","1033","0","69.80","36.79"
"63","000","00","040","0004","0906","850","485","365","24","874","1334","0","65.52","36.36"
"63","000","00","040","0005","0000","1244","645","599","49","1293","2176","0","59.42","29.64"
"63","000","00","040","0005","0907","563","308","255","29","592","998","0","59.32","30.86"
"63","000","00","040","0005","0908","681","337","344","20","701","1178","0","59.51","28.61"
"63","000","00","040","0006","0000","3281","1790","1491","125","3406","5661","0","60.17","31.62"
"63","000","00","040","0006","0909","597","336","261","38","635","1031","0","61.59","32.59"
"63","000","00","040","0006","0910","685","376","309","20","705","1127","0","62.56","33.36"
"63","000","00","040","0006","0911","601","323","278","20","621","1076","0","57.71","30.02"
"63","000","00","040","0006","0912","607","305","302","21","628","1157","0","54.28","26.36"
"63","000","00","040","0006","0913","791","450","341","26","817","1270","0","64.33","35.43"
"63","000","00","040","0007","0000","1909","1030","879","114","2023","3452","0","58.60","29.84"
"63","000","00","040","0007","0914","638","358","280","34","672","1159","0","57.98","30.89"
"63","000","00","040","0007","0915","649","360","289","29","678","1108","0","61.19","32.49"
"63","000","00","040","0007","0916","622","312","310","51","673","1185","0","56.79","26.33"
"63","000","00","040","0008","0000","3404","1955","1449","98","3502","5567","0","62.91","35.12"
"63","000","00","040","0008","0917","642","391","251","19","661","1008","0","65.58","38.79"
"63","000","00","040","0008","0918","718","415","303","20","738","1117","0","66.07","37.15"
"63","000","00","040","0008","0919","725","382","343","27","752","1179","0","63.78","32.40"
"63","000","00","040","0008","0920","616","382","234","15","631","1102","0","57.26","34.66"
"63","000","00","040","0008","0921","703","385","318","17","720","1161","0","62.02","33.16"
"63","000","00","040","0009","0000","1970","945","1025","70","2040","3235","0","63.06","29.21"
"63","000","00","040","0009","0922","684","231","453","26","710","1092","0","65.02","21.15"
"63","000","00","040","0009","0923","700","405","295","20","720","1097","0","65.63","36.92"
"63","000","00","040","0009","0924","586","309","277","24","610","1046","0","58.32","29.54"
"63","000","00","040","0010","0000","2512","1334","1178","115","2627","4137","0","63.50","32.25"
"63","000","00","040","0010","0925","675","375","300","26","701","1057","0","66.32","35.48"
"63","000","00","040","0010","0926","732","384","348","35","767","1197","0","64.08","32.08"
"63","000","00","040","0010","0927","632","346","286","26","658","1006","0","65.41","34.39"
"63","000","00","040","0010","0928","473","229","244","28","501","877","0","57.13","26.11"
"63","000","00","040","0011","0000","2636","1399","1237","125","2761","4476","0","61.68","31.26"
"63","000","00","040","0011","0929","643","331","312","29","672","1169","0","57.49","28.31"
"63","000","00","040","0011","0930","607","330","277","14","621","979","0","63.43","33.71"
"63","000","00","040","0011","0931","695","388","307","35","730","1149","0","63.53","33.77"
"63","000","00","040","0011","0932","691","350","341","47","738","1179","0","62.60","29.69"
"63","000","00","040","0012","0000","2050","1114","936","99","2149","3379","0","63.60","32.97"
"63","000","00","040","0012","0933","653","340","313","21","674","1082","0","62.29","31.42"
"63","000","00","040","0012","0934","772","438","334","36","808","1199","0","67.39","36.53"
"63","000","00","040","0012","0935","625","336","289","42","667","1098","0","60.75","30.60"
"63","000","00","040","0013","0000","1912","639","1273","69","1981","2887","0","68.62","22.13"
"63","000","00","040","0013","0939","597","193","404","19","616","895","0","68.83","21.56"
"63","000","00","040","0013","0940","621","237","384","32","653","981","0","66.56","24.16"
"63","000","00","040","0013","0941","694","209","485","18","712","1011","0","70.43","20.67"
"63","000","00","040","0014","0000","4505","2234","2271","147","4652","6833","0","68.08","32.69"
"63","000","00","040","0014","0942","761","404","357","19","780","1124","0","69.40","35.94"
"63","000","00","040","0014","0943","741","377","364","29","770","1089","0","70.71","34.62"
"63","000","00","040","0014","0944","759","371","388","33","792","1120","0","70.71","33.13"
"63","000","00","040","0014","0945","776","372","404","26","802","1233","0","65.04","30.17"
"63","000","00","040","0014","0946","650","306","344","21","671","975","0","68.82","31.38"
"63","000","00","040","0014","0947","818","404","414","19","837","1292","0","64.78","31.27"
"63","000","00","040","0015","0000","3047","1568","1479","74","3121","4881","0","63.94","32.12"
"63","000","00","040","0015","0948","827","425","402","23","850","1283","0","66.25","33.13"
"63","000","00","040","0015","0949","798","441","357","8","806","1263","0","63.82","34.92"
"63","000","00","040","0015","0950","738","381","357","20","758","1221","0","62.08","31.20"
"63","000","00","040","0015","0951","684","321","363","23","707","1114","0","63.46","28.82"
"63","000","00","040","0016","0000","4791","2447","2344","162","4953","7135","0","69.42","34.30"
"63","000","00","040","0016","0952","783","380","403","32","815","1210","0","67.36","31.40"
"63","000","00","040","0016","0953","724","349","375","20","744","1024","0","72.66","34.08"
"63","000","00","040","0016","0954","868","454","414","24","892","1255","0","71.08","36.18"
"63","000","00","040","0016","0955","740","395","345","31","771","1202","0","64.14","32.86"
"63","000","00","040","0016","0956","861","420","441","33","894","1273","0","70.23","32.99"
"63","000","00","040","0016","0957","815","449","366","22","837","1171","0","71.48","38.34"
"63","000","00","040","0017","0000","519","330","189","34","553","868","0","63.71","38.02"
"63","000","00","040","0017","0981","519","330","189","34","553","868","0","63.71","38.02"
"63","000","00","040","0018","0000","2469","1385","1084","149","2618","4120","0","63.54","33.62"
"63","000","00","040","0018","0965","816","464","352","59","875","1438","0","60.85","32.27"
"63","000","00","040","0018","0966","826","480","346","47","873","1358","0","64.29","35.35"
"63","000","00","040","0018","0967","827","441","386","43","870","1324","0","65.71","33.31"
"63","000","00","040","0019","0000","2577","1462","1115","125","2702","3999","0","67.57","36.56"
"63","000","00","040","0019","0936","847","466","381","26","873","1381","0","63.22","33.74"
"63","000","00","040","0019","0937","944","548","396","64","1008","1400","0","72.00","39.14"
"63","000","00","040","0019","0938","786","448","338","35","821","1218","0","67.41","36.78"
"63","000","00","040","0020","0000","2575","1531","1044","128","2703","4099","0","65.94","37.35"
"63","000","00","040","0020","0968","901","562","339","35","936","1423","0","65.78","39.49"
"63","000","00","040","0020","0969","805","460","345","47","852","1287","0","66.20","35.74"
"63","000","00","040","0020","0970","869","509","360","46","915","1389","0","65.87","36.65"
"63","000","00","040","0021","0000","3080","1670","1410","139","3219","4980","0","64.64","33.53"
"63","000","00","040","0021","0971","724","398","326","34","758","1193","0","63.54","33.36"
"63","000","00","040","0021","0972","860","465","395","29","889","1340","0","66.34","34.70"
"63","000","00","040","0021","0973","750","414","336","33","783","1266","0","61.85","32.70"
"63","000","00","040","0021","0974","746","393","353","43","789","1181","0","66.81","33.28"
"63","000","00","040","0022","0000","2495","1384","1111","98","2593","3792","0","68.38","36.50"
"63","000","00","040","0022","0975","773","430","343","30","803","1099","0","73.07","39.13"
"63","000","00","040","0022","0976","822","464","358","21","843","1271","0","66.33","36.51"
"63","000","00","040","0022","0977","900","490","410","47","947","1422","0","66.60","34.46"
"63","000","00","040","0023","0000","2537","1472","1065","130","2667","4108","0","64.92","35.83"
"63","000","00","040","0023","0978","899","536","363","29","928","1422","0","65.26","37.69"
"63","000","00","040","0023","0979","818","468","350","61","879","1295","0","67.88","36.14"
"63","000","00","040","0023","0980","820","468","352","40","860","1391","0","61.83","33.64"
"63","000","00","040","0024","0000","3143","1707","1436","144","3287","6225","0","52.80","27.42"
"63","000","00","040","0024","0982","634","338","296","23","657","937","0","70.12","36.07"
"63","000","00","040","0024","0983","696","371","325","27","723","1060","0","68.21","35.00"
"63","000","00","040","0024","0984","835","475","360","22","857","1231","0","69.62","38.59"
"63","000","00","040","0024","0985","978","523","455","72","1050","2997","0","35.04","17.45"
"63","000","00","040","0025","0000","4119","2290","1829","198","4317","6435","0","67.09","35.59"
"63","000","00","040","0025","0986","805","435","370","28","833","1239","0","67.23","35.11"
"63","000","00","040","0025","0987","955","531","424","45","1000","1500","0","66.67","35.40"
"63","000","00","040","0025","0988","769","418","351","51","820","1195","0","68.62","34.98"
"63","000","00","040","0025","0989","795","470","325","31","826","1224","0","67.48","38.40"
"63","000","00","040","0025","0990","795","436","359","43","838","1277","0","65.62","34.14"
"63","000","00","040","0026","0000","2187","1250","937","92","2279","3568","0","63.87","35.03"
"63","000","00","040","0026","0991","854","488","366","30","884","1355","0","65.24","36.01"
"63","000","00","040","0026","0992","605","356","249","30","635","1053","0","60.30","33.81"
"63","000","00","040","0026","0993","728","406","322","32","760","1160","0","65.52","35.00"
"63","000","00","040","0027","0000","3857","2107","1750","190","4047","6094","0","66.41","34.57"
"63","000","00","040","0027","0994","784","413","371","31","815","1237","0","65.89","33.39"
"63","000","00","040","0027","0995","740","391","349","50","790","1157","0","68.28","33.79"
"63","000","00","040","0027","0996","712","399","313","30","742","1255","0","59.12","31.79"
"63","000","00","040","0027","0997","805","443","362","37","842","1217","0","69.19","36.40"
"63","000","00","040","0027","0998","816","461","355","42","858","1228","0","69.87","37.54"
"63","000","00","040","0028","0000","3422","1849","1573","131","3553","5452","0","65.17","33.91"
"63","000","00","040","0028","0999","980","531","449","23","1003","1511","0","66.38","35.14"
"63","000","00","040","0028","1000","757","407","350","29","786","1309","0","60.05","31.09"
"63","000","00","040","0028","1001","830","461","369","49","879","1282","0","68.56","35.96"
"63","000","00","040","0028","1002","855","450","405","30","885","1350","0","65.56","33.33"
"63","000","00","040","0029","0000","3881","2114","1767","138","4019","5935","0","67.72","35.62"
"63","000","00","040","0029","1003","801","423","378","13","814","1237","0","65.80","34.20"
"63","000","00","040","0029","1004","784","431","353","31","815","1213","0","67.19","35.53"
"63","000","00","040","0029","1005","735","430","305","41","776","1177","0","65.93","36.53"
"63","000","00","040","0029","1006","787","432","355","24","811","1147","0","70.71","37.66"
"63","000","00","040","0029","1007","774","398","376","29","803","1161","0","69.16","34.28"
"63","000","00","040","0030","0000","2898","1661","1237","73","2971","4377","0","67.88","37.95"
"63","000","00","040","0030","1008","713","370","343","15","728","1091","0","66.73","33.91"
"63","000","00","040","0030","1009","730","411","319","23","753","1108","0","67.96","37.09"
"63","000","00","040","0030","1010","741","475","266","24","765","1101","0","69.48","43.14"
"63","000","00","040","0030","1011","714","405","309","11","725","1077","0","67.32","37.60"
"63","000","00","040","0031","0000","2630","1476","1154","70","2700","4107","0","65.74","35.94"
"63","000","00","040","0031","1012","681","405","276","19","700","1035","0","67.63","39.13"
"63","000","00","040","0031","1013","660","362","298","19","679","981","0","69.22","36.90"
"63","000","00","040","0031","1014","664","364","300","22","686","1055","0","65.02","34.50"
"63","000","00","040","0031","1015","625","345","280","10","635","1036","0","61.29","33.30"
"63","000","00","040","0032","0000","2682","1483","1199","68","2750","4405","0","62.43","33.67"
"63","000","00","040","0032","1016","697","358","339","15","712","1108","0","64.26","32.31"
"63","000","00","040","0032","1017","681","386","295","23","704","1116","0","63.08","34.59"
"63","000","00","040","0032","1018","640","354","286","18","658","1105","0","59.55","32.04"
"63","000","00","040","0032","1019","664","385","279","12","676","1076","0","62.83","35.78"
"63","000","00","040","0033","0000","1858","997","861","64","1922","2878","0","66.78","34.64"
"63","000","00","040","0033","1020","638","345","293","20","658","946","0","69.56","36.47"
"63","000","00","040","0033","1021","577","311","266","12","589","945","0","62.33","32.91"
"63","000","00","040","0033","1022","643","341","302","32","675","987","0","68.39","34.55"
"63","000","00","040","0034","0000","2784","1476","1308","154","2938","4607","0","63.77","32.04"
"63","000","00","040","0034","1023","768","390","378","33","801","1258","0","63.67","31.00"
"63","000","00","040","0034","1024","719","372","347","40","759","1148","0","66.11","32.40"
"63","000","00","040","0034","1025","626","335","291","31","657","1057","0","62.16","31.69"
"63","000","00","040","0034","1026","671","379","292","50","721","1144","0","63.02","33.13"
"63","000","00","040","0035","0000","2702","1073","1629","95","2797","4032","0","69.37","26.61"
"63","000","00","040","0035","1027","634","265","369","32","666","966","0","68.94","27.43"
"63","000","00","040","0035","1028","698","307","391","18","716","1002","0","71.46","30.64"
"63","000","00","040","0035","1029","634","246","388","22","656","960","0","68.33","25.63"
"63","000","00","040","0035","1030","736","255","481","23","759","1104","0","68.75","23.10"
"63","000","00","040","0036","0000","2164","1208","956","76","2240","3584","0","62.50","33.71"
"63","000","00","040","0036","1031","713","395","318","14","727","1216","0","59.79","32.48"
"63","000","00","040","0036","1032","663","369","294","16","679","1124","0","60.41","32.83"
"63","000","00","040","0036","1033","788","444","344","46","834","1244","0","67.04","35.69"
"63","000","00","040","0037","0000","1678","921","757","67","1745","2623","0","66.53","35.11"
"63","000","00","040","0037","1034","537","292","245","27","564","849","0","66.43","34.39"
"63","000","00","040","0037","1035","536","295","241","21","557","874","0","63.73","33.75"
"63","000","00","040","0037","1036","605","334","271","19","624","900","0","69.33","37.11"
"63","000","00","040","0038","0000","1579","859","720","57","1636","2406","0","68.00","35.70"
"63","000","00","040","0038","1037","838","464","374","27","865","1276","0","67.79","36.36"
"63","000","00","040","0038","1038","741","395","346","30","771","1130","0","68.23","34.96"
"63","000","00","040","0039","0000","3083","1665","1418","123","3206","4936","0","64.95","33.73"
"63","000","00","040","0039","1039","808","467","341","32","840","1252","0","67.09","37.30"
"63","000","00","040","0039","1040","775","442","333","40","815","1217","0","66.97","36.32"
"63","000","00","040","0039","1041","729","363","366","31","760","1200","0","63.33","30.25"
"63","000","00","040","0039","1042","771","393","378","20","791","1267","0","62.43","31.02"
"63","000","00","040","0040","0000","2239","1112","1127","72","2311","3661","0","63.12","30.37"
"63","000","00","040","0040","1043","784","365","419","28","812","1272","0","63.84","28.69"
"63","000","00","040","0040","1044","748","380","368","22","770","1256","0","61.31","30.25"
"63","000","00","040","0040","1045","707","367","340","22","729","1133","0","64.34","32.39"
"63","000","00","040","0041","0000","3671","1878","1793","121","3792","6025","0","62.94","31.17"
"63","000","00","040","0041","0958","591","338","253","19","610","954","0","63.94","35.43"
"63","000","00","040","0041","0959","788","371","417","37","825","1225","0","67.35","30.29"
"63","000","00","040","0041","0960","646","334","312","15","661","1153","0","57.33","28.97"
"63","000","00","040","0041","0961","775","408","367","22","797","1377","0","57.88","29.63"
"63","000","00","040","0041","0962","871","427","444","28","899","1316","0","68.31","32.45"
"63","000","00","040","0042","0000","1302","584","718","50","1352","2015","0","67.10","28.98"
"63","000","00","040","0042","0963","743","328","415","29","772","1095","0","70.50","29.95"
"63","000","00","040","0042","0964","559","256","303","21","580","920","0","63.04","27.83"
"63","000","00","050","0000","0000","73558","37100","36458","2783","76341","115914","146970","65.86","32.01"
"63","000","00","050","0001","0000","1500","827","673","64","1564","2393","0","65.36","34.56"
"63","000","00","050","0001","1216","511","283","228","16","527","781","0","67.48","36.24"
"63","000","00","050","0001","1217","509","278","231","30","539","834","0","64.63","33.33"
"63","000","00","050","0001","1218","480","266","214","18","498","778","0","64.01","34.19"
"63","000","00","050","0002","0000","1139","506","633","53","1192","1949","0","61.16","25.96"
"63","000","00","050","0002","1219","623","242","381","21","644","969","0","66.46","24.97"
"63","000","00","050","0002","1220","516","264","252","32","548","980","0","55.92","26.94"
"63","000","00","050","0003","0000","1412","702","710","59","1471","2115","0","69.55","33.19"
"63","000","00","050","0003","1221","773","381","392","27","800","1156","0","69.20","32.96"
"63","000","00","050","0003","1222","639","321","318","32","671","959","0","69.97","33.47"
"63","000","00","050","0004","0000","2376","1136","1240","70","2446","3824","0","63.96","29.71"
"63","000","00","050","0004","1223","619","312","307","24","643","976","0","65.88","31.97"
"63","000","00","050","0004","1224","558","264","294","16","574","919","0","62.46","28.73"
"63","000","00","050","0004","1225","680","307","373","14","694","1096","0","63.32","28.01"
"63","000","00","050","0004","1226","519","253","266","16","535","833","0","64.23","30.37"
"63","000","00","050","0005","0000","2318","1115","1203","89","2407","3560","0","67.61","31.32"
"63","000","00","050","0005","1227","631","314","317","20","651","926","0","70.30","33.91"
"63","000","00","050","0005","1228","556","267","289","18","574","883","0","65.01","30.24"
"63","000","00","050","0005","1229","625","284","341","16","641","924","0","69.37","30.74"
"63","000","00","050","0005","1230","506","250","256","35","541","827","0","65.42","30.23"
"63","000","00","050","0006","0000","3143","1597","1546","124","3267","4829","0","67.65","33.07"
"63","000","00","050","0006","1231","665","337","328","18","683","1014","0","67.36","33.23"
"63","000","00","050","0006","1232","724","365","359","29","753","1067","0","70.57","34.21"
"63","000","00","050","0006","1233","536","269","267","31","567","842","0","67.34","31.95"
"63","000","00","050","0006","1234","610","296","314","19","629","960","0","65.52","30.83"
"63","000","00","050","0006","1235","608","330","278","27","635","946","0","67.12","34.88"
"63","000","00","050","0007","0000","3019","1497","1522","99","3118","4578","0","68.11","32.70"
"63","000","00","050","0007","1236","761","334","427","21","782","1145","0","68.30","29.17"
"63","000","00","050","0007","1237","800","399","401","21","821","1219","0","67.35","32.73"
"63","000","00","050","0007","1238","709","383","326","23","732","1062","0","68.93","36.06"
"63","000","00","050","0007","1239","749","381","368","34","783","1152","0","67.97","33.07"
"63","000","00","050","0008","0000","1756","906","850","104","1860","2762","0","67.34","32.80"
"63","000","00","050","0008","1240","534","273","261","38","572","860","0","66.51","31.74"
"63","000","00","050","0008","1241","564","291","273","32","596","900","0","66.22","32.33"
"63","000","00","050","0008","1242","658","342","316","34","692","1002","0","69.06","34.13"
"63","000","00","050","0009","0000","2902","1431","1471","112","3014","4486","0","67.19","31.90"
"63","000","00","050","0009","1243","742","377","365","38","780","1180","0","66.10","31.95"
"63","000","00","050","0009","1244","812","386","426","29","841","1220","0","68.93","31.64"
"63","000","00","050","0009","1245","621","309","312","20","641","960","0","66.77","32.19"
"63","000","00","050","0009","1246","727","359","368","25","752","1126","0","66.79","31.88"
"63","000","00","050","0010","0000","2231","1080","1151","114","2345","3456","0","67.85","31.25"
"63","000","00","050","0010","1247","791","373","418","35","826","1234","0","66.94","30.23"
"63","000","00","050","0010","1248","676","336","340","48","724","1059","0","68.37","31.73"
"63","000","00","050","0010","1249","764","371","393","31","795","1163","0","68.36","31.90"
"63","000","00","050","0011","0000","3053","1591","1462","148","3201","4958","0","64.56","32.09"
"63","000","00","050","0011","1134","564","289","275","22","586","912","0","64.25","31.69"
"63","000","00","050","0011","1135","639","316","323","34","673","1081","0","62.26","29.23"
"63","000","00","050","0011","1136","591","333","258","28","619","970","0","63.81","34.33"
"63","000","00","050","0011","1137","591","316","275","38","629","980","0","64.18","32.24"
"63","000","00","050","0011","1138","668","337","331","26","694","1015","0","68.37","33.20"
"63","000","00","050","0012","0000","2435","1256","1179","131","2566","3877","0","66.19","32.40"
"63","000","00","050","0012","1139","677","368","309","39","716","1076","0","66.54","34.20"
"63","000","00","050","0012","1140","605","328","277","37","642","930","0","69.03","35.27"
"63","000","00","050","0012","1141","628","296","332","22","650","986","0","65.92","30.02"
"63","000","00","050","0012","1142","525","264","261","33","558","885","0","63.05","29.83"
"63","000","00","050","0013","0000","1760","922","838","73","1833","2701","0","67.86","34.14"
"63","000","00","050","0013","1143","633","327","306","27","660","922","0","71.58","35.47"
"63","000","00","050","0013","1144","577","302","275","18","595","925","0","64.32","32.65"
"63","000","00","050","0013","1145","550","293","257","28","578","854","0","67.68","34.31"
"63","000","00","050","0014","0000","3068","1497","1571","222","3290","5199","0","63.28","28.79"
"63","000","00","050","0014","1146","602","278","324","39","641","1013","0","63.28","27.44"
"63","000","00","050","0014","1147","661","316","345","50","711","1162","0","61.19","27.19"
"63","000","00","050","0014","1148","507","261","246","43","550","875","0","62.86","29.83"
"63","000","00","050","0014","1149","625","304","321","49","674","1054","0","63.95","28.84"
"63","000","00","050","0014","1150","673","338","335","41","714","1095","0","65.21","30.87"
"63","000","00","050","0015","0000","2046","1109","937","85","2131","3338","0","63.84","33.22"
"63","000","00","050","0015","1151","695","367","328","26","721","1136","0","63.47","32.31"
"63","000","00","050","0015","1152","687","388","299","19","706","1115","0","63.32","34.80"
"63","000","00","050","0015","1153","664","354","310","40","704","1087","0","64.77","32.57"
"63","000","00","050","0016","0000","1595","776","819","44","1639","2427","0","67.53","31.97"
"63","000","00","050","0016","1154","540","283","257","10","550","811","0","67.82","34.90"
"63","000","00","050","0016","1155","539","245","294","15","554","843","0","65.72","29.06"
"63","000","00","050","0016","1156","516","248","268","19","535","773","0","69.21","32.08"
"63","000","00","050","0017","0000","1266","606","660","47","1313","1999","0","65.68","30.32"
"63","000","00","050","0017","1157","640","303","337","12","652","1013","0","64.36","29.91"
"63","000","00","050","0017","1158","626","303","323","35","661","986","0","67.04","30.73"
"63","000","00","050","0018","0000","1641","812","829","53","1694","2435","0","69.57","33.35"
"63","000","00","050","0018","1159","595","283","312","21","616","898","0","68.60","31.51"
"63","000","00","050","0018","1160","524","251","273","9","533","755","0","70.60","33.25"
"63","000","00","050","0018","1161","522","278","244","23","545","782","0","69.69","35.55"
"63","000","00","050","0019","0000","5561","2728","2833","171","5732","8415","0","68.12","32.42"
"63","000","00","050","0019","1162","645","325","320","22","667","1002","0","66.57","32.44"
"63","000","00","050","0019","1163","663","326","337","24","687","1007","0","68.22","32.37"
"63","000","00","050","0019","1164","723","376","347","32","755","1069","0","70.63","35.17"
"63","000","00","050","0019","1165","801","392","409","9","810","1191","0","68.01","32.91"
"63","000","00","050","0019","1166","648","298","350","19","667","977","0","68.27","30.50"
"63","000","00","050","0019","1167","709","354","355","30","739","1094","0","67.55","32.36"
"63","000","00","050","0019","1168","627","304","323","12","639","965","0","66.22","31.50"
"63","000","00","050","0019","1169","745","353","392","23","768","1110","0","69.19","31.80"
"63","000","00","050","0020","0000","2429","1280","1149","68","2497","3866","0","64.59","33.11"
"63","000","00","050","0020","1170","577","316","261","12","589","949","0","62.07","33.30"
"63","000","00","050","0020","1171","710","399","311","23","733","1118","0","65.56","35.69"
"63","000","00","050","0020","1172","495","229","266","15","510","816","0","62.50","28.06"
"63","000","00","050","0020","1173","647","336","311","18","665","983","0","67.65","34.18"
"63","000","00","050","0021","0000","4096","1940","2156","97","4193","6313","0","66.42","30.73"
"63","000","00","050","0021","1174","709","355","354","16","725","1081","0","67.07","32.84"
"63","000","00","050","0021","1175","676","336","340","18","694","1080","0","64.26","31.11"
"63","000","00","050","0021","1176","696","333","363","17","713","1072","0","66.51","31.06"
"63","000","00","050","0021","1177","698","342","356","13","711","1078","0","65.96","31.73"
"63","000","00","050","0021","1178","683","285","398","15","698","984","0","70.93","28.96"
"63","000","00","050","0021","1179","634","289","345","18","652","1018","0","64.05","28.39"
"63","000","00","050","0022","0000","771","381","390","32","803","1182","0","67.94","32.23"
"63","000","00","050","0022","1180","771","381","390","32","803","1182","0","67.94","32.23"
"63","000","00","050","0023","0000","1808","947","861","77","1885","3000","0","62.83","31.57"
"63","000","00","050","0023","1181","502","264","238","36","538","867","0","62.05","30.45"
"63","000","00","050","0023","1182","637","343","294","26","663","1010","0","65.64","33.96"
"63","000","00","050","0023","1183","669","340","329","15","684","1123","0","60.91","30.28"
"63","000","00","050","0024","0000","1447","743","704","47","1494","2491","0","59.98","29.83"
"63","000","00","050","0024","1184","455","229","226","23","478","815","0","58.65","28.10"
"63","000","00","050","0024","1185","490","263","227","13","503","798","0","63.03","32.96"
"63","000","00","050","0024","1186","502","251","251","11","513","878","0","58.43","28.59"
"63","000","00","050","0025","0000","1568","826","742","51","1619","2465","0","65.68","33.51"
"63","000","00","050","0025","1187","542","310","232","13","555","868","0","63.94","35.71"
"63","000","00","050","0025","1188","494","248","246","17","511","789","0","64.77","31.43"
"63","000","00","050","0025","1189","532","268","264","21","553","808","0","68.44","33.17"
"63","000","00","050","0026","0000","2418","1260","1158","95","2513","4644","0","54.11","27.13"
"63","000","00","050","0026","1190","700","370","330","24","724","1103","0","65.64","33.54"
"63","000","00","050","0026","1191","575","275","300","28","603","1738","0","34.70","15.82"
"63","000","00","050","0026","1192","563","309","254","25","588","912","0","64.47","33.88"
"63","000","00","050","0026","1193","580","306","274","18","598","891","0","67.12","34.34"
"63","000","00","050","0027","0000","2168","1181","987","78","2246","3384","0","66.37","34.90"
"63","000","00","050","0027","1194","499","271","228","13","512","797","0","64.24","34.00"
"63","000","00","050","0027","1195","606","339","267","28","634","945","0","67.09","35.87"
"63","000","00","050","0027","1196","596","332","264","21","617","881","0","70.03","37.68"
"63","000","00","050","0027","1197","467","239","228","16","483","761","0","63.47","31.41"
"63","000","00","050","0028","0000","1828","872","956","53","1881","2839","0","66.26","30.72"
"63","000","00","050","0028","1198","621","305","316","21","642","955","0","67.23","31.94"
"63","000","00","050","0028","1199","597","297","300","14","611","920","0","66.41","32.28"
"63","000","00","050","0028","1200","610","270","340","18","628","964","0","65.15","28.01"
"63","000","00","050","0029","0000","2774","1401","1373","79","2853","4128","0","69.11","33.94"
"63","000","00","050","0029","1201","714","331","383","26","740","1105","0","66.97","29.95"
"63","000","00","050","0029","1202","716","351","365","23","739","1072","0","68.94","32.74"
"63","000","00","050","0029","1203","596","325","271","18","614","870","0","70.57","37.36"
"63","000","00","050","0029","1204","748","394","354","12","760","1081","0","70.31","36.45"
"63","000","00","050","0030","0000","3850","2021","1829","117","3967","5814","0","68.23","34.76"
"63","000","00","050","0030","1205","827","443","384","26","853","1288","0","66.23","34.39"
"63","000","00","050","0030","1206","756","387","369","29","785","1148","0","68.38","33.71"
"63","000","00","050","0030","1207","821","439","382","24","845","1276","0","66.22","34.40"
"63","000","00","050","0030","1208","677","335","342","15","692","971","0","71.27","34.50"
"63","000","00","050","0030","1209","769","417","352","23","792","1131","0","70.03","36.87"
"63","000","00","050","0031","0000","4180","2154","2026","127","4307","6487","0","66.39","33.20"
"63","000","00","050","0031","1210","657","322","335","9","666","995","0","66.93","32.36"
"63","000","00","050","0031","1211","649","355","294","25","674","1079","0","62.47","32.90"
"63","000","00","050","0031","1212","708","336","372","17","725","1088","0","66.64","30.88"
"63","000","00","050","0031","1213","693","393","300","32","725","1009","0","71.85","38.95"
"63","000","00","050","0031","1214","702","338","364","18","720","1106","0","65.10","30.56"
"63","000","00","050","0031","1215","771","410","361","26","797","1210","0","65.87","33.88"
"63","000","00","060","0000","0000","62424","36542","25882","2897","65321","98574","118354","66.27","37.07"
"63","000","00","060","0001","0000","1465","861","604","68","1533","2348","0","65.29","36.67"
"63","000","00","060","0001","1046","708","427","281","21","729","1109","0","65.73","38.50"
"63","000","00","060","0001","1047","757","434","323","47","804","1239","0","64.89","35.03"
"63","000","00","060","0002","0000","1546","888","658","48","1594","2560","0","62.27","34.69"
"63","000","00","060","0002","1048","602","330","272","22","624","937","0","66.60","35.22"
"63","000","00","060","0002","1049","546","343","203","17","563","900","0","62.56","38.11"
"63","000","00","060","0002","1050","398","215","183","9","407","723","0","56.29","29.74"
"63","000","00","060","0003","0000","2352","1385","967","129","2481","3823","0","64.90","36.23"
"63","000","00","060","0003","1051","786","472","314","49","835","1255","0","66.53","37.61"
"63","000","00","060","0003","1052","762","448","314","37","799","1230","0","64.96","36.42"
"63","000","00","060","0003","1053","804","465","339","43","847","1338","0","63.30","34.75"
"63","000","00","060","0004","0000","1805","1065","740","79","1884","2816","0","66.90","37.82"
"63","000","00","060","0004","1054","591","338","253","32","623","930","0","66.99","36.34"
"63","000","00","060","0004","1055","579","355","224","15","594","865","0","68.67","41.04"
"63","000","00","060","0004","1056","635","372","263","32","667","1021","0","65.33","36.43"
"63","000","00","060","0005","0000","2658","1622","1036","126","2784","4153","0","67.04","39.06"
"63","000","00","060","0005","1057","741","450","291","28","769","1167","0","65.90","38.56"
"63","000","00","060","0005","1058","531","316","215","40","571","861","0","66.32","36.70"
"63","000","00","060","0005","1059","697","432","265","22","719","1062","0","67.70","40.68"
"63","000","00","060","0005","1060","689","424","265","36","725","1063","0","68.20","39.89"
"63","000","00","060","0006","0000","2207","1254","953","105","2312","3535","0","65.40","35.47"
"63","000","00","060","0006","1061","748","392","356","20","768","1173","0","65.47","33.42"
"63","000","00","060","0006","1062","723","424","299","42","765","1194","0","64.07","35.51"
"63","000","00","060","0006","1063","736","438","298","43","779","1168","0","66.70","37.50"
"63","000","00","060","0007","0000","2848","1591","1257","90","2938","4661","0","63.03","34.13"
"63","000","00","060","0007","1064","693","366","327","16","709","1156","0","61.33","31.66"
"63","000","00","060","0007","1065","693","391","302","24","717","1117","0","64.19","35.00"
"63","000","00","060","0007","1066","680","381","299","19","699","1138","0","61.42","33.48"
"63","000","00","060","0007","1067","782","453","329","31","813","1250","0","65.04","36.24"
"63","000","00","060","0008","0000","2563","1493","1070","142","2705","3950","0","68.48","37.80"
"63","000","00","060","0008","1068","591","373","218","42","633","906","0","69.87","41.17"
"63","000","00","060","0008","1069","680","379","301","47","727","1072","0","67.82","35.35"
"63","000","00","060","0008","1070","604","356","248","25","629","914","0","68.82","38.95"
"63","000","00","060","0008","1071","688","385","303","28","716","1058","0","67.67","36.39"
"63","000","00","060","0009","0000","2387","1430","957","147","2534","3662","0","69.20","39.05"
"63","000","00","060","0009","1072","763","475","288","46","809","1236","0","65.45","38.43"
"63","000","00","060","0009","1073","742","456","286","38","780","1206","0","64.68","37.81"
"63","000","00","060","0009","1074","882","499","383","63","945","1220","0","77.46","40.90"
"63","000","00","060","0010","0000","2080","1221","859","101","2181","3351","0","65.09","36.44"
"63","000","00","060","0010","1075","595","345","250","32","627","998","0","62.83","34.57"
"63","000","00","060","0010","1076","733","413","320","31","764","1148","0","66.55","35.98"
"63","000","00","060","0010","1077","752","463","289","38","790","1205","0","65.56","38.42"
"63","000","00","060","0011","0000","4543","2639","1904","215","4758","7188","0","66.19","36.71"
"63","000","00","060","0011","1078","755","436","319","32","787","1182","0","66.58","36.89"
"63","000","00","060","0011","1079","821","464","357","50","871","1317","0","66.14","35.23"
"63","000","00","060","0011","1080","626","361","265","10","636","1072","0","59.33","33.68"
"63","000","00","060","0011","1081","888","538","350","34","922","1293","0","71.31","41.61"
"63","000","00","060","0011","1082","796","481","315","49","845","1293","0","65.35","37.20"
"63","000","00","060","0011","1083","657","359","298","40","697","1031","0","67.60","34.82"
"63","000","00","060","0012","0000","2015","1206","809","119","2134","3237","0","65.93","37.26"
"63","000","00","060","0012","1084","718","446","272","39","757","1073","0","70.55","41.57"
"63","000","00","060","0012","1085","683","396","287","45","728","1076","0","67.66","36.80"
"63","000","00","060","0012","1086","614","364","250","35","649","1088","0","59.65","33.46"
"63","000","00","060","0013","0000","3370","1915","1455","136","3506","5133","0","68.30","37.31"
"63","000","00","060","0013","1087","891","522","369","32","923","1338","0","68.98","39.01"
"63","000","00","060","0013","1088","843","486","357","35","878","1295","0","67.80","37.53"
"63","000","00","060","0013","1089","827","440","387","41","868","1240","0","70.00","35.48"
"63","000","00","060","0013","1090","809","467","342","28","837","1260","0","66.43","37.06"
"63","000","00","060","0014","0000","1277","798","479","53","1330","2091","0","63.61","38.16"
"63","000","00","060","0014","1091","597","361","236","25","622","1017","0","61.16","35.50"
"63","000","00","060","0014","1092","680","437","243","28","708","1074","0","65.92","40.69"
"63","000","00","060","0015","0000","1897","1133","764","88","1985","2842","0","69.85","39.87"
"63","000","00","060","0015","1093","867","528","339","48","915","1295","0","70.66","40.77"
"63","000","00","060","0015","1094","1030","605","425","40","1070","1547","0","69.17","39.11"
"63","000","00","060","0016","0000","2577","1473","1104","95","2672","3958","0","67.51","37.22"
"63","000","00","060","0016","1095","602","337","265","23","625","944","0","66.21","35.70"
"63","000","00","060","0016","1096","585","338","247","24","609","875","0","69.60","38.63"
"63","000","00","060","0016","1097","749","435","314","29","778","1151","0","67.59","37.79"
"63","000","00","060","0016","1098","641","363","278","19","660","988","0","66.80","36.74"
"63","000","00","060","0017","0000","1464","930","534","108","1572","2373","0","66.25","39.19"
"63","000","00","060","0017","1099","650","416","234","40","690","997","0","69.21","41.73"
"63","000","00","060","0017","1100","814","514","300","68","882","1376","0","64.10","37.35"
"63","000","00","060","0018","0000","2448","1423","1025","92","2540","3696","0","68.72","38.50"
"63","000","00","060","0018","1101","826","480","346","25","851","1201","0","70.86","39.97"
"63","000","00","060","0018","1102","820","471","349","27","847","1226","0","69.09","38.42"
"63","000","00","060","0018","1103","802","472","330","40","842","1269","0","66.35","37.19"
"63","000","00","060","0019","0000","1889","1182","707","94","1983","3835","0","51.71","30.82"
"63","000","00","060","0019","1104","603","380","223","32","635","876","0","72.49","43.38"
"63","000","00","060","0019","1105","668","431","237","31","699","2020","0","34.60","21.34"
"63","000","00","060","0019","1106","618","371","247","31","649","939","0","69.12","39.51"
"63","000","00","060","0020","0000","2510","1497","1013","136","2646","4038","0","65.53","37.07"
"63","000","00","060","0020","1107","577","378","199","48","625","1065","0","58.69","35.49"
"63","000","00","060","0020","1108","711","408","303","30","741","1093","0","67.80","37.33"
"63","000","00","060","0020","1109","619","372","247","41","660","979","0","67.42","38.00"
"63","000","00","060","0020","1110","603","339","264","17","620","901","0","68.81","37.62"
"63","000","00","060","0021","0000","3381","2027","1354","136","3517","5271","0","66.72","38.46"
"63","000","00","060","0021","1111","686","447","239","31","717","1068","0","67.13","41.85"
"63","000","00","060","0021","1112","639","360","279","26","665","1054","0","63.09","34.16"
"63","000","00","060","0021","1113","693","416","277","22","715","1058","0","67.58","39.32"
"63","000","00","060","0021","1114","743","448","295","28","771","1135","0","67.93","39.47"
"63","000","00","060","0021","1115","620","356","264","29","649","956","0","67.89","37.24"
"63","000","00","060","0022","0000","4137","2326","1811","193","4330","6385","0","67.82","36.43"
"63","000","00","060","0022","1116","582","330","252","27","609","911","0","66.85","36.22"
"63","000","00","060","0022","1117","576","340","236","32","608","910","0","66.81","37.36"
"63","000","00","060","0022","1118","688","373","315","22","710","1025","0","69.27","36.39"
"63","000","00","060","0022","1119","757","396","361","25","782","1125","0","69.51","35.20"
"63","000","00","060","0022","1120","788","439","349","55","843","1223","0","68.93","35.90"
"63","000","00","060","0022","1121","746","448","298","32","778","1191","0","65.32","37.62"
"63","000","00","060","0024","0000","2962","1764","1198","127","3089","4668","0","66.17","37.79"
"63","000","00","060","0024","1122","727","435","292","40","767","1180","0","65.00","36.86"
"63","000","00","060","0024","1123","782","466","316","42","824","1244","0","66.24","37.46"
"63","000","00","060","0024","1124","668","389","279","27","695","1087","0","63.94","35.79"
"63","000","00","060","0024","1125","785","474","311","18","803","1157","0","69.40","40.97"
"63","000","00","060","0025","0000","3588","1957","1631","138","3726","5345","0","69.71","36.61"
"63","000","00","060","0025","1126","654","364","290","40","694","1025","0","67.71","35.51"
"63","000","00","060","0025","1127","737","399","338","30","767","1094","0","70.11","36.47"
"63","000","00","060","0025","1128","706","380","326","25","731","1011","0","72.30","37.59"
"63","000","00","060","0025","1129","727","367","360","20","747","1079","0","69.23","34.01"
"63","000","00","060","0025","1130","764","447","317","23","787","1136","0","69.28","39.35"
"63","000","00","060","0026","0000","2455","1462","993","132","2587","3655","0","70.78","40.00"
"63","000","00","060","0026","1131","814","513","301","38","852","1208","0","70.53","42.47"
"63","000","00","060","0026","1132","846","466","380","46","892","1251","0","71.30","37.25"
"63","000","00","060","0026","1133","795","483","312","48","843","1196","0","70.48","40.38"
"63","000","00","070","0000","0000","92032","49888","42144","4776","96808","149552","172819","64.73","33.36"
"63","000","00","070","0001","0000","2617","1347","1270","131","2748","4418","0","62.20","30.49"
"63","000","00","070","0001","1250","690","363","327","40","730","1113","0","65.59","32.61"
"63","000","00","070","0001","1251","637","295","342","46","683","1114","0","61.31","26.48"
"63","000","00","070","0001","1252","647","342","305","20","667","1128","0","59.13","30.32"
"63","000","00","070","0001","1253","643","347","296","25","668","1063","0","62.84","32.64"
"63","000","00","070","0002","0000","1413","725","688","65","1478","2685","0","55.05","27.00"
"63","000","00","070","0002","1254","484","267","217","17","501","836","0","59.93","31.94"
"63","000","00","070","0002","1255","485","241","244","27","512","947","0","54.07","25.45"
"63","000","00","070","0002","1256","444","217","227","21","465","902","0","51.55","24.06"
"63","000","00","070","0003","0000","1889","989","900","61","1950","2995","0","65.11","33.02"
"63","000","00","070","0003","1257","776","387","389","27","803","1046","0","76.77","37.00"
"63","000","00","070","0003","1258","596","332","264","16","612","1018","0","60.12","32.61"
"63","000","00","070","0003","1259","517","270","247","18","535","931","0","57.47","29.00"
"63","000","00","070","0004","0000","3434","1885","1549","158","3592","5723","0","62.76","32.94"
"63","000","00","070","0004","1260","685","393","292","29","714","1102","0","64.79","35.66"
"63","000","00","070","0004","1261","629","336","293","33","662","1086","0","60.96","30.94"
"63","000","00","070","0004","1262","729","392","337","34","763","1259","0","60.60","31.14"
"63","000","00","070","0004","1263","682","373","309","19","701","1090","0","64.31","34.22"
"63","000","00","070","0004","1264","709","391","318","43","752","1186","0","63.41","32.97"
"63","000","00","070","0005","0000","3061","1727","1334","171","3232","5030","0","64.25","34.33"
"63","000","00","070","0005","1265","700","404","296","39","739","1200","0","61.58","33.67"
"63","000","00","070","0005","1266","731","402","329","43","774","1175","0","65.87","34.21"
"63","000","00","070","0005","1267","780","436","344","38","818","1298","0","63.02","33.59"
"63","000","00","070","0005","1268","850","485","365","51","901","1357","0","66.40","35.74"
"63","000","00","070","0006","0000","2950","1732","1218","156","3106","5032","0","61.72","34.42"
"63","000","00","070","0006","1269","812","471","341","33","845","1376","0","61.41","34.23"
"63","000","00","070","0006","1270","771","432","339","44","815","1260","0","64.68","34.29"
"63","000","00","070","0006","1271","666","407","259","28","694","1152","0","60.24","35.33"
"63","000","00","070","0006","1272","701","422","279","51","752","1244","0","60.45","33.92"
"63","000","00","070","0007","0000","2525","1491","1034","147","2672","4137","0","64.59","36.04"
"63","000","00","070","0007","1273","600","351","249","40","640","1047","0","61.13","33.52"
"63","000","00","070","0007","1274","727","427","300","35","762","1157","0","65.86","36.91"
"63","000","00","070","0007","1275","586","368","218","19","605","962","0","62.89","38.25"
"63","000","00","070","0007","1276","612","345","267","53","665","971","0","68.49","35.53"
"63","000","00","070","0008","0000","1945","1121","824","109","2054","3175","0","64.69","35.31"
"63","000","00","070","0008","1277","734","404","330","32","766","1218","0","62.89","33.17"
"63","000","00","070","0008","1278","581","343","238","27","608","906","0","67.11","37.86"
"63","000","00","070","0008","1279","630","374","256","50","680","1051","0","64.70","35.59"
"63","000","00","070","0009","0000","2514","1386","1128","116","2630","3844","0","68.42","36.06"
"63","000","00","070","0009","1280","723","411","312","46","769","1096","0","70.16","37.50"
"63","000","00","070","0009","1281","625","333","292","22","647","947","0","68.32","35.16"
"63","000","00","070","0009","1282","624","362","262","24","648","991","0","65.39","36.53"
"63","000","00","070","0009","1283","542","280","262","24","566","810","0","69.88","34.57"
"63","000","00","070","0010","0000","2496","1466","1030","111","2607","5177","0","50.36","28.32"
"63","000","00","070","0010","1284","712","450","262","34","746","2571","0","29.02","17.50"
"63","000","00","070","0010","1285","592","334","258","23","615","843","0","72.95","39.62"
"63","000","00","070","0010","1286","604","339","265","27","631","896","0","70.42","37.83"
"63","000","00","070","0010","1287","588","343","245","27","615","867","0","70.93","39.56"
"63","000","00","070","0011","0000","3694","2122","1572","173","3867","5757","0","67.17","36.86"
"63","000","00","070","0011","1305","572","343","229","27","599","946","0","63.32","36.26"
"63","000","00","070","0011","1306","738","424","314","35","773","1093","0","70.72","38.79"
"63","000","00","070","0011","1307","659","391","268","16","675","1014","0","66.57","38.56"
"63","000","00","070","0011","1308","876","516","360","43","919","1376","0","66.79","37.50"
"63","000","00","070","0011","1309","849","448","401","52","901","1328","0","67.85","33.73"
"63","000","00","070","0012","0000","2227","1269","958","99","2326","3647","0","63.78","34.80"
"63","000","00","070","0012","1310","764","448","316","17","781","1262","0","61.89","35.50"
"63","000","00","070","0012","1311","797","466","331","45","842","1260","0","66.83","36.98"
"63","000","00","070","0012","1312","666","355","311","37","703","1125","0","62.49","31.56"
"63","000","00","070","0013","0000","1745","651","1094","98","1843","2813","0","65.52","23.14"
"63","000","00","070","0013","1368","486","245","241","33","519","894","0","58.05","27.40"
"63","000","00","070","0013","1369","548","175","373","40","588","871","0","67.51","20.09"
"63","000","00","070","0013","1370","711","231","480","25","736","1048","0","70.23","22.04"
"63","000","00","070","0014","0000","4364","1678","2686","191","4555","6685","0","68.14","25.10"
"63","000","00","070","0014","1371","713","274","439","33","746","1059","0","70.44","25.87"
"63","000","00","070","0014","1372","706","244","462","32","738","1090","0","67.71","22.39"
"63","000","00","070","0014","1373","768","293","475","32","800","1177","0","67.97","24.89"
"63","000","00","070","0014","1374","730","312","418","35","765","1146","0","66.75","27.23"
"63","000","00","070","0014","1375","707","254","453","31","738","1081","0","68.27","23.50"
"63","000","00","070","0014","1376","740","301","439","28","768","1132","0","67.84","26.59"
"63","000","00","070","0015","0000","2888","1636","1252","177","3065","4512","0","67.93","36.26"
"63","000","00","070","0015","1298","766","484","282","43","809","1177","0","68.73","41.12"
"63","000","00","070","0015","1299","720","401","319","38","758","1108","0","68.41","36.19"
"63","000","00","070","0015","1300","722","385","337","45","767","1166","0","65.78","33.02"
"63","000","00","070","0015","1301","680","366","314","51","731","1061","0","68.90","34.50"
"63","000","00","070","0016","0000","3361","2007","1354","165","3526","5438","0","64.84","36.91"
"63","000","00","070","0016","1313","770","484","286","46","816","1226","0","66.56","39.48"
"63","000","00","070","0016","1314","602","359","243","35","637","976","0","65.27","36.78"
"63","000","00","070","0016","1315","727","439","288","29","756","1125","0","67.20","39.02"
"63","000","00","070","0016","1316","607","334","273","16","623","988","0","63.06","33.81"
"63","000","00","070","0016","1317","655","391","264","39","694","1123","0","61.80","34.82"
"63","000","00","070","0017","0000","2184","1193","991","157","2341","3539","0","66.15","33.71"
"63","000","00","070","0017","1302","754","414","340","51","805","1193","0","67.48","34.70"
"63","000","00","070","0017","1303","704","350","354","55","759","1159","0","65.49","30.20"
"63","000","00","070","0017","1304","726","429","297","51","777","1187","0","65.46","36.14"
"63","000","00","070","0018","0000","4356","2420","1936","235","4591","6905","0","66.49","35.05"
"63","000","00","070","0018","1292","667","338","329","46","713","1137","0","62.71","29.73"
"63","000","00","070","0018","1293","758","436","322","38","796","1163","0","68.44","37.49"
"63","000","00","070","0018","1294","741","395","346","26","767","1106","0","69.35","35.71"
"63","000","00","070","0018","1295","804","462","342","43","847","1164","0","72.77","39.69"
"63","000","00","070","0018","1296","760","447","313","46","806","1193","0","67.56","37.47"
"63","000","00","070","0018","1297","626","342","284","36","662","1142","0","57.97","29.95"
"63","000","00","070","0019","0000","2439","1510","929","128","2567","4205","0","61.05","35.91"
"63","000","00","070","0019","1288","538","316","222","25","563","961","0","58.58","32.88"
"63","000","00","070","0019","1289","671","416","255","33","704","1132","0","62.19","36.75"
"63","000","00","070","0019","1290","625","393","232","35","660","1050","0","62.86","37.43"
"63","000","00","070","0019","1291","605","385","220","35","640","1062","0","60.26","36.25"
"63","000","00","070","0020","0000","1933","1053","880","85","2018","2931","0","68.85","35.93"
"63","000","00","070","0020","1326","592","305","287","26","618","932","0","66.31","32.73"
"63","000","00","070","0020","1327","656","379","277","29","685","991","0","69.12","38.24"
"63","000","00","070","0020","1328","685","369","316","30","715","1008","0","70.93","36.61"
"63","000","00","070","0021","0000","2686","1271","1415","164","2850","4877","0","58.44","26.06"
"63","000","00","070","0021","1377","602","306","296","39","641","1119","0","57.28","27.35"
"63","000","00","070","0021","1378","467","258","209","38","505","877","0","57.58","29.42"
"63","000","00","070","0021","1379","470","236","234","24","494","870","0","56.78","27.13"
"63","000","00","070","0021","1380","611","259","352","38","649","1101","0","58.95","23.52"
"63","000","00","070","0021","1381","536","212","324","25","561","910","0","61.65","23.30"
"63","000","00","070","0022","0000","2383","1359","1024","91","2474","3659","0","67.61","37.14"
"63","000","00","070","0022","1329","800","485","315","38","838","1258","0","66.61","38.55"
"63","000","00","070","0022","1330","762","408","354","19","781","1144","0","68.27","35.66"
"63","000","00","070","0022","1331","821","466","355","34","855","1257","0","68.02","37.07"
"63","000","00","070","0023","0000","1799","1096","703","96","1895","2661","0","71.21","41.19"
"63","000","00","070","0023","1336","923","589","334","35","958","1306","0","73.35","45.10"
"63","000","00","070","0023","1337","876","507","369","61","937","1355","0","69.15","37.42"
"63","000","00","070","0024","0000","3012","1794","1218","199","3211","5260","0","61.05","34.11"
"63","000","00","070","0024","1318","617","383","234","33","650","1067","0","60.92","35.90"
"63","000","00","070","0024","1319","610","371","239","45","655","1066","0","61.44","34.80"
"63","000","00","070","0024","1320","435","271","164","49","484","851","0","56.87","31.84"
"63","000","00","070","0024","1321","635","341","294","50","685","1129","0","60.67","30.20"
"63","000","00","070","0024","1322","715","428","287","22","737","1147","0","64.25","37.31"
"63","000","00","070","0025","0000","2890","1684","1206","141","3031","4579","0","66.19","36.78"
"63","000","00","070","0025","1332","726","385","341","47","773","1151","0","67.16","33.45"
"63","000","00","070","0025","1333","733","428","305","31","764","1184","0","64.53","36.15"
"63","000","00","070","0025","1334","754","450","304","27","781","1206","0","64.76","37.31"
"63","000","00","070","0025","1335","677","421","256","36","713","1038","0","68.69","40.56"
"63","000","00","070","0026","0000","2202","1201","1001","98","2300","3442","0","66.82","34.89"
"63","000","00","070","0026","1323","644","357","287","46","690","1067","0","64.67","33.46"
"63","000","00","070","0026","1324","807","470","337","28","835","1261","0","66.22","37.27"
"63","000","00","070","0026","1325","751","374","377","24","775","1114","0","69.57","33.57"
"63","000","00","070","0027","0000","1637","901","736","89","1726","2574","0","67.06","35.00"
"63","000","00","070","0027","1345","642","367","275","28","670","968","0","69.21","37.91"
"63","000","00","070","0027","1346","494","265","229","32","526","788","0","66.75","33.63"
"63","000","00","070","0027","1347","501","269","232","29","530","818","0","64.79","32.89"
"63","000","00","070","0028","0000","2411","1396","1015","118","2529","3795","0","66.64","36.79"
"63","000","00","070","0028","1342","819","471","348","41","860","1274","0","67.50","36.97"
"63","000","00","070","0028","1343","839","484","355","26","865","1275","0","67.84","37.96"
"63","000","00","070","0028","1344","753","441","312","51","804","1246","0","64.53","35.39"
"63","000","00","070","0029","0000","1829","1036","793","119","1948","2930","0","66.48","35.36"
"63","000","00","070","0029","1348","637","370","267","34","671","974","0","68.89","37.99"
"63","000","00","070","0029","1349","594","343","251","53","647","974","0","66.43","35.22"
"63","000","00","070","0029","1350","598","323","275","32","630","982","0","64.15","32.89"
"63","000","00","070","0030","0000","2567","1438","1129","106","2673","4034","0","66.26","35.65"
"63","000","00","070","0030","1338","633","354","279","27","660","1011","0","65.28","35.01"
"63","000","00","070","0030","1339","714","413","301","21","735","1094","0","67.18","37.75"
"63","000","00","070","0030","1340","594","318","276","27","621","971","0","63.95","32.75"
"63","000","00","070","0030","1341","626","353","273","31","657","958","0","68.58","36.85"
"63","000","00","070","0031","0000","2208","1273","935","133","2341","3728","0","62.80","34.15"
"63","000","00","070","0031","1356","696","396","300","42","738","1164","0","63.40","34.02"
"63","000","00","070","0031","1357","794","464","330","34","828","1278","0","64.79","36.31"
"63","000","00","070","0031","1358","718","413","305","57","775","1286","0","60.26","32.12"
"63","000","00","070","0032","0000","3246","1846","1400","190","3436","5011","0","68.57","36.84"
"63","000","00","070","0032","1351","719","414","305","40","759","1089","0","69.70","38.02"
"63","000","00","070","0032","1352","561","291","270","36","597","899","0","66.41","32.37"
"63","000","00","070","0032","1353","693","392","301","46","739","1050","0","70.38","37.33"
"63","000","00","070","0032","1354","730","442","288","36","766","1099","0","69.70","40.22"
"63","000","00","070","0032","1355","543","307","236","32","575","874","0","65.79","35.13"
"63","000","00","070","0033","0000","3183","1498","1685","193","3376","4929","0","68.49","30.39"
"63","000","00","070","0033","1359","574","327","247","50","624","945","0","66.03","34.60"
"63","000","00","070","0033","1360","633","331","302","34","667","989","0","67.44","33.47"
"63","000","00","070","0033","1361","727","245","482","41","768","1121","0","68.51","21.86"
"63","000","00","070","0033","1362","645","273","372","39","684","952","0","71.85","28.68"
"63","000","00","070","0033","1363","604","322","282","29","633","922","0","68.66","34.92"
"63","000","00","070","0034","0000","2473","1074","1399","150","2623","3965","0","66.15","27.09"
"63","000","00","070","0034","1364","658","247","411","55","713","1003","0","71.09","24.63"
"63","000","00","070","0034","1365","657","248","409","18","675","1015","0","66.50","24.43"
"63","000","00","070","0034","1366","589","298","291","31","620","1008","0","61.51","29.56"
"63","000","00","070","0034","1367","569","281","288","46","615","939","0","65.50","29.93"
"63","000","00","070","0035","0000","1861","848","1013","96","1957","2963","0","66.05","28.62"
"63","000","00","070","0035","1382","639","291","348","28","667","990","0","67.37","29.39"
"63","000","00","070","0035","1383","608","286","322","25","633","966","0","65.53","29.61"
"63","000","00","070","0035","1384","614","271","343","43","657","1007","0","65.24","26.91"
"63","000","00","070","0036","0000","1610","765","845","60","1670","2497","0","66.88","30.64"
"63","000","00","070","0036","1385","791","363","428","25","816","1244","0","65.59","29.18"
"63","000","00","070","0036","1386","819","402","417","35","854","1253","0","68.16","32.08"
"63","000","00","080","0000","0000","134823","61996","72827","5427","140250","210846","256418","66.52","29.40"
"63","000","00","080","0001","0000","3876","1982","1894","115","3991","6073","0","65.72","32.64"
"63","000","00","080","0001","1581","770","408","362","30","800","1233","0","64.88","33.09"
"63","000","00","080","0001","1582","774","390","384","16","790","1227","0","64.38","31.78"
"63","000","00","080","0001","1583","768","390","378","15","783","1188","0","65.91","32.83"
"63","000","00","080","0001","1584","746","378","368","23","769","1219","0","63.08","31.01"
"63","000","00","080","0001","1585","818","416","402","31","849","1206","0","70.40","34.49"
"63","000","00","080","0002","0000","3496","1528","1968","167","3663","5681","0","64.48","26.90"
"63","000","00","080","0002","1586","870","391","479","38","908","1438","0","63.14","27.19"
"63","000","00","080","0002","1587","867","384","483","52","919","1434","0","64.09","26.78"
"63","000","00","080","0002","1588","904","393","511","40","944","1429","0","66.06","27.50"
"63","000","00","080","0002","1589","855","360","495","37","892","1380","0","64.64","26.09"
"63","000","00","080","0003","0000","2605","1210","1395","92","2697","4003","0","67.37","30.23"
"63","000","00","080","0003","1590","866","405","461","27","893","1352","0","66.05","29.96"
"63","000","00","080","0003","1591","835","369","466","35","870","1274","0","68.29","28.96"
"63","000","00","080","0003","1592","904","436","468","30","934","1377","0","67.83","31.66"
"63","000","00","080","0004","0000","3347","1595","1752","135","3482","5091","0","68.40","31.33"
"63","000","00","080","0004","1593","817","381","436","25","842","1248","0","67.47","30.53"
"63","000","00","080","0004","1594","820","393","427","42","862","1262","0","68.30","31.14"
"63","000","00","080","0004","1595","864","410","454","35","899","1323","0","67.95","30.99"
"63","000","00","080","0004","1596","846","411","435","33","879","1258","0","69.87","32.67"
"63","000","00","080","0005","0000","2986","1372","1614","101","3087","4507","0","68.49","30.44"
"63","000","00","080","0005","1597","656","320","336","35","691","1074","0","64.34","29.80"
"63","000","00","080","0005","1598","793","361","432","22","815","1174","0","69.42","30.75"
"63","000","00","080","0005","1599","805","366","439","21","826","1193","0","69.24","30.68"
"63","000","00","080","0005","1600","732","325","407","23","755","1066","0","70.83","30.49"
"63","000","00","080","0006","0000","2844","1330","1514","155","2999","4437","0","67.59","29.98"
"63","000","00","080","0006","1601","693","298","395","34","727","1084","0","67.07","27.49"
"63","000","00","080","0006","1602","667","319","348","41","708","1060","0","66.79","30.09"
"63","000","00","080","0006","1603","728","336","392","35","763","1128","0","67.64","29.79"
"63","000","00","080","0006","1604","756","377","379","45","801","1165","0","68.76","32.36"
"63","000","00","080","0007","0000","2996","1375","1621","81","3077","4388","0","70.12","31.34"
"63","000","00","080","0007","1605","708","341","367","27","735","1057","0","69.54","32.26"
"63","000","00","080","0007","1606","792","361","431","23","815","1196","0","68.14","30.18"
"63","000","00","080","0007","1607","726","347","379","12","738","1067","0","69.17","32.52"
"63","000","00","080","0007","1608","770","326","444","19","789","1068","0","73.88","30.52"
"63","000","00","080","0008","0000","2393","1161","1232","80","2473","3573","0","69.21","32.49"
"63","000","00","080","0008","1609","757","383","374","32","789","1165","0","67.73","32.88"
"63","000","00","080","0008","1610","830","384","446","24","854","1203","0","70.99","31.92"
"63","000","00","080","0008","1611","806","394","412","24","830","1205","0","68.88","32.70"
"63","000","00","080","0009","0000","3848","1732","2116","132","3980","5690","0","69.95","30.44"
"63","000","00","080","0009","1612","773","316","457","14","787","1191","0","66.08","26.53"
"63","000","00","080","0009","1613","761","337","424","28","789","1136","0","69.45","29.67"
"63","000","00","080","0009","1614","768","334","434","25","793","1122","0","70.68","29.77"
"63","000","00","080","0009","1615","766","374","392","38","804","1090","0","73.76","34.31"
"63","000","00","080","0009","1616","780","371","409","27","807","1151","0","70.11","32.23"
"63","000","00","080","0010","0000","2728","1281","1447","118","2846","4245","0","67.04","30.18"
"63","000","00","080","0010","1617","662","326","336","30","692","1069","0","64.73","30.50"
"63","000","00","080","0010","1618","669","301","368","38","707","1044","0","67.72","28.83"
"63","000","00","080","0010","1619","723","337","386","23","746","1069","0","69.78","31.52"
"63","000","00","080","0010","1620","674","317","357","27","701","1063","0","65.95","29.82"
"63","000","00","080","0011","0000","1737","673","1064","92","1829","2723","0","67.17","24.72"
"63","000","00","080","0011","1621","863","359","504","50","913","1372","0","66.55","26.17"
"63","000","00","080","0011","1622","874","314","560","42","916","1351","0","67.80","23.24"
"63","000","00","080","0012","0000","2442","1151","1291","63","2505","3809","0","65.77","30.22"
"63","000","00","080","0012","1623","748","378","370","33","781","1223","0","63.86","30.91"
"63","000","00","080","0012","1624","799","393","406","22","821","1252","0","65.58","31.39"
"63","000","00","080","0012","1625","895","380","515","8","903","1334","0","67.69","28.49"
"63","000","00","080","0013","0000","2558","1236","1322","113","2671","3927","0","68.02","31.47"
"63","000","00","080","0013","1626","827","422","405","49","876","1353","0","64.75","31.19"
"63","000","00","080","0013","1627","856","400","456","39","895","1330","0","67.29","30.08"
"63","000","00","080","0013","1628","875","414","461","25","900","1244","0","72.35","33.28"
"63","000","00","080","0014","0000","1900","902","998","84","1984","3178","0","62.43","28.38"
"63","000","00","080","0014","1632","684","349","335","35","719","1143","0","62.90","30.53"
"63","000","00","080","0014","1633","569","274","295","25","594","1041","0","57.06","26.32"
"63","000","00","080","0014","1634","647","279","368","24","671","994","0","67.51","28.07"
"63","000","00","080","0015","0000","3859","1746","2113","153","4012","6029","0","66.55","28.96"
"63","000","00","080","0015","1635","844","378","466","33","877","1279","0","68.57","29.55"
"63","000","00","080","0015","1636","767","336","431","27","794","1165","0","68.15","28.84"
"63","000","00","080","0015","1637","736","358","378","30","766","1158","0","66.15","30.92"
"63","000","00","080","0015","1638","772","314","458","37","809","1232","0","65.67","25.49"
"63","000","00","080","0015","1639","740","360","380","26","766","1195","0","64.10","30.13"
"63","000","00","080","0016","0000","3040","1359","1681","139","3179","4975","0","63.90","27.32"
"63","000","00","080","0016","1640","825","394","431","48","873","1424","0","61.31","27.67"
"63","000","00","080","0016","1641","824","358","466","32","856","1316","0","65.05","27.20"
"63","000","00","080","0016","1642","732","314","418","45","777","1240","0","62.66","25.32"
"63","000","00","080","0016","1643","659","293","366","14","673","995","0","67.64","29.45"
"63","000","00","080","0017","0000","2717","1151","1566","99","2816","4275","0","65.87","26.92"
"63","000","00","080","0017","1644","702","293","409","17","719","1061","0","67.77","27.62"
"63","000","00","080","0017","1645","642","276","366","38","680","1036","0","65.64","26.64"
"63","000","00","080","0017","1646","625","256","369","17","642","994","0","64.59","25.75"
"63","000","00","080","0017","1647","748","326","422","27","775","1184","0","65.46","27.53"
"63","000","00","080","0018","0000","3652","1559","2093","128","3780","5392","0","70.10","28.91"
"63","000","00","080","0018","1648","908","414","494","22","930","1333","0","69.77","31.06"
"63","000","00","080","0018","1649","885","371","514","40","925","1412","0","65.51","26.27"
"63","000","00","080","0018","1650","973","418","555","41","1014","1374","0","73.80","30.42"
"63","000","00","080","0018","1651","886","356","530","25","911","1273","0","71.56","27.97"
"63","000","00","080","0019","0000","2939","1375","1564","99","3038","4415","0","68.81","31.14"
"63","000","00","080","0019","1652","731","338","393","11","742","1045","0","71.00","32.34"
"63","000","00","080","0019","1653","680","323","357","31","711","1071","0","66.39","30.16"
"63","000","00","080","0019","1654","681","331","350","32","713","1039","0","68.62","31.86"
"63","000","00","080","0019","1655","847","383","464","25","872","1260","0","69.21","30.40"
"63","000","00","080","0020","0000","4403","1948","2455","139","4542","6721","0","67.58","28.98"
"63","000","00","080","0020","1656","763","343","420","27","790","1147","0","68.88","29.90"
"63","000","00","080","0020","1657","770","331","439","20","790","1143","0","69.12","28.96"
"63","000","00","080","0020","1658","764","330","434","22","786","1165","0","67.47","28.33"
"63","000","00","080","0020","1659","711","315","396","24","735","1088","0","67.56","28.95"
"63","000","00","080","0020","1660","689","315","374","22","711","1078","0","65.96","29.22"
"63","000","00","080","0020","1661","706","314","392","24","730","1100","0","66.36","28.55"
"63","000","00","080","0021","0000","2267","1078","1189","108","2375","3414","0","69.57","31.58"
"63","000","00","080","0021","1662","714","321","393","16","730","1043","0","69.99","30.78"
"63","000","00","080","0021","1663","772","380","392","42","814","1139","0","71.47","33.36"
"63","000","00","080","0021","1664","781","377","404","50","831","1232","0","67.45","30.60"
"63","000","00","080","0022","0000","3250","1537","1713","137","3387","5314","0","63.74","28.92"
"63","000","00","080","0022","1665","782","335","447","35","817","1307","0","62.51","25.63"
"63","000","00","080","0022","1666","812","387","425","18","830","1340","0","61.94","28.88"
"63","000","00","080","0022","1667","779","375","404","45","824","1331","0","61.91","28.17"
"63","000","00","080","0022","1668","877","440","437","39","916","1336","0","68.56","32.93"
"63","000","00","080","0023","0000","3688","1570","2118","134","3822","5550","0","68.86","28.29"
"63","000","00","080","0023","1669","721","348","373","18","739","1091","0","67.74","31.90"
"63","000","00","080","0023","1670","687","264","423","38","725","1055","0","68.72","25.02"
"63","000","00","080","0023","1671","687","278","409","20","707","1043","0","67.79","26.65"
"63","000","00","080","0023","1672","768","325","443","26","794","1154","0","68.80","28.16"
"63","000","00","080","0023","1673","825","355","470","32","857","1207","0","71.00","29.41"
"63","000","00","080","0024","0000","4587","2049","2538","179","4766","7153","0","66.63","28.65"
"63","000","00","080","0024","1674","808","366","442","26","834","1223","0","68.19","29.93"
"63","000","00","080","0024","1675","751","323","428","24","775","1144","0","67.74","28.23"
"63","000","00","080","0024","1676","767","341","426","29","796","1179","0","67.51","28.92"
"63","000","00","080","0024","1677","734","332","402","35","769","1204","0","63.87","27.57"
"63","000","00","080","0024","1678","793","354","439","27","820","1244","0","65.92","28.46"
"63","000","00","080","0024","1679","734","333","401","38","772","1159","0","66.61","28.73"
"63","000","00","080","0025","0000","1947","968","979","103","2050","3373","0","60.78","28.70"
"63","000","00","080","0025","1680","632","320","312","40","672","1176","0","57.14","27.21"
"63","000","00","080","0025","1681","798","407","391","38","836","1309","0","63.87","31.09"
"63","000","00","080","0025","1682","517","241","276","25","542","888","0","61.04","27.14"
"63","000","00","080","0026","0000","3506","1552","1954","124","3630","5522","0","65.74","28.11"
"63","000","00","080","0026","1683","828","368","460","33","861","1315","0","65.48","27.98"
"63","000","00","080","0026","1684","800","340","460","40","840","1371","0","61.27","24.80"
"63","000","00","080","0026","1685","919","417","502","18","937","1373","0","68.24","30.37"
"63","000","00","080","0026","1686","959","427","532","33","992","1463","0","67.81","29.19"
"63","000","00","080","0027","0000","4895","2076","2819","171","5066","7439","0","68.10","27.91"
"63","000","00","080","0027","1687","838","360","478","30","868","1233","0","70.40","29.20"
"63","000","00","080","0027","1688","842","373","469","25","867","1288","0","67.31","28.96"
"63","000","00","080","0027","1689","830","369","461","33","863","1255","0","68.76","29.40"
"63","000","00","080","0027","1690","729","301","428","24","753","1131","0","66.58","26.61"
"63","000","00","080","0027","1691","805","329","476","23","828","1198","0","69.12","27.46"
"63","000","00","080","0027","1692","851","344","507","36","887","1334","0","66.49","25.79"
"63","000","00","080","0028","0000","4481","2211","2270","268","4749","8466","0","56.09","26.12"
"63","000","00","080","0028","1693","834","435","399","44","878","2367","0","37.09","18.38"
"63","000","00","080","0028","1694","707","357","350","36","743","1171","0","63.45","30.49"
"63","000","00","080","0028","1695","679","319","360","35","714","1149","0","62.14","27.76"
"63","000","00","080","0028","1696","706","329","377","51","757","1268","0","59.70","25.95"
"63","000","00","080","0028","1697","761","375","386","48","809","1232","0","65.67","30.44"
"63","000","00","080","0028","1698","794","396","398","54","848","1279","0","66.30","30.96"
"63","000","00","080","0029","0000","3886","1826","2060","182","4068","5947","0","68.40","30.70"
"63","000","00","080","0029","1699","673","332","341","57","730","1098","0","66.48","30.24"
"63","000","00","080","0029","1700","769","369","400","26","795","1128","0","70.48","32.71"
"63","000","00","080","0029","1701","797","375","422","38","835","1214","0","68.78","30.89"
"63","000","00","080","0029","1702","711","328","383","36","747","1157","0","64.56","28.35"
"63","000","00","080","0029","1703","936","422","514","25","961","1350","0","71.19","31.26"
"63","000","00","080","0030","0000","4104","1794","2310","203","4307","6753","0","63.78","26.57"
"63","000","00","080","0030","1707","795","321","474","49","844","1364","0","61.88","23.53"
"63","000","00","080","0030","1708","783","350","433","42","825","1312","0","62.88","26.68"
"63","000","00","080","0030","1709","840","380","460","34","874","1343","0","65.08","28.29"
"63","000","00","080","0030","1710","856","415","441","38","894","1456","0","61.40","28.50"
"63","000","00","080","0030","1711","830","328","502","40","870","1278","0","68.08","25.67"
"63","000","00","080","0031","0000","2915","1274","1641","96","3011","4355","0","69.14","29.25"
"63","000","00","080","0031","1712","707","303","404","38","745","1143","0","65.18","26.51"
"63","000","00","080","0031","1713","758","322","436","15","773","1053","0","73.41","30.58"
"63","000","00","080","0031","1714","688","321","367","24","712","1066","0","66.79","30.11"
"63","000","00","080","0031","1715","762","328","434","19","781","1093","0","71.45","30.01"
"63","000","00","080","0032","0000","2824","1345","1479","123","2947","4435","0","66.45","30.33"
"63","000","00","080","0032","1720","690","324","366","35","725","1040","0","69.71","31.15"
"63","000","00","080","0032","1721","674","322","352","31","705","1089","0","64.74","29.57"
"63","000","00","080","0032","1722","748","352","396","21","769","1222","0","62.93","28.81"
"63","000","00","080","0032","1723","712","347","365","36","748","1084","0","69.00","32.01"
"63","000","00","080","0033","0000","4090","1880","2210","174","4264","6357","0","67.08","29.57"
"63","000","00","080","0033","1727","872","424","448","34","906","1315","0","68.90","32.24"
"63","000","00","080","0033","1728","752","341","411","28","780","1194","0","65.33","28.56"
"63","000","00","080","0033","1729","851","400","451","42","893","1318","0","67.75","30.35"
"63","000","00","080","0033","1730","869","392","477","41","910","1295","0","70.27","30.27"
"63","000","00","080","0033","1731","746","323","423","29","775","1235","0","62.75","26.15"
"63","000","00","080","0034","0000","2960","1424","1536","148","3108","4739","0","65.58","30.05"
"63","000","00","080","0034","1737","590","322","268","50","640","948","0","67.51","33.97"
"63","000","00","080","0034","1738","631","310","321","17","648","1027","0","63.10","30.19"
"63","000","00","080","0034","1739","594","300","294","28","622","927","0","67.10","32.36"
"63","000","00","080","0034","1740","534","225","309","33","567","930","0","60.97","24.19"
"63","000","00","080","0034","1741","611","267","344","20","631","907","0","69.57","29.44"
"63","000","00","080","0035","0000","4484","2114","2370","147","4631","6701","0","69.11","31.55"
"63","000","00","080","0035","1742","910","436","474","30","940","1372","0","68.51","31.78"
"63","000","00","080","0035","1743","899","413","486","33","932","1357","0","68.68","30.43"
"63","000","00","080","0035","1744","974","462","512","27","1001","1399","0","71.55","33.02"
"63","000","00","080","0035","1745","873","397","476","15","888","1271","0","69.87","31.24"
"63","000","00","080","0035","1746","828","406","422","42","870","1302","0","66.82","31.18"
"63","000","00","080","0036","0000","2107","1063","1044","96","2203","3350","0","65.76","31.73"
"63","000","00","080","0036","1752","839","408","431","40","879","1308","0","67.20","31.19"
"63","000","00","080","0036","1753","792","381","411","26","818","1244","0","65.76","30.63"
"63","000","00","080","0036","1754","476","274","202","30","506","798","0","63.41","34.34"
"63","000","00","080","0037","0000","519","281","238","34","553","733","0","75.44","38.34"
"63","000","00","080","0037","1755","519","281","238","34","553","733","0","75.44","38.34"
"63","000","00","080","0038","0000","2246","1000","1246","103","2349","3459","0","67.91","28.91"
"63","000","00","080","0038","1704","746","346","400","36","782","1162","0","67.30","29.78"
"63","000","00","080","0038","1705","755","327","428","45","800","1159","0","69.03","28.21"
"63","000","00","080","0038","1706","745","327","418","22","767","1138","0","67.40","28.73"
"63","000","00","080","0039","0000","3663","1617","2046","165","3828","5918","0","64.68","27.32"
"63","000","00","080","0039","1732","746","371","375","35","781","1169","0","66.81","31.74"
"63","000","00","080","0039","1733","675","289","386","23","698","1145","0","60.96","25.24"
"63","000","00","080","0039","1734","776","341","435","36","812","1189","0","68.29","28.68"
"63","000","00","080","0039","1735","733","317","416","40","773","1262","0","61.25","25.12"
"63","000","00","080","0039","1736","733","299","434","31","764","1153","0","66.26","25.93"
"63","000","00","080","0040","0000","3881","1883","1998","86","3967","5930","0","66.90","31.75"
"63","000","00","080","0040","1747","629","313","316","21","650","968","0","67.15","32.33"
"63","000","00","080","0040","1748","743","351","392","17","760","1156","0","65.74","30.36"
"63","000","00","080","0040","1749","820","427","393","29","849","1247","0","68.08","34.24"
"63","000","00","080","0040","1750","847","423","424","7","854","1281","0","66.67","33.02"
"63","000","00","080","0040","1751","842","369","473","12","854","1278","0","66.82","28.87"
"63","000","00","080","0041","0000","3157","1496","1661","142","3299","4939","0","66.79","30.29"
"63","000","00","080","0041","1716","852","418","434","29","881","1287","0","68.45","32.48"
"63","000","00","080","0041","1717","788","364","424","28","816","1214","0","67.22","29.98"
"63","000","00","080","0041","1718","773","356","417","41","814","1226","0","66.39","29.04"
"63","000","00","080","0041","1719","744","358","386","44","788","1212","0","65.02","29.54"
"63","000","00","080","0042","0000","2616","1102","1514","101","2717","4109","0","66.12","26.82"
"63","000","00","080","0042","1629","810","352","458","45","855","1323","0","64.63","26.61"
"63","000","00","080","0042","1630","929","415","514","26","955","1419","0","67.30","29.25"
"63","000","00","080","0042","1631","877","335","542","30","907","1367","0","66.35","24.51"
"63","000","00","080","0043","0000","2384","1190","1194","118","2502","3758","0","66.58","31.67"
"63","000","00","080","0043","1724","783","386","397","40","823","1225","0","67.18","31.51"
"63","000","00","080","0043","1725","797","401","396","35","832","1253","0","66.40","32.00"
"63","000","00","080","0043","1726","804","403","401","43","847","1280","0","66.17","31.48"
"63","000","00","090","0000","0000","58924","30412","28512","2819","61743","94771","113612","65.15","32.09"
"63","000","00","090","0001","0000","2942","1573","1369","144","3086","5311","0","58.11","29.62"
"63","000","00","090","0001","0517","619","339","280","24","643","1066","0","60.32","31.80"
"63","000","00","090","0001","0518","823","445","378","41","864","1337","0","64.62","33.28"
"63","000","00","090","0001","0519","738","392","346","52","790","1216","0","64.97","32.24"
"63","000","00","090","0001","0520","762","397","365","27","789","1692","0","46.63","23.46"
"63","000","00","090","0002","0000","1810","1000","810","82","1892","2928","0","64.62","34.15"
"63","000","00","090","0002","0521","612","370","242","15","627","961","0","65.24","38.50"
"63","000","00","090","0002","0522","632","329","303","42","674","1062","0","63.47","30.98"
"63","000","00","090","0002","0523","566","301","265","25","591","905","0","65.30","33.26"
"63","000","00","090","0003","0000","2055","1124","931","108","2163","3116","0","69.42","36.07"
"63","000","00","090","0003","0529","628","325","303","35","663","944","0","70.23","34.43"
"63","000","00","090","0003","0530","719","419","300","33","752","1099","0","68.43","38.13"
"63","000","00","090","0003","0531","708","380","328","40","748","1073","0","69.71","35.41"
"63","000","00","090","0004","0000","3637","1934","1703","149","3786","6100","0","62.07","31.70"
"63","000","00","090","0004","0524","724","409","315","43","767","1203","0","63.76","34.00"
"63","000","00","090","0004","0525","724","391","333","24","748","1229","0","60.86","31.81"
"63","000","00","090","0004","0526","711","362","349","36","747","1207","0","61.89","29.99"
"63","000","00","090","0004","0527","726","395","331","21","747","1200","0","62.25","32.92"
"63","000","00","090","0004","0528","752","377","375","25","777","1261","0","61.62","29.90"
"63","000","00","090","0005","0000","3428","1864","1564","204","3632","5687","0","63.86","32.78"
"63","000","00","090","0005","0548","631","345","286","44","675","1143","0","59.06","30.18"
"63","000","00","090","0005","0549","737","388","349","41","778","1239","0","62.79","31.32"
"63","000","00","090","0005","0550","687","394","293","51","738","1115","0","66.19","35.34"
"63","000","00","090","0005","0551","707","369","338","29","736","1122","0","65.60","32.89"
"63","000","00","090","0005","0552","666","368","298","39","705","1068","0","66.01","34.46"
"63","000","00","090","0006","0000","1871","923","948","81","1952","3085","0","63.27","29.92"
"63","000","00","090","0006","0572","608","311","297","20","628","1063","0","59.08","29.26"
"63","000","00","090","0006","0573","689","326","363","30","719","1057","0","68.02","30.84"
"63","000","00","090","0006","0574","574","286","288","31","605","965","0","62.69","29.64"
"63","000","00","090","0007","0000","2944","1448","1496","116","3060","4610","0","66.38","31.41"
"63","000","00","090","0007","0557","776","391","385","26","802","1155","0","69.44","33.85"
"63","000","00","090","0007","0558","693","316","377","39","732","1119","0","65.42","28.24"
"63","000","00","090","0007","0559","686","368","318","32","718","1151","0","62.38","31.97"
"63","000","00","090","0007","0560","789","373","416","19","808","1185","0","68.19","31.48"
"63","000","00","090","0008","0000","2394","1356","1038","146","2540","3786","0","67.09","35.82"
"63","000","00","090","0008","0561","805","440","365","52","857","1251","0","68.51","35.17"
"63","000","00","090","0008","0562","791","458","333","55","846","1261","0","67.09","36.32"
"63","000","00","090","0008","0563","798","458","340","39","837","1274","0","65.70","35.95"
"63","000","00","090","0009","0000","2468","1348","1120","132","2600","3877","0","67.06","34.77"
"63","000","00","090","0009","0564","843","480","363","53","896","1335","0","67.12","35.96"
"63","000","00","090","0009","0565","792","408","384","46","838","1249","0","67.09","32.67"
"63","000","00","090","0009","0566","833","460","373","33","866","1293","0","66.98","35.58"
"63","000","00","090","0010","0000","3341","1788","1553","169","3510","5391","0","65.11","33.17"
"63","000","00","090","0010","0567","609","330","279","38","647","968","0","66.84","34.09"
"63","000","00","090","0010","0568","714","391","323","31","745","1161","0","64.17","33.68"
"63","000","00","090","0010","0569","736","375","361","40","776","1160","0","66.90","32.33"
"63","000","00","090","0010","0570","645","351","294","25","670","1045","0","64.11","33.59"
"63","000","00","090","0010","0571","637","341","296","35","672","1057","0","63.58","32.26"
"63","000","00","090","0011","0000","3976","1874","2102","195","4171","6089","0","68.50","30.78"
"63","000","00","090","0011","0587","773","394","379","52","825","1298","0","63.56","30.35"
"63","000","00","090","0011","0588","861","358","503","37","898","1328","0","67.62","26.96"
"63","000","00","090","0011","0589","710","366","344","41","751","1094","0","68.65","33.46"
"63","000","00","090","0011","0590","853","398","455","37","890","1190","0","74.79","33.45"
"63","000","00","090","0011","0591","779","358","421","28","807","1179","0","68.45","30.36"
"63","000","00","090","0012","0000","2309","1103","1206","120","2429","3440","0","70.61","32.06"
"63","000","00","090","0012","0578","730","357","373","40","770","1098","0","70.13","32.51"
"63","000","00","090","0012","0579","774","413","361","31","805","1140","0","70.61","36.23"
"63","000","00","090","0012","0580","805","333","472","49","854","1202","0","71.05","27.70"
"63","000","00","090","0013","0000","2400","1207","1193","108","2508","3715","0","67.51","32.49"
"63","000","00","090","0013","0581","809","406","403","37","846","1266","0","66.82","32.07"
"63","000","00","090","0013","0582","780","384","396","31","811","1197","0","67.75","32.08"
"63","000","00","090","0013","0583","811","417","394","40","851","1252","0","67.97","33.31"
"63","000","00","090","0014","0000","2571","1373","1198","124","2695","4362","0","61.78","31.48"
"63","000","00","090","0014","0584","863","456","407","37","900","1455","0","61.86","31.34"
"63","000","00","090","0014","0585","849","463","386","30","879","1455","0","60.41","31.82"
"63","000","00","090","0014","0586","859","454","405","57","916","1452","0","63.09","31.27"
"63","000","00","090","0015","0000","2619","1276","1343","130","2749","3973","0","69.19","32.12"
"63","000","00","090","0015","0575","870","411","459","32","902","1315","0","68.59","31.25"
"63","000","00","090","0015","0576","906","459","447","43","949","1367","0","69.42","33.58"
"63","000","00","090","0015","0577","843","406","437","55","898","1291","0","69.56","31.45"
"63","000","00","090","0016","0000","4193","2204","1989","222","4415","7394","0","59.71","29.81"
"63","000","00","090","0016","0542","724","381","343","43","767","1294","0","59.27","29.44"
"63","000","00","090","0016","0543","770","435","335","46","816","1379","0","59.17","31.54"
"63","000","00","090","0016","0544","654","353","301","31","685","1142","0","59.98","30.91"
"63","000","00","090","0016","0545","738","354","384","40","778","1292","0","60.22","27.40"
"63","000","00","090","0016","0546","656","334","322","26","682","1122","0","60.78","29.77"
"63","000","00","090","0016","0547","651","347","304","36","687","1165","0","58.97","29.79"
"63","000","00","090","0017","0000","4807","2496","2311","208","5015","7486","0","66.99","33.34"
"63","000","00","090","0017","0532","794","429","365","44","838","1329","0","63.05","32.28"
"63","000","00","090","0017","0533","773","418","355","33","806","1186","0","67.96","35.24"
"63","000","00","090","0017","0534","785","445","340","30","815","1189","0","68.54","37.43"
"63","000","00","090","0017","0535","830","438","392","27","857","1289","0","66.49","33.98"
"63","000","00","090","0017","0536","816","371","445","42","858","1218","0","70.44","30.46"
"63","000","00","090","0017","0537","809","395","414","32","841","1275","0","65.96","30.98"
"63","000","00","090","0018","0000","3125","1530","1595","179","3304","5147","0","64.19","29.73"
"63","000","00","090","0018","0538","778","404","374","54","832","1321","0","62.98","30.58"
"63","000","00","090","0018","0539","826","326","500","49","875","1255","0","69.72","25.98"
"63","000","00","090","0018","0540","691","379","312","58","749","1243","0","60.26","30.49"
"63","000","00","090","0018","0541","830","421","409","18","848","1328","0","63.86","31.70"
"63","000","00","090","0019","0000","2994","1437","1557","117","3111","4552","0","68.34","31.57"
"63","000","00","090","0019","0592","705","326","379","30","735","1041","0","70.61","31.32"
"63","000","00","090","0019","0593","641","299","342","26","667","928","0","71.88","32.22"
"63","000","00","090","0019","0594","837","410","427","28","865","1251","0","69.14","32.77"
"63","000","00","090","0019","0595","811","402","409","33","844","1332","0","63.36","30.18"
"63","000","00","090","0020","0000","3040","1554","1486","85","3125","4722","0","66.18","32.91"
"63","000","00","090","0020","0553","641","347","294","24","665","1028","0","64.69","33.75"
"63","000","00","090","0020","0554","766","367","399","21","787","1134","0","69.40","32.36"
"63","000","00","090","0020","0555","775","396","379","18","793","1186","0","66.86","33.39"
"63","000","00","090","0020","0556","858","444","414","22","880","1374","0","64.05","32.31"
"63","000","00","100","0000","0000","139637","70158","69479","5356","144993","220986","271749","65.61","31.75"
"63","000","00","100","0001","0000","3757","1960","1797","174","3931","5754","0","68.32","34.06"
"63","000","00","100","0001","0352","702","377","325","47","749","1107","0","67.66","34.06"
"63","000","00","100","0001","0353","700","374","326","21","721","1101","0","65.49","33.97"
"63","000","00","100","0001","0354","779","450","329","29","808","1163","0","69.48","38.69"
"63","000","00","100","0001","0355","774","353","421","43","817","1170","0","69.83","30.17"
"63","000","00","100","0001","0356","802","406","396","34","836","1213","0","68.92","33.47"
"63","000","00","100","0002","0000","4957","2443","2514","188","5145","7746","0","66.42","31.54"
"63","000","00","100","0002","0357","783","419","364","30","813","1260","0","64.52","33.25"
"63","000","00","100","0002","0358","896","459","437","36","932","1337","0","69.71","34.33"
"63","000","00","100","0002","0359","905","445","460","25","930","1313","0","70.83","33.89"
"63","000","00","100","0002","0360","818","416","402","26","844","1394","0","60.55","29.84"
"63","000","00","100","0002","0361","785","390","395","23","808","1231","0","65.64","31.68"
"63","000","00","100","0002","0362","770","314","456","48","818","1211","0","67.55","25.93"
"63","000","00","100","0003","0000","3419","1691","1728","110","3529","5319","0","66.35","31.79"
"63","000","00","100","0003","0363","806","395","411","30","836","1226","0","68.19","32.22"
"63","000","00","100","0003","0364","839","406","433","30","869","1340","0","64.85","30.30"
"63","000","00","100","0003","0365","834","443","391","30","864","1301","0","66.41","34.05"
"63","000","00","100","0003","0366","940","447","493","20","960","1452","0","66.12","30.79"
"63","000","00","100","0005","0000","3158","1610","1548","123","3281","4771","0","68.77","33.75"
"63","000","00","100","0005","0367","804","414","390","40","844","1242","0","67.95","33.33"
"63","000","00","100","0005","0368","748","364","384","31","779","1105","0","70.50","32.94"
"63","000","00","100","0005","0369","849","453","396","25","874","1266","0","69.04","35.78"
"63","000","00","100","0005","0370","757","379","378","27","784","1158","0","67.70","32.73"
"63","000","00","100","0006","0000","2927","1537","1390","112","3039","4384","0","69.32","35.06"
"63","000","00","100","0006","0371","1055","563","492","25","1080","1570","0","68.79","35.86"
"63","000","00","100","0006","0372","930","477","453","39","969","1433","0","67.62","33.29"
"63","000","00","100","0006","0373","942","497","445","48","990","1381","0","71.69","35.99"
"63","000","00","100","0007","0000","4716","2470","2246","184","4900","7515","0","65.20","32.87"
"63","000","00","100","0007","0374","764","409","355","46","810","1232","0","65.75","33.20"
"63","000","00","100","0007","0375","853","474","379","42","895","1336","0","66.99","35.48"
"63","000","00","100","0007","0376","651","316","335","17","668","1147","0","58.24","27.55"
"63","000","00","100","0007","0377","1024","558","466","31","1055","1494","0","70.62","37.35"
"63","000","00","100","0007","0378","690","339","351","18","708","1146","0","61.78","29.58"
"63","000","00","100","0007","0379","734","374","360","30","764","1160","0","65.86","32.24"
"63","000","00","100","0008","0000","4731","2401","2330","157","4888","7279","0","67.15","32.99"
"63","000","00","100","0008","0380","924","429","495","25","949","1428","0","66.46","30.04"
"63","000","00","100","0008","0381","923","452","471","28","951","1488","0","63.91","30.38"
"63","000","00","100","0008","0382","922","439","483","37","959","1429","0","67.11","30.72"
"63","000","00","100","0008","0383","976","535","441","45","1021","1476","0","69.17","36.25"
"63","000","00","100","0008","0384","986","546","440","22","1008","1458","0","69.14","37.45"
"63","000","00","100","0009","0000","3339","1640","1699","137","3476","5323","0","65.30","30.81"
"63","000","00","100","0009","0385","857","430","427","37","894","1369","0","65.30","31.41"
"63","000","00","100","0009","0386","784","398","386","38","822","1312","0","62.65","30.34"
"63","000","00","100","0009","0387","818","401","417","36","854","1329","0","64.26","30.17"
"63","000","00","100","0009","0388","880","411","469","26","906","1313","0","69.00","31.30"
"63","000","00","100","0010","0000","4358","2057","2301","189","4547","6638","0","68.50","30.99"
"63","000","00","100","0010","0389","996","503","493","40","1036","1440","0","71.94","34.93"
"63","000","00","100","0010","0390","956","439","517","36","992","1451","0","68.37","30.25"
"63","000","00","100","0010","0391","901","447","454","31","932","1447","0","64.41","30.89"
"63","000","00","100","0010","0392","844","362","482","52","896","1272","0","70.44","28.46"
"63","000","00","100","0010","0393","661","306","355","30","691","1028","0","67.22","29.77"
"63","000","00","100","0011","0000","4240","2195","2045","175","4415","6529","0","67.62","33.62"
"63","000","00","100","0011","0394","942","486","456","38","980","1451","0","67.54","33.49"
"63","000","00","100","0011","0395","803","405","398","22","825","1232","0","66.96","32.87"
"63","000","00","100","0011","0396","869","446","423","45","914","1319","0","69.29","33.81"
"63","000","00","100","0011","0397","833","441","392","40","873","1272","0","68.63","34.67"
"63","000","00","100","0011","0398","793","417","376","30","823","1255","0","65.58","33.23"
"63","000","00","100","0012","0000","2839","1392","1447","89","2928","4350","0","67.31","32.00"
"63","000","00","100","0012","0399","918","441","477","26","944","1452","0","65.01","30.37"
"63","000","00","100","0012","0400","1015","473","542","42","1057","1480","0","71.42","31.96"
"63","000","00","100","0012","0401","906","478","428","21","927","1418","0","65.37","33.71"
"63","000","00","100","0013","0000","2778","1381","1397","132","2910","4426","0","65.75","31.20"
"63","000","00","100","0013","0402","987","467","520","50","1037","1531","0","67.73","30.50"
"63","000","00","100","0013","0403","866","432","434","51","917","1413","0","64.90","30.57"
"63","000","00","100","0013","0404","925","482","443","31","956","1482","0","64.51","32.52"
"63","000","00","100","0014","0000","3522","1805","1717","149","3671","5499","0","66.76","32.82"
"63","000","00","100","0014","0405","875","455","420","30","905","1379","0","65.63","32.99"
"63","000","00","100","0014","0406","931","477","454","47","978","1424","0","68.68","33.50"
"63","000","00","100","0014","0407","800","396","404","41","841","1292","0","65.09","30.65"
"63","000","00","100","0014","0408","916","477","439","31","947","1404","0","67.45","33.97"
"63","000","00","100","0015","0000","3703","1871","1832","143","3846","5802","0","66.29","32.25"
"63","000","00","100","0015","0409","222","153","69","16","238","390","0","61.03","39.23"
"63","000","00","100","0015","0410","975","484","491","37","1012","1536","0","65.89","31.51"
"63","000","00","100","0015","0411","864","431","433","34","898","1280","0","70.16","33.67"
"63","000","00","100","0015","0412","845","399","446","24","869","1275","0","68.16","31.29"
"63","000","00","100","0015","0413","797","404","393","32","829","1321","0","62.76","30.58"
"63","000","00","100","0016","0000","2881","1326","1555","107","2988","4589","0","65.11","28.90"
"63","000","00","100","0016","0414","750","345","405","28","778","1244","0","62.54","27.73"
"63","000","00","100","0016","0415","686","301","385","24","710","1046","0","67.88","28.78"
"63","000","00","100","0016","0416","666","299","367","25","691","1085","0","63.69","27.56"
"63","000","00","100","0016","0417","779","381","398","30","809","1214","0","66.64","31.38"
"63","000","00","100","0017","0000","4636","2325","2311","170","4806","6854","0","70.12","33.92"
"63","000","00","100","0017","0418","960","467","493","34","994","1436","0","69.22","32.52"
"63","000","00","100","0017","0419","950","478","472","30","980","1426","0","68.72","33.52"
"63","000","00","100","0017","0420","994","496","498","38","1032","1507","0","68.48","32.91"
"63","000","00","100","0017","0421","867","442","425","33","900","1205","0","74.69","36.68"
"63","000","00","100","0017","0422","865","442","423","35","900","1280","0","70.31","34.53"
"63","000","00","100","0018","0000","3516","1638","1878","123","3639","5650","0","64.41","28.99"
"63","000","00","100","0018","0423","902","432","470","28","930","1442","0","64.49","29.96"
"63","000","00","100","0018","0424","890","403","487","33","923","1466","0","62.96","27.49"
"63","000","00","100","0018","0425","852","397","455","28","880","1396","0","63.04","28.44"
"63","000","00","100","0018","0426","872","406","466","34","906","1346","0","67.31","30.16"
"63","000","00","100","0019","0000","4337","2243","2094","175","4512","6856","0","65.81","32.72"
"63","000","00","100","0019","0427","961","513","448","29","990","1489","0","66.49","34.45"
"63","000","00","100","0019","0428","711","393","318","31","742","1238","0","59.94","31.74"
"63","000","00","100","0019","0429","800","416","384","41","841","1309","0","64.25","31.78"
"63","000","00","100","0019","0430","842","400","442","30","872","1266","0","68.88","31.60"
"63","000","00","100","0019","0431","1023","521","502","44","1067","1554","0","68.66","33.53"
"63","000","00","100","0020","0000","4042","1794","2248","175","4217","6251","0","67.46","28.70"
"63","000","00","100","0020","0432","892","370","522","48","940","1414","0","66.48","26.17"
"63","000","00","100","0020","0433","817","381","436","30","847","1244","0","68.09","30.63"
"63","000","00","100","0020","0434","800","347","453","31","831","1215","0","68.40","28.56"
"63","000","00","100","0020","0435","766","405","361","33","799","1171","0","68.23","34.59"
"63","000","00","100","0020","0436","767","291","476","33","800","1207","0","66.28","24.11"
"63","000","00","100","0021","0000","2370","1105","1265","123","2493","3702","0","67.34","29.85"
"63","000","00","100","0021","0437","850","428","422","41","891","1350","0","66.00","31.70"
"63","000","00","100","0021","0438","758","345","413","52","810","1162","0","69.71","29.69"
"63","000","00","100","0021","0439","762","332","430","30","792","1190","0","66.55","27.90"
"63","000","00","100","0022","0000","4954","2589","2365","248","5202","8309","0","62.61","31.16"
"63","000","00","100","0022","0440","830","442","388","48","878","1343","0","65.38","32.91"
"63","000","00","100","0022","0441","797","396","401","40","837","1338","0","62.56","29.60"
"63","000","00","100","0022","0442","815","464","351","48","863","1393","0","61.95","33.31"
"63","000","00","100","0022","0443","798","422","376","51","849","1355","0","62.66","31.14"
"63","000","00","100","0022","0444","885","436","449","27","912","1465","0","62.25","29.76"
"63","000","00","100","0022","0445","829","429","400","34","863","1415","0","60.99","30.32"
"63","000","00","100","0023","0000","4084","2098","1986","131","4215","6608","0","63.79","31.75"
"63","000","00","100","0023","0446","843","461","382","23","866","1345","0","64.39","34.28"
"63","000","00","100","0023","0447","734","358","376","23","757","1229","0","61.59","29.13"
"63","000","00","100","0023","0448","831","424","407","34","865","1314","0","65.83","32.27"
"63","000","00","100","0023","0449","881","453","428","30","911","1431","0","63.66","31.66"
"63","000","00","100","0023","0450","795","402","393","21","816","1289","0","63.30","31.19"
"63","000","00","100","0024","0000","3831","1988","1843","161","3992","6502","0","61.40","30.58"
"63","000","00","100","0024","0451","755","395","360","27","782","1328","0","58.89","29.74"
"63","000","00","100","0024","0452","735","392","343","27","762","1260","0","60.48","31.11"
"63","000","00","100","0024","0453","780","396","384","28","808","1255","0","64.38","31.55"
"63","000","00","100","0024","0454","791","419","372","44","835","1357","0","61.53","30.88"
"63","000","00","100","0024","0455","770","386","384","35","805","1302","0","61.83","29.65"
"63","000","00","100","0025","0000","2487","1291","1196","92","2579","3777","0","68.28","34.18"
"63","000","00","100","0025","0456","734","376","358","32","766","1078","0","71.06","34.88"
"63","000","00","100","0025","0457","691","332","359","21","712","1092","0","65.20","30.40"
"63","000","00","100","0025","0458","641","310","331","23","664","929","0","71.47","33.37"
"63","000","00","100","0025","0459","421","273","148","16","437","678","0","64.45","40.27"
"63","000","00","100","0026","0000","4684","2498","2186","164","4848","7370","0","65.78","33.89"
"63","000","00","100","0026","0460","835","488","347","25","860","1432","0","60.06","34.08"
"63","000","00","100","0026","0461","952","519","433","39","991","1509","0","65.67","34.39"
"63","000","00","100","0026","0462","813","449","364","50","863","1312","0","65.78","34.22"
"63","000","00","100","0026","0463","1162","585","577","28","1190","1552","0","76.68","37.69"
"63","000","00","100","0026","0464","922","457","465","22","944","1565","0","60.32","29.20"
"63","000","00","100","0027","0000","3794","2012","1782","158","3952","5849","0","67.57","34.40"
"63","000","00","100","0027","0465","854","494","360","53","907","1326","0","68.40","37.25"
"63","000","00","100","0027","0466","950","521","429","46","996","1462","0","68.13","35.64"
"63","000","00","100","0027","0467","986","495","491","34","1020","1491","0","68.41","33.20"
"63","000","00","100","0027","0468","1004","502","502","25","1029","1570","0","65.54","31.97"
"63","000","00","100","0028","0000","1882","936","946","69","1951","3276","0","59.55","28.57"
"63","000","00","100","0028","0469","792","433","359","40","832","1353","0","61.49","32.00"
"63","000","00","100","0028","0470","720","331","389","23","743","1284","0","57.87","25.78"
"63","000","00","100","0028","0471","370","172","198","6","376","639","0","58.84","26.92"
"63","000","00","100","0029","0000","3817","1964","1853","169","3986","7224","0","55.18","27.19"
"63","000","00","100","0029","0472","931","483","448","59","990","1533","0","64.58","31.51"
"63","000","00","100","0029","0473","1017","521","496","44","1061","2780","0","38.17","18.74"
"63","000","00","100","0029","0474","887","416","471","29","916","1455","0","62.96","28.59"
"63","000","00","100","0029","0475","982","544","438","37","1019","1456","0","69.99","37.36"
"63","000","00","100","0030","0000","3021","1588","1433","139","3160","4703","0","67.19","33.77"
"63","000","00","100","0030","0476","999","507","492","55","1054","1529","0","68.93","33.16"
"63","000","00","100","0030","0477","1012","556","456","51","1063","1580","0","67.28","35.19"
"63","000","00","100","0030","0478","1010","525","485","33","1043","1594","0","65.43","32.94"
"63","000","00","100","0031","0000","3862","1908","1954","133","3995","6033","0","66.22","31.63"
"63","000","00","100","0031","0479","650","339","311","23","673","1095","0","61.46","30.96"
"63","000","00","100","0031","0480","736","375","361","18","754","1155","0","65.28","32.47"
"63","000","00","100","0031","0481","729","372","357","38","767","1141","0","67.22","32.60"
"63","000","00","100","0031","0482","885","396","489","23","908","1312","0","69.21","30.18"
"63","000","00","100","0031","0483","862","426","436","31","893","1330","0","67.14","32.03"
"63","000","00","100","0032","0000","3227","1527","1700","106","3333","5004","0","66.61","30.52"
"63","000","00","100","0032","0484","818","404","414","26","844","1240","0","68.06","32.58"
"63","000","00","100","0032","0485","781","394","387","28","809","1266","0","63.90","31.12"
"63","000","00","100","0032","0486","822","353","469","29","851","1254","0","67.86","28.15"
"63","000","00","100","0032","0487","806","376","430","23","829","1244","0","66.64","30.23"
"63","000","00","100","0033","0000","2707","1291","1416","130","2837","4355","0","65.14","29.64"
"63","000","00","100","0033","0488","975","460","515","55","1030","1594","0","64.62","28.86"
"63","000","00","100","0033","0489","936","437","499","45","981","1503","0","65.27","29.08"
"63","000","00","100","0033","0490","796","394","402","30","826","1258","0","65.66","31.32"
"63","000","00","100","0034","0000","4760","2413","2347","123","4883","7597","0","64.28","31.76"
"63","000","00","100","0034","0491","896","491","405","21","917","1512","0","60.65","32.47"
"63","000","00","100","0034","0492","920","457","463","26","946","1492","0","63.40","30.63"
"63","000","00","100","0034","0493","935","479","456","35","970","1517","0","63.94","31.58"
"63","000","00","100","0034","0494","1023","501","522","22","1045","1519","0","68.80","32.98"
"63","000","00","100","0034","0495","986","485","501","19","1005","1557","0","64.55","31.15"
"63","000","00","100","0035","0000","4428","2104","2324","117","4545","6963","0","65.27","30.22"
"63","000","00","100","0035","0496","815","363","452","20","835","1306","0","63.94","27.79"
"63","000","00","100","0035","0497","816","398","418","19","835","1303","0","64.08","30.54"
"63","000","00","100","0035","0498","874","429","445","15","889","1361","0","65.32","31.52"
"63","000","00","100","0035","0499","1011","469","542","43","1054","1606","0","65.63","29.20"
"63","000","00","100","0035","0500","912","445","467","20","932","1387","0","67.20","32.08"
"63","000","00","100","0036","0000","2747","1409","1338","117","2864","4303","0","66.56","32.74"
"63","000","00","100","0036","0501","943","466","477","46","989","1412","0","70.04","33.00"
"63","000","00","100","0036","0502","971","527","444","37","1008","1526","0","66.06","34.53"
"63","000","00","100","0036","0503","833","416","417","34","867","1365","0","63.52","30.48"
"63","000","00","100","0037","0000","576","308","268","22","598","1042","0","57.39","29.56"
"63","000","00","100","0037","0504","576","308","268","22","598","1042","0","57.39","29.56"
"63","000","00","100","0038","0000","2924","1618","1306","107","3031","4762","0","63.65","33.98"
"63","000","00","100","0038","0505","816","477","339","32","848","1272","0","66.67","37.50"
"63","000","00","100","0038","0506","694","358","336","30","724","1144","0","63.29","31.29"
"63","000","00","100","0038","0507","741","429","312","18","759","1268","0","59.86","33.83"
"63","000","00","100","0038","0508","673","354","319","27","700","1078","0","64.94","32.84"
"63","000","00","100","0039","0000","4847","2348","2499","179","5026","7688","0","65.37","30.54"
"63","000","00","100","0039","0509","979","458","521","33","1012","1546","0","65.46","29.62"
"63","000","00","100","0039","0510","969","464","505","41","1010","1491","0","67.74","31.12"
"63","000","00","100","0039","0511","936","413","523","51","987","1501","0","65.76","27.51"
"63","000","00","100","0039","0512","1010","515","495","29","1039","1557","0","66.73","33.08"
"63","000","00","100","0039","0513","953","498","455","25","978","1593","0","61.39","31.26"
"63","000","00","100","0040","0000","2779","1384","1395","56","2835","4384","0","64.67","31.57"
"63","000","00","100","0040","0514","876","424","452","18","894","1349","0","66.27","31.43"
"63","000","00","100","0040","0515","1098","532","566","29","1127","1753","0","64.29","30.35"
"63","000","00","100","0040","0516","805","428","377","9","814","1282","0","63.49","33.39"
"63","000","00","110","0000","0000","140010","76976","63034","6407","146417","219714","263360","66.64","35.03"
"63","000","00","110","0001","0000","2077","1212","865","137","2214","3129","0","70.76","38.73"
"63","000","00","110","0001","0170","694","426","268","69","763","1093","0","69.81","38.98"
"63","000","00","110","0001","0171","641","379","262","19","660","947","0","69.69","40.02"
"63","000","00","110","0001","0172","742","407","335","49","791","1089","0","72.64","37.37"
"63","000","00","110","0002","0000","1546","801","745","87","1633","2577","0","63.37","31.08"
"63","000","00","110","0002","0173","760","399","361","58","818","1286","0","63.61","31.03"
"63","000","00","110","0002","0174","786","402","384","29","815","1291","0","63.13","31.14"
"63","000","00","110","0003","0000","1493","833","660","75","1568","2356","0","66.55","35.36"
"63","000","00","110","0003","0175","356","167","189","23","379","588","0","64.46","28.40"
"63","000","00","110","0003","0176","449","256","193","22","471","757","0","62.22","33.82"
"63","000","00","110","0003","0177","688","410","278","30","718","1011","0","71.02","40.55"
"63","000","00","110","0004","0000","2407","1269","1138","90","2497","4786","0","52.17","26.51"
"63","000","00","110","0004","0178","611","322","289","20","631","868","0","72.70","37.10"
"63","000","00","110","0004","0179","608","309","299","22","630","922","0","68.33","33.51"
"63","000","00","110","0004","0180","662","338","324","26","688","995","0","69.15","33.97"
"63","000","00","110","0004","0181","526","300","226","22","548","2001","0","27.39","14.99"
"63","000","00","110","0005","0000","4126","2111","2015","159","4285","6080","0","70.48","34.72"
"63","000","00","110","0005","0182","734","335","399","27","761","1118","0","68.07","29.96"
"63","000","00","110","0005","0183","727","300","427","33","760","1124","0","67.62","26.69"
"63","000","00","110","0005","0184","748","393","355","26","774","1093","0","70.81","35.96"
"63","000","00","110","0005","0185","907","495","412","32","939","1310","0","71.68","37.79"
"63","000","00","110","0005","0186","1010","588","422","41","1051","1435","0","73.24","40.98"
"63","000","00","110","0006","0000","3248","1721","1527","156","3404","4936","0","68.96","34.87"
"63","000","00","110","0006","0187","830","429","401","23","853","1278","0","66.74","33.57"
"63","000","00","110","0006","0188","733","388","345","46","779","1140","0","68.33","34.04"
"63","000","00","110","0006","0189","931","479","452","50","981","1365","0","71.87","35.09"
"63","000","00","110","0006","0190","754","425","329","37","791","1153","0","68.60","36.86"
"63","000","00","110","0007","0000","4103","2226","1877","173","4276","6195","0","69.02","35.93"
"63","000","00","110","0007","0191","674","390","284","34","708","1029","0","68.80","37.90"
"63","000","00","110","0007","0192","834","467","367","25","859","1228","0","69.95","38.03"
"63","000","00","110","0007","0193","919","487","432","27","946","1405","0","67.33","34.66"
"63","000","00","110","0007","0194","961","501","460","28","989","1370","0","72.19","36.57"
"63","000","00","110","0007","0195","715","381","334","59","774","1163","0","66.55","32.76"
"63","000","00","110","0008","0000","4109","2339","1770","150","4259","6488","0","65.64","36.05"
"63","000","00","110","0008","0196","853","476","377","24","877","1286","0","68.20","37.01"
"63","000","00","110","0008","0197","797","486","311","43","840","1324","0","63.44","36.71"
"63","000","00","110","0008","0198","819","464","355","29","848","1324","0","64.05","35.05"
"63","000","00","110","0008","0199","774","458","316","31","805","1235","0","65.18","37.09"
"63","000","00","110","0008","0200","866","455","411","23","889","1319","0","67.40","34.50"
"63","000","00","110","0009","0000","3539","2022","1517","125","3664","5348","0","68.51","37.81"
"63","000","00","110","0009","0201","804","476","328","28","832","1294","0","64.30","36.79"
"63","000","00","110","0009","0202","856","474","382","30","886","1268","0","69.87","37.38"
"63","000","00","110","0009","0203","957","501","456","34","991","1369","0","72.39","36.60"
"63","000","00","110","0009","0204","922","571","351","33","955","1417","0","67.40","40.30"
"63","000","00","110","0010","0000","2305","1331","974","101","2406","3607","0","66.70","36.90"
"63","000","00","110","0010","0205","809","450","359","48","857","1253","0","68.40","35.91"
"63","000","00","110","0010","0206","818","480","338","23","841","1289","0","65.24","37.24"
"63","000","00","110","0010","0207","678","401","277","30","708","1065","0","66.48","37.65"
"63","000","00","110","0011","0000","3460","1985","1475","187","3647","5482","0","66.53","36.21"
"63","000","00","110","0011","0208","861","494","367","62","923","1398","0","66.02","35.34"
"63","000","00","110","0011","0209","897","537","360","33","930","1353","0","68.74","39.69"
"63","000","00","110","0011","0210","875","481","394","52","927","1369","0","67.71","35.14"
"63","000","00","110","0011","0211","827","473","354","40","867","1362","0","63.66","34.73"
"63","000","00","110","0012","0000","2781","1435","1346","114","2895","4441","0","65.19","32.31"
"63","000","00","110","0012","0212","659","338","321","28","687","1045","0","65.74","32.34"
"63","000","00","110","0012","0213","812","433","379","28","840","1249","0","67.25","34.67"
"63","000","00","110","0012","0214","626","324","302","38","664","1049","0","63.30","30.89"
"63","000","00","110","0012","0215","684","340","344","20","704","1098","0","64.12","30.97"
"63","000","00","110","0013","0000","3159","1765","1394","167","3326","5105","0","65.15","34.57"
"63","000","00","110","0013","0216","731","395","336","44","775","1190","0","65.13","33.19"
"63","000","00","110","0013","0217","576","343","233","39","615","999","0","61.56","34.33"
"63","000","00","110","0013","0218","824","448","376","41","865","1397","0","61.92","32.07"
"63","000","00","110","0013","0219","1028","579","449","43","1071","1519","0","70.51","38.12"
"63","000","00","110","0014","0000","2620","1463","1157","120","2740","3889","0","70.46","37.62"
"63","000","00","110","0014","0220","868","443","425","51","919","1294","0","71.02","34.23"
"63","000","00","110","0014","0221","842","483","359","40","882","1315","0","67.07","36.73"
"63","000","00","110","0014","0222","910","537","373","29","939","1280","0","73.36","41.95"
"63","000","00","110","0015","0000","2805","1670","1135","145","2950","4466","0","66.05","37.39"
"63","000","00","110","0015","0223","681","405","276","33","714","1097","0","65.09","36.92"
"63","000","00","110","0015","0224","591","385","206","39","630","1002","0","62.87","38.42"
"63","000","00","110","0015","0225","694","404","290","33","727","1122","0","64.80","36.01"
"63","000","00","110","0015","0226","839","476","363","40","879","1245","0","70.60","38.23"
"63","000","00","110","0016","0000","3183","1870","1313","197","3380","4949","0","68.30","37.79"
"63","000","00","110","0016","0227","810","456","354","54","864","1223","0","70.65","37.29"
"63","000","00","110","0016","0228","758","460","298","50","808","1191","0","67.84","38.62"
"63","000","00","110","0016","0229","813","489","324","57","870","1262","0","68.94","38.75"
"63","000","00","110","0016","0230","802","465","337","36","838","1273","0","65.83","36.53"
"63","000","00","110","0017","0000","3755","2109","1646","219","3974","5940","0","66.90","35.51"
"63","000","00","110","0017","0231","709","446","263","24","733","1125","0","65.16","39.64"
"63","000","00","110","0017","0232","771","446","325","45","816","1202","0","67.89","37.10"
"63","000","00","110","0017","0233","773","453","320","63","836","1209","0","69.15","37.47"
"63","000","00","110","0017","0234","686","311","375","57","743","1112","0","66.82","27.97"
"63","000","00","110","0017","0235","816","453","363","30","846","1292","0","65.48","35.06"
"63","000","00","110","0018","0000","2084","1191","893","105","2189","3323","0","65.87","35.84"
"63","000","00","110","0018","0236","642","341","301","28","670","1015","0","66.01","33.60"
"63","000","00","110","0018","0237","731","423","308","38","769","1160","0","66.29","36.47"
"63","000","00","110","0018","0238","711","427","284","39","750","1148","0","65.33","37.20"
"63","000","00","110","0019","0000","3366","2009","1357","188","3554","5317","0","66.84","37.78"
"63","000","00","110","0019","0239","797","472","325","36","833","1267","0","65.75","37.25"
"63","000","00","110","0019","0240","863","551","312","55","918","1377","0","66.67","40.01"
"63","000","00","110","0019","0241","867","481","386","37","904","1334","0","67.77","36.06"
"63","000","00","110","0019","0242","839","505","334","60","899","1339","0","67.14","37.71"
"63","000","00","110","0020","0000","4597","2764","1833","229","4826","7384","0","65.36","37.43"
"63","000","00","110","0020","0243","914","552","362","32","946","1360","0","69.56","40.59"
"63","000","00","110","0020","0244","865","528","337","43","908","1389","0","65.37","38.01"
"63","000","00","110","0020","0245","645","377","268","51","696","1088","0","63.97","34.65"
"63","000","00","110","0020","0246","669","440","229","48","717","1104","0","64.95","39.86"
"63","000","00","110","0020","0247","851","502","349","27","878","1413","0","62.14","35.53"
"63","000","00","110","0020","0248","653","365","288","28","681","1030","0","66.12","35.44"
"63","000","00","110","0021","0000","3722","2308","1414","214","3936","5881","0","66.93","39.25"
"63","000","00","110","0021","0249","804","469","335","38","842","1235","0","68.18","37.98"
"63","000","00","110","0021","0250","794","508","286","36","830","1235","0","67.21","41.13"
"63","000","00","110","0021","0251","782","486","296","46","828","1269","0","65.25","38.30"
"63","000","00","110","0021","0252","742","464","278","55","797","1172","0","68.00","39.59"
"63","000","00","110","0021","0253","600","381","219","39","639","970","0","65.88","39.28"
"63","000","00","110","0022","0000","3702","2257","1445","186","3888","5898","0","65.92","38.27"
"63","000","00","110","0022","0254","712","439","273","27","739","1153","0","64.09","38.07"
"63","000","00","110","0022","0255","747","466","281","40","787","1138","0","69.16","40.95"
"63","000","00","110","0022","0256","772","455","317","38","810","1226","0","66.07","37.11"
"63","000","00","110","0022","0257","687","425","262","34","721","1121","0","64.32","37.91"
"63","000","00","110","0022","0258","784","472","312","47","831","1260","0","65.95","37.46"
"63","000","00","110","0023","0000","2865","1857","1008","203","3068","4285","0","71.60","43.34"
"63","000","00","110","0023","0259","954","640","314","43","997","1384","0","72.04","46.24"
"63","000","00","110","0023","0260","925","590","335","69","994","1414","0","70.30","41.73"
"63","000","00","110","0023","0261","986","627","359","91","1077","1487","0","72.43","42.17"
"63","000","00","110","0024","0000","3223","2020","1203","214","3437","5322","0","64.58","37.96"
"63","000","00","110","0024","0262","699","428","271","47","746","1156","0","64.53","37.02"
"63","000","00","110","0024","0263","899","581","318","52","951","1472","0","64.61","39.47"
"63","000","00","110","0024","0264","778","499","279","68","846","1313","0","64.43","38.00"
"63","000","00","110","0024","0265","847","512","335","47","894","1381","0","64.74","37.07"
"63","000","00","110","0025","0000","1748","867","881","74","1822","2719","0","67.01","31.89"
"63","000","00","110","0025","0266","823","436","387","32","855","1335","0","64.04","32.66"
"63","000","00","110","0025","0267","925","431","494","42","967","1384","0","69.87","31.14"
"63","000","00","110","0026","0000","3716","1936","1780","134","3850","5654","0","68.09","34.24"
"63","000","00","110","0026","0268","809","402","407","15","824","1220","0","67.54","32.95"
"63","000","00","110","0026","0269","744","384","360","35","779","1110","0","70.18","34.59"
"63","000","00","110","0026","0270","814","428","386","33","847","1242","0","68.20","34.46"
"63","000","00","110","0026","0271","745","373","372","30","775","1141","0","67.92","32.69"
"63","000","00","110","0026","0272","604","349","255","21","625","941","0","66.42","37.09"
"63","000","00","110","0027","0000","2317","1250","1067","83","2400","3600","0","66.67","34.72"
"63","000","00","110","0027","0273","834","449","385","41","875","1240","0","70.56","36.21"
"63","000","00","110","0027","0274","754","396","358","25","779","1196","0","65.13","33.11"
"63","000","00","110","0027","0275","729","405","324","17","746","1164","0","64.09","34.79"
"63","000","00","110","0028","0000","2932","1654","1278","108","3040","4500","0","67.56","36.76"
"63","000","00","110","0028","0276","762","422","340","26","788","1127","0","69.92","37.44"
"63","000","00","110","0028","0277","692","411","281","37","729","1136","0","64.17","36.18"
"63","000","00","110","0028","0278","794","446","348","23","817","1188","0","68.77","37.54"
"63","000","00","110","0028","0279","684","375","309","22","706","1049","0","67.30","35.75"
"63","000","00","110","0029","0000","2680","1288","1392","79","2759","4064","0","67.89","31.69"
"63","000","00","110","0029","0280","889","469","420","28","917","1374","0","66.74","34.13"
"63","000","00","110","0029","0281","867","474","393","31","898","1303","0","68.92","36.38"
"63","000","00","110","0029","0282","924","345","579","20","944","1387","0","68.06","24.87"
"63","000","00","110","0030","0000","2805","1278","1527","100","2905","4398","0","66.05","29.06"
"63","000","00","110","0030","0283","735","279","456","31","766","1127","0","67.97","24.76"
"63","000","00","110","0030","0284","670","323","347","30","700","1049","0","66.73","30.79"
"63","000","00","110","0030","0285","734","312","422","21","755","1163","0","64.92","26.83"
"63","000","00","110","0030","0286","666","364","302","18","684","1059","0","64.59","34.37"
"63","000","00","110","0031","0000","3930","2086","1844","127","4057","5976","0","67.89","34.91"
"63","000","00","110","0031","0287","779","441","338","24","803","1235","0","65.02","35.71"
"63","000","00","110","0031","0288","873","463","410","33","906","1270","0","71.34","36.46"
"63","000","00","110","0031","0289","818","403","415","15","833","1202","0","69.30","33.53"
"63","000","00","110","0031","0290","713","365","348","28","741","1106","0","67.00","33.00"
"63","000","00","110","0031","0291","747","414","333","27","774","1163","0","66.55","35.60"
"63","000","00","110","0032","0000","2664","1310","1354","126","2790","4081","0","68.37","32.10"
"63","000","00","110","0032","0292","861","383","478","65","926","1368","0","67.69","28.00"
"63","000","00","110","0032","0293","865","449","416","27","892","1314","0","67.88","34.17"
"63","000","00","110","0032","0294","938","478","460","34","972","1399","0","69.48","34.17"
"63","000","00","110","0033","0000","2816","1524","1292","110","2926","4616","0","63.39","33.02"
"63","000","00","110","0033","0295","644","353","291","22","666","1203","0","55.36","29.34"
"63","000","00","110","0033","0296","705","359","346","26","731","1147","0","63.73","31.30"
"63","000","00","110","0033","0297","730","424","306","28","758","1153","0","65.74","36.77"
"63","000","00","110","0033","0298","737","388","349","34","771","1113","0","69.27","34.86"
"63","000","00","110","0034","0000","4477","2356","2121","162","4639","6968","0","66.58","33.81"
"63","000","00","110","0034","0299","665","362","303","16","681","1101","0","61.85","32.88"
"63","000","00","110","0034","0300","715","370","345","44","759","1128","0","67.29","32.80"
"63","000","00","110","0034","0301","716","391","325","17","733","1098","0","66.76","35.61"
"63","000","00","110","0034","0302","890","485","405","35","925","1288","0","71.82","37.66"
"63","000","00","110","0034","0303","801","398","403","30","831","1296","0","64.12","30.71"
"63","000","00","110","0034","0304","690","350","340","20","710","1057","0","67.17","33.11"
"63","000","00","110","0035","0000","3340","1797","1543","155","3495","5116","0","68.32","35.13"
"63","000","00","110","0035","0305","840","438","402","32","872","1297","0","67.23","33.77"
"63","000","00","110","0035","0306","872","505","367","47","919","1362","0","67.47","37.08"
"63","000","00","110","0035","0307","908","478","430","42","950","1372","0","69.24","34.84"
"63","000","00","110","0035","0308","720","376","344","34","754","1085","0","69.49","34.65"
"63","000","00","110","0036","0000","3161","1637","1524","111","3272","4970","0","65.84","32.94"
"63","000","00","110","0036","0309","906","486","420","23","929","1414","0","65.70","34.37"
"63","000","00","110","0036","0310","707","366","341","23","730","1166","0","62.61","31.39"
"63","000","00","110","0036","0311","769","387","382","35","804","1189","0","67.62","32.55"
"63","000","00","110","0036","0312","779","398","381","30","809","1201","0","67.36","33.14"
"63","000","00","110","0037","0000","2731","1494","1237","87","2818","4089","0","68.92","36.54"
"63","000","00","110","0037","0313","915","495","420","29","944","1381","0","68.36","35.84"
"63","000","00","110","0037","0314","954","536","418","35","989","1400","0","70.64","38.29"
"63","000","00","110","0037","0315","862","463","399","23","885","1308","0","67.66","35.40"
"63","000","00","110","0038","0000","2441","1302","1139","88","2529","3914","0","64.61","33.27"
"63","000","00","110","0038","0316","807","421","386","42","849","1310","0","64.81","32.14"
"63","000","00","110","0038","0317","762","428","334","19","781","1226","0","63.70","34.91"
"63","000","00","110","0038","0318","872","453","419","27","899","1378","0","65.24","32.87"
"63","000","00","110","0039","0000","3776","1974","1802","136","3912","5839","0","67.00","33.81"
"63","000","00","110","0039","0319","731","380","351","32","763","1137","0","67.11","33.42"
"63","000","00","110","0039","0320","778","419","359","35","813","1150","0","70.70","36.43"
"63","000","00","110","0039","0321","736","382","354","22","758","1111","0","68.23","34.38"
"63","000","00","110","0039","0322","782","389","393","20","802","1194","0","67.17","32.58"
"63","000","00","110","0039","0323","749","404","345","27","776","1247","0","62.23","32.40"
"63","000","00","110","0040","0000","3388","1703","1685","117","3505","5420","0","64.67","31.42"
"63","000","00","110","0040","0324","798","402","396","31","829","1359","0","61.00","29.58"
"63","000","00","110","0040","0325","874","399","475","22","896","1397","0","64.14","28.56"
"63","000","00","110","0040","0326","805","417","388","31","836","1304","0","64.11","31.98"
"63","000","00","110","0040","0327","911","485","426","33","944","1360","0","69.41","35.66"
"63","000","00","110","0041","0000","4320","2276","2044","130","4450","6810","0","65.35","33.42"
"63","000","00","110","0041","0328","908","490","418","37","945","1459","0","64.77","33.58"
"63","000","00","110","0041","0329","844","432","412","21","865","1329","0","65.09","32.51"
"63","000","00","110","0041","0330","864","448","416","27","891","1345","0","66.25","33.31"
"63","000","00","110","0041","0331","909","516","393","18","927","1446","0","64.11","35.68"
"63","000","00","110","0041","0332","795","390","405","27","822","1231","0","66.77","31.68"
"63","000","00","110","0042","0000","3255","1697","1558","114","3369","5123","0","65.76","33.13"
"63","000","00","110","0042","0333","738","423","315","22","760","1119","0","67.92","37.80"
"63","000","00","110","0042","0334","846","441","405","26","872","1334","0","65.37","33.06"
"63","000","00","110","0042","0335","869","429","440","23","892","1362","0","65.49","31.50"
"63","000","00","110","0042","0336","802","404","398","43","845","1308","0","64.60","30.89"
"63","000","00","110","0043","0000","656","380","276","26","682","1033","0","66.02","36.79"
"63","000","00","110","0043","0337","656","380","276","26","682","1033","0","66.02","36.79"
"63","000","00","110","0044","0000","761","475","286","76","837","1153","0","72.59","41.20"
"63","000","00","110","0044","0338","761","475","286","76","837","1153","0","72.59","41.20"
"63","000","00","110","0045","0000","1032","574","458","76","1108","1569","0","70.62","36.58"
"63","000","00","110","0045","0339","521","286","235","42","563","781","0","72.09","36.62"
"63","000","00","110","0045","0340","511","288","223","34","545","788","0","69.16","36.55"
"63","000","00","110","0046","0000","1446","796","650","110","1556","2471","0","62.97","32.21"
"63","000","00","110","0046","0341","504","313","191","43","547","891","0","61.39","35.13"
"63","000","00","110","0046","0342","505","277","228","35","540","813","0","66.42","34.07"
"63","000","00","110","0046","0343","437","206","231","32","469","767","0","61.15","26.86"
"63","000","00","110","0047","0000","837","458","379","74","911","1364","0","66.79","33.58"
"63","000","00","110","0047","0344","493","267","226","45","538","855","0","62.92","31.23"
"63","000","00","110","0047","0345","344","191","153","29","373","509","0","73.28","37.52"
"63","000","00","110","0048","0000","869","527","342","63","932","1284","0","72.59","41.04"
"63","000","00","110","0048","0346","869","527","342","63","932","1284","0","72.59","41.04"
"63","000","00","110","0049","0000","775","461","314","62","837","1278","0","65.49","36.07"
"63","000","00","110","0049","0347","775","461","314","62","837","1278","0","65.49","36.07"
"63","000","00","110","0050","0000","1471","592","879","64","1535","2223","0","69.05","26.63"
"63","000","00","110","0050","0348","713","289","424","40","753","1115","0","67.53","25.92"
"63","000","00","110","0050","0349","758","303","455","24","782","1108","0","70.58","27.35"
"63","000","00","110","0051","0000","1391","716","675","74","1465","2298","0","63.75","31.16"
"63","000","00","110","0051","0350","758","387","371","48","806","1259","0","64.02","30.74"
"63","000","00","110","0051","0351","633","329","304","26","659","1039","0","63.43","31.67"
"63","000","00","120","0000","0000","124511","66528","57983","5894","130405","197879","239780","65.90","33.62"
"63","000","00","120","0001","0000","2385","1331","1054","92","2477","3589","0","69.02","37.09"
"63","000","00","120","0001","0001","749","398","351","27","776","1177","0","65.93","33.81"
"63","000","00","120","0001","0002","810","459","351","40","850","1214","0","70.02","37.81"
"63","000","00","120","0001","0003","826","474","352","25","851","1198","0","71.04","39.57"
"63","000","00","120","0002","0000","2262","1295","967","98","2360","3504","0","67.35","36.96"
"63","000","00","120","0002","0004","706","409","297","26","732","1108","0","66.06","36.91"
"63","000","00","120","0002","0005","796","461","335","45","841","1234","0","68.15","37.36"
"63","000","00","120","0002","0006","760","425","335","27","787","1162","0","67.73","36.57"
"63","000","00","120","0003","0000","2695","1451","1244","164","2859","4204","0","68.01","34.51"
"63","000","00","120","0003","0007","723","369","354","36","759","1102","0","68.87","33.48"
"63","000","00","120","0003","0008","713","396","317","28","741","1081","0","68.55","36.63"
"63","000","00","120","0003","0009","594","332","262","43","637","992","0","64.21","33.47"
"63","000","00","120","0003","0010","665","354","311","57","722","1029","0","70.17","34.40"
"63","000","00","120","0004","0000","3755","1937","1818","181","3936","5630","0","69.91","34.40"
"63","000","00","120","0004","0011","784","419","365","21","805","1148","0","70.12","36.50"
"63","000","00","120","0004","0012","741","398","343","27","768","1113","0","69.00","35.76"
"63","000","00","120","0004","0013","789","371","418","44","833","1166","0","71.44","31.82"
"63","000","00","120","0004","0014","730","372","358","48","778","1113","0","69.90","33.42"
"63","000","00","120","0004","0015","711","377","334","41","752","1090","0","68.99","34.59"
"63","000","00","120","0005","0000","3461","1797","1664","126","3587","5675","0","63.21","31.67"
"63","000","00","120","0005","0016","642","377","265","15","657","1185","0","55.44","31.81"
"63","000","00","120","0005","0017","654","312","342","31","685","1199","0","57.13","26.02"
"63","000","00","120","0005","0018","726","396","330","41","767","1104","0","69.47","35.87"
"63","000","00","120","0005","0019","737","366","371","26","763","1095","0","69.68","33.42"
"63","000","00","120","0005","0020","702","346","356","13","715","1092","0","65.48","31.68"
"63","000","00","120","0006","0000","3880","2042","1838","118","3998","5844","0","68.41","34.94"
"63","000","00","120","0006","0021","743","371","372","13","756","1223","0","61.82","30.34"
"63","000","00","120","0006","0022","824","457","367","25","849","1232","0","68.91","37.09"
"63","000","00","120","0006","0023","865","439","426","26","891","1260","0","70.71","34.84"
"63","000","00","120","0006","0024","755","420","335","29","784","1088","0","72.06","38.60"
"63","000","00","120","0006","0025","693","355","338","25","718","1041","0","68.97","34.10"
"63","000","00","120","0007","0000","3996","2099","1897","176","4172","6261","0","66.63","33.52"
"63","000","00","120","0007","0026","840","447","393","48","888","1292","0","68.73","34.60"
"63","000","00","120","0007","0027","788","394","394","40","828","1230","0","67.32","32.03"
"63","000","00","120","0007","0028","829","434","395","23","852","1354","0","62.92","32.05"
"63","000","00","120","0007","0029","794","445","349","33","827","1201","0","68.86","37.05"
"63","000","00","120","0007","0030","745","379","366","32","777","1184","0","65.63","32.01"
"63","000","00","120","0008","0000","3777","1944","1833","154","3931","5960","0","65.96","32.62"
"63","000","00","120","0008","0031","763","370","393","29","792","1148","0","68.99","32.23"
"63","000","00","120","0008","0032","779","392","387","29","808","1280","0","63.13","30.63"
"63","000","00","120","0008","0033","662","336","326","35","697","1111","0","62.74","30.24"
"63","000","00","120","0008","0034","777","424","353","44","821","1222","0","67.18","34.70"
"63","000","00","120","0008","0035","796","422","374","17","813","1199","0","67.81","35.20"
"63","000","00","120","0009","0000","4753","2576","2177","188","4941","7525","0","65.66","34.23"
"63","000","00","120","0009","0036","682","352","330","20","702","1100","0","63.82","32.00"
"63","000","00","120","0009","0037","785","458","327","41","826","1199","0","68.89","38.20"
"63","000","00","120","0009","0038","880","482","398","23","903","1387","0","65.10","34.75"
"63","000","00","120","0009","0039","865","464","401","29","894","1426","0","62.69","32.54"
"63","000","00","120","0009","0040","768","399","369","37","805","1230","0","65.45","32.44"
"63","000","00","120","0009","0041","773","421","352","38","811","1183","0","68.55","35.59"
"63","000","00","120","0010","0000","4100","2177","1923","146","4246","6435","0","65.98","33.83"
"63","000","00","120","0010","0042","815","445","370","33","848","1308","0","64.83","34.02"
"63","000","00","120","0010","0043","748","386","362","22","770","1185","0","64.98","32.57"
"63","000","00","120","0010","0044","840","393","447","32","872","1336","0","65.27","29.42"
"63","000","00","120","0010","0045","904","503","401","27","931","1382","0","67.37","36.40"
"63","000","00","120","0010","0046","793","450","343","32","825","1224","0","67.40","36.76"
"63","000","00","120","0011","0000","2450","1216","1234","119","2569","3804","0","67.53","31.97"
"63","000","00","120","0011","0047","872","407","465","44","916","1357","0","67.50","29.99"
"63","000","00","120","0011","0048","835","434","401","32","867","1318","0","65.78","32.93"
"63","000","00","120","0011","0049","743","375","368","43","786","1129","0","69.62","33.22"
"63","000","00","120","0012","0000","2369","1165","1204","110","2479","3552","0","69.79","32.80"
"63","000","00","120","0012","0050","674","336","338","35","709","1039","0","68.24","32.34"
"63","000","00","120","0012","0051","802","366","436","24","826","1127","0","73.29","32.48"
"63","000","00","120","0012","0052","893","463","430","51","944","1386","0","68.11","33.41"
"63","000","00","120","0013","0000","3567","1779","1788","152","3719","5428","0","68.52","32.77"
"63","000","00","120","0013","0053","741","362","379","19","760","1112","0","68.35","32.55"
"63","000","00","120","0013","0054","632","319","313","31","663","938","0","70.68","34.01"
"63","000","00","120","0013","0055","721","365","356","37","758","1153","0","65.74","31.66"
"63","000","00","120","0013","0056","728","368","360","34","762","1104","0","69.02","33.33"
"63","000","00","120","0013","0057","745","365","380","31","776","1121","0","69.22","32.56"
"63","000","00","120","0014","0000","2589","1455","1134","133","2722","4020","0","67.71","36.19"
"63","000","00","120","0014","0058","691","400","291","34","725","1048","0","69.18","38.17"
"63","000","00","120","0014","0059","607","339","268","34","641","972","0","65.95","34.88"
"63","000","00","120","0014","0060","647","364","283","32","679","983","0","69.07","37.03"
"63","000","00","120","0014","0061","644","352","292","33","677","1017","0","66.57","34.61"
"63","000","00","120","0015","0000","2420","1378","1042","97","2517","3792","0","66.38","36.34"
"63","000","00","120","0015","0062","802","452","350","38","840","1263","0","66.51","35.79"
"63","000","00","120","0015","0063","783","449","334","30","813","1264","0","64.32","35.52"
"63","000","00","120","0015","0064","835","477","358","29","864","1265","0","68.30","37.71"
"63","000","00","120","0016","0000","2927","1593","1334","104","3031","4362","0","69.49","36.52"
"63","000","00","120","0016","0065","799","439","360","28","827","1138","0","72.67","38.58"
"63","000","00","120","0016","0066","757","431","326","35","792","1128","0","70.21","38.21"
"63","000","00","120","0016","0067","695","378","317","18","713","1062","0","67.14","35.59"
"63","000","00","120","0016","0068","676","345","331","23","699","1034","0","67.60","33.37"
"63","000","00","120","0017","0000","4772","2630","2142","226","4998","7360","0","67.91","35.73"
"63","000","00","120","0017","0069","758","389","369","52","810","1214","0","66.72","32.04"
"63","000","00","120","0017","0070","755","433","322","45","800","1192","0","67.11","36.33"
"63","000","00","120","0017","0071","805","448","357","37","842","1263","0","66.67","35.47"
"63","000","00","120","0017","0072","785","426","359","32","817","1182","0","69.12","36.04"
"63","000","00","120","0017","0073","840","482","358","33","873","1241","0","70.35","38.84"
"63","000","00","120","0017","0074","829","452","377","27","856","1268","0","67.51","35.65"
"63","000","00","120","0018","0000","2750","1512","1238","150","2900","4433","0","65.42","34.11"
"63","000","00","120","0018","0075","727","418","309","26","753","1113","0","67.65","37.56"
"63","000","00","120","0018","0076","597","362","235","58","655","1064","0","61.56","34.02"
"63","000","00","120","0018","0077","620","349","271","34","654","982","0","66.60","35.54"
"63","000","00","120","0018","0078","806","383","423","32","838","1274","0","65.78","30.06"
"63","000","00","120","0019","0000","1379","834","545","59","1438","1919","0","74.93","43.46"
"63","000","00","120","0019","0079","669","423","246","38","707","939","0","75.29","45.05"
"63","000","00","120","0019","0080","710","411","299","21","731","980","0","74.59","41.94"
"63","000","00","120","0020","0000","5927","3197","2730","227","6154","9265","0","66.42","34.51"
"63","000","00","120","0020","0081","888","508","380","47","935","1464","0","63.87","34.70"
"63","000","00","120","0020","0082","800","440","360","44","844","1269","0","66.51","34.67"
"63","000","00","120","0020","0083","879","464","415","30","909","1370","0","66.35","33.87"
"63","000","00","120","0020","0084","864","466","398","39","903","1320","0","68.41","35.30"
"63","000","00","120","0020","0085","799","437","362","25","824","1179","0","69.89","37.07"
"63","000","00","120","0020","0086","843","397","446","21","864","1322","0","65.36","30.03"
"63","000","00","120","0020","0087","854","485","369","21","875","1341","0","65.25","36.17"
"63","000","00","120","0021","0000","4535","2480","2055","257","4792","8262","0","58.00","30.02"
"63","000","00","120","0021","0088","648","381","267","45","693","2248","0","30.83","16.95"
"63","000","00","120","0021","0089","823","462","361","61","884","1259","0","70.21","36.70"
"63","000","00","120","0021","0090","828","464","364","36","864","1246","0","69.34","37.24"
"63","000","00","120","0021","0091","776","441","335","40","816","1270","0","64.25","34.72"
"63","000","00","120","0021","0092","840","456","384","33","873","1280","0","68.20","35.63"
"63","000","00","120","0021","0093","620","276","344","42","662","959","0","69.03","28.78"
"63","000","00","120","0022","0000","4017","2278","1739","194","4211","6744","0","62.44","33.78"
"63","000","00","120","0022","0094","544","305","239","25","569","875","0","65.03","34.86"
"63","000","00","120","0022","0095","772","435","337","37","809","1280","0","63.20","33.98"
"63","000","00","120","0022","0096","714","387","327","23","737","1123","0","65.63","34.46"
"63","000","00","120","0022","0097","687","387","300","39","726","1136","0","63.91","34.07"
"63","000","00","120","0022","0098","629","377","252","28","657","1148","0","57.23","32.84"
"63","000","00","120","0022","0099","671","387","284","42","713","1182","0","60.32","32.74"
"63","000","00","120","0023","0000","3034","1725","1309","135","3169","4975","0","63.70","34.67"
"63","000","00","120","0023","0100","746","437","309","45","791","1198","0","66.03","36.48"
"63","000","00","120","0023","0101","757","436","321","37","794","1196","0","66.39","36.45"
"63","000","00","120","0023","0102","755","430","325","25","780","1196","0","65.22","35.95"
"63","000","00","120","0023","0103","776","422","354","28","804","1385","0","58.05","30.47"
"63","000","00","120","0024","0000","2867","1641","1226","142","3009","4477","0","67.21","36.65"
"63","000","00","120","0024","0104","766","448","318","49","815","1248","0","65.30","35.90"
"63","000","00","120","0024","0105","674","418","256","35","709","1075","0","65.95","38.88"
"63","000","00","120","0024","0106","642","347","295","27","669","1007","0","66.43","34.46"
"63","000","00","120","0024","0107","785","428","357","31","816","1147","0","71.14","37.31"
"63","000","00","120","0025","0000","3441","1846","1595","146","3587","5376","0","66.72","34.34"
"63","000","00","120","0025","0108","649","376","273","39","688","1028","0","66.93","36.58"
"63","000","00","120","0025","0109","582","333","249","22","604","938","0","64.39","35.50"
"63","000","00","120","0025","0110","762","401","361","28","790","1088","0","72.61","36.86"
"63","000","00","120","0025","0111","698","354","344","33","731","1162","0","62.91","30.46"
"63","000","00","120","0025","0112","750","382","368","24","774","1160","0","66.72","32.93"
"63","000","00","120","0026","0000","1458","753","705","44","1502","2524","0","59.51","29.83"
"63","000","00","120","0026","0113","720","343","377","15","735","1228","0","59.85","27.93"
"63","000","00","120","0026","0114","738","410","328","29","767","1296","0","59.18","31.64"
"63","000","00","120","0027","0000","3226","1703","1523","127","3353","5490","0","61.07","31.02"
"63","000","00","120","0027","0115","598","301","297","33","631","1081","0","58.37","27.84"
"63","000","00","120","0027","0116","686","371","315","32","718","1108","0","64.80","33.48"
"63","000","00","120","0027","0117","667","372","295","21","688","1090","0","63.12","34.13"
"63","000","00","120","0027","0118","646","329","317","19","665","1080","0","61.57","30.46"
"63","000","00","120","0027","0119","629","330","299","22","651","1131","0","57.56","29.18"
"63","000","00","120","0028","0000","2037","1082","955","95","2132","3341","0","63.81","32.39"
"63","000","00","120","0028","0120","672","355","317","37","709","1083","0","65.47","32.78"
"63","000","00","120","0028","0121","728","369","359","33","761","1222","0","62.27","30.20"
"63","000","00","120","0028","0122","637","358","279","25","662","1036","0","63.90","34.56"
"63","000","00","120","0029","0000","3487","1797","1690","193","3680","5501","0","66.90","32.67"
"63","000","00","120","0029","0123","844","446","398","55","899","1319","0","68.16","33.81"
"63","000","00","120","0029","0124","841","396","445","37","878","1338","0","65.62","29.60"
"63","000","00","120","0029","0125","924","495","429","37","961","1448","0","66.37","34.19"
"63","000","00","120","0029","0126","878","460","418","64","942","1396","0","67.48","32.95"
"63","000","00","120","0030","0000","2492","1339","1153","168","2660","4010","0","66.33","33.39"
"63","000","00","120","0030","0127","620","346","274","30","650","1029","0","63.17","33.62"
"63","000","00","120","0030","0128","626","316","310","45","671","1023","0","65.59","30.89"
"63","000","00","120","0030","0129","441","265","176","35","476","755","0","63.05","35.10"
"63","000","00","120","0030","0130","805","412","393","58","863","1203","0","71.74","34.25"
"63","000","00","120","0031","0000","3190","1629","1561","209","3399","4952","0","68.64","32.90"
"63","000","00","120","0031","0131","750","410","340","49","799","1183","0","67.54","34.66"
"63","000","00","120","0031","0132","786","377","409","52","838","1193","0","70.24","31.60"
"63","000","00","120","0031","0133","844","447","397","51","895","1284","0","69.70","34.81"
"63","000","00","120","0031","0134","810","395","415","57","867","1292","0","67.11","30.57"
"63","000","00","120","0032","0000","1666","870","796","120","1786","2670","0","66.89","32.58"
"63","000","00","120","0032","0135","762","382","380","60","822","1208","0","68.05","31.62"
"63","000","00","120","0032","0136","904","488","416","60","964","1462","0","65.94","33.38"
"63","000","00","120","0033","0000","2125","912","1213","116","2241","3288","0","68.16","27.74"
"63","000","00","120","0033","0137","686","300","386","28","714","1046","0","68.26","28.68"
"63","000","00","120","0033","0138","633","233","400","39","672","997","0","67.40","23.37"
"63","000","00","120","0033","0139","806","379","427","49","855","1245","0","68.67","30.44"
"63","000","00","120","0034","0000","2227","1185","1042","132","2359","3552","0","66.41","33.36"
"63","000","00","120","0034","0140","774","384","390","45","819","1225","0","66.86","31.35"
"63","000","00","120","0034","0141","768","422","346","37","805","1238","0","65.02","34.09"
"63","000","00","120","0034","0142","685","379","306","50","735","1089","0","67.49","34.80"
"63","000","00","120","0035","0000","2815","1387","1428","133","2948","4553","0","64.75","30.46"
"63","000","00","120","0035","0143","669","276","393","47","716","1099","0","65.15","25.11"
"63","000","00","120","0035","0144","741","364","377","31","772","1124","0","68.68","32.38"
"63","000","00","120","0035","0145","671","351","320","22","693","1088","0","63.69","32.26"
"63","000","00","120","0035","0146","734","396","338","33","767","1242","0","61.76","31.88"
"63","000","00","120","0036","0000","3292","1802","1490","156","3448","5057","0","68.18","35.63"
"63","000","00","120","0036","0147","923","486","437","47","970","1391","0","69.73","34.94"
"63","000","00","120","0036","0148","736","440","296","49","785","1194","0","65.75","36.85"
"63","000","00","120","0036","0149","790","380","410","30","820","1162","0","70.57","32.70"
"63","000","00","120","0036","0150","843","496","347","30","873","1310","0","66.64","37.86"
"63","000","00","120","0037","0000","3799","2097","1702","173","3972","6101","0","65.10","34.37"
"63","000","00","120","0037","0151","626","379","247","32","658","1083","0","60.76","35.00"
"63","000","00","120","0037","0152","709","403","306","28","737","1173","0","62.83","34.36"
"63","000","00","120","0037","0153","755","416","339","41","796","1240","0","64.19","33.55"
"63","000","00","120","0037","0154","898","490","408","49","947","1306","0","72.51","37.52"
"63","000","00","120","0037","0155","811","409","402","23","834","1299","0","64.20","31.49"
"63","000","00","120","0038","0000","5604","2913","2691","324","5928","9244","0","64.13","31.51"
"63","000","00","120","0038","0156","804","429","375","41","845","1331","0","63.49","32.23"
"63","000","00","120","0038","0157","732","341","391","32","764","1090","0","70.09","31.28"
"63","000","00","120","0038","0158","678","344","334","38","716","1112","0","64.39","30.94"
"63","000","00","120","0038","0159","683","353","330","25","708","1125","0","62.93","31.38"
"63","000","00","120","0038","0160","713","372","341","43","756","1104","0","68.48","33.70"
"63","000","00","120","0038","0161","719","376","343","31","750","1127","0","66.55","33.36"
"63","000","00","120","0038","0162","624","342","282","84","708","1168","0","60.62","29.28"
"63","000","00","120","0038","0163","651","356","295","30","681","1187","0","57.37","29.99"
"63","000","00","120","0039","0000","1092","630","462","70","1162","2004","0","57.98","31.44"
"63","000","00","120","0039","0164","300","191","109","12","312","514","0","60.70","37.16"
"63","000","00","120","0039","0165","792","439","353","58","850","1490","0","57.05","29.46"
"63","000","00","120","0040","0000","810","449","361","50","860","1342","0","64.08","33.46"
"63","000","00","120","0040","0166","419","234","185","18","437","722","0","60.53","32.41"
"63","000","00","120","0040","0167","391","215","176","32","423","620","0","68.23","34.68"
"63","000","00","120","0041","0000","668","394","274","69","737","1064","0","69.27","37.03"
"63","000","00","120","0041","0168","668","394","274","69","737","1064","0","69.27","37.03"
"63","000","00","120","0042","0000","415","208","207","21","436","790","0","55.19","26.33"
"63","000","00","120","0042","0169","415","208","207","21","436","790","0","55.19","26.33"
"65","000","00","000","0000","0000","1748151","921553","826598","93329","1841480","3329257","3982363","55.31","27.68"
"65","000","00","010","0000","0000","246130","134863","111267","13372","259502","452429","548043","57.36","29.81"
"65","000","00","010","0001","0000","772","385","387","32","804","1336","0","60.18","28.82"
"65","000","00","010","0001","0996","772","385","387","32","804","1336","0","60.18","28.82"
"65","000","00","010","0002","0000","602","325","277","27","629","1161","0","54.18","27.99"
"65","000","00","010","0002","0997","602","325","277","27","629","1161","0","54.18","27.99"
"65","000","00","010","0003","0000","496","278","218","17","513","850","0","60.35","32.71"
"65","000","00","010","0003","0998","496","278","218","17","513","850","0","60.35","32.71"
"65","000","00","010","0004","0000","554","330","224","29","583","990","0","58.89","33.33"
"65","000","00","010","0004","0999","554","330","224","29","583","990","0","58.89","33.33"
"65","000","00","010","0005","0000","943","424","519","25","968","1520","0","63.68","27.89"
"65","000","00","010","0005","1000","506","243","263","10","516","857","0","60.21","28.35"
"65","000","00","010","0005","1001","437","181","256","15","452","663","0","68.17","27.30"
"65","000","00","010","0006","0000","2417","1296","1121","114","2531","4350","0","58.18","29.79"
"65","000","00","010","0006","1002","715","391","324","39","754","1268","0","59.46","30.84"
"65","000","00","010","0006","1003","586","323","263","48","634","1064","0","59.59","30.36"
"65","000","00","010","0006","1004","523","287","236","17","540","930","0","58.06","30.86"
"65","000","00","010","0006","1005","593","295","298","10","603","1088","0","55.42","27.11"
"65","000","00","010","0007","0000","1498","853","645","86","1584","2815","0","56.27","30.30"
"65","000","00","010","0007","1006","793","462","331","52","845","1413","0","59.80","32.70"
"65","000","00","010","0007","1007","705","391","314","34","739","1402","0","52.71","27.89"
"65","000","00","010","0008","0000","2842","1591","1251","136","2978","8709","0","34.19","18.27"
"65","000","00","010","0008","1008","820","446","374","35","855","5008","0","17.07","8.91"
"65","000","00","010","0008","1009","716","391","325","39","755","1346","0","56.09","29.05"
"65","000","00","010","0008","1010","741","420","321","29","770","1320","0","58.33","31.82"
"65","000","00","010","0008","1011","565","334","231","33","598","1035","0","57.78","32.27"
"65","000","00","010","0009","0000","2150","1258","892","111","2261","3858","0","58.61","32.61"
"65","000","00","010","0009","1012","751","439","312","28","779","1370","0","56.86","32.04"
"65","000","00","010","0009","1013","726","435","291","50","776","1291","0","60.11","33.69"
"65","000","00","010","0009","1014","673","384","289","33","706","1197","0","58.98","32.08"
"65","000","00","010","0010","0000","2772","1539","1233","111","2883","5651","0","51.02","27.23"
"65","000","00","010","0010","1017","875","477","398","27","902","1779","0","50.70","26.81"
"65","000","00","010","0010","1018","827","498","329","42","869","1811","0","47.98","27.50"
"65","000","00","010","0010","1019","1070","564","506","42","1112","2061","0","53.95","27.37"
"65","000","00","010","0011","0000","2452","1194","1258","100","2552","4186","0","60.97","28.52"
"65","000","00","010","0011","1020","626","279","347","24","650","1044","0","62.26","26.72"
"65","000","00","010","0011","1021","587","303","284","38","625","1008","0","62.00","30.06"
"65","000","00","010","0011","1022","670","348","322","23","693","1156","0","59.95","30.10"
"65","000","00","010","0011","1023","569","264","305","15","584","978","0","59.71","26.99"
"65","000","00","010","0012","0000","1351","748","603","96","1447","2354","0","61.47","31.78"
"65","000","00","010","0012","1024","685","382","303","49","734","1187","0","61.84","32.18"
"65","000","00","010","0012","1025","666","366","300","47","713","1167","0","61.10","31.36"
"65","000","00","010","0013","0000","1246","633","613","70","1316","2215","0","59.41","28.58"
"65","000","00","010","0013","1026","541","310","231","29","570","1044","0","54.60","29.69"
"65","000","00","010","0013","1027","705","323","382","41","746","1171","0","63.71","27.58"
"65","000","00","010","0014","0000","1957","765","1192","94","2051","3183","0","64.44","24.03"
"65","000","00","010","0014","1030","676","247","429","24","700","1051","0","66.60","23.50"
"65","000","00","010","0014","1031","629","226","403","38","667","1072","0","62.22","21.08"
"65","000","00","010","0014","1032","652","292","360","32","684","1060","0","64.53","27.55"
"65","000","00","010","0015","0000","1427","743","684","74","1501","2359","0","63.63","31.50"
"65","000","00","010","0015","1033","714","384","330","40","754","1181","0","63.84","32.51"
"65","000","00","010","0015","1034","713","359","354","34","747","1178","0","63.41","30.48"
"65","000","00","010","0016","0000","1931","1084","847","155","2086","3316","0","62.91","32.69"
"65","000","00","010","0016","1038","616","332","284","53","669","1010","0","66.24","32.87"
"65","000","00","010","0016","1039","653","371","282","56","709","1112","0","63.76","33.36"
"65","000","00","010","0016","1040","662","381","281","46","708","1194","0","59.30","31.91"
"65","000","00","010","0017","0000","2110","1164","946","131","2241","3955","0","56.66","29.43"
"65","000","00","010","0017","1041","544","316","228","22","566","1103","0","51.31","28.65"
"65","000","00","010","0017","1042","485","274","211","41","526","939","0","56.02","29.18"
"65","000","00","010","0017","1043","417","226","191","39","456","752","0","60.64","30.05"
"65","000","00","010","0017","1044","664","348","316","29","693","1161","0","59.69","29.97"
"65","000","00","010","0018","0000","1390","713","677","84","1474","2223","0","66.31","32.07"
"65","000","00","010","0018","1045","682","352","330","34","716","1082","0","66.17","32.53"
"65","000","00","010","0018","1046","708","361","347","50","758","1141","0","66.43","31.64"
"65","000","00","010","0019","0000","1737","978","759","98","1835","2953","0","62.14","33.12"
"65","000","00","010","0019","1049","564","311","253","34","598","971","0","61.59","32.03"
"65","000","00","010","0019","1050","531","285","246","21","552","924","0","59.74","30.84"
"65","000","00","010","0019","1051","642","382","260","43","685","1058","0","64.74","36.11"
"65","000","00","010","0020","0000","1871","1005","866","95","1966","3380","0","58.17","29.73"
"65","000","00","010","0020","1052","614","308","306","25","639","1065","0","60.00","28.92"
"65","000","00","010","0020","1053","597","333","264","46","643","1128","0","57.00","29.52"
"65","000","00","010","0020","1054","660","364","296","24","684","1187","0","57.62","30.67"
"65","000","00","010","0021","0000","1751","1005","746","95","1846","3196","0","57.76","31.45"
"65","000","00","010","0021","1055","589","335","254","20","609","1048","0","58.11","31.97"
"65","000","00","010","0021","1056","593","337","256","40","633","1079","0","58.67","31.23"
"65","000","00","010","0021","1057","569","333","236","35","604","1069","0","56.50","31.15"
"65","000","00","010","0022","0000","2063","1079","984","103","2166","3487","0","62.12","30.94"
"65","000","00","010","0022","1058","613","311","302","27","640","1071","0","59.76","29.04"
"65","000","00","010","0022","1059","727","414","313","50","777","1220","0","63.69","33.93"
"65","000","00","010","0022","1060","723","354","369","26","749","1196","0","62.63","29.60"
"65","000","00","010","0023","0000","1851","1041","810","130","1981","3415","0","58.01","30.48"
"65","000","00","010","0023","1061","596","344","252","58","654","1127","0","58.03","30.52"
"65","000","00","010","0023","1062","676","373","303","37","713","1180","0","60.42","31.61"
"65","000","00","010","0023","1063","579","324","255","35","614","1108","0","55.42","29.24"
"65","000","00","010","0024","0000","2075","838","1237","81","2156","3437","0","62.73","24.38"
"65","000","00","010","0024","1066","648","253","395","23","671","1052","0","63.78","24.05"
"65","000","00","010","0024","1067","818","301","517","33","851","1325","0","64.23","22.72"
"65","000","00","010","0024","1068","609","284","325","25","634","1060","0","59.81","26.79"
"65","000","00","010","0025","0000","1331","708","623","79","1410","2254","0","62.56","31.41"
"65","000","00","010","0025","1071","677","364","313","37","714","1130","0","63.19","32.21"
"65","000","00","010","0025","1072","654","344","310","42","696","1124","0","61.92","30.60"
"65","000","00","010","0026","0000","1406","751","655","93","1499","2476","0","60.54","30.33"
"65","000","00","010","0026","1073","712","381","331","46","758","1251","0","60.59","30.46"
"65","000","00","010","0026","1074","694","370","324","47","741","1225","0","60.49","30.20"
"65","000","00","010","0027","0000","1110","603","507","60","1170","1778","0","65.80","33.91"
"65","000","00","010","0027","1075","494","284","210","36","530","807","0","65.68","35.19"
"65","000","00","010","0027","1076","616","319","297","24","640","971","0","65.91","32.85"
"65","000","00","010","0028","0000","3263","1774","1489","111","3374","5819","0","57.98","30.49"
"65","000","00","010","0028","1077","830","436","394","31","861","1488","0","57.86","29.30"
"65","000","00","010","0028","1078","686","376","310","37","723","1222","0","59.17","30.77"
"65","000","00","010","0028","1079","924","539","385","28","952","1612","0","59.06","33.44"
"65","000","00","010","0028","1080","823","423","400","15","838","1497","0","55.98","28.26"
"65","000","00","010","0029","0000","2167","1255","912","146","2313","4424","0","52.28","28.37"
"65","000","00","010","0029","1081","734","440","294","50","784","1511","0","51.89","29.12"
"65","000","00","010","0029","1082","722","424","298","44","766","1457","0","52.57","29.10"
"65","000","00","010","0029","1083","711","391","320","52","763","1456","0","52.40","26.85"
"65","000","00","010","0030","0000","2356","1339","1017","135","2491","4643","0","53.65","28.84"
"65","000","00","010","0030","1084","797","457","340","46","843","1556","0","54.18","29.37"
"65","000","00","010","0030","1085","785","439","346","47","832","1557","0","53.44","28.20"
"65","000","00","010","0030","1086","774","443","331","42","816","1530","0","53.33","28.95"
"65","000","00","010","0031","0000","3577","2033","1544","168","3745","6629","0","56.49","30.67"
"65","000","00","010","0031","1087","590","337","253","24","614","1104","0","55.62","30.53"
"65","000","00","010","0031","1088","800","438","362","37","837","1422","0","58.86","30.80"
"65","000","00","010","0031","1089","836","472","364","40","876","1540","0","56.88","30.65"
"65","000","00","010","0031","1090","715","408","307","48","763","1374","0","55.53","29.69"
"65","000","00","010","0031","1091","636","378","258","19","655","1189","0","55.09","31.79"
"65","000","00","010","0032","0000","1689","930","759","78","1767","3151","0","56.08","29.51"
"65","000","00","010","0032","1092","535","283","252","9","544","1028","0","52.92","27.53"
"65","000","00","010","0032","1093","602","304","298","30","632","1059","0","59.68","28.71"
"65","000","00","010","0032","1094","552","343","209","39","591","1064","0","55.55","32.24"
"65","000","00","010","0033","0000","2565","1373","1192","105","2670","4622","0","57.77","29.71"
"65","000","00","010","0033","1097","928","519","409","47","975","1594","0","61.17","32.56"
"65","000","00","010","0033","1098","759","434","325","36","795","1327","0","59.91","32.71"
"65","000","00","010","0033","1099","878","420","458","22","900","1701","0","52.91","24.69"
"65","000","00","010","0034","0000","1249","755","494","74","1323","2432","0","54.40","31.04"
"65","000","00","010","0034","1100","649","406","243","36","685","1297","0","52.81","31.30"
"65","000","00","010","0034","1101","600","349","251","38","638","1135","0","56.21","30.75"
"65","000","00","010","0035","0000","3798","2168","1630","181","3979","6902","0","57.65","31.41"
"65","000","00","010","0035","1102","787","505","282","44","831","1405","0","59.15","35.94"
"65","000","00","010","0035","1103","740","443","297","27","767","1380","0","55.58","32.10"
"65","000","00","010","0035","1104","736","420","316","56","792","1350","0","58.67","31.11"
"65","000","00","010","0035","1105","772","390","382","28","800","1406","0","56.90","27.74"
"65","000","00","010","0035","1106","763","410","353","26","789","1361","0","57.97","30.12"
"65","000","00","010","0036","0000","1714","1039","675","134","1848","3150","0","58.67","32.98"
"65","000","00","010","0036","1110","586","364","222","56","642","1084","0","59.23","33.58"
"65","000","00","010","0036","1111","557","339","218","50","607","1091","0","55.64","31.07"
"65","000","00","010","0036","1112","571","336","235","28","599","975","0","61.44","34.46"
"65","000","00","010","0037","0000","3470","1831","1639","155","3625","5965","0","60.77","30.70"
"65","000","00","010","0037","1113","830","446","384","54","884","1545","0","57.22","28.87"
"65","000","00","010","0037","1114","901","489","412","34","935","1577","0","59.29","31.01"
"65","000","00","010","0037","1115","861","434","427","48","909","1390","0","65.40","31.22"
"65","000","00","010","0037","1116","878","462","416","19","897","1453","0","61.73","31.80"
"65","000","00","010","0038","0000","1449","844","605","135","1584","2577","0","61.47","32.75"
"65","000","00","010","0038","1120","424","257","167","44","468","802","0","58.35","32.04"
"65","000","00","010","0038","1121","486","284","202","44","530","804","0","65.92","35.32"
"65","000","00","010","0038","1122","539","303","236","47","586","971","0","60.35","31.20"
"65","000","00","010","0039","0000","2018","1128","890","134","2152","4007","0","53.71","28.15"
"65","000","00","010","0039","1123","461","272","189","39","500","963","0","51.92","28.25"
"65","000","00","010","0039","1124","458","252","206","19","477","927","0","51.46","27.18"
"65","000","00","010","0039","1125","494","278","216","40","534","1010","0","52.87","27.52"
"65","000","00","010","0039","1126","605","326","279","36","641","1107","0","57.90","29.45"
"65","000","00","010","0040","0000","1430","819","611","87","1517","2855","0","53.13","28.69"
"65","000","00","010","0040","1127","695","409","286","45","740","1426","0","51.89","28.68"
"65","000","00","010","0040","1128","735","410","325","42","777","1429","0","54.37","28.69"
"65","000","00","010","0041","0000","2174","1219","955","113","2287","4239","0","53.95","28.76"
"65","000","00","010","0041","1129","710","407","303","43","753","1383","0","54.45","29.43"
"65","000","00","010","0041","1130","692","379","313","34","726","1237","0","58.69","30.64"
"65","000","00","010","0041","1131","772","433","339","36","808","1619","0","49.91","26.74"
"65","000","00","010","0042","0000","2223","1271","952","109","2332","4207","0","55.43","30.21"
"65","000","00","010","0042","1132","738","442","296","43","781","1387","0","56.31","31.87"
"65","000","00","010","0042","1133","740","439","301","37","777","1423","0","54.60","30.85"
"65","000","00","010","0042","1134","745","390","355","29","774","1397","0","55.40","27.92"
"65","000","00","010","0043","0000","1691","971","720","78","1769","2912","0","60.75","33.34"
"65","000","00","010","0043","1137","890","531","359","53","943","1509","0","62.49","35.19"
"65","000","00","010","0043","1138","801","440","361","25","826","1403","0","58.87","31.36"
"65","000","00","010","0044","0000","5170","2828","2342","218","5388","8722","0","61.77","32.42"
"65","000","00","010","0044","1141","921","507","414","39","960","1504","0","63.83","33.71"
"65","000","00","010","0044","1142","840","470","370","46","886","1397","0","63.42","33.64"
"65","000","00","010","0044","1143","884","465","419","47","931","1583","0","58.81","29.37"
"65","000","00","010","0044","1144","841","472","369","21","862","1398","0","61.66","33.76"
"65","000","00","010","0044","1145","876","482","394","39","915","1460","0","62.67","33.01"
"65","000","00","010","0044","1146","808","432","376","26","834","1380","0","60.43","31.30"
"65","000","00","010","0045","0000","1059","662","397","70","1129","2023","0","55.81","32.72"
"65","000","00","010","0045","1147","513","350","163","38","551","1007","0","54.72","34.76"
"65","000","00","010","0045","1148","546","312","234","32","578","1016","0","56.89","30.71"
"65","000","00","010","0046","0000","1796","1020","776","105","1901","3314","0","57.36","30.78"
"65","000","00","010","0046","1151","549","322","227","26","575","1041","0","55.24","30.93"
"65","000","00","010","0046","1152","636","346","290","35","671","1076","0","62.36","32.16"
"65","000","00","010","0046","1153","611","352","259","44","655","1197","0","54.72","29.41"
"65","000","00","010","0047","0000","1479","888","591","91","1570","2598","0","60.43","34.18"
"65","000","00","010","0047","1154","718","422","296","38","756","1256","0","60.19","33.60"
"65","000","00","010","0047","1155","761","466","295","53","814","1342","0","60.66","34.72"
"65","000","00","010","0048","0000","2851","1608","1243","184","3035","5173","0","58.67","31.08"
"65","000","00","010","0048","1156","839","467","372","71","910","1600","0","56.88","29.19"
"65","000","00","010","0048","1157","977","563","414","49","1026","1784","0","57.51","31.56"
"65","000","00","010","0048","1158","1035","578","457","64","1099","1789","0","61.43","32.31"
"65","000","00","010","0049","0000","627","340","287","42","669","1188","0","56.31","28.62"
"65","000","00","010","0049","1159","627","340","287","42","669","1188","0","56.31","28.62"
"65","000","00","010","0050","0000","2778","1566","1212","143","2921","5132","0","56.92","30.51"
"65","000","00","010","0050","1160","656","366","290","24","680","1275","0","53.33","28.71"
"65","000","00","010","0050","1161","770","437","333","54","824","1427","0","57.74","30.62"
"65","000","00","010","0050","1162","683","397","286","31","714","1270","0","56.22","31.26"
"65","000","00","010","0050","1163","669","366","303","34","703","1160","0","60.60","31.55"
"65","000","00","010","0051","0000","2172","1266","906","154","2326","3755","0","61.94","33.72"
"65","000","00","010","0051","1164","720","423","297","72","792","1296","0","61.11","32.64"
"65","000","00","010","0051","1165","719","415","304","51","770","1305","0","59.00","31.80"
"65","000","00","010","0051","1166","733","428","305","31","764","1154","0","66.20","37.09"
"65","000","00","010","0052","0000","2063","1213","850","178","2241","3613","0","62.03","33.57"
"65","000","00","010","0052","1167","475","286","189","53","528","869","0","60.76","32.91"
"65","000","00","010","0052","1168","794","468","326","64","858","1356","0","63.27","34.51"
"65","000","00","010","0052","1169","794","459","335","61","855","1388","0","61.60","33.07"
"65","000","00","010","0053","0000","1621","986","635","88","1709","2830","0","60.39","34.84"
"65","000","00","010","0053","1170","813","484","329","50","863","1410","0","61.21","34.33"
"65","000","00","010","0053","1171","808","502","306","38","846","1420","0","59.58","35.35"
"65","000","00","010","0054","0000","2807","1500","1307","187","2994","5378","0","55.67","27.89"
"65","000","00","010","0054","1172","595","316","279","63","658","1173","0","56.10","26.94"
"65","000","00","010","0054","1173","543","294","249","33","576","992","0","58.06","29.64"
"65","000","00","010","0054","1174","597","296","301","28","625","1114","0","56.10","26.57"
"65","000","00","010","0054","1175","633","335","298","30","663","1255","0","52.83","26.69"
"65","000","00","010","0054","1176","439","259","180","33","472","844","0","55.92","30.69"
"65","000","00","010","0055","0000","1513","886","627","88","1601","2492","0","64.25","35.55"
"65","000","00","010","0055","1179","712","400","312","42","754","1185","0","63.63","33.76"
"65","000","00","010","0055","1180","801","486","315","46","847","1307","0","64.80","37.18"
"65","000","00","010","0056","0000","1531","786","745","90","1621","2804","0","57.81","28.03"
"65","000","00","010","0056","1181","737","354","383","41","778","1306","0","59.57","27.11"
"65","000","00","010","0056","1182","794","432","362","49","843","1498","0","56.28","28.84"
"65","000","00","010","0057","0000","3590","1902","1688","155","3745","6068","0","61.72","31.34"
"65","000","00","010","0057","1185","580","330","250","17","597","1010","0","59.11","32.67"
"65","000","00","010","0057","1186","612","327","285","32","644","1071","0","60.13","30.53"
"65","000","00","010","0057","1187","599","324","275","34","633","1004","0","63.05","32.27"
"65","000","00","010","0057","1188","613","363","250","37","650","1057","0","61.49","34.34"
"65","000","00","010","0057","1189","589","276","313","20","609","964","0","63.17","28.63"
"65","000","00","010","0057","1190","597","282","315","15","612","962","0","63.62","29.31"
"65","000","00","010","0058","0000","1260","755","505","85","1345","2418","0","55.62","31.22"
"65","000","00","010","0058","1191","647","398","249","36","683","1223","0","55.85","32.54"
"65","000","00","010","0058","1192","613","357","256","49","662","1195","0","55.40","29.87"
"65","000","00","010","0059","0000","2259","1283","976","166","2425","4476","0","54.18","28.66"
"65","000","00","010","0059","1195","721","404","317","34","755","1399","0","53.97","28.88"
"65","000","00","010","0059","1196","756","446","310","61","817","1544","0","52.91","28.89"
"65","000","00","010","0059","1197","782","433","349","71","853","1533","0","55.64","28.25"
"65","000","00","010","0060","0000","1242","718","524","75","1317","2324","0","56.67","30.90"
"65","000","00","010","0060","1198","592","327","265","38","630","1167","0","53.98","28.02"
"65","000","00","010","0060","1199","650","391","259","37","687","1157","0","59.38","33.79"
"65","000","00","010","0061","0000","2038","1176","862","103","2141","3604","0","59.41","32.63"
"65","000","00","010","0061","1200","657","385","272","33","690","1206","0","57.21","31.92"
"65","000","00","010","0061","1201","652","407","245","35","687","1193","0","57.59","34.12"
"65","000","00","010","0061","1202","729","384","345","35","764","1205","0","63.40","31.87"
"65","000","00","010","0062","0000","1654","955","699","115","1769","3020","0","58.58","31.62"
"65","000","00","010","0062","1205","813","454","359","70","883","1548","0","57.04","29.33"
"65","000","00","010","0062","1206","841","501","340","45","886","1472","0","60.19","34.04"
"65","000","00","010","0063","0000","1794","1065","729","85","1879","3391","0","55.41","31.41"
"65","000","00","010","0063","1207","888","536","352","56","944","1683","0","56.09","31.85"
"65","000","00","010","0063","1208","906","529","377","29","935","1708","0","54.74","30.97"
"65","000","00","010","0064","0000","1471","791","680","92","1563","2935","0","53.25","26.95"
"65","000","00","010","0064","1209","361","187","174","44","405","842","0","48.10","22.21"
"65","000","00","010","0064","1210","535","271","264","27","562","1031","0","54.51","26.29"
"65","000","00","010","0064","1211","575","333","242","21","596","1062","0","56.12","31.36"
"65","000","00","010","0065","0000","3671","1892","1779","139","3810","6773","0","56.25","27.93"
"65","000","00","010","0065","1212","695","351","344","37","732","1372","0","53.35","25.58"
"65","000","00","010","0065","1213","804","454","350","26","830","1372","0","60.50","33.09"
"65","000","00","010","0065","1214","759","380","379","27","786","1372","0","57.29","27.70"
"65","000","00","010","0065","1215","738","362","376","28","766","1329","0","57.64","27.24"
"65","000","00","010","0065","1216","675","345","330","21","696","1328","0","52.41","25.98"
"65","000","00","010","0066","0000","1671","892","779","79","1750","3052","0","57.34","29.23"
"65","000","00","010","0066","1217","564","311","253","23","587","984","0","59.65","31.61"
"65","000","00","010","0066","1218","555","314","241","22","577","1008","0","57.24","31.15"
"65","000","00","010","0066","1219","552","267","285","34","586","1060","0","55.28","25.19"
"65","000","00","010","0067","0000","1292","704","588","73","1365","2240","0","60.94","31.43"
"65","000","00","010","0067","1220","658","363","295","30","688","1130","0","60.88","32.12"
"65","000","00","010","0067","1221","634","341","293","43","677","1110","0","60.99","30.72"
"65","000","00","010","0068","0000","2190","1238","952","128","2318","3782","0","61.29","32.73"
"65","000","00","010","0068","1222","737","408","329","61","798","1246","0","64.04","32.74"
"65","000","00","010","0068","1223","713","369","344","34","747","1262","0","59.19","29.24"
"65","000","00","010","0068","1224","740","461","279","33","773","1274","0","60.68","36.19"
"65","000","00","010","0069","0000","2006","1122","884","110","2116","3642","0","58.10","30.81"
"65","000","00","010","0069","1227","840","454","386","50","890","1513","0","58.82","30.01"
"65","000","00","010","0069","1228","631","364","267","35","666","1092","0","60.99","33.33"
"65","000","00","010","0069","1229","535","304","231","25","560","1037","0","54.00","29.32"
"65","000","00","010","0070","0000","2288","1148","1140","81","2369","3943","0","60.08","29.11"
"65","000","00","010","0070","1232","824","421","403","25","849","1383","0","61.39","30.44"
"65","000","00","010","0070","1233","796","391","405","26","822","1319","0","62.32","29.64"
"65","000","00","010","0070","1234","668","336","332","30","698","1241","0","56.24","27.07"
"65","000","00","010","0071","0000","1752","858","894","94","1846","3358","0","54.97","25.55"
"65","000","00","010","0071","1235","852","428","424","49","901","1760","0","51.19","24.32"
"65","000","00","010","0071","1236","900","430","470","45","945","1598","0","59.14","26.91"
"65","000","00","010","0072","0000","2323","1238","1085","122","2445","3781","0","64.67","32.74"
"65","000","00","010","0072","1237","670","335","335","27","697","1196","0","58.28","28.01"
"65","000","00","010","0072","1238","876","465","411","49","925","1416","0","65.32","32.84"
"65","000","00","010","0072","1239","777","438","339","46","823","1169","0","70.40","37.47"
"65","000","00","010","0073","0000","1736","896","840","123","1859","2976","0","62.47","30.11"
"65","000","00","010","0073","1240","768","383","385","63","831","1424","0","58.36","26.90"
"65","000","00","010","0073","1241","968","513","455","60","1028","1552","0","66.24","33.05"
"65","000","00","010","0074","0000","2418","1306","1112","99","2517","4166","0","60.42","31.35"
"65","000","00","010","0074","1244","621","327","294","32","653","1114","0","58.62","29.35"
"65","000","00","010","0074","1245","967","543","424","30","997","1585","0","62.90","34.26"
"65","000","00","010","0074","1246","830","436","394","37","867","1467","0","59.10","29.72"
"65","000","00","010","0075","0000","1558","820","738","48","1606","2982","0","53.86","27.50"
"65","000","00","010","0075","1247","794","417","377","14","808","1530","0","52.81","27.25"
"65","000","00","010","0075","1248","764","403","361","34","798","1452","0","54.96","27.75"
"65","000","00","010","0076","0000","1675","900","775","86","1761","2935","0","60.00","30.66"
"65","000","00","010","0076","1249","842","458","384","38","880","1439","0","61.15","31.83"
"65","000","00","010","0076","1250","833","442","391","48","881","1496","0","58.89","29.55"
"65","000","00","010","0077","0000","1788","902","886","105","1893","3220","0","58.79","28.01"
"65","000","00","010","0077","1251","1088","544","544","55","1143","1971","0","57.99","27.60"
"65","000","00","010","0077","1252","700","358","342","50","750","1249","0","60.05","28.66"
"65","000","00","010","0078","0000","3079","1835","1244","156","3235","5777","0","56.00","31.76"
"65","000","00","010","0078","1253","779","614","165","30","809","1383","0","58.50","44.40"
"65","000","00","010","0078","1254","783","389","394","48","831","1427","0","58.23","27.26"
"65","000","00","010","0078","1255","759","402","357","48","807","1431","0","56.39","28.09"
"65","000","00","010","0078","1256","758","430","328","30","788","1536","0","51.30","27.99"
"65","000","00","010","0079","0000","2069","1095","974","117","2186","3886","0","56.25","28.18"
"65","000","00","010","0079","1257","700","373","327","52","752","1332","0","56.46","28.00"
"65","000","00","010","0079","1258","673","351","322","27","700","1238","0","56.54","28.35"
"65","000","00","010","0079","1259","696","371","325","38","734","1316","0","55.78","28.19"
"65","000","00","010","0080","0000","3602","1940","1662","194","3796","7308","0","51.94","26.55"
"65","000","00","010","0080","1260","704","399","305","57","761","1467","0","51.87","27.20"
"65","000","00","010","0080","1261","679","385","294","26","705","1443","0","48.86","26.68"
"65","000","00","010","0080","1262","726","400","326","40","766","1440","0","53.19","27.78"
"65","000","00","010","0080","1263","751","397","354","34","785","1460","0","53.77","27.19"
"65","000","00","010","0080","1264","742","359","383","37","779","1498","0","52.00","23.97"
"65","000","00","010","0081","0000","1663","789","874","94","1757","2588","0","67.89","30.49"
"65","000","00","010","0081","1265","554","217","337","29","583","826","0","70.58","26.27"
"65","000","00","010","0081","1266","550","291","259","24","574","853","0","67.29","34.11"
"65","000","00","010","0081","1267","559","281","278","41","600","909","0","66.01","30.91"
"65","000","00","010","0082","0000","1824","930","894","83","1907","3231","0","59.02","28.78"
"65","000","00","010","0082","1268","904","459","445","28","932","1612","0","57.82","28.47"
"65","000","00","010","0082","1269","920","471","449","55","975","1619","0","60.22","29.09"
"65","000","00","010","0083","0000","1755","982","773","81","1836","3339","0","54.99","29.41"
"65","000","00","010","0083","1270","905","491","414","32","937","1649","0","56.82","29.78"
"65","000","00","010","0083","1271","850","491","359","49","899","1690","0","53.20","29.05"
"65","000","00","010","0084","0000","1929","1038","891","120","2049","3589","0","57.09","28.92"
"65","000","00","010","0084","1275","643","345","298","31","674","1242","0","54.27","27.78"
"65","000","00","010","0084","1276","553","307","246","42","595","1096","0","54.29","28.01"
"65","000","00","010","0084","1277","733","386","347","47","780","1251","0","62.35","30.86"
"65","000","00","010","0085","0000","1230","705","525","98","1328","2170","0","61.20","32.49"
"65","000","00","010","0085","1278","599","350","249","51","650","1014","0","64.10","34.52"
"65","000","00","010","0085","1279","631","355","276","47","678","1156","0","58.65","30.71"
"65","000","00","010","0086","0000","3066","1655","1411","144","3210","5946","0","53.99","27.83"
"65","000","00","010","0086","1282","690","370","320","40","730","1347","0","54.19","27.47"
"65","000","00","010","0086","1283","716","409","307","50","766","1330","0","57.59","30.75"
"65","000","00","010","0086","1284","815","462","353","37","852","1629","0","52.30","28.36"
"65","000","00","010","0086","1285","845","414","431","17","862","1640","0","52.56","25.24"
"65","000","00","010","0087","0000","3684","1838","1846","133","3817","6699","0","56.98","27.44"
"65","000","00","010","0087","1286","695","347","348","17","712","1239","0","57.47","28.01"
"65","000","00","010","0087","1287","748","375","373","27","775","1305","0","59.39","28.74"
"65","000","00","010","0087","1288","670","325","345","24","694","1294","0","53.63","25.12"
"65","000","00","010","0087","1289","784","412","372","41","825","1500","0","55.00","27.47"
"65","000","00","010","0087","1290","787","379","408","24","811","1361","0","59.59","27.85"
"65","000","00","010","0088","0000","1938","991","947","141","2079","3701","0","56.17","26.78"
"65","000","00","010","0088","1291","682","340","342","47","729","1323","0","55.10","25.70"
"65","000","00","010","0088","1292","613","330","283","52","665","1188","0","55.98","27.78"
"65","000","00","010","0088","1293","643","321","322","42","685","1190","0","57.56","26.97"
"65","000","00","010","0089","0000","1812","1029","783","120","1932","3151","0","61.31","32.66"
"65","000","00","010","0089","1294","635","355","280","43","678","1085","0","62.49","32.72"
"65","000","00","010","0089","1295","531","299","232","53","584","1014","0","57.59","29.49"
"65","000","00","010","0089","1296","646","375","271","24","670","1052","0","63.69","35.65"
"65","000","00","010","0090","0000","2225","1302","923","141","2366","4453","0","53.13","29.24"
"65","000","00","010","0090","1297","741","446","295","42","783","1385","0","56.53","32.20"
"65","000","00","010","0090","1298","722","403","319","49","771","1468","0","52.52","27.45"
"65","000","00","010","0090","1299","762","453","309","50","812","1600","0","50.75","28.31"
"65","000","00","010","0091","0000","1765","1035","730","116","1881","3614","0","52.05","28.64"
"65","000","00","010","0091","1300","535","319","216","36","571","1093","0","52.24","29.19"
"65","000","00","010","0091","1301","576","331","245","46","622","1248","0","49.84","26.52"
"65","000","00","010","0091","1302","654","385","269","34","688","1273","0","54.05","30.24"
"65","000","00","010","0092","0000","3217","1717","1500","189","3406","5915","0","57.58","29.03"
"65","000","00","010","0092","1306","702","422","280","52","754","1191","0","63.31","35.43"
"65","000","00","010","0092","1307","629","352","277","56","685","1177","0","58.20","29.91"
"65","000","00","010","0092","1308","638","331","307","46","684","1136","0","60.21","29.14"
"65","000","00","010","0092","1309","553","279","274","23","576","1121","0","51.38","24.89"
"65","000","00","010","0092","1310","695","333","362","12","707","1290","0","54.81","25.81"
"65","000","00","010","0093","0000","490","275","215","52","542","809","0","67.00","33.99"
"65","000","00","010","0093","1311","193","96","97","31","224","343","0","65.31","27.99"
"65","000","00","010","0093","1312","297","179","118","21","318","466","0","68.24","38.41"
"65","000","00","010","0094","0000","2016","1055","961","135","2151","3381","0","63.62","31.20"
"65","000","00","010","0094","1313","657","351","306","31","688","1132","0","60.78","31.01"
"65","000","00","010","0094","1314","674","332","342","54","728","1148","0","63.41","28.92"
"65","000","00","010","0094","1315","685","372","313","50","735","1101","0","66.76","33.79"
"65","000","00","010","0095","0000","3368","1748","1620","167","3535","6195","0","57.06","28.22"
"65","000","00","010","0095","1316","557","267","290","50","607","960","0","63.23","27.81"
"65","000","00","010","0095","1317","635","384","251","49","684","1136","0","60.21","33.80"
"65","000","00","010","0095","1318","772","373","399","15","787","1497","0","52.57","24.92"
"65","000","00","010","0095","1319","652","328","324","22","674","1225","0","55.02","26.78"
"65","000","00","010","0095","1320","752","396","356","31","783","1377","0","56.86","28.76"
"65","000","00","010","0096","0000","2193","1265","928","164","2357","4419","0","53.34","28.63"
"65","000","00","010","0096","1321","562","334","228","22","584","1159","0","50.39","28.82"
"65","000","00","010","0096","1322","570","338","232","47","617","1078","0","57.24","31.35"
"65","000","00","010","0096","1323","522","286","236","47","569","1085","0","52.44","26.36"
"65","000","00","010","0096","1324","539","307","232","48","587","1097","0","53.51","27.99"
"65","000","00","010","0097","0000","1430","839","591","137","1567","2349","0","66.71","35.72"
"65","000","00","010","0097","1325","672","413","259","70","742","1115","0","66.55","37.04"
"65","000","00","010","0097","1326","758","426","332","67","825","1234","0","66.86","34.52"
"65","000","00","010","0098","0000","4093","2268","1825","172","4265","8240","0","51.76","27.52"
"65","000","00","010","0098","1327","662","374","288","27","689","1353","0","50.92","27.64"
"65","000","00","010","0098","1328","707","368","339","51","758","1388","0","54.61","26.51"
"65","000","00","010","0098","1329","621","361","260","18","639","1361","0","46.95","26.52"
"65","000","00","010","0098","1330","656","340","316","26","682","1436","0","47.49","23.68"
"65","000","00","010","0098","1331","768","449","319","27","795","1418","0","56.06","31.66"
"65","000","00","010","0098","1332","679","376","303","23","702","1284","0","54.67","29.28"
"65","000","00","010","0099","0000","2398","1339","1059","123","2521","4946","0","50.97","27.07"
"65","000","00","010","0099","1337","766","419","347","43","809","1707","0","47.39","24.55"
"65","000","00","010","0099","1338","855","468","387","24","879","1666","0","52.76","28.09"
"65","000","00","010","0099","1339","777","452","325","56","833","1573","0","52.96","28.73"
"65","000","00","010","0100","0000","1563","846","717","92","1655","2948","0","56.14","28.70"
"65","000","00","010","0100","1348","758","416","342","53","811","1458","0","55.62","28.53"
"65","000","00","010","0100","1349","805","430","375","39","844","1490","0","56.64","28.86"
"65","000","00","010","0101","0000","1299","707","592","62","1361","2418","0","56.29","29.24"
"65","000","00","010","0101","1015","605","325","280","31","636","1132","0","56.18","28.71"
"65","000","00","010","0101","1016","694","382","312","31","725","1286","0","56.38","29.70"
"65","000","00","010","0102","0000","2219","1203","1016","114","2333","3595","0","64.90","33.46"
"65","000","00","010","0102","1035","666","351","315","60","726","1177","0","61.68","29.82"
"65","000","00","010","0102","1036","829","466","363","26","855","1294","0","66.07","36.01"
"65","000","00","010","0102","1037","724","386","338","28","752","1124","0","66.90","34.34"
"65","000","00","010","0103","0000","1502","811","691","59","1561","2707","0","57.67","29.96"
"65","000","00","010","0103","1064","759","402","357","14","773","1385","0","55.81","29.03"
"65","000","00","010","0103","1065","743","409","334","45","788","1322","0","59.61","30.94"
"65","000","00","010","0104","0000","1672","945","727","111","1783","2827","0","63.07","33.43"
"65","000","00","010","0104","1095","811","450","361","68","879","1431","0","61.43","31.45"
"65","000","00","010","0104","1096","861","495","366","43","904","1396","0","64.76","35.46"
"65","000","00","010","0105","0000","1689","956","733","116","1805","2894","0","62.37","33.03"
"65","000","00","010","0105","1117","535","301","234","37","572","964","0","59.34","31.22"
"65","000","00","010","0105","1118","503","306","197","45","548","909","0","60.29","33.66"
"65","000","00","010","0105","1119","651","349","302","34","685","1021","0","67.09","34.18"
"65","000","00","010","0106","0000","1450","840","610","62","1512","2326","0","65.00","36.11"
"65","000","00","010","0106","1139","788","436","352","38","826","1243","0","66.45","35.08"
"65","000","00","010","0106","1140","662","404","258","24","686","1083","0","63.34","37.30"
"65","000","00","010","0107","0000","1090","610","480","82","1172","1932","0","60.66","31.57"
"65","000","00","010","0107","1177","528","324","204","41","569","978","0","58.18","33.13"
"65","000","00","010","0107","1178","562","286","276","41","603","954","0","63.21","29.98"
"65","000","00","010","0108","0000","1547","853","694","93","1640","2499","0","65.63","34.13"
"65","000","00","010","0108","1193","758","429","329","56","814","1295","0","62.86","33.13"
"65","000","00","010","0108","1194","789","424","365","37","826","1204","0","68.60","35.22"
"65","000","00","010","0109","0000","1134","666","468","50","1184","1859","0","63.69","35.83"
"65","000","00","010","0109","1225","570","339","231","33","603","921","0","65.47","36.81"
"65","000","00","010","0109","1226","564","327","237","17","581","938","0","61.94","34.86"
"65","000","00","010","0110","0000","1902","992","910","67","1969","3176","0","62.00","31.23"
"65","000","00","010","0110","1242","928","489","439","34","962","1549","0","62.10","31.57"
"65","000","00","010","0110","1243","974","503","471","33","1007","1627","0","61.89","30.92"
"65","000","00","010","0111","0000","1027","523","504","59","1086","1683","0","64.53","31.08"
"65","000","00","010","0111","1280","573","297","276","25","598","917","0","65.21","32.39"
"65","000","00","010","0111","1281","454","226","228","34","488","766","0","63.71","29.50"
"65","000","00","010","0112","0000","1775","999","776","75","1850","3564","0","51.91","28.03"
"65","000","00","010","0112","1350","558","317","241","31","589","1149","0","51.26","27.59"
"65","000","00","010","0112","1351","524","297","227","24","548","1057","0","51.84","28.10"
"65","000","00","010","0112","1352","693","385","308","20","713","1358","0","52.50","28.35"
"65","000","00","010","0113","0000","2797","1544","1253","142","2939","5894","0","49.86","26.20"
"65","000","00","010","0113","1333","716","418","298","32","748","1518","0","49.28","27.54"
"65","000","00","010","0113","1334","676","370","306","60","736","1440","0","51.11","25.69"
"65","000","00","010","0113","1335","686","363","323","33","719","1380","0","52.10","26.30"
"65","000","00","010","0113","1336","719","393","326","17","736","1556","0","47.30","25.26"
"65","000","00","010","0114","0000","1244","624","620","85","1329","2182","0","60.91","28.60"
"65","000","00","010","0114","1028","614","302","312","42","656","1114","0","58.89","27.11"
"65","000","00","010","0114","1029","630","322","308","43","673","1068","0","63.01","30.15"
"65","000","00","010","0115","0000","1019","557","462","67","1086","1687","0","64.37","33.02"
"65","000","00","010","0115","1047","568","315","253","50","618","941","0","65.67","33.48"
"65","000","00","010","0115","1048","451","242","209","17","468","746","0","62.73","32.44"
"65","000","00","010","0116","0000","1320","737","583","94","1414","2299","0","61.51","32.06"
"65","000","00","010","0116","1069","693","378","315","47","740","1181","0","62.66","32.01"
"65","000","00","010","0116","1070","627","359","268","47","674","1118","0","60.29","32.11"
"65","000","00","010","0117","0000","1690","974","716","116","1806","2868","0","62.97","33.96"
"65","000","00","010","0117","1107","566","327","239","52","618","1018","0","60.71","32.12"
"65","000","00","010","0117","1108","514","304","210","26","540","844","0","63.98","36.02"
"65","000","00","010","0117","1109","610","343","267","38","648","1006","0","64.41","34.10"
"65","000","00","010","0118","0000","1098","688","410","66","1164","1941","0","59.97","35.45"
"65","000","00","010","0118","1135","595","405","190","40","635","1070","0","59.35","37.85"
"65","000","00","010","0118","1136","503","283","220","26","529","871","0","60.73","32.49"
"65","000","00","010","0119","0000","1815","1050","765","135","1950","3348","0","58.24","31.36"
"65","000","00","010","0119","1149","833","492","341","81","914","1591","0","57.45","30.92"
"65","000","00","010","0119","1150","982","558","424","54","1036","1757","0","58.96","31.76"
"65","000","00","010","0120","0000","1621","893","728","59","1680","3303","0","50.86","27.04"
"65","000","00","010","0120","1183","840","460","380","31","871","1737","0","50.14","26.48"
"65","000","00","010","0120","1184","781","433","348","28","809","1566","0","51.66","27.65"
"65","000","00","010","0121","0000","1880","1004","876","77","1957","3427","0","57.11","29.30"
"65","000","00","010","0121","1203","994","525","469","36","1030","1758","0","58.59","29.86"
"65","000","00","010","0121","1204","886","479","407","41","927","1669","0","55.54","28.70"
"65","000","00","010","0122","0000","1051","597","454","65","1116","1911","0","58.40","31.24"
"65","000","00","010","0122","1230","532","296","236","35","567","938","0","60.45","31.56"
"65","000","00","010","0122","1231","519","301","218","30","549","973","0","56.42","30.94"
"65","000","00","010","0123","0000","1777","1016","761","114","1891","3463","0","54.61","29.34"
"65","000","00","010","0123","1272","631","344","287","44","675","1173","0","57.54","29.33"
"65","000","00","010","0123","1273","582","341","241","38","620","1163","0","53.31","29.32"
"65","000","00","010","0123","1274","564","331","233","32","596","1127","0","52.88","29.37"
"65","000","00","010","0124","0000","6016","3165","2851","235","6251","11803","0","52.96","26.82"
"65","000","00","010","0124","1340","762","391","371","39","801","1471","0","54.45","26.58"
"65","000","00","010","0124","1341","805","428","377","39","844","1520","0","55.53","28.16"
"65","000","00","010","0124","1342","762","428","334","23","785","1488","0","52.76","28.76"
"65","000","00","010","0124","1343","729","385","344","34","763","1464","0","52.12","26.30"
"65","000","00","010","0124","1344","729","402","327","24","753","1422","0","52.95","28.27"
"65","000","00","010","0124","1345","779","374","405","27","806","1598","0","50.44","23.40"
"65","000","00","010","0124","1346","722","383","339","27","749","1393","0","53.77","27.49"
"65","000","00","010","0124","1347","728","374","354","22","750","1447","0","51.83","25.85"
"65","000","00","010","0125","0000","1473","885","588","101","1574","3071","0","51.25","28.82"
"65","000","00","010","0125","1303","751","435","316","40","791","1518","0","52.11","28.66"
"65","000","00","010","0125","1304","722","450","272","61","783","1553","0","50.42","28.98"
"65","000","00","010","0126","0000","533","318","215","27","560","1049","0","53.38","30.31"
"65","000","00","010","0126","1305","533","318","215","27","560","1049","0","53.38","30.31"
"65","000","00","020","0000","0000","172513","99874","72639","10175","182688","321317","378963","56.86","31.08"
"65","000","00","020","0001","0000","2281","1320","961","124","2405","4546","0","52.90","29.04"
"65","000","00","020","0001","0751","672","389","283","36","708","1408","0","50.28","27.63"
"65","000","00","020","0001","0752","406","249","157","28","434","785","0","55.29","31.72"
"65","000","00","020","0001","0753","637","371","266","28","665","1256","0","52.95","29.54"
"65","000","00","020","0001","0754","566","311","255","32","598","1097","0","54.51","28.35"
"65","000","00","020","0002","0000","670","406","264","50","720","1374","0","52.40","29.55"
"65","000","00","020","0002","0758","670","406","264","50","720","1374","0","52.40","29.55"
"65","000","00","020","0003","0000","1130","677","453","41","1171","2271","0","51.56","29.81"
"65","000","00","020","0003","0759","656","385","271","22","678","1258","0","53.90","30.60"
"65","000","00","020","0003","0760","474","292","182","19","493","1013","0","48.67","28.83"
"65","000","00","020","0004","0000","726","444","282","45","771","1246","0","61.88","35.63"
"65","000","00","020","0004","0761","726","444","282","45","771","1246","0","61.88","35.63"
"65","000","00","020","0005","0000","1927","1114","813","106","2033","3421","0","59.43","32.56"
"65","000","00","020","0005","0764","1110","624","486","62","1172","1926","0","60.85","32.40"
"65","000","00","020","0005","0765","817","490","327","44","861","1495","0","57.59","32.78"
"65","000","00","020","0006","0000","220","130","90","11","231","429","0","53.85","30.30"
"65","000","00","020","0006","0766","220","130","90","11","231","429","0","53.85","30.30"
"65","000","00","020","0007","0000","3163","1813","1350","111","3274","6097","0","53.70","29.74"
"65","000","00","020","0007","0767","611","354","257","25","636","1139","0","55.84","31.08"
"65","000","00","020","0007","0768","603","375","228","24","627","1120","0","55.98","33.48"
"65","000","00","020","0007","0769","1005","601","404","27","1032","2085","0","49.50","28.82"
"65","000","00","020","0007","0770","944","483","461","35","979","1753","0","55.85","27.55"
"65","000","00","020","0008","0000","2603","1501","1102","122","2725","4877","0","55.87","30.78"
"65","000","00","020","0008","0771","691","407","284","31","722","1256","0","57.48","32.40"
"65","000","00","020","0008","0772","700","397","303","33","733","1231","0","59.55","32.25"
"65","000","00","020","0008","0773","562","334","228","40","602","1086","0","55.43","30.76"
"65","000","00","020","0008","0774","650","363","287","18","668","1304","0","51.23","27.84"
"65","000","00","020","0009","0000","1414","852","562","102","1516","2890","0","52.46","29.48"
"65","000","00","020","0009","0777","754","458","296","36","790","1472","0","53.67","31.11"
"65","000","00","020","0009","0778","660","394","266","66","726","1418","0","51.20","27.79"
"65","000","00","020","0010","0000","3097","1720","1377","135","3232","8606","0","37.56","19.99"
"65","000","00","020","0010","0779","827","501","326","35","862","4679","0","18.42","10.71"
"65","000","00","020","0010","0780","686","348","338","31","717","1150","0","62.35","30.26"
"65","000","00","020","0010","0781","827","459","368","43","870","1380","0","63.04","33.26"
"65","000","00","020","0010","0782","757","412","345","26","783","1397","0","56.05","29.49"
"65","000","00","020","0011","0000","1079","612","467","55","1134","1840","0","61.63","33.26"
"65","000","00","020","0011","0783","606","336","270","32","638","1017","0","62.73","33.04"
"65","000","00","020","0011","0784","473","276","197","23","496","823","0","60.27","33.54"
"65","000","00","020","0012","0000","1670","964","706","109","1779","3146","0","56.55","30.64"
"65","000","00","020","0012","0785","767","437","330","72","839","1436","0","58.43","30.43"
"65","000","00","020","0012","0786","903","527","376","37","940","1710","0","54.97","30.82"
"65","000","00","020","0013","0000","2282","1315","967","113","2395","3868","0","61.92","34.00"
"65","000","00","020","0013","0787","733","427","306","39","772","1297","0","59.52","32.92"
"65","000","00","020","0013","0788","781","465","316","48","829","1341","0","61.82","34.68"
"65","000","00","020","0013","0789","768","423","345","26","794","1230","0","64.55","34.39"
"65","000","00","020","0014","0000","2995","1674","1321","154","3149","5545","0","56.79","30.19"
"65","000","00","020","0014","0790","990","558","432","46","1036","1886","0","54.93","29.59"
"65","000","00","020","0014","0791","518","281","237","27","545","937","0","58.16","29.99"
"65","000","00","020","0014","0792","720","421","299","46","766","1375","0","55.71","30.62"
"65","000","00","020","0014","0793","767","414","353","35","802","1347","0","59.54","30.73"
"65","000","00","020","0015","0000","2086","1224","862","123","2209","3553","0","62.17","34.45"
"65","000","00","020","0015","0794","687","386","301","40","727","1176","0","61.82","32.82"
"65","000","00","020","0015","0795","678","375","303","52","730","1176","0","62.07","31.89"
"65","000","00","020","0015","0796","721","463","258","31","752","1201","0","62.61","38.55"
"65","000","00","020","0016","0000","1723","970","753","104","1827","3007","0","60.76","32.26"
"65","000","00","020","0016","0797","805","441","364","44","849","1442","0","58.88","30.58"
"65","000","00","020","0016","0798","918","529","389","60","978","1565","0","62.49","33.80"
"65","000","00","020","0017","0000","2840","1653","1187","160","3000","5261","0","57.02","31.42"
"65","000","00","020","0017","0799","693","416","277","48","741","1246","0","59.47","33.39"
"65","000","00","020","0017","0800","738","408","330","34","772","1199","0","64.39","34.03"
"65","000","00","020","0017","0801","720","426","294","36","756","1389","0","54.43","30.67"
"65","000","00","020","0017","0802","689","403","286","42","731","1427","0","51.23","28.24"
"65","000","00","020","0018","0000","2910","1690","1220","182","3092","5287","0","58.48","31.97"
"65","000","00","020","0018","0803","933","552","381","64","997","1648","0","60.50","33.50"
"65","000","00","020","0018","0804","1074","614","460","63","1137","1917","0","59.31","32.03"
"65","000","00","020","0018","0805","903","524","379","55","958","1722","0","55.63","30.43"
"65","000","00","020","0019","0000","1673","995","678","72","1745","2842","0","61.40","35.01"
"65","000","00","020","0019","0806","819","484","335","35","854","1383","0","61.75","35.00"
"65","000","00","020","0019","0807","854","511","343","37","891","1459","0","61.07","35.02"
"65","000","00","020","0020","0000","3088","1744","1344","154","3242","6252","0","51.86","27.90"
"65","000","00","020","0020","0808","618","330","288","34","652","1351","0","48.26","24.43"
"65","000","00","020","0020","0809","822","454","368","41","863","1642","0","52.56","27.65"
"65","000","00","020","0020","0810","816","493","323","46","862","1688","0","51.07","29.21"
"65","000","00","020","0020","0811","832","467","365","33","865","1571","0","55.06","29.73"
"65","000","00","020","0021","0000","1215","626","589","70","1285","2338","0","54.96","26.78"
"65","000","00","020","0021","0812","612","298","314","29","641","1175","0","54.55","25.36"
"65","000","00","020","0021","0813","603","328","275","41","644","1163","0","55.37","28.20"
"65","000","00","020","0022","0000","582","352","230","38","620","1252","0","49.52","28.12"
"65","000","00","020","0022","0814","582","352","230","38","620","1252","0","49.52","28.12"
"65","000","00","020","0023","0000","862","475","387","37","899","1536","0","58.53","30.92"
"65","000","00","020","0023","0815","862","475","387","37","899","1536","0","58.53","30.92"
"65","000","00","020","0024","0000","1095","621","474","59","1154","1913","0","60.32","32.46"
"65","000","00","020","0024","0816","595","350","245","29","624","1035","0","60.29","33.82"
"65","000","00","020","0024","0817","500","271","229","30","530","878","0","60.36","30.87"
"65","000","00","020","0025","0000","937","502","435","62","999","1575","0","63.43","31.87"
"65","000","00","020","0025","0818","937","502","435","62","999","1575","0","63.43","31.87"
"65","000","00","020","0026","0000","779","447","332","58","837","1225","0","68.33","36.49"
"65","000","00","020","0026","0819","779","447","332","58","837","1225","0","68.33","36.49"
"65","000","00","020","0027","0000","613","323","290","54","667","1275","0","52.31","25.33"
"65","000","00","020","0027","0820","613","323","290","54","667","1275","0","52.31","25.33"
"65","000","00","020","0028","0000","966","562","404","64","1030","1784","0","57.74","31.50"
"65","000","00","020","0028","0821","966","562","404","64","1030","1784","0","57.74","31.50"
"65","000","00","020","0029","0000","638","363","275","42","680","1082","0","62.85","33.55"
"65","000","00","020","0029","0822","638","363","275","42","680","1082","0","62.85","33.55"
"65","000","00","020","0030","0000","669","404","265","42","711","1383","0","51.41","29.21"
"65","000","00","020","0030","0823","669","404","265","42","711","1383","0","51.41","29.21"
"65","000","00","020","0031","0000","781","403","378","88","869","1437","0","60.47","28.04"
"65","000","00","020","0031","0824","781","403","378","88","869","1437","0","60.47","28.04"
"65","000","00","020","0032","0000","947","527","420","78","1025","1731","0","59.21","30.44"
"65","000","00","020","0032","0825","478","279","199","35","513","880","0","58.30","31.70"
"65","000","00","020","0032","0826","469","248","221","43","512","851","0","60.16","29.14"
"65","000","00","020","0033","0000","864","492","372","70","934","1578","0","59.19","31.18"
"65","000","00","020","0033","0827","864","492","372","70","934","1578","0","59.19","31.18"
"65","000","00","020","0034","0000","686","396","290","57","743","1214","0","61.20","32.62"
"65","000","00","020","0034","0828","686","396","290","57","743","1214","0","61.20","32.62"
"65","000","00","020","0035","0000","667","394","273","30","697","1269","0","54.93","31.05"
"65","000","00","020","0035","0829","667","394","273","30","697","1269","0","54.93","31.05"
"65","000","00","020","0036","0000","742","442","300","56","798","1311","0","60.87","33.71"
"65","000","00","020","0036","0830","742","442","300","56","798","1311","0","60.87","33.71"
"65","000","00","020","0037","0000","571","323","248","32","603","1071","0","56.30","30.16"
"65","000","00","020","0037","0831","571","323","248","32","603","1071","0","56.30","30.16"
"65","000","00","020","0038","0000","1058","572","486","75","1133","1971","0","57.48","29.02"
"65","000","00","020","0038","0832","547","308","239","43","590","1038","0","56.84","29.67"
"65","000","00","020","0038","0833","511","264","247","32","543","933","0","58.20","28.30"
"65","000","00","020","0039","0000","1858","1061","797","96","1954","3544","0","55.14","29.94"
"65","000","00","020","0039","0834","971","575","396","44","1015","1831","0","55.43","31.40"
"65","000","00","020","0039","0835","887","486","401","52","939","1713","0","54.82","28.37"
"65","000","00","020","0040","0000","728","396","332","42","770","1309","0","58.82","30.25"
"65","000","00","020","0040","0836","728","396","332","42","770","1309","0","58.82","30.25"
"65","000","00","020","0041","0000","1343","747","596","85","1428","2316","0","61.66","32.25"
"65","000","00","020","0041","0837","755","410","345","30","785","1306","0","60.11","31.39"
"65","000","00","020","0041","0838","588","337","251","55","643","1010","0","63.66","33.37"
"65","000","00","020","0042","0000","1129","659","470","77","1206","2343","0","51.47","28.13"
"65","000","00","020","0042","0839","554","313","241","54","608","1133","0","53.66","27.63"
"65","000","00","020","0042","0840","575","346","229","23","598","1210","0","49.42","28.60"
"65","000","00","020","0043","0000","1318","748","570","106","1424","2323","0","61.30","32.20"
"65","000","00","020","0043","0841","656","369","287","54","710","1141","0","62.23","32.34"
"65","000","00","020","0043","0842","662","379","283","52","714","1182","0","60.41","32.06"
"65","000","00","020","0044","0000","1587","912","675","74","1661","3004","0","55.29","30.36"
"65","000","00","020","0044","0843","819","465","354","52","871","1530","0","56.93","30.39"
"65","000","00","020","0044","0844","768","447","321","22","790","1474","0","53.60","30.33"
"65","000","00","020","0045","0000","2042","1259","783","107","2149","3660","0","58.72","34.40"
"65","000","00","020","0045","0845","560","360","200","35","595","1082","0","54.99","33.27"
"65","000","00","020","0045","0846","756","465","291","29","785","1320","0","59.47","35.23"
"65","000","00","020","0045","0847","726","434","292","43","769","1258","0","61.13","34.50"
"65","000","00","020","0046","0000","853","518","335","63","916","1322","0","69.29","39.18"
"65","000","00","020","0046","0848","853","518","335","63","916","1322","0","69.29","39.18"
"65","000","00","020","0047","0000","501","316","185","44","545","964","0","56.54","32.78"
"65","000","00","020","0047","0849","501","316","185","44","545","964","0","56.54","32.78"
"65","000","00","020","0048","0000","842","511","331","53","895","1544","0","57.97","33.10"
"65","000","00","020","0048","0850","842","511","331","53","895","1544","0","57.97","33.10"
"65","000","00","020","0049","0000","916","488","428","41","957","1673","0","57.20","29.17"
"65","000","00","020","0049","0851","916","488","428","41","957","1673","0","57.20","29.17"
"65","000","00","020","0050","0000","860","485","375","77","937","1591","0","58.89","30.48"
"65","000","00","020","0050","0852","860","485","375","77","937","1591","0","58.89","30.48"
"65","000","00","020","0051","0000","1149","682","467","64","1213","1922","0","63.11","35.48"
"65","000","00","020","0051","0853","580","356","224","31","611","1001","0","61.04","35.56"
"65","000","00","020","0051","0854","569","326","243","33","602","921","0","65.36","35.40"
"65","000","00","020","0052","0000","890","542","348","77","967","1663","0","58.15","32.59"
"65","000","00","020","0052","0855","890","542","348","77","967","1663","0","58.15","32.59"
"65","000","00","020","0053","0000","553","291","262","31","584","824","0","70.87","35.32"
"65","000","00","020","0053","0856","553","291","262","31","584","824","0","70.87","35.32"
"65","000","00","020","0054","0000","680","405","275","73","753","1292","0","58.28","31.35"
"65","000","00","020","0054","0857","680","405","275","73","753","1292","0","58.28","31.35"
"65","000","00","020","0055","0000","997","584","413","73","1070","1613","0","66.34","36.21"
"65","000","00","020","0055","0858","594","336","258","40","634","960","0","66.04","35.00"
"65","000","00","020","0055","0859","403","248","155","33","436","653","0","66.77","37.98"
"65","000","00","020","0056","0000","893","530","363","60","953","1819","0","52.39","29.14"
"65","000","00","020","0056","0860","383","234","149","29","412","868","0","47.47","26.96"
"65","000","00","020","0056","0861","510","296","214","31","541","951","0","56.89","31.13"
"65","000","00","020","0057","0000","1091","655","436","64","1155","2058","0","56.12","31.83"
"65","000","00","020","0057","0862","581","334","247","34","615","1050","0","58.57","31.81"
"65","000","00","020","0057","0863","510","321","189","30","540","1008","0","53.57","31.85"
"65","000","00","020","0058","0000","462","277","185","28","490","788","0","62.18","35.15"
"65","000","00","020","0058","0864","462","277","185","28","490","788","0","62.18","35.15"
"65","000","00","020","0059","0000","881","518","363","46","927","1450","0","63.93","35.72"
"65","000","00","020","0059","0865","881","518","363","46","927","1450","0","63.93","35.72"
"65","000","00","020","0060","0000","464","269","195","27","491","730","0","67.26","36.85"
"65","000","00","020","0060","0866","464","269","195","27","491","730","0","67.26","36.85"
"65","000","00","020","0061","0000","1180","683","497","78","1258","2143","0","58.70","31.87"
"65","000","00","020","0061","0867","543","314","229","25","568","1010","0","56.24","31.09"
"65","000","00","020","0061","0868","637","369","268","53","690","1133","0","60.90","32.57"
"65","000","00","020","0062","0000","889","535","354","56","945","1756","0","53.82","30.47"
"65","000","00","020","0062","0869","418","250","168","29","447","830","0","53.86","30.12"
"65","000","00","020","0062","0870","471","285","186","27","498","926","0","53.78","30.78"
"65","000","00","020","0063","0000","1030","610","420","57","1087","1947","0","55.83","31.33"
"65","000","00","020","0063","0871","558","327","231","33","591","1059","0","55.81","30.88"
"65","000","00","020","0063","0872","472","283","189","24","496","888","0","55.86","31.87"
"65","000","00","020","0064","0000","720","418","302","49","769","1374","0","55.97","30.42"
"65","000","00","020","0064","0873","720","418","302","49","769","1374","0","55.97","30.42"
"65","000","00","020","0065","0000","625","335","290","43","668","1003","0","66.60","33.40"
"65","000","00","020","0065","0874","625","335","290","43","668","1003","0","66.60","33.40"
"65","000","00","020","0066","0000","926","537","389","81","1007","1730","0","58.21","31.04"
"65","000","00","020","0066","0875","430","261","169","30","460","828","0","55.56","31.52"
"65","000","00","020","0066","0876","496","276","220","51","547","902","0","60.64","30.60"
"65","000","00","020","0067","0000","1086","630","456","78","1164","2028","0","57.40","31.07"
"65","000","00","020","0067","0877","543","300","243","44","587","1006","0","58.35","29.82"
"65","000","00","020","0067","0878","543","330","213","34","577","1022","0","56.46","32.29"
"65","000","00","020","0068","0000","1551","884","667","115","1666","2819","0","59.10","31.36"
"65","000","00","020","0068","0879","726","423","303","57","783","1324","0","59.14","31.95"
"65","000","00","020","0068","0880","825","461","364","58","883","1495","0","59.06","30.84"
"65","000","00","020","0069","0000","961","564","397","75","1036","1638","0","63.25","34.43"
"65","000","00","020","0069","0881","961","564","397","75","1036","1638","0","63.25","34.43"
"65","000","00","020","0070","0000","560","304","256","39","599","1088","0","55.06","27.94"
"65","000","00","020","0070","0882","560","304","256","39","599","1088","0","55.06","27.94"
"65","000","00","020","0071","0000","834","492","342","67","901","1469","0","61.33","33.49"
"65","000","00","020","0071","0883","834","492","342","67","901","1469","0","61.33","33.49"
"65","000","00","020","0072","0000","1230","700","530","74","1304","2309","0","56.47","30.32"
"65","000","00","020","0072","0884","562","306","256","37","599","1091","0","54.90","28.05"
"65","000","00","020","0072","0885","668","394","274","37","705","1218","0","57.88","32.35"
"65","000","00","020","0073","0000","1360","786","574","89","1449","2609","0","55.54","30.13"
"65","000","00","020","0073","0886","657","370","287","42","699","1297","0","53.89","28.53"
"65","000","00","020","0073","0887","703","416","287","47","750","1312","0","57.16","31.71"
"65","000","00","020","0074","0000","890","509","381","45","935","1753","0","53.34","29.04"
"65","000","00","020","0074","0888","890","509","381","45","935","1753","0","53.34","29.04"
"65","000","00","020","0075","0000","968","584","384","62","1030","1832","0","56.22","31.88"
"65","000","00","020","0075","0889","482","282","200","29","511","920","0","55.54","30.65"
"65","000","00","020","0075","0890","486","302","184","33","519","912","0","56.91","33.11"
"65","000","00","020","0076","0000","1938","1132","806","118","2056","3985","0","51.59","28.41"
"65","000","00","020","0076","0891","675","389","286","33","708","1448","0","48.90","26.86"
"65","000","00","020","0076","0892","687","410","277","26","713","1340","0","53.21","30.60"
"65","000","00","020","0076","0893","576","333","243","59","635","1197","0","53.05","27.82"
"65","000","00","020","0077","0000","1868","1065","803","108","1976","3268","0","60.47","32.59"
"65","000","00","020","0077","0894","893","510","383","52","945","1577","0","59.92","32.34"
"65","000","00","020","0077","0895","975","555","420","56","1031","1691","0","60.97","32.82"
"65","000","00","020","0078","0000","2630","1527","1103","143","2773","4751","0","58.37","32.14"
"65","000","00","020","0078","0896","626","389","237","33","659","1189","0","55.42","32.72"
"65","000","00","020","0078","0897","661","388","273","33","694","1075","0","64.56","36.09"
"65","000","00","020","0078","0898","656","383","273","36","692","1181","0","58.59","32.43"
"65","000","00","020","0078","0899","687","367","320","41","728","1306","0","55.74","28.10"
"65","000","00","020","0079","0000","1043","622","421","97","1140","1927","0","59.16","32.28"
"65","000","00","020","0079","0900","577","342","235","52","629","1052","0","59.79","32.51"
"65","000","00","020","0079","0901","466","280","186","45","511","875","0","58.40","32.00"
"65","000","00","020","0080","0000","843","531","312","74","917","1528","0","60.01","34.75"
"65","000","00","020","0080","0902","843","531","312","74","917","1528","0","60.01","34.75"
"65","000","00","020","0081","0000","1245","736","509","130","1375","2103","0","65.38","35.00"
"65","000","00","020","0081","0903","595","350","245","59","654","1031","0","63.43","33.95"
"65","000","00","020","0081","0904","650","386","264","71","721","1072","0","67.26","36.01"
"65","000","00","020","0082","0000","1996","1210","786","126","2122","3443","0","61.63","35.14"
"65","000","00","020","0082","0905","726","434","292","52","778","1162","0","66.95","37.35"
"65","000","00","020","0082","0906","564","318","246","34","598","1012","0","59.09","31.42"
"65","000","00","020","0082","0907","706","458","248","40","746","1269","0","58.79","36.09"
"65","000","00","020","0083","0000","1820","1008","812","103","1923","2969","0","64.77","33.95"
"65","000","00","020","0083","0908","929","524","405","59","988","1481","0","66.71","35.38"
"65","000","00","020","0083","0909","891","484","407","44","935","1488","0","62.84","32.53"
"65","000","00","020","0084","0000","1436","883","553","78","1514","2427","0","62.38","36.38"
"65","000","00","020","0084","0910","763","487","276","53","816","1279","0","63.80","38.08"
"65","000","00","020","0084","0911","673","396","277","25","698","1148","0","60.80","34.49"
"65","000","00","020","0085","0000","1442","814","628","101","1543","2582","0","59.76","31.53"
"65","000","00","020","0085","0912","824","469","355","50","874","1519","0","57.54","30.88"
"65","000","00","020","0085","0913","618","345","273","51","669","1063","0","62.94","32.46"
"65","000","00","020","0086","0000","1886","1087","799","70","1956","3124","0","62.61","34.80"
"65","000","00","020","0086","0914","924","538","386","41","965","1530","0","63.07","35.16"
"65","000","00","020","0086","0915","962","549","413","29","991","1594","0","62.17","34.44"
"65","000","00","020","0087","0000","2324","1359","965","156","2480","4125","0","60.12","32.95"
"65","000","00","020","0087","0918","791","433","358","61","852","1403","0","60.73","30.86"
"65","000","00","020","0087","0919","687","431","256","44","731","1214","0","60.21","35.50"
"65","000","00","020","0087","0920","846","495","351","51","897","1508","0","59.48","32.82"
"65","000","00","020","0088","0000","1410","833","577","108","1518","2685","0","56.54","31.02"
"65","000","00","020","0088","0926","682","399","283","52","734","1303","0","56.33","30.62"
"65","000","00","020","0088","0927","728","434","294","56","784","1382","0","56.73","31.40"
"65","000","00","020","0089","0000","2315","1378","937","147","2462","4417","0","55.74","31.20"
"65","000","00","020","0089","0935","712","427","285","47","759","1306","0","58.12","32.70"
"65","000","00","020","0089","0936","810","485","325","43","853","1590","0","53.65","30.50"
"65","000","00","020","0089","0937","793","466","327","57","850","1521","0","55.88","30.64"
"65","000","00","020","0090","0000","2578","1543","1035","175","2753","4491","0","61.30","34.36"
"65","000","00","020","0090","0938","838","488","350","56","894","1500","0","59.60","32.53"
"65","000","00","020","0090","0939","897","547","350","65","962","1577","0","61.00","34.69"
"65","000","00","020","0090","0940","843","508","335","54","897","1414","0","63.44","35.93"
"65","000","00","020","0091","0000","1890","1066","824","102","1992","3414","0","58.35","31.22"
"65","000","00","020","0091","0930","1007","568","439","51","1058","1856","0","57.00","30.60"
"65","000","00","020","0091","0931","883","498","385","51","934","1558","0","59.95","31.96"
"65","000","00","020","0092","0000","1254","752","502","77","1331","2151","0","61.88","34.96"
"65","000","00","020","0092","0921","653","368","285","48","701","1113","0","62.98","33.06"
"65","000","00","020","0092","0922","601","384","217","29","630","1038","0","60.69","36.99"
"65","000","00","020","0093","0000","4094","2394","1700","210","4304","7481","0","57.53","32.00"
"65","000","00","020","0093","0944","677","409","268","46","723","1134","0","63.76","36.07"
"65","000","00","020","0093","0945","796","473","323","41","837","1481","0","56.52","31.94"
"65","000","00","020","0093","0946","832","483","349","30","862","1546","0","55.76","31.24"
"65","000","00","020","0093","0947","853","470","383","41","894","1586","0","56.37","29.63"
"65","000","00","020","0093","0948","936","559","377","52","988","1734","0","56.98","32.24"
"65","000","00","020","0094","0000","2002","1181","821","91","2093","3742","0","55.93","31.56"
"65","000","00","020","0094","0949","714","431","283","28","742","1329","0","55.83","32.43"
"65","000","00","020","0094","0950","634","368","266","32","666","1200","0","55.50","30.67"
"65","000","00","020","0094","0951","654","382","272","31","685","1213","0","56.47","31.49"
"65","000","00","020","0095","0000","2520","1501","1019","141","2661","4400","0","60.48","34.11"
"65","000","00","020","0095","0952","999","581","418","53","1052","1719","0","61.20","33.80"
"65","000","00","020","0095","0953","815","498","317","47","862","1394","0","61.84","35.72"
"65","000","00","020","0095","0954","706","422","284","41","747","1287","0","58.04","32.79"
"65","000","00","020","0096","0000","1539","901","638","80","1619","3315","0","48.84","27.18"
"65","000","00","020","0096","0955","475","278","197","35","510","986","0","51.72","28.19"
"65","000","00","020","0096","0956","425","256","169","23","448","941","0","47.61","27.21"
"65","000","00","020","0096","0957","639","367","272","22","661","1388","0","47.62","26.44"
"65","000","00","020","0097","0000","1452","810","642","98","1550","2747","0","56.43","29.49"
"65","000","00","020","0097","0958","731","414","317","60","791","1458","0","54.25","28.40"
"65","000","00","020","0097","0959","721","396","325","38","759","1289","0","58.88","30.72"
"65","000","00","020","0098","0000","982","583","399","68","1050","1952","0","53.79","29.87"
"65","000","00","020","0098","0960","426","251","175","26","452","810","0","55.80","30.99"
"65","000","00","020","0098","0961","556","332","224","42","598","1142","0","52.36","29.07"
"65","000","00","020","0099","0000","1090","653","437","103","1193","1933","0","61.72","33.78"
"65","000","00","020","0099","0962","514","291","223","52","566","967","0","58.53","30.09"
"65","000","00","020","0099","0963","576","362","214","51","627","966","0","64.91","37.47"
"65","000","00","020","0100","0000","1101","715","386","71","1172","1925","0","60.88","37.14"
"65","000","00","020","0100","0964","514","346","168","22","536","879","0","60.98","39.36"
"65","000","00","020","0100","0965","587","369","218","49","636","1046","0","60.80","35.28"
"65","000","00","020","0101","0000","1836","1109","727","92","1928","2965","0","65.03","37.40"
"65","000","00","020","0101","0966","962","592","370","56","1018","1546","0","65.85","38.29"
"65","000","00","020","0101","0967","874","517","357","36","910","1419","0","64.13","36.43"
"65","000","00","020","0102","0000","1119","642","477","79","1198","2136","0","56.09","30.06"
"65","000","00","020","0102","0968","533","323","210","53","586","1001","0","58.54","32.27"
"65","000","00","020","0102","0969","586","319","267","26","612","1135","0","53.92","28.11"
"65","000","00","020","0103","0000","2313","1344","969","141","2454","4245","0","57.81","31.66"
"65","000","00","020","0103","0970","801","484","317","55","856","1514","0","56.54","31.97"
"65","000","00","020","0103","0971","784","433","351","29","813","1443","0","56.34","30.01"
"65","000","00","020","0103","0972","728","427","301","57","785","1288","0","60.95","33.15"
"65","000","00","020","0104","0000","2358","1387","971","116","2474","4368","0","56.64","31.75"
"65","000","00","020","0104","0980","682","418","264","34","716","1287","0","55.63","32.48"
"65","000","00","020","0104","0981","837","476","361","54","891","1593","0","55.93","29.88"
"65","000","00","020","0104","0982","839","493","346","28","867","1488","0","58.27","33.13"
"65","000","00","020","0105","0000","2862","1542","1320","123","2985","5640","0","52.93","27.34"
"65","000","00","020","0105","0975","812","469","343","41","853","1718","0","49.65","27.30"
"65","000","00","020","0105","0976","974","522","452","40","1014","1824","0","55.59","28.62"
"65","000","00","020","0105","0977","1076","551","525","42","1118","2098","0","53.29","26.26"
"65","000","00","020","0106","0000","1497","850","647","99","1596","2832","0","56.36","30.01"
"65","000","00","020","0106","0973","713","401","312","46","759","1343","0","56.52","29.86"
"65","000","00","020","0106","0974","784","449","335","53","837","1489","0","56.21","30.15"
"65","000","00","020","0107","0000","894","510","384","57","951","1786","0","53.25","28.56"
"65","000","00","020","0107","0978","413","237","176","28","441","838","0","52.63","28.28"
"65","000","00","020","0107","0979","481","273","208","29","510","948","0","53.80","28.80"
"65","000","00","020","0108","0000","3713","2034","1679","105","3818","7180","0","53.18","28.33"
"65","000","00","020","0108","0983","650","387","263","34","684","1213","0","56.39","31.90"
"65","000","00","020","0108","0984","551","311","240","17","568","990","0","57.37","31.41"
"65","000","00","020","0108","0985","671","357","314","15","686","1341","0","51.16","26.62"
"65","000","00","020","0108","0986","829","451","378","18","847","1696","0","49.94","26.59"
"65","000","00","020","0108","0987","1012","528","484","21","1033","1940","0","53.25","27.22"
"65","000","00","020","0109","0000","961","553","408","49","1010","1655","0","61.03","33.41"
"65","000","00","020","0109","0762","468","280","188","18","486","894","0","54.36","31.32"
"65","000","00","020","0109","0763","493","273","220","31","524","761","0","68.86","35.87"
"65","000","00","020","0110","0000","2170","1231","939","110","2280","3919","0","58.18","31.41"
"65","000","00","020","0110","0755","735","449","286","49","784","1298","0","60.40","34.59"
"65","000","00","020","0110","0756","756","368","388","31","787","1376","0","57.19","26.74"
"65","000","00","020","0110","0757","679","414","265","30","709","1245","0","56.95","33.25"
"65","000","00","020","0111","0000","1810","1013","797","75","1885","3539","0","53.26","28.62"
"65","000","00","020","0111","0775","910","526","384","47","957","1735","0","55.16","30.32"
"65","000","00","020","0111","0776","900","487","413","28","928","1804","0","51.44","27.00"
"65","000","00","020","0112","0000","1358","772","586","80","1438","2414","0","59.57","31.98"
"65","000","00","020","0112","0928","723","414","309","27","750","1242","0","60.39","33.33"
"65","000","00","020","0112","0929","635","358","277","53","688","1172","0","58.70","30.55"
"65","000","00","020","0113","0000","2567","1574","993","113","2680","4860","0","55.14","32.39"
"65","000","00","020","0113","0923","932","552","380","47","979","1706","0","57.39","32.36"
"65","000","00","020","0113","0924","681","424","257","25","706","1464","0","48.22","28.96"
"65","000","00","020","0113","0925","954","598","356","41","995","1690","0","58.88","35.38"
"65","000","00","020","0114","0000","2042","1223","819","116","2158","4292","0","50.28","28.49"
"65","000","00","020","0114","0941","611","359","252","44","655","1295","0","50.58","27.72"
"65","000","00","020","0114","0942","718","432","286","35","753","1567","0","48.05","27.57"
"65","000","00","020","0114","0943","713","432","281","37","750","1430","0","52.45","30.21"
"65","000","00","020","0115","0000","2353","1420","933","126","2479","4839","0","51.23","29.34"
"65","000","00","020","0115","0932","714","442","272","33","747","1523","0","49.05","29.02"
"65","000","00","020","0115","0933","819","480","339","49","868","1664","0","52.16","28.85"
"65","000","00","020","0115","0934","820","498","322","44","864","1652","0","52.30","30.15"
"65","000","00","020","0116","0000","1732","957","775","78","1810","2934","0","61.69","32.62"
"65","000","00","020","0116","0916","782","422","360","40","822","1287","0","63.87","32.79"
"65","000","00","020","0116","0917","950","535","415","38","988","1647","0","59.99","32.48"
"65","000","00","020","0117","0000","1614","942","672","109","1723","3181","0","54.17","29.61"
"65","000","00","020","0117","0988","775","463","312","55","830","1534","0","54.11","30.18"
"65","000","00","020","0117","0989","839","479","360","54","893","1647","0","54.22","29.08"
"65","000","00","020","0118","0000","2007","1128","879","135","2142","3694","0","57.99","30.54"
"65","000","00","020","0118","0990","571","323","248","43","614","1034","0","59.38","31.24"
"65","000","00","020","0118","0991","722","412","310","45","767","1291","0","59.41","31.91"
"65","000","00","020","0118","0992","714","393","321","47","761","1369","0","55.59","28.71"
"65","000","00","020","0119","0000","1513","893","620","96","1609","3400","0","47.32","26.26"
"65","000","00","020","0119","0993","600","343","257","54","654","1477","0","44.28","23.22"
"65","000","00","020","0119","0994","371","210","161","21","392","805","0","48.70","26.09"
"65","000","00","020","0119","0995","542","340","202","21","563","1118","0","50.36","30.41"
"65","000","00","030","0000","0000","187759","92174","95585","9719","197478","343320","401841","57.52","26.85"
"65","000","00","030","0001","0000","4027","2054","1973","136","4163","7625","0","54.60","26.94"
"65","000","00","030","0001","1353","725","370","355","25","750","1363","0","55.03","27.15"
"65","000","00","030","0001","1354","829","399","430","33","862","1500","0","57.47","26.60"
"65","000","00","030","0001","1355","736","373","363","17","753","1473","0","51.12","25.32"
"65","000","00","030","0001","1356","964","505","459","23","987","1811","0","54.50","27.89"
"65","000","00","030","0001","1357","773","407","366","38","811","1478","0","54.87","27.54"
"65","000","00","030","0002","0000","4152","2107","2045","190","4342","7742","0","56.08","27.22"
"65","000","00","030","0002","1407","810","458","352","50","860","1655","0","51.96","27.67"
"65","000","00","030","0002","1408","916","493","423","58","974","1764","0","55.22","27.95"
"65","000","00","030","0002","1409","631","306","325","26","657","1240","0","52.98","24.68"
"65","000","00","030","0002","1410","1027","507","520","41","1068","1824","0","58.55","27.80"
"65","000","00","030","0002","1411","768","343","425","15","783","1259","0","62.19","27.24"
"65","000","00","030","0003","0000","1895","1020","875","100","1995","3608","0","55.29","28.27"
"65","000","00","030","0003","1412","616","338","278","34","650","1109","0","58.61","30.48"
"65","000","00","030","0003","1413","578","311","267","15","593","1166","0","50.86","26.67"
"65","000","00","030","0003","1414","701","371","330","51","752","1333","0","56.41","27.83"
"65","000","00","030","0004","0000","1758","882","876","126","1884","3299","0","57.11","26.74"
"65","000","00","030","0004","1415","581","277","304","42","623","1146","0","54.36","24.17"
"65","000","00","030","0004","1416","504","254","250","35","539","937","0","57.52","27.11"
"65","000","00","030","0004","1417","673","351","322","49","722","1216","0","59.38","28.87"
"65","000","00","030","0005","0000","1744","907","837","94","1838","3294","0","55.80","27.53"
"65","000","00","030","0005","1418","882","441","441","37","919","1697","0","54.15","25.99"
"65","000","00","030","0005","1419","862","466","396","57","919","1597","0","57.55","29.18"
"65","000","00","030","0006","0000","1701","763","938","94","1795","2991","0","60.01","25.51"
"65","000","00","030","0006","1420","881","326","555","40","921","1501","0","61.36","21.72"
"65","000","00","030","0006","1421","820","437","383","54","874","1490","0","58.66","29.33"
"65","000","00","030","0007","0000","1165","503","662","44","1209","2072","0","58.35","24.28"
"65","000","00","030","0007","1358","558","245","313","29","587","940","0","62.45","26.06"
"65","000","00","030","0007","1359","607","258","349","15","622","1132","0","54.95","22.79"
"65","000","00","030","0008","0000","3160","1492","1668","167","3327","5451","0","61.03","27.37"
"65","000","00","030","0008","1360","942","451","491","30","972","1629","0","59.67","27.69"
"65","000","00","030","0008","1361","648","241","407","35","683","1043","0","65.48","23.11"
"65","000","00","030","0008","1362","893","485","408","64","957","1607","0","59.55","30.18"
"65","000","00","030","0008","1363","677","315","362","38","715","1172","0","61.01","26.88"
"65","000","00","030","0009","0000","2940","1486","1454","133","3073","5115","0","60.08","29.05"
"65","000","00","030","0009","1364","1071","507","564","44","1115","1883","0","59.21","26.93"
"65","000","00","030","0009","1365","952","509","443","55","1007","1581","0","63.69","32.19"
"65","000","00","030","0009","1366","917","470","447","34","951","1651","0","57.60","28.47"
"65","000","00","030","0010","0000","1689","854","835","77","1766","3138","0","56.28","27.21"
"65","000","00","030","0010","1373","865","457","408","37","902","1596","0","56.52","28.63"
"65","000","00","030","0010","1374","824","397","427","40","864","1542","0","56.03","25.75"
"65","000","00","030","0011","0000","1768","867","901","63","1831","3300","0","55.48","26.27"
"65","000","00","030","0011","1375","876","438","438","32","908","1658","0","54.76","26.42"
"65","000","00","030","0011","1376","892","429","463","31","923","1642","0","56.21","26.13"
"65","000","00","030","0012","0000","2189","1142","1047","117","2306","3768","0","61.20","30.31"
"65","000","00","030","0012","1377","634","336","298","46","680","1209","0","56.24","27.79"
"65","000","00","030","0012","1378","755","372","383","38","793","1191","0","66.58","31.23"
"65","000","00","030","0012","1379","800","434","366","33","833","1368","0","60.89","31.73"
"65","000","00","030","0013","0000","1900","1038","862","163","2063","3582","0","57.59","28.98"
"65","000","00","030","0013","1380","954","508","446","110","1064","1859","0","57.24","27.33"
"65","000","00","030","0013","1381","946","530","416","53","999","1723","0","57.98","30.76"
"65","000","00","030","0014","0000","1986","1003","983","117","2103","3701","0","56.82","27.10"
"65","000","00","030","0014","1382","622","300","322","30","652","1109","0","58.79","27.05"
"65","000","00","030","0014","1383","679","348","331","53","732","1330","0","55.04","26.17"
"65","000","00","030","0014","1384","685","355","330","34","719","1262","0","56.97","28.13"
"65","000","00","030","0015","0000","2335","1193","1142","110","2445","3713","0","65.85","32.13"
"65","000","00","030","0015","1385","742","338","404","24","766","1095","0","69.95","30.87"
"65","000","00","030","0015","1386","807","413","394","35","842","1282","0","65.68","32.22"
"65","000","00","030","0015","1387","786","442","344","51","837","1336","0","62.65","33.08"
"65","000","00","030","0016","0000","2582","1359","1223","151","2733","4329","0","63.13","31.39"
"65","000","00","030","0016","1388","806","449","357","34","840","1336","0","62.87","33.61"
"65","000","00","030","0016","1389","877","437","440","63","940","1454","0","64.65","30.06"
"65","000","00","030","0016","1390","899","473","426","54","953","1539","0","61.92","30.73"
"65","000","00","030","0017","0000","2578","1342","1236","135","2713","4733","0","57.32","28.35"
"65","000","00","030","0017","1391","834","451","383","51","885","1588","0","55.73","28.40"
"65","000","00","030","0017","1392","879","452","427","40","919","1593","0","57.69","28.37"
"65","000","00","030","0017","1393","865","439","426","44","909","1552","0","58.57","28.29"
"65","000","00","030","0018","0000","1751","894","857","99","1850","3103","0","59.62","28.81"
"65","000","00","030","0018","1394","525","254","271","27","552","927","0","59.55","27.40"
"65","000","00","030","0018","1395","641","351","290","43","684","1089","0","62.81","32.23"
"65","000","00","030","0018","1396","585","289","296","29","614","1087","0","56.49","26.59"
"65","000","00","030","0019","0000","2290","1173","1117","123","2413","4268","0","56.54","27.48"
"65","000","00","030","0019","1397","897","442","455","53","950","1724","0","55.10","25.64"
"65","000","00","030","0019","1398","851","474","377","43","894","1510","0","59.21","31.39"
"65","000","00","030","0019","1399","542","257","285","27","569","1034","0","55.03","24.85"
"65","000","00","030","0020","0000","1757","797","960","86","1843","3127","0","58.94","25.49"
"65","000","00","030","0020","1564","685","328","357","35","720","1245","0","57.83","26.35"
"65","000","00","030","0020","1565","503","222","281","30","533","907","0","58.77","24.48"
"65","000","00","030","0020","1566","569","247","322","21","590","975","0","60.51","25.33"
"65","000","00","030","0021","0000","1602","780","822","59","1661","2643","0","62.85","29.51"
"65","000","00","030","0021","1567","775","385","390","32","807","1277","0","63.19","30.15"
"65","000","00","030","0021","1568","827","395","432","27","854","1366","0","62.52","28.92"
"65","000","00","030","0022","0000","2958","1287","1671","111","3069","4987","0","61.54","25.81"
"65","000","00","030","0022","1572","1020","445","575","44","1064","1716","0","62.00","25.93"
"65","000","00","030","0022","1573","951","442","509","32","983","1623","0","60.57","27.23"
"65","000","00","030","0022","1574","987","400","587","35","1022","1648","0","62.01","24.27"
"65","000","00","030","0023","0000","2205","946","1259","70","2275","3773","0","60.30","25.07"
"65","000","00","030","0023","1575","763","342","421","29","792","1289","0","61.44","26.53"
"65","000","00","030","0023","1576","702","283","419","28","730","1225","0","59.59","23.10"
"65","000","00","030","0023","1577","740","321","419","13","753","1259","0","59.81","25.50"
"65","000","00","030","0024","0000","1528","764","764","104","1632","2944","0","55.43","25.95"
"65","000","00","030","0024","1578","575","280","295","41","616","1071","0","57.52","26.14"
"65","000","00","030","0024","1579","389","181","208","31","420","751","0","55.93","24.10"
"65","000","00","030","0024","1580","564","303","261","32","596","1122","0","53.12","27.01"
"65","000","00","030","0025","0000","3654","1734","1920","126","3780","6794","0","55.64","25.52"
"65","000","00","030","0025","1400","843","434","409","34","877","1637","0","53.57","26.51"
"65","000","00","030","0025","1401","933","425","508","38","971","1724","0","56.32","24.65"
"65","000","00","030","0025","1402","926","430","496","36","962","1693","0","56.82","25.40"
"65","000","00","030","0025","1403","952","445","507","18","970","1740","0","55.75","25.57"
"65","000","00","030","0026","0000","2400","1138","1262","109","2509","4407","0","56.93","25.82"
"65","000","00","030","0026","1404","860","411","449","41","901","1554","0","57.98","26.45"
"65","000","00","030","0026","1405","679","318","361","34","713","1358","0","52.50","23.42"
"65","000","00","030","0026","1406","861","409","452","34","895","1495","0","59.87","27.36"
"65","000","00","030","0027","0000","2040","928","1112","107","2147","3847","0","55.81","24.12"
"65","000","00","030","0027","1581","634","289","345","30","664","1261","0","52.66","22.92"
"65","000","00","030","0027","1582","669","322","347","43","712","1285","0","55.41","25.06"
"65","000","00","030","0027","1583","737","317","420","34","771","1301","0","59.26","24.37"
"65","000","00","030","0028","0000","1541","720","821","90","1631","2909","0","56.07","24.75"
"65","000","00","030","0028","1584","743","350","393","41","784","1375","0","57.02","25.45"
"65","000","00","030","0028","1585","798","370","428","49","847","1534","0","55.22","24.12"
"65","000","00","030","0029","0000","2231","1066","1165","108","2339","4147","0","56.40","25.71"
"65","000","00","030","0029","1588","776","372","404","43","819","1438","0","56.95","25.87"
"65","000","00","030","0029","1589","671","325","346","33","704","1331","0","52.89","24.42"
"65","000","00","030","0029","1590","784","369","415","32","816","1378","0","59.22","26.78"
"65","000","00","030","0030","0000","2989","1349","1640","128","3117","5444","0","57.26","24.78"
"65","000","00","030","0030","1591","934","384","550","38","972","1647","0","59.02","23.32"
"65","000","00","030","0030","1592","925","445","480","57","982","1820","0","53.96","24.45"
"65","000","00","030","0030","1593","453","226","227","26","479","860","0","55.70","26.28"
"65","000","00","030","0030","1594","677","294","383","7","684","1117","0","61.24","26.32"
"65","000","00","030","0031","0000","2242","952","1290","96","2338","4249","0","55.02","22.41"
"65","000","00","030","0031","1595","802","347","455","25","827","1445","0","57.23","24.01"
"65","000","00","030","0031","1596","735","270","465","31","766","1485","0","51.58","18.18"
"65","000","00","030","0031","1597","705","335","370","40","745","1319","0","56.48","25.40"
"65","000","00","030","0032","0000","2272","996","1276","129","2401","4218","0","56.92","23.61"
"65","000","00","030","0032","1598","651","277","374","70","721","1132","0","63.69","24.47"
"65","000","00","030","0032","1599","845","366","479","28","873","1628","0","53.62","22.48"
"65","000","00","030","0032","1600","776","353","423","31","807","1458","0","55.35","24.21"
"65","000","00","030","0033","0000","1466","685","781","80","1546","2822","0","54.78","24.27"
"65","000","00","030","0033","1606","734","335","399","47","781","1425","0","54.81","23.51"
"65","000","00","030","0033","1607","732","350","382","33","765","1397","0","54.76","25.05"
"65","000","00","030","0034","0000","1414","670","744","82","1496","2449","0","61.09","27.36"
"65","000","00","030","0034","1429","661","337","324","37","698","1149","0","60.75","29.33"
"65","000","00","030","0034","1430","753","333","420","45","798","1300","0","61.38","25.62"
"65","000","00","030","0035","0000","3225","1529","1696","153","3378","6697","0","50.44","22.83"
"65","000","00","030","0035","1431","669","289","380","36","705","1438","0","49.03","20.10"
"65","000","00","030","0035","1432","772","382","390","38","810","1492","0","54.29","25.60"
"65","000","00","030","0035","1433","671","316","355","30","701","1395","0","50.25","22.65"
"65","000","00","030","0035","1434","556","281","275","33","589","1172","0","50.26","23.98"
"65","000","00","030","0035","1435","557","261","296","16","573","1200","0","47.75","21.75"
"65","000","00","030","0036","0000","2005","721","1284","97","2102","3586","0","58.62","20.11"
"65","000","00","030","0036","1436","614","191","423","30","644","1089","0","59.14","17.54"
"65","000","00","030","0036","1437","661","294","367","35","696","1246","0","55.86","23.60"
"65","000","00","030","0036","1438","730","236","494","32","762","1251","0","60.91","18.86"
"65","000","00","030","0037","0000","2240","1017","1223","136","2376","4215","0","56.37","24.13"
"65","000","00","030","0037","1439","775","364","411","62","837","1531","0","54.67","23.78"
"65","000","00","030","0037","1440","778","347","431","44","822","1436","0","57.24","24.16"
"65","000","00","030","0037","1441","687","306","381","30","717","1248","0","57.45","24.52"
"65","000","00","030","0038","0000","2183","1038","1145","166","2349","3934","0","59.71","26.39"
"65","000","00","030","0038","1442","771","382","389","68","839","1365","0","61.47","27.99"
"65","000","00","030","0038","1443","698","304","394","48","746","1292","0","57.74","23.53"
"65","000","00","030","0038","1444","714","352","362","50","764","1277","0","59.83","27.56"
"65","000","00","030","0039","0000","2111","942","1169","98","2209","3745","0","58.99","25.15"
"65","000","00","030","0039","1445","798","363","435","36","834","1421","0","58.69","25.55"
"65","000","00","030","0039","1446","700","318","382","33","733","1233","0","59.45","25.79"
"65","000","00","030","0039","1447","613","261","352","29","642","1091","0","58.85","23.92"
"65","000","00","030","0040","0000","1352","640","712","80","1432","2668","0","53.67","23.99"
"65","000","00","030","0040","1450","622","286","336","34","656","1266","0","51.82","22.59"
"65","000","00","030","0040","1451","730","354","376","46","776","1402","0","55.35","25.25"
"65","000","00","030","0041","0000","176","93","83","15","191","292","0","65.41","31.85"
"65","000","00","030","0041","1454","176","93","83","15","191","292","0","65.41","31.85"
"65","000","00","030","0042","0000","2128","1008","1120","150","2278","4216","0","54.03","23.91"
"65","000","00","030","0042","1455","659","319","340","49","708","1369","0","51.72","23.30"
"65","000","00","030","0042","1456","727","332","395","44","771","1411","0","54.64","23.53"
"65","000","00","030","0042","1457","742","357","385","57","799","1436","0","55.64","24.86"
"65","000","00","030","0043","0000","1269","624","645","91","1360","2195","0","61.96","28.43"
"65","000","00","030","0043","1458","705","307","398","39","744","1083","0","68.70","28.35"
"65","000","00","030","0043","1459","564","317","247","52","616","1112","0","55.40","28.51"
"65","000","00","030","0044","0000","1817","905","912","90","1907","6645","0","28.70","13.62"
"65","000","00","030","0044","1463","706","318","388","33","739","1374","0","53.78","23.14"
"65","000","00","030","0044","1464","658","355","303","31","689","1311","0","52.56","27.08"
"65","000","00","030","0044","1465","453","232","221","26","479","3960","0","12.10","5.86"
"65","000","00","030","0045","0000","2369","1206","1163","146","2515","4239","0","59.33","28.45"
"65","000","00","030","0045","1472","942","449","493","42","984","1523","0","64.61","29.48"
"65","000","00","030","0045","1473","747","398","349","65","812","1440","0","56.39","27.64"
"65","000","00","030","0045","1474","680","359","321","39","719","1276","0","56.35","28.13"
"65","000","00","030","0046","0000","2060","936","1124","99","2159","3785","0","57.04","24.73"
"65","000","00","030","0046","1475","564","250","314","30","594","986","0","60.24","25.35"
"65","000","00","030","0046","1476","847","409","438","54","901","1630","0","55.28","25.09"
"65","000","00","030","0046","1477","649","277","372","15","664","1169","0","56.80","23.70"
"65","000","00","030","0047","0000","2785","1235","1550","139","2924","4908","0","59.58","25.16"
"65","000","00","030","0047","1478","665","300","365","29","694","1119","0","62.02","26.81"
"65","000","00","030","0047","1479","1036","457","579","67","1103","1931","0","57.12","23.67"
"65","000","00","030","0047","1480","589","235","354","9","598","875","0","68.34","26.86"
"65","000","00","030","0047","1481","495","243","252","34","529","983","0","53.81","24.72"
"65","000","00","030","0048","0000","1764","855","909","111","1875","3055","0","61.37","27.99"
"65","000","00","030","0048","1482","862","402","460","51","913","1510","0","60.46","26.62"
"65","000","00","030","0048","1483","902","453","449","60","962","1545","0","62.27","29.32"
"65","000","00","030","0049","0000","2573","1187","1386","155","2728","4964","0","54.96","23.91"
"65","000","00","030","0049","1484","960","432","528","32","992","1870","0","53.05","23.10"
"65","000","00","030","0049","1485","782","358","424","47","829","1487","0","55.75","24.08"
"65","000","00","030","0049","1486","831","397","434","76","907","1607","0","56.44","24.70"
"65","000","00","030","0050","0000","2326","1084","1242","138","2464","4183","0","58.91","25.91"
"65","000","00","030","0050","1487","511","253","258","31","542","926","0","58.53","27.32"
"65","000","00","030","0050","1488","641","279","362","33","674","1132","0","59.54","24.65"
"65","000","00","030","0050","1489","660","299","361","31","691","1222","0","56.55","24.47"
"65","000","00","030","0050","1490","514","253","261","43","557","903","0","61.68","28.02"
"65","000","00","030","0051","0000","1859","873","986","90","1949","3401","0","57.31","25.67"
"65","000","00","030","0051","1491","966","440","526","39","1005","1729","0","58.13","25.45"
"65","000","00","030","0051","1492","893","433","460","51","944","1672","0","56.46","25.90"
"65","000","00","030","0052","0000","2359","1230","1129","99","2458","4513","0","54.46","27.25"
"65","000","00","030","0052","1493","851","433","418","34","885","1476","0","59.96","29.34"
"65","000","00","030","0052","1494","738","365","373","23","761","1541","0","49.38","23.69"
"65","000","00","030","0052","1495","770","432","338","42","812","1496","0","54.28","28.88"
"65","000","00","030","0053","0000","1126","542","584","62","1188","1947","0","61.02","27.84"
"65","000","00","030","0053","1496","531","261","270","30","561","960","0","58.44","27.19"
"65","000","00","030","0053","1497","595","281","314","32","627","987","0","63.53","28.47"
"65","000","00","030","0054","0000","370","218","152","25","395","655","0","60.31","33.28"
"65","000","00","030","0054","1498","370","218","152","25","395","655","0","60.31","33.28"
"65","000","00","030","0055","0000","3941","1899","2042","217","4158","6971","0","59.65","27.24"
"65","000","00","030","0055","1499","780","353","427","58","838","1486","0","56.39","23.76"
"65","000","00","030","0055","1500","695","361","334","36","731","1294","0","56.49","27.90"
"65","000","00","030","0055","1501","820","397","423","33","853","1397","0","61.06","28.42"
"65","000","00","030","0055","1502","850","405","445","29","879","1396","0","62.97","29.01"
"65","000","00","030","0055","1503","796","383","413","61","857","1398","0","61.30","27.40"
"65","000","00","030","0056","0000","1390","784","606","71","1461","2100","0","69.57","37.33"
"65","000","00","030","0056","1504","676","397","279","36","712","998","0","71.34","39.78"
"65","000","00","030","0056","1505","714","387","327","35","749","1102","0","67.97","35.12"
"65","000","00","030","0057","0000","2925","1521","1404","149","3074","5325","0","57.73","28.56"
"65","000","00","030","0057","1506","687","368","319","42","729","1288","0","56.60","28.57"
"65","000","00","030","0057","1507","832","458","374","49","881","1522","0","57.88","30.09"
"65","000","00","030","0057","1508","785","378","407","42","827","1379","0","59.97","27.41"
"65","000","00","030","0057","1509","621","317","304","16","637","1136","0","56.07","27.90"
"65","000","00","030","0058","0000","1526","790","736","77","1603","2464","0","65.06","32.06"
"65","000","00","030","0058","1510","936","456","480","50","986","1461","0","67.49","31.21"
"65","000","00","030","0058","1511","590","334","256","27","617","1003","0","61.52","33.30"
"65","000","00","030","0059","0000","2260","1201","1059","130","2390","4399","0","54.33","27.30"
"65","000","00","030","0059","1512","723","394","329","54","777","1450","0","53.59","27.17"
"65","000","00","030","0059","1513","766","407","359","41","807","1474","0","54.75","27.61"
"65","000","00","030","0059","1514","771","400","371","35","806","1475","0","54.64","27.12"
"65","000","00","030","0060","0000","1718","936","782","118","1836","3424","0","53.62","27.34"
"65","000","00","030","0060","1515","859","453","406","59","918","1671","0","54.94","27.11"
"65","000","00","030","0060","1516","859","483","376","59","918","1753","0","52.37","27.55"
"65","000","00","030","0061","0000","2407","1248","1159","105","2512","4372","0","57.46","28.55"
"65","000","00","030","0061","1517","757","423","334","35","792","1437","0","55.11","29.44"
"65","000","00","030","0061","1518","791","414","377","46","837","1443","0","58.00","28.69"
"65","000","00","030","0061","1519","859","411","448","24","883","1492","0","59.18","27.55"
"65","000","00","030","0062","0000","2153","1161","992","119","2272","3820","0","59.48","30.39"
"65","000","00","030","0062","1520","749","417","332","40","789","1277","0","61.79","32.65"
"65","000","00","030","0062","1521","695","351","344","28","723","1296","0","55.79","27.08"
"65","000","00","030","0062","1522","709","393","316","51","760","1247","0","60.95","31.52"
"65","000","00","030","0063","0000","1170","573","597","55","1225","1982","0","61.81","28.91"
"65","000","00","030","0063","1523","596","313","283","33","629","1063","0","59.17","29.44"
"65","000","00","030","0063","1524","574","260","314","22","596","919","0","64.85","28.29"
"65","000","00","030","0064","0000","2062","1104","958","85","2147","3771","0","56.93","29.28"
"65","000","00","030","0064","1525","692","366","326","28","720","1209","0","59.55","30.27"
"65","000","00","030","0064","1526","691","356","335","19","710","1247","0","56.94","28.55"
"65","000","00","030","0064","1527","679","382","297","38","717","1315","0","54.52","29.05"
"65","000","00","030","0065","0000","1584","817","767","47","1631","2685","0","60.74","30.43"
"65","000","00","030","0065","1528","753","391","362","12","765","1272","0","60.14","30.74"
"65","000","00","030","0065","1529","831","426","405","35","866","1413","0","61.29","30.15"
"65","000","00","030","0066","0000","2253","1235","1018","119","2372","4240","0","55.94","29.13"
"65","000","00","030","0066","1530","778","414","364","33","811","1466","0","55.32","28.24"
"65","000","00","030","0066","1531","769","431","338","35","804","1469","0","54.73","29.34"
"65","000","00","030","0066","1532","706","390","316","51","757","1305","0","58.01","29.89"
"65","000","00","030","0067","0000","2090","1062","1028","114","2204","3911","0","56.35","27.15"
"65","000","00","030","0067","1533","703","364","339","44","747","1340","0","55.75","27.16"
"65","000","00","030","0067","1534","782","431","351","50","832","1406","0","59.17","30.65"
"65","000","00","030","0067","1535","605","267","338","20","625","1165","0","53.65","22.92"
"65","000","00","030","0068","0000","2029","1061","968","145","2174","3615","0","60.14","29.35"
"65","000","00","030","0068","1536","976","491","485","74","1050","1718","0","61.12","28.58"
"65","000","00","030","0068","1537","619","335","284","51","670","1095","0","61.19","30.59"
"65","000","00","030","0068","1538","434","235","199","20","454","802","0","56.61","29.30"
"65","000","00","030","0069","0000","1833","915","918","87","1920","3305","0","58.09","27.69"
"65","000","00","030","0069","1539","881","465","416","41","922","1629","0","56.60","28.55"
"65","000","00","030","0069","1540","952","450","502","46","998","1676","0","59.55","26.85"
"65","000","00","030","0070","0000","2290","1040","1250","120","2410","3776","0","63.82","27.54"
"65","000","00","030","0070","1541","821","376","445","54","875","1354","0","64.62","27.77"
"65","000","00","030","0070","1542","668","357","311","30","698","1114","0","62.66","32.05"
"65","000","00","030","0070","1543","801","307","494","36","837","1308","0","63.99","23.47"
"65","000","00","030","0071","0000","1985","1095","890","115","2100","3322","0","63.21","32.96"
"65","000","00","030","0071","1544","598","345","253","45","643","1046","0","61.47","32.98"
"65","000","00","030","0071","1545","663","374","289","41","704","1125","0","62.58","33.24"
"65","000","00","030","0071","1546","724","376","348","29","753","1151","0","65.42","32.67"
"65","000","00","030","0072","0000","1796","830","966","135","1931","3223","0","59.91","25.75"
"65","000","00","030","0072","1603","560","269","291","45","605","1129","0","53.59","23.83"
"65","000","00","030","0072","1604","638","312","326","47","685","1107","0","61.88","28.18"
"65","000","00","030","0072","1605","598","249","349","43","641","987","0","64.94","25.23"
"65","000","00","030","0073","0000","3051","1532","1519","110","3161","5475","0","57.74","27.98"
"65","000","00","030","0073","1369","758","353","405","28","786","1418","0","55.43","24.89"
"65","000","00","030","0073","1370","744","381","363","36","780","1391","0","56.07","27.39"
"65","000","00","030","0073","1371","696","329","367","25","721","1115","0","64.66","29.51"
"65","000","00","030","0073","1372","853","469","384","21","874","1551","0","56.35","30.24"
"65","000","00","030","0074","0000","996","439","557","48","1044","1705","0","61.23","25.75"
"65","000","00","030","0074","1563","996","439","557","48","1044","1705","0","61.23","25.75"
"65","000","00","030","0075","0000","2404","1117","1287","127","2531","3726","0","67.93","29.98"
"65","000","00","030","0075","1569","714","317","397","22","736","1077","0","68.34","29.43"
"65","000","00","030","0075","1570","868","431","437","46","914","1365","0","66.96","31.58"
"65","000","00","030","0075","1571","822","369","453","59","881","1284","0","68.61","28.74"
"65","000","00","030","0076","0000","1369","710","659","77","1446","2312","0","62.54","30.71"
"65","000","00","030","0076","1586","765","412","353","42","807","1277","0","63.19","32.26"
"65","000","00","030","0076","1587","604","298","306","35","639","1035","0","61.74","28.79"
"65","000","00","030","0077","0000","1220","535","685","71","1291","2141","0","60.30","24.99"
"65","000","00","030","0077","1601","566","229","337","31","597","1031","0","57.90","22.21"
"65","000","00","030","0077","1602","654","306","348","40","694","1110","0","62.52","27.57"
"65","000","00","030","0078","0000","1496","683","813","94","1590","2596","0","61.25","26.31"
"65","000","00","030","0078","1448","781","380","401","48","829","1342","0","61.77","28.32"
"65","000","00","030","0078","1449","715","303","412","46","761","1254","0","60.69","24.16"
"65","000","00","030","0079","0000","904","446","458","58","962","1783","0","53.95","25.01"
"65","000","00","030","0079","1452","434","222","212","28","462","832","0","55.53","26.68"
"65","000","00","030","0079","1453","470","224","246","30","500","951","0","52.58","23.55"
"65","000","00","030","0080","0000","2030","894","1136","136","2166","3542","0","61.15","25.24"
"65","000","00","030","0080","1460","732","333","399","61","793","1282","0","61.86","25.98"
"65","000","00","030","0080","1461","744","310","434","46","790","1324","0","59.67","23.41"
"65","000","00","030","0080","1462","554","251","303","29","583","936","0","62.29","26.82"
"65","000","00","030","0081","0000","2907","1411","1496","115","3022","5576","0","54.20","25.30"
"65","000","00","030","0081","1466","736","354","382","33","769","1416","0","54.31","25.00"
"65","000","00","030","0081","1467","764","358","406","28","792","1464","0","54.10","24.45"
"65","000","00","030","0081","1468","714","358","356","23","737","1352","0","54.51","26.48"
"65","000","00","030","0081","1469","693","341","352","31","724","1344","0","53.87","25.37"
"65","000","00","030","0082","0000","1379","646","733","71","1450","2529","0","57.33","25.54"
"65","000","00","030","0082","1470","742","334","408","27","769","1306","0","58.88","25.57"
"65","000","00","030","0082","1471","637","312","325","44","681","1223","0","55.68","25.51"
"65","000","00","030","0083","0000","1245","666","579","55","1300","2287","0","56.84","29.12"
"65","000","00","030","0083","1422","675","347","328","39","714","1168","0","61.13","29.71"
"65","000","00","030","0083","1423","570","319","251","16","586","1119","0","52.37","28.51"
"65","000","00","030","0084","0000","2446","1296","1150","111","2557","4370","0","58.51","29.66"
"65","000","00","030","0084","1424","902","468","434","25","927","1599","0","57.97","29.27"
"65","000","00","030","0084","1425","676","405","271","51","727","1165","0","62.40","34.76"
"65","000","00","030","0084","1426","868","423","445","35","903","1606","0","56.23","26.34"
"65","000","00","030","0085","0000","1807","937","870","95","1902","3510","0","54.19","26.70"
"65","000","00","030","0085","1547","598","298","300","22","620","1191","0","52.06","25.02"
"65","000","00","030","0085","1548","542","272","270","32","574","1094","0","52.47","24.86"
"65","000","00","030","0085","1549","667","367","300","41","708","1225","0","57.80","29.96"
"65","000","00","030","0086","0000","1839","946","893","77","1916","3272","0","58.56","28.91"
"65","000","00","030","0086","1550","946","489","457","31","977","1671","0","58.47","29.26"
"65","000","00","030","0086","1551","893","457","436","46","939","1601","0","58.65","28.54"
"65","000","00","030","0087","0000","1395","714","681","90","1485","2364","0","62.82","30.20"
"65","000","00","030","0087","1552","642","329","313","42","684","1127","0","60.69","29.19"
"65","000","00","030","0087","1553","753","385","368","48","801","1237","0","64.75","31.12"
"65","000","00","030","0088","0000","1643","880","763","93","1736","3165","0","54.85","27.80"
"65","000","00","030","0088","1554","760","394","366","30","790","1417","0","55.75","27.81"
"65","000","00","030","0088","1555","883","486","397","63","946","1748","0","54.12","27.80"
"65","000","00","030","0089","0000","1841","968","873","108","1949","3684","0","52.90","26.28"
"65","000","00","030","0089","1556","568","311","257","36","604","1187","0","50.88","26.20"
"65","000","00","030","0089","1557","665","347","318","35","700","1267","0","55.25","27.39"
"65","000","00","030","0089","1558","608","310","298","37","645","1230","0","52.44","25.20"
"65","000","00","030","0090","0000","1801","1006","795","71","1872","2838","0","65.96","35.45"
"65","000","00","030","0090","1559","935","557","378","34","969","1531","0","63.29","36.38"
"65","000","00","030","0090","1560","866","449","417","37","903","1307","0","69.09","34.35"
"65","000","00","030","0091","0000","1724","959","765","89","1813","2904","0","62.43","33.02"
"65","000","00","030","0091","1561","730","418","312","32","762","1206","0","63.18","34.66"
"65","000","00","030","0091","1562","994","541","453","57","1051","1698","0","61.90","31.86"
"65","000","00","030","0092","0000","1537","709","828","93","1630","2955","0","55.16","23.99"
"65","000","00","030","0092","1427","792","340","452","45","837","1591","0","52.61","21.37"
"65","000","00","030","0092","1428","745","369","376","48","793","1364","0","58.14","27.05"
"65","000","00","030","0093","0000","1307","634","673","58","1365","2446","0","55.81","25.92"
"65","000","00","030","0093","1367","639","327","312","34","673","1138","0","59.14","28.73"
"65","000","00","030","0093","1368","668","307","361","24","692","1308","0","52.91","23.47"
"65","000","00","040","0000","0000","96590","44257","52333","4336","100926","176285","211029","57.25","25.11"
"65","000","00","040","0001","0000","1664","782","882","76","1740","2732","0","63.69","28.62"
"65","000","00","040","0001","1618","849","396","453","39","888","1377","0","64.49","28.76"
"65","000","00","040","0001","1619","815","386","429","37","852","1355","0","62.88","28.49"
"65","000","00","040","0002","0000","1275","552","723","82","1357","2349","0","57.77","23.50"
"65","000","00","040","0002","1736","617","275","342","25","642","1122","0","57.22","24.51"
"65","000","00","040","0002","1737","658","277","381","57","715","1227","0","58.27","22.58"
"65","000","00","040","0003","0000","1603","687","916","59","1662","4252","0","39.09","16.16"
"65","000","00","040","0003","1627","829","360","469","31","860","1469","0","58.54","24.51"
"65","000","00","040","0003","1628","774","327","447","28","802","2783","0","28.82","11.75"
"65","000","00","040","0004","0000","1486","681","805","68","1554","2419","0","64.24","28.15"
"65","000","00","040","0004","1629","669","291","378","36","705","1113","0","63.34","26.15"
"65","000","00","040","0004","1630","817","390","427","32","849","1306","0","65.01","29.86"
"65","000","00","040","0005","0000","1333","622","711","40","1373","2325","0","59.05","26.75"
"65","000","00","040","0005","1734","657","313","344","26","683","1171","0","58.33","26.73"
"65","000","00","040","0005","1735","676","309","367","14","690","1154","0","59.79","26.78"
"65","000","00","040","0006","0000","1504","664","840","76","1580","2761","0","57.23","24.05"
"65","000","00","040","0006","1637","766","323","443","30","796","1405","0","56.65","22.99"
"65","000","00","040","0006","1638","738","341","397","46","784","1356","0","57.82","25.15"
"65","000","00","040","0007","0000","1480","657","823","61","1541","2250","0","68.49","29.20"
"65","000","00","040","0007","1639","778","360","418","30","808","1163","0","69.48","30.95"
"65","000","00","040","0007","1640","702","297","405","31","733","1087","0","67.43","27.32"
"65","000","00","040","0008","0000","1208","541","667","49","1257","2356","0","53.35","22.96"
"65","000","00","040","0008","1675","618","266","352","12","630","1169","0","53.89","22.75"
"65","000","00","040","0008","1676","590","275","315","37","627","1187","0","52.82","23.17"
"65","000","00","040","0009","0000","424","137","287","30","454","816","0","55.64","16.79"
"65","000","00","040","0009","1732","424","137","287","30","454","816","0","55.64","16.79"
"65","000","00","040","0010","0000","391","135","256","31","422","652","0","64.72","20.71"
"65","000","00","040","0010","1733","391","135","256","31","422","652","0","64.72","20.71"
"65","000","00","040","0011","0000","2151","991","1160","83","2234","3842","0","58.15","25.79"
"65","000","00","040","0011","1646","775","354","421","31","806","1369","0","58.88","25.86"
"65","000","00","040","0011","1647","678","316","362","21","699","1175","0","59.49","26.89"
"65","000","00","040","0011","1648","698","321","377","31","729","1298","0","56.16","24.73"
"65","000","00","040","0012","0000","1869","927","942","91","1960","3302","0","59.36","28.07"
"65","000","00","040","0012","1659","944","487","457","50","994","1649","0","60.28","29.53"
"65","000","00","040","0012","1660","925","440","485","41","966","1653","0","58.44","26.62"
"65","000","00","040","0013","0000","3071","1478","1593","105","3176","5777","0","54.98","25.58"
"65","000","00","040","0013","1716","745","395","350","27","772","1492","0","51.74","26.47"
"65","000","00","040","0013","1717","774","362","412","27","801","1434","0","55.86","25.24"
"65","000","00","040","0013","1718","738","354","384","26","764","1420","0","53.80","24.93"
"65","000","00","040","0013","1719","814","367","447","25","839","1431","0","58.63","25.65"
"65","000","00","040","0014","0000","2372","1108","1264","101","2473","4245","0","58.26","26.10"
"65","000","00","040","0014","1713","861","396","465","36","897","1479","0","60.65","26.77"
"65","000","00","040","0014","1714","771","363","408","34","805","1376","0","58.50","26.38"
"65","000","00","040","0014","1715","740","349","391","31","771","1390","0","55.47","25.11"
"65","000","00","040","0015","0000","2036","918","1118","67","2103","3454","0","60.89","26.58"
"65","000","00","040","0015","1691","671","296","375","17","688","1141","0","60.30","25.94"
"65","000","00","040","0015","1692","620","277","343","21","641","1054","0","60.82","26.28"
"65","000","00","040","0015","1693","745","345","400","29","774","1259","0","61.48","27.40"
"65","000","00","040","0016","0000","2162","940","1222","97","2259","3764","0","60.02","24.97"
"65","000","00","040","0016","1652","751","312","439","33","784","1232","0","63.64","25.32"
"65","000","00","040","0016","1653","689","331","358","34","723","1227","0","58.92","26.98"
"65","000","00","040","0016","1654","722","297","425","30","752","1305","0","57.62","22.76"
"65","000","00","040","0017","0000","1966","894","1072","82","2048","3650","0","56.11","24.49"
"65","000","00","040","0017","1649","687","312","375","36","723","1252","0","57.75","24.92"
"65","000","00","040","0017","1650","732","328","404","14","746","1368","0","54.53","23.98"
"65","000","00","040","0017","1651","547","254","293","32","579","1030","0","56.21","24.66"
"65","000","00","040","0018","0000","1441","675","766","81","1522","2661","0","57.20","25.37"
"65","000","00","040","0018","1621","690","322","368","44","734","1256","0","58.44","25.64"
"65","000","00","040","0018","1622","751","353","398","37","788","1405","0","56.09","25.12"
"65","000","00","040","0019","0000","516","270","246","51","567","1031","0","55.00","26.19"
"65","000","00","040","0019","1620","516","270","246","51","567","1031","0","55.00","26.19"
"65","000","00","040","0020","0000","1688","807","881","97","1785","3219","0","55.45","25.07"
"65","000","00","040","0020","1655","842","365","477","47","889","1574","0","56.48","23.19"
"65","000","00","040","0020","1656","846","442","404","50","896","1645","0","54.47","26.87"
"65","000","00","040","0021","0000","1236","612","624","74","1310","2417","0","54.20","25.32"
"65","000","00","040","0021","1657","615","311","304","34","649","1216","0","53.37","25.58"
"65","000","00","040","0021","1658","621","301","320","40","661","1201","0","55.04","25.06"
"65","000","00","040","0022","0000","906","434","472","48","954","1598","0","59.70","27.16"
"65","000","00","040","0022","1742","438","208","230","28","466","802","0","58.10","25.94"
"65","000","00","040","0022","1743","468","226","242","20","488","796","0","61.31","28.39"
"65","000","00","040","0023","0000","1652","721","931","74","1726","3053","0","56.53","23.62"
"65","000","00","040","0023","1612","903","395","508","41","944","1642","0","57.49","24.06"
"65","000","00","040","0023","1613","749","326","423","33","782","1411","0","55.42","23.10"
"65","000","00","040","0024","0000","1817","836","981","85","1902","3216","0","59.14","26.00"
"65","000","00","040","0024","1701","912","392","520","38","950","1627","0","58.39","24.09"
"65","000","00","040","0024","1702","905","444","461","47","952","1589","0","59.91","27.94"
"65","000","00","040","0025","0000","1821","820","1001","61","1882","3161","0","59.54","25.94"
"65","000","00","040","0025","1703","639","315","324","11","650","1081","0","60.13","29.14"
"65","000","00","040","0025","1704","566","269","297","27","593","1050","0","56.48","25.62"
"65","000","00","040","0025","1705","616","236","380","23","639","1030","0","62.04","22.91"
"65","000","00","040","0026","0000","1803","832","971","74","1877","3236","0","58.00","25.71"
"65","000","00","040","0026","1696","607","244","363","26","633","1092","0","57.97","22.34"
"65","000","00","040","0026","1697","562","272","290","19","581","1056","0","55.02","25.76"
"65","000","00","040","0026","1698","634","316","318","29","663","1088","0","60.94","29.04"
"65","000","00","040","0027","0000","1326","638","688","74","1400","2475","0","56.57","25.78"
"65","000","00","040","0027","1699","633","299","334","34","667","1238","0","53.88","24.15"
"65","000","00","040","0027","1700","693","339","354","40","733","1237","0","59.26","27.41"
"65","000","00","040","0028","0000","1494","683","811","71","1565","2874","0","54.45","23.76"
"65","000","00","040","0028","1746","802","381","421","35","837","1541","0","54.32","24.72"
"65","000","00","040","0028","1747","692","302","390","36","728","1333","0","54.61","22.66"
"65","000","00","040","0029","0000","1094","494","600","59","1153","2075","0","55.57","23.81"
"65","000","00","040","0029","1744","578","253","325","36","614","1162","0","52.84","21.77"
"65","000","00","040","0029","1745","516","241","275","23","539","913","0","59.04","26.40"
"65","000","00","040","0030","0000","1956","845","1111","78","2034","3697","0","55.02","22.86"
"65","000","00","040","0030","1683","657","278","379","38","695","1241","0","56.00","22.40"
"65","000","00","040","0030","1684","647","287","360","17","664","1251","0","53.08","22.94"
"65","000","00","040","0030","1685","652","280","372","23","675","1205","0","56.02","23.24"
"65","000","00","040","0031","0000","2073","936","1137","87","2160","3866","0","55.87","24.21"
"65","000","00","040","0031","1679","497","217","280","20","517","952","0","54.31","22.79"
"65","000","00","040","0031","1680","507","239","268","23","530","930","0","56.99","25.70"
"65","000","00","040","0031","1681","582","265","317","26","608","1039","0","58.52","25.51"
"65","000","00","040","0031","1682","487","215","272","18","505","945","0","53.44","22.75"
"65","000","00","040","0032","0000","1303","586","717","56","1359","2147","0","63.30","27.29"
"65","000","00","040","0032","1689","663","304","359","29","692","1096","0","63.14","27.74"
"65","000","00","040","0032","1690","640","282","358","27","667","1051","0","63.46","26.83"
"65","000","00","040","0033","0000","2270","1118","1152","116","2386","3947","0","60.45","28.33"
"65","000","00","040","0033","1710","676","314","362","19","695","1257","0","55.29","24.98"
"65","000","00","040","0033","1711","768","394","374","48","816","1276","0","63.95","30.88"
"65","000","00","040","0033","1712","826","410","416","49","875","1414","0","61.88","29.00"
"65","000","00","040","0034","0000","1706","831","875","101","1807","3252","0","55.57","25.55"
"65","000","00","040","0034","1668","854","428","426","42","896","1584","0","56.57","27.02"
"65","000","00","040","0034","1669","852","403","449","59","911","1668","0","54.62","24.16"
"65","000","00","040","0035","0000","2278","984","1294","82","2360","3811","0","61.93","25.82"
"65","000","00","040","0035","1672","734","307","427","30","764","1233","0","61.96","24.90"
"65","000","00","040","0035","1673","781","318","463","24","805","1343","0","59.94","23.68"
"65","000","00","040","0035","1674","763","359","404","28","791","1235","0","64.05","29.07"
"65","000","00","040","0036","0000","870","385","485","39","909","1444","0","62.95","26.66"
"65","000","00","040","0036","1608","870","385","485","39","909","1444","0","62.95","26.66"
"65","000","00","040","0037","0000","1093","468","625","33","1126","2023","0","55.66","23.13"
"65","000","00","040","0037","1610","509","234","275","16","525","997","0","52.66","23.47"
"65","000","00","040","0037","1611","584","234","350","17","601","1026","0","58.58","22.81"
"65","000","00","040","0038","0000","2419","1095","1324","83","2502","4248","0","58.90","25.78"
"65","000","00","040","0038","1631","794","347","447","24","818","1394","0","58.68","24.89"
"65","000","00","040","0038","1632","770","356","414","34","804","1358","0","59.20","26.22"
"65","000","00","040","0038","1633","855","392","463","25","880","1496","0","58.82","26.20"
"65","000","00","040","0039","0000","2124","912","1212","80","2204","3497","0","63.03","26.08"
"65","000","00","040","0039","1634","794","344","450","27","821","1235","0","66.48","27.85"
"65","000","00","040","0039","1635","669","268","401","31","700","1109","0","63.12","24.17"
"65","000","00","040","0039","1636","661","300","361","22","683","1153","0","59.24","26.02"
"65","000","00","040","0040","0000","1345","655","690","100","1445","2687","0","53.78","24.38"
"65","000","00","040","0040","1677","667","323","344","52","719","1376","0","52.25","23.47"
"65","000","00","040","0040","1678","678","332","346","48","726","1311","0","55.38","25.32"
"65","000","00","040","0041","0000","464","181","283","27","491","831","0","59.09","21.78"
"65","000","00","040","0041","1731","464","181","283","27","491","831","0","59.09","21.78"
"65","000","00","040","0042","0000","474","192","282","29","503","907","0","55.46","21.17"
"65","000","00","040","0042","1730","474","192","282","29","503","907","0","55.46","21.17"
"65","000","00","040","0043","0000","1005","440","565","42","1047","1820","0","57.53","24.18"
"65","000","00","040","0043","1706","1005","440","565","42","1047","1820","0","57.53","24.18"
"65","000","00","040","0044","0000","2031","982","1049","97","2128","4035","0","52.74","24.34"
"65","000","00","040","0044","1707","740","376","364","39","779","1422","0","54.78","26.44"
"65","000","00","040","0044","1708","622","289","333","30","652","1227","0","53.14","23.55"
"65","000","00","040","0044","1709","669","317","352","28","697","1386","0","50.29","22.87"
"65","000","00","040","0045","0000","1128","519","609","56","1184","1865","0","63.49","27.83"
"65","000","00","040","0045","1748","609","298","311","19","628","963","0","65.21","30.94"
"65","000","00","040","0045","1749","519","221","298","37","556","902","0","61.64","24.50"
"65","000","00","040","0046","0000","2138","1070","1068","122","2260","3900","0","57.95","27.44"
"65","000","00","040","0046","1727","688","351","337","49","737","1295","0","56.91","27.10"
"65","000","00","040","0046","1728","690","354","336","40","730","1285","0","56.81","27.55"
"65","000","00","040","0046","1729","760","365","395","33","793","1320","0","60.08","27.65"
"65","000","00","040","0047","0000","2250","1009","1241","79","2329","4079","0","57.10","24.74"
"65","000","00","040","0047","1643","838","395","443","30","868","1552","0","55.93","25.45"
"65","000","00","040","0047","1644","630","258","372","19","649","1124","0","57.74","22.95"
"65","000","00","040","0047","1645","782","356","426","30","812","1403","0","57.88","25.37"
"65","000","00","040","0048","0000","1443","670","773","84","1527","2659","0","57.43","25.20"
"65","000","00","040","0048","1641","696","313","383","42","738","1292","0","57.12","24.23"
"65","000","00","040","0048","1642","747","357","390","42","789","1367","0","57.72","26.12"
"65","000","00","040","0049","0000","1906","887","1019","108","2014","3223","0","62.49","27.52"
"65","000","00","040","0049","1665","601","292","309","44","645","1041","0","61.96","28.05"
"65","000","00","040","0049","1666","652","279","373","34","686","1056","0","64.96","26.42"
"65","000","00","040","0049","1667","653","316","337","30","683","1126","0","60.66","28.06"
"65","000","00","040","0050","0000","1172","489","683","42","1214","2189","0","55.46","22.34"
"65","000","00","040","0050","1661","644","274","370","22","666","1153","0","57.76","23.76"
"65","000","00","040","0050","1662","528","215","313","20","548","1036","0","52.90","20.75"
"65","000","00","040","0051","0000","1572","671","901","57","1629","2851","0","57.14","23.54"
"65","000","00","040","0051","1616","778","341","437","20","798","1414","0","56.44","24.12"
"65","000","00","040","0051","1617","794","330","464","37","831","1437","0","57.83","22.96"
"65","000","00","040","0052","0000","555","248","307","24","579","978","0","59.20","25.36"
"65","000","00","040","0052","1609","555","248","307","24","579","978","0","59.20","25.36"
"65","000","00","040","0053","0000","1008","451","557","56","1064","1858","0","57.27","24.27"
"65","000","00","040","0053","1625","564","265","299","23","587","1029","0","57.05","25.75"
"65","000","00","040","0053","1626","444","186","258","33","477","829","0","57.54","22.44"
"65","000","00","040","0054","0000","1336","590","746","54","1390","2584","0","53.79","22.83"
"65","000","00","040","0054","1623","651","303","348","28","679","1258","0","53.97","24.09"
"65","000","00","040","0054","1624","685","287","398","26","711","1326","0","53.62","21.64"
"65","000","00","040","0055","0000","1679","684","995","67","1746","3116","0","56.03","21.95"
"65","000","00","040","0055","1614","915","375","540","40","955","1647","0","57.98","22.77"
"65","000","00","040","0055","1615","764","309","455","27","791","1469","0","53.85","21.03"
"65","000","00","040","0056","0000","1817","814","1003","61","1878","3375","0","55.64","24.12"
"65","000","00","040","0056","1686","607","283","324","11","618","1108","0","55.78","25.54"
"65","000","00","040","0056","1687","627","263","364","27","654","1123","0","58.24","23.42"
"65","000","00","040","0056","1688","583","268","315","23","606","1144","0","52.97","23.43"
"65","000","00","040","0057","0000","1250","590","660","70","1320","2208","0","59.78","26.72"
"65","000","00","040","0057","1738","721","327","394","41","762","1289","0","59.12","25.37"
"65","000","00","040","0057","1739","529","263","266","29","558","919","0","60.72","28.62"
"65","000","00","040","0058","0000","923","450","473","35","958","1678","0","57.09","26.82"
"65","000","00","040","0058","1740","445","224","221","14","459","779","0","58.92","28.75"
"65","000","00","040","0058","1741","478","226","252","21","499","899","0","55.51","25.14"
"65","000","00","040","0059","0000","1231","614","617","78","1309","2380","0","55.00","25.80"
"65","000","00","040","0059","1670","597","304","293","37","634","1206","0","52.57","25.21"
"65","000","00","040","0059","1671","634","310","324","41","675","1174","0","57.50","26.41"
"65","000","00","040","0060","0000","1346","649","697","64","1410","2526","0","55.82","25.69"
"65","000","00","040","0060","1663","690","323","367","34","724","1314","0","55.10","24.58"
"65","000","00","040","0060","1664","656","326","330","30","686","1212","0","56.60","26.90"
"65","000","00","040","0061","0000","1102","578","524","40","1142","1957","0","58.35","29.54"
"65","000","00","040","0061","1694","580","307","273","25","605","992","0","60.99","30.95"
"65","000","00","040","0061","1695","522","271","251","15","537","965","0","55.65","28.08"
"65","000","00","040","0062","0000","4534","2128","2406","142","4676","8685","0","53.84","24.50"
"65","000","00","040","0062","1720","516","260","256","26","542","1149","0","47.17","22.63"
"65","000","00","040","0062","1721","687","333","354","18","705","1356","0","51.99","24.56"
"65","000","00","040","0062","1722","684","317","367","27","711","1273","0","55.85","24.90"
"65","000","00","040","0062","1723","591","278","313","12","603","1110","0","54.32","25.05"
"65","000","00","040","0062","1724","639","281","358","14","653","1227","0","53.22","22.90"
"65","000","00","040","0062","1725","797","372","425","25","822","1407","0","58.42","26.44"
"65","000","00","040","0062","1726","620","287","333","20","640","1163","0","55.03","24.68"
"65","000","00","050","0000","0000","178664","99506","79158","8963","187627","341965","419008","54.87","29.10"
"65","000","00","050","0001","0000","2578","1424","1154","181","2759","4661","0","59.19","30.55"
"65","000","00","050","0001","0362","588","346","242","38","626","1099","0","56.96","31.48"
"65","000","00","050","0001","0363","701","381","320","47","748","1216","0","61.51","31.33"
"65","000","00","050","0001","0364","618","350","268","44","662","1093","0","60.57","32.02"
"65","000","00","050","0001","0365","671","347","324","52","723","1253","0","57.70","27.69"
"65","000","00","050","0002","0000","4444","2543","1901","164","4608","8715","0","52.87","29.18"
"65","000","00","050","0002","0389","781","484","297","41","822","1418","0","57.97","34.13"
"65","000","00","050","0002","0390","725","445","280","14","739","1391","0","53.13","31.99"
"65","000","00","050","0002","0391","699","378","321","39","738","1362","0","54.19","27.75"
"65","000","00","050","0002","0392","786","446","340","23","809","1489","0","54.33","29.95"
"65","000","00","050","0002","0393","709","387","322","26","735","1431","0","51.36","27.04"
"65","000","00","050","0002","0394","744","403","341","21","765","1624","0","47.11","24.82"
"65","000","00","050","0003","0000","603","329","274","42","645","1138","0","56.68","28.91"
"65","000","00","050","0003","0527","603","329","274","42","645","1138","0","56.68","28.91"
"65","000","00","050","0004","0000","2111","1179","932","104","2215","3770","0","58.75","31.27"
"65","000","00","050","0004","0366","720","407","313","38","758","1234","0","61.43","32.98"
"65","000","00","050","0004","0367","647","377","270","37","684","1192","0","57.38","31.63"
"65","000","00","050","0004","0368","744","395","349","29","773","1344","0","57.51","29.39"
"65","000","00","050","0005","0000","2238","1240","998","79","2317","4501","0","51.48","27.55"
"65","000","00","050","0005","0395","608","327","281","29","637","1248","0","51.04","26.20"
"65","000","00","050","0005","0396","654","344","310","16","670","1297","0","51.66","26.52"
"65","000","00","050","0005","0397","625","375","250","22","647","1206","0","53.65","31.09"
"65","000","00","050","0005","0398","351","194","157","12","363","750","0","48.40","25.87"
"65","000","00","050","0006","0000","1766","991","775","115","1881","3119","0","60.31","31.77"
"65","000","00","050","0006","0524","551","279","272","35","586","1010","0","58.02","27.62"
"65","000","00","050","0006","0525","646","390","256","36","682","1102","0","61.89","35.39"
"65","000","00","050","0006","0526","569","322","247","44","613","1007","0","60.87","31.98"
"65","000","00","050","0007","0000","2287","1242","1045","109","2396","4383","0","54.67","28.34"
"65","000","00","050","0007","0372","725","373","352","38","763","1420","0","53.73","26.27"
"65","000","00","050","0007","0373","821","446","375","38","859","1523","0","56.40","29.28"
"65","000","00","050","0007","0374","741","423","318","33","774","1440","0","53.75","29.38"
"65","000","00","050","0008","0000","1893","1030","863","74","1967","3712","0","52.99","27.75"
"65","000","00","050","0008","0454","645","358","287","36","681","1273","0","53.50","28.12"
"65","000","00","050","0008","0455","636","358","278","20","656","1247","0","52.61","28.71"
"65","000","00","050","0008","0456","612","314","298","18","630","1192","0","52.85","26.34"
"65","000","00","050","0009","0000","3383","1881","1502","124","3507","6096","0","57.53","30.86"
"65","000","00","050","0009","0582","575","320","255","21","596","1121","0","53.17","28.55"
"65","000","00","050","0009","0583","690","398","292","25","715","1269","0","56.34","31.36"
"65","000","00","050","0009","0584","675","394","281","30","705","1129","0","62.44","34.90"
"65","000","00","050","0009","0585","720","372","348","19","739","1267","0","58.33","29.36"
"65","000","00","050","0009","0586","723","397","326","29","752","1310","0","57.40","30.31"
"65","000","00","050","0010","0000","1022","551","471","64","1086","1796","0","60.47","30.68"
"65","000","00","050","0010","0375","514","280","234","37","551","897","0","61.43","31.22"
"65","000","00","050","0010","0376","508","271","237","27","535","899","0","59.51","30.14"
"65","000","00","050","0011","0000","2742","1499","1243","151","2893","5120","0","56.50","29.28"
"65","000","00","050","0011","0450","641","353","288","27","668","1143","0","58.44","30.88"
"65","000","00","050","0011","0451","685","370","315","48","733","1241","0","59.07","29.81"
"65","000","00","050","0011","0452","558","313","245","42","600","1137","0","52.77","27.53"
"65","000","00","050","0011","0453","858","463","395","34","892","1599","0","55.78","28.96"
"65","000","00","050","0012","0000","1312","731","581","61","1373","2650","0","51.81","27.58"
"65","000","00","050","0012","0601","638","353","285","41","679","1357","0","50.04","26.01"
"65","000","00","050","0012","0602","674","378","296","20","694","1293","0","53.67","29.23"
"65","000","00","050","0013","0000","1638","808","830","79","1717","2757","0","62.28","29.31"
"65","000","00","050","0013","0379","351","184","167","15","366","601","0","60.90","30.62"
"65","000","00","050","0013","0380","664","313","351","33","697","1106","0","63.02","28.30"
"65","000","00","050","0013","0381","623","311","312","31","654","1050","0","62.29","29.62"
"65","000","00","050","0014","0000","2121","1217","904","127","2248","3904","0","57.58","31.17"
"65","000","00","050","0014","0461","730","414","316","28","758","1293","0","58.62","32.02"
"65","000","00","050","0014","0462","685","387","298","51","736","1318","0","55.84","29.36"
"65","000","00","050","0014","0463","706","416","290","48","754","1293","0","58.31","32.17"
"65","000","00","050","0015","0000","5291","2897","2394","211","5502","10813","0","50.88","26.79"
"65","000","00","050","0015","0631","618","361","257","21","639","1151","0","55.52","31.36"
"65","000","00","050","0015","0632","553","325","228","24","577","1046","0","55.16","31.07"
"65","000","00","050","0015","0633","786","432","354","31","817","1495","0","54.65","28.90"
"65","000","00","050","0015","0634","548","285","263","21","569","1137","0","50.04","25.07"
"65","000","00","050","0015","0635","486","253","233","25","511","1124","0","45.46","22.51"
"65","000","00","050","0015","0636","718","356","362","25","743","1360","0","54.63","26.18"
"65","000","00","050","0015","0637","740","409","331","21","761","1571","0","48.44","26.03"
"65","000","00","050","0015","0638","842","476","366","43","885","1929","0","45.88","24.68"
"65","000","00","050","0016","0000","1495","828","667","54","1549","5136","0","30.16","16.12"
"65","000","00","050","0016","0382","583","329","254","33","616","1192","0","51.68","27.60"
"65","000","00","050","0016","0383","912","499","413","21","933","3944","0","23.66","12.65"
"65","000","00","050","0017","0000","2073","1256","817","118","2191","3766","0","58.18","33.35"
"65","000","00","050","0017","0464","658","408","250","31","689","1205","0","57.18","33.86"
"65","000","00","050","0017","0465","756","440","316","45","801","1322","0","60.59","33.28"
"65","000","00","050","0017","0466","659","408","251","42","701","1239","0","56.58","32.93"
"65","000","00","050","0018","0000","2089","1222","867","145","2234","4205","0","53.13","29.06"
"65","000","00","050","0018","0530","629","343","286","36","665","1258","0","52.86","27.27"
"65","000","00","050","0018","0531","644","377","267","43","687","1130","0","60.80","33.36"
"65","000","00","050","0018","0532","464","290","174","46","510","1051","0","48.53","27.59"
"65","000","00","050","0018","0533","352","212","140","20","372","766","0","48.56","27.68"
"65","000","00","050","0019","0000","868","469","399","42","910","1510","0","60.26","31.06"
"65","000","00","050","0019","0384","868","469","399","42","910","1510","0","60.26","31.06"
"65","000","00","050","0020","0000","872","539","333","66","938","1834","0","51.15","29.39"
"65","000","00","050","0020","0487","456","295","161","28","484","927","0","52.21","31.82"
"65","000","00","050","0020","0488","416","244","172","38","454","907","0","50.06","26.90"
"65","000","00","050","0021","0000","3140","1826","1314","203","3343","5764","0","58.00","31.68"
"65","000","00","050","0021","0564","746","405","341","39","785","1380","0","56.88","29.35"
"65","000","00","050","0021","0565","880","525","355","51","931","1521","0","61.21","34.52"
"65","000","00","050","0021","0566","792","473","319","64","856","1456","0","58.79","32.49"
"65","000","00","050","0021","0567","722","423","299","49","771","1407","0","54.80","30.06"
"65","000","00","050","0022","0000","943","573","370","40","983","1469","0","66.92","39.01"
"65","000","00","050","0022","0385","943","573","370","40","983","1469","0","66.92","39.01"
"65","000","00","050","0023","0000","2828","1567","1261","126","2954","5153","0","57.33","30.41"
"65","000","00","050","0023","0489","687","381","306","24","711","1313","0","54.15","29.02"
"65","000","00","050","0023","0490","675","377","298","39","714","1310","0","54.50","28.78"
"65","000","00","050","0023","0491","793","441","352","37","830","1338","0","62.03","32.96"
"65","000","00","050","0023","0492","673","368","305","26","699","1192","0","58.64","30.87"
"65","000","00","050","0024","0000","1092","645","447","77","1169","1975","0","59.19","32.66"
"65","000","00","050","0024","0570","519","314","205","37","556","988","0","56.28","31.78"
"65","000","00","050","0024","0571","573","331","242","40","613","987","0","62.11","33.54"
"65","000","00","050","0025","0000","2251","1315","936","141","2392","4505","0","53.10","29.19"
"65","000","00","050","0025","0441","557","319","238","37","594","1111","0","53.47","28.71"
"65","000","00","050","0025","0442","587","335","252","26","613","1113","0","55.08","30.10"
"65","000","00","050","0025","0443","545","321","224","46","591","1151","0","51.35","27.89"
"65","000","00","050","0025","0444","562","340","222","32","594","1130","0","52.57","30.09"
"65","000","00","050","0026","0000","894","392","502","46","940","1612","0","58.31","24.32"
"65","000","00","050","0026","0457","437","229","208","19","456","789","0","57.79","29.02"
"65","000","00","050","0026","0458","457","163","294","27","484","823","0","58.81","19.81"
"65","000","00","050","0027","0000","2312","1329","983","115","2427","4468","0","54.32","29.74"
"65","000","00","050","0027","0590","530","309","221","25","555","1062","0","52.26","29.10"
"65","000","00","050","0027","0591","584","339","245","34","618","1063","0","58.14","31.89"
"65","000","00","050","0027","0592","618","350","268","36","654","1187","0","55.10","29.49"
"65","000","00","050","0027","0593","580","331","249","20","600","1156","0","51.90","28.63"
"65","000","00","050","0028","0000","1193","716","477","105","1298","2271","0","57.16","31.53"
"65","000","00","050","0028","0431","583","365","218","59","642","1105","0","58.10","33.03"
"65","000","00","050","0028","0432","610","351","259","46","656","1166","0","56.26","30.10"
"65","000","00","050","0029","0000","1227","639","588","48","1275","2179","0","58.51","29.33"
"65","000","00","050","0029","0459","616","303","313","16","632","1062","0","59.51","28.53"
"65","000","00","050","0029","0460","611","336","275","32","643","1117","0","57.56","30.08"
"65","000","00","050","0030","0000","2220","1257","963","154","2374","4465","0","53.17","28.15"
"65","000","00","050","0030","0418","530","273","257","33","563","1108","0","50.81","24.64"
"65","000","00","050","0030","0419","514","299","215","40","554","1033","0","53.63","28.94"
"65","000","00","050","0030","0420","600","382","218","42","642","1199","0","53.54","31.86"
"65","000","00","050","0030","0421","576","303","273","39","615","1125","0","54.67","26.93"
"65","000","00","050","0031","0000","2323","1171","1152","116","2439","4204","0","58.02","27.85"
"65","000","00","050","0031","0521","715","390","325","41","756","1313","0","57.58","29.70"
"65","000","00","050","0031","0522","806","395","411","34","840","1385","0","60.65","28.52"
"65","000","00","050","0031","0523","802","386","416","41","843","1506","0","55.98","25.63"
"65","000","00","050","0032","0000","2715","1411","1304","110","2825","4999","0","56.51","28.23"
"65","000","00","050","0032","0606","628","345","283","38","666","1253","0","53.15","27.53"
"65","000","00","050","0032","0607","744","373","371","24","768","1305","0","58.85","28.58"
"65","000","00","050","0032","0608","683","367","316","28","711","1215","0","58.52","30.21"
"65","000","00","050","0032","0609","660","326","334","20","680","1226","0","55.46","26.59"
"65","000","00","050","0033","0000","2084","1263","821","121","2205","4060","0","54.31","31.11"
"65","000","00","050","0033","0409","701","443","258","50","751","1397","0","53.76","31.71"
"65","000","00","050","0033","0410","728","468","260","41","769","1405","0","54.73","33.31"
"65","000","00","050","0033","0411","655","352","303","30","685","1258","0","54.45","27.98"
"65","000","00","050","0034","0000","1502","846","656","99","1601","3073","0","52.10","27.53"
"65","000","00","050","0034","0515","448","244","204","30","478","951","0","50.26","25.66"
"65","000","00","050","0034","0516","497","278","219","34","531","1055","0","50.33","26.35"
"65","000","00","050","0034","0517","557","324","233","35","592","1067","0","55.48","30.37"
"65","000","00","050","0035","0000","1362","797","565","102","1464","2577","0","56.81","30.93"
"65","000","00","050","0035","0613","723","423","300","46","769","1310","0","58.70","32.29"
"65","000","00","050","0035","0614","639","374","265","56","695","1267","0","54.85","29.52"
"65","000","00","050","0036","0000","1824","1058","766","93","1917","3312","0","57.88","31.94"
"65","000","00","050","0036","0386","560","340","220","26","586","1013","0","57.85","33.56"
"65","000","00","050","0036","0387","596","343","253","43","639","1026","0","62.28","33.43"
"65","000","00","050","0036","0388","668","375","293","24","692","1273","0","54.36","29.46"
"65","000","00","050","0037","0000","1894","1069","825","95","1989","3295","0","60.36","32.44"
"65","000","00","050","0037","0473","612","363","249","29","641","1095","0","58.54","33.15"
"65","000","00","050","0037","0474","652","357","295","40","692","1070","0","64.67","33.36"
"65","000","00","050","0037","0475","630","349","281","26","656","1130","0","58.05","30.88"
"65","000","00","050","0038","0000","2950","1658","1292","116","3066","5954","0","51.49","27.85"
"65","000","00","050","0038","0626","594","343","251","20","614","1206","0","50.91","28.44"
"65","000","00","050","0038","0627","564","317","247","25","589","1154","0","51.04","27.47"
"65","000","00","050","0038","0628","600","334","266","21","621","1211","0","51.28","27.58"
"65","000","00","050","0038","0629","530","292","238","29","559","1170","0","47.78","24.96"
"65","000","00","050","0038","0630","662","372","290","21","683","1213","0","56.31","30.67"
"65","000","00","050","0039","0000","2106","1177","929","95","2201","3569","0","61.67","32.98"
"65","000","00","050","0039","0445","674","381","293","27","701","1161","0","60.38","32.82"
"65","000","00","050","0039","0446","702","401","301","34","736","1186","0","62.06","33.81"
"65","000","00","050","0039","0447","730","395","335","34","764","1222","0","62.52","32.32"
"65","000","00","050","0040","0000","889","477","412","59","948","1484","0","63.88","32.14"
"65","000","00","050","0040","0536","237","122","115","11","248","444","0","55.86","27.48"
"65","000","00","050","0040","0537","652","355","297","48","700","1040","0","67.31","34.13"
"65","000","00","050","0041","0000","2088","1058","1030","134","2222","3738","0","59.44","28.30"
"65","000","00","050","0041","0621","723","348","375","41","764","1276","0","59.87","27.27"
"65","000","00","050","0041","0622","698","352","346","44","742","1240","0","59.84","28.39"
"65","000","00","050","0041","0623","667","358","309","49","716","1222","0","58.59","29.30"
"65","000","00","050","0042","0000","1026","612","414","112","1138","2220","0","51.26","27.57"
"65","000","00","050","0042","0439","505","287","218","47","552","1084","0","50.92","26.48"
"65","000","00","050","0042","0440","521","325","196","65","586","1136","0","51.58","28.61"
"65","000","00","050","0043","0000","3412","1887","1525","172","3584","7457","0","48.06","25.31"
"65","000","00","050","0043","0538","569","316","253","15","584","1263","0","46.24","25.02"
"65","000","00","050","0043","0539","586","337","249","22","608","1319","0","46.10","25.55"
"65","000","00","050","0043","0540","656","373","283","50","706","1303","0","54.18","28.63"
"65","000","00","050","0043","0541","616","340","276","42","658","1362","0","48.31","24.96"
"65","000","00","050","0043","0542","538","266","272","32","570","1212","0","47.03","21.95"
"65","000","00","050","0043","0543","447","255","192","11","458","998","0","45.89","25.55"
"65","000","00","050","0044","0000","1924","1065","859","123","2047","4035","0","50.73","26.39"
"65","000","00","050","0044","0615","615","345","270","48","663","1298","0","51.08","26.58"
"65","000","00","050","0044","0616","634","341","293","47","681","1372","0","49.64","24.85"
"65","000","00","050","0044","0617","675","379","296","28","703","1365","0","51.50","27.77"
"65","000","00","050","0045","0000","2221","1310","911","159","2380","4498","0","52.91","29.12"
"65","000","00","050","0045","0435","621","360","261","27","648","1161","0","55.81","31.01"
"65","000","00","050","0045","0436","562","315","247","34","596","1118","0","53.31","28.18"
"65","000","00","050","0045","0437","501","303","198","47","548","1075","0","50.98","28.19"
"65","000","00","050","0045","0438","537","332","205","51","588","1144","0","51.40","29.02"
"65","000","00","050","0046","0000","2055","1193","862","155","2210","3820","0","57.85","31.23"
"65","000","00","050","0046","0544","635","364","271","57","692","1219","0","56.77","29.86"
"65","000","00","050","0046","0545","725","418","307","49","774","1323","0","58.50","31.59"
"65","000","00","050","0046","0546","695","411","284","49","744","1278","0","58.22","32.16"
"65","000","00","050","0047","0000","1981","1182","799","141","2122","3667","0","57.87","32.23"
"65","000","00","050","0047","0412","668","398","270","19","687","1230","0","55.85","32.36"
"65","000","00","050","0047","0413","621","365","256","60","681","1201","0","56.70","30.39"
"65","000","00","050","0047","0414","692","419","273","62","754","1236","0","61.00","33.90"
"65","000","00","050","0048","0000","4741","2584","2157","190","4931","9641","0","51.15","26.80"
"65","000","00","050","0048","0549","825","433","392","21","846","1559","0","54.27","27.77"
"65","000","00","050","0048","0550","748","409","339","22","770","1423","0","54.11","28.74"
"65","000","00","050","0048","0551","578","325","253","28","606","1284","0","47.20","25.31"
"65","000","00","050","0048","0552","602","339","263","32","634","1322","0","47.96","25.64"
"65","000","00","050","0048","0553","705","360","345","34","739","1442","0","51.25","24.97"
"65","000","00","050","0048","0554","595","341","254","31","626","1246","0","50.24","27.37"
"65","000","00","050","0048","0555","688","377","311","22","710","1365","0","52.01","27.62"
"65","000","00","050","0049","0000","1107","654","453","76","1183","2091","0","56.58","31.28"
"65","000","00","050","0049","0433","523","302","221","38","561","1012","0","55.43","29.84"
"65","000","00","050","0049","0434","584","352","232","38","622","1079","0","57.65","32.62"
"65","000","00","050","0050","0000","4543","2488","2055","188","4731","8398","0","56.33","29.63"
"65","000","00","050","0050","0558","777","458","319","26","803","1383","0","58.06","33.12"
"65","000","00","050","0050","0559","793","397","396","34","827","1446","0","57.19","27.46"
"65","000","00","050","0050","0560","726","429","297","51","777","1413","0","54.99","30.36"
"65","000","00","050","0050","0561","761","411","350","29","790","1381","0","57.20","29.76"
"65","000","00","050","0050","0562","732","389","343","20","752","1386","0","54.26","28.07"
"65","000","00","050","0050","0563","754","404","350","28","782","1389","0","56.30","29.09"
"65","000","00","050","0051","0000","1386","787","599","65","1451","2429","0","59.74","32.40"
"65","000","00","050","0051","0448","668","381","287","41","709","1208","0","58.69","31.54"
"65","000","00","050","0051","0449","718","406","312","24","742","1221","0","60.77","33.25"
"65","000","00","050","0052","0000","2206","1269","937","101","2307","4412","0","52.29","28.76"
"65","000","00","050","0052","0512","752","444","308","35","787","1561","0","50.42","28.44"
"65","000","00","050","0052","0513","810","439","371","41","851","1588","0","53.59","27.64"
"65","000","00","050","0052","0514","644","386","258","25","669","1263","0","52.97","30.56"
"65","000","00","050","0053","0000","5874","3237","2637","237","6111","11406","0","53.58","28.38"
"65","000","00","050","0053","0504","806","452","354","24","830","1703","0","48.74","26.54"
"65","000","00","050","0053","0505","540","283","257","12","552","1187","0","46.50","23.84"
"65","000","00","050","0053","0506","619","349","270","22","641","1227","0","52.24","28.44"
"65","000","00","050","0053","0507","697","388","309","38","735","1279","0","57.47","30.34"
"65","000","00","050","0053","0508","894","489","405","38","932","1617","0","57.64","30.24"
"65","000","00","050","0053","0509","703","381","322","41","744","1336","0","55.69","28.52"
"65","000","00","050","0053","0510","753","419","334","38","791","1435","0","55.12","29.20"
"65","000","00","050","0053","0511","862","476","386","24","886","1622","0","54.62","29.35"
"65","000","00","050","0054","0000","3624","2119","1505","194","3818","7031","0","54.30","30.14"
"65","000","00","050","0054","0493","711","400","311","49","760","1412","0","53.82","28.33"
"65","000","00","050","0054","0494","742","458","284","43","785","1398","0","56.15","32.76"
"65","000","00","050","0054","0495","747","454","293","34","781","1430","0","54.62","31.75"
"65","000","00","050","0054","0496","687","388","299","37","724","1380","0","52.46","28.12"
"65","000","00","050","0054","0497","737","419","318","31","768","1411","0","54.43","29.70"
"65","000","00","050","0055","0000","1718","1018","700","110","1828","3955","0","46.22","25.74"
"65","000","00","050","0055","0587","612","373","239","32","644","1331","0","48.38","28.02"
"65","000","00","050","0055","0588","550","324","226","41","591","1293","0","45.71","25.06"
"65","000","00","050","0055","0589","556","321","235","37","593","1331","0","44.55","24.12"
"65","000","00","050","0056","0000","1094","609","485","62","1156","2122","0","54.48","28.70"
"65","000","00","050","0056","0580","560","317","243","28","588","1058","0","55.58","29.96"
"65","000","00","050","0056","0581","534","292","242","34","568","1064","0","53.38","27.44"
"65","000","00","050","0057","0000","1578","871","707","77","1655","3118","0","53.08","27.93"
"65","000","00","050","0057","0467","495","307","188","28","523","1025","0","51.02","29.95"
"65","000","00","050","0057","0468","599","312","287","24","623","1113","0","55.97","28.03"
"65","000","00","050","0057","0469","484","252","232","25","509","980","0","51.94","25.71"
"65","000","00","050","0058","0000","1663","1020","643","104","1767","2976","0","59.38","34.27"
"65","000","00","050","0058","0470","586","378","208","38","624","1046","0","59.66","36.14"
"65","000","00","050","0058","0471","537","310","227","32","569","963","0","59.09","32.19"
"65","000","00","050","0058","0472","540","332","208","34","574","967","0","59.36","34.33"
"65","000","00","050","0059","0000","2330","1223","1107","121","2451","4229","0","57.96","28.92"
"65","000","00","050","0059","0518","753","391","362","44","797","1454","0","54.81","26.89"
"65","000","00","050","0059","0519","780","433","347","55","835","1390","0","60.07","31.15"
"65","000","00","050","0059","0520","797","399","398","22","819","1385","0","59.13","28.81"
"65","000","00","050","0060","0000","2378","1258","1120","92","2470","4114","0","60.04","30.58"
"65","000","00","050","0060","0369","789","405","384","31","820","1414","0","57.99","28.64"
"65","000","00","050","0060","0370","831","437","394","30","861","1417","0","60.76","30.84"
"65","000","00","050","0060","0371","758","416","342","31","789","1283","0","61.50","32.42"
"65","000","00","050","0061","0000","1719","1020","699","92","1811","3139","0","57.69","32.49"
"65","000","00","050","0061","0428","580","333","247","25","605","1034","0","58.51","32.21"
"65","000","00","050","0061","0429","578","346","232","35","613","1029","0","59.57","33.62"
"65","000","00","050","0061","0430","561","341","220","32","593","1076","0","55.11","31.69"
"65","000","00","050","0062","0000","2780","1493","1287","127","2907","5100","0","57.00","29.27"
"65","000","00","050","0062","0483","692","352","340","31","723","1313","0","55.06","26.81"
"65","000","00","050","0062","0484","615","344","271","51","666","1217","0","54.72","28.27"
"65","000","00","050","0062","0485","736","384","352","18","754","1301","0","57.96","29.52"
"65","000","00","050","0062","0486","737","413","324","27","764","1269","0","60.20","32.55"
"65","000","00","050","0063","0000","1764","963","801","87","1851","3047","0","60.75","31.60"
"65","000","00","050","0063","0425","550","298","252","41","591","960","0","61.56","31.04"
"65","000","00","050","0063","0426","577","325","252","28","605","1001","0","60.44","32.47"
"65","000","00","050","0063","0427","637","340","297","18","655","1086","0","60.31","31.31"
"65","000","00","050","0064","0000","3710","2000","1710","96","3806","7262","0","52.41","27.54"
"65","000","00","050","0064","0403","408","208","200","4","412","791","0","52.09","26.30"
"65","000","00","050","0064","0404","617","303","314","14","631","1260","0","50.08","24.05"
"65","000","00","050","0064","0405","636","350","286","19","655","1291","0","50.74","27.11"
"65","000","00","050","0064","0406","785","445","340","21","806","1460","0","55.21","30.48"
"65","000","00","050","0064","0407","625","348","277","20","645","1223","0","52.74","28.45"
"65","000","00","050","0064","0408","639","346","293","18","657","1237","0","53.11","27.97"
"65","000","00","050","0065","0000","1619","799","820","92","1711","2849","0","60.06","28.04"
"65","000","00","050","0065","0377","804","388","416","49","853","1424","0","59.90","27.25"
"65","000","00","050","0065","0378","815","411","404","43","858","1425","0","60.21","28.84"
"65","000","00","050","0066","0000","1715","1019","696","101","1816","3159","0","57.49","32.26"
"65","000","00","050","0066","0577","562","332","230","26","588","1041","0","56.48","31.89"
"65","000","00","050","0066","0578","558","328","230","36","594","1010","0","58.81","32.48"
"65","000","00","050","0066","0579","595","359","236","39","634","1108","0","57.22","32.40"
"65","000","00","050","0067","0000","1063","617","446","67","1130","1962","0","57.59","31.45"
"65","000","00","050","0067","0568","514","320","194","35","549","997","0","55.07","32.10"
"65","000","00","050","0067","0569","549","297","252","32","581","965","0","60.21","30.78"
"65","000","00","050","0068","0000","1035","615","420","68","1103","2067","0","53.36","29.75"
"65","000","00","050","0068","0534","476","293","183","37","513","1072","0","47.85","27.33"
"65","000","00","050","0068","0535","559","322","237","31","590","995","0","59.30","32.36"
"65","000","00","050","0069","0000","1473","803","670","68","1541","2589","0","59.52","31.02"
"65","000","00","050","0069","0575","730","390","340","31","761","1289","0","59.04","30.26"
"65","000","00","050","0069","0576","743","413","330","37","780","1300","0","60.00","31.77"
"65","000","00","050","0070","0000","2881","1624","1257","105","2986","5720","0","52.20","28.39"
"65","000","00","050","0070","0594","722","397","325","37","759","1395","0","54.41","28.46"
"65","000","00","050","0070","0595","762","420","342","22","784","1440","0","54.44","29.17"
"65","000","00","050","0070","0596","697","403","294","28","725","1427","0","50.81","28.24"
"65","000","00","050","0070","0597","700","404","296","18","718","1458","0","49.25","27.71"
"65","000","00","050","0071","0000","1989","1098","891","96","2085","4248","0","49.08","25.85"
"65","000","00","050","0071","0603","635","343","292","53","688","1352","0","50.89","25.37"
"65","000","00","050","0071","0604","690","400","290","8","698","1470","0","47.48","27.21"
"65","000","00","050","0071","0605","664","355","309","35","699","1426","0","49.02","24.89"
"65","000","00","050","0072","0000","2812","1603","1209","114","2926","5143","0","56.89","31.17"
"65","000","00","050","0072","0399","647","345","302","11","658","1293","0","50.89","26.68"
"65","000","00","050","0072","0400","706","432","274","29","735","1283","0","57.29","33.67"
"65","000","00","050","0072","0401","730","455","275","27","757","1262","0","59.98","36.05"
"65","000","00","050","0072","0402","729","371","358","47","776","1305","0","59.46","28.43"
"65","000","00","050","0073","0000","1595","921","674","76","1671","3147","0","53.10","29.27"
"65","000","00","050","0073","0422","569","326","243","17","586","1117","0","52.46","29.19"
"65","000","00","050","0073","0423","482","291","191","36","518","934","0","55.46","31.16"
"65","000","00","050","0073","0424","544","304","240","23","567","1096","0","51.73","27.74"
"65","000","00","050","0074","0000","2015","1100","915","69","2084","3748","0","55.60","29.35"
"65","000","00","050","0074","0415","667","357","310","33","700","1211","0","57.80","29.48"
"65","000","00","050","0074","0416","670","377","293","16","686","1319","0","52.01","28.58"
"65","000","00","050","0074","0417","678","366","312","20","698","1218","0","57.31","30.05"
"65","000","00","050","0075","0000","4112","2165","1947","137","4249","7664","0","55.44","28.25"
"65","000","00","050","0075","0498","715","383","332","27","742","1259","0","58.94","30.42"
"65","000","00","050","0075","0499","707","381","326","16","723","1287","0","56.18","29.60"
"65","000","00","050","0075","0500","646","342","304","23","669","1257","0","53.22","27.21"
"65","000","00","050","0075","0501","660","350","310","34","694","1254","0","55.34","27.91"
"65","000","00","050","0075","0502","629","302","327","19","648","1198","0","54.09","25.21"
"65","000","00","050","0075","0503","755","407","348","18","773","1409","0","54.86","28.89"
"65","000","00","050","0076","0000","5116","2744","2372","184","5300","9843","0","53.85","27.88"
"65","000","00","050","0076","0476","855","479","376","42","897","1519","0","59.05","31.53"
"65","000","00","050","0076","0477","765","403","362","36","801","1506","0","53.19","26.76"
"65","000","00","050","0076","0478","746","376","370","24","770","1389","0","55.44","27.07"
"65","000","00","050","0076","0479","686","367","319","14","700","1365","0","51.28","26.89"
"65","000","00","050","0076","0480","692","352","340","23","715","1337","0","53.48","26.33"
"65","000","00","050","0076","0481","692","390","302","23","715","1365","0","52.38","28.57"
"65","000","00","050","0076","0482","680","377","303","22","702","1362","0","51.54","27.68"
"65","000","00","050","0077","0000","1207","669","538","75","1282","2160","0","59.35","30.97"
"65","000","00","050","0077","0528","604","320","284","27","631","1074","0","58.75","29.80"
"65","000","00","050","0077","0529","603","349","254","48","651","1086","0","59.94","32.14"
"65","000","00","050","0078","0000","1748","989","759","92","1840","3329","0","55.27","29.71"
"65","000","00","050","0078","0572","576","330","246","28","604","1151","0","52.48","28.67"
"65","000","00","050","0078","0573","558","319","239","26","584","1015","0","57.54","31.43"
"65","000","00","050","0078","0574","614","340","274","38","652","1163","0","56.06","29.23"
"65","000","00","050","0079","0000","914","499","415","31","945","1888","0","50.05","26.43"
"65","000","00","050","0079","0556","430","231","199","17","447","923","0","48.43","25.03"
"65","000","00","050","0079","0557","484","268","216","14","498","965","0","51.61","27.77"
"65","000","00","050","0080","0000","1111","572","539","49","1160","2044","0","56.75","27.98"
"65","000","00","050","0080","0547","552","263","289","29","581","1026","0","56.63","25.63"
"65","000","00","050","0080","0548","559","309","250","20","579","1018","0","56.88","30.35"
"65","000","00","050","0081","0000","1659","929","730","63","1722","3146","0","54.74","29.53"
"65","000","00","050","0081","0598","620","358","262","19","639","1162","0","54.99","30.81"
"65","000","00","050","0081","0599","533","324","209","25","558","985","0","56.65","32.89"
"65","000","00","050","0081","0600","506","247","259","19","525","999","0","52.55","24.72"
"65","000","00","050","0082","0000","1974","1071","903","87","2061","3404","0","60.55","31.46"
"65","000","00","050","0082","0610","687","394","293","28","715","1169","0","61.16","33.70"
"65","000","00","050","0082","0611","557","278","279","21","578","964","0","59.96","28.84"
"65","000","00","050","0082","0612","730","399","331","38","768","1271","0","60.42","31.39"
"65","000","00","050","0083","0000","2025","1071","954","111","2136","3646","0","58.58","29.37"
"65","000","00","050","0083","0618","662","343","319","38","700","1187","0","58.97","28.90"
"65","000","00","050","0083","0619","691","385","306","33","724","1231","0","58.81","31.28"
"65","000","00","050","0083","0620","672","343","329","40","712","1228","0","57.98","27.93"
"65","000","00","050","0084","0000","1104","616","488","92","1196","2330","0","51.33","26.44"
"65","000","00","050","0084","0624","579","324","255","39","618","1171","0","52.78","27.67"
"65","000","00","050","0084","0625","525","292","233","53","578","1159","0","49.87","25.19"
"65","000","00","060","0000","0000","136411","60617","75794","6206","142617","255988","296811","55.71","23.68"
"65","000","00","060","0001","0000","1472","589","883","66","1538","2663","0","57.75","22.12"
"65","000","00","060","0001","2213","742","303","439","35","777","1340","0","57.99","22.61"
"65","000","00","060","0001","2214","730","286","444","31","761","1323","0","57.52","21.62"
"65","000","00","060","0002","0000","1905","819","1086","92","1997","3410","0","58.56","24.02"
"65","000","00","060","0002","2215","738","315","423","32","770","1335","0","57.68","23.60"
"65","000","00","060","0002","2216","545","228","317","33","578","965","0","59.90","23.63"
"65","000","00","060","0002","2217","622","276","346","27","649","1110","0","58.47","24.86"
"65","000","00","060","0003","0000","1801","792","1009","88","1889","3076","0","61.41","25.75"
"65","000","00","060","0003","2218","586","245","341","24","610","982","0","62.12","24.95"
"65","000","00","060","0003","2219","599","292","307","28","627","1068","0","58.71","27.34"
"65","000","00","060","0003","2220","616","255","361","36","652","1026","0","63.55","24.85"
"65","000","00","060","0004","0000","1876","850","1026","111","1987","3315","0","59.94","25.64"
"65","000","00","060","0004","2221","536","269","267","40","576","958","0","60.13","28.08"
"65","000","00","060","0004","2222","703","301","402","31","734","1174","0","62.52","25.64"
"65","000","00","060","0004","2223","637","280","357","40","677","1183","0","57.23","23.67"
"65","000","00","060","0005","0000","2614","1090","1524","95","2709","4672","0","57.98","23.33"
"65","000","00","060","0005","2224","567","238","329","26","593","1047","0","56.64","22.73"
"65","000","00","060","0005","2225","692","271","421","27","719","1185","0","60.68","22.87"
"65","000","00","060","0005","2226","728","298","430","19","747","1244","0","60.05","23.95"
"65","000","00","060","0005","2227","627","283","344","23","650","1196","0","54.35","23.66"
"65","000","00","060","0006","0000","2695","1277","1418","105","2800","4685","0","59.77","27.26"
"65","000","00","060","0006","2230","917","375","542","29","946","1613","0","58.65","23.25"
"65","000","00","060","0006","2231","616","374","242","11","627","1070","0","58.60","34.95"
"65","000","00","060","0006","2232","609","267","342","29","638","1008","0","63.29","26.49"
"65","000","00","060","0006","2233","553","261","292","36","589","994","0","59.26","26.26"
"65","000","00","060","0007","0000","2521","1071","1450","99","2620","4634","0","56.54","23.11"
"65","000","00","060","0007","2239","562","271","291","28","590","1204","0","49.00","22.51"
"65","000","00","060","0007","2240","610","239","371","36","646","1119","0","57.73","21.36"
"65","000","00","060","0007","2241","635","243","392","25","660","1132","0","58.30","21.47"
"65","000","00","060","0007","2242","714","318","396","10","724","1179","0","61.41","26.97"
"65","000","00","060","0008","0000","3098","1435","1663","139","3237","5721","0","56.58","25.08"
"65","000","00","060","0008","2243","831","350","481","31","862","1437","0","59.99","24.36"
"65","000","00","060","0008","2244","731","365","366","32","763","1405","0","54.31","25.98"
"65","000","00","060","0008","2245","742","371","371","24","766","1444","0","53.05","25.69"
"65","000","00","060","0008","2246","794","349","445","52","846","1435","0","58.95","24.32"
"65","000","00","060","0009","0000","1227","492","735","69","1296","2428","0","53.38","20.26"
"65","000","00","060","0009","2247","662","282","380","36","698","1328","0","52.56","21.23"
"65","000","00","060","0009","2248","565","210","355","33","598","1100","0","54.36","19.09"
"65","000","00","060","0010","0000","1428","387","1041","46","1474","2343","0","62.91","16.52"
"65","000","00","060","0010","2249","729","177","552","25","754","1194","0","63.15","14.82"
"65","000","00","060","0010","2250","699","210","489","21","720","1149","0","62.66","18.28"
"65","000","00","060","0011","0000","1478","670","808","67","1545","2681","0","57.63","24.99"
"65","000","00","060","0011","2251","493","248","245","28","521","880","0","59.20","28.18"
"65","000","00","060","0011","2252","533","244","289","22","555","953","0","58.24","25.60"
"65","000","00","060","0011","2253","452","178","274","17","469","848","0","55.31","20.99"
"65","000","00","060","0012","0000","673","302","371","65","738","1422","0","51.90","21.24"
"65","000","00","060","0012","2256","395","176","219","50","445","835","0","53.29","21.08"
"65","000","00","060","0012","2257","278","126","152","15","293","587","0","49.91","21.47"
"65","000","00","060","0013","0000","1354","764","590","56","1410","2798","0","50.39","27.31"
"65","000","00","060","0013","2258","682","400","282","43","725","1408","0","51.49","28.41"
"65","000","00","060","0013","2259","672","364","308","13","685","1390","0","49.28","26.19"
"65","000","00","060","0014","0000","3902","1794","2108","165","4067","7816","0","52.03","22.95"
"65","000","00","060","0014","2260","724","291","433","25","749","1341","0","55.85","21.70"
"65","000","00","060","0014","2261","611","281","330","32","643","1237","0","51.98","22.72"
"65","000","00","060","0014","2262","618","308","310","42","660","1231","0","53.61","25.02"
"65","000","00","060","0014","2263","660","337","323","29","689","1357","0","50.77","24.83"
"65","000","00","060","0014","2264","630","295","335","24","654","1331","0","49.14","22.16"
"65","000","00","060","0014","2265","659","282","377","13","672","1319","0","50.95","21.38"
"65","000","00","060","0015","0000","2229","1028","1201","118","2347","4388","0","53.49","23.43"
"65","000","00","060","0015","2271","552","236","316","27","579","1106","0","52.35","21.34"
"65","000","00","060","0015","2272","555","262","293","26","581","1129","0","51.46","23.21"
"65","000","00","060","0015","2273","511","239","272","32","543","1046","0","51.91","22.85"
"65","000","00","060","0015","2274","611","291","320","33","644","1107","0","58.18","26.29"
"65","000","00","060","0016","0000","5582","2482","3100","237","5819","11438","0","50.87","21.70"
"65","000","00","060","0016","2282","648","298","350","34","682","1402","0","48.64","21.26"
"65","000","00","060","0016","2283","563","288","275","30","593","1201","0","49.38","23.98"
"65","000","00","060","0016","2284","657","288","369","22","679","1359","0","49.96","21.19"
"65","000","00","060","0016","2285","629","283","346","17","646","1302","0","49.62","21.74"
"65","000","00","060","0016","2286","584","256","328","26","610","1186","0","51.43","21.59"
"65","000","00","060","0016","2287","598","241","357","38","636","1194","0","53.27","20.18"
"65","000","00","060","0016","2288","581","264","317","21","602","1259","0","47.82","20.97"
"65","000","00","060","0016","2289","656","274","382","29","685","1269","0","53.98","21.59"
"65","000","00","060","0016","2290","666","290","376","20","686","1266","0","54.19","22.91"
"65","000","00","060","0017","0000","2524","1201","1323","154","2678","5241","0","51.10","22.92"
"65","000","00","060","0017","2295","649","297","352","33","682","1345","0","50.71","22.08"
"65","000","00","060","0017","2296","639","298","341","22","661","1275","0","51.84","23.37"
"65","000","00","060","0017","2297","595","259","336","49","644","1276","0","50.47","20.30"
"65","000","00","060","0017","2298","641","347","294","50","691","1345","0","51.38","25.80"
"65","000","00","060","0018","0000","2428","1223","1205","150","2578","4995","0","51.61","24.48"
"65","000","00","060","0018","2307","469","254","215","33","502","1083","0","46.35","23.45"
"65","000","00","060","0018","2308","517","264","253","37","554","1078","0","51.39","24.49"
"65","000","00","060","0018","2309","427","188","239","24","451","820","0","55.00","22.93"
"65","000","00","060","0018","2310","452","204","248","17","469","866","0","54.16","23.56"
"65","000","00","060","0018","2311","563","313","250","39","602","1148","0","52.44","27.26"
"65","000","00","060","0019","0000","2402","1201","1201","157","2559","5116","0","50.02","23.48"
"65","000","00","060","0019","2320","424","205","219","31","455","986","0","46.15","20.79"
"65","000","00","060","0019","2321","446","254","192","33","479","952","0","50.32","26.68"
"65","000","00","060","0019","2322","436","219","217","24","460","879","0","52.33","24.91"
"65","000","00","060","0019","2323","534","236","298","44","578","1135","0","50.93","20.79"
"65","000","00","060","0019","2324","562","287","275","25","587","1164","0","50.43","24.66"
"65","000","00","060","0020","0000","2713","1226","1487","127","2840","5191","0","54.71","23.62"
"65","000","00","060","0020","2325","589","279","310","36","625","1190","0","52.52","23.45"
"65","000","00","060","0020","2326","629","286","343","31","660","1265","0","52.17","22.61"
"65","000","00","060","0020","2327","651","288","363","26","677","1216","0","55.67","23.68"
"65","000","00","060","0020","2328","844","373","471","34","878","1520","0","57.76","24.54"
"65","000","00","060","0021","0000","425","281","144","41","466","905","0","51.49","31.05"
"65","000","00","060","0021","2333","425","281","144","41","466","905","0","51.49","31.05"
"65","000","00","060","0022","0000","2240","984","1256","109","2349","4496","0","52.25","21.89"
"65","000","00","060","0022","2340","558","238","320","20","578","1124","0","51.42","21.17"
"65","000","00","060","0022","2341","578","252","326","15","593","1194","0","49.66","21.11"
"65","000","00","060","0022","2342","524","261","263","43","567","1122","0","50.53","23.26"
"65","000","00","060","0022","2343","580","233","347","31","611","1056","0","57.86","22.06"
"65","000","00","060","0023","0000","2450","1121","1329","138","2588","4592","0","56.36","24.41"
"65","000","00","060","0023","2344","734","342","392","60","794","1438","0","55.22","23.78"
"65","000","00","060","0023","2345","1043","438","605","47","1090","1892","0","57.61","23.15"
"65","000","00","060","0023","2346","673","341","332","31","704","1262","0","55.78","27.02"
"65","000","00","060","0024","0000","344","191","153","42","386","704","0","54.83","27.13"
"65","000","00","060","0024","2347","344","191","153","42","386","704","0","54.83","27.13"
"65","000","00","060","0025","0000","1451","799","652","64","1515","2656","0","57.04","30.08"
"65","000","00","060","0025","2348","338","196","142","18","356","581","0","61.27","33.73"
"65","000","00","060","0025","2349","516","289","227","24","540","980","0","55.10","29.49"
"65","000","00","060","0025","2350","597","314","283","22","619","1095","0","56.53","28.68"
"65","000","00","060","0026","0000","1356","737","619","89","1445","2235","0","64.65","32.98"
"65","000","00","060","0026","2351","712","415","297","40","752","1099","0","68.43","37.76"
"65","000","00","060","0026","2352","644","322","322","49","693","1136","0","61.00","28.35"
"65","000","00","060","0027","0000","843","429","414","70","913","1537","0","59.40","27.91"
"65","000","00","060","0027","2353","843","429","414","70","913","1537","0","59.40","27.91"
"65","000","00","060","0028","0000","690","413","277","78","768","1222","0","62.85","33.80"
"65","000","00","060","0028","2354","690","413","277","78","768","1222","0","62.85","33.80"
"65","000","00","060","0029","0000","724","390","334","37","761","1153","0","66.00","33.82"
"65","000","00","060","0029","2355","221","136","85","22","243","406","0","59.85","33.50"
"65","000","00","060","0029","2356","503","254","249","15","518","747","0","69.34","34.00"
"65","000","00","060","0030","0000","2271","1055","1216","122","2393","4714","0","50.76","22.38"
"65","000","00","060","0030","2336","601","298","303","21","622","1257","0","49.48","23.71"
"65","000","00","060","0030","2337","612","293","319","42","654","1227","0","53.30","23.88"
"65","000","00","060","0030","2338","481","199","282","23","504","986","0","51.12","20.18"
"65","000","00","060","0030","2339","577","265","312","36","613","1244","0","49.28","21.30"
"65","000","00","060","0031","0000","845","456","389","64","909","1552","0","58.57","29.38"
"65","000","00","060","0031","2137","845","456","389","64","909","1552","0","58.57","29.38"
"65","000","00","060","0032","0000","1135","480","655","47","1182","2080","0","56.83","23.08"
"65","000","00","060","0032","2138","452","187","265","16","468","778","0","60.15","24.04"
"65","000","00","060","0032","2139","683","293","390","31","714","1302","0","54.84","22.50"
"65","000","00","060","0033","0000","1234","600","634","59","1293","2239","0","57.75","26.80"
"65","000","00","060","0033","2140","587","291","296","36","623","1055","0","59.05","27.58"
"65","000","00","060","0033","2141","647","309","338","23","670","1184","0","56.59","26.10"
"65","000","00","060","0034","0000","886","350","536","36","922","1557","0","59.22","22.48"
"65","000","00","060","0034","2142","886","350","536","36","922","1557","0","59.22","22.48"
"65","000","00","060","0035","0000","390","205","185","18","408","700","0","58.29","29.29"
"65","000","00","060","0035","2143","390","205","185","18","408","700","0","58.29","29.29"
"65","000","00","060","0036","0000","1287","653","634","64","1351","2149","0","62.87","30.39"
"65","000","00","060","0036","2144","745","404","341","29","774","1254","0","61.72","32.22"
"65","000","00","060","0036","2145","542","249","293","35","577","895","0","64.47","27.82"
"65","000","00","060","0037","0000","2572","1069","1503","111","2683","6697","0","40.06","15.96"
"65","000","00","060","0037","2146","637","248","389","26","663","1211","0","54.75","20.48"
"65","000","00","060","0037","2147","457","167","290","19","476","834","0","57.07","20.02"
"65","000","00","060","0037","2148","318","157","161","12","330","2528","0","13.05","6.21"
"65","000","00","060","0037","2149","675","271","404","28","703","1189","0","59.13","22.79"
"65","000","00","060","0037","2150","485","226","259","26","511","935","0","54.65","24.17"
"65","000","00","060","0038","0000","2716","1152","1564","144","2860","4912","0","58.22","23.45"
"65","000","00","060","0038","2151","416","175","241","26","442","753","0","58.70","23.24"
"65","000","00","060","0038","2152","930","344","586","32","962","1480","0","65.00","23.24"
"65","000","00","060","0038","2153","719","336","383","44","763","1371","0","55.65","24.51"
"65","000","00","060","0038","2154","651","297","354","42","693","1308","0","52.98","22.71"
"65","000","00","060","0039","0000","1477","723","754","44","1521","2309","0","65.87","31.31"
"65","000","00","060","0039","2155","868","403","465","23","891","1187","0","75.06","33.95"
"65","000","00","060","0039","2156","609","320","289","21","630","1122","0","56.15","28.52"
"65","000","00","060","0040","0000","4286","1864","2422","162","4448","7696","0","57.80","24.22"
"65","000","00","060","0040","2157","653","297","356","31","684","1222","0","55.97","24.30"
"65","000","00","060","0040","2158","712","343","369","30","742","1182","0","62.77","29.02"
"65","000","00","060","0040","2159","763","341","422","42","805","1326","0","60.71","25.72"
"65","000","00","060","0040","2160","813","331","482","23","836","1446","0","57.81","22.89"
"65","000","00","060","0040","2161","694","302","392","20","714","1313","0","54.38","23.00"
"65","000","00","060","0040","2162","651","250","401","16","667","1207","0","55.26","20.71"
"65","000","00","060","0041","0000","3563","1553","2010","133","3696","6621","0","55.82","23.46"
"65","000","00","060","0041","2163","600","269","331","19","619","1133","0","54.63","23.74"
"65","000","00","060","0041","2164","634","292","342","38","672","1142","0","58.84","25.57"
"65","000","00","060","0041","2165","540","240","300","34","574","1074","0","53.45","22.35"
"65","000","00","060","0041","2166","582","260","322","15","597","1042","0","57.29","24.95"
"65","000","00","060","0041","2167","634","238","396","10","644","1091","0","59.03","21.81"
"65","000","00","060","0041","2168","573","254","319","17","590","1139","0","51.80","22.30"
"65","000","00","060","0042","0000","2001","842","1159","86","2087","3484","0","59.90","24.17"
"65","000","00","060","0042","2171","639","235","404","27","666","1088","0","61.21","21.60"
"65","000","00","060","0042","2172","231","95","136","9","240","466","0","51.50","20.39"
"65","000","00","060","0042","2173","543","249","294","13","556","917","0","60.63","27.15"
"65","000","00","060","0042","2174","588","263","325","37","625","1013","0","61.70","25.96"
"65","000","00","060","0043","0000","1226","532","694","50","1276","2071","0","61.61","25.69"
"65","000","00","060","0043","2175","661","276","385","29","690","1072","0","64.37","25.75"
"65","000","00","060","0043","2176","565","256","309","21","586","999","0","58.66","25.63"
"65","000","00","060","0044","0000","2918","1204","1714","126","3044","5203","0","58.50","23.14"
"65","000","00","060","0044","2177","837","346","491","40","877","1532","0","57.25","22.58"
"65","000","00","060","0044","2178","691","293","398","35","726","1270","0","57.17","23.07"
"65","000","00","060","0044","2179","754","302","452","38","792","1290","0","61.40","23.41"
"65","000","00","060","0044","2180","636","263","373","13","649","1111","0","58.42","23.67"
"65","000","00","060","0045","0000","1949","819","1130","95","2044","3768","0","54.25","21.74"
"65","000","00","060","0045","2181","623","259","364","33","656","1212","0","54.13","21.37"
"65","000","00","060","0045","2182","664","274","390","33","697","1216","0","57.32","22.53"
"65","000","00","060","0045","2183","662","286","376","29","691","1340","0","51.57","21.34"
"65","000","00","060","0046","0000","1019","414","605","38","1057","1722","0","61.38","24.04"
"65","000","00","060","0046","2184","533","243","290","20","553","884","0","62.56","27.49"
"65","000","00","060","0046","2185","486","171","315","18","504","838","0","60.14","20.41"
"65","000","00","060","0047","0000","1763","703","1060","97","1860","3148","0","59.09","22.33"
"65","000","00","060","0047","2188","475","205","270","35","510","861","0","59.23","23.81"
"65","000","00","060","0047","2189","585","221","364","17","602","1006","0","59.84","21.97"
"65","000","00","060","0047","2190","703","277","426","45","748","1281","0","58.39","21.62"
"65","000","00","060","0048","0000","1508","641","867","84","1592","2705","0","58.85","23.70"
"65","000","00","060","0048","2191","773","352","421","36","809","1348","0","60.01","26.11"
"65","000","00","060","0048","2192","735","289","446","48","783","1357","0","57.70","21.30"
"65","000","00","060","0049","0000","1727","774","953","114","1841","3327","0","55.34","23.26"
"65","000","00","060","0049","2193","569","251","318","50","619","1153","0","53.69","21.77"
"65","000","00","060","0049","2194","661","301","360","36","697","1222","0","57.04","24.63"
"65","000","00","060","0049","2195","497","222","275","28","525","952","0","55.15","23.32"
"65","000","00","060","0050","0000","1797","759","1038","75","1872","3133","0","59.75","24.23"
"65","000","00","060","0050","2196","618","274","344","35","653","1065","0","61.31","25.73"
"65","000","00","060","0050","2197","554","222","332","23","577","963","0","59.92","23.05"
"65","000","00","060","0050","2198","625","263","362","17","642","1105","0","58.10","23.80"
"65","000","00","060","0051","0000","1856","684","1172","74","1930","3521","0","54.81","19.43"
"65","000","00","060","0051","2199","822","276","546","37","859","1441","0","59.61","19.15"
"65","000","00","060","0051","2200","526","211","315","21","547","1009","0","54.21","20.91"
"65","000","00","060","0051","2201","508","197","311","16","524","1071","0","48.93","18.39"
"65","000","00","060","0052","0000","2844","1154","1690","63","2907","4886","0","59.50","23.62"
"65","000","00","060","0052","2202","511","238","273","5","516","1087","0","47.47","21.90"
"65","000","00","060","0052","2203","443","164","279","12","455","691","0","65.85","23.73"
"65","000","00","060","0052","2204","625","261","364","11","636","952","0","66.81","27.42"
"65","000","00","060","0052","2205","474","173","301","10","484","843","0","57.41","20.52"
"65","000","00","060","0052","2206","791","318","473","25","816","1313","0","62.15","24.22"
"65","000","00","060","0053","0000","681","346","335","45","726","1346","0","53.94","25.71"
"65","000","00","060","0053","2207","322","179","143","30","352","660","0","53.33","27.12"
"65","000","00","060","0053","2208","359","167","192","15","374","686","0","54.52","24.34"
"65","000","00","060","0054","0000","3105","1209","1896","104","3209","4978","0","64.46","24.29"
"65","000","00","060","0054","2209","832","333","499","32","864","1346","0","64.19","24.74"
"65","000","00","060","0054","2210","687","239","448","24","711","1126","0","63.14","21.23"
"65","000","00","060","0054","2211","822","339","483","20","842","1309","0","64.32","25.90"
"65","000","00","060","0054","2212","764","298","466","28","792","1197","0","66.17","24.90"
"65","000","00","060","0055","0000","1658","670","988","52","1710","2952","0","57.93","22.70"
"65","000","00","060","0055","2302","875","369","506","21","896","1490","0","60.13","24.77"
"65","000","00","060","0055","2303","783","301","482","31","814","1462","0","55.68","20.59"
"65","000","00","060","0056","0000","3414","1665","1749","141","3555","6806","0","52.23","24.46"
"65","000","00","060","0056","2266","881","395","486","32","913","1615","0","56.53","24.46"
"65","000","00","060","0056","2267","619","320","299","39","658","1299","0","50.65","24.63"
"65","000","00","060","0056","2268","636","320","316","14","650","1289","0","50.43","24.83"
"65","000","00","060","0056","2269","650","324","326","26","676","1270","0","53.23","25.51"
"65","000","00","060","0056","2270","628","306","322","30","658","1333","0","49.36","22.96"
"65","000","00","060","0057","0000","2236","876","1360","99","2335","4034","0","57.88","21.72"
"65","000","00","060","0057","2329","663","237","426","32","695","1189","0","58.45","19.93"
"65","000","00","060","0057","2330","621","237","384","29","650","1193","0","54.48","19.87"
"65","000","00","060","0057","2331","536","233","303","20","556","947","0","58.71","24.60"
"65","000","00","060","0057","2332","416","169","247","18","434","705","0","61.56","23.97"
"65","000","00","060","0058","0000","3423","1513","1910","145","3568","6143","0","58.08","24.63"
"65","000","00","060","0058","2234","734","303","431","14","748","1285","0","58.21","23.58"
"65","000","00","060","0058","2235","675","343","332","33","708","1289","0","54.93","26.61"
"65","000","00","060","0058","2236","365","180","185","23","388","815","0","47.61","22.09"
"65","000","00","060","0058","2237","792","323","469","15","807","1350","0","59.78","23.93"
"65","000","00","060","0058","2238","857","364","493","60","917","1404","0","65.31","25.93"
"65","000","00","060","0059","0000","1789","714","1075","57","1846","3141","0","58.77","22.73"
"65","000","00","060","0059","2304","643","265","378","20","663","1107","0","59.89","23.94"
"65","000","00","060","0059","2305","621","246","375","17","638","1111","0","57.43","22.14"
"65","000","00","060","0059","2306","525","203","322","20","545","923","0","59.05","21.99"
"65","000","00","060","0060","0000","4985","2148","2837","159","5144","9946","0","51.72","21.60"
"65","000","00","060","0060","2312","806","372","434","30","836","1531","0","54.60","24.30"
"65","000","00","060","0060","2313","566","250","316","20","586","1118","0","52.42","22.36"
"65","000","00","060","0060","2314","569","256","313","14","583","1143","0","51.01","22.40"
"65","000","00","060","0060","2315","673","252","421","14","687","1427","0","48.14","17.66"
"65","000","00","060","0060","2316","533","239","294","20","553","995","0","55.58","24.02"
"65","000","00","060","0060","2317","480","203","277","29","509","1062","0","47.93","19.11"
"65","000","00","060","0060","2318","593","255","338","15","608","1093","0","55.63","23.33"
"65","000","00","060","0060","2319","765","321","444","17","782","1577","0","49.59","20.36"
"65","000","00","060","0061","0000","1500","607","893","86","1586","2622","0","60.49","23.15"
"65","000","00","060","0061","2186","787","312","475","36","823","1369","0","60.12","22.79"
"65","000","00","060","0061","2187","713","295","418","50","763","1253","0","60.89","23.54"
"65","000","00","060","0062","0000","1370","632","738","54","1424","2818","0","50.53","22.43"
"65","000","00","060","0062","2228","698","346","352","32","730","1378","0","52.98","25.11"
"65","000","00","060","0062","2229","672","286","386","22","694","1440","0","48.19","19.86"
"65","000","00","060","0063","0000","1213","534","679","66","1279","2363","0","54.13","22.60"
"65","000","00","060","0063","2254","631","272","359","26","657","1219","0","53.90","22.31"
"65","000","00","060","0063","2255","582","262","320","40","622","1144","0","54.37","22.90"
"65","000","00","060","0064","0000","2596","1119","1477","95","2691","4727","0","56.93","23.67"
"65","000","00","060","0064","2291","648","271","377","18","666","1209","0","55.09","22.42"
"65","000","00","060","0064","2292","596","276","320","19","615","1123","0","54.76","24.58"
"65","000","00","060","0064","2293","713","293","420","30","743","1251","0","59.39","23.42"
"65","000","00","060","0064","2294","639","279","360","28","667","1144","0","58.30","24.39"
"65","000","00","060","0065","0000","1256","531","725","34","1290","2152","0","59.94","24.67"
"65","000","00","060","0065","2169","666","299","367","14","680","1132","0","60.07","26.41"
"65","000","00","060","0065","2170","590","232","358","20","610","1020","0","59.80","22.75"
"65","000","00","060","0066","0000","1813","811","1002","86","1899","3577","0","53.09","22.67"
"65","000","00","060","0066","2275","637","269","368","34","671","1271","0","52.79","21.16"
"65","000","00","060","0066","2276","628","272","356","26","654","1221","0","53.56","22.28"
"65","000","00","060","0066","2277","548","270","278","26","574","1085","0","52.90","24.88"
"65","000","00","060","0067","0000","2594","1211","1383","116","2710","4769","0","56.83","25.39"
"65","000","00","060","0067","2278","678","281","397","35","713","1268","0","56.23","22.16"
"65","000","00","060","0067","2279","665","313","352","22","687","1167","0","58.87","26.82"
"65","000","00","060","0067","2280","665","314","351","33","698","1256","0","55.57","25.00"
"65","000","00","060","0067","2281","586","303","283","26","612","1078","0","56.77","28.11"
"65","000","00","060","0068","0000","1803","738","1065","62","1865","3473","0","53.70","21.25"
"65","000","00","060","0068","2299","427","174","253","10","437","798","0","54.76","21.80"
"65","000","00","060","0068","2300","638","256","382","18","656","1145","0","57.29","22.36"
"65","000","00","060","0068","2301","738","308","430","34","772","1530","0","50.46","20.13"
"65","000","00","060","0069","0000","1260","569","691","25","1285","2414","0","53.23","23.57"
"65","000","00","060","0069","2334","485","220","265","11","496","973","0","50.98","22.61"
"65","000","00","060","0069","2335","775","349","426","14","789","1441","0","54.75","24.22"
"65","000","00","070","0000","0000","76431","41751","34680","3950","80381","147577","179845","54.47","28.29"
"65","000","00","070","0001","0000","1592","914","678","104","1696","3435","0","49.37","26.61"
"65","000","00","070","0001","1756","822","479","343","71","893","1828","0","48.85","26.20"
"65","000","00","070","0001","1757","770","435","335","33","803","1607","0","49.97","27.07"
"65","000","00","070","0002","0000","1812","933","879","112","1924","3319","0","57.97","28.11"
"65","000","00","070","0002","1753","605","312","293","29","634","1139","0","55.66","27.39"
"65","000","00","070","0002","1754","552","291","261","55","607","1032","0","58.82","28.20"
"65","000","00","070","0002","1755","655","330","325","28","683","1148","0","59.49","28.75"
"65","000","00","070","0003","0000","1786","1064","722","113","1899","3990","0","47.59","26.67"
"65","000","00","070","0003","1750","546","298","248","30","576","1278","0","45.07","23.32"
"65","000","00","070","0003","1751","581","335","246","38","619","1238","0","50.00","27.06"
"65","000","00","070","0003","1752","659","431","228","45","704","1474","0","47.76","29.24"
"65","000","00","070","0004","0000","1538","898","640","90","1628","3169","0","51.37","28.34"
"65","000","00","070","0004","1779","554","317","237","38","592","1068","0","55.43","29.68"
"65","000","00","070","0004","1780","460","277","183","27","487","1014","0","48.03","27.32"
"65","000","00","070","0004","1781","524","304","220","25","549","1087","0","50.51","27.97"
"65","000","00","070","0005","0000","2815","1506","1309","144","2959","5246","0","56.40","28.71"
"65","000","00","070","0005","1775","753","405","348","48","801","1402","0","57.13","28.89"
"65","000","00","070","0005","1776","751","399","352","41","792","1416","0","55.93","28.18"
"65","000","00","070","0005","1777","756","398","358","17","773","1334","0","57.95","29.84"
"65","000","00","070","0005","1778","555","304","251","38","593","1094","0","54.20","27.79"
"65","000","00","070","0006","0000","1733","994","739","113","1846","4282","0","43.11","23.21"
"65","000","00","070","0006","1769","588","381","207","37","625","1991","0","31.39","19.14"
"65","000","00","070","0006","1770","424","211","213","31","455","915","0","49.73","23.06"
"65","000","00","070","0006","1771","721","402","319","45","766","1376","0","55.67","29.22"
"65","000","00","070","0007","0000","1972","1149","823","96","2068","4226","0","48.94","27.19"
"65","000","00","070","0007","1760","723","426","297","29","752","1448","0","51.93","29.42"
"65","000","00","070","0007","1761","604","336","268","20","624","1356","0","46.02","24.78"
"65","000","00","070","0007","1762","645","387","258","47","692","1422","0","48.66","27.22"
"65","000","00","070","0008","0000","1777","943","834","106","1883","3065","0","61.44","30.77"
"65","000","00","070","0008","1788","481","230","251","31","512","843","0","60.74","27.28"
"65","000","00","070","0008","1789","779","444","335","53","832","1256","0","66.24","35.35"
"65","000","00","070","0008","1790","517","269","248","22","539","966","0","55.80","27.85"
"65","000","00","070","0009","0000","2518","1318","1200","122","2640","4277","0","61.73","30.82"
"65","000","00","070","0009","1793","841","438","403","42","883","1348","0","65.50","32.49"
"65","000","00","070","0009","1794","874","449","425","33","907","1471","0","61.66","30.52"
"65","000","00","070","0009","1795","803","431","372","47","850","1458","0","58.30","29.56"
"65","000","00","070","0010","0000","1832","1004","828","102","1934","3542","0","54.60","28.35"
"65","000","00","070","0010","1803","574","347","227","42","616","1174","0","52.47","29.56"
"65","000","00","070","0010","1804","697","373","324","43","740","1239","0","59.73","30.10"
"65","000","00","070","0010","1805","561","284","277","17","578","1129","0","51.20","25.16"
"65","000","00","070","0011","0000","1343","664","679","65","1408","2734","0","51.50","24.29"
"65","000","00","070","0011","1799","741","373","368","17","758","1535","0","49.38","24.30"
"65","000","00","070","0011","1800","602","291","311","48","650","1199","0","54.21","24.27"
"65","000","00","070","0012","0000","830","449","381","35","865","1452","0","59.57","30.92"
"65","000","00","070","0012","1806","830","449","381","35","865","1452","0","59.57","30.92"
"65","000","00","070","0013","0000","566","306","260","37","603","1022","0","59.00","29.94"
"65","000","00","070","0013","1807","566","306","260","37","603","1022","0","59.00","29.94"
"65","000","00","070","0014","0000","1740","900","840","85","1825","3022","0","60.39","29.78"
"65","000","00","070","0014","1822","843","432","411","53","896","1460","0","61.37","29.59"
"65","000","00","070","0014","1823","897","468","429","32","929","1562","0","59.48","29.96"
"65","000","00","070","0015","0000","1744","995","749","93","1837","3274","0","56.11","30.39"
"65","000","00","070","0015","1812","617","333","284","39","656","1124","0","58.36","29.63"
"65","000","00","070","0015","1813","537","305","232","25","562","996","0","56.43","30.62"
"65","000","00","070","0015","1814","590","357","233","29","619","1154","0","53.64","30.94"
"65","000","00","070","0016","0000","2184","1205","979","120","2304","4192","0","54.96","28.75"
"65","000","00","070","0016","1819","786","459","327","42","828","1397","0","59.27","32.86"
"65","000","00","070","0016","1820","733","395","338","33","766","1490","0","51.41","26.51"
"65","000","00","070","0016","1821","665","351","314","45","710","1305","0","54.41","26.90"
"65","000","00","070","0017","0000","2441","1311","1130","113","2554","4739","0","53.89","27.66"
"65","000","00","070","0017","1809","858","477","381","35","893","1566","0","57.02","30.46"
"65","000","00","070","0017","1810","831","460","371","53","884","1822","0","48.52","25.25"
"65","000","00","070","0017","1811","752","374","378","25","777","1351","0","57.51","27.68"
"65","000","00","070","0018","0000","1462","844","618","90","1552","2745","0","56.54","30.75"
"65","000","00","070","0018","1835","832","465","367","44","876","1520","0","57.63","30.59"
"65","000","00","070","0018","1836","630","379","251","46","676","1225","0","55.18","30.94"
"65","000","00","070","0019","0000","2447","1316","1131","134","2581","5059","0","51.02","26.01"
"65","000","00","070","0019","1831","609","343","266","42","651","1189","0","54.75","28.85"
"65","000","00","070","0019","1832","618","315","303","32","650","1368","0","47.51","23.03"
"65","000","00","070","0019","1833","540","297","243","21","561","1251","0","44.84","23.74"
"65","000","00","070","0019","1834","680","361","319","39","719","1251","0","57.47","28.86"
"65","000","00","070","0020","0000","2341","1249","1092","119","2460","4279","0","57.49","29.19"
"65","000","00","070","0020","1828","986","557","429","49","1035","1743","0","59.38","31.96"
"65","000","00","070","0020","1829","846","456","390","49","895","1590","0","56.29","28.68"
"65","000","00","070","0020","1830","509","236","273","21","530","946","0","56.03","24.95"
"65","000","00","070","0021","0000","834","483","351","65","899","1761","0","51.05","27.43"
"65","000","00","070","0021","1844","834","483","351","65","899","1761","0","51.05","27.43"
"65","000","00","070","0022","0000","679","413","266","45","724","1440","0","50.28","28.68"
"65","000","00","070","0022","1859","679","413","266","45","724","1440","0","50.28","28.68"
"65","000","00","070","0023","0000","836","529","307","67","903","1557","0","58.00","33.98"
"65","000","00","070","0023","1850","836","529","307","67","903","1557","0","58.00","33.98"
"65","000","00","070","0024","0000","6254","3086","3168","173","6427","11883","0","54.09","25.97"
"65","000","00","070","0024","1851","841","450","391","20","861","1575","0","54.67","28.57"
"65","000","00","070","0024","1852","843","441","402","24","867","1561","0","55.54","28.25"
"65","000","00","070","0024","1853","848","409","439","21","869","1430","0","60.77","28.60"
"65","000","00","070","0024","1854","768","358","410","17","785","1450","0","54.14","24.69"
"65","000","00","070","0024","1855","824","388","436","25","849","1499","0","56.64","25.88"
"65","000","00","070","0024","1856","680","320","360","20","700","1337","0","52.36","23.93"
"65","000","00","070","0024","1857","716","355","361","11","727","1490","0","48.79","23.83"
"65","000","00","070","0024","1858","734","365","369","35","769","1541","0","49.90","23.69"
"65","000","00","070","0025","0000","1042","631","411","53","1095","1863","0","58.78","33.87"
"65","000","00","070","0025","1860","508","301","207","19","527","917","0","57.47","32.82"
"65","000","00","070","0025","1861","534","330","204","34","568","946","0","60.04","34.88"
"65","000","00","070","0026","0000","4220","2055","2165","135","4355","7812","0","55.75","26.31"
"65","000","00","070","0026","1845","761","405","356","41","802","1400","0","57.29","28.93"
"65","000","00","070","0026","1846","914","421","493","26","940","1757","0","53.50","23.96"
"65","000","00","070","0026","1847","931","453","478","21","952","1709","0","55.71","26.51"
"65","000","00","070","0026","1848","918","446","472","27","945","1633","0","57.87","27.31"
"65","000","00","070","0026","1849","696","330","366","20","716","1313","0","54.53","25.13"
"65","000","00","070","0027","0000","459","260","199","34","493","814","0","60.57","31.94"
"65","000","00","070","0027","1808","459","260","199","34","493","814","0","60.57","31.94"
"65","000","00","070","0028","0000","1854","1006","848","110","1964","3714","0","52.88","27.09"
"65","000","00","070","0028","1782","638","343","295","50","688","1333","0","51.61","25.73"
"65","000","00","070","0028","1783","683","349","334","31","714","1284","0","55.61","27.18"
"65","000","00","070","0028","1784","533","314","219","29","562","1097","0","51.23","28.62"
"65","000","00","070","0029","0000","1589","853","736","74","1663","3093","0","53.77","27.58"
"65","000","00","070","0029","1796","462","247","215","13","475","950","0","50.00","26.00"
"65","000","00","070","0029","1797","607","331","276","29","636","1113","0","57.14","29.74"
"65","000","00","070","0029","1798","520","275","245","32","552","1030","0","53.59","26.70"
"65","000","00","070","0030","0000","1850","1023","827","82","1932","2989","0","64.64","34.23"
"65","000","00","070","0030","1791","960","537","423","36","996","1545","0","64.47","34.76"
"65","000","00","070","0030","1792","890","486","404","46","936","1444","0","64.82","33.66"
"65","000","00","070","0031","0000","1917","1074","843","78","1995","3465","0","57.58","31.00"
"65","000","00","070","0031","1763","619","355","264","18","637","1076","0","59.20","32.99"
"65","000","00","070","0031","1764","608","357","251","27","635","1199","0","52.96","29.77"
"65","000","00","070","0031","1765","690","362","328","33","723","1190","0","60.76","30.42"
"65","000","00","070","0032","0000","1831","1061","770","109","1940","3794","0","51.13","27.97"
"65","000","00","070","0032","1766","582","333","249","41","623","1178","0","52.89","28.27"
"65","000","00","070","0032","1767","605","352","253","35","640","1298","0","49.31","27.12"
"65","000","00","070","0032","1768","644","376","268","33","677","1318","0","51.37","28.53"
"65","000","00","070","0033","0000","2377","1411","966","143","2520","4939","0","51.02","28.57"
"65","000","00","070","0033","1815","518","306","212","31","549","1040","0","52.79","29.42"
"65","000","00","070","0033","1816","620","341","279","28","648","1361","0","47.61","25.06"
"65","000","00","070","0033","1817","552","326","226","32","584","1134","0","51.50","28.75"
"65","000","00","070","0033","1818","687","438","249","52","739","1404","0","52.64","31.20"
"65","000","00","070","0034","0000","2378","1285","1093","126","2504","4272","0","58.61","30.08"
"65","000","00","070","0034","1772","775","436","339","37","812","1338","0","60.69","32.59"
"65","000","00","070","0034","1773","849","434","415","55","904","1468","0","61.58","29.56"
"65","000","00","070","0034","1774","754","415","339","34","788","1466","0","53.75","28.31"
"65","000","00","070","0035","0000","2622","1479","1143","166","2788","4937","0","56.47","29.96"
"65","000","00","070","0035","1837","595","372","223","48","643","1156","0","55.62","32.18"
"65","000","00","070","0035","1838","796","481","315","51","847","1467","0","57.74","32.79"
"65","000","00","070","0035","1839","670","312","358","41","711","1293","0","54.99","24.13"
"65","000","00","070","0035","1840","561","314","247","26","587","1021","0","57.49","30.75"
"65","000","00","070","0036","0000","2274","1288","986","125","2399","4601","0","52.14","27.99"
"65","000","00","070","0036","1841","754","425","329","33","787","1490","0","52.82","28.52"
"65","000","00","070","0036","1842","714","401","313","48","762","1370","0","55.62","29.27"
"65","000","00","070","0036","1843","806","462","344","44","850","1741","0","48.82","26.54"
"65","000","00","070","0037","0000","1474","835","639","50","1524","2730","0","55.82","30.59"
"65","000","00","070","0037","1801","776","438","338","38","814","1422","0","57.24","30.80"
"65","000","00","070","0037","1802","698","397","301","12","710","1308","0","54.28","30.35"
"65","000","00","070","0038","0000","1370","737","633","71","1441","2895","0","49.78","25.46"
"65","000","00","070","0038","1824","670","372","298","33","703","1443","0","48.72","25.78"
"65","000","00","070","0038","1825","700","365","335","38","738","1452","0","50.83","25.14"
"65","000","00","070","0039","0000","1085","596","489","60","1145","2331","0","49.12","25.57"
"65","000","00","070","0039","1826","579","294","285","45","624","1214","0","51.40","24.22"
"65","000","00","070","0039","1827","506","302","204","15","521","1117","0","46.64","27.04"
"65","000","00","070","0040","0000","1225","697","528","81","1306","2445","0","53.42","28.51"
"65","000","00","070","0040","1785","640","358","282","38","678","1223","0","55.44","29.27"
"65","000","00","070","0040","1786","585","339","246","43","628","1222","0","51.39","27.74"
"65","000","00","070","0041","0000","836","475","361","42","878","1386","0","63.35","34.27"
"65","000","00","070","0041","1787","836","475","361","42","878","1386","0","63.35","34.27"
"65","000","00","070","0042","0000","952","512","440","68","1020","1787","0","57.08","28.65"
"65","000","00","070","0042","1758","341","189","152","35","376","682","0","55.13","27.71"
"65","000","00","070","0042","1759","611","323","288","33","644","1105","0","58.28","29.23"
"65","000","00","080","0000","0000","38505","20828","17677","2219","40724","72680","88251","56.03","28.66"
"65","000","00","080","0001","0000","574","321","253","25","599","905","0","66.19","35.47"
"65","000","00","080","0001","1863","574","321","253","25","599","905","0","66.19","35.47"
"65","000","00","080","0002","0000","1112","588","524","63","1175","1926","0","61.01","30.53"
"65","000","00","080","0002","1867","553","283","270","31","584","944","0","61.86","29.98"
"65","000","00","080","0002","1868","559","305","254","32","591","982","0","60.18","31.06"
"65","000","00","080","0003","0000","2606","1415","1191","127","2733","4780","0","57.18","29.60"
"65","000","00","080","0003","1870","963","538","425","32","995","1689","0","58.91","31.85"
"65","000","00","080","0003","1871","834","447","387","46","880","1542","0","57.07","28.99"
"65","000","00","080","0003","1872","809","430","379","49","858","1549","0","55.39","27.76"
"65","000","00","080","0004","0000","1896","986","910","78","1974","3706","0","53.26","26.61"
"65","000","00","080","0004","1864","545","284","261","26","571","920","0","62.07","30.87"
"65","000","00","080","0004","1865","627","330","297","17","644","1436","0","44.85","22.98"
"65","000","00","080","0004","1866","724","372","352","35","759","1350","0","56.22","27.56"
"65","000","00","080","0005","0000","511","294","217","38","549","870","0","63.10","33.79"
"65","000","00","080","0005","1869","511","294","217","38","549","870","0","63.10","33.79"
"65","000","00","080","0006","0000","299","162","137","26","325","493","0","65.92","32.86"
"65","000","00","080","0006","1862","299","162","137","26","325","493","0","65.92","32.86"
"65","000","00","080","0007","0000","796","447","349","42","838","1359","0","61.66","32.89"
"65","000","00","080","0007","1891","796","447","349","42","838","1359","0","61.66","32.89"
"65","000","00","080","0008","0000","3556","1926","1630","203","3759","7004","0","53.67","27.50"
"65","000","00","080","0008","1892","623","350","273","29","652","1218","0","53.53","28.74"
"65","000","00","080","0008","1893","668","341","327","37","705","1270","0","55.51","26.85"
"65","000","00","080","0008","1894","571","322","249","48","619","1178","0","52.55","27.33"
"65","000","00","080","0008","1895","584","285","299","23","607","1297","0","46.80","21.97"
"65","000","00","080","0008","1896","558","307","251","29","587","997","0","58.88","30.79"
"65","000","00","080","0008","1897","552","321","231","37","589","1044","0","56.42","30.75"
"65","000","00","080","0009","0000","1602","907","695","109","1711","2994","0","57.15","30.29"
"65","000","00","080","0009","1888","453","233","220","25","478","830","0","57.59","28.07"
"65","000","00","080","0009","1889","694","408","286","64","758","1251","0","60.59","32.61"
"65","000","00","080","0009","1890","455","266","189","20","475","913","0","52.03","29.13"
"65","000","00","080","0010","0000","3900","2153","1747","189","4089","7669","0","53.32","28.07"
"65","000","00","080","0010","1883","924","488","436","35","959","1676","0","57.22","29.12"
"65","000","00","080","0010","1884","878","456","422","40","918","1676","0","54.77","27.21"
"65","000","00","080","0010","1885","729","419","310","23","752","1506","0","49.93","27.82"
"65","000","00","080","0010","1886","627","339","288","48","675","1223","0","55.19","27.72"
"65","000","00","080","0010","1887","742","451","291","43","785","1588","0","49.43","28.40"
"65","000","00","080","0011","0000","3822","2059","1763","215","4037","7186","0","56.18","28.65"
"65","000","00","080","0011","1878","840","478","362","46","886","1696","0","52.24","28.18"
"65","000","00","080","0011","1879","835","393","442","30","865","1463","0","59.13","26.86"
"65","000","00","080","0011","1880","668","366","302","14","682","1267","0","53.83","28.89"
"65","000","00","080","0011","1881","622","351","271","29","651","1240","0","52.50","28.31"
"65","000","00","080","0011","1882","857","471","386","96","953","1520","0","62.70","30.99"
"65","000","00","080","0012","0000","464","273","191","49","513","830","0","61.81","32.89"
"65","000","00","080","0012","1877","464","273","191","49","513","830","0","61.81","32.89"
"65","000","00","080","0013","0000","159","85","74","14","173","240","0","72.08","35.42"
"65","000","00","080","0013","1917","159","85","74","14","173","240","0","72.08","35.42"
"65","000","00","080","0014","0000","2467","1235","1232","165","2632","4330","0","60.79","28.52"
"65","000","00","080","0014","1910","787","417","370","64","851","1421","0","59.89","29.35"
"65","000","00","080","0014","1911","953","473","480","57","1010","1627","0","62.08","29.07"
"65","000","00","080","0014","1912","727","345","382","44","771","1282","0","60.14","26.91"
"65","000","00","080","0015","0000","2602","1449","1153","140","2742","5601","0","48.96","25.87"
"65","000","00","080","0015","1904","707","399","308","49","756","1386","0","54.55","28.79"
"65","000","00","080","0015","1905","927","506","421","38","965","2060","0","46.84","24.56"
"65","000","00","080","0015","1906","968","544","424","53","1021","2155","0","47.38","25.24"
"65","000","00","080","0016","0000","2128","1156","972","104","2232","4085","0","54.64","28.30"
"65","000","00","080","0016","1907","776","396","380","42","818","1422","0","57.52","27.85"
"65","000","00","080","0016","1908","760","435","325","27","787","1413","0","55.70","30.79"
"65","000","00","080","0016","1909","592","325","267","35","627","1250","0","50.16","26.00"
"65","000","00","080","0017","0000","2335","1224","1111","169","2504","4084","0","61.31","29.97"
"65","000","00","080","0017","1898","807","439","368","51","858","1437","0","59.71","30.55"
"65","000","00","080","0017","1899","822","421","401","51","873","1449","0","60.25","29.05"
"65","000","00","080","0017","1900","706","364","342","67","773","1198","0","64.52","30.38"
"65","000","00","080","0018","0000","2601","1379","1222","184","2785","4891","0","56.94","28.19"
"65","000","00","080","0018","1913","742","395","347","64","806","1281","0","62.92","30.84"
"65","000","00","080","0018","1914","683","400","283","51","734","1221","0","60.11","32.76"
"65","000","00","080","0018","1915","670","312","358","52","722","1262","0","57.21","24.72"
"65","000","00","080","0018","1916","506","272","234","17","523","1127","0","46.41","24.13"
"65","000","00","080","0019","0000","1811","1039","772","129","1940","3750","0","51.73","27.71"
"65","000","00","080","0019","1901","745","430","315","61","806","1470","0","54.83","29.25"
"65","000","00","080","0019","1902","573","318","255","29","602","1122","0","53.65","28.34"
"65","000","00","080","0019","1903","493","291","202","39","532","1158","0","45.94","25.13"
"65","000","00","080","0020","0000","3264","1730","1534","150","3414","5977","0","57.12","28.94"
"65","000","00","080","0020","1873","848","443","405","45","893","1549","0","57.65","28.60"
"65","000","00","080","0020","1874","811","432","379","39","850","1455","0","58.42","29.69"
"65","000","00","080","0020","1875","746","419","327","33","779","1443","0","53.98","29.04"
"65","000","00","080","0020","1876","859","436","423","33","892","1530","0","58.30","28.50"
"65","000","00","090","0000","0000","46210","24318","21892","2597","48807","93306","115122","52.31","26.06"
"65","000","00","090","0001","0000","171","102","69","9","180","259","0","69.50","39.38"
"65","000","00","090","0001","2065","171","102","69","9","180","259","0","69.50","39.38"
"65","000","00","090","0002","0000","305","182","123","18","323","535","0","60.37","34.02"
"65","000","00","090","0002","2066","305","182","123","18","323","535","0","60.37","34.02"
"65","000","00","090","0003","0000","1661","926","735","98","1759","3439","0","51.15","26.93"
"65","000","00","090","0003","2067","491","271","220","24","515","960","0","53.65","28.23"
"65","000","00","090","0003","2068","573","309","264","41","614","1184","0","51.86","26.10"
"65","000","00","090","0003","2069","597","346","251","33","630","1295","0","48.65","26.72"
"65","000","00","090","0004","0000","1572","775","797","78","1650","2952","0","55.89","26.25"
"65","000","00","090","0004","2070","758","376","382","37","795","1441","0","55.17","26.09"
"65","000","00","090","0004","2071","814","399","415","41","855","1511","0","56.59","26.41"
"65","000","00","090","0005","0000","473","302","171","27","500","975","0","51.28","30.97"
"65","000","00","090","0005","2072","473","302","171","27","500","975","0","51.28","30.97"
"65","000","00","090","0006","0000","3004","1624","1380","127","3131","6262","0","50.00","25.93"
"65","000","00","090","0006","2073","633","345","288","22","655","1291","0","50.74","26.72"
"65","000","00","090","0006","2074","499","289","210","14","513","1057","0","48.53","27.34"
"65","000","00","090","0006","2075","581","299","282","28","609","1272","0","47.88","23.51"
"65","000","00","090","0006","2076","554","313","241","30","584","1171","0","49.87","26.73"
"65","000","00","090","0006","2077","737","378","359","33","770","1471","0","52.35","25.70"
"65","000","00","090","0007","0000","2579","1332","1247","121","2700","5227","0","51.65","25.48"
"65","000","00","090","0007","2101","719","382","337","49","768","1413","0","54.35","27.03"
"65","000","00","090","0007","2102","567","288","279","32","599","1180","0","50.76","24.41"
"65","000","00","090","0007","2103","617","308","309","17","634","1221","0","51.92","25.23"
"65","000","00","090","0007","2104","676","354","322","23","699","1413","0","49.47","25.05"
"65","000","00","090","0008","0000","3707","1928","1779","177","3884","8557","0","45.39","22.53"
"65","000","00","090","0008","2078","625","336","289","26","651","1403","0","46.40","23.95"
"65","000","00","090","0008","2079","549","296","253","24","573","1259","0","45.51","23.51"
"65","000","00","090","0008","2080","628","297","331","35","663","1400","0","47.36","21.21"
"65","000","00","090","0008","2081","647","339","308","32","679","1515","0","44.82","22.38"
"65","000","00","090","0008","2082","569","317","252","28","597","1404","0","42.52","22.58"
"65","000","00","090","0008","2083","689","343","346","32","721","1576","0","45.75","21.76"
"65","000","00","090","0009","0000","4105","2141","1964","209","4314","8387","0","51.44","25.53"
"65","000","00","090","0009","2084","670","392","278","51","721","1499","0","48.10","26.15"
"65","000","00","090","0009","2085","893","467","426","47","940","1952","0","48.16","23.92"
"65","000","00","090","0009","2086","884","467","417","40","924","1773","0","52.12","26.34"
"65","000","00","090","0009","2087","774","377","397","33","807","1489","0","54.20","25.32"
"65","000","00","090","0009","2088","884","438","446","38","922","1674","0","55.08","26.16"
"65","000","00","090","0010","0000","1937","988","949","129","2066","3512","0","58.83","28.13"
"65","000","00","090","0010","2116","589","317","272","37","626","1105","0","56.65","28.69"
"65","000","00","090","0010","2117","627","355","272","58","685","1114","0","61.49","31.87"
"65","000","00","090","0010","2118","721","316","405","34","755","1293","0","58.39","24.44"
"65","000","00","090","0011","0000","959","541","418","103","1062","2016","0","52.68","26.84"
"65","000","00","090","0011","2119","493","287","206","65","558","1051","0","53.09","27.31"
"65","000","00","090","0011","2120","466","254","212","38","504","965","0","52.23","26.32"
"65","000","00","090","0012","0000","548","335","213","68","616","996","0","61.85","33.63"
"65","000","00","090","0012","2121","548","335","213","68","616","996","0","61.85","33.63"
"65","000","00","090","0013","0000","219","137","82","29","248","454","0","54.63","30.18"
"65","000","00","090","0013","2122","219","137","82","29","248","454","0","54.63","30.18"
"65","000","00","090","0014","0000","414","225","189","51","465","753","0","61.75","29.88"
"65","000","00","090","0014","2123","414","225","189","51","465","753","0","61.75","29.88"
"65","000","00","090","0015","0000","352","221","131","77","429","607","0","70.68","36.41"
"65","000","00","090","0015","2124","352","221","131","77","429","607","0","70.68","36.41"
"65","000","00","090","0016","0000","336","205","131","28","364","648","0","56.17","31.64"
"65","000","00","090","0016","2125","336","205","131","28","364","648","0","56.17","31.64"
"65","000","00","090","0017","0000","1142","603","539","89","1231","1992","0","61.80","30.27"
"65","000","00","090","0017","2129","382","198","184","16","398","710","0","56.06","27.89"
"65","000","00","090","0017","2130","760","405","355","73","833","1282","0","64.98","31.59"
"65","000","00","090","0018","0000","741","445","296","69","810","1302","0","62.21","34.18"
"65","000","00","090","0018","2128","741","445","296","69","810","1302","0","62.21","34.18"
"65","000","00","090","0019","0000","1175","649","526","114","1289","2613","0","49.33","24.84"
"65","000","00","090","0019","2131","588","332","256","48","636","1342","0","47.39","24.74"
"65","000","00","090","0019","2132","587","317","270","66","653","1271","0","51.38","24.94"
"65","000","00","090","0020","0000","529","289","240","44","573","816","0","70.22","35.42"
"65","000","00","090","0020","2133","529","289","240","44","573","816","0","70.22","35.42"
"65","000","00","090","0021","0000","645","407","238","79","724","1248","0","58.01","32.61"
"65","000","00","090","0021","2136","645","407","238","79","724","1248","0","58.01","32.61"
"65","000","00","090","0022","0000","806","493","313","91","897","1797","0","49.92","27.43"
"65","000","00","090","0022","2134","301","199","102","46","347","703","0","49.36","28.31"
"65","000","00","090","0022","2135","505","294","211","45","550","1094","0","50.27","26.87"
"65","000","00","090","0023","0000","2542","1461","1081","109","2651","5937","0","44.65","24.61"
"65","000","00","090","0023","2109","649","372","277","36","685","1427","0","48.00","26.07"
"65","000","00","090","0023","2110","652","374","278","33","685","1418","0","48.31","26.38"
"65","000","00","090","0023","2111","744","436","308","17","761","1604","0","47.44","27.18"
"65","000","00","090","0023","2112","497","279","218","23","520","1488","0","34.95","18.75"
"65","000","00","090","0024","0000","3110","1561","1549","134","3244","6409","0","50.62","24.36"
"65","000","00","090","0024","2105","748","383","365","33","781","1547","0","50.48","24.76"
"65","000","00","090","0024","2106","776","415","361","36","812","1685","0","48.19","24.63"
"65","000","00","090","0024","2107","717","339","378","36","753","1511","0","49.83","22.44"
"65","000","00","090","0024","2108","869","424","445","29","898","1666","0","53.90","25.45"
"65","000","00","090","0025","0000","2024","1092","932","158","2182","4516","0","48.32","24.18"
"65","000","00","090","0025","2113","699","372","327","47","746","1488","0","50.13","25.00"
"65","000","00","090","0025","2114","665","341","324","37","702","1544","0","45.47","22.09"
"65","000","00","090","0025","2115","660","379","281","74","734","1484","0","49.46","25.54"
"65","000","00","090","0026","0000","1818","915","903","105","1923","3135","0","61.34","29.19"
"65","000","00","090","0026","2126","927","441","486","55","982","1573","0","62.43","28.04"
"65","000","00","090","0026","2127","891","474","417","50","941","1562","0","60.24","30.35"
"65","000","00","090","0027","0000","6450","3056","3394","168","6618","12129","0","54.56","25.20"
"65","000","00","090","0027","2093","766","387","379","32","798","1538","0","51.89","25.16"
"65","000","00","090","0027","2094","708","365","343","29","737","1465","0","50.31","24.91"
"65","000","00","090","0027","2095","889","405","484","18","907","1707","0","53.13","23.73"
"65","000","00","090","0027","2096","920","451","469","19","939","1558","0","60.27","28.95"
"65","000","00","090","0027","2097","782","377","405","11","793","1512","0","52.45","24.93"
"65","000","00","090","0027","2098","818","383","435","19","837","1498","0","55.87","25.57"
"65","000","00","090","0027","2099","794","328","466","17","811","1433","0","56.59","22.89"
"65","000","00","090","0027","2100","773","360","413","23","796","1418","0","56.14","25.39"
"65","000","00","090","0028","0000","2886","1383","1503","88","2974","5833","0","50.99","23.71"
"65","000","00","090","0028","2089","734","352","382","19","753","1542","0","48.83","22.83"
"65","000","00","090","0028","2090","827","394","433","23","850","1552","0","54.77","25.39"
"65","000","00","090","0028","2091","706","335","371","17","723","1365","0","52.97","24.54"
"65","000","00","090","0028","2092","619","302","317","29","648","1374","0","47.16","21.98"
"65","000","00","100","0000","0000","78431","39638","38793","3789","82220","156864","186371","52.41","25.27"
"65","000","00","100","0001","0000","312","177","135","50","362","521","0","69.48","33.97"
"65","000","00","100","0001","0032","312","177","135","50","362","521","0","69.48","33.97"
"65","000","00","100","0002","0000","679","363","316","57","736","963","0","76.43","37.69"
"65","000","00","100","0002","0033","679","363","316","57","736","963","0","76.43","37.69"
"65","000","00","100","0003","0000","634","318","316","59","693","1403","0","49.39","22.67"
"65","000","00","100","0003","0034","634","318","316","59","693","1403","0","49.39","22.67"
"65","000","00","100","0004","0000","676","379","297","76","752","1425","0","52.77","26.60"
"65","000","00","100","0004","0035","676","379","297","76","752","1425","0","52.77","26.60"
"65","000","00","100","0005","0000","537","266","271","57","594","988","0","60.12","26.92"
"65","000","00","100","0005","0036","537","266","271","57","594","988","0","60.12","26.92"
"65","000","00","100","0006","0000","1169","590","579","98","1267","2278","0","55.62","25.90"
"65","000","00","100","0006","0038","633","329","304","57","690","1214","0","56.84","27.10"
"65","000","00","100","0006","0039","536","261","275","41","577","1064","0","54.23","24.53"
"65","000","00","100","0007","0000","440","222","218","49","489","766","0","63.84","28.98"
"65","000","00","100","0007","0037","440","222","218","49","489","766","0","63.84","28.98"
"65","000","00","100","0008","0000","8516","4146","4370","261","8777","19221","0","45.66","21.57"
"65","000","00","100","0008","0072","607","303","304","15","622","1173","0","53.03","25.83"
"65","000","00","100","0008","0073","612","273","339","24","636","1277","0","49.80","21.38"
"65","000","00","100","0008","0074","771","346","425","27","798","2291","0","34.83","15.10"
"65","000","00","100","0008","0075","866","408","458","24","890","1748","0","50.92","23.34"
"65","000","00","100","0008","0076","630","326","304","25","655","1376","0","47.60","23.69"
"65","000","00","100","0008","0077","633","306","327","36","669","1273","0","52.55","24.04"
"65","000","00","100","0008","0078","694","352","342","14","708","1427","0","49.61","24.67"
"65","000","00","100","0008","0079","863","406","457","26","889","2285","0","38.91","17.77"
"65","000","00","100","0008","0080","697","338","359","19","716","1541","0","46.46","21.93"
"65","000","00","100","0008","0081","843","428","415","27","870","1809","0","48.09","23.66"
"65","000","00","100","0008","0082","622","317","305","13","635","1408","0","45.10","22.51"
"65","000","00","100","0008","0083","678","343","335","11","689","1613","0","42.72","21.26"
"65","000","00","100","0009","0000","836","416","420","79","915","1637","0","55.89","25.41"
"65","000","00","100","0009","0084","836","416","420","79","915","1637","0","55.89","25.41"
"65","000","00","100","0010","0000","2972","1521","1451","108","3080","6376","0","48.31","23.86"
"65","000","00","100","0010","0094","811","410","401","30","841","1688","0","49.82","24.29"
"65","000","00","100","0010","0095","779","370","409","30","809","1642","0","49.27","22.53"
"65","000","00","100","0010","0096","749","392","357","26","775","1543","0","50.23","25.41"
"65","000","00","100","0010","0097","633","349","284","22","655","1503","0","43.58","23.22"
"65","000","00","100","0011","0000","2677","1373","1304","180","2857","4924","0","58.02","27.88"
"65","000","00","100","0011","0085","672","367","305","40","712","1196","0","59.53","30.69"
"65","000","00","100","0011","0086","748","348","400","48","796","1292","0","61.61","26.93"
"65","000","00","100","0011","0087","632","335","297","46","678","1216","0","55.76","27.55"
"65","000","00","100","0011","0088","625","323","302","46","671","1220","0","55.00","26.48"
"65","000","00","100","0012","0000","4634","2261","2373","160","4794","8934","0","53.66","25.31"
"65","000","00","100","0012","0110","772","373","399","30","802","1468","0","54.63","25.41"
"65","000","00","100","0012","0111","764","383","381","21","785","1450","0","54.14","26.41"
"65","000","00","100","0012","0112","732","366","366","20","752","1449","0","51.90","25.26"
"65","000","00","100","0012","0113","820","402","418","33","853","1517","0","56.23","26.50"
"65","000","00","100","0012","0114","729","341","388","33","762","1483","0","51.38","22.99"
"65","000","00","100","0012","0115","817","396","421","23","840","1567","0","53.61","25.27"
"65","000","00","100","0013","0000","1059","609","450","81","1140","1881","0","60.61","32.38"
"65","000","00","100","0013","0040","525","301","224","39","564","933","0","60.45","32.26"
"65","000","00","100","0013","0041","534","308","226","42","576","948","0","60.76","32.49"
"65","000","00","100","0014","0000","570","310","260","47","617","1020","0","60.49","30.39"
"65","000","00","100","0014","0042","570","310","260","47","617","1020","0","60.49","30.39"
"65","000","00","100","0015","0000","746","383","363","62","808","1369","0","59.02","27.98"
"65","000","00","100","0015","0043","746","383","363","62","808","1369","0","59.02","27.98"
"65","000","00","100","0016","0000","674","377","297","52","726","1203","0","60.35","31.34"
"65","000","00","100","0016","0044","674","377","297","52","726","1203","0","60.35","31.34"
"65","000","00","100","0017","0000","3314","1662","1652","99","3413","6094","0","56.01","27.27"
"65","000","00","100","0017","0045","634","312","322","17","651","1200","0","54.25","26.00"
"65","000","00","100","0017","0046","830","440","390","24","854","1441","0","59.26","30.53"
"65","000","00","100","0017","0047","584","277","307","16","600","1132","0","53.00","24.47"
"65","000","00","100","0017","0048","658","308","350","15","673","1191","0","56.51","25.86"
"65","000","00","100","0017","0049","608","325","283","27","635","1130","0","56.19","28.76"
"65","000","00","100","0018","0000","2793","1408","1385","149","2942","5360","0","54.89","26.27"
"65","000","00","100","0018","0050","690","357","333","54","744","1384","0","53.76","25.79"
"65","000","00","100","0018","0051","676","311","365","29","705","1197","0","58.90","25.98"
"65","000","00","100","0018","0052","691","368","323","29","720","1332","0","54.05","27.63"
"65","000","00","100","0018","0053","736","372","364","37","773","1447","0","53.42","25.71"
"65","000","00","100","0019","0000","3232","1656","1576","169","3401","6346","0","53.59","26.10"
"65","000","00","100","0019","0057","806","412","394","53","859","1594","0","53.89","25.85"
"65","000","00","100","0019","0058","834","378","456","20","854","1804","0","47.34","20.95"
"65","000","00","100","0019","0059","778","425","353","38","816","1420","0","57.46","29.93"
"65","000","00","100","0019","0060","814","441","373","58","872","1528","0","57.07","28.86"
"65","000","00","100","0020","0000","2863","1409","1454","91","2954","5986","0","49.35","23.54"
"65","000","00","100","0020","0061","636","322","314","22","658","1402","0","46.93","22.97"
"65","000","00","100","0020","0062","642","314","328","19","661","1466","0","45.09","21.42"
"65","000","00","100","0020","0063","739","352","387","16","755","1568","0","48.15","22.45"
"65","000","00","100","0020","0064","846","421","425","34","880","1550","0","56.77","27.16"
"65","000","00","100","0021","0000","4657","2270","2387","129","4786","9667","0","49.51","23.48"
"65","000","00","100","0021","0065","555","255","300","16","571","1082","0","52.77","23.57"
"65","000","00","100","0021","0066","729","360","369","22","751","1558","0","48.20","23.11"
"65","000","00","100","0021","0067","736","397","339","25","761","1470","0","51.77","27.01"
"65","000","00","100","0021","0068","753","361","392","24","777","1429","0","54.37","25.26"
"65","000","00","100","0021","0069","611","274","337","9","620","1417","0","43.75","19.34"
"65","000","00","100","0021","0070","748","373","375","20","768","1542","0","49.81","24.19"
"65","000","00","100","0021","0071","525","250","275","13","538","1169","0","46.02","21.39"
"65","000","00","100","0022","0000","2677","1370","1307","83","2760","5289","0","52.18","25.90"
"65","000","00","100","0022","0116","651","337","314","21","672","1314","0","51.14","25.65"
"65","000","00","100","0022","0117","678","336","342","18","696","1347","0","51.67","24.94"
"65","000","00","100","0022","0118","691","345","346","22","713","1308","0","54.51","26.38"
"65","000","00","100","0022","0119","657","352","305","22","679","1320","0","51.44","26.67"
"65","000","00","100","0023","0000","1686","901","785","132","1818","3482","0","52.21","25.88"
"65","000","00","100","0023","0126","557","306","251","56","613","1242","0","49.36","24.64"
"65","000","00","100","0023","0127","556","298","258","25","581","1209","0","48.06","24.65"
"65","000","00","100","0023","0128","573","297","276","51","624","1031","0","60.52","28.81"
"65","000","00","100","0024","0000","746","432","314","69","815","1276","0","63.87","33.86"
"65","000","00","100","0024","0129","746","432","314","69","815","1276","0","63.87","33.86"
"65","000","00","100","0025","0000","586","352","234","57","643","1011","0","63.60","34.82"
"65","000","00","100","0025","0130","586","352","234","57","643","1011","0","63.60","34.82"
"65","000","00","100","0026","0000","369","210","159","22","391","647","0","60.43","32.46"
"65","000","00","100","0026","0131","369","210","159","22","391","647","0","60.43","32.46"
"65","000","00","100","0027","0000","671","372","299","31","702","1275","0","55.06","29.18"
"65","000","00","100","0027","0132","671","372","299","31","702","1275","0","55.06","29.18"
"65","000","00","100","0028","0000","454","242","212","24","478","770","0","62.08","31.43"
"65","000","00","100","0028","0133","454","242","212","24","478","770","0","62.08","31.43"
"65","000","00","100","0029","0000","352","205","147","18","370","584","0","63.36","35.10"
"65","000","00","100","0029","0134","352","205","147","18","370","584","0","63.36","35.10"
"65","000","00","100","0030","0000","241","130","111","14","255","389","0","65.55","33.42"
"65","000","00","100","0030","0135","241","130","111","14","255","389","0","65.55","33.42"
"65","000","00","100","0031","0000","802","391","411","42","844","1508","0","55.97","25.93"
"65","000","00","100","0031","0136","802","391","411","42","844","1508","0","55.97","25.93"
"65","000","00","100","0032","0000","2337","1164","1173","130","2467","4735","0","52.10","24.58"
"65","000","00","100","0032","0137","743","346","397","39","782","1566","0","49.94","22.09"
"65","000","00","100","0032","0138","865","436","429","62","927","1623","0","57.12","26.86"
"65","000","00","100","0032","0139","729","382","347","29","758","1546","0","49.03","24.71"
"65","000","00","100","0033","0000","2086","1009","1077","111","2197","4169","0","52.70","24.20"
"65","000","00","100","0033","0140","723","345","378","45","768","1376","0","55.81","25.07"
"65","000","00","100","0033","0141","654","351","303","51","705","1327","0","53.13","26.45"
"65","000","00","100","0033","0142","709","313","396","15","724","1466","0","49.39","21.35"
"65","000","00","100","0034","0000","1784","954","830","126","1910","3580","0","53.35","26.65"
"65","000","00","100","0034","0098","594","302","292","47","641","1170","0","54.79","25.81"
"65","000","00","100","0034","0099","510","279","231","37","547","1114","0","49.10","25.04"
"65","000","00","100","0034","0100","680","373","307","42","722","1296","0","55.71","28.78"
"65","000","00","100","0035","0000","3885","1964","1921","145","4030","8036","0","50.15","24.44"
"65","000","00","100","0035","0101","631","345","286","31","662","1298","0","51.00","26.58"
"65","000","00","100","0035","0102","689","352","337","18","707","1427","0","49.54","24.67"
"65","000","00","100","0035","0103","618","307","311","17","635","1331","0","47.71","23.07"
"65","000","00","100","0035","0104","693","335","358","23","716","1442","0","49.65","23.23"
"65","000","00","100","0035","0105","622","308","314","36","658","1305","0","50.42","23.60"
"65","000","00","100","0035","0106","632","317","315","20","652","1233","0","52.88","25.71"
"65","000","00","100","0036","0000","2057","1080","977","82","2139","4120","0","51.92","26.21"
"65","000","00","100","0036","0107","722","420","302","18","740","1369","0","54.05","30.68"
"65","000","00","100","0036","0108","621","318","303","37","658","1377","0","47.79","23.09"
"65","000","00","100","0036","0109","714","342","372","27","741","1374","0","53.93","24.89"
"65","000","00","100","0037","0000","2046","925","1121","91","2137","4057","0","52.67","22.80"
"65","000","00","100","0037","0091","739","328","411","27","766","1357","0","56.45","24.17"
"65","000","00","100","0037","0092","626","299","327","29","655","1288","0","50.85","23.21"
"65","000","00","100","0037","0093","681","298","383","35","716","1412","0","50.71","21.10"
"65","000","00","100","0038","0000","1113","556","557","32","1145","2483","0","46.11","22.39"
"65","000","00","100","0038","0089","614","313","301","15","629","1280","0","49.14","24.45"
"65","000","00","100","0038","0090","499","243","256","17","516","1203","0","42.89","20.20"
"65","000","00","100","0039","0000","2271","1202","1069","103","2374","4134","0","57.43","29.08"
"65","000","00","100","0039","0054","660","373","287","44","704","1241","0","56.73","30.06"
"65","000","00","100","0039","0055","851","441","410","24","875","1445","0","60.55","30.52"
"65","000","00","100","0039","0056","760","388","372","35","795","1448","0","54.90","26.80"
"65","000","00","100","0040","0000","1608","863","745","113","1721","3305","0","52.07","26.11"
"65","000","00","100","0040","0120","454","240","214","34","488","979","0","49.85","24.51"
"65","000","00","100","0040","0121","610","320","290","32","642","1238","0","51.86","25.85"
"65","000","00","100","0040","0122","544","303","241","47","591","1088","0","54.32","27.85"
"65","000","00","100","0041","0000","1958","1000","958","88","2046","4138","0","49.44","24.17"
"65","000","00","100","0041","0123","623","310","313","37","660","1326","0","49.77","23.38"
"65","000","00","100","0041","0124","759","398","361","37","796","1490","0","53.42","26.71"
"65","000","00","100","0041","0125","576","292","284","14","590","1322","0","44.63","22.09"
"65","000","00","100","0042","0000","4712","2200","2512","163","4875","9514","0","51.24","23.12"
"65","000","00","100","0042","0143","694","344","350","29","723","1325","0","54.57","25.96"
"65","000","00","100","0042","0144","765","364","401","29","794","1460","0","54.38","24.93"
"65","000","00","100","0042","0145","969","510","459","43","1012","2141","0","47.27","23.82"
"65","000","00","100","0042","0146","801","390","411","18","819","1695","0","48.32","23.01"
"65","000","00","100","0042","0147","897","352","545","24","921","1830","0","50.33","19.23"
"65","000","00","100","0042","0148","586","240","346","20","606","1063","0","57.01","22.58"
"65","000","00","110","0000","0000","88565","45040","43525","4097","92662","176337","205353","52.55","25.54"
"65","000","00","110","0001","0000","631","342","289","41","672","1177","0","57.09","29.06"
"65","000","00","110","0001","2539","631","342","289","41","672","1177","0","57.09","29.06"
"65","000","00","110","0002","0000","569","325","244","31","600","978","0","61.35","33.23"
"65","000","00","110","0002","2540","569","325","244","31","600","978","0","61.35","33.23"
"65","000","00","110","0003","0000","2013","958","1055","72","2085","4090","0","50.98","23.42"
"65","000","00","110","0003","2541","660","305","355","26","686","1337","0","51.31","22.81"
"65","000","00","110","0003","2542","687","322","365","26","713","1328","0","53.69","24.25"
"65","000","00","110","0003","2543","666","331","335","20","686","1425","0","48.14","23.23"
"65","000","00","110","0004","0000","177","113","64","15","192","315","0","60.95","35.87"
"65","000","00","110","0004","2546","177","113","64","15","192","315","0","60.95","35.87"
"65","000","00","110","0005","0000","1602","826","776","87","1689","3113","0","54.26","26.53"
"65","000","00","110","0005","2582","788","416","372","41","829","1528","0","54.25","27.23"
"65","000","00","110","0005","2583","814","410","404","46","860","1585","0","54.26","25.87"
"65","000","00","110","0006","0000","1628","901","727","89","1717","4714","0","36.42","19.11"
"65","000","00","110","0006","2554","315","183","132","17","332","1834","0","18.10","9.98"
"65","000","00","110","0006","2555","705","380","325","34","739","1522","0","48.55","24.97"
"65","000","00","110","0006","2556","608","338","270","38","646","1358","0","47.57","24.89"
"65","000","00","110","0007","0000","2245","1210","1035","111","2356","4665","0","50.50","25.94"
"65","000","00","110","0007","2547","773","414","359","47","820","1564","0","52.43","26.47"
"65","000","00","110","0007","2548","759","409","350","30","789","1580","0","49.94","25.89"
"65","000","00","110","0007","2549","713","387","326","34","747","1521","0","49.11","25.44"
"65","000","00","110","0008","0000","3364","1731","1633","129","3493","6064","0","57.60","28.55"
"65","000","00","110","0008","2560","826","427","399","50","876","1577","0","55.55","27.08"
"65","000","00","110","0008","2561","860","415","445","24","884","1514","0","58.39","27.41"
"65","000","00","110","0008","2562","759","412","347","31","790","1428","0","55.32","28.85"
"65","000","00","110","0008","2563","919","477","442","24","943","1545","0","61.04","30.87"
"65","000","00","110","0009","0000","1981","1045","936","126","2107","3864","0","54.53","27.04"
"65","000","00","110","0009","2573","701","371","330","50","751","1291","0","58.17","28.74"
"65","000","00","110","0009","2574","665","361","304","43","708","1359","0","52.10","26.56"
"65","000","00","110","0009","2575","615","313","302","33","648","1214","0","53.38","25.78"
"65","000","00","110","0010","0000","776","419","357","40","816","1449","0","56.31","28.92"
"65","000","00","110","0010","2587","776","419","357","40","816","1449","0","56.31","28.92"
"65","000","00","110","0011","0000","712","357","355","45","757","1483","0","51.05","24.07"
"65","000","00","110","0011","2588","712","357","355","45","757","1483","0","51.05","24.07"
"65","000","00","110","0012","0000","2027","1041","986","103","2130","4111","0","51.81","25.32"
"65","000","00","110","0012","2590","633","333","300","52","685","1273","0","53.81","26.16"
"65","000","00","110","0012","2591","753","365","388","27","780","1596","0","48.87","22.87"
"65","000","00","110","0012","2592","641","343","298","24","665","1242","0","53.54","27.62"
"65","000","00","110","0013","0000","1204","651","553","113","1317","2054","0","64.12","31.69"
"65","000","00","110","0013","2595","738","404","334","98","836","1279","0","65.36","31.59"
"65","000","00","110","0013","2596","466","247","219","15","481","775","0","62.06","31.87"
"65","000","00","110","0014","0000","2658","1378","1280","166","2824","5347","0","52.81","25.77"
"65","000","00","110","0014","2597","622","310","312","64","686","1223","0","56.09","25.35"
"65","000","00","110","0014","2598","623","330","293","33","656","1297","0","50.58","25.44"
"65","000","00","110","0014","2599","731","376","355","24","755","1562","0","48.34","24.07"
"65","000","00","110","0014","2600","682","362","320","45","727","1265","0","57.47","28.62"
"65","000","00","110","0015","0000","2141","1130","1011","108","2249","4557","0","49.35","24.80"
"65","000","00","110","0015","2601","632","331","301","41","673","1438","0","46.80","23.02"
"65","000","00","110","0015","2602","750","405","345","44","794","1491","0","53.25","27.16"
"65","000","00","110","0015","2603","759","394","365","23","782","1628","0","48.03","24.20"
"65","000","00","110","0016","0000","767","385","382","46","813","1414","0","57.50","27.23"
"65","000","00","110","0016","2604","767","385","382","46","813","1414","0","57.50","27.23"
"65","000","00","110","0017","0000","557","305","252","41","598","916","0","65.28","33.30"
"65","000","00","110","0017","2605","557","305","252","41","598","916","0","65.28","33.30"
"65","000","00","110","0018","0000","1030","597","433","83","1113","1960","0","56.79","30.46"
"65","000","00","110","0018","2613","1030","597","433","83","1113","1960","0","56.79","30.46"
"65","000","00","110","0019","0000","1968","1103","865","123","2091","4491","0","46.56","24.56"
"65","000","00","110","0019","2607","779","451","328","56","835","1734","0","48.15","26.01"
"65","000","00","110","0019","2608","606","314","292","37","643","1408","0","45.67","22.30"
"65","000","00","110","0019","2609","583","338","245","30","613","1349","0","45.44","25.06"
"65","000","00","110","0020","0000","2874","1468","1406","115","2989","5134","0","58.22","28.59"
"65","000","00","110","0020","2647","763","386","377","27","790","1452","0","54.41","26.58"
"65","000","00","110","0020","2648","757","378","379","30","787","1314","0","59.89","28.77"
"65","000","00","110","0020","2649","752","386","366","29","781","1252","0","62.38","30.83"
"65","000","00","110","0020","2650","602","318","284","29","631","1116","0","56.54","28.49"
"65","000","00","110","0021","0000","1944","980","964","92","2036","3830","0","53.16","25.59"
"65","000","00","110","0021","2570","602","292","310","35","637","1180","0","53.98","24.75"
"65","000","00","110","0021","2571","661","344","317","39","700","1343","0","52.12","25.61"
"65","000","00","110","0021","2572","681","344","337","18","699","1307","0","53.48","26.32"
"65","000","00","110","0022","0000","2077","1080","997","124","2201","4148","0","53.06","26.04"
"65","000","00","110","0022","2654","708","367","341","34","742","1436","0","51.67","25.56"
"65","000","00","110","0022","2655","675","332","343","49","724","1331","0","54.40","24.94"
"65","000","00","110","0022","2656","694","381","313","41","735","1381","0","53.22","27.59"
"65","000","00","110","0023","0000","306","171","135","24","330","528","0","62.50","32.39"
"65","000","00","110","0023","2589","306","171","135","24","330","528","0","62.50","32.39"
"65","000","00","110","0024","0000","1650","852","798","65","1715","3263","0","52.56","26.11"
"65","000","00","110","0024","2657","806","424","382","42","848","1679","0","50.51","25.25"
"65","000","00","110","0024","2658","844","428","416","23","867","1584","0","54.73","27.02"
"65","000","00","110","0025","0000","1367","629","738","63","1430","2604","0","54.92","24.16"
"65","000","00","110","0025","2659","630","265","365","28","658","1253","0","52.51","21.15"
"65","000","00","110","0025","2660","737","364","373","35","772","1351","0","57.14","26.94"
"65","000","00","110","0026","0000","3113","1661","1452","146","3259","6956","0","46.85","23.88"
"65","000","00","110","0026","2625","591","336","255","41","632","1369","0","46.17","24.54"
"65","000","00","110","0026","2626","591","312","279","25","616","1347","0","45.73","23.16"
"65","000","00","110","0026","2627","604","331","273","31","635","1413","0","44.94","23.43"
"65","000","00","110","0026","2628","654","341","313","22","676","1378","0","49.06","24.75"
"65","000","00","110","0026","2629","673","341","332","27","700","1449","0","48.31","23.53"
"65","000","00","110","0027","0000","2876","1388","1488","92","2968","5467","0","54.29","25.39"
"65","000","00","110","0027","2637","714","379","335","27","741","1364","0","54.33","27.79"
"65","000","00","110","0027","2638","720","345","375","25","745","1361","0","54.74","25.35"
"65","000","00","110","0027","2639","779","376","403","23","802","1435","0","55.89","26.20"
"65","000","00","110","0027","2640","663","288","375","17","680","1307","0","52.03","22.04"
"65","000","00","110","0028","0000","941","463","478","73","1014","1649","0","61.49","28.08"
"65","000","00","110","0028","2538","941","463","478","73","1014","1649","0","61.49","28.08"
"65","000","00","110","0029","0000","2973","1442","1531","122","3095","6667","0","46.42","21.63"
"65","000","00","110","0029","2619","782","418","364","30","812","1713","0","47.40","24.40"
"65","000","00","110","0029","2620","692","330","362","29","721","1595","0","45.20","20.69"
"65","000","00","110","0029","2621","746","354","392","30","776","1698","0","45.70","20.85"
"65","000","00","110","0029","2622","753","340","413","33","786","1661","0","47.32","20.47"
"65","000","00","110","0030","0000","3439","1676","1763","107","3546","7267","0","48.80","23.06"
"65","000","00","110","0030","2614","662","331","331","25","687","1359","0","50.55","24.36"
"65","000","00","110","0030","2615","723","362","361","34","757","1480","0","51.15","24.46"
"65","000","00","110","0030","2616","699","301","398","16","715","1486","0","48.12","20.26"
"65","000","00","110","0030","2617","659","346","313","20","679","1448","0","46.89","23.90"
"65","000","00","110","0030","2618","696","336","360","12","708","1494","0","47.39","22.49"
"65","000","00","110","0031","0000","2696","1391","1305","101","2797","5050","0","55.39","27.54"
"65","000","00","110","0031","2564","939","474","465","35","974","1669","0","58.36","28.40"
"65","000","00","110","0031","2565","863","461","402","44","907","1689","0","53.70","27.29"
"65","000","00","110","0031","2566","894","456","438","22","916","1692","0","54.14","26.95"
"65","000","00","110","0032","0000","2022","1029","993","108","2130","4060","0","52.46","25.34"
"65","000","00","110","0032","2567","743","392","351","49","792","1531","0","51.73","25.60"
"65","000","00","110","0032","2568","770","389","381","21","791","1468","0","53.88","26.50"
"65","000","00","110","0032","2569","509","248","261","38","547","1061","0","51.56","23.37"
"65","000","00","110","0033","0000","2193","1118","1075","108","2301","4808","0","47.86","23.25"
"65","000","00","110","0033","2610","645","323","322","35","680","1594","0","42.66","20.26"
"65","000","00","110","0033","2611","742","364","378","31","773","1625","0","47.57","22.40"
"65","000","00","110","0033","2612","806","431","375","42","848","1589","0","53.37","27.12"
"65","000","00","110","0034","0000","1447","743","704","58","1505","3089","0","48.72","24.05"
"65","000","00","110","0034","2630","802","425","377","33","835","1644","0","50.79","25.85"
"65","000","00","110","0034","2631","645","318","327","25","670","1445","0","46.37","22.01"
"65","000","00","110","0035","0000","1492","752","740","69","1561","2873","0","54.33","26.17"
"65","000","00","110","0035","2632","761","358","403","38","799","1382","0","57.81","25.90"
"65","000","00","110","0035","2633","731","394","337","31","762","1491","0","51.11","26.43"
"65","000","00","110","0036","0000","2333","1204","1129","90","2423","4704","0","51.51","25.60"
"65","000","00","110","0036","2634","754","391","363","28","782","1546","0","50.58","25.29"
"65","000","00","110","0036","2635","722","383","339","27","749","1474","0","50.81","25.98"
"65","000","00","110","0036","2636","857","430","427","35","892","1684","0","52.97","25.53"
"65","000","00","110","0037","0000","1772","788","984","43","1815","2941","0","61.71","26.79"
"65","000","00","110","0037","2651","823","348","475","18","841","1381","0","60.90","25.20"
"65","000","00","110","0037","2652","949","440","509","25","974","1560","0","62.44","28.21"
"65","000","00","110","0038","0000","600","370","230","44","644","1135","0","56.74","32.60"
"65","000","00","110","0038","2653","600","370","230","44","644","1135","0","56.74","32.60"
"65","000","00","110","0039","0000","2255","1102","1153","50","2305","4248","0","54.26","25.94"
"65","000","00","110","0039","2661","660","347","313","18","678","1160","0","58.45","29.91"
"65","000","00","110","0039","2662","677","322","355","11","688","1264","0","54.43","25.47"
"65","000","00","110","0039","2663","918","433","485","21","939","1824","0","51.48","23.74"
"65","000","00","110","0040","0000","1351","649","702","61","1412","2803","0","50.37","23.15"
"65","000","00","110","0040","2623","706","322","384","36","742","1470","0","50.48","21.90"
"65","000","00","110","0040","2624","645","327","318","25","670","1333","0","50.26","24.53"
"65","000","00","110","0041","0000","1305","662","643","62","1367","2473","0","55.28","26.77"
"65","000","00","110","0041","2544","667","349","318","36","703","1215","0","57.86","28.72"
"65","000","00","110","0041","2545","638","313","325","26","664","1258","0","52.78","24.88"
"65","000","00","110","0042","0000","2106","1125","981","107","2213","4318","0","51.25","26.05"
"65","000","00","110","0042","2576","780","411","369","43","823","1606","0","51.25","25.59"
"65","000","00","110","0042","2577","719","395","324","44","763","1546","0","49.35","25.55"
"65","000","00","110","0042","2578","607","319","288","20","627","1166","0","53.77","27.36"
"65","000","00","110","0043","0000","3079","1446","1633","108","3187","5737","0","55.55","25.20"
"65","000","00","110","0043","2643","810","353","457","26","836","1480","0","56.49","23.85"
"65","000","00","110","0043","2644","738","344","394","31","769","1374","0","55.97","25.04"
"65","000","00","110","0043","2645","768","403","365","19","787","1527","0","51.54","26.39"
"65","000","00","110","0043","2646","763","346","417","32","795","1356","0","58.63","25.52"
"65","000","00","110","0044","0000","481","242","239","24","505","840","0","60.12","28.81"
"65","000","00","110","0044","2606","481","242","239","24","505","840","0","60.12","28.81"
"65","000","00","110","0045","0000","2592","1306","1286","98","2690","5507","0","48.85","23.72"
"65","000","00","110","0045","2550","585","293","292","30","615","1319","0","46.63","22.21"
"65","000","00","110","0045","2551","682","332","350","17","699","1356","0","51.55","24.48"
"65","000","00","110","0045","2552","650","356","294","21","671","1410","0","47.59","25.25"
"65","000","00","110","0045","2553","675","325","350","30","705","1422","0","49.58","22.86"
"65","000","00","110","0046","0000","2070","1022","1048","100","2170","3989","0","54.40","25.62"
"65","000","00","110","0046","2557","737","375","362","43","780","1390","0","56.12","26.98"
"65","000","00","110","0046","2558","648","342","306","39","687","1248","0","55.05","27.40"
"65","000","00","110","0046","2559","685","305","380","18","703","1351","0","52.04","22.58"
"65","000","00","110","0047","0000","2353","1149","1204","97","2450","4482","0","54.66","25.64"
"65","000","00","110","0047","2584","843","443","400","27","870","1586","0","54.85","27.93"
"65","000","00","110","0047","2585","848","404","444","36","884","1656","0","53.38","24.40"
"65","000","00","110","0047","2586","662","302","360","34","696","1240","0","56.13","24.35"
"65","000","00","110","0048","0000","2157","1070","1087","79","2236","3972","0","56.29","26.94"
"65","000","00","110","0048","2579","637","326","311","26","663","1207","0","54.93","27.01"
"65","000","00","110","0048","2580","738","367","371","20","758","1301","0","58.26","28.21"
"65","000","00","110","0048","2581","782","377","405","33","815","1464","0","55.67","25.75"
"65","000","00","110","0049","0000","1513","672","841","57","1570","2433","0","64.53","27.62"
"65","000","00","110","0049","2641","674","325","349","25","699","1124","0","62.19","28.91"
"65","000","00","110","0049","2642","839","347","492","32","871","1309","0","66.54","26.51"
"65","000","00","110","0050","0000","1138","573","565","41","1179","2600","0","45.35","22.04"
"65","000","00","110","0050","2593","857","411","446","14","871","1947","0","44.74","21.11"
"65","000","00","110","0050","2594","281","162","119","27","308","653","0","47.17","24.81"
"65","000","00","120","0000","0000","15684","7904","7780","1319","17003","32989","37721","51.54","23.96"
"65","000","00","120","0001","0000","365","182","183","20","385","683","0","56.37","26.65"
"65","000","00","120","0001","2416","365","182","183","20","385","683","0","56.37","26.65"
"65","000","00","120","0002","0000","971","467","504","70","1041","1796","0","57.96","26.00"
"65","000","00","120","0002","2417","569","281","288","47","616","998","0","61.72","28.16"
"65","000","00","120","0002","2418","402","186","216","23","425","798","0","53.26","23.31"
"65","000","00","120","0003","0000","640","330","310","39","679","1177","0","57.69","28.04"
"65","000","00","120","0003","2419","640","330","310","39","679","1177","0","57.69","28.04"
"65","000","00","120","0004","0000","723","378","345","59","782","1516","0","51.58","24.93"
"65","000","00","120","0004","2421","422","206","216","28","450","847","0","53.13","24.32"
"65","000","00","120","0004","2422","301","172","129","31","332","669","0","49.63","25.71"
"65","000","00","120","0005","0000","495","233","262","30","525","1244","0","42.20","18.73"
"65","000","00","120","0005","2423","495","233","262","30","525","1244","0","42.20","18.73"
"65","000","00","120","0006","0000","254","122","132","17","271","565","0","47.96","21.59"
"65","000","00","120","0006","2420","254","122","132","17","271","565","0","47.96","21.59"
"65","000","00","120","0007","0000","1719","866","853","128","1847","3410","0","54.16","25.40"
"65","000","00","120","0007","2424","567","277","290","34","601","1311","0","45.84","21.13"
"65","000","00","120","0007","2425","614","315","299","46","660","1083","0","60.94","29.09"
"65","000","00","120","0007","2426","538","274","264","48","586","1016","0","57.68","26.97"
"65","000","00","120","0008","0000","480","282","198","53","533","1011","0","52.72","27.89"
"65","000","00","120","0008","2432","480","282","198","53","533","1011","0","52.72","27.89"
"65","000","00","120","0009","0000","713","366","347","60","773","1532","0","50.46","23.89"
"65","000","00","120","0009","2430","434","214","220","31","465","927","0","50.16","23.09"
"65","000","00","120","0009","2431","279","152","127","29","308","605","0","50.91","25.12"
"65","000","00","120","0010","0000","595","297","298","73","668","1215","0","54.98","24.44"
"65","000","00","120","0010","2442","318","151","167","34","352","634","0","55.52","23.82"
"65","000","00","120","0010","2443","277","146","131","39","316","581","0","54.39","25.13"
"65","000","00","120","0011","0000","897","453","444","87","984","1618","0","60.82","28.00"
"65","000","00","120","0011","2437","476","241","235","37","513","775","0","66.19","31.10"
"65","000","00","120","0011","2438","421","212","209","50","471","843","0","55.87","25.15"
"65","000","00","120","0012","0000","1186","593","593","105","1291","2791","0","46.26","21.25"
"65","000","00","120","0012","2439","281","144","137","37","318","725","0","43.86","19.86"
"65","000","00","120","0012","2440","460","230","230","37","497","1110","0","44.77","20.72"
"65","000","00","120","0012","2441","445","219","226","31","476","956","0","49.79","22.91"
"65","000","00","120","0013","0000","792","431","361","60","852","1800","0","47.33","23.94"
"65","000","00","120","0013","2444","414","220","194","26","440","1001","0","43.96","21.98"
"65","000","00","120","0013","2445","378","211","167","34","412","799","0","51.56","26.41"
"65","000","00","120","0014","0000","170","103","67","17","187","406","0","46.06","25.37"
"65","000","00","120","0014","2434","170","103","67","17","187","406","0","46.06","25.37"
"65","000","00","120","0015","0000","140","92","48","27","167","234","0","71.37","39.32"
"65","000","00","120","0015","2435","140","92","48","27","167","234","0","71.37","39.32"
"65","000","00","120","0016","0000","155","94","61","13","168","290","0","57.93","32.41"
"65","000","00","120","0016","2433","155","94","61","13","168","290","0","57.93","32.41"
"65","000","00","120","0017","0000","113","59","54","11","124","139","0","89.21","42.45"
"65","000","00","120","0017","2436","113","59","54","11","124","139","0","89.21","42.45"
"65","000","00","120","0018","0000","184","111","73","17","201","383","0","52.48","28.98"
"65","000","00","120","0018","2446","184","111","73","17","201","383","0","52.48","28.98"
"65","000","00","120","0019","0000","207","113","94","28","235","403","0","58.31","28.04"
"65","000","00","120","0019","2447","207","113","94","28","235","403","0","58.31","28.04"
"65","000","00","120","0020","0000","120","68","52","12","132","279","0","47.31","24.37"
"65","000","00","120","0020","2448","120","68","52","12","132","279","0","47.31","24.37"
"65","000","00","120","0021","0000","85","41","44","4","89","146","0","60.96","28.08"
"65","000","00","120","0021","2449","85","41","44","4","89","146","0","60.96","28.08"
"65","000","00","120","0022","0000","126","77","49","3","129","309","0","41.75","24.92"
"65","000","00","120","0022","2450","126","77","49","3","129","309","0","41.75","24.92"
"65","000","00","120","0023","0000","178","94","84","22","200","344","0","58.14","27.33"
"65","000","00","120","0023","2453","178","94","84","22","200","344","0","58.14","27.33"
"65","000","00","120","0024","0000","119","46","73","11","130","168","0","77.38","27.38"
"65","000","00","120","0024","2451","119","46","73","11","130","168","0","77.38","27.38"
"65","000","00","120","0025","0000","104","63","41","14","118","178","0","66.29","35.39"
"65","000","00","120","0025","2452","104","63","41","14","118","178","0","66.29","35.39"
"65","000","00","120","0026","0000","155","74","81","16","171","298","0","57.38","24.83"
"65","000","00","120","0026","2454","155","74","81","16","171","298","0","57.38","24.83"
"65","000","00","120","0027","0000","92","54","38","12","104","269","0","38.66","20.07"
"65","000","00","120","0027","2456","92","54","38","12","104","269","0","38.66","20.07"
"65","000","00","120","0028","0000","276","116","160","32","308","448","0","68.75","25.89"
"65","000","00","120","0028","2455","276","116","160","32","308","448","0","68.75","25.89"
"65","000","00","120","0029","0000","607","265","342","43","650","1224","0","53.10","21.65"
"65","000","00","120","0029","2459","607","265","342","43","650","1224","0","53.10","21.65"
"65","000","00","120","0030","0000","696","336","360","73","769","1805","0","42.60","18.61"
"65","000","00","120","0030","2460","362","191","171","32","394","981","0","40.16","19.47"
"65","000","00","120","0030","2461","334","145","189","41","375","824","0","45.51","17.60"
"65","000","00","120","0031","0000","531","236","295","56","587","1232","0","47.65","19.16"
"65","000","00","120","0031","2462","531","236","295","56","587","1232","0","47.65","19.16"
"65","000","00","120","0032","0000","175","84","91","14","189","252","0","75.00","33.33"
"65","000","00","120","0032","2457","175","84","91","14","189","252","0","75.00","33.33"
"65","000","00","120","0033","0000","277","159","118","8","285","824","0","34.59","19.30"
"65","000","00","120","0033","2458","277","159","118","8","285","824","0","34.59","19.30"
"65","000","00","120","0034","0000","1344","619","725","85","1429","3000","0","47.63","20.63"
"65","000","00","120","0034","2427","608","293","315","38","646","1384","0","46.68","21.17"
"65","000","00","120","0034","2428","234","100","134","14","248","460","0","53.91","21.74"
"65","000","00","120","0034","2429","502","226","276","33","535","1156","0","46.28","19.55"
"65","000","00","130","0000","0000","100956","54360","46596","5145","106101","198364","236872","53.49","27.40"
"65","000","00","130","0001","0000","1584","864","720","114","1698","4951","0","34.30","17.45"
"65","000","00","130","0001","1943","522","291","231","39","561","2771","0","20.25","10.50"
"65","000","00","130","0001","1944","565","317","248","39","604","1184","0","51.01","26.77"
"65","000","00","130","0001","1945","497","256","241","36","533","996","0","53.51","25.70"
"65","000","00","130","0002","0000","888","471","417","68","956","1761","0","54.29","26.75"
"65","000","00","130","0002","1946","471","255","216","42","513","934","0","54.93","27.30"
"65","000","00","130","0002","1947","417","216","201","26","443","827","0","53.57","26.12"
"65","000","00","130","0003","0000","3851","2020","1831","179","4030","6987","0","57.68","28.91"
"65","000","00","130","0003","1953","681","371","310","33","714","1293","0","55.22","28.69"
"65","000","00","130","0003","1954","723","370","353","38","761","1382","0","55.07","26.77"
"65","000","00","130","0003","1955","804","392","412","30","834","1476","0","56.50","26.56"
"65","000","00","130","0003","1956","810","436","374","50","860","1387","0","62.00","31.43"
"65","000","00","130","0003","1957","833","451","382","28","861","1449","0","59.42","31.12"
"65","000","00","130","0004","0000","2301","1256","1045","140","2441","4853","0","50.30","25.88"
"65","000","00","130","0004","1939","673","366","307","52","725","1396","0","51.93","26.22"
"65","000","00","130","0004","1940","591","325","266","23","614","1263","0","48.61","25.73"
"65","000","00","130","0004","1941","519","267","252","36","555","1071","0","51.82","24.93"
"65","000","00","130","0004","1942","518","298","220","29","547","1123","0","48.71","26.54"
"65","000","00","130","0005","0000","1069","384","685","33","1102","1757","0","62.72","21.86"
"65","000","00","130","0005","1948","501","197","304","18","519","842","0","61.64","23.40"
"65","000","00","130","0005","1949","568","187","381","15","583","915","0","63.72","20.44"
"65","000","00","130","0006","0000","2042","1124","918","108","2150","3894","0","55.21","28.86"
"65","000","00","130","0006","1966","690","396","294","43","733","1274","0","57.54","31.08"
"65","000","00","130","0006","1967","630","336","294","26","656","1274","0","51.49","26.37"
"65","000","00","130","0006","1968","722","392","330","39","761","1346","0","56.54","29.12"
"65","000","00","130","0007","0000","3555","1966","1589","165","3720","6313","0","58.93","31.14"
"65","000","00","130","0007","1962","1020","555","465","49","1069","1821","0","58.70","30.48"
"65","000","00","130","0007","1963","985","540","445","33","1018","1698","0","59.95","31.80"
"65","000","00","130","0007","1964","855","486","369","41","896","1584","0","56.57","30.68"
"65","000","00","130","0007","1965","695","385","310","42","737","1210","0","60.91","31.82"
"65","000","00","130","0008","0000","2225","1163","1062","92","2317","4084","0","56.73","28.48"
"65","000","00","130","0008","1973","713","406","307","43","756","1394","0","54.23","29.12"
"65","000","00","130","0008","1974","907","494","413","39","946","1641","0","57.65","30.10"
"65","000","00","130","0008","1975","605","263","342","10","615","1049","0","58.63","25.07"
"65","000","00","130","0009","0000","1634","881","753","56","1690","3157","0","53.53","27.91"
"65","000","00","130","0009","2004","567","322","245","24","591","1127","0","52.44","28.57"
"65","000","00","130","0009","2005","489","236","253","15","504","962","0","52.39","24.53"
"65","000","00","130","0009","2006","578","323","255","17","595","1068","0","55.71","30.24"
"65","000","00","130","0010","0000","3720","1911","1809","154","3874","7064","0","54.84","27.05"
"65","000","00","130","0010","1986","791","447","344","45","836","1474","0","56.72","30.33"
"65","000","00","130","0010","1987","682","369","313","29","711","1389","0","51.19","26.57"
"65","000","00","130","0010","1988","790","398","392","22","812","1442","0","56.31","27.60"
"65","000","00","130","0010","1989","753","358","395","30","783","1417","0","55.26","25.26"
"65","000","00","130","0010","1990","704","339","365","28","732","1342","0","54.55","25.26"
"65","000","00","130","0011","0000","1506","839","667","100","1606","2612","0","61.49","32.12"
"65","000","00","130","0011","1976","729","407","322","37","766","1259","0","60.84","32.33"
"65","000","00","130","0011","1977","777","432","345","63","840","1353","0","62.08","31.93"
"65","000","00","130","0012","0000","3281","1793","1488","161","3442","6857","0","50.20","26.15"
"65","000","00","130","0012","2022","546","284","262","35","581","1294","0","44.90","21.95"
"65","000","00","130","0012","2023","631","338","293","22","653","1236","0","52.83","27.35"
"65","000","00","130","0012","2024","717","359","358","30","747","1416","0","52.75","25.35"
"65","000","00","130","0012","2025","743","436","307","31","774","1465","0","52.83","29.76"
"65","000","00","130","0012","2026","644","376","268","43","687","1446","0","47.51","26.00"
"65","000","00","130","0013","0000","2748","1539","1209","156","2904","5582","0","52.02","27.57"
"65","000","00","130","0013","2011","707","423","284","43","750","1353","0","55.43","31.26"
"65","000","00","130","0013","2012","764","451","313","29","793","1609","0","49.29","28.03"
"65","000","00","130","0013","2013","654","351","303","46","700","1329","0","52.67","26.41"
"65","000","00","130","0013","2014","623","314","309","38","661","1291","0","51.20","24.32"
"65","000","00","130","0014","0000","1873","964","909","77","1950","3688","0","52.87","26.14"
"65","000","00","130","0014","2027","577","317","260","34","611","1151","0","53.08","27.54"
"65","000","00","130","0014","2028","584","301","283","32","616","1247","0","49.40","24.14"
"65","000","00","130","0014","2029","712","346","366","11","723","1290","0","56.05","26.82"
"65","000","00","130","0015","0000","699","402","297","47","746","1404","0","53.13","28.63"
"65","000","00","130","0015","2015","699","402","297","47","746","1404","0","53.13","28.63"
"65","000","00","130","0016","0000","2940","1577","1363","158","3098","5801","0","53.40","27.18"
"65","000","00","130","0016","2016","665","374","291","43","708","1450","0","48.83","25.79"
"65","000","00","130","0016","2017","711","388","323","26","737","1429","0","51.57","27.15"
"65","000","00","130","0016","2018","810","409","401","51","861","1496","0","57.55","27.34"
"65","000","00","130","0016","2019","754","406","348","38","792","1426","0","55.54","28.47"
"65","000","00","130","0017","0000","2946","1636","1310","166","3112","6268","0","49.65","26.10"
"65","000","00","130","0017","2040","616","367","249","39","655","1239","0","52.87","29.62"
"65","000","00","130","0017","2041","610","320","290","36","646","1359","0","47.53","23.55"
"65","000","00","130","0017","2042","507","277","230","26","533","1070","0","49.81","25.89"
"65","000","00","130","0017","2043","545","302","243","30","575","1192","0","48.24","25.34"
"65","000","00","130","0017","2044","668","370","298","35","703","1408","0","49.93","26.28"
"65","000","00","130","0018","0000","3226","1781","1445","153","3379","6003","0","56.29","29.67"
"65","000","00","130","0018","2054","745","422","323","38","783","1490","0","52.55","28.32"
"65","000","00","130","0018","2055","911","503","408","49","960","1543","0","62.22","32.60"
"65","000","00","130","0018","2056","760","420","340","40","800","1459","0","54.83","28.79"
"65","000","00","130","0018","2057","810","436","374","26","836","1511","0","55.33","28.86"
"65","000","00","130","0019","0000","2099","1158","941","95","2194","4169","0","52.63","27.78"
"65","000","00","130","0019","2033","674","375","299","49","723","1266","0","57.11","29.62"
"65","000","00","130","0019","2034","718","374","344","14","732","1457","0","50.24","25.67"
"65","000","00","130","0019","2035","707","409","298","32","739","1446","0","51.11","28.28"
"65","000","00","130","0020","0000","2179","1227","952","112","2291","4209","0","54.43","29.15"
"65","000","00","130","0020","1935","663","385","278","32","695","1214","0","57.25","31.71"
"65","000","00","130","0020","1936","604","359","245","22","626","1113","0","56.24","32.26"
"65","000","00","130","0020","1937","447","221","226","31","478","963","0","49.64","22.95"
"65","000","00","130","0020","1938","465","262","203","27","492","919","0","53.54","28.51"
"65","000","00","130","0021","0000","3496","1890","1606","157","3653","7015","0","52.07","26.94"
"65","000","00","130","0021","1930","716","369","347","21","737","1452","0","50.76","25.41"
"65","000","00","130","0021","1931","691","395","296","41","732","1443","0","50.73","27.37"
"65","000","00","130","0021","1932","658","375","283","44","702","1336","0","52.54","28.07"
"65","000","00","130","0021","1933","692","361","331","31","723","1318","0","54.86","27.39"
"65","000","00","130","0021","1934","739","390","349","20","759","1466","0","51.77","26.60"
"65","000","00","130","0022","0000","2191","1238","953","137","2328","4117","0","56.55","30.07"
"65","000","00","130","0022","1927","712","422","290","50","762","1327","0","57.42","31.80"
"65","000","00","130","0022","1928","660","365","295","48","708","1255","0","56.41","29.08"
"65","000","00","130","0022","1929","819","451","368","39","858","1535","0","55.90","29.38"
"65","000","00","130","0023","0000","2006","1089","917","135","2141","4213","0","50.82","25.85"
"65","000","00","130","0023","1924","680","376","304","45","725","1422","0","50.98","26.44"
"65","000","00","130","0023","1925","612","311","301","35","647","1409","0","45.92","22.07"
"65","000","00","130","0023","1926","714","402","312","55","769","1382","0","55.64","29.09"
"65","000","00","130","0024","0000","2181","1177","1004","160","2341","4594","0","50.96","25.62"
"65","000","00","130","0024","1921","614","342","272","52","666","1357","0","49.08","25.20"
"65","000","00","130","0024","1922","765","408","357","42","807","1627","0","49.60","25.08"
"65","000","00","130","0024","1923","802","427","375","66","868","1610","0","53.91","26.52"
"65","000","00","130","0025","0000","1307","641","666","78","1385","2463","0","56.23","26.03"
"65","000","00","130","0025","1919","648","336","312","40","688","1270","0","54.17","26.46"
"65","000","00","130","0025","1920","659","305","354","38","697","1193","0","58.42","25.57"
"65","000","00","130","0026","0000","749","422","327","45","794","1408","0","56.39","29.97"
"65","000","00","130","0026","1918","749","422","327","45","794","1408","0","56.39","29.97"
"65","000","00","130","0027","0000","2381","1283","1098","91","2472","4311","0","57.34","29.76"
"65","000","00","130","0027","1993","876","490","386","42","918","1534","0","59.84","31.94"
"65","000","00","130","0027","1994","704","394","310","9","713","1296","0","55.02","30.40"
"65","000","00","130","0027","1995","801","399","402","40","841","1481","0","56.79","26.94"
"65","000","00","130","0028","0000","2534","1262","1272","119","2653","4736","0","56.02","26.65"
"65","000","00","130","0028","1981","818","431","387","47","865","1609","0","53.76","26.79"
"65","000","00","130","0028","1982","867","410","457","19","886","1532","0","57.83","26.76"
"65","000","00","130","0028","1983","849","421","428","53","902","1595","0","56.55","26.39"
"65","000","00","130","0029","0000","1495","787","708","90","1585","2956","0","53.62","26.62"
"65","000","00","130","0029","1996","810","397","413","39","849","1545","0","54.95","25.70"
"65","000","00","130","0029","1997","685","390","295","51","736","1411","0","52.16","27.64"
"65","000","00","130","0030","0000","1743","962","781","117","1860","3747","0","49.64","25.67"
"65","000","00","130","0030","2048","565","294","271","51","616","1243","0","49.56","23.65"
"65","000","00","130","0030","2049","608","352","256","30","638","1235","0","51.66","28.50"
"65","000","00","130","0030","2050","570","316","254","36","606","1269","0","47.75","24.90"
"65","000","00","130","0031","0000","2137","1204","933","102","2239","4198","0","53.33","28.68"
"65","000","00","130","0031","2058","796","456","340","36","832","1464","0","56.83","31.15"
"65","000","00","130","0031","2059","685","391","294","35","720","1399","0","51.47","27.95"
"65","000","00","130","0031","2060","656","357","299","31","687","1335","0","51.46","26.74"
"65","000","00","130","0032","0000","1493","817","676","99","1592","2936","0","54.22","27.83"
"65","000","00","130","0032","2009","839","451","388","60","899","1633","0","55.05","27.62"
"65","000","00","130","0032","2010","654","366","288","39","693","1303","0","53.18","28.09"
"65","000","00","130","0033","0000","2449","1357","1092","143","2592","4644","0","55.81","29.22"
"65","000","00","130","0033","1958","628","371","257","50","678","1244","0","54.50","29.82"
"65","000","00","130","0033","1959","560","306","254","35","595","1078","0","55.19","28.39"
"65","000","00","130","0033","1960","658","340","318","25","683","1205","0","56.68","28.22"
"65","000","00","130","0033","1961","603","340","263","33","636","1117","0","56.94","30.44"
"65","000","00","130","0034","0000","1697","977","720","116","1813","3709","0","48.88","26.34"
"65","000","00","130","0034","2045","515","292","223","46","561","1180","0","47.54","24.75"
"65","000","00","130","0034","2046","689","395","294","33","722","1371","0","52.66","28.81"
"65","000","00","130","0034","2047","493","290","203","37","530","1158","0","45.77","25.04"
"65","000","00","130","0035","0000","2146","1168","978","131","2277","3841","0","59.28","30.41"
"65","000","00","130","0035","1978","624","331","293","52","676","1195","0","56.57","27.70"
"65","000","00","130","0035","1979","677","388","289","43","720","1228","0","58.63","31.60"
"65","000","00","130","0035","1980","845","449","396","36","881","1418","0","62.13","31.66"
"65","000","00","130","0036","0000","2501","1391","1110","158","2659","4670","0","56.94","29.79"
"65","000","00","130","0036","1969","602","352","250","48","650","1107","0","58.72","31.80"
"65","000","00","130","0036","1970","661","354","307","45","706","1220","0","57.87","29.02"
"65","000","00","130","0036","1971","668","369","299","44","712","1260","0","56.51","29.29"
"65","000","00","130","0036","1972","570","316","254","21","591","1083","0","54.57","29.18"
"65","000","00","130","0037","0000","1753","898","855","82","1835","3734","0","49.14","24.05"
"65","000","00","130","0037","1950","627","311","316","37","664","1277","0","52.00","24.35"
"65","000","00","130","0037","1951","587","323","264","21","608","1240","0","49.03","26.05"
"65","000","00","130","0037","1952","539","264","275","24","563","1217","0","46.26","21.69"
"65","000","00","130","0038","0000","2307","1218","1089","127","2434","4847","0","50.22","25.13"
"65","000","00","130","0038","2030","796","407","389","51","847","1683","0","50.33","24.18"
"65","000","00","130","0038","2031","758","397","361","36","794","1591","0","49.91","24.95"
"65","000","00","130","0038","2032","753","414","339","40","793","1573","0","50.41","26.32"
"65","000","00","130","0039","0000","1558","848","710","75","1633","2797","0","58.38","30.32"
"65","000","00","130","0039","1984","743","401","342","37","780","1322","0","59.00","30.33"
"65","000","00","130","0039","1985","815","447","368","38","853","1475","0","57.83","30.31"
"65","000","00","130","0040","0000","2793","1546","1247","124","2917","5703","0","51.15","27.11"
"65","000","00","130","0040","2061","788","440","348","43","831","1565","0","53.10","28.12"
"65","000","00","130","0040","2062","638","356","282","30","668","1284","0","52.02","27.73"
"65","000","00","130","0040","2063","680","391","289","27","707","1414","0","50.00","27.65"
"65","000","00","130","0040","2064","687","359","328","24","711","1440","0","49.38","24.93"
"65","000","00","130","0041","0000","1558","849","709","70","1628","2776","0","58.65","30.58"
"65","000","00","130","0041","2007","818","445","373","37","855","1467","0","58.28","30.33"
"65","000","00","130","0041","2008","740","404","336","33","773","1309","0","59.05","30.86"
"65","000","00","130","0042","0000","2176","1199","977","74","2250","4123","0","54.57","29.08"
"65","000","00","130","0042","2001","687","357","330","16","703","1394","0","50.43","25.61"
"65","000","00","130","0042","2002","744","435","309","38","782","1365","0","57.29","31.87"
"65","000","00","130","0042","2003","745","407","338","20","765","1364","0","56.09","29.84"
"65","000","00","130","0043","0000","2984","1558","1426","83","3067","5253","0","58.39","29.66"
"65","000","00","130","0043","1998","926","491","435","46","972","1639","0","59.30","29.96"
"65","000","00","130","0043","1999","868","459","409","21","889","1630","0","54.54","28.16"
"65","000","00","130","0043","2000","1190","608","582","16","1206","1984","0","60.79","30.65"
"65","000","00","130","0044","0000","1478","769","709","42","1520","2916","0","52.13","26.37"
"65","000","00","130","0044","1991","783","390","393","27","810","1561","0","51.89","24.98"
"65","000","00","130","0044","1992","695","379","316","15","710","1355","0","52.40","27.97"
"65","000","00","130","0045","0000","1355","748","607","75","1430","2539","0","56.32","29.46"
"65","000","00","130","0045","2020","740","405","335","41","781","1286","0","60.73","31.49"
"65","000","00","130","0045","2021","615","343","272","34","649","1253","0","51.80","27.37"
"65","000","00","130","0046","0000","2569","1231","1338","109","2678","5185","0","51.65","23.74"
"65","000","00","130","0046","2036","612","270","342","33","645","1272","0","50.71","21.23"
"65","000","00","130","0046","2037","656","309","347","30","686","1303","0","52.65","23.71"
"65","000","00","130","0046","2038","658","332","326","17","675","1284","0","52.57","25.86"
"65","000","00","130","0046","2039","643","320","323","29","672","1326","0","50.68","24.13"
"65","000","00","130","0047","0000","1553","875","678","72","1625","3519","0","46.18","24.87"
"65","000","00","130","0047","2051","577","288","289","18","595","1322","0","45.01","21.79"
"65","000","00","130","0047","2052","475","286","189","19","494","1058","0","46.69","27.03"
"65","000","00","130","0047","2053","501","301","200","35","536","1139","0","47.06","26.43"
"65","000","00","140","0000","0000","83160","47714","35446","4304","87464","164774","199543","53.08","28.96"
"65","000","00","140","0001","0000","5791","3225","2566","214","6005","11362","0","52.85","28.38"
"65","000","00","140","0001","0667","832","448","384","23","855","1579","0","54.15","28.37"
"65","000","00","140","0001","0668","831","492","339","37","868","1635","0","53.09","30.09"
"65","000","00","140","0001","0669","822","487","335","35","857","1640","0","52.26","29.70"
"65","000","00","140","0001","0670","884","470","414","29","913","1652","0","55.27","28.45"
"65","000","00","140","0001","0671","846","482","364","30","876","1645","0","53.25","29.30"
"65","000","00","140","0001","0672","804","453","351","31","835","1607","0","51.96","28.19"
"65","000","00","140","0001","0673","772","393","379","29","801","1604","0","49.94","24.50"
"65","000","00","140","0002","0000","2469","1425","1044","110","2579","5098","0","50.59","27.95"
"65","000","00","140","0002","0658","670","384","286","40","710","1320","0","53.79","29.09"
"65","000","00","140","0002","0659","654","373","281","34","688","1296","0","53.09","28.78"
"65","000","00","140","0002","0660","566","324","242","18","584","1241","0","47.06","26.11"
"65","000","00","140","0002","0661","579","344","235","18","597","1241","0","48.11","27.72"
"65","000","00","140","0003","0000","1881","1078","803","137","2018","3459","0","58.34","31.17"
"65","000","00","140","0003","0645","666","393","273","47","713","1237","0","57.64","31.77"
"65","000","00","140","0003","0646","786","447","339","56","842","1425","0","59.09","31.37"
"65","000","00","140","0003","0647","429","238","191","34","463","797","0","58.09","29.86"
"65","000","00","140","0004","0000","2237","1269","968","144","2381","4571","0","52.09","27.76"
"65","000","00","140","0004","0639","800","450","350","35","835","1574","0","53.05","28.59"
"65","000","00","140","0004","0640","727","409","318","53","780","1516","0","51.45","26.98"
"65","000","00","140","0004","0641","710","410","300","56","766","1481","0","51.72","27.68"
"65","000","00","140","0005","0000","1557","901","656","94","1651","3219","0","51.29","27.99"
"65","000","00","140","0005","0747","750","446","304","41","791","1616","0","48.95","27.60"
"65","000","00","140","0005","0748","807","455","352","53","860","1603","0","53.65","28.38"
"65","000","00","140","0006","0000","4475","2575","1900","225","4700","9030","0","52.05","28.52"
"65","000","00","140","0006","0735","737","406","331","41","778","1385","0","56.17","29.31"
"65","000","00","140","0006","0736","524","324","200","35","559","1118","0","50.00","28.98"
"65","000","00","140","0006","0737","682","415","267","36","718","1403","0","51.18","29.58"
"65","000","00","140","0006","0738","548","297","251","22","570","1106","0","51.54","26.85"
"65","000","00","140","0006","0739","626","367","259","30","656","1261","0","52.02","29.10"
"65","000","00","140","0006","0740","712","400","312","34","746","1393","0","53.55","28.72"
"65","000","00","140","0006","0741","646","366","280","27","673","1364","0","49.34","26.83"
"65","000","00","140","0007","0000","2927","1640","1287","168","3095","5714","0","54.17","28.70"
"65","000","00","140","0007","0691","808","468","340","42","850","1452","0","58.54","32.23"
"65","000","00","140","0007","0692","820","448","372","41","861","1668","0","51.62","26.86"
"65","000","00","140","0007","0693","527","304","223","36","563","1098","0","51.28","27.69"
"65","000","00","140","0007","0694","772","420","352","49","821","1496","0","54.88","28.07"
"65","000","00","140","0008","0000","2569","1469","1100","95","2664","4686","0","56.85","31.35"
"65","000","00","140","0008","0705","813","484","329","34","847","1542","0","54.93","31.39"
"65","000","00","140","0008","0706","940","542","398","49","989","1661","0","59.54","32.63"
"65","000","00","140","0008","0707","816","443","373","12","828","1483","0","55.83","29.87"
"65","000","00","140","0009","0000","2693","1446","1247","131","2824","5282","0","53.46","27.38"
"65","000","00","140","0009","0708","620","328","292","21","641","1254","0","51.12","26.16"
"65","000","00","140","0009","0709","656","362","294","52","708","1295","0","54.67","27.95"
"65","000","00","140","0009","0710","640","351","289","40","680","1269","0","53.59","27.66"
"65","000","00","140","0009","0711","777","405","372","18","795","1464","0","54.30","27.66"
"65","000","00","140","0010","0000","1600","893","707","101","1701","2708","0","62.81","32.98"
"65","000","00","140","0010","0712","743","427","316","41","784","1272","0","61.64","33.57"
"65","000","00","140","0010","0713","857","466","391","60","917","1436","0","63.86","32.45"
"65","000","00","140","0011","0000","1481","867","614","73","1554","2740","0","56.72","31.64"
"65","000","00","140","0011","0726","784","447","337","31","815","1471","0","55.40","30.39"
"65","000","00","140","0011","0727","697","420","277","42","739","1269","0","58.23","33.10"
"65","000","00","140","0012","0000","1256","683","573","81","1337","2285","0","58.51","29.89"
"65","000","00","140","0012","0724","660","372","288","45","705","1155","0","61.04","32.21"
"65","000","00","140","0012","0725","596","311","285","36","632","1130","0","55.93","27.52"
"65","000","00","140","0013","0000","1029","586","443","75","1104","1838","0","60.07","31.88"
"65","000","00","140","0013","0714","1029","586","443","75","1104","1838","0","60.07","31.88"
"65","000","00","140","0014","0000","1433","792","641","97","1530","2885","0","53.03","27.45"
"65","000","00","140","0014","0720","687","369","318","44","731","1326","0","55.13","27.83"
"65","000","00","140","0014","0721","746","423","323","53","799","1559","0","51.25","27.13"
"65","000","00","140","0015","0000","2369","1388","981","117","2486","4978","0","49.94","27.88"
"65","000","00","140","0015","0674","724","435","289","40","764","1567","0","48.76","27.76"
"65","000","00","140","0015","0675","856","503","353","30","886","1739","0","50.95","28.92"
"65","000","00","140","0015","0676","789","450","339","47","836","1672","0","50.00","26.91"
"65","000","00","140","0016","0000","2781","1605","1176","103","2884","5247","0","54.96","30.59"
"65","000","00","140","0016","0677","954","561","393","33","987","1793","0","55.05","31.29"
"65","000","00","140","0016","0678","935","527","408","29","964","1728","0","55.79","30.50"
"65","000","00","140","0016","0679","892","517","375","41","933","1726","0","54.06","29.95"
"65","000","00","140","0017","0000","2697","1560","1137","118","2815","5761","0","48.86","27.08"
"65","000","00","140","0017","0684","608","358","250","21","629","1379","0","45.61","25.96"
"65","000","00","140","0017","0685","674","401","273","24","698","1398","0","49.93","28.68"
"65","000","00","140","0017","0686","693","408","285","33","726","1484","0","48.92","27.49"
"65","000","00","140","0017","0687","722","393","329","40","762","1500","0","50.80","26.20"
"65","000","00","140","0018","0000","1671","965","706","92","1763","3417","0","51.59","28.24"
"65","000","00","140","0018","0695","849","486","363","40","889","1730","0","51.39","28.09"
"65","000","00","140","0018","0696","822","479","343","52","874","1687","0","51.81","28.39"
"65","000","00","140","0019","0000","2670","1505","1165","136","2806","5103","0","54.99","29.49"
"65","000","00","140","0019","0697","711","400","311","52","763","1392","0","54.81","28.74"
"65","000","00","140","0019","0698","718","401","317","28","746","1347","0","55.38","29.77"
"65","000","00","140","0019","0699","702","410","292","31","733","1314","0","55.78","31.20"
"65","000","00","140","0019","0700","539","294","245","25","564","1050","0","53.71","28.00"
"65","000","00","140","0020","0000","1545","907","638","88","1633","3065","0","53.28","29.59"
"65","000","00","140","0020","0701","753","450","303","51","804","1519","0","52.93","29.62"
"65","000","00","140","0020","0702","792","457","335","37","829","1546","0","53.62","29.56"
"65","000","00","140","0021","0000","4123","2341","1782","203","4326","8090","0","53.47","28.94"
"65","000","00","140","0021","0730","873","476","397","42","915","1641","0","55.76","29.01"
"65","000","00","140","0021","0731","765","460","305","39","804","1552","0","51.80","29.64"
"65","000","00","140","0021","0732","862","520","342","50","912","1670","0","54.61","31.14"
"65","000","00","140","0021","0733","829","455","374","45","874","1677","0","52.12","27.13"
"65","000","00","140","0021","0734","794","430","364","27","821","1550","0","52.97","27.74"
"65","000","00","140","0022","0000","2260","1271","989","83","2343","4553","0","51.46","27.92"
"65","000","00","140","0022","0742","769","455","314","35","804","1511","0","53.21","30.11"
"65","000","00","140","0022","0743","737","421","316","16","753","1596","0","47.18","26.38"
"65","000","00","140","0022","0744","754","395","359","32","786","1446","0","54.36","27.32"
"65","000","00","140","0023","0000","1417","814","603","78","1495","2777","0","53.84","29.31"
"65","000","00","140","0023","0665","646","359","287","41","687","1295","0","53.05","27.72"
"65","000","00","140","0023","0666","771","455","316","37","808","1482","0","54.52","30.70"
"65","000","00","140","0024","0000","2362","1382","980","135","2497","4677","0","53.39","29.55"
"65","000","00","140","0024","0651","788","470","318","49","837","1553","0","53.90","30.26"
"65","000","00","140","0024","0652","802","481","321","44","846","1554","0","54.44","30.95"
"65","000","00","140","0024","0653","772","431","341","42","814","1570","0","51.85","27.45"
"65","000","00","140","0025","0000","1497","908","589","107","1604","2807","0","57.14","32.35"
"65","000","00","140","0025","0656","774","508","266","58","832","1418","0","58.67","35.83"
"65","000","00","140","0025","0657","723","400","323","49","772","1389","0","55.58","28.80"
"65","000","00","140","0026","0000","1585","942","643","97","1682","2576","0","65.30","36.57"
"65","000","00","140","0026","0722","822","465","357","62","884","1276","0","69.28","36.44"
"65","000","00","140","0026","0723","763","477","286","35","798","1300","0","61.38","36.69"
"65","000","00","140","0027","0000","2469","1444","1025","137","2606","4708","0","55.35","30.67"
"65","000","00","140","0027","0715","823","510","313","62","885","1662","0","53.25","30.69"
"65","000","00","140","0027","0716","834","460","374","37","871","1510","0","57.68","30.46"
"65","000","00","140","0027","0717","812","474","338","38","850","1536","0","55.34","30.86"
"65","000","00","140","0028","0000","1817","1003","814","85","1902","4778","0","39.81","20.99"
"65","000","00","140","0028","0718","931","491","440","39","970","3025","0","32.07","16.23"
"65","000","00","140","0028","0719","886","512","374","46","932","1753","0","53.17","29.21"
"65","000","00","140","0029","0000","1957","1133","824","103","2060","4024","0","51.19","28.16"
"65","000","00","140","0029","0642","660","366","294","40","700","1302","0","53.76","28.11"
"65","000","00","140","0029","0643","633","392","241","24","657","1283","0","51.21","30.55"
"65","000","00","140","0029","0644","664","375","289","39","703","1439","0","48.85","26.06"
"65","000","00","140","0030","0000","1617","925","692","77","1694","3390","0","49.97","27.29"
"65","000","00","140","0030","0749","849","481","368","37","886","1738","0","50.98","27.68"
"65","000","00","140","0030","0750","768","444","324","40","808","1652","0","48.91","26.88"
"65","000","00","140","0031","0000","2130","1275","855","92","2222","4426","0","50.20","28.81"
"65","000","00","140","0031","0662","690","415","275","24","714","1444","0","49.45","28.74"
"65","000","00","140","0031","0663","716","429","287","28","744","1476","0","50.41","29.07"
"65","000","00","140","0031","0664","724","431","293","40","764","1506","0","50.73","28.62"
"65","000","00","140","0032","0000","1177","684","493","93","1270","2303","0","55.15","29.70"
"65","000","00","140","0032","0728","719","413","306","58","777","1414","0","54.95","29.21"
"65","000","00","140","0032","0729","458","271","187","35","493","889","0","55.46","30.48"
"65","000","00","140","0033","0000","1163","702","461","68","1231","2064","0","59.64","34.01"
"65","000","00","140","0033","0745","608","348","260","33","641","1120","0","57.23","31.07"
"65","000","00","140","0033","0746","555","354","201","35","590","944","0","62.50","37.50"
"65","000","00","140","0034","0000","1440","855","585","99","1539","2770","0","55.56","30.87"
"65","000","00","140","0034","0703","781","467","314","52","833","1574","0","52.92","29.67"
"65","000","00","140","0034","0704","659","388","271","47","706","1196","0","59.03","32.44"
"65","000","00","140","0035","0000","2471","1445","1026","144","2615","4470","0","58.50","32.33"
"65","000","00","140","0035","0648","769","461","308","55","824","1376","0","59.88","33.50"
"65","000","00","140","0035","0649","921","525","396","43","964","1595","0","60.44","32.92"
"65","000","00","140","0035","0650","781","459","322","46","827","1499","0","55.17","30.62"
"65","000","00","140","0036","0000","1851","1137","714","86","1937","3566","0","54.32","31.88"
"65","000","00","140","0036","0654","930","544","386","43","973","1809","0","53.79","30.07"
"65","000","00","140","0036","0655","921","593","328","43","964","1757","0","54.87","33.75"
"65","000","00","140","0037","0000","2941","1730","1211","155","3096","6450","0","48.00","26.82"
"65","000","00","140","0037","0680","726","415","311","47","773","1585","0","48.77","26.18"
"65","000","00","140","0037","0681","765","442","323","30","795","1655","0","48.04","26.71"
"65","000","00","140","0037","0682","759","451","308","46","805","1672","0","48.15","26.97"
"65","000","00","140","0037","0683","691","422","269","32","723","1538","0","47.01","27.44"
"65","000","00","140","0038","0000","1752","944","808","63","1815","3897","0","46.57","24.22"
"65","000","00","140","0038","0688","528","215","313","18","546","1341","0","40.72","16.03"
"65","000","00","140","0038","0689","633","382","251","23","656","1282","0","51.17","29.80"
"65","000","00","140","0038","0690","591","347","244","22","613","1274","0","48.12","27.24"
"65","000","00","150","0000","0000","39059","21821","17238","2156","41215","76129","91100","54.14","28.66"
"65","000","00","150","0001","0000","2180","1291","889","132","2312","4018","0","57.54","32.13"
"65","000","00","150","0001","0256","718","442","276","48","766","1333","0","57.46","33.16"
"65","000","00","150","0001","0257","711","423","288","49","760","1475","0","51.53","28.68"
"65","000","00","150","0001","0258","751","426","325","35","786","1210","0","64.96","35.21"
"65","000","00","150","0002","0000","615","402","213","40","655","1020","0","64.22","39.41"
"65","000","00","150","0002","0259","615","402","213","40","655","1020","0","64.22","39.41"
"65","000","00","150","0003","0000","1766","1034","732","99","1865","3372","0","55.31","30.66"
"65","000","00","150","0003","0261","830","502","328","37","867","1620","0","53.52","30.99"
"65","000","00","150","0003","0262","690","391","299","32","722","1304","0","55.37","29.98"
"65","000","00","150","0003","0263","246","141","105","30","276","448","0","61.61","31.47"
"65","000","00","150","0004","0000","723","452","271","68","791","1193","0","66.30","37.89"
"65","000","00","150","0004","0260","723","452","271","68","791","1193","0","66.30","37.89"
"65","000","00","150","0005","0000","2434","1478","956","187","2621","5310","0","49.36","27.83"
"65","000","00","150","0005","0269","658","404","254","68","726","1438","0","50.49","28.09"
"65","000","00","150","0005","0270","580","358","222","32","612","1240","0","49.35","28.87"
"65","000","00","150","0005","0271","630","382","248","53","683","1467","0","46.56","26.04"
"65","000","00","150","0005","0272","566","334","232","34","600","1165","0","51.50","28.67"
"65","000","00","150","0006","0000","3399","1975","1424","167","3566","7179","0","49.67","27.51"
"65","000","00","150","0006","0273","631","350","281","33","664","1442","0","46.05","24.27"
"65","000","00","150","0006","0274","770","421","349","23","793","1667","0","47.57","25.25"
"65","000","00","150","0006","0275","650","424","226","39","689","1288","0","53.49","32.92"
"65","000","00","150","0006","0276","632","381","251","43","675","1338","0","50.45","28.48"
"65","000","00","150","0006","0277","716","399","317","29","745","1444","0","51.59","27.63"
"65","000","00","150","0007","0000","656","440","216","48","704","1160","0","60.69","37.93"
"65","000","00","150","0007","0285","656","440","216","48","704","1160","0","60.69","37.93"
"65","000","00","150","0008","0000","1683","962","721","111","1794","3757","0","47.75","25.61"
"65","000","00","150","0008","0292","556","306","250","38","594","1571","0","37.81","19.48"
"65","000","00","150","0008","0293","563","301","262","31","594","1078","0","55.10","27.92"
"65","000","00","150","0008","0294","564","355","209","42","606","1108","0","54.69","32.04"
"65","000","00","150","0009","0000","1712","990","722","93","1805","2965","0","60.88","33.39"
"65","000","00","150","0009","0286","863","484","379","45","908","1481","0","61.31","32.68"
"65","000","00","150","0009","0287","849","506","343","48","897","1484","0","60.44","34.10"
"65","000","00","150","0010","0000","2474","1313","1161","145","2619","4758","0","55.04","27.60"
"65","000","00","150","0010","0295","874","482","392","50","924","1677","0","55.10","28.74"
"65","000","00","150","0010","0296","861","435","426","59","920","1664","0","55.29","26.14"
"65","000","00","150","0010","0297","739","396","343","36","775","1417","0","54.69","27.95"
"65","000","00","150","0011","0000","1238","435","803","126","1364","2255","0","60.49","19.29"
"65","000","00","150","0011","0310","607","216","391","61","668","1110","0","60.18","19.46"
"65","000","00","150","0011","0311","631","219","412","65","696","1145","0","60.79","19.13"
"65","000","00","150","0012","0000","1575","681","894","84","1659","2591","0","64.03","26.28"
"65","000","00","150","0012","0308","801","377","424","40","841","1294","0","64.99","29.13"
"65","000","00","150","0012","0309","774","304","470","44","818","1297","0","63.07","23.44"
"65","000","00","150","0013","0000","2072","1118","954","104","2176","3853","0","56.48","29.02"
"65","000","00","150","0013","0305","588","302","286","31","619","1195","0","51.80","25.27"
"65","000","00","150","0013","0306","705","379","326","31","736","1279","0","57.54","29.63"
"65","000","00","150","0013","0307","779","437","342","42","821","1379","0","59.54","31.69"
"65","000","00","150","0014","0000","1520","893","627","89","1609","2904","0","55.41","30.75"
"65","000","00","150","0014","0267","731","416","315","44","775","1494","0","51.87","27.84"
"65","000","00","150","0014","0268","789","477","312","45","834","1410","0","59.15","33.83"
"65","000","00","150","0015","0000","1799","902","897","74","1873","3393","0","55.20","26.58"
"65","000","00","150","0015","0288","918","462","456","44","962","1740","0","55.29","26.55"
"65","000","00","150","0015","0289","881","440","441","30","911","1653","0","55.11","26.62"
"65","000","00","150","0016","0000","1892","1090","802","99","1991","3665","0","54.32","29.74"
"65","000","00","150","0016","0264","725","412","313","37","762","1388","0","54.90","29.68"
"65","000","00","150","0016","0265","547","342","205","33","580","1064","0","54.51","32.14"
"65","000","00","150","0016","0266","620","336","284","29","649","1213","0","53.50","27.70"
"65","000","00","150","0017","0000","1618","922","696","70","1688","3122","0","54.07","29.53"
"65","000","00","150","0017","0290","722","401","321","33","755","1449","0","52.10","27.67"
"65","000","00","150","0017","0291","896","521","375","37","933","1673","0","55.77","31.14"
"65","000","00","150","0018","0000","4725","2613","2112","169","4894","9851","0","49.68","26.53"
"65","000","00","150","0018","0278","605","325","280","16","621","1262","0","49.21","25.75"
"65","000","00","150","0018","0279","613","331","282","14","627","1429","0","43.88","23.16"
"65","000","00","150","0018","0280","690","365","325","13","703","1432","0","49.09","25.49"
"65","000","00","150","0018","0281","739","412","327","34","773","1705","0","45.34","24.16"
"65","000","00","150","0018","0282","740","406","334","41","781","1438","0","54.31","28.23"
"65","000","00","150","0018","0283","682","399","283","28","710","1374","0","51.67","29.04"
"65","000","00","150","0018","0284","656","375","281","23","679","1211","0","56.07","30.97"
"65","000","00","150","0019","0000","3461","1986","1475","159","3620","6817","0","53.10","29.13"
"65","000","00","150","0019","0300","747","420","327","50","797","1492","0","53.42","28.15"
"65","000","00","150","0019","0301","633","371","262","36","669","1263","0","52.97","29.37"
"65","000","00","150","0019","0302","643","381","262","24","667","1284","0","51.95","29.67"
"65","000","00","150","0019","0303","703","400","303","29","732","1386","0","52.81","28.86"
"65","000","00","150","0019","0304","735","414","321","20","755","1392","0","54.24","29.74"
"65","000","00","150","0020","0000","1517","844","673","92","1609","2946","0","54.62","28.65"
"65","000","00","150","0020","0298","801","428","373","50","851","1469","0","57.93","29.14"
"65","000","00","150","0020","0299","716","416","300","42","758","1477","0","51.32","28.17"
"65","000","00","160","0000","0000","33079","17765","15314","1661","34740","62435","76759","55.64","28.45"
"65","000","00","160","0001","0000","510","277","233","30","540","771","0","70.04","35.93"
"65","000","00","160","0001","0312","392","207","185","28","420","617","0","68.07","33.55"
"65","000","00","160","0001","0313","118","70","48","2","120","154","0","77.92","45.45"
"65","000","00","160","0002","0000","1654","896","758","102","1756","2931","0","59.91","30.57"
"65","000","00","160","0002","0314","803","444","359","62","865","1378","0","62.77","32.22"
"65","000","00","160","0002","0315","851","452","399","40","891","1553","0","57.37","29.10"
"65","000","00","160","0003","0000","2924","1535","1389","154","3078","5820","0","52.89","26.37"
"65","000","00","160","0003","0316","798","416","382","26","824","1633","0","50.46","25.47"
"65","000","00","160","0003","0317","919","490","429","48","967","1800","0","53.72","27.22"
"65","000","00","160","0003","0318","565","273","292","35","600","1157","0","51.86","23.60"
"65","000","00","160","0003","0319","642","356","286","45","687","1230","0","55.85","28.94"
"65","000","00","160","0004","0000","1315","777","538","91","1406","2380","0","59.08","32.65"
"65","000","00","160","0004","0320","683","399","284","54","737","1178","0","62.56","33.87"
"65","000","00","160","0004","0321","632","378","254","37","669","1202","0","55.66","31.45"
"65","000","00","160","0005","0000","1955","1070","885","104","2059","3729","0","55.22","28.69"
"65","000","00","160","0005","0324","645","329","316","39","684","1255","0","54.50","26.22"
"65","000","00","160","0005","0325","579","328","251","33","612","1207","0","50.70","27.17"
"65","000","00","160","0005","0326","731","413","318","32","763","1267","0","60.22","32.60"
"65","000","00","160","0006","0000","1887","976","911","113","2000","3471","0","57.62","28.12"
"65","000","00","160","0006","0327","693","339","354","35","728","1271","0","57.28","26.67"
"65","000","00","160","0006","0328","655","350","305","40","695","1183","0","58.75","29.59"
"65","000","00","160","0006","0329","539","287","252","38","577","1017","0","56.74","28.22"
"65","000","00","160","0007","0000","2036","1096","940","103","2139","4034","0","53.02","27.17"
"65","000","00","160","0007","0338","699","391","308","26","725","1349","0","53.74","28.98"
"65","000","00","160","0007","0339","712","379","333","46","758","1409","0","53.80","26.90"
"65","000","00","160","0007","0340","625","326","299","31","656","1276","0","51.41","25.55"
"65","000","00","160","0008","0000","1809","930","879","100","1909","3223","0","59.23","28.86"
"65","000","00","160","0008","0346","648","341","307","54","702","1218","0","57.64","28.00"
"65","000","00","160","0008","0347","559","288","271","24","583","1013","0","57.55","28.43"
"65","000","00","160","0008","0348","602","301","301","22","624","992","0","62.90","30.34"
"65","000","00","160","0009","0000","1779","968","811","93","1872","3450","0","54.26","28.06"
"65","000","00","160","0009","0353","591","316","275","20","611","1161","0","52.63","27.22"
"65","000","00","160","0009","0354","704","402","302","31","735","1292","0","56.89","31.11"
"65","000","00","160","0009","0355","484","250","234","42","526","997","0","52.76","25.08"
"65","000","00","160","0010","0000","2310","1248","1062","120","2430","4297","0","56.55","29.04"
"65","000","00","160","0010","0359","728","393","335","24","752","1361","0","55.25","28.88"
"65","000","00","160","0010","0360","738","381","357","51","789","1315","0","60.00","28.97"
"65","000","00","160","0010","0361","844","474","370","45","889","1621","0","54.84","29.24"
"65","000","00","160","0011","0000","1659","956","703","83","1742","3107","0","56.07","30.77"
"65","000","00","160","0011","0330","564","323","241","31","595","1047","0","56.83","30.85"
"65","000","00","160","0011","0331","559","324","235","27","586","1059","0","55.34","30.59"
"65","000","00","160","0011","0332","536","309","227","25","561","1001","0","56.04","30.87"
"65","000","00","160","0012","0000","3620","1999","1621","149","3769","7001","0","53.84","28.55"
"65","000","00","160","0012","0341","743","410","333","35","778","1449","0","53.69","28.30"
"65","000","00","160","0012","0342","760","424","336","37","797","1477","0","53.96","28.71"
"65","000","00","160","0012","0343","607","349","258","29","636","1267","0","50.20","27.55"
"65","000","00","160","0012","0344","805","427","378","32","837","1522","0","54.99","28.06"
"65","000","00","160","0012","0345","705","389","316","16","721","1286","0","56.07","30.25"
"65","000","00","160","0013","0000","1059","554","505","69","1128","1755","0","64.27","31.57"
"65","000","00","160","0013","0349","553","285","268","39","592","936","0","63.25","30.45"
"65","000","00","160","0013","0350","506","269","237","30","536","819","0","65.45","32.84"
"65","000","00","160","0014","0000","1585","848","737","89","1674","2776","0","60.30","30.55"
"65","000","00","160","0014","0351","775","416","359","44","819","1348","0","60.76","30.86"
"65","000","00","160","0014","0352","810","432","378","45","855","1428","0","59.87","30.25"
"65","000","00","160","0015","0000","1934","998","936","75","2009","3197","0","62.84","31.22"
"65","000","00","160","0015","0356","705","354","351","25","730","1082","0","67.47","32.72"
"65","000","00","160","0015","0357","609","302","307","25","634","1107","0","57.27","27.28"
"65","000","00","160","0015","0358","620","342","278","25","645","1008","0","63.99","33.93"
"65","000","00","160","0016","0000","1538","795","743","52","1590","3046","0","52.20","26.10"
"65","000","00","160","0016","0322","762","387","375","25","787","1446","0","54.43","26.76"
"65","000","00","160","0016","0323","776","408","368","27","803","1600","0","50.19","25.50"
"65","000","00","160","0017","0000","3505","1842","1663","134","3639","7447","0","48.87","24.73"
"65","000","00","160","0017","0333","633","346","287","29","662","1566","0","42.27","22.09"
"65","000","00","160","0017","0334","736","399","337","24","760","1554","0","48.91","25.68"
"65","000","00","160","0017","0335","831","425","406","27","858","1615","0","53.13","26.32"
"65","000","00","160","0017","0336","710","337","373","22","732","1459","0","50.17","23.10"
"65","000","00","160","0017","0337","595","335","260","32","627","1253","0","50.04","26.74"
"65","000","00","170","0000","0000","48379","25051","23328","1817","50196","97096","126670","51.70","25.80"
"65","000","00","170","0001","0000","1599","915","684","109","1708","3345","0","51.06","27.35"
"65","000","00","170","0001","0177","560","308","252","49","609","1144","0","53.23","26.92"
"65","000","00","170","0001","0178","484","281","203","34","518","1060","0","48.87","26.51"
"65","000","00","170","0001","0179","555","326","229","26","581","1141","0","50.92","28.57"
"65","000","00","170","0002","0000","2253","1202","1051","124","2377","4711","0","50.46","25.51"
"65","000","00","170","0002","0180","648","338","310","30","678","1374","0","49.34","24.60"
"65","000","00","170","0002","0181","572","293","279","27","599","1115","0","53.72","26.28"
"65","000","00","170","0002","0182","518","282","236","29","547","1177","0","46.47","23.96"
"65","000","00","170","0002","0183","515","289","226","38","553","1045","0","52.92","27.66"
"65","000","00","170","0003","0000","4500","2376","2124","157","4657","9458","0","49.24","25.12"
"65","000","00","170","0003","0184","573","329","244","36","609","1283","0","47.47","25.64"
"65","000","00","170","0003","0185","472","244","228","28","500","1326","0","37.71","18.40"
"65","000","00","170","0003","0186","676","340","336","28","704","1354","0","51.99","25.11"
"65","000","00","170","0003","0187","786","410","376","11","797","1405","0","56.73","29.18"
"65","000","00","170","0003","0188","716","379","337","17","733","1329","0","55.15","28.52"
"65","000","00","170","0003","0189","707","363","344","20","727","1402","0","51.85","25.89"
"65","000","00","170","0003","0190","570","311","259","17","587","1359","0","43.19","22.88"
"65","000","00","170","0004","0000","1869","1023","846","77","1946","3568","0","54.54","28.67"
"65","000","00","170","0004","0191","693","386","307","36","729","1301","0","56.03","29.67"
"65","000","00","170","0004","0192","495","294","201","26","521","1059","0","49.20","27.76"
"65","000","00","170","0004","0193","681","343","338","15","696","1208","0","57.62","28.39"
"65","000","00","170","0005","0000","2048","1104","944","114","2162","4365","0","49.53","25.29"
"65","000","00","170","0005","0194","654","379","275","51","705","1320","0","53.41","28.71"
"65","000","00","170","0005","0195","676","329","347","38","714","1504","0","47.47","21.88"
"65","000","00","170","0005","0196","718","396","322","25","743","1541","0","48.22","25.70"
"65","000","00","170","0006","0000","756","460","296","55","811","1297","0","62.53","35.47"
"65","000","00","170","0006","0197","756","460","296","55","811","1297","0","62.53","35.47"
"65","000","00","170","0007","0000","10172","5041","5131","245","10417","20873","0","49.91","24.15"
"65","000","00","170","0007","0198","545","249","296","13","558","1168","0","47.77","21.32"
"65","000","00","170","0007","0199","552","268","284","17","569","1222","0","46.56","21.93"
"65","000","00","170","0007","0200","611","295","316","12","623","1358","0","45.88","21.72"
"65","000","00","170","0007","0201","702","317","385","13","715","1468","0","48.71","21.59"
"65","000","00","170","0007","0202","661","336","325","11","672","1317","0","51.03","25.51"
"65","000","00","170","0007","0203","543","234","309","12","555","1130","0","49.12","20.71"
"65","000","00","170","0007","0204","567","255","312","17","584","1112","0","52.52","22.93"
"65","000","00","170","0007","0205","638","335","303","13","651","1256","0","51.83","26.67"
"65","000","00","170","0007","0206","679","331","348","9","688","1280","0","53.75","25.86"
"65","000","00","170","0007","0207","693","380","313","10","703","1237","0","56.83","30.72"
"65","000","00","170","0007","0208","733","362","371","19","752","1313","0","57.27","27.57"
"65","000","00","170","0007","0209","583","328","255","18","601","1264","0","47.55","25.95"
"65","000","00","170","0007","0210","545","284","261","23","568","1130","0","50.27","25.13"
"65","000","00","170","0007","0211","501","249","252","12","513","1056","0","48.58","23.58"
"65","000","00","170","0007","0212","593","286","307","17","610","1244","0","49.04","22.99"
"65","000","00","170","0007","0213","542","271","271","14","556","1107","0","50.23","24.48"
"65","000","00","170","0007","0214","484","261","223","15","499","1211","0","41.21","21.55"
"65","000","00","170","0008","0000","10594","5423","5171","222","10816","21452","0","50.42","25.28"
"65","000","00","170","0008","0215","590","308","282","21","611","1086","0","56.26","28.36"
"65","000","00","170","0008","0216","522","273","249","23","545","1067","0","51.08","25.59"
"65","000","00","170","0008","0217","535","291","244","12","547","1044","0","52.39","27.87"
"65","000","00","170","0008","0218","571","335","236","12","583","1229","0","47.44","27.26"
"65","000","00","170","0008","0219","584","286","298","8","592","1129","0","52.44","25.33"
"65","000","00","170","0008","0220","548","287","261","13","561","1084","0","51.75","26.48"
"65","000","00","170","0008","0221","566","273","293","10","576","1056","0","54.55","25.85"
"65","000","00","170","0008","0222","656","301","355","4","660","1309","0","50.42","22.99"
"65","000","00","170","0008","0223","594","286","308","13","607","1184","0","51.27","24.16"
"65","000","00","170","0008","0224","597","307","290","11","608","1197","0","50.79","25.65"
"65","000","00","170","0008","0225","581","283","298","11","592","1239","0","47.78","22.84"
"65","000","00","170","0008","0226","683","374","309","12","695","1387","0","50.11","26.96"
"65","000","00","170","0008","0227","637","325","312","16","653","1458","0","44.79","22.29"
"65","000","00","170","0008","0228","852","431","421","11","863","1778","0","48.54","24.24"
"65","000","00","170","0008","0229","747","393","354","10","757","1485","0","50.98","26.46"
"65","000","00","170","0008","0230","711","346","365","20","731","1414","0","51.70","24.47"
"65","000","00","170","0008","0231","620","324","296","15","635","1306","0","48.62","24.81"
"65","000","00","170","0009","0000","3261","1676","1585","126","3387","6357","0","53.28","26.36"
"65","000","00","170","0009","0243","661","340","321","29","690","1258","0","54.85","27.03"
"65","000","00","170","0009","0244","662","315","347","24","686","1269","0","54.06","24.82"
"65","000","00","170","0009","0245","670","330","340","31","701","1242","0","56.44","26.57"
"65","000","00","170","0009","0246","711","388","323","24","735","1276","0","57.60","30.41"
"65","000","00","170","0009","0247","557","303","254","18","575","1312","0","43.83","23.09"
"65","000","00","170","0010","0000","472","315","157","47","519","953","0","54.46","33.05"
"65","000","00","170","0010","0251","472","315","157","47","519","953","0","54.46","33.05"
"65","000","00","170","0011","0000","657","371","286","46","703","1182","0","59.48","31.39"
"65","000","00","170","0011","0252","657","371","286","46","703","1182","0","59.48","31.39"
"65","000","00","170","0012","0000","569","333","236","80","649","860","0","75.47","38.72"
"65","000","00","170","0012","0253","569","333","236","80","649","860","0","75.47","38.72"
"65","000","00","170","0013","0000","513","285","228","53","566","736","0","76.90","38.72"
"65","000","00","170","0013","0254","513","285","228","53","566","736","0","76.90","38.72"
"65","000","00","170","0014","0000","863","528","335","92","955","1422","0","67.16","37.13"
"65","000","00","170","0014","0255","863","528","335","92","955","1422","0","67.16","37.13"
"65","000","00","170","0015","0000","2974","1406","1568","76","3050","5780","0","52.77","24.33"
"65","000","00","170","0015","0232","477","228","249","10","487","1049","0","46.43","21.73"
"65","000","00","170","0015","0233","573","270","303","17","590","1125","0","52.44","24.00"
"65","000","00","170","0015","0234","571","283","288","14","585","1144","0","51.14","24.74"
"65","000","00","170","0015","0235","614","270","344","18","632","1117","0","56.58","24.17"
"65","000","00","170","0015","0236","739","355","384","17","756","1345","0","56.21","26.39"
"65","000","00","170","0016","0000","3568","1702","1866","120","3688","7286","0","50.62","23.36"
"65","000","00","170","0016","0237","631","303","328","21","652","1325","0","49.21","22.87"
"65","000","00","170","0016","0238","502","250","252","17","519","1104","0","47.01","22.64"
"65","000","00","170","0016","0239","549","246","303","18","567","1153","0","49.18","21.34"
"65","000","00","170","0016","0240","588","261","327","18","606","1179","0","51.40","22.14"
"65","000","00","170","0016","0241","663","306","357","24","687","1335","0","51.46","22.92"
"65","000","00","170","0016","0242","635","336","299","22","657","1190","0","55.21","28.24"
"65","000","00","170","0017","0000","1711","891","820","74","1785","3451","0","51.72","25.82"
"65","000","00","170","0017","0248","571","313","258","28","599","1244","0","48.15","25.16"
"65","000","00","170","0017","0249","545","270","275","19","564","1107","0","50.95","24.39"
"65","000","00","170","0017","0250","595","308","287","27","622","1100","0","56.55","28.00"
"65","000","00","180","0000","0000","10695","5268","5427","626","11321","20295","23479","55.78","25.96"
"65","000","00","180","0001","0000","1489","712","777","65","1554","3014","0","51.56","23.62"
"65","000","00","180","0001","2363","715","310","405","34","749","1489","0","50.30","20.82"
"65","000","00","180","0001","2364","774","402","372","31","805","1525","0","52.79","26.36"
"65","000","00","180","0002","0000","1164","635","529","72","1236","2247","0","55.01","28.26"
"65","000","00","180","0002","2357","553","298","255","21","574","1126","0","50.98","26.47"
"65","000","00","180","0002","2358","611","337","274","51","662","1121","0","59.05","30.06"
"65","000","00","180","0003","0000","1272","649","623","109","1381","2648","0","52.15","24.51"
"65","000","00","180","0003","2361","613","313","300","61","674","1330","0","50.68","23.53"
"65","000","00","180","0003","2362","659","336","323","48","707","1318","0","53.64","25.49"
"65","000","00","180","0004","0000","1042","474","568","63","1105","1838","0","60.12","25.79"
"65","000","00","180","0004","2369","425","228","197","32","457","744","0","61.42","30.65"
"65","000","00","180","0004","2370","617","246","371","31","648","1094","0","59.23","22.49"
"65","000","00","180","0005","0000","355","176","179","36","391","550","0","71.09","32.00"
"65","000","00","180","0005","2373","355","176","179","36","391","550","0","71.09","32.00"
"65","000","00","180","0006","0000","2921","1448","1473","122","3043","5520","0","55.13","26.23"
"65","000","00","180","0006","2365","735","366","369","33","768","1394","0","55.09","26.26"
"65","000","00","180","0006","2366","734","337","397","35","769","1361","0","56.50","24.76"
"65","000","00","180","0006","2367","641","322","319","24","665","1314","0","50.61","24.51"
"65","000","00","180","0006","2368","811","423","388","30","841","1451","0","57.96","29.15"
"65","000","00","180","0007","0000","1177","592","585","90","1267","2405","0","52.68","24.62"
"65","000","00","180","0007","2359","513","277","236","46","559","1029","0","54.32","26.92"
"65","000","00","180","0007","2360","664","315","349","44","708","1376","0","51.45","22.89"
"65","000","00","180","0008","0000","1275","582","693","69","1344","2073","0","64.83","28.08"
"65","000","00","180","0008","2371","812","375","437","51","863","1352","0","63.83","27.74"
"65","000","00","180","0008","2372","463","207","256","18","481","721","0","66.71","28.71"
"65","000","00","190","0000","0000","3306","2003","1303","374","3680","6508","7308","56.55","30.78"
"65","000","00","190","0001","0000","200","117","83","15","215","365","0","58.90","32.05"
"65","000","00","190","0001","2374","200","117","83","15","215","365","0","58.90","32.05"
"65","000","00","190","0002","0000","314","169","145","7","321","759","0","42.29","22.27"
"65","000","00","190","0002","2375","314","169","145","7","321","759","0","42.29","22.27"
"65","000","00","190","0003","0000","288","172","116","39","327","627","0","52.15","27.43"
"65","000","00","190","0003","2380","288","172","116","39","327","627","0","52.15","27.43"
"65","000","00","190","0004","0000","305","204","101","59","364","567","0","64.20","35.98"
"65","000","00","190","0004","2376","305","204","101","59","364","567","0","64.20","35.98"
"65","000","00","190","0005","0000","140","81","59","18","158","281","0","56.23","28.83"
"65","000","00","190","0005","2377","140","81","59","18","158","281","0","56.23","28.83"
"65","000","00","190","0006","0000","203","121","82","18","221","363","0","60.88","33.33"
"65","000","00","190","0006","2378","144","81","63","9","153","278","0","55.04","29.14"
"65","000","00","190","0006","2379","59","40","19","9","68","85","0","80.00","47.06"
"65","000","00","190","0007","0000","310","200","110","34","344","573","0","60.03","34.90"
"65","000","00","190","0007","2383","310","200","110","34","344","573","0","60.03","34.90"
"65","000","00","190","0008","0000","340","201","139","59","399","674","0","59.20","29.82"
"65","000","00","190","0008","2382","340","201","139","59","399","674","0","59.20","29.82"
"65","000","00","190","0009","0000","186","112","74","12","198","260","0","76.15","43.08"
"65","000","00","190","0009","2384","186","112","74","12","198","260","0","76.15","43.08"
"65","000","00","190","0010","0000","115","63","52","6","121","283","0","42.76","22.26"
"65","000","00","190","0010","2381","115","63","52","6","121","283","0","42.76","22.26"
"65","000","00","190","0011","0000","432","246","186","56","488","792","0","61.62","31.06"
"65","000","00","190","0011","2385","432","246","186","56","488","792","0","61.62","31.06"
"65","000","00","190","0012","0000","473","317","156","51","524","964","0","54.36","32.88"
"65","000","00","190","0012","2386","473","317","156","51","524","964","0","54.36","32.88"
"65","000","00","200","0000","0000","3452","2007","1445","427","3879","5889","6559","65.87","34.08"
"65","000","00","200","0001","0000","436","243","193","51","487","832","0","58.53","29.21"
"65","000","00","200","0001","2391","326","182","144","45","371","575","0","64.52","31.65"
"65","000","00","200","0001","2392","110","61","49","6","116","257","0","45.14","23.74"
"65","000","00","200","0002","0000","706","393","313","86","792","1261","0","62.81","31.17"
"65","000","00","200","0002","2387","706","393","313","86","792","1261","0","62.81","31.17"
"65","000","00","200","0003","0000","797","468","329","91","888","1111","0","79.93","42.12"
"65","000","00","200","0003","2389","797","468","329","91","888","1111","0","79.93","42.12"
"65","000","00","200","0004","0000","200","122","78","17","217","408","0","53.19","29.90"
"65","000","00","200","0004","2390","200","122","78","17","217","408","0","53.19","29.90"
"65","000","00","200","0005","0000","444","243","201","62","506","808","0","62.62","30.07"
"65","000","00","200","0005","2393","174","110","64","21","195","334","0","58.38","32.93"
"65","000","00","200","0005","2394","270","133","137","41","311","474","0","65.61","28.06"
"65","000","00","200","0006","0000","385","235","150","31","416","643","0","64.70","36.55"
"65","000","00","200","0006","2388","385","235","150","31","416","643","0","64.70","36.55"
"65","000","00","200","0007","0000","484","303","181","89","573","826","0","69.37","36.68"
"65","000","00","200","0007","2395","240","149","91","43","283","385","0","73.51","38.70"
"65","000","00","200","0007","2396","244","154","90","46","290","441","0","65.76","34.92"
"65","000","00","210","0000","0000","9489","4879","4610","972","10461","19360","22204","54.03","25.20"
"65","000","00","210","0001","0000","208","125","83","35","243","294","0","82.65","42.52"
"65","000","00","210","0001","0011","208","125","83","35","243","294","0","82.65","42.52"
"65","000","00","210","0002","0000","2180","1052","1128","177","2357","4660","0","50.58","22.58"
"65","000","00","210","0002","0012","571","274","297","53","624","1195","0","52.22","22.93"
"65","000","00","210","0002","0013","593","270","323","68","661","1189","0","55.59","22.71"
"65","000","00","210","0002","0014","537","276","261","26","563","1232","0","45.70","22.40"
"65","000","00","210","0002","0015","479","232","247","30","509","1044","0","48.75","22.22"
"65","000","00","210","0003","0000","608","307","301","69","677","1113","0","60.83","27.58"
"65","000","00","210","0003","0016","608","307","301","69","677","1113","0","60.83","27.58"
"65","000","00","210","0004","0000","374","180","194","30","404","743","0","54.37","24.23"
"65","000","00","210","0004","0017","374","180","194","30","404","743","0","54.37","24.23"
"65","000","00","210","0005","0000","2653","1350","1303","253","2906","6025","0","48.23","22.41"
"65","000","00","210","0005","0018","543","276","267","35","578","1250","0","46.24","22.08"
"65","000","00","210","0005","0019","560","307","253","33","593","1305","0","45.44","23.52"
"65","000","00","210","0005","0020","505","267","238","81","586","1150","0","50.96","23.22"
"65","000","00","210","0005","0021","527","254","273","45","572","1193","0","47.95","21.29"
"65","000","00","210","0005","0022","518","246","272","59","577","1127","0","51.20","21.83"
"65","000","00","210","0006","0000","328","170","158","26","354","573","0","61.78","29.67"
"65","000","00","210","0006","0023","328","170","158","26","354","573","0","61.78","29.67"
"65","000","00","210","0007","0000","294","148","146","62","356","474","0","75.11","31.22"
"65","000","00","210","0007","0024","294","148","146","62","356","474","0","75.11","31.22"
"65","000","00","210","0008","0000","313","177","136","29","342","625","0","54.72","28.32"
"65","000","00","210","0008","0025","313","177","136","29","342","625","0","54.72","28.32"
"65","000","00","210","0009","0000","998","473","525","85","1083","1944","0","55.71","24.33"
"65","000","00","210","0009","0026","444","215","229","66","510","812","0","62.81","26.48"
"65","000","00","210","0009","0027","554","258","296","19","573","1132","0","50.62","22.79"
"65","000","00","210","0010","0000","367","202","165","47","414","715","0","57.90","28.25"
"65","000","00","210","0010","0028","367","202","165","47","414","715","0","57.90","28.25"
"65","000","00","210","0011","0000","290","159","131","59","349","508","0","68.70","31.30"
"65","000","00","210","0011","0029","290","159","131","59","349","508","0","68.70","31.30"
"65","000","00","210","0012","0000","305","175","130","50","355","543","0","65.38","32.23"
"65","000","00","210","0012","0030","305","175","130","50","355","543","0","65.38","32.23"
"65","000","00","210","0013","0000","571","361","210","50","621","1143","0","54.33","31.58"
"65","000","00","210","0013","0031","571","361","210","50","621","1143","0","54.33","31.58"
"65","000","00","220","0000","0000","5397","2858","2539","816","6213","9695","10977","64.08","29.48"
"65","000","00","220","0001","0000","650","349","301","94","744","1064","0","69.92","32.80"
"65","000","00","220","0001","0001","650","349","301","94","744","1064","0","69.92","32.80"
"65","000","00","220","0002","0000","615","316","299","79","694","1267","0","54.78","24.94"
"65","000","00","220","0002","0002","615","316","299","79","694","1267","0","54.78","24.94"
"65","000","00","220","0003","0000","1015","547","468","149","1164","1967","0","59.18","27.81"
"65","000","00","220","0003","0003","454","239","215","55","509","850","0","59.88","28.12"
"65","000","00","220","0003","0004","561","308","253","94","655","1117","0","58.64","27.57"
"65","000","00","220","0004","0000","436","255","181","68","504","832","0","60.58","30.65"
"65","000","00","220","0004","0005","436","255","181","68","504","832","0","60.58","30.65"
"65","000","00","220","0005","0000","927","457","470","125","1052","1464","0","71.86","31.22"
"65","000","00","220","0005","0006","927","457","470","125","1052","1464","0","71.86","31.22"
"65","000","00","220","0006","0000","706","373","333","122","828","1396","0","59.31","26.72"
"65","000","00","220","0006","0007","706","373","333","122","828","1396","0","59.31","26.72"
"65","000","00","220","0007","0000","128","68","60","21","149","277","0","53.79","24.55"
"65","000","00","220","0007","0008","128","68","60","21","149","277","0","53.79","24.55"
"65","000","00","220","0008","0000","356","182","174","45","401","551","0","72.78","33.03"
"65","000","00","220","0008","0009","356","182","174","45","401","551","0","72.78","33.03"
"65","000","00","220","0009","0000","564","311","253","113","677","877","0","77.19","35.46"
"65","000","00","220","0009","0010","564","311","253","113","677","877","0","77.19","35.46"
"65","000","00","230","0000","0000","17326","9474","7852","1098","18424","34332","40706","53.66","27.60"
"65","000","00","230","0001","0000","3249","1914","1335","193","3442","6598","0","52.17","29.01"
"65","000","00","230","0001","0149","713","413","300","45","758","1451","0","52.24","28.46"
"65","000","00","230","0001","0150","599","301","298","31","630","1351","0","46.63","22.28"
"65","000","00","230","0001","0151","596","512","84","44","640","1237","0","51.74","41.39"
"65","000","00","230","0001","0152","706","362","344","24","730","1270","0","57.48","28.50"
"65","000","00","230","0001","0153","635","326","309","49","684","1289","0","53.06","25.29"
"65","000","00","230","0002","0000","1692","914","778","111","1803","3283","0","54.92","27.84"
"65","000","00","230","0002","0154","505","275","230","41","546","1102","0","49.55","24.95"
"65","000","00","230","0002","0155","573","325","248","35","608","1035","0","58.74","31.40"
"65","000","00","230","0002","0156","614","314","300","35","649","1146","0","56.63","27.40"
"65","000","00","230","0003","0000","1727","907","820","93","1820","3025","0","60.17","29.98"
"65","000","00","230","0003","0157","571","307","264","43","614","998","0","61.52","30.76"
"65","000","00","230","0003","0158","573","280","293","26","599","976","0","61.37","28.69"
"65","000","00","230","0003","0159","583","320","263","24","607","1051","0","57.75","30.45"
"65","000","00","230","0004","0000","2087","1189","898","112","2199","3981","0","55.24","29.87"
"65","000","00","230","0004","0160","774","446","328","46","820","1465","0","55.97","30.44"
"65","000","00","230","0004","0161","664","367","297","35","699","1266","0","55.21","28.99"
"65","000","00","230","0004","0162","649","376","273","31","680","1250","0","54.40","30.08"
"65","000","00","230","0005","0000","1137","586","551","64","1201","2166","0","55.45","27.05"
"65","000","00","230","0005","0163","664","339","325","40","704","1094","0","64.35","30.99"
"65","000","00","230","0005","0164","473","247","226","24","497","1072","0","46.36","23.04"
"65","000","00","230","0006","0000","3031","1653","1378","150","3181","6334","0","50.22","26.10"
"65","000","00","230","0006","0165","610","336","274","34","644","1205","0","53.44","27.88"
"65","000","00","230","0006","0166","579","319","260","33","612","1273","0","48.08","25.06"
"65","000","00","230","0006","0167","622","334","288","23","645","1335","0","48.31","25.02"
"65","000","00","230","0006","0168","640","338","302","27","667","1242","0","53.70","27.21"
"65","000","00","230","0006","0169","580","326","254","33","613","1279","0","47.93","25.49"
"65","000","00","230","0007","0000","2245","1202","1043","161","2406","4479","0","53.72","26.84"
"65","000","00","230","0007","0170","609","330","279","45","654","1065","0","61.41","30.99"
"65","000","00","230","0007","0171","571","295","276","35","606","1248","0","48.56","23.64"
"65","000","00","230","0007","0172","555","302","253","51","606","1119","0","54.16","26.99"
"65","000","00","230","0007","0173","510","275","235","30","540","1047","0","51.58","26.27"
"65","000","00","230","0008","0000","746","403","343","66","812","1577","0","51.49","25.55"
"65","000","00","230","0008","0174","746","403","343","66","812","1577","0","51.49","25.55"
"65","000","00","230","0009","0000","664","355","309","53","717","1471","0","48.74","24.13"
"65","000","00","230","0009","0175","664","355","309","53","717","1471","0","48.74","24.13"
"65","000","00","230","0010","0000","748","351","397","95","843","1418","0","59.45","24.75"
"65","000","00","230","0010","0176","748","351","397","95","843","1418","0","59.45","24.75"
"65","000","00","240","0000","0000","2229","1274","955","299","2528","3975","4298","63.60","32.05"
"65","000","00","240","0001","0000","180","103","77","21","201","349","0","57.59","29.51"
"65","000","00","240","0001","2404","180","103","77","21","201","349","0","57.59","29.51"
"65","000","00","240","0002","0000","168","103","65","13","181","239","0","75.73","43.10"
"65","000","00","240","0002","2405","168","103","65","13","181","239","0","75.73","43.10"
"65","000","00","240","0003","0000","155","95","60","17","172","221","0","77.83","42.99"
"65","000","00","240","0003","2406","155","95","60","17","172","221","0","77.83","42.99"
"65","000","00","240","0004","0000","208","138","70","24","232","388","0","59.79","35.57"
"65","000","00","240","0004","2407","208","138","70","24","232","388","0","59.79","35.57"
"65","000","00","240","0005","0000","101","52","49","26","127","227","0","55.95","22.91"
"65","000","00","240","0005","2408","101","52","49","26","127","227","0","55.95","22.91"
"65","000","00","240","0006","0000","339","189","150","40","379","581","0","65.23","32.53"
"65","000","00","240","0006","2409","339","189","150","40","379","581","0","65.23","32.53"
"65","000","00","240","0007","0000","225","116","109","29","254","406","0","62.56","28.57"
"65","000","00","240","0007","2410","225","116","109","29","254","406","0","62.56","28.57"
"65","000","00","240","0008","0000","79","47","32","13","92","146","0","63.01","32.19"
"65","000","00","240","0008","2412","79","47","32","13","92","146","0","63.01","32.19"
"65","000","00","240","0009","0000","192","108","84","30","222","323","0","68.73","33.44"
"65","000","00","240","0009","2413","192","108","84","30","222","323","0","68.73","33.44"
"65","000","00","240","0010","0000","91","52","39","7","98","154","0","63.64","33.77"
"65","000","00","240","0010","2415","91","52","39","7","98","154","0","63.64","33.77"
"65","000","00","240","0011","0000","410","227","183","60","470","795","0","59.12","28.55"
"65","000","00","240","0011","2411","410","227","183","60","470","795","0","59.12","28.55"
"65","000","00","240","0012","0000","81","44","37","19","100","146","0","68.49","30.14"
"65","000","00","240","0012","2414","81","44","37","19","100","146","0","68.49","30.14"
"65","000","00","250","0000","0000","3944","2074","1870","447","4391","7383","8159","59.47","28.09"
"65","000","00","250","0001","0000","216","97","119","36","252","416","0","60.58","23.32"
"65","000","00","250","0001","2463","216","97","119","36","252","416","0","60.58","23.32"
"65","000","00","250","0002","0000","188","103","85","18","206","340","0","60.59","30.29"
"65","000","00","250","0002","2475","188","103","85","18","206","340","0","60.59","30.29"
"65","000","00","250","0003","0000","381","185","196","55","436","691","0","63.10","26.77"
"65","000","00","250","0003","2464","119","53","66","22","141","257","0","54.86","20.62"
"65","000","00","250","0003","2465","262","132","130","33","295","434","0","67.97","30.41"
"65","000","00","250","0004","0000","321","173","148","25","346","635","0","54.49","27.24"
"65","000","00","250","0004","2476","175","94","81","18","193","314","0","61.46","29.94"
"65","000","00","250","0004","2477","146","79","67","7","153","321","0","47.66","24.61"
"65","000","00","250","0005","0000","156","83","73","16","172","321","0","53.58","25.86"
"65","000","00","250","0005","2466","156","83","73","16","172","321","0","53.58","25.86"
"65","000","00","250","0006","0000","689","356","333","107","796","1364","0","58.36","26.10"
"65","000","00","250","0006","2467","405","218","187","61","466","775","0","60.13","28.13"
"65","000","00","250","0006","2468","284","138","146","46","330","589","0","56.03","23.43"
"65","000","00","250","0007","0000","269","164","105","22","291","384","0","75.78","42.71"
"65","000","00","250","0007","2469","269","164","105","22","291","384","0","75.78","42.71"
"65","000","00","250","0008","0000","387","213","174","32","419","822","0","50.97","25.91"
"65","000","00","250","0008","2470","272","148","124","17","289","577","0","50.09","25.65"
"65","000","00","250","0008","2471","115","65","50","15","130","245","0","53.06","26.53"
"65","000","00","250","0009","0000","282","159","123","39","321","561","0","57.22","28.34"
"65","000","00","250","0009","2472","282","159","123","39","321","561","0","57.22","28.34"
"65","000","00","250","0010","0000","194","120","74","8","202","391","0","51.66","30.69"
"65","000","00","250","0010","2473","194","120","74","8","202","391","0","51.66","30.69"
"65","000","00","250","0011","0000","153","90","63","20","173","340","0","50.88","26.47"
"65","000","00","250","0011","2474","153","90","63","20","173","340","0","50.88","26.47"
"65","000","00","250","0012","0000","708","331","377","69","777","1118","0","69.50","29.61"
"65","000","00","250","0012","2478","708","331","377","69","777","1118","0","69.50","29.61"
"65","000","00","260","0000","0000","4765","2859","1906","425","5190","10356","11300","50.12","27.61"
"65","000","00","260","0001","0000","345","171","174","36","381","768","0","49.61","22.27"
"65","000","00","260","0001","2479","345","171","174","36","381","768","0","49.61","22.27"
"65","000","00","260","0002","0000","253","136","117","24","277","465","0","59.57","29.25"
"65","000","00","260","0002","2481","253","136","117","24","277","465","0","59.57","29.25"
"65","000","00","260","0003","0000","297","170","127","25","322","598","0","53.85","28.43"
"65","000","00","260","0003","2482","141","89","52","11","152","323","0","47.06","27.55"
"65","000","00","260","0003","2483","156","81","75","14","170","275","0","61.82","29.45"
"65","000","00","260","0004","0000","175","104","71","8","183","385","0","47.53","27.01"
"65","000","00","260","0004","2480","175","104","71","8","183","385","0","47.53","27.01"
"65","000","00","260","0005","0000","358","254","104","19","377","617","0","61.10","41.17"
"65","000","00","260","0005","2488","358","254","104","19","377","617","0","61.10","41.17"
"65","000","00","260","0006","0000","681","377","304","54","735","1535","0","47.88","24.56"
"65","000","00","260","0006","2486","351","192","159","25","376","758","0","49.60","25.33"
"65","000","00","260","0006","2487","330","185","145","29","359","777","0","46.20","23.81"
"65","000","00","260","0007","0000","885","528","357","83","968","1627","0","59.50","32.45"
"65","000","00","260","0007","2491","408","233","175","34","442","705","0","62.70","33.05"
"65","000","00","260","0007","2492","477","295","182","49","526","922","0","57.05","32.00"
"65","000","00","260","0008","0000","792","537","255","70","862","1914","0","45.04","28.06"
"65","000","00","260","0008","2489","417","281","136","35","452","1035","0","43.67","27.15"
"65","000","00","260","0008","2490","375","256","119","35","410","879","0","46.64","29.12"
"65","000","00","260","0009","0000","336","193","143","41","377","847","0","44.51","22.79"
"65","000","00","260","0009","2484","207","98","109","24","231","471","0","49.04","20.81"
"65","000","00","260","0009","2485","129","95","34","17","146","376","0","38.83","25.27"
"65","000","00","260","0010","0000","201","103","98","26","227","675","0","33.63","15.26"
"65","000","00","260","0010","2493","82","39","43","3","85","369","0","23.04","10.57"
"65","000","00","260","0010","2494","119","64","55","23","142","306","0","46.41","20.92"
"65","000","00","260","0011","0000","442","286","156","39","481","925","0","52.00","30.92"
"65","000","00","260","0011","2495","281","171","110","35","316","472","0","66.95","36.23"
"65","000","00","260","0011","2496","161","115","46","4","165","453","0","36.42","25.39"
"65","000","00","270","0000","0000","9159","5037","4122","991","10150","18029","20605","56.30","27.94"
"65","000","00","270","0001","0000","229","107","122","11","240","427","0","56.21","25.06"
"65","000","00","270","0001","2497","229","107","122","11","240","427","0","56.21","25.06"
"65","000","00","270","0002","0000","337","187","150","39","376","660","0","56.97","28.33"
"65","000","00","270","0002","2498","337","187","150","39","376","660","0","56.97","28.33"
"65","000","00","270","0003","0000","222","135","87","29","251","486","0","51.65","27.78"
"65","000","00","270","0003","2499","222","135","87","29","251","486","0","51.65","27.78"
"65","000","00","270","0004","0000","786","475","311","87","873","1652","0","52.85","28.75"
"65","000","00","270","0004","2500","376","226","150","37","413","764","0","54.06","29.58"
"65","000","00","270","0004","2501","410","249","161","50","460","888","0","51.80","28.04"
"65","000","00","270","0005","0000","1981","1065","916","188","2169","3725","0","58.23","28.59"
"65","000","00","270","0005","2508","662","383","279","61","723","1200","0","60.25","31.92"
"65","000","00","270","0005","2509","637","347","290","97","734","1222","0","60.07","28.40"
"65","000","00","270","0005","2510","682","335","347","30","712","1303","0","54.64","25.71"
"65","000","00","270","0006","0000","941","501","440","68","1009","1596","0","63.22","31.39"
"65","000","00","270","0006","2506","442","229","213","22","464","756","0","61.38","30.29"
"65","000","00","270","0006","2507","499","272","227","46","545","840","0","64.88","32.38"
"65","000","00","270","0007","0000","503","310","193","53","556","1127","0","49.33","27.51"
"65","000","00","270","0007","2511","503","310","193","53","556","1127","0","49.33","27.51"
"65","000","00","270","0008","0000","209","132","77","32","241","369","0","65.31","35.77"
"65","000","00","270","0008","2512","209","132","77","32","241","369","0","65.31","35.77"
"65","000","00","270","0009","0000","407","236","171","71","478","640","0","74.69","36.88"
"65","000","00","270","0009","2513","407","236","171","71","478","640","0","74.69","36.88"
"65","000","00","270","0010","0000","355","194","161","56","411","593","0","69.31","32.72"
"65","000","00","270","0010","2514","355","194","161","56","411","593","0","69.31","32.72"
"65","000","00","270","0011","0000","373","197","176","56","429","777","0","55.21","25.35"
"65","000","00","270","0011","2516","373","197","176","56","429","777","0","55.21","25.35"
"65","000","00","270","0012","0000","273","168","105","34","307","436","0","70.41","38.53"
"65","000","00","270","0012","2515","273","168","105","34","307","436","0","70.41","38.53"
"65","000","00","270","0013","0000","93","55","38","23","116","171","0","67.84","32.16"
"65","000","00","270","0013","2517","93","55","38","23","116","171","0","67.84","32.16"
"65","000","00","270","0014","0000","326","184","142","59","385","541","0","71.16","34.01"
"65","000","00","270","0014","2518","326","184","142","59","385","541","0","71.16","34.01"
"65","000","00","270","0015","0000","2124","1091","1033","185","2309","4829","0","47.82","22.59"
"65","000","00","270","0015","2502","538","269","269","53","591","1159","0","50.99","23.21"
"65","000","00","270","0015","2503","615","301","314","50","665","1321","0","50.34","22.79"
"65","000","00","270","0015","2504","526","296","230","51","577","1223","0","47.18","24.20"
"65","000","00","270","0015","2505","445","225","220","31","476","1126","0","42.27","19.98"
"65","000","00","280","0000","0000","8753","4770","3983","763","9516","18464","21139","51.54","25.83"
"65","000","00","280","0001","0000","2050","1118","932","116","2166","4151","0","52.18","26.93"
"65","000","00","280","0001","2519","487","253","234","24","511","1001","0","51.05","25.27"
"65","000","00","280","0001","2520","369","214","155","24","393","882","0","44.56","24.26"
"65","000","00","280","0001","2521","486","266","220","24","510","909","0","56.11","29.26"
"65","000","00","280","0001","2522","708","385","323","44","752","1359","0","55.33","28.33"
"65","000","00","280","0002","0000","1259","691","568","128","1387","2477","0","56.00","27.90"
"65","000","00","280","0002","2525","523","280","243","34","557","1193","0","46.69","23.47"
"65","000","00","280","0002","2526","736","411","325","94","830","1284","0","64.64","32.01"
"65","000","00","280","0003","0000","1634","889","745","151","1785","3073","0","58.09","28.93"
"65","000","00","280","0003","2527","517","284","233","43","560","963","0","58.15","29.49"
"65","000","00","280","0003","2528","491","263","228","46","537","953","0","56.35","27.60"
"65","000","00","280","0003","2529","626","342","284","62","688","1157","0","59.46","29.56"
"65","000","00","280","0004","0000","1050","558","492","114","1164","2590","0","44.94","21.54"
"65","000","00","280","0004","2530","354","186","168","56","410","904","0","45.35","20.58"
"65","000","00","280","0004","2531","346","192","154","27","373","872","0","42.78","22.02"
"65","000","00","280","0004","2532","350","180","170","31","381","814","0","46.81","22.11"
"65","000","00","280","0005","0000","244","125","119","26","270","560","0","48.21","22.32"
"65","000","00","280","0005","2533","244","125","119","26","270","560","0","48.21","22.32"
"65","000","00","280","0006","0000","550","318","232","81","631","932","0","67.70","34.12"
"65","000","00","280","0006","2534","550","318","232","81","631","932","0","67.70","34.12"
"65","000","00","280","0007","0000","232","142","90","32","264","616","0","42.86","23.05"
"65","000","00","280","0007","2535","232","142","90","32","264","616","0","42.86","23.05"
"65","000","00","280","0008","0000","225","134","91","19","244","379","0","64.38","35.36"
"65","000","00","280","0008","2536","225","134","91","19","244","379","0","64.38","35.36"
"65","000","00","280","0009","0000","483","261","222","26","509","1061","0","47.97","24.60"
"65","000","00","280","0009","2537","483","261","222","26","509","1061","0","47.97","24.60"
"65","000","00","280","0010","0000","1026","534","492","70","1096","2625","0","41.75","20.34"
"65","000","00","280","0010","2523","520","264","256","46","566","1352","0","41.86","19.53"
"65","000","00","280","0010","2524","506","270","236","24","530","1273","0","41.63","21.21"
"65","000","00","290","0000","0000","3110","1569","1541","266","3376","5116","6327","65.99","30.67"
"65","000","00","290","0001","0000","1420","722","698","126","1546","2276","0","67.93","31.72"
"65","000","00","290","0001","2399","691","346","345","54","745","1142","0","65.24","30.30"
"65","000","00","290","0001","2400","729","376","353","72","801","1134","0","70.63","33.16"
"65","000","00","290","0002","0000","858","427","431","58","916","1535","0","59.67","27.82"
"65","000","00","290","0002","2397","551","284","267","47","598","896","0","66.74","31.70"
"65","000","00","290","0002","2398","307","143","164","11","318","639","0","49.77","22.38"
"65","000","00","290","0003","0000","377","181","196","39","416","598","0","69.57","30.27"
"65","000","00","290","0003","2403","377","181","196","39","416","598","0","69.57","30.27"
"65","000","00","290","0004","0000","286","138","148","30","316","481","0","65.70","28.69"
"65","000","00","290","0004","2402","286","138","148","30","316","481","0","65.70","28.69"
"65","000","00","290","0005","0000","169","101","68","13","182","226","0","80.53","44.69"
"65","000","00","290","0005","2401","169","101","68","13","182","226","0","80.53","44.69"
"68","000","00","000","0000","0000","1009314","503496","505818","51231","1060545","1833796","2273968","57.83","27.46"
"68","000","00","010","0000","0000","203072","103187","99885","8230","211302","368364","460324","57.36","28.01"
"68","000","00","010","0001","0000","621","315","306","14","635","1029","0","61.71","30.61"
"68","000","00","010","0001","0036","621","315","306","14","635","1029","0","61.71","30.61"
"68","000","00","010","0002","0000","905","447","458","15","920","1444","0","63.71","30.96"
"68","000","00","010","0002","0038","905","447","458","15","920","1444","0","63.71","30.96"
"68","000","00","010","0003","0000","787","425","362","24","811","1595","0","50.85","26.65"
"68","000","00","010","0003","0047","787","425","362","24","811","1595","0","50.85","26.65"
"68","000","00","010","0004","0000","3400","1841","1559","130","3530","6749","0","52.30","27.28"
"68","000","00","010","0004","0001","756","419","337","39","795","1508","0","52.72","27.79"
"68","000","00","010","0004","0002","500","263","237","10","510","1084","0","47.05","24.26"
"68","000","00","010","0004","0003","682","384","298","19","701","1313","0","53.39","29.25"
"68","000","00","010","0004","0004","748","393","355","27","775","1375","0","56.36","28.58"
"68","000","00","010","0004","0005","714","382","332","35","749","1469","0","50.99","26.00"
"68","000","00","010","0005","0000","1835","853","982","71","1906","3463","0","55.04","24.63"
"68","000","00","010","0005","0228","939","418","521","41","980","1792","0","54.69","23.33"
"68","000","00","010","0005","0229","896","435","461","30","926","1671","0","55.42","26.03"
"68","000","00","010","0006","0000","1977","943","1034","74","2051","3663","0","55.99","25.74"
"68","000","00","010","0006","0243","716","351","365","29","745","1345","0","55.39","26.10"
"68","000","00","010","0006","0244","626","299","327","29","655","1122","0","58.38","26.65"
"68","000","00","010","0006","0245","635","293","342","16","651","1196","0","54.43","24.50"
"68","000","00","010","0007","0000","584","371","213","31","615","990","0","62.12","37.47"
"68","000","00","010","0007","0048","584","371","213","31","615","990","0","62.12","37.47"
"68","000","00","010","0008","0000","933","470","463","44","977","1635","0","59.76","28.75"
"68","000","00","010","0008","0040","933","470","463","44","977","1635","0","59.76","28.75"
"68","000","00","010","0009","0000","1001","570","431","50","1051","1750","0","60.06","32.57"
"68","000","00","010","0009","0041","1001","570","431","50","1051","1750","0","60.06","32.57"
"68","000","00","010","0010","0000","3587","1964","1623","166","3753","6883","0","54.53","28.53"
"68","000","00","010","0010","0223","633","370","263","14","647","1316","0","49.16","28.12"
"68","000","00","010","0010","0224","668","372","296","23","691","1395","0","49.53","26.67"
"68","000","00","010","0010","0225","811","418","393","50","861","1453","0","59.26","28.77"
"68","000","00","010","0010","0226","718","379","339","32","750","1450","0","51.72","26.14"
"68","000","00","010","0010","0227","757","425","332","47","804","1269","0","63.36","33.49"
"68","000","00","010","0011","0000","2577","1497","1080","120","2697","4401","0","61.28","34.01"
"68","000","00","010","0011","0135","762","423","339","34","796","1366","0","58.27","30.97"
"68","000","00","010","0011","0136","871","494","377","27","898","1531","0","58.65","32.27"
"68","000","00","010","0011","0137","944","580","364","59","1003","1504","0","66.69","38.56"
"68","000","00","010","0012","0000","2321","1262","1059","129","2450","4449","0","55.07","28.37"
"68","000","00","010","0012","0158","761","429","332","22","783","1645","0","47.60","26.08"
"68","000","00","010","0012","0159","798","411","387","49","847","1436","0","58.98","28.62"
"68","000","00","010","0012","0160","762","422","340","58","820","1368","0","59.94","30.85"
"68","000","00","010","0013","0000","1733","865","868","64","1797","2904","0","61.88","29.79"
"68","000","00","010","0013","0232","856","430","426","33","889","1458","0","60.97","29.49"
"68","000","00","010","0013","0233","877","435","442","31","908","1446","0","62.79","30.08"
"68","000","00","010","0014","0000","1020","515","505","47","1067","1828","0","58.37","28.17"
"68","000","00","010","0014","0230","566","294","272","25","591","929","0","63.62","31.65"
"68","000","00","010","0014","0231","454","221","233","22","476","899","0","52.95","24.58"
"68","000","00","010","0015","0000","473","276","197","37","510","913","0","55.86","30.23"
"68","000","00","010","0015","0246","473","276","197","37","510","913","0","55.86","30.23"
"68","000","00","010","0016","0000","1824","999","825","92","1916","3402","0","56.32","29.37"
"68","000","00","010","0016","0161","854","482","372","46","900","1651","0","54.51","29.19"
"68","000","00","010","0016","0162","970","517","453","46","1016","1751","0","58.02","29.53"
"68","000","00","010","0017","0000","1556","876","680","90","1646","2662","0","61.83","32.91"
"68","000","00","010","0017","0126","815","458","357","49","864","1365","0","63.30","33.55"
"68","000","00","010","0017","0127","741","418","323","41","782","1297","0","60.29","32.23"
"68","000","00","010","0018","0000","1722","1003","719","130","1852","2999","0","61.75","33.44"
"68","000","00","010","0018","0153","544","315","229","39","583","953","0","61.18","33.05"
"68","000","00","010","0018","0154","543","312","231","50","593","958","0","61.90","32.57"
"68","000","00","010","0018","0155","635","376","259","41","676","1088","0","62.13","34.56"
"68","000","00","010","0019","0000","883","498","385","42","925","1676","0","55.19","29.71"
"68","000","00","010","0019","0045","883","498","385","42","925","1676","0","55.19","29.71"
"68","000","00","010","0020","0000","739","407","332","54","793","1275","0","62.20","31.92"
"68","000","00","010","0020","0031","739","407","332","54","793","1275","0","62.20","31.92"
"68","000","00","010","0021","0000","537","317","220","22","559","755","0","74.04","41.99"
"68","000","00","010","0021","0037","537","317","220","22","559","755","0","74.04","41.99"
"68","000","00","010","0022","0000","2807","1320","1487","122","2929","4651","0","62.98","28.38"
"68","000","00","010","0022","0184","931","445","486","26","957","1583","0","60.45","28.11"
"68","000","00","010","0022","0185","922","416","506","25","947","1570","0","60.32","26.50"
"68","000","00","010","0022","0186","954","459","495","71","1025","1498","0","68.42","30.64"
"68","000","00","010","0023","0000","3781","1876","1905","115","3896","6555","0","59.44","28.62"
"68","000","00","010","0023","0054","905","448","457","22","927","1606","0","57.72","27.90"
"68","000","00","010","0023","0055","1014","491","523","18","1032","1683","0","61.32","29.17"
"68","000","00","010","0023","0056","888","467","421","46","934","1585","0","58.93","29.46"
"68","000","00","010","0023","0057","974","470","504","29","1003","1681","0","59.67","27.96"
"68","000","00","010","0024","0000","3233","1702","1531","153","3386","6190","0","54.70","27.50"
"68","000","00","010","0024","0180","896","495","401","38","934","1683","0","55.50","29.41"
"68","000","00","010","0024","0181","714","338","376","33","747","1499","0","49.83","22.55"
"68","000","00","010","0024","0182","762","428","334","54","816","1440","0","56.67","29.72"
"68","000","00","010","0024","0183","861","441","420","28","889","1568","0","56.70","28.13"
"68","000","00","010","0025","0000","769","397","372","31","800","1348","0","59.35","29.45"
"68","000","00","010","0025","0046","769","397","372","31","800","1348","0","59.35","29.45"
"68","000","00","010","0026","0000","3090","1590","1500","147","3237","5641","0","57.38","28.19"
"68","000","00","010","0026","0049","1098","597","501","50","1148","1997","0","57.49","29.89"
"68","000","00","010","0026","0050","514","276","238","38","552","945","0","58.41","29.21"
"68","000","00","010","0026","0051","538","270","268","27","565","984","0","57.42","27.44"
"68","000","00","010","0026","0052","940","447","493","32","972","1715","0","56.68","26.06"
"68","000","00","010","0027","0000","748","431","317","37","785","1287","0","60.99","33.49"
"68","000","00","010","0027","0053","748","431","317","37","785","1287","0","60.99","33.49"
"68","000","00","010","0028","0000","2651","1461","1190","134","2785","4657","0","59.80","31.37"
"68","000","00","010","0028","0096","835","476","359","46","881","1367","0","64.45","34.82"
"68","000","00","010","0028","0097","589","335","254","23","612","1133","0","54.02","29.57"
"68","000","00","010","0028","0098","632","332","300","36","668","1101","0","60.67","30.15"
"68","000","00","010","0028","0099","595","318","277","29","624","1056","0","59.09","30.11"
"68","000","00","010","0029","0000","3364","1793","1571","124","3488","6164","0","56.59","29.09"
"68","000","00","010","0029","0066","650","410","240","32","682","1095","0","62.28","37.44"
"68","000","00","010","0029","0067","844","447","397","19","863","1507","0","57.27","29.66"
"68","000","00","010","0029","0068","600","295","305","33","633","1099","0","57.60","26.84"
"68","000","00","010","0029","0069","704","331","373","29","733","1507","0","48.64","21.96"
"68","000","00","010","0029","0070","566","310","256","11","577","956","0","60.36","32.43"
"68","000","00","010","0030","0000","4034","2012","2022","135","4169","7063","0","59.03","28.49"
"68","000","00","010","0030","0061","893","426","467","24","917","1503","0","61.01","28.34"
"68","000","00","010","0030","0062","707","363","344","41","748","1276","0","58.62","28.45"
"68","000","00","010","0030","0063","770","410","360","20","790","1418","0","55.71","28.91"
"68","000","00","010","0030","0064","847","420","427","30","877","1436","0","61.07","29.25"
"68","000","00","010","0030","0065","817","393","424","20","837","1430","0","58.53","27.48"
"68","000","00","010","0031","0000","952","515","437","54","1006","1676","0","60.02","30.73"
"68","000","00","010","0031","0039","952","515","437","54","1006","1676","0","60.02","30.73"
"68","000","00","010","0032","0000","3243","1696","1547","131","3374","5832","0","57.85","29.08"
"68","000","00","010","0032","0016","762","436","326","40","802","1350","0","59.41","32.30"
"68","000","00","010","0032","0017","715","392","323","37","752","1366","0","55.05","28.70"
"68","000","00","010","0032","0018","830","431","399","32","862","1517","0","56.82","28.41"
"68","000","00","010","0032","0019","936","437","499","22","958","1599","0","59.91","27.33"
"68","000","00","010","0033","0000","3414","1643","1771","110","3524","5753","0","61.25","28.56"
"68","000","00","010","0033","0023","818","385","433","33","851","1343","0","63.37","28.67"
"68","000","00","010","0033","0024","942","456","486","11","953","1519","0","62.74","30.02"
"68","000","00","010","0033","0025","860","433","427","34","894","1526","0","58.58","28.37"
"68","000","00","010","0033","0026","794","369","425","32","826","1365","0","60.51","27.03"
"68","000","00","010","0034","0000","2558","1351","1207","124","2682","4330","0","61.94","31.20"
"68","000","00","010","0034","0042","869","451","418","41","910","1475","0","61.69","30.58"
"68","000","00","010","0034","0043","850","464","386","39","889","1416","0","62.78","32.77"
"68","000","00","010","0034","0044","839","436","403","44","883","1439","0","61.36","30.30"
"68","000","00","010","0035","0000","1781","880","901","104","1885","3350","0","56.27","26.27"
"68","000","00","010","0035","0103","630","325","305","27","657","1078","0","60.95","30.15"
"68","000","00","010","0035","0104","564","254","310","38","602","1128","0","53.37","22.52"
"68","000","00","010","0035","0105","587","301","286","39","626","1144","0","54.72","26.31"
"68","000","00","010","0036","0000","3127","1522","1605","145","3272","5633","0","58.09","27.02"
"68","000","00","010","0036","0110","788","377","411","61","849","1364","0","62.24","27.64"
"68","000","00","010","0036","0111","802","390","412","29","831","1525","0","54.49","25.57"
"68","000","00","010","0036","0112","818","411","407","19","837","1470","0","56.94","27.96"
"68","000","00","010","0036","0113","719","344","375","36","755","1274","0","59.26","27.00"
"68","000","00","010","0037","0000","2195","1082","1113","91","2286","3767","0","60.68","28.72"
"68","000","00","010","0037","0220","628","293","335","30","658","1077","0","61.10","27.21"
"68","000","00","010","0037","0221","747","384","363","28","775","1346","0","57.58","28.53"
"68","000","00","010","0037","0222","820","405","415","33","853","1344","0","63.47","30.13"
"68","000","00","010","0038","0000","2597","1380","1217","72","2669","4331","0","61.63","31.86"
"68","000","00","010","0038","0234","980","512","468","10","990","1515","0","65.35","33.80"
"68","000","00","010","0038","0235","800","438","362","39","839","1420","0","59.08","30.85"
"68","000","00","010","0038","0236","817","430","387","23","840","1396","0","60.17","30.80"
"68","000","00","010","0039","0000","1108","594","514","51","1159","1894","0","61.19","31.36"
"68","000","00","010","0039","0241","616","343","273","20","636","986","0","64.50","34.79"
"68","000","00","010","0039","0242","492","251","241","31","523","908","0","57.60","27.64"
"68","000","00","010","0040","0000","3262","1726","1536","134","3396","5687","0","59.72","30.35"
"68","000","00","010","0040","0032","748","383","365","24","772","1266","0","60.98","30.25"
"68","000","00","010","0040","0033","801","440","361","35","836","1461","0","57.22","30.12"
"68","000","00","010","0040","0034","1001","560","441","43","1044","1682","0","62.07","33.29"
"68","000","00","010","0040","0035","712","343","369","32","744","1278","0","58.22","26.84"
"68","000","00","010","0041","0000","3457","1806","1651","212","3669","5990","0","61.25","30.15"
"68","000","00","010","0041","0027","923","485","438","60","983","1580","0","62.22","30.70"
"68","000","00","010","0041","0028","862","454","408","40","902","1566","0","57.60","28.99"
"68","000","00","010","0041","0029","816","424","392","62","878","1417","0","61.96","29.92"
"68","000","00","010","0041","0030","856","443","413","50","906","1427","0","63.49","31.04"
"68","000","00","010","0042","0000","2859","1468","1391","139","2998","4928","0","60.84","29.79"
"68","000","00","010","0042","0012","742","374","368","45","787","1233","0","63.83","30.33"
"68","000","00","010","0042","0013","785","389","396","48","833","1327","0","62.77","29.31"
"68","000","00","010","0042","0014","661","350","311","24","685","1192","0","57.47","29.36"
"68","000","00","010","0042","0015","671","355","316","22","693","1176","0","58.93","30.19"
"68","000","00","010","0043","0000","2772","1463","1309","97","2869","4747","0","60.44","30.82"
"68","000","00","010","0043","0009","984","486","498","25","1009","1750","0","57.66","27.77"
"68","000","00","010","0043","0010","897","479","418","31","928","1519","0","61.09","31.53"
"68","000","00","010","0043","0011","891","498","393","41","932","1478","0","63.06","33.69"
"68","000","00","010","0044","0000","2312","1202","1110","116","2428","3955","0","61.39","30.39"
"68","000","00","010","0044","0020","719","349","370","31","750","1213","0","61.83","28.77"
"68","000","00","010","0044","0021","688","361","327","30","718","1307","0","54.93","27.62"
"68","000","00","010","0044","0022","905","492","413","55","960","1435","0","66.90","34.29"
"68","000","00","010","0045","0000","2425","1101","1324","81","2506","4013","0","62.45","27.44"
"68","000","00","010","0045","0206","798","355","443","31","829","1358","0","61.05","26.14"
"68","000","00","010","0045","0207","833","372","461","29","862","1318","0","65.40","28.22"
"68","000","00","010","0045","0208","794","374","420","21","815","1337","0","60.96","27.97"
"68","000","00","010","0046","0000","2766","1498","1268","109","2875","5209","0","55.19","28.76"
"68","000","00","010","0046","0216","564","309","255","16","580","1216","0","47.70","25.41"
"68","000","00","010","0046","0217","708","378","330","20","728","1307","0","55.70","28.92"
"68","000","00","010","0046","0218","743","416","327","38","781","1348","0","57.94","30.86"
"68","000","00","010","0046","0219","751","395","356","35","786","1338","0","58.74","29.52"
"68","000","00","010","0047","0000","3138","1662","1476","131","3269","5955","0","54.90","27.91"
"68","000","00","010","0047","0237","796","404","392","30","826","1462","0","56.50","27.63"
"68","000","00","010","0047","0238","742","405","337","44","786","1420","0","55.35","28.52"
"68","000","00","010","0047","0239","827","457","370","34","861","1491","0","57.75","30.65"
"68","000","00","010","0047","0240","773","396","377","23","796","1582","0","50.32","25.03"
"68","000","00","010","0048","0000","3731","1993","1738","155","3886","6674","0","58.23","29.86"
"68","000","00","010","0048","0166","761","418","343","31","792","1250","0","63.36","33.44"
"68","000","00","010","0048","0167","636","341","295","32","668","1269","0","52.64","26.87"
"68","000","00","010","0048","0168","753","421","332","36","789","1332","0","59.23","31.61"
"68","000","00","010","0048","0169","821","440","381","34","855","1486","0","57.54","29.61"
"68","000","00","010","0048","0170","760","373","387","22","782","1337","0","58.49","27.90"
"68","000","00","010","0049","0000","3112","1511","1601","91","3203","5971","0","53.64","25.31"
"68","000","00","010","0049","0128","774","397","377","26","800","1453","0","55.06","27.32"
"68","000","00","010","0049","0129","730","366","364","28","758","1374","0","55.17","26.64"
"68","000","00","010","0049","0130","790","380","410","26","816","1674","0","48.75","22.70"
"68","000","00","010","0049","0131","818","368","450","11","829","1470","0","56.39","25.03"
"68","000","00","010","0050","0000","5544","2824","2720","177","5721","9686","0","59.06","29.16"
"68","000","00","010","0050","0138","926","514","412","31","957","1602","0","59.74","32.08"
"68","000","00","010","0050","0139","1012","520","492","28","1040","1647","0","63.15","31.57"
"68","000","00","010","0050","0140","858","448","410","31","889","1610","0","55.22","27.83"
"68","000","00","010","0050","0141","905","450","455","18","923","1484","0","62.20","30.32"
"68","000","00","010","0050","0142","943","422","521","32","975","1719","0","56.72","24.55"
"68","000","00","010","0050","0143","900","470","430","37","937","1624","0","57.70","28.94"
"68","000","00","010","0051","0000","4654","2249","2405","154","4808","8537","0","56.32","26.34"
"68","000","00","010","0051","0174","699","343","356","24","723","1460","0","49.52","23.49"
"68","000","00","010","0051","0175","842","374","468","19","861","1514","0","56.87","24.70"
"68","000","00","010","0051","0176","814","419","395","18","832","1408","0","59.09","29.76"
"68","000","00","010","0051","0177","749","353","396","30","779","1264","0","61.63","27.93"
"68","000","00","010","0051","0178","712","356","356","31","743","1353","0","54.92","26.31"
"68","000","00","010","0051","0179","838","404","434","32","870","1538","0","56.57","26.27"
"68","000","00","010","0052","0000","2761","1483","1278","101","2862","4987","0","57.39","29.74"
"68","000","00","010","0052","0093","853","461","392","30","883","1544","0","57.19","29.86"
"68","000","00","010","0052","0094","918","458","460","50","968","1585","0","61.07","28.90"
"68","000","00","010","0052","0095","990","564","426","21","1011","1858","0","54.41","30.36"
"68","000","00","010","0053","0000","2040","1068","972","101","2141","3539","0","60.50","30.18"
"68","000","00","010","0053","0100","668","316","352","49","717","1186","0","60.46","26.64"
"68","000","00","010","0053","0101","718","392","326","17","735","1227","0","59.90","31.95"
"68","000","00","010","0053","0102","654","360","294","35","689","1126","0","61.19","31.97"
"68","000","00","010","0054","0000","2046","1057","989","74","2120","3807","0","55.69","27.76"
"68","000","00","010","0054","0085","745","397","348","33","778","1290","0","60.31","30.78"
"68","000","00","010","0054","0086","612","299","313","21","633","1242","0","50.97","24.07"
"68","000","00","010","0054","0087","689","361","328","20","709","1275","0","55.61","28.31"
"68","000","00","010","0055","0000","3419","1731","1688","173","3592","6271","0","57.28","27.60"
"68","000","00","010","0055","0088","687","345","342","43","730","1262","0","57.84","27.34"
"68","000","00","010","0055","0089","923","448","475","37","960","1726","0","55.62","25.96"
"68","000","00","010","0055","0090","681","373","308","34","715","1149","0","62.23","32.46"
"68","000","00","010","0055","0091","551","297","254","34","585","942","0","62.10","31.53"
"68","000","00","010","0055","0092","577","268","309","25","602","1192","0","50.50","22.48"
"68","000","00","010","0056","0000","2571","1246","1325","133","2704","4860","0","55.64","25.64"
"68","000","00","010","0056","0114","839","422","417","65","904","1577","0","57.32","26.76"
"68","000","00","010","0056","0115","816","407","409","33","849","1579","0","53.77","25.78"
"68","000","00","010","0056","0116","916","417","499","35","951","1704","0","55.81","24.47"
"68","000","00","010","0057","0000","3352","1591","1761","116","3468","6314","0","54.93","25.20"
"68","000","00","010","0057","0209","763","348","415","24","787","1510","0","52.12","23.05"
"68","000","00","010","0057","0210","775","357","418","32","807","1523","0","52.99","23.44"
"68","000","00","010","0057","0211","899","421","478","34","933","1628","0","57.31","25.86"
"68","000","00","010","0057","0212","915","465","450","26","941","1653","0","56.93","28.13"
"68","000","00","010","0058","0000","2222","1110","1112","129","2351","4131","0","56.91","26.87"
"68","000","00","010","0058","0254","768","392","376","51","819","1501","0","54.56","26.12"
"68","000","00","010","0058","0255","741","382","359","37","778","1338","0","58.15","28.55"
"68","000","00","010","0058","0256","713","336","377","41","754","1292","0","58.36","26.01"
"68","000","00","010","0059","0000","3976","1966","2010","132","4108","9570","0","42.93","20.54"
"68","000","00","010","0059","0121","840","430","410","12","852","1526","0","55.83","28.18"
"68","000","00","010","0059","0122","616","327","289","25","641","3544","0","18.09","9.23"
"68","000","00","010","0059","0123","827","383","444","31","858","1554","0","55.21","24.65"
"68","000","00","010","0059","0124","850","391","459","30","880","1419","0","62.02","27.55"
"68","000","00","010","0059","0125","843","435","408","34","877","1527","0","57.43","28.49"
"68","000","00","010","0060","0000","2845","1430","1415","111","2956","5301","0","55.76","26.98"
"68","000","00","010","0060","0106","728","380","348","27","755","1330","0","56.77","28.57"
"68","000","00","010","0060","0107","764","391","373","38","802","1419","0","56.52","27.55"
"68","000","00","010","0060","0108","673","339","334","14","687","1255","0","54.74","27.01"
"68","000","00","010","0060","0109","680","320","360","32","712","1297","0","54.90","24.67"
"68","000","00","010","0061","0000","4209","2065","2144","166","4375","7219","0","60.60","28.61"
"68","000","00","010","0061","0148","985","513","472","30","1015","1689","0","60.09","30.37"
"68","000","00","010","0061","0149","779","380","399","37","816","1396","0","58.45","27.22"
"68","000","00","010","0061","0150","770","364","406","43","813","1326","0","61.31","27.45"
"68","000","00","010","0061","0151","835","423","412","24","859","1406","0","61.10","30.09"
"68","000","00","010","0061","0152","840","385","455","32","872","1402","0","62.20","27.46"
"68","000","00","010","0062","0000","2954","1469","1485","105","3059","5494","0","55.68","26.74"
"68","000","00","010","0062","0071","755","372","383","28","783","1300","0","60.23","28.62"
"68","000","00","010","0062","0072","713","362","351","28","741","1364","0","54.33","26.54"
"68","000","00","010","0062","0073","740","379","361","25","765","1391","0","55.00","27.25"
"68","000","00","010","0062","0074","746","356","390","24","770","1439","0","53.51","24.74"
"68","000","00","010","0063","0000","2781","1452","1329","113","2894","4797","0","60.33","30.27"
"68","000","00","010","0063","0163","1010","512","498","53","1063","1672","0","63.58","30.62"
"68","000","00","010","0063","0164","806","420","386","35","841","1290","0","65.19","32.56"
"68","000","00","010","0063","0165","965","520","445","25","990","1835","0","53.95","28.34"
"68","000","00","010","0064","0000","2433","1181","1252","126","2559","4518","0","56.64","26.14"
"68","000","00","010","0064","0058","749","321","428","25","774","1459","0","53.05","22.00"
"68","000","00","010","0064","0059","845","427","418","52","897","1563","0","57.39","27.32"
"68","000","00","010","0064","0060","839","433","406","49","888","1496","0","59.36","28.94"
"68","000","00","010","0065","0000","2532","1185","1347","94","2626","4463","0","58.84","26.55"
"68","000","00","010","0065","0075","857","434","423","30","887","1582","0","56.07","27.43"
"68","000","00","010","0065","0076","906","408","498","34","940","1543","0","60.92","26.44"
"68","000","00","010","0065","0077","769","343","426","30","799","1338","0","59.72","25.64"
"68","000","00","010","0066","0000","2283","1036","1247","70","2353","3993","0","58.93","25.95"
"68","000","00","010","0066","0078","827","359","468","26","853","1448","0","58.91","24.79"
"68","000","00","010","0066","0079","718","321","397","21","739","1275","0","57.96","25.18"
"68","000","00","010","0066","0080","738","356","382","23","761","1270","0","59.92","28.03"
"68","000","00","010","0067","0000","2677","1383","1294","113","2790","4908","0","56.85","28.18"
"68","000","00","010","0067","0171","913","493","420","37","950","1693","0","56.11","29.12"
"68","000","00","010","0067","0172","880","465","415","49","929","1562","0","59.48","29.77"
"68","000","00","010","0067","0173","884","425","459","27","911","1653","0","55.11","25.71"
"68","000","00","010","0068","0000","3308","1618","1690","103","3411","5913","0","57.69","27.36"
"68","000","00","010","0068","0199","810","388","422","39","849","1448","0","58.63","26.80"
"68","000","00","010","0068","0200","921","466","455","20","941","1596","0","58.96","29.20"
"68","000","00","010","0068","0201","841","403","438","16","857","1580","0","54.24","25.51"
"68","000","00","010","0068","0202","736","361","375","28","764","1289","0","59.27","28.01"
"68","000","00","010","0069","0000","2502","1258","1244","66","2568","4634","0","55.42","27.15"
"68","000","00","010","0069","0132","834","457","377","22","856","1545","0","55.40","29.58"
"68","000","00","010","0069","0133","804","374","430","14","818","1521","0","53.78","24.59"
"68","000","00","010","0069","0134","864","427","437","30","894","1568","0","57.02","27.23"
"68","000","00","010","0070","0000","2840","1336","1504","79","2919","5255","0","55.55","25.42"
"68","000","00","010","0070","0081","606","259","347","20","626","1311","0","47.75","19.76"
"68","000","00","010","0070","0082","670","315","355","12","682","1238","0","55.09","25.44"
"68","000","00","010","0070","0083","702","362","340","22","724","1379","0","52.50","26.25"
"68","000","00","010","0070","0084","862","400","462","25","887","1327","0","66.84","30.14"
"68","000","00","010","0071","0000","3515","1750","1765","133","3648","6412","0","56.89","27.29"
"68","000","00","010","0071","0117","912","434","478","42","954","1578","0","60.46","27.50"
"68","000","00","010","0071","0118","844","430","414","45","889","1564","0","56.84","27.49"
"68","000","00","010","0071","0119","903","466","437","24","927","1669","0","55.54","27.92"
"68","000","00","010","0071","0120","856","420","436","22","878","1601","0","54.84","26.23"
"68","000","00","010","0072","0000","3273","1591","1682","88","3361","5784","0","58.11","27.51"
"68","000","00","010","0072","0144","829","400","429","14","843","1490","0","56.58","26.85"
"68","000","00","010","0072","0145","814","408","406","32","846","1480","0","57.16","27.57"
"68","000","00","010","0072","0146","802","384","418","25","827","1417","0","58.36","27.10"
"68","000","00","010","0072","0147","828","399","429","17","845","1397","0","60.49","28.56"
"68","000","00","010","0073","0000","1788","840","948","63","1851","3004","0","61.62","27.96"
"68","000","00","010","0073","0156","886","439","447","36","922","1541","0","59.83","28.49"
"68","000","00","010","0073","0157","902","401","501","27","929","1463","0","63.50","27.41"
"68","000","00","010","0074","0000","4092","1909","2183","133","4225","7791","0","54.23","24.50"
"68","000","00","010","0074","0194","806","366","440","30","836","1474","0","56.72","24.83"
"68","000","00","010","0074","0195","722","370","352","28","750","1573","0","47.68","23.52"
"68","000","00","010","0074","0196","832","382","450","21","853","1507","0","56.60","25.35"
"68","000","00","010","0074","0197","864","426","438","26","890","1556","0","57.20","27.38"
"68","000","00","010","0074","0198","868","365","503","28","896","1681","0","53.30","21.71"
"68","000","00","010","0075","0000","2924","1482","1442","97","3021","5773","0","52.33","25.67"
"68","000","00","010","0075","0187","685","342","343","26","711","1517","0","46.87","22.54"
"68","000","00","010","0075","0188","786","423","363","27","813","1447","0","56.19","29.23"
"68","000","00","010","0075","0189","742","358","384","23","765","1442","0","53.05","24.83"
"68","000","00","010","0075","0190","711","359","352","21","732","1367","0","53.55","26.26"
"68","000","00","010","0076","0000","2041","1028","1013","79","2120","3756","0","56.44","27.37"
"68","000","00","010","0076","0203","723","391","332","36","759","1301","0","58.34","30.05"
"68","000","00","010","0076","0204","628","315","313","18","646","1165","0","55.45","27.04"
"68","000","00","010","0076","0205","690","322","368","25","715","1290","0","55.43","24.96"
"68","000","00","010","0077","0000","2108","1122","986","140","2248","3752","0","59.91","29.90"
"68","000","00","010","0077","0006","751","397","354","42","793","1394","0","56.89","28.48"
"68","000","00","010","0077","0007","706","379","327","61","767","1190","0","64.45","31.85"
"68","000","00","010","0077","0008","651","346","305","37","688","1168","0","58.90","29.62"
"68","000","00","010","0078","0000","2737","1344","1393","103","2840","4864","0","58.39","27.63"
"68","000","00","010","0078","0213","1013","511","502","44","1057","1674","0","63.14","30.53"
"68","000","00","010","0078","0214","885","429","456","33","918","1584","0","57.95","27.08"
"68","000","00","010","0078","0215","839","404","435","26","865","1606","0","53.86","25.16"
"68","000","00","010","0079","0000","2414","1213","1201","92","2506","4435","0","56.51","27.35"
"68","000","00","010","0079","0247","753","355","398","23","776","1312","0","59.15","27.06"
"68","000","00","010","0079","0248","776","405","371","36","812","1474","0","55.09","27.48"
"68","000","00","010","0079","0249","885","453","432","33","918","1649","0","55.67","27.47"
"68","000","00","010","0080","0000","2769","1328","1441","104","2873","4834","0","59.43","27.47"
"68","000","00","010","0080","0191","908","452","456","22","930","1600","0","58.13","28.25"
"68","000","00","010","0080","0192","1039","481","558","38","1077","1764","0","61.05","27.27"
"68","000","00","010","0080","0193","822","395","427","44","866","1470","0","58.91","26.87"
"68","000","00","010","0081","0000","3069","1422","1647","96","3165","5920","0","53.46","24.02"
"68","000","00","010","0081","0250","721","338","383","23","744","1420","0","52.39","23.80"
"68","000","00","010","0081","0251","721","341","380","18","739","1413","0","52.30","24.13"
"68","000","00","010","0081","0252","863","396","467","29","892","1563","0","57.07","25.34"
"68","000","00","010","0081","0253","764","347","417","26","790","1524","0","51.84","22.77"
"68","000","00","010","0082","0000","2092","1031","1061","75","2167","4126","0","52.52","24.99"
"68","000","00","010","0082","0257","758","387","371","24","782","1383","0","56.54","27.98"
"68","000","00","010","0082","0258","768","359","409","34","802","1647","0","48.69","21.80"
"68","000","00","010","0082","0259","566","285","281","17","583","1096","0","53.19","26.00"
"68","000","00","020","0000","0000","191542","91242","100300","9251","200793","339799","421806","59.09","26.85"
"68","000","00","020","0001","0000","1558","550","1008","117","1675","2761","0","60.67","19.92"
"68","000","00","020","0001","0739","773","244","529","55","828","1268","0","65.30","19.24"
"68","000","00","020","0001","0740","785","306","479","62","847","1493","0","56.73","20.50"
"68","000","00","020","0002","0000","3034","1241","1793","177","3211","5281","0","60.80","23.50"
"68","000","00","020","0002","0735","891","345","546","39","930","1364","0","68.18","25.29"
"68","000","00","020","0002","0736","637","250","387","47","684","1228","0","55.70","20.36"
"68","000","00","020","0002","0737","743","314","429","64","807","1350","0","59.78","23.26"
"68","000","00","020","0002","0738","763","332","431","27","790","1339","0","59.00","24.79"
"68","000","00","020","0003","0000","1697","796","901","125","1822","2972","0","61.31","26.78"
"68","000","00","020","0003","0782","871","436","435","70","941","1545","0","60.91","28.22"
"68","000","00","020","0003","0783","826","360","466","55","881","1427","0","61.74","25.23"
"68","000","00","020","0004","0000","491","265","226","41","532","876","0","60.73","30.25"
"68","000","00","020","0004","0914","491","265","226","41","532","876","0","60.73","30.25"
"68","000","00","020","0005","0000","1027","454","573","47","1074","2124","0","50.56","21.37"
"68","000","00","020","0005","0823","482","218","264","15","497","1053","0","47.20","20.70"
"68","000","00","020","0005","0824","545","236","309","32","577","1071","0","53.87","22.04"
"68","000","00","020","0006","0000","2356","1134","1222","104","2460","4279","0","57.49","26.50"
"68","000","00","020","0006","0825","867","434","433","58","925","1520","0","60.86","28.55"
"68","000","00","020","0006","0826","770","378","392","26","796","1498","0","53.14","25.23"
"68","000","00","020","0006","0827","719","322","397","20","739","1261","0","58.60","25.54"
"68","000","00","020","0007","0000","2955","1442","1513","99","3054","5150","0","59.30","28.00"
"68","000","00","020","0007","0922","833","420","413","24","857","1526","0","56.16","27.52"
"68","000","00","020","0007","0923","580","300","280","28","608","992","0","61.29","30.24"
"68","000","00","020","0007","0924","753","388","365","20","773","1313","0","58.87","29.55"
"68","000","00","020","0007","0925","789","334","455","27","816","1319","0","61.87","25.32"
"68","000","00","020","0008","0000","2705","888","1817","177","2882","4868","0","59.20","18.24"
"68","000","00","020","0008","0811","665","196","469","40","705","1193","0","59.09","16.43"
"68","000","00","020","0008","0812","683","212","471","46","729","1183","0","61.62","17.92"
"68","000","00","020","0008","0813","694","222","472","53","747","1238","0","60.34","17.93"
"68","000","00","020","0008","0814","663","258","405","38","701","1254","0","55.90","20.57"
"68","000","00","020","0009","0000","1836","762","1074","48","1884","3349","0","56.26","22.75"
"68","000","00","020","0009","0807","896","369","527","27","923","1557","0","59.28","23.70"
"68","000","00","020","0009","0808","940","393","547","21","961","1792","0","53.63","21.93"
"68","000","00","020","0010","0000","2025","879","1146","122","2147","3655","0","58.74","24.05"
"68","000","00","020","0010","0792","780","364","416","49","829","1384","0","59.90","26.30"
"68","000","00","020","0010","0793","423","169","254","32","455","782","0","58.18","21.61"
"68","000","00","020","0010","0794","822","346","476","41","863","1489","0","57.96","23.24"
"68","000","00","020","0011","0000","2324","1090","1234","131","2455","4159","0","59.03","26.21"
"68","000","00","020","0011","0723","694","337","357","53","747","1167","0","64.01","28.88"
"68","000","00","020","0011","0724","823","381","442","26","849","1441","0","58.92","26.44"
"68","000","00","020","0011","0725","807","372","435","52","859","1551","0","55.38","23.98"
"68","000","00","020","0012","0000","3034","1358","1676","161","3195","5465","0","58.46","24.85"
"68","000","00","020","0012","0741","784","327","457","36","820","1483","0","55.29","22.05"
"68","000","00","020","0012","0742","544","233","311","36","580","1056","0","54.92","22.06"
"68","000","00","020","0012","0743","841","387","454","42","883","1441","0","61.28","26.86"
"68","000","00","020","0012","0744","865","411","454","47","912","1485","0","61.41","27.68"
"68","000","00","020","0013","0000","1637","786","851","75","1712","2888","0","59.28","27.22"
"68","000","00","020","0013","0780","822","398","424","39","861","1442","0","59.71","27.60"
"68","000","00","020","0013","0781","815","388","427","36","851","1446","0","58.85","26.83"
"68","000","00","020","0014","0000","1248","598","650","55","1303","2292","0","56.85","26.09"
"68","000","00","020","0014","0904","586","302","284","30","616","1123","0","54.85","26.89"
"68","000","00","020","0014","0905","662","296","366","25","687","1169","0","58.77","25.32"
"68","000","00","020","0015","0000","2052","1022","1030","94","2146","3267","0","65.69","31.28"
"68","000","00","020","0015","0861","841","392","449","28","869","1352","0","64.28","28.99"
"68","000","00","020","0015","0862","623","327","296","32","655","996","0","65.76","32.83"
"68","000","00","020","0015","0863","588","303","285","34","622","919","0","67.68","32.97"
"68","000","00","020","0016","0000","2161","1043","1118","103","2264","4133","0","54.78","25.24"
"68","000","00","020","0016","0751","758","370","388","48","806","1369","0","58.88","27.03"
"68","000","00","020","0016","0752","720","346","374","33","753","1364","0","55.21","25.37"
"68","000","00","020","0016","0753","683","327","356","22","705","1400","0","50.36","23.36"
"68","000","00","020","0017","0000","2160","1005","1155","80","2240","5489","0","40.81","18.31"
"68","000","00","020","0017","0767","722","326","396","30","752","1140","0","65.96","28.60"
"68","000","00","020","0017","0768","717","334","383","18","735","1173","0","62.66","28.47"
"68","000","00","020","0017","0769","721","345","376","32","753","3176","0","23.71","10.86"
"68","000","00","020","0018","0000","2084","1056","1028","95","2179","3874","0","56.25","27.26"
"68","000","00","020","0018","0775","718","373","345","17","735","1486","0","49.46","25.10"
"68","000","00","020","0018","0776","754","386","368","62","816","1251","0","65.23","30.86"
"68","000","00","020","0018","0777","612","297","315","16","628","1137","0","55.23","26.12"
"68","000","00","020","0019","0000","2537","1172","1365","129","2666","5066","0","52.63","23.13"
"68","000","00","020","0019","0798","532","222","310","35","567","1154","0","49.13","19.24"
"68","000","00","020","0019","0799","555","294","261","32","587","1189","0","49.37","24.73"
"68","000","00","020","0019","0800","739","352","387","15","754","1399","0","53.90","25.16"
"68","000","00","020","0019","0801","711","304","407","47","758","1324","0","57.25","22.96"
"68","000","00","020","0020","0000","1617","732","885","93","1710","3320","0","51.51","22.05"
"68","000","00","020","0020","0795","609","267","342","34","643","1112","0","57.82","24.01"
"68","000","00","020","0020","0796","494","250","244","35","529","1141","0","46.36","21.91"
"68","000","00","020","0020","0797","514","215","299","24","538","1067","0","50.42","20.15"
"68","000","00","020","0021","0000","1900","960","940","84","1984","3189","0","62.21","30.10"
"68","000","00","020","0021","0874","864","429","435","39","903","1591","0","56.76","26.96"
"68","000","00","020","0021","0875","1036","531","505","45","1081","1598","0","67.65","33.23"
"68","000","00","020","0022","0000","2651","1449","1202","88","2739","4705","0","58.21","30.80"
"68","000","00","020","0022","0943","833","486","347","48","881","1670","0","52.75","29.10"
"68","000","00","020","0022","0944","1089","574","515","27","1116","1679","0","66.47","34.19"
"68","000","00","020","0022","0945","729","389","340","13","742","1356","0","54.72","28.69"
"68","000","00","020","0023","0000","1351","646","705","58","1409","2594","0","54.32","24.90"
"68","000","00","020","0023","0805","622","310","312","38","660","1248","0","52.88","24.84"
"68","000","00","020","0023","0806","729","336","393","20","749","1346","0","55.65","24.96"
"68","000","00","020","0024","0000","1969","1036","933","96","2065","3617","0","57.09","28.64"
"68","000","00","020","0024","0919","665","339","326","37","702","1204","0","58.31","28.16"
"68","000","00","020","0024","0920","642","379","263","29","671","1151","0","58.30","32.93"
"68","000","00","020","0024","0921","662","318","344","30","692","1262","0","54.83","25.20"
"68","000","00","020","0025","0000","2033","1005","1028","96","2129","3545","0","60.06","28.35"
"68","000","00","020","0025","0864","648","346","302","43","691","1208","0","57.20","28.64"
"68","000","00","020","0025","0865","676","361","315","27","703","1189","0","59.13","30.36"
"68","000","00","020","0025","0866","709","298","411","26","735","1148","0","64.02","25.96"
"68","000","00","020","0026","0000","1896","883","1013","114","2010","3475","0","57.84","25.41"
"68","000","00","020","0026","0830","636","325","311","27","663","1078","0","61.50","30.15"
"68","000","00","020","0026","0831","628","292","336","39","667","1194","0","55.86","24.46"
"68","000","00","020","0026","0832","632","266","366","48","680","1203","0","56.53","22.11"
"68","000","00","020","0027","0000","4196","2153","2043","225","4421","6772","0","65.28","31.79"
"68","000","00","020","0027","0855","709","372","337","59","768","1191","0","64.48","31.23"
"68","000","00","020","0027","0856","706","365","341","39","745","1176","0","63.35","31.04"
"68","000","00","020","0027","0857","962","496","466","40","1002","1498","0","66.89","33.11"
"68","000","00","020","0027","0858","1048","531","517","51","1099","1656","0","66.36","32.07"
"68","000","00","020","0027","0859","771","389","382","36","807","1251","0","64.51","31.10"
"68","000","00","020","0028","0000","441","218","223","21","462","643","0","71.85","33.90"
"68","000","00","020","0028","0915","441","218","223","21","462","643","0","71.85","33.90"
"68","000","00","020","0029","0000","2471","1036","1435","184","2655","4480","0","59.26","23.13"
"68","000","00","020","0029","0729","875","380","495","71","946","1596","0","59.27","23.81"
"68","000","00","020","0029","0730","801","324","477","58","859","1451","0","59.20","22.33"
"68","000","00","020","0029","0731","795","332","463","55","850","1433","0","59.32","23.17"
"68","000","00","020","0030","0000","1537","653","884","147","1684","2721","0","61.89","24.00"
"68","000","00","020","0030","0787","845","375","470","69","914","1483","0","61.63","25.29"
"68","000","00","020","0030","0788","692","278","414","78","770","1238","0","62.20","22.46"
"68","000","00","020","0031","0000","2236","1091","1145","144","2380","3556","0","66.93","30.68"
"68","000","00","020","0031","0879","679","371","308","51","730","1103","0","66.18","33.64"
"68","000","00","020","0031","0880","823","396","427","53","876","1269","0","69.03","31.21"
"68","000","00","020","0031","0881","734","324","410","40","774","1184","0","65.37","27.36"
"68","000","00","020","0032","0000","4098","2189","1909","111","4209","7460","0","56.42","29.34"
"68","000","00","020","0032","0899","892","467","425","23","915","1724","0","53.07","27.09"
"68","000","00","020","0032","0900","846","464","382","46","892","1389","0","64.22","33.41"
"68","000","00","020","0032","0901","915","469","446","14","929","1702","0","54.58","27.56"
"68","000","00","020","0032","0902","836","408","428","18","854","1509","0","56.59","27.04"
"68","000","00","020","0032","0903","609","381","228","10","619","1136","0","54.49","33.54"
"68","000","00","020","0033","0000","1971","999","972","64","2035","3725","0","54.63","26.82"
"68","000","00","020","0033","0840","655","321","334","19","674","1191","0","56.59","26.95"
"68","000","00","020","0033","0841","650","349","301","26","676","1304","0","51.84","26.76"
"68","000","00","020","0033","0842","666","329","337","19","685","1230","0","55.69","26.75"
"68","000","00","020","0034","0000","4699","2333","2366","223","4922","8494","0","57.95","27.47"
"68","000","00","020","0034","0847","737","374","363","42","779","1397","0","55.76","26.77"
"68","000","00","020","0034","0848","754","364","390","46","800","1409","0","56.78","25.83"
"68","000","00","020","0034","0849","668","328","340","42","710","1201","0","59.12","27.31"
"68","000","00","020","0034","0850","824","394","430","41","865","1465","0","59.04","26.89"
"68","000","00","020","0034","0851","900","457","443","26","926","1498","0","61.82","30.51"
"68","000","00","020","0034","0852","816","416","400","26","842","1524","0","55.25","27.30"
"68","000","00","020","0035","0000","1036","557","479","57","1093","1787","0","61.16","31.17"
"68","000","00","020","0035","0908","511","282","229","25","536","907","0","59.10","31.09"
"68","000","00","020","0035","0909","525","275","250","32","557","880","0","63.30","31.25"
"68","000","00","020","0036","0000","2343","1141","1202","132","2475","3949","0","62.67","28.89"
"68","000","00","020","0036","0888","618","283","335","49","667","925","0","72.11","30.59"
"68","000","00","020","0036","0889","964","473","491","9","973","1718","0","56.64","27.53"
"68","000","00","020","0036","0890","761","385","376","74","835","1306","0","63.94","29.48"
"68","000","00","020","0037","0000","2571","1185","1386","95","2666","4194","0","63.57","28.25"
"68","000","00","020","0037","0761","785","360","425","35","820","1276","0","64.26","28.21"
"68","000","00","020","0037","0762","900","409","491","37","937","1384","0","67.70","29.55"
"68","000","00","020","0037","0763","886","416","470","23","909","1534","0","59.26","27.12"
"68","000","00","020","0038","0000","885","481","404","44","929","1519","0","61.16","31.67"
"68","000","00","020","0038","0860","885","481","404","44","929","1519","0","61.16","31.67"
"68","000","00","020","0039","0000","2748","1025","1723","202","2950","4772","0","61.82","21.48"
"68","000","00","020","0039","0732","861","350","511","64","925","1600","0","57.81","21.88"
"68","000","00","020","0039","0733","929","335","594","61","990","1516","0","65.30","22.10"
"68","000","00","020","0039","0734","958","340","618","77","1035","1656","0","62.50","20.53"
"68","000","00","020","0040","0000","569","324","245","14","583","955","0","61.05","33.93"
"68","000","00","020","0040","0917","569","324","245","14","583","955","0","61.05","33.93"
"68","000","00","020","0041","0000","1616","773","843","69","1685","2866","0","58.79","26.97"
"68","000","00","020","0041","0906","810","414","396","40","850","1329","0","63.96","31.15"
"68","000","00","020","0041","0907","806","359","447","29","835","1537","0","54.33","23.36"
"68","000","00","020","0042","0000","2467","1151","1316","115","2582","4751","0","54.35","24.23"
"68","000","00","020","0042","0710","830","379","451","28","858","1463","0","58.65","25.91"
"68","000","00","020","0042","0711","833","400","433","52","885","1674","0","52.87","23.89"
"68","000","00","020","0042","0712","804","372","432","35","839","1614","0","51.98","23.05"
"68","000","00","020","0043","0000","4299","2250","2049","151","4450","8121","0","54.80","27.71"
"68","000","00","020","0043","0958","980","568","412","38","1018","1633","0","62.34","34.78"
"68","000","00","020","0043","0959","848","426","422","56","904","1571","0","57.54","27.12"
"68","000","00","020","0043","0960","841","402","439","21","862","1621","0","53.18","24.80"
"68","000","00","020","0043","0961","807","433","374","20","827","1666","0","49.64","25.99"
"68","000","00","020","0043","0962","823","421","402","16","839","1630","0","51.47","25.83"
"68","000","00","020","0044","0000","3638","1849","1789","180","3818","6141","0","62.17","30.11"
"68","000","00","020","0044","0932","723","348","375","29","752","1256","0","59.87","27.71"
"68","000","00","020","0044","0933","687","359","328","44","731","1222","0","59.82","29.38"
"68","000","00","020","0044","0934","802","411","391","43","845","1250","0","67.60","32.88"
"68","000","00","020","0044","0935","698","366","332","41","739","1200","0","61.58","30.50"
"68","000","00","020","0044","0936","728","365","363","23","751","1213","0","61.91","30.09"
"68","000","00","020","0045","0000","871","456","415","48","919","1363","0","67.42","33.46"
"68","000","00","020","0045","0918","871","456","415","48","919","1363","0","67.42","33.46"
"68","000","00","020","0046","0000","2441","1363","1078","102","2543","4479","0","56.78","30.43"
"68","000","00","020","0046","0940","813","491","322","34","847","1432","0","59.15","34.29"
"68","000","00","020","0046","0941","763","428","335","52","815","1296","0","62.89","33.02"
"68","000","00","020","0046","0942","865","444","421","16","881","1751","0","50.31","25.36"
"68","000","00","020","0047","0000","3224","1863","1361","181","3405","5577","0","61.05","33.41"
"68","000","00","020","0047","0951","843","473","370","44","887","1493","0","59.41","31.68"
"68","000","00","020","0047","0952","723","410","313","40","763","1360","0","56.10","30.15"
"68","000","00","020","0047","0953","954","568","386","62","1016","1583","0","64.18","35.88"
"68","000","00","020","0047","0954","704","412","292","35","739","1141","0","64.77","36.11"
"68","000","00","020","0048","0000","1914","1019","895","92","2006","3179","0","63.10","32.05"
"68","000","00","020","0048","0930","957","529","428","51","1008","1545","0","65.24","34.24"
"68","000","00","020","0048","0931","957","490","467","41","998","1634","0","61.08","29.99"
"68","000","00","020","0049","0000","2196","1309","887","140","2336","3681","0","63.46","35.56"
"68","000","00","020","0049","0955","733","405","328","40","773","1216","0","63.57","33.31"
"68","000","00","020","0049","0956","794","520","274","47","841","1274","0","66.01","40.82"
"68","000","00","020","0049","0957","669","384","285","53","722","1191","0","60.62","32.24"
"68","000","00","020","0050","0000","467","262","205","44","511","797","0","64.12","32.87"
"68","000","00","020","0050","0916","467","262","205","44","511","797","0","64.12","32.87"
"68","000","00","020","0051","0000","2779","1548","1231","148","2927","4650","0","62.95","33.29"
"68","000","00","020","0051","0948","975","551","424","54","1029","1680","0","61.25","32.80"
"68","000","00","020","0051","0949","845","458","387","57","902","1394","0","64.71","32.86"
"68","000","00","020","0051","0950","959","539","420","37","996","1576","0","63.20","34.20"
"68","000","00","020","0052","0000","2584","1131","1453","151","2735","4666","0","58.62","24.24"
"68","000","00","020","0052","0870","701","317","384","39","740","1194","0","61.98","26.55"
"68","000","00","020","0052","0871","658","276","382","30","688","1278","0","53.83","21.60"
"68","000","00","020","0052","0872","639","255","384","44","683","1171","0","58.33","21.78"
"68","000","00","020","0052","0873","586","283","303","38","624","1023","0","61.00","27.66"
"68","000","00","020","0053","0000","1483","665","818","92","1575","2500","0","63.00","26.60"
"68","000","00","020","0053","0759","752","336","416","42","794","1277","0","62.18","26.31"
"68","000","00","020","0053","0760","731","329","402","50","781","1223","0","63.86","26.90"
"68","000","00","020","0054","0000","1723","918","805","107","1830","2646","0","69.16","34.69"
"68","000","00","020","0054","0912","614","349","265","40","654","982","0","66.60","35.54"
"68","000","00","020","0054","0913","1109","569","540","67","1176","1664","0","70.67","34.19"
"68","000","00","020","0055","0000","2936","1466","1470","125","3061","5301","0","57.74","27.66"
"68","000","00","020","0055","0926","729","397","332","43","772","1272","0","60.69","31.21"
"68","000","00","020","0055","0927","825","393","432","35","860","1450","0","59.31","27.10"
"68","000","00","020","0055","0928","666","339","327","37","703","1183","0","59.43","28.66"
"68","000","00","020","0055","0929","716","337","379","10","726","1396","0","52.01","24.14"
"68","000","00","020","0056","0000","3041","1417","1624","114","3155","5383","0","58.61","26.32"
"68","000","00","020","0056","0843","733","343","390","35","768","1253","0","61.29","27.37"
"68","000","00","020","0056","0844","818","397","421","12","830","1465","0","56.66","27.10"
"68","000","00","020","0056","0845","591","283","308","21","612","1189","0","51.47","23.80"
"68","000","00","020","0056","0846","899","394","505","46","945","1476","0","64.02","26.69"
"68","000","00","020","0057","0000","2361","1107","1254","108","2469","4484","0","55.06","24.69"
"68","000","00","020","0057","0833","905","426","479","59","964","1581","0","60.97","26.94"
"68","000","00","020","0057","0834","655","333","322","30","685","1388","0","49.35","23.99"
"68","000","00","020","0057","0835","801","348","453","19","820","1515","0","54.13","22.97"
"68","000","00","020","0058","0000","1631","751","880","80","1711","2725","0","62.79","27.56"
"68","000","00","020","0058","0828","738","348","390","50","788","1280","0","61.56","27.19"
"68","000","00","020","0058","0829","893","403","490","30","923","1445","0","63.88","27.89"
"68","000","00","020","0059","0000","1399","711","688","72","1471","2465","0","59.68","28.84"
"68","000","00","020","0059","0853","661","354","307","34","695","1211","0","57.39","29.23"
"68","000","00","020","0059","0854","738","357","381","38","776","1254","0","61.88","28.47"
"68","000","00","020","0060","0000","1805","853","952","73","1878","3136","0","59.89","27.20"
"68","000","00","020","0060","0754","947","478","469","38","985","1644","0","59.91","29.08"
"68","000","00","020","0060","0755","858","375","483","35","893","1492","0","59.85","25.13"
"68","000","00","020","0061","0000","2138","956","1182","86","2224","3533","0","62.95","27.06"
"68","000","00","020","0061","0756","674","289","385","26","700","1087","0","64.40","26.59"
"68","000","00","020","0061","0757","699","302","397","32","731","1119","0","65.33","26.99"
"68","000","00","020","0061","0758","765","365","400","28","793","1327","0","59.76","27.51"
"68","000","00","020","0062","0000","2753","1320","1433","99","2852","4503","0","63.34","29.31"
"68","000","00","020","0062","0713","982","460","522","42","1024","1651","0","62.02","27.86"
"68","000","00","020","0062","0714","807","382","425","30","837","1384","0","60.48","27.60"
"68","000","00","020","0062","0715","964","478","486","27","991","1468","0","67.51","32.56"
"68","000","00","020","0063","0000","1981","800","1181","92","2073","3613","0","57.38","22.14"
"68","000","00","020","0063","0716","573","219","354","34","607","1045","0","58.09","20.96"
"68","000","00","020","0063","0717","768","284","484","40","808","1285","0","62.88","22.10"
"68","000","00","020","0063","0718","640","297","343","18","658","1283","0","51.29","23.15"
"68","000","00","020","0064","0000","2045","1079","966","173","2218","3501","0","63.35","30.82"
"68","000","00","020","0064","0937","660","349","311","38","698","1043","0","66.92","33.46"
"68","000","00","020","0064","0938","607","318","289","57","664","1103","0","60.20","28.83"
"68","000","00","020","0064","0939","778","412","366","78","856","1355","0","63.17","30.41"
"68","000","00","020","0065","0000","2467","1072","1395","101","2568","3968","0","64.72","27.02"
"68","000","00","020","0065","0726","814","386","428","30","844","1287","0","65.58","29.99"
"68","000","00","020","0065","0727","808","351","457","34","842","1255","0","67.09","27.97"
"68","000","00","020","0065","0728","845","335","510","37","882","1426","0","61.85","23.49"
"68","000","00","020","0066","0000","2466","1208","1258","69","2535","4114","0","61.62","29.36"
"68","000","00","020","0066","0764","805","371","434","22","827","1339","0","61.76","27.71"
"68","000","00","020","0066","0765","791","385","406","21","812","1334","0","60.87","28.86"
"68","000","00","020","0066","0766","870","452","418","26","896","1441","0","62.18","31.37"
"68","000","00","020","0067","0000","1253","465","788","101","1354","1956","0","69.22","23.77"
"68","000","00","020","0067","0778","570","211","359","51","621","928","0","66.92","22.74"
"68","000","00","020","0067","0779","683","254","429","50","733","1028","0","71.30","24.71"
"68","000","00","020","0068","0000","2398","1067","1331","79","2477","4581","0","54.07","23.29"
"68","000","00","020","0068","0802","704","297","407","22","726","1438","0","50.49","20.65"
"68","000","00","020","0068","0803","931","441","490","35","966","1682","0","57.43","26.22"
"68","000","00","020","0068","0804","763","329","434","22","785","1461","0","53.73","22.52"
"68","000","00","020","0069","0000","1441","677","764","50","1491","2390","0","62.38","28.33"
"68","000","00","020","0069","0770","632","275","357","16","648","1053","0","61.54","26.12"
"68","000","00","020","0069","0771","809","402","407","34","843","1337","0","63.05","30.07"
"68","000","00","020","0070","0000","2044","1078","966","94","2138","3708","0","57.66","29.07"
"68","000","00","020","0070","0772","588","290","298","26","614","1127","0","54.48","25.73"
"68","000","00","020","0070","0773","739","408","331","35","774","1307","0","59.22","31.22"
"68","000","00","020","0070","0774","717","380","337","33","750","1274","0","58.87","29.83"
"68","000","00","020","0071","0000","2026","853","1173","131","2157","3895","0","55.38","21.90"
"68","000","00","020","0071","0789","584","218","366","61","645","1021","0","63.17","21.35"
"68","000","00","020","0071","0790","715","306","409","41","756","1395","0","54.19","21.94"
"68","000","00","020","0071","0791","727","329","398","29","756","1479","0","51.12","22.24"
"68","000","00","020","0072","0000","2606","1131","1475","135","2741","4636","0","59.12","24.40"
"68","000","00","020","0072","0745","957","427","530","55","1012","1583","0","63.93","26.97"
"68","000","00","020","0072","0746","858","366","492","42","900","1528","0","58.90","23.95"
"68","000","00","020","0072","0747","791","338","453","38","829","1525","0","54.36","22.16"
"68","000","00","020","0073","0000","3189","1566","1623","146","3335","5947","0","56.08","26.33"
"68","000","00","020","0073","0891","856","448","408","46","902","1539","0","58.61","29.11"
"68","000","00","020","0073","0892","826","405","421","32","858","1637","0","52.41","24.74"
"68","000","00","020","0073","0893","696","336","360","30","726","1340","0","54.18","25.07"
"68","000","00","020","0073","0894","811","377","434","38","849","1431","0","59.33","26.35"
"68","000","00","020","0074","0000","3376","1615","1761","155","3531","5300","0","66.62","30.47"
"68","000","00","020","0074","0895","357","188","169","20","377","625","0","60.32","30.08"
"68","000","00","020","0074","0896","966","478","488","51","1017","1463","0","69.51","32.67"
"68","000","00","020","0074","0897","1045","490","555","37","1082","1600","0","67.63","30.63"
"68","000","00","020","0074","0898","1008","459","549","47","1055","1612","0","65.45","28.47"
"68","000","00","020","0075","0000","1832","787","1045","83","1915","3479","0","55.04","22.62"
"68","000","00","020","0075","0784","773","323","450","47","820","1394","0","58.82","23.17"
"68","000","00","020","0075","0785","601","260","341","27","628","1193","0","52.64","21.79"
"68","000","00","020","0075","0786","458","204","254","9","467","892","0","52.35","22.87"
"68","000","00","020","0076","0000","1827","805","1022","111","1938","3499","0","55.39","23.01"
"68","000","00","020","0076","0748","601","277","324","46","647","1222","0","52.95","22.67"
"68","000","00","020","0076","0749","589","244","345","38","627","1084","0","57.84","22.51"
"68","000","00","020","0076","0750","637","284","353","27","664","1193","0","55.66","23.81"
"68","000","00","020","0077","0000","1819","648","1171","90","1909","3288","0","58.06","19.71"
"68","000","00","020","0077","0819","959","285","674","50","1009","1633","0","61.79","17.45"
"68","000","00","020","0077","0820","860","363","497","40","900","1655","0","54.38","21.93"
"68","000","00","020","0078","0000","1949","862","1087","115","2064","3545","0","58.22","24.32"
"68","000","00","020","0078","0821","961","397","564","55","1016","1774","0","57.27","22.38"
"68","000","00","020","0078","0822","988","465","523","60","1048","1771","0","59.18","26.26"
"68","000","00","020","0079","0000","2491","1122","1369","128","2619","4275","0","61.26","26.25"
"68","000","00","020","0079","0876","806","351","455","51","857","1305","0","65.67","26.90"
"68","000","00","020","0079","0877","816","351","465","39","855","1481","0","57.73","23.70"
"68","000","00","020","0079","0878","869","420","449","38","907","1489","0","60.91","28.21"
"68","000","00","020","0080","0000","1558","816","742","80","1638","2353","0","69.61","34.68"
"68","000","00","020","0080","0910","767","411","356","45","812","1195","0","67.95","34.39"
"68","000","00","020","0080","0911","791","405","386","35","826","1158","0","71.33","34.97"
"68","000","00","020","0081","0000","1728","763","965","54","1782","3309","0","53.85","23.06"
"68","000","00","020","0081","0809","875","376","499","34","909","1755","0","51.79","21.42"
"68","000","00","020","0081","0810","853","387","466","20","873","1554","0","56.18","24.90"
"68","000","00","020","0082","0000","2467","1104","1363","102","2569","4628","0","55.51","23.85"
"68","000","00","020","0082","0719","633","299","334","26","659","1096","0","60.13","27.28"
"68","000","00","020","0082","0720","729","312","417","29","758","1374","0","55.17","22.71"
"68","000","00","020","0082","0721","607","252","355","22","629","1234","0","50.97","20.42"
"68","000","00","020","0082","0722","498","241","257","25","523","924","0","56.60","26.08"
"68","000","00","020","0083","0000","2819","1243","1576","106","2925","5426","0","53.91","22.91"
"68","000","00","020","0083","0815","687","304","383","37","724","1327","0","54.56","22.91"
"68","000","00","020","0083","0816","779","341","438","27","806","1415","0","56.96","24.10"
"68","000","00","020","0083","0817","689","285","404","20","709","1347","0","52.64","21.16"
"68","000","00","020","0083","0818","664","313","351","22","686","1337","0","51.31","23.41"
"68","000","00","020","0084","0000","2291","1079","1212","78","2369","3743","0","63.29","28.83"
"68","000","00","020","0084","0867","800","396","404","25","825","1334","0","61.84","29.69"
"68","000","00","020","0084","0868","695","325","370","28","723","1187","0","60.91","27.38"
"68","000","00","020","0084","0869","796","358","438","25","821","1222","0","67.18","29.30"
"68","000","00","020","0085","0000","2471","1099","1372","62","2533","3865","0","65.54","28.43"
"68","000","00","020","0085","0882","858","386","472","16","874","1357","0","64.41","28.45"
"68","000","00","020","0085","0883","829","362","467","27","856","1279","0","66.93","28.30"
"68","000","00","020","0085","0884","784","351","433","19","803","1229","0","65.34","28.56"
"68","000","00","020","0086","0000","1785","933","852","35","1820","3037","0","59.93","30.72"
"68","000","00","020","0086","0946","688","384","304","14","702","1155","0","60.78","33.25"
"68","000","00","020","0086","0947","1097","549","548","21","1118","1882","0","59.40","29.17"
"68","000","00","020","0087","0000","3140","1535","1605","123","3263","5680","0","57.45","27.02"
"68","000","00","020","0087","0836","757","377","380","50","807","1373","0","58.78","27.46"
"68","000","00","020","0087","0837","821","413","408","18","839","1453","0","57.74","28.42"
"68","000","00","020","0087","0838","771","380","391","22","793","1370","0","57.88","27.74"
"68","000","00","020","0087","0839","791","365","426","33","824","1484","0","55.53","24.60"
"68","000","00","020","0088","0000","2168","1060","1108","109","2277","3696","0","61.61","28.68"
"68","000","00","020","0088","0885","728","357","371","49","777","1165","0","66.70","30.64"
"68","000","00","020","0088","0886","646","313","333","29","675","1200","0","56.25","26.08"
"68","000","00","020","0088","0887","794","390","404","31","825","1331","0","61.98","29.30"
"68","000","00","030","0000","0000","41990","22222","19768","2804","44794","77466","94151","57.82","28.69"
"68","000","00","030","0001","0000","853","496","357","57","910","1375","0","66.18","36.07"
"68","000","00","030","0001","0636","853","496","357","57","910","1375","0","66.18","36.07"
"68","000","00","030","0002","0000","582","371","211","27","609","929","0","65.55","39.94"
"68","000","00","030","0002","0637","582","371","211","27","609","929","0","65.55","39.94"
"68","000","00","030","0003","0000","2353","1264","1089","90","2443","4674","0","52.27","27.04"
"68","000","00","030","0003","0641","566","304","262","17","583","1096","0","53.19","27.74"
"68","000","00","030","0003","0642","664","344","320","22","686","1231","0","55.73","27.94"
"68","000","00","030","0003","0643","630","334","296","38","668","1201","0","55.62","27.81"
"68","000","00","030","0003","0644","493","282","211","13","506","1146","0","44.15","24.61"
"68","000","00","030","0004","0000","2676","1502","1174","196","2872","5451","0","52.69","27.55"
"68","000","00","030","0004","0645","638","379","259","40","678","1203","0","56.36","31.50"
"68","000","00","030","0004","0646","657","354","303","37","694","1373","0","50.55","25.78"
"68","000","00","030","0004","0647","675","374","301","60","735","1380","0","53.26","27.10"
"68","000","00","030","0004","0648","706","395","311","59","765","1495","0","51.17","26.42"
"68","000","00","030","0005","0000","652","406","246","36","688","1206","0","57.05","33.67"
"68","000","00","030","0005","0649","652","406","246","36","688","1206","0","57.05","33.67"
"68","000","00","030","0006","0000","501","338","163","42","543","909","0","59.74","37.18"
"68","000","00","030","0006","0650","501","338","163","42","543","909","0","59.74","37.18"
"68","000","00","030","0007","0000","1827","1075","752","145","1972","2957","0","66.69","36.35"
"68","000","00","030","0007","0654","641","381","260","46","687","1036","0","66.31","36.78"
"68","000","00","030","0007","0655","741","433","308","68","809","1198","0","67.53","36.14"
"68","000","00","030","0007","0656","445","261","184","31","476","723","0","65.84","36.10"
"68","000","00","030","0008","0000","1206","769","437","150","1356","2137","0","63.45","35.99"
"68","000","00","030","0008","0657","672","412","260","78","750","1234","0","60.78","33.39"
"68","000","00","030","0008","0658","534","357","177","72","606","903","0","67.11","39.53"
"68","000","00","030","0009","0000","448","282","166","45","493","843","0","58.48","33.45"
"68","000","00","030","0009","0659","448","282","166","45","493","843","0","58.48","33.45"
"68","000","00","030","0010","0000","551","308","243","68","619","773","0","80.08","39.84"
"68","000","00","030","0010","0660","551","308","243","68","619","773","0","80.08","39.84"
"68","000","00","030","0011","0000","738","443","295","35","773","1245","0","62.09","35.58"
"68","000","00","030","0011","0651","738","443","295","35","773","1245","0","62.09","35.58"
"68","000","00","030","0012","0000","1037","625","412","66","1103","1672","0","65.97","37.38"
"68","000","00","030","0012","0652","661","397","264","41","702","1068","0","65.73","37.17"
"68","000","00","030","0012","0653","376","228","148","25","401","604","0","66.39","37.75"
"68","000","00","030","0013","0000","1333","757","576","122","1455","2580","0","56.40","29.34"
"68","000","00","030","0013","0663","716","456","260","73","789","1330","0","59.32","34.29"
"68","000","00","030","0013","0664","617","301","316","49","666","1250","0","53.28","24.08"
"68","000","00","030","0014","0000","994","612","382","82","1076","1466","0","73.40","41.75"
"68","000","00","030","0014","0661","551","348","203","36","587","802","0","73.19","43.39"
"68","000","00","030","0014","0662","443","264","179","46","489","664","0","73.64","39.76"
"68","000","00","030","0015","0000","1205","504","701","137","1342","2715","0","49.43","18.56"
"68","000","00","030","0015","0673","648","290","358","68","716","1412","0","50.71","20.54"
"68","000","00","030","0015","0674","557","214","343","69","626","1303","0","48.04","16.42"
"68","000","00","030","0016","0000","1355","394","961","82","1437","2376","0","60.48","16.58"
"68","000","00","030","0016","0671","707","153","554","43","750","1156","0","64.88","13.24"
"68","000","00","030","0016","0672","648","241","407","39","687","1220","0","56.31","19.75"
"68","000","00","030","0017","0000","2314","1172","1142","97","2411","4510","0","53.46","25.99"
"68","000","00","030","0017","0665","756","407","349","32","788","1514","0","52.05","26.88"
"68","000","00","030","0017","0666","671","327","344","30","701","1266","0","55.37","25.83"
"68","000","00","030","0017","0667","887","438","449","35","922","1730","0","53.29","25.32"
"68","000","00","030","0018","0000","2884","1428","1456","162","3046","5048","0","60.34","28.29"
"68","000","00","030","0018","0678","755","376","379","28","783","1305","0","60.00","28.81"
"68","000","00","030","0018","0679","668","342","326","51","719","1077","0","66.76","31.75"
"68","000","00","030","0018","0680","754","372","382","27","781","1303","0","59.94","28.55"
"68","000","00","030","0018","0681","707","338","369","56","763","1363","0","55.98","24.80"
"68","000","00","030","0019","0000","1736","843","893","123","1859","3117","0","59.64","27.05"
"68","000","00","030","0019","0682","956","471","485","72","1028","1701","0","60.44","27.69"
"68","000","00","030","0019","0683","780","372","408","51","831","1416","0","58.69","26.27"
"68","000","00","030","0020","0000","947","497","450","61","1008","1625","0","62.03","30.58"
"68","000","00","030","0020","0693","947","497","450","61","1008","1625","0","62.03","30.58"
"68","000","00","030","0021","0000","2741","1553","1188","197","2938","5022","0","58.50","30.92"
"68","000","00","030","0021","0687","662","399","263","40","702","1177","0","59.64","33.90"
"68","000","00","030","0021","0688","725","430","295","42","767","1261","0","60.82","34.10"
"68","000","00","030","0021","0689","623","368","255","43","666","1273","0","52.32","28.91"
"68","000","00","030","0021","0690","731","356","375","72","803","1311","0","61.25","27.15"
"68","000","00","030","0022","0000","1801","922","879","114","1915","3596","0","53.25","25.64"
"68","000","00","030","0022","0696","599","308","291","25","624","1188","0","52.53","25.93"
"68","000","00","030","0022","0697","567","239","328","28","595","1122","0","53.03","21.30"
"68","000","00","030","0022","0698","635","375","260","61","696","1286","0","54.12","29.16"
"68","000","00","030","0023","0000","1075","447","628","68","1143","2351","0","48.62","19.01"
"68","000","00","030","0023","0691","499","228","271","34","533","1215","0","43.87","18.77"
"68","000","00","030","0023","0692","576","219","357","34","610","1136","0","53.70","19.28"
"68","000","00","030","0024","0000","1568","684","884","95","1663","2853","0","58.29","23.97"
"68","000","00","030","0024","0694","813","383","430","43","856","1416","0","60.45","27.05"
"68","000","00","030","0024","0695","755","301","454","52","807","1437","0","56.16","20.95"
"68","000","00","030","0025","0000","2226","1263","963","129","2355","4289","0","54.91","29.45"
"68","000","00","030","0025","0638","785","407","378","42","827","1488","0","55.58","27.35"
"68","000","00","030","0025","0639","717","426","291","49","766","1371","0","55.87","31.07"
"68","000","00","030","0025","0640","724","430","294","38","762","1430","0","53.29","30.07"
"68","000","00","030","0026","0000","2076","1045","1031","143","2219","3779","0","58.72","27.65"
"68","000","00","030","0026","0684","662","345","317","66","728","1303","0","55.87","26.48"
"68","000","00","030","0026","0685","593","298","295","28","621","1023","0","60.70","29.13"
"68","000","00","030","0026","0686","821","402","419","49","870","1453","0","59.88","27.67"
"68","000","00","030","0027","0000","2637","1354","1283","130","2767","4776","0","57.94","28.35"
"68","000","00","030","0027","0675","921","422","499","39","960","1642","0","58.47","25.70"
"68","000","00","030","0027","0676","884","461","423","40","924","1631","0","56.65","28.26"
"68","000","00","030","0027","0677","832","471","361","51","883","1503","0","58.75","31.34"
"68","000","00","030","0028","0000","1674","868","806","105","1779","3192","0","55.73","27.19"
"68","000","00","030","0028","0668","457","256","201","33","490","919","0","53.32","27.86"
"68","000","00","030","0028","0669","570","300","270","35","605","1023","0","59.14","29.33"
"68","000","00","030","0028","0670","647","312","335","37","684","1250","0","54.72","24.96"
"68","000","00","040","0000","0000","74082","34460","39622","3248","77330","142357","177184","54.32","24.21"
"68","000","00","040","0001","0000","2171","988","1183","88","2259","3754","0","60.18","26.32"
"68","000","00","040","0001","1147","783","390","393","30","813","1369","0","59.39","28.49"
"68","000","00","040","0001","1148","702","322","380","20","722","1235","0","58.46","26.07"
"68","000","00","040","0001","1149","686","276","410","38","724","1150","0","62.96","24.00"
"68","000","00","040","0002","0000","630","283","347","33","663","1040","0","63.75","27.21"
"68","000","00","040","0002","1150","630","283","347","33","663","1040","0","63.75","27.21"
"68","000","00","040","0003","0000","1416","623","793","82","1498","2502","0","59.87","24.90"
"68","000","00","040","0003","1153","617","288","329","41","658","1201","0","54.79","23.98"
"68","000","00","040","0003","1154","799","335","464","41","840","1301","0","64.57","25.75"
"68","000","00","040","0004","0000","3471","1601","1870","134","3605","7606","0","47.40","21.05"
"68","000","00","040","0004","1155","690","347","343","36","726","2109","0","34.42","16.45"
"68","000","00","040","0004","1156","674","335","339","25","699","1408","0","49.64","23.79"
"68","000","00","040","0004","1157","737","302","435","25","762","1372","0","55.54","22.01"
"68","000","00","040","0004","1158","705","289","416","20","725","1381","0","52.50","20.93"
"68","000","00","040","0004","1159","665","328","337","28","693","1336","0","51.87","24.55"
"68","000","00","040","0005","0000","1557","712","845","103","1660","3007","0","55.20","23.68"
"68","000","00","040","0005","1160","724","337","387","39","763","1501","0","50.83","22.45"
"68","000","00","040","0005","1161","833","375","458","64","897","1506","0","59.56","24.90"
"68","000","00","040","0006","0000","1429","752","677","53","1482","2887","0","51.33","26.05"
"68","000","00","040","0006","1164","847","447","400","33","880","1747","0","50.37","25.59"
"68","000","00","040","0006","1165","582","305","277","20","602","1140","0","52.81","26.75"
"68","000","00","040","0007","0000","2347","1069","1278","122","2469","3995","0","61.80","26.76"
"68","000","00","040","0007","1199","850","387","463","50","900","1435","0","62.72","26.97"
"68","000","00","040","0007","1200","717","320","397","32","749","1277","0","58.65","25.06"
"68","000","00","040","0007","1201","780","362","418","40","820","1283","0","63.91","28.22"
"68","000","00","040","0008","0000","1440","679","761","45","1485","2656","0","55.91","25.56"
"68","000","00","040","0008","1183","691","335","356","31","722","1149","0","62.84","29.16"
"68","000","00","040","0008","1184","749","344","405","14","763","1507","0","50.63","22.83"
"68","000","00","040","0009","0000","1183","497","686","54","1237","1921","0","64.39","25.87"
"68","000","00","040","0009","1151","533","205","328","31","564","918","0","61.44","22.33"
"68","000","00","040","0009","1152","650","292","358","23","673","1003","0","67.10","29.11"
"68","000","00","040","0010","0000","1801","796","1005","60","1861","3454","0","53.88","23.05"
"68","000","00","040","0010","1143","926","424","502","37","963","1778","0","54.16","23.85"
"68","000","00","040","0010","1144","875","372","503","23","898","1676","0","53.58","22.20"
"68","000","00","040","0011","0000","812","392","420","34","846","1301","0","65.03","30.13"
"68","000","00","040","0011","1106","812","392","420","34","846","1301","0","65.03","30.13"
"68","000","00","040","0012","0000","900","378","522","61","961","1576","0","60.98","23.98"
"68","000","00","040","0012","1109","900","378","522","61","961","1576","0","60.98","23.98"
"68","000","00","040","0013","0000","2663","1292","1371","90","2753","5669","0","48.56","22.79"
"68","000","00","040","0013","1115","773","403","370","30","803","1684","0","47.68","23.93"
"68","000","00","040","0013","1116","596","299","297","17","613","1336","0","45.88","22.38"
"68","000","00","040","0013","1117","686","322","364","26","712","1408","0","50.57","22.87"
"68","000","00","040","0013","1118","608","268","340","17","625","1241","0","50.36","21.60"
"68","000","00","040","0014","0000","2535","1105","1430","85","2620","4572","0","57.31","24.17"
"68","000","00","040","0014","1110","850","398","452","25","875","1536","0","56.97","25.91"
"68","000","00","040","0014","1111","822","335","487","37","859","1502","0","57.19","22.30"
"68","000","00","040","0014","1112","863","372","491","23","886","1534","0","57.76","24.25"
"68","000","00","040","0015","0000","1973","939","1034","62","2035","4061","0","50.11","23.12"
"68","000","00","040","0015","1123","734","340","394","23","757","1396","0","54.23","24.36"
"68","000","00","040","0015","1124","590","270","320","21","611","1303","0","46.89","20.72"
"68","000","00","040","0015","1125","649","329","320","18","667","1362","0","48.97","24.16"
"68","000","00","040","0016","0000","1677","721","956","90","1767","3673","0","48.11","19.63"
"68","000","00","040","0016","1185","504","187","317","41","545","1167","0","46.70","16.02"
"68","000","00","040","0016","1186","563","269","294","28","591","1276","0","46.32","21.08"
"68","000","00","040","0016","1187","610","265","345","21","631","1230","0","51.30","21.54"
"68","000","00","040","0017","0000","1654","842","812","69","1723","3407","0","50.57","24.71"
"68","000","00","040","0017","1193","792","414","378","28","820","1640","0","50.00","25.24"
"68","000","00","040","0017","1194","862","428","434","41","903","1767","0","51.10","24.22"
"68","000","00","040","0018","0000","2036","940","1096","89","2125","3728","0","57.00","25.21"
"68","000","00","040","0018","1103","622","275","347","27","649","1204","0","53.90","22.84"
"68","000","00","040","0018","1104","683","322","361","23","706","1291","0","54.69","24.94"
"68","000","00","040","0018","1105","731","343","388","39","770","1233","0","62.45","27.82"
"68","000","00","040","0019","0000","1589","670","919","80","1669","3000","0","55.63","22.33"
"68","000","00","040","0019","1107","746","307","439","28","774","1440","0","53.75","21.32"
"68","000","00","040","0019","1108","843","363","480","52","895","1560","0","57.37","23.27"
"68","000","00","040","0020","0000","964","456","508","66","1030","1712","0","60.16","26.64"
"68","000","00","040","0020","1169","506","216","290","29","535","891","0","60.04","24.24"
"68","000","00","040","0020","1170","458","240","218","37","495","821","0","60.29","29.23"
"68","000","00","040","0021","0000","2084","1005","1079","109","2193","3760","0","58.32","26.73"
"68","000","00","040","0021","1166","704","328","376","51","755","1286","0","58.71","25.51"
"68","000","00","040","0021","1167","658","318","340","32","690","1197","0","57.64","26.57"
"68","000","00","040","0021","1168","722","359","363","26","748","1277","0","58.57","28.11"
"68","000","00","040","0022","0000","1438","710","728","83","1521","2818","0","53.97","25.20"
"68","000","00","040","0022","1173","819","401","418","40","859","1596","0","53.82","25.13"
"68","000","00","040","0022","1174","619","309","310","43","662","1222","0","54.17","25.29"
"68","000","00","040","0023","0000","1933","933","1000","95","2028","3618","0","56.05","25.79"
"68","000","00","040","0023","1202","602","297","305","37","639","1193","0","53.56","24.90"
"68","000","00","040","0023","1203","677","317","360","28","705","1162","0","60.67","27.28"
"68","000","00","040","0023","1204","654","319","335","30","684","1263","0","54.16","25.26"
"68","000","00","040","0024","0000","1597","753","844","99","1696","2866","0","59.18","26.27"
"68","000","00","040","0024","1175","743","333","410","51","794","1392","0","57.04","23.92"
"68","000","00","040","0024","1176","854","420","434","48","902","1474","0","61.19","28.49"
"68","000","00","040","0025","0000","2864","1360","1504","142","3006","5846","0","51.42","23.26"
"68","000","00","040","0025","1179","852","419","433","23","875","1618","0","54.08","25.90"
"68","000","00","040","0025","1180","709","347","362","60","769","1412","0","54.46","24.58"
"68","000","00","040","0025","1181","670","301","369","25","695","1388","0","50.07","21.69"
"68","000","00","040","0025","1182","633","293","340","34","667","1428","0","46.71","20.52"
"68","000","00","040","0026","0000","1600","763","837","38","1638","2894","0","56.60","26.36"
"68","000","00","040","0026","1145","928","434","494","27","955","1643","0","58.13","26.42"
"68","000","00","040","0026","1146","672","329","343","11","683","1251","0","54.60","26.30"
"68","000","00","040","0027","0000","4010","1851","2159","120","4130","7701","0","53.63","24.04"
"68","000","00","040","0027","1134","817","360","457","53","870","1569","0","55.45","22.94"
"68","000","00","040","0027","1135","836","366","470","33","869","1429","0","60.81","25.61"
"68","000","00","040","0027","1136","822","379","443","17","839","1538","0","54.55","24.64"
"68","000","00","040","0027","1137","737","350","387","10","747","1518","0","49.21","23.06"
"68","000","00","040","0027","1138","798","396","402","7","805","1647","0","48.88","24.04"
"68","000","00","040","0028","0000","1925","837","1088","53","1978","3945","0","50.14","21.22"
"68","000","00","040","0028","1129","737","330","407","26","763","1833","0","41.63","18.00"
"68","000","00","040","0028","1130","622","269","353","14","636","1092","0","58.24","24.63"
"68","000","00","040","0028","1131","566","238","328","13","579","1020","0","56.76","23.33"
"68","000","00","040","0029","0000","1790","775","1015","47","1837","3148","0","58.35","24.62"
"68","000","00","040","0029","1139","902","372","530","32","934","1561","0","59.83","23.83"
"68","000","00","040","0029","1140","888","403","485","15","903","1587","0","56.90","25.39"
"68","000","00","040","0030","0000","1768","840","928","98","1866","3241","0","57.57","25.92"
"68","000","00","040","0030","1162","910","434","476","54","964","1600","0","60.25","27.13"
"68","000","00","040","0030","1163","858","406","452","44","902","1641","0","54.97","24.74"
"68","000","00","040","0031","0000","2216","1103","1113","81","2297","4495","0","51.10","24.54"
"68","000","00","040","0031","1190","770","379","391","37","807","1506","0","53.59","25.17"
"68","000","00","040","0031","1191","720","389","331","17","737","1598","0","46.12","24.34"
"68","000","00","040","0031","1192","726","335","391","27","753","1391","0","54.13","24.08"
"68","000","00","040","0032","0000","1830","953","877","112","1942","3346","0","58.04","28.48"
"68","000","00","040","0032","1197","963","513","450","53","1016","1675","0","60.66","30.63"
"68","000","00","040","0032","1198","867","440","427","59","926","1671","0","55.42","26.33"
"68","000","00","040","0033","0000","1885","902","983","76","1961","3171","0","61.84","28.45"
"68","000","00","040","0033","1195","897","417","480","44","941","1588","0","59.26","26.26"
"68","000","00","040","0033","1196","988","485","503","32","1020","1583","0","64.43","30.64"
"68","000","00","040","0034","0000","2879","1176","1703","108","2987","6128","0","48.74","19.19"
"68","000","00","040","0034","1119","667","239","428","32","699","1442","0","48.47","16.57"
"68","000","00","040","0034","1120","695","300","395","23","718","1614","0","44.49","18.59"
"68","000","00","040","0034","1121","754","323","431","30","784","1536","0","51.04","21.03"
"68","000","00","040","0034","1122","763","314","449","23","786","1536","0","51.17","20.44"
"68","000","00","040","0035","0000","1135","523","612","37","1172","2010","0","58.31","26.02"
"68","000","00","040","0035","1113","445","222","223","17","462","934","0","49.46","23.77"
"68","000","00","040","0035","1114","690","301","389","20","710","1076","0","65.99","27.97"
"68","000","00","040","0036","0000","1604","762","842","61","1665","3519","0","47.31","21.65"
"68","000","00","040","0036","1126","503","259","244","8","511","1247","0","40.98","20.77"
"68","000","00","040","0036","1127","618","287","331","29","647","1185","0","54.60","24.22"
"68","000","00","040","0036","1128","483","216","267","24","507","1087","0","46.64","19.87"
"68","000","00","040","0037","0000","1449","743","706","95","1544","2682","0","57.57","27.70"
"68","000","00","040","0037","1188","732","398","334","43","775","1412","0","54.89","28.19"
"68","000","00","040","0037","1189","717","345","372","52","769","1270","0","60.55","27.17"
"68","000","00","040","0038","0000","1697","833","864","109","1806","3027","0","59.66","27.52"
"68","000","00","040","0038","1171","839","436","403","57","896","1490","0","60.13","29.26"
"68","000","00","040","0038","1172","858","397","461","52","910","1537","0","59.21","25.83"
"68","000","00","040","0039","0000","1211","531","680","56","1267","2445","0","51.82","21.72"
"68","000","00","040","0039","1141","526","217","309","24","550","1255","0","43.82","17.29"
"68","000","00","040","0039","1142","685","314","371","32","717","1190","0","60.25","26.39"
"68","000","00","040","0040","0000","1552","705","847","61","1613","3339","0","48.31","21.11"
"68","000","00","040","0040","1132","830","371","459","37","867","1613","0","53.75","23.00"
"68","000","00","040","0040","1133","722","334","388","24","746","1726","0","43.22","19.35"
"68","000","00","040","0041","0000","1367","667","700","68","1435","2837","0","50.58","23.51"
"68","000","00","040","0041","1177","704","309","395","39","743","1289","0","57.64","23.97"
"68","000","00","040","0041","1178","663","358","305","29","692","1548","0","44.70","23.13"
"68","000","00","050","0000","0000","73887","39599","34288","3450","77337","130849","166448","59.10","30.26"
"68","000","00","050","0001","0000","1736","1036","700","104","1840","2869","0","64.13","36.11"
"68","000","00","050","0001","0487","961","565","396","50","1011","1526","0","66.25","37.02"
"68","000","00","050","0001","0488","775","471","304","54","829","1343","0","61.73","35.07"
"68","000","00","050","0002","0000","2405","1390","1015","135","2540","3995","0","63.58","34.79"
"68","000","00","050","0002","0489","846","475","371","47","893","1428","0","62.54","33.26"
"68","000","00","050","0002","0490","836","490","346","63","899","1365","0","65.86","35.90"
"68","000","00","050","0002","0491","723","425","298","25","748","1202","0","62.23","35.36"
"68","000","00","050","0003","0000","2893","1598","1295","174","3067","4954","0","61.91","32.26"
"68","000","00","050","0003","0497","934","496","438","47","981","1659","0","59.13","29.90"
"68","000","00","050","0003","0498","660","372","288","31","691","1170","0","59.06","31.79"
"68","000","00","050","0003","0499","652","387","265","44","696","1085","0","64.15","35.67"
"68","000","00","050","0003","0500","647","343","304","52","699","1040","0","67.21","32.98"
"68","000","00","050","0004","0000","2778","1467","1311","109","2887","5134","0","56.23","28.57"
"68","000","00","050","0004","0506","1040","556","484","35","1075","1967","0","54.65","28.27"
"68","000","00","050","0004","0507","893","444","449","38","931","1634","0","56.98","27.17"
"68","000","00","050","0004","0508","845","467","378","36","881","1533","0","57.47","30.46"
"68","000","00","050","0006","0000","2251","1298","953","150","2401","3837","0","62.57","33.83"
"68","000","00","050","0006","0510","658","382","276","54","712","1128","0","63.12","33.87"
"68","000","00","050","0006","0511","810","473","337","49","859","1346","0","63.82","35.14"
"68","000","00","050","0006","0512","783","443","340","47","830","1363","0","60.90","32.50"
"68","000","00","050","0007","0000","2069","1154","915","103","2172","3531","0","61.51","32.68"
"68","000","00","050","0007","0532","709","405","304","29","738","1135","0","65.02","35.68"
"68","000","00","050","0007","0533","770","429","341","54","824","1259","0","65.45","34.07"
"68","000","00","050","0007","0534","590","320","270","20","610","1137","0","53.65","28.14"
"68","000","00","050","0008","0000","2168","1148","1020","78","2246","3809","0","58.97","30.14"
"68","000","00","050","0008","0535","761","401","360","29","790","1296","0","60.96","30.94"
"68","000","00","050","0008","0536","628","345","283","26","654","1132","0","57.77","30.48"
"68","000","00","050","0008","0537","779","402","377","23","802","1381","0","58.07","29.11"
"68","000","00","050","0009","0000","1369","706","663","61","1430","2333","0","61.29","30.26"
"68","000","00","050","0009","0544","722","374","348","23","745","1175","0","63.40","31.83"
"68","000","00","050","0009","0545","647","332","315","38","685","1158","0","59.15","28.67"
"68","000","00","050","0010","0000","1338","775","563","94","1432","2517","0","56.89","30.79"
"68","000","00","050","0010","0567","516","301","215","21","537","1291","0","41.60","23.32"
"68","000","00","050","0010","0568","822","474","348","73","895","1226","0","73.00","38.66"
"68","000","00","050","0011","0000","999","537","462","72","1071","1816","0","58.98","29.57"
"68","000","00","050","0011","0569","999","537","462","72","1071","1816","0","58.98","29.57"
"68","000","00","050","0012","0000","2125","1220","905","177","2302","3467","0","66.40","35.19"
"68","000","00","050","0012","0570","713","401","312","63","776","1161","0","66.84","34.54"
"68","000","00","050","0012","0571","737","414","323","58","795","1183","0","67.20","35.00"
"68","000","00","050","0012","0572","675","405","270","56","731","1123","0","65.09","36.06"
"68","000","00","050","0013","0000","1003","625","378","88","1091","1475","0","73.97","42.37"
"68","000","00","050","0013","0573","1003","625","378","88","1091","1475","0","73.97","42.37"
"68","000","00","050","0014","0000","960","597","363","76","1036","1613","0","64.23","37.01"
"68","000","00","050","0014","0574","960","597","363","76","1036","1613","0","64.23","37.01"
"68","000","00","050","0015","0000","1219","721","498","74","1293","2198","0","58.83","32.80"
"68","000","00","050","0015","0575","562","348","214","36","598","926","0","64.58","37.58"
"68","000","00","050","0015","0576","657","373","284","38","695","1272","0","54.64","29.32"
"68","000","00","050","0016","0000","1626","845","781","118","1744","2936","0","59.40","28.78"
"68","000","00","050","0016","0577","764","422","342","52","816","1456","0","56.04","28.98"
"68","000","00","050","0016","0578","862","423","439","66","928","1480","0","62.70","28.58"
"68","000","00","050","0017","0000","1891","1011","880","77","1968","3475","0","56.63","29.09"
"68","000","00","050","0017","0529","644","362","282","44","688","1194","0","57.62","30.32"
"68","000","00","050","0017","0530","694","371","323","23","717","1216","0","58.96","30.51"
"68","000","00","050","0017","0531","553","278","275","10","563","1065","0","52.86","26.10"
"68","000","00","050","0018","0000","2913","1454","1459","84","2997","5041","0","59.45","28.84"
"68","000","00","050","0018","0513","649","327","322","22","671","1159","0","57.89","28.21"
"68","000","00","050","0018","0514","771","364","407","23","794","1292","0","61.46","28.17"
"68","000","00","050","0018","0515","713","378","335","20","733","1257","0","58.31","30.07"
"68","000","00","050","0018","0516","780","385","395","19","799","1333","0","59.94","28.88"
"68","000","00","050","0019","0000","1265","661","604","101","1366","2549","0","53.59","25.93"
"68","000","00","050","0019","0542","621","329","292","69","690","1128","0","61.17","29.17"
"68","000","00","050","0019","0543","644","332","312","32","676","1421","0","47.57","23.36"
"68","000","00","050","0020","0000","1719","948","771","95","1814","3091","0","58.69","30.67"
"68","000","00","050","0020","0540","816","476","340","54","870","1441","0","60.37","33.03"
"68","000","00","050","0020","0541","903","472","431","41","944","1650","0","57.21","28.61"
"68","000","00","050","0021","0000","897","572","325","49","946","1328","0","71.23","43.07"
"68","000","00","050","0021","0509","897","572","325","49","946","1328","0","71.23","43.07"
"68","000","00","050","0022","0000","1920","989","931","96","2016","3438","0","58.64","28.77"
"68","000","00","050","0022","0501","657","345","312","45","702","1156","0","60.73","29.84"
"68","000","00","050","0022","0502","635","322","313","29","664","1114","0","59.61","28.90"
"68","000","00","050","0022","0503","628","322","306","22","650","1168","0","55.65","27.57"
"68","000","00","050","0023","0000","1800","1031","769","102","1902","2955","0","64.37","34.89"
"68","000","00","050","0023","0504","912","523","389","47","959","1495","0","64.15","34.98"
"68","000","00","050","0023","0505","888","508","380","55","943","1460","0","64.59","34.79"
"68","000","00","050","0024","0000","1672","852","820","54","1726","3292","0","52.43","25.88"
"68","000","00","050","0024","0565","822","432","390","25","847","1634","0","51.84","26.44"
"68","000","00","050","0024","0566","850","420","430","29","879","1658","0","53.02","25.33"
"68","000","00","050","0025","0000","2744","1389","1355","111","2855","4753","0","60.07","29.22"
"68","000","00","050","0025","0560","888","452","436","49","937","1463","0","64.05","30.90"
"68","000","00","050","0025","0561","905","442","463","35","940","1640","0","57.32","26.95"
"68","000","00","050","0025","0562","951","495","456","27","978","1650","0","59.27","30.00"
"68","000","00","050","0026","0000","2450","1286","1164","79","2529","4297","0","58.86","29.93"
"68","000","00","050","0026","0550","904","489","415","33","937","1582","0","59.23","30.91"
"68","000","00","050","0026","0551","828","418","410","23","851","1438","0","59.18","29.07"
"68","000","00","050","0026","0552","718","379","339","23","741","1277","0","58.03","29.68"
"68","000","00","050","0027","0000","2054","1118","936","62","2116","3931","0","53.83","28.44"
"68","000","00","050","0027","0525","784","435","349","31","815","1589","0","51.29","27.38"
"68","000","00","050","0027","0526","664","345","319","16","680","1238","0","54.93","27.87"
"68","000","00","050","0027","0527","606","338","268","15","621","1104","0","56.25","30.62"
"68","000","00","050","0028","0000","2610","1262","1348","95","2705","4928","0","54.89","25.61"
"68","000","00","050","0028","0517","890","424","466","43","933","1766","0","52.83","24.01"
"68","000","00","050","0028","0518","823","376","447","22","845","1607","0","52.58","23.40"
"68","000","00","050","0028","0519","897","462","435","30","927","1555","0","59.61","29.71"
"68","000","00","050","0029","0000","1815","939","876","60","1875","3389","0","55.33","27.71"
"68","000","00","050","0029","0520","897","445","452","29","926","1653","0","56.02","26.92"
"68","000","00","050","0029","0521","918","494","424","31","949","1736","0","54.67","28.46"
"68","000","00","050","0030","0000","1051","515","536","55","1106","1585","0","69.78","32.49"
"68","000","00","050","0030","0528","1051","515","536","55","1106","1585","0","69.78","32.49"
"68","000","00","050","0031","0000","3108","1562","1546","95","3203","5333","0","60.06","29.29"
"68","000","00","050","0031","0556","847","448","399","22","869","1439","0","60.39","31.13"
"68","000","00","050","0031","0557","704","326","378","24","728","1256","0","57.96","25.96"
"68","000","00","050","0031","0558","772","391","381","24","796","1295","0","61.47","30.19"
"68","000","00","050","0031","0559","785","397","388","25","810","1343","0","60.31","29.56"
"68","000","00","050","0032","0000","2167","1067","1100","52","2219","3492","0","63.55","30.56"
"68","000","00","050","0032","0553","690","337","353","15","705","1113","0","63.34","30.28"
"68","000","00","050","0032","0554","770","364","406","13","783","1174","0","66.70","31.01"
"68","000","00","050","0032","0555","707","366","341","24","731","1205","0","60.66","30.37"
"68","000","00","050","0033","0000","1660","837","823","42","1702","3183","0","53.47","26.30"
"68","000","00","050","0033","0546","888","445","443","25","913","1669","0","54.70","26.66"
"68","000","00","050","0033","0547","772","392","380","17","789","1514","0","52.11","25.89"
"68","000","00","050","0034","0000","1667","882","785","43","1710","3171","0","53.93","27.81"
"68","000","00","050","0034","0548","850","473","377","20","870","1505","0","57.81","31.43"
"68","000","00","050","0034","0549","817","409","408","23","840","1666","0","50.42","24.55"
"68","000","00","050","0035","0000","1601","811","790","72","1673","2731","0","61.26","29.70"
"68","000","00","050","0035","0538","802","410","392","27","829","1403","0","59.09","29.22"
"68","000","00","050","0035","0539","799","401","398","45","844","1328","0","63.55","30.20"
"68","000","00","050","0036","0000","2774","1405","1369","85","2859","5054","0","56.57","27.80"
"68","000","00","050","0036","0494","846","404","442","25","871","1460","0","59.66","27.67"
"68","000","00","050","0036","0495","901","481","420","36","937","1795","0","52.20","26.80"
"68","000","00","050","0036","0496","1027","520","507","24","1051","1799","0","58.42","28.90"
"68","000","00","050","0037","0000","1844","956","888","76","1920","3344","0","57.42","28.59"
"68","000","00","050","0037","0492","951","517","434","28","979","1760","0","55.63","29.38"
"68","000","00","050","0037","0493","893","439","454","48","941","1584","0","59.41","27.71"
"68","000","00","050","0038","0000","1681","904","777","56","1737","3180","0","54.62","28.43"
"68","000","00","050","0038","0563","785","433","352","25","810","1512","0","53.57","28.64"
"68","000","00","050","0038","0564","896","471","425","31","927","1668","0","55.58","28.24"
"68","000","00","050","0039","0000","2176","1187","989","78","2254","4243","0","53.12","27.98"
"68","000","00","050","0039","0522","759","410","349","28","787","1452","0","54.20","28.24"
"68","000","00","050","0039","0523","756","410","346","21","777","1513","0","51.35","27.10"
"68","000","00","050","0039","0524","661","367","294","29","690","1278","0","53.99","28.72"
"68","000","00","050","0040","0000","1469","844","625","118","1587","2582","0","61.46","32.69"
"68","000","00","050","0040","0579","733","412","321","75","808","1242","0","65.06","33.17"
"68","000","00","050","0040","0580","736","432","304","43","779","1340","0","58.13","32.24"
"68","000","00","060","0000","0000","35853","19416","16437","2325","38178","69935","86643","54.59","27.76"
"68","000","00","060","0001","0000","3019","1606","1413","237","3256","6191","0","52.59","25.94"
"68","000","00","060","0001","0581","766","382","384","56","822","1544","0","53.24","24.74"
"68","000","00","060","0001","0582","665","346","319","51","716","1706","0","41.97","20.28"
"68","000","00","060","0001","0583","798","439","359","65","863","1479","0","58.35","29.68"
"68","000","00","060","0001","0584","790","439","351","65","855","1462","0","58.48","30.03"
"68","000","00","060","0002","0000","3301","1750","1551","195","3496","7211","0","48.48","24.27"
"68","000","00","060","0002","0585","705","393","312","44","749","1358","0","55.15","28.94"
"68","000","00","060","0002","0586","518","273","245","14","532","1407","0","37.81","19.40"
"68","000","00","060","0002","0587","665","350","315","53","718","1371","0","52.37","25.53"
"68","000","00","060","0002","0588","754","381","373","45","799","1578","0","50.63","24.14"
"68","000","00","060","0002","0589","659","353","306","39","698","1497","0","46.63","23.58"
"68","000","00","060","0003","0000","2099","1163","936","137","2236","4712","0","47.45","24.68"
"68","000","00","060","0003","0590","634","349","285","38","672","1513","0","44.42","23.07"
"68","000","00","060","0003","0591","689","396","293","63","752","1530","0","49.15","25.88"
"68","000","00","060","0003","0592","776","418","358","36","812","1669","0","48.65","25.04"
"68","000","00","060","0004","0000","819","490","329","71","890","1581","0","56.29","30.99"
"68","000","00","060","0004","0593","819","490","329","71","890","1581","0","56.29","30.99"
"68","000","00","060","0005","0000","2531","1360","1171","184","2715","4361","0","62.26","31.19"
"68","000","00","060","0005","0594","799","436","363","68","867","1419","0","61.10","30.73"
"68","000","00","060","0005","0595","804","415","389","66","870","1466","0","59.35","28.31"
"68","000","00","060","0005","0596","928","509","419","50","978","1476","0","66.26","34.49"
"68","000","00","060","0006","0000","2597","1492","1105","177","2774","5094","0","54.46","29.29"
"68","000","00","060","0006","0603","618","386","232","60","678","1145","0","59.21","33.71"
"68","000","00","060","0006","0604","656","377","279","29","685","1302","0","52.61","28.96"
"68","000","00","060","0006","0605","738","431","307","51","789","1341","0","58.84","32.14"
"68","000","00","060","0006","0606","585","298","287","37","622","1306","0","47.63","22.82"
"68","000","00","060","0007","0000","2663","1472","1191","201","2864","4761","0","60.16","30.92"
"68","000","00","060","0007","0607","602","320","282","41","643","1087","0","59.15","29.44"
"68","000","00","060","0007","0608","712","405","307","67","779","1292","0","60.29","31.35"
"68","000","00","060","0007","0609","587","273","314","36","623","1128","0","55.23","24.20"
"68","000","00","060","0007","0610","762","474","288","57","819","1254","0","65.31","37.80"
"68","000","00","060","0008","0000","586","301","285","35","621","838","0","74.11","35.92"
"68","000","00","060","0008","0611","586","301","285","35","621","838","0","74.11","35.92"
"68","000","00","060","0010","0000","1690","932","758","110","1800","2845","0","63.27","32.76"
"68","000","00","060","0010","0612","727","414","313","48","775","1369","0","56.61","30.24"
"68","000","00","060","0010","0613","963","518","445","62","1025","1476","0","69.44","35.09"
"68","000","00","060","0011","0000","3131","1696","1435","235","3366","6580","0","51.16","25.78"
"68","000","00","060","0011","0614","715","384","331","48","763","1370","0","55.69","28.03"
"68","000","00","060","0011","0615","705","390","315","68","773","1458","0","53.02","26.75"
"68","000","00","060","0011","0616","622","354","268","38","660","1299","0","50.81","27.25"
"68","000","00","060","0011","0617","524","260","264","35","559","1248","0","44.79","20.83"
"68","000","00","060","0011","0618","565","308","257","46","611","1205","0","50.71","25.56"
"68","000","00","060","0012","0000","841","437","404","41","882","1318","0","66.92","33.16"
"68","000","00","060","0012","0619","417","223","194","22","439","737","0","59.57","30.26"
"68","000","00","060","0012","0620","424","214","210","19","443","581","0","76.25","36.83"
"68","000","00","060","0013","0000","745","404","341","69","814","1095","0","74.34","36.89"
"68","000","00","060","0013","0621","745","404","341","69","814","1095","0","74.34","36.89"
"68","000","00","060","0014","0000","778","401","377","88","866","1569","0","55.19","25.56"
"68","000","00","060","0014","0622","464","242","222","68","532","992","0","53.63","24.40"
"68","000","00","060","0014","0623","314","159","155","20","334","577","0","57.89","27.56"
"68","000","00","060","0015","0000","668","369","299","56","724","1030","0","70.29","35.83"
"68","000","00","060","0015","0624","241","130","111","27","268","359","0","74.65","36.21"
"68","000","00","060","0015","0625","427","239","188","29","456","671","0","67.96","35.62"
"68","000","00","060","0016","0000","1176","629","547","90","1266","2030","0","62.36","30.99"
"68","000","00","060","0016","0626","522","273","249","29","551","950","0","58.00","28.74"
"68","000","00","060","0016","0627","654","356","298","61","715","1080","0","66.20","32.96"
"68","000","00","060","0017","0000","1017","604","413","68","1085","2215","0","48.98","27.27"
"68","000","00","060","0017","0628","419","262","157","15","434","1157","0","37.51","22.64"
"68","000","00","060","0017","0629","598","342","256","53","651","1058","0","61.53","32.33"
"68","000","00","060","0018","0000","1464","790","674","94","1558","2980","0","52.28","26.51"
"68","000","00","060","0018","0630","773","419","354","67","840","1491","0","56.34","28.10"
"68","000","00","060","0018","0631","691","371","320","27","718","1489","0","48.22","24.92"
"68","000","00","060","0019","0000","2780","1493","1287","130","2910","6279","0","46.34","23.78"
"68","000","00","060","0019","0632","708","393","315","32","740","1564","0","47.31","25.13"
"68","000","00","060","0019","0633","712","372","340","40","752","1592","0","47.24","23.37"
"68","000","00","060","0019","0634","704","397","307","26","730","1554","0","46.98","25.55"
"68","000","00","060","0019","0635","656","331","325","32","688","1569","0","43.85","21.10"
"68","000","00","060","0020","0000","2138","1069","1069","55","2193","3889","0","56.39","27.49"
"68","000","00","060","0020","0597","774","387","387","20","794","1342","0","59.17","28.84"
"68","000","00","060","0020","0598","635","318","317","14","649","1201","0","54.04","26.48"
"68","000","00","060","0020","0599","729","364","365","21","750","1346","0","55.72","27.04"
"68","000","00","060","0021","0000","1810","958","852","52","1862","3356","0","55.48","28.55"
"68","000","00","060","0021","0600","658","338","320","18","676","1197","0","56.47","28.24"
"68","000","00","060","0021","0601","588","315","273","11","599","1137","0","52.68","27.70"
"68","000","00","060","0021","0602","564","305","259","23","587","1022","0","57.44","29.84"
"68","000","00","070","0000","0000","72055","37608","34447","3551","75606","140758","171288","53.71","26.72"
"68","000","00","070","0001","0000","2143","1129","1014","120","2263","3855","0","58.70","29.29"
"68","000","00","070","0001","0333","658","332","326","25","683","1154","0","59.19","28.77"
"68","000","00","070","0001","0334","665","374","291","46","711","1242","0","57.25","30.11"
"68","000","00","070","0001","0335","820","423","397","49","869","1459","0","59.56","28.99"
"68","000","00","070","0002","0000","3323","1730","1593","184","3507","6381","0","54.96","27.11"
"68","000","00","070","0002","0349","615","304","311","43","658","1087","0","60.53","27.97"
"68","000","00","070","0002","0350","675","365","310","19","694","1213","0","57.21","30.09"
"68","000","00","070","0002","0351","794","436","358","41","835","1460","0","57.19","29.86"
"68","000","00","070","0002","0352","621","320","301","33","654","1350","0","48.44","23.70"
"68","000","00","070","0002","0353","618","305","313","48","666","1271","0","52.40","24.00"
"68","000","00","070","0003","0000","2279","1217","1062","130","2409","4306","0","55.95","28.26"
"68","000","00","070","0003","0302","470","247","223","34","504","767","0","65.71","32.20"
"68","000","00","070","0003","0303","624","302","322","59","683","1236","0","55.26","24.43"
"68","000","00","070","0003","0304","583","320","263","23","606","1149","0","52.74","27.85"
"68","000","00","070","0003","0305","602","348","254","14","616","1154","0","53.38","30.16"
"68","000","00","070","0004","0000","3136","1604","1532","176","3312","5673","0","58.38","28.27"
"68","000","00","070","0004","0260","831","402","429","49","880","1548","0","56.85","25.97"
"68","000","00","070","0004","0261","812","407","405","52","864","1385","0","62.38","29.39"
"68","000","00","070","0004","0262","864","460","404","49","913","1608","0","56.78","28.61"
"68","000","00","070","0004","0263","629","335","294","26","655","1132","0","57.86","29.59"
"68","000","00","070","0005","0000","1650","870","780","112","1762","3156","0","55.83","27.57"
"68","000","00","070","0005","0282","962","495","467","69","1031","1810","0","56.96","27.35"
"68","000","00","070","0005","0283","688","375","313","43","731","1346","0","54.31","27.86"
"68","000","00","070","0006","0000","2691","1388","1303","152","2843","5284","0","53.80","26.27"
"68","000","00","070","0006","0279","809","423","386","33","842","1686","0","49.94","25.09"
"68","000","00","070","0006","0280","896","468","428","65","961","1871","0","51.36","25.01"
"68","000","00","070","0006","0281","986","497","489","54","1040","1727","0","60.22","28.78"
"68","000","00","070","0007","0000","2030","600","1430","156","2186","3488","0","62.67","17.20"
"68","000","00","070","0007","0320","986","274","712","69","1055","1701","0","62.02","16.11"
"68","000","00","070","0007","0321","1044","326","718","87","1131","1787","0","63.29","18.24"
"68","000","00","070","0008","0000","2772","1146","1626","131","2903","5076","0","57.19","22.58"
"68","000","00","070","0008","0338","947","293","654","47","994","1562","0","63.64","18.76"
"68","000","00","070","0008","0339","863","366","497","54","917","1654","0","55.44","22.13"
"68","000","00","070","0008","0340","962","487","475","30","992","1860","0","53.33","26.18"
"68","000","00","070","0009","0000","707","388","319","51","758","1243","0","60.98","31.21"
"68","000","00","070","0009","0290","707","388","319","51","758","1243","0","60.98","31.21"
"68","000","00","070","0010","0000","3827","2187","1640","115","3942","9112","0","43.26","24.00"
"68","000","00","070","0010","0341","865","481","384","13","878","2294","0","38.27","20.97"
"68","000","00","070","0010","0342","741","443","298","17","758","2001","0","37.88","22.14"
"68","000","00","070","0010","0343","807","454","353","25","832","1856","0","44.83","24.46"
"68","000","00","070","0010","0344","721","401","320","33","754","1544","0","48.83","25.97"
"68","000","00","070","0010","0345","693","408","285","27","720","1417","0","50.81","28.79"
"68","000","00","070","0011","0000","1047","616","431","75","1122","1825","0","61.48","33.75"
"68","000","00","070","0011","0312","1047","616","431","75","1122","1825","0","61.48","33.75"
"68","000","00","070","0012","0000","1009","571","438","72","1081","1897","0","56.98","30.10"
"68","000","00","070","0012","0264","515","286","229","40","555","945","0","58.73","30.26"
"68","000","00","070","0012","0265","494","285","209","32","526","952","0","55.25","29.94"
"68","000","00","070","0013","0000","2349","1226","1123","122","2471","4580","0","53.95","26.77"
"68","000","00","070","0013","0287","711","348","363","34","745","1559","0","47.79","22.32"
"68","000","00","070","0013","0288","895","487","408","43","938","1621","0","57.87","30.04"
"68","000","00","070","0013","0289","743","391","352","45","788","1400","0","56.29","27.93"
"68","000","00","070","0014","0000","2464","1324","1140","140","2604","4578","0","56.88","28.92"
"68","000","00","070","0014","0284","838","457","381","42","880","1593","0","55.24","28.69"
"68","000","00","070","0014","0285","791","445","346","34","825","1400","0","58.93","31.79"
"68","000","00","070","0014","0286","835","422","413","64","899","1585","0","56.72","26.62"
"68","000","00","070","0015","0000","2869","1508","1361","132","3001","5038","0","59.57","29.93"
"68","000","00","070","0015","0322","781","413","368","43","824","1373","0","60.01","30.08"
"68","000","00","070","0015","0323","567","289","278","23","590","973","0","60.64","29.70"
"68","000","00","070","0015","0324","671","368","303","28","699","1338","0","52.24","27.50"
"68","000","00","070","0015","0325","850","438","412","38","888","1354","0","65.58","32.35"
"68","000","00","070","0016","0000","1934","1073","861","108","2042","3876","0","52.68","27.68"
"68","000","00","070","0016","0354","589","324","265","49","638","1177","0","54.21","27.53"
"68","000","00","070","0016","0355","620","357","263","39","659","1263","0","52.18","28.27"
"68","000","00","070","0016","0356","725","392","333","20","745","1436","0","51.88","27.30"
"68","000","00","070","0017","0000","874","567","307","57","931","1723","0","54.03","32.91"
"68","000","00","070","0017","0348","874","567","307","57","931","1723","0","54.03","32.91"
"68","000","00","070","0018","0000","1430","730","700","127","1557","2610","0","59.66","27.97"
"68","000","00","070","0018","0357","867","408","459","76","943","1613","0","58.46","25.29"
"68","000","00","070","0018","0358","563","322","241","51","614","997","0","61.58","32.30"
"68","000","00","070","0019","0000","1982","1090","892","102","2084","4181","0","49.84","26.07"
"68","000","00","070","0019","0266","635","353","282","36","671","1335","0","50.26","26.44"
"68","000","00","070","0019","0267","770","438","332","42","812","1611","0","50.40","27.19"
"68","000","00","070","0019","0268","577","299","278","24","601","1235","0","48.66","24.21"
"68","000","00","070","0020","0000","3492","1856","1636","118","3610","7295","0","49.49","25.44"
"68","000","00","070","0020","0291","720","394","326","30","750","1505","0","49.83","26.18"
"68","000","00","070","0020","0292","697","380","317","16","713","1410","0","50.57","26.95"
"68","000","00","070","0020","0293","791","401","390","25","816","1566","0","52.11","25.61"
"68","000","00","070","0020","0294","591","310","281","28","619","1442","0","42.93","21.50"
"68","000","00","070","0020","0295","693","371","322","19","712","1372","0","51.90","27.04"
"68","000","00","070","0021","0000","1243","703","540","60","1303","2257","0","57.73","31.15"
"68","000","00","070","0021","0313","571","332","239","37","608","1134","0","53.62","29.28"
"68","000","00","070","0021","0314","672","371","301","23","695","1123","0","61.89","33.04"
"68","000","00","070","0022","0000","2442","1343","1099","109","2551","5067","0","50.35","26.50"
"68","000","00","070","0022","0306","862","464","398","38","900","1715","0","52.48","27.06"
"68","000","00","070","0022","0307","761","432","329","40","801","1560","0","51.35","27.69"
"68","000","00","070","0022","0308","819","447","372","31","850","1792","0","47.43","24.94"
"68","000","00","070","0023","0000","962","458","504","70","1032","1874","0","55.07","24.44"
"68","000","00","070","0023","0336","728","345","383","58","786","1402","0","56.06","24.61"
"68","000","00","070","0023","0337","234","113","121","12","246","472","0","52.12","23.94"
"68","000","00","070","0024","0000","1843","1049","794","104","1947","3353","0","58.07","31.29"
"68","000","00","070","0024","0346","1076","596","480","61","1137","1889","0","60.19","31.55"
"68","000","00","070","0024","0347","767","453","314","43","810","1464","0","55.33","30.94"
"68","000","00","070","0025","0000","2946","1623","1323","161","3107","5897","0","52.69","27.52"
"68","000","00","070","0025","0315","431","247","184","25","456","879","0","51.88","28.10"
"68","000","00","070","0025","0316","497","311","186","22","519","1010","0","51.39","30.79"
"68","000","00","070","0025","0317","644","344","300","49","693","1303","0","53.18","26.40"
"68","000","00","070","0025","0318","696","354","342","36","732","1373","0","53.31","25.78"
"68","000","00","070","0025","0319","678","367","311","29","707","1332","0","53.08","27.55"
"68","000","00","070","0026","0000","1780","980","800","129","1909","3798","0","50.26","25.80"
"68","000","00","070","0026","0328","562","300","262","31","593","1170","0","50.68","25.64"
"68","000","00","070","0026","0329","435","225","210","24","459","931","0","49.30","24.17"
"68","000","00","070","0026","0330","783","455","328","74","857","1697","0","50.50","26.81"
"68","000","00","070","0027","0000","2533","1329","1204","75","2608","5298","0","49.23","25.08"
"68","000","00","070","0027","0269","795","410","385","24","819","1658","0","49.40","24.73"
"68","000","00","070","0027","0270","620","342","278","22","642","1365","0","47.03","25.05"
"68","000","00","070","0027","0271","460","233","227","6","466","1063","0","43.84","21.92"
"68","000","00","070","0027","0272","658","344","314","23","681","1212","0","56.19","28.38"
"68","000","00","070","0028","0000","4274","2323","1951","156","4430","8626","0","51.36","26.93"
"68","000","00","070","0028","0273","698","390","308","39","737","1424","0","51.76","27.39"
"68","000","00","070","0028","0274","681","378","303","24","705","1330","0","53.01","28.42"
"68","000","00","070","0028","0275","728","386","342","28","756","1450","0","52.14","26.62"
"68","000","00","070","0028","0276","836","463","373","21","857","1608","0","53.30","28.79"
"68","000","00","070","0028","0277","686","375","311","21","707","1391","0","50.83","26.96"
"68","000","00","070","0028","0278","645","331","314","23","668","1423","0","46.94","23.26"
"68","000","00","070","0029","0000","2380","1309","1071","38","2418","4676","0","51.71","27.99"
"68","000","00","070","0029","0309","710","390","320","13","723","1411","0","51.24","27.64"
"68","000","00","070","0029","0310","780","438","342","10","790","1335","0","59.18","32.81"
"68","000","00","070","0029","0311","890","481","409","15","905","1930","0","46.89","24.92"
"68","000","00","070","0030","0000","1304","533","771","57","1361","3146","0","43.26","16.94"
"68","000","00","070","0030","0326","965","372","593","39","1004","1583","0","63.42","23.50"
"68","000","00","070","0030","0327","339","161","178","18","357","1563","0","22.84","10.30"
"68","000","00","070","0031","0000","4365","2194","2171","151","4516","8324","0","54.25","26.36"
"68","000","00","070","0031","0296","767","414","353","23","790","1490","0","53.02","27.79"
"68","000","00","070","0031","0297","825","381","444","20","845","1576","0","53.62","24.18"
"68","000","00","070","0031","0298","507","260","247","18","525","954","0","55.03","27.25"
"68","000","00","070","0031","0299","691","334","357","32","723","1356","0","53.32","24.63"
"68","000","00","070","0031","0300","690","364","326","25","715","1373","0","52.08","26.51"
"68","000","00","070","0031","0301","885","441","444","33","918","1575","0","58.29","28.00"
"68","000","00","070","0032","0000","1975","944","1031","61","2036","3265","0","62.36","28.91"
"68","000","00","070","0032","0331","1121","554","567","42","1163","1824","0","63.76","30.37"
"68","000","00","070","0032","0332","854","390","464","19","873","1441","0","60.58","27.06"
"68","000","00","080","0000","0000","92821","46821","46000","5641","98462","169169","209397","58.20","27.68"
"68","000","00","080","0001","0000","1862","949","913","84","1946","4298","0","45.28","22.08"
"68","000","00","080","0001","0359","667","313","354","26","693","1237","0","56.02","25.30"
"68","000","00","080","0001","0360","704","374","330","28","732","1344","0","54.46","27.83"
"68","000","00","080","0001","0361","491","262","229","30","521","1717","0","30.34","15.26"
"68","000","00","080","0002","0000","2315","1159","1156","103","2418","4561","0","53.01","25.41"
"68","000","00","080","0002","0364","732","370","362","16","748","1507","0","49.64","24.55"
"68","000","00","080","0002","0365","747","360","387","45","792","1432","0","55.31","25.14"
"68","000","00","080","0002","0366","836","429","407","42","878","1622","0","54.13","26.45"
"68","000","00","080","0003","0000","2489","1296","1193","145","2634","5047","0","52.19","25.68"
"68","000","00","080","0003","0372","580","285","295","64","644","1000","0","64.40","28.50"
"68","000","00","080","0003","0373","795","427","368","39","834","1632","0","51.10","26.16"
"68","000","00","080","0003","0374","661","362","299","11","672","1359","0","49.45","26.64"
"68","000","00","080","0003","0375","453","222","231","31","484","1056","0","45.83","21.02"
"68","000","00","080","0004","0000","1854","835","1019","148","2002","3023","0","66.23","27.62"
"68","000","00","080","0004","0381","920","429","491","67","987","1516","0","65.11","28.30"
"68","000","00","080","0004","0382","934","406","528","81","1015","1507","0","67.35","26.94"
"68","000","00","080","0005","0000","1730","834","896","171","1901","3411","0","55.73","24.45"
"68","000","00","080","0005","0383","573","281","292","42","615","1057","0","58.18","26.58"
"68","000","00","080","0005","0384","566","296","270","60","626","1209","0","51.78","24.48"
"68","000","00","080","0005","0385","591","257","334","69","660","1145","0","57.64","22.45"
"68","000","00","080","0006","0000","1784","772","1012","175","1959","3035","0","64.55","25.44"
"68","000","00","080","0006","0386","884","404","480","125","1009","1503","0","67.13","26.88"
"68","000","00","080","0006","0387","900","368","532","50","950","1532","0","62.01","24.02"
"68","000","00","080","0007","0000","1741","916","825","106","1847","3120","0","59.20","29.36"
"68","000","00","080","0007","0390","865","468","397","54","919","1612","0","57.01","29.03"
"68","000","00","080","0007","0391","876","448","428","52","928","1508","0","61.54","29.71"
"68","000","00","080","0008","0000","2580","1286","1294","159","2739","4388","0","62.42","29.31"
"68","000","00","080","0008","0392","747","404","343","60","807","1326","0","60.86","30.47"
"68","000","00","080","0008","0393","658","283","375","49","707","1102","0","64.16","25.68"
"68","000","00","080","0008","0394","567","292","275","17","584","986","0","59.23","29.61"
"68","000","00","080","0008","0395","608","307","301","33","641","974","0","65.81","31.52"
"68","000","00","080","0009","0000","1978","1044","934","165","2143","3542","0","60.50","29.47"
"68","000","00","080","0009","0396","620","333","287","84","704","1111","0","63.37","29.97"
"68","000","00","080","0009","0397","681","382","299","40","721","1179","0","61.15","32.40"
"68","000","00","080","0009","0398","677","329","348","41","718","1252","0","57.35","26.28"
"68","000","00","080","0010","0000","1142","602","540","84","1226","2163","0","56.68","27.83"
"68","000","00","080","0010","0399","611","314","297","45","656","1172","0","55.97","26.79"
"68","000","00","080","0010","0400","531","288","243","39","570","991","0","57.52","29.06"
"68","000","00","080","0011","0000","1339","762","577","75","1414","2427","0","58.26","31.40"
"68","000","00","080","0011","0406","738","414","324","32","770","1293","0","59.55","32.02"
"68","000","00","080","0011","0407","601","348","253","43","644","1134","0","56.79","30.69"
"68","000","00","080","0012","0000","1956","1057","899","118","2074","3699","0","56.07","28.58"
"68","000","00","080","0012","0410","743","407","336","37","780","1318","0","59.18","30.88"
"68","000","00","080","0012","0411","542","307","235","42","584","1117","0","52.28","27.48"
"68","000","00","080","0012","0412","671","343","328","39","710","1264","0","56.17","27.14"
"68","000","00","080","0013","0000","1613","888","725","90","1703","2985","0","57.05","29.75"
"68","000","00","080","0013","0415","837","452","385","47","884","1583","0","55.84","28.55"
"68","000","00","080","0013","0416","776","436","340","43","819","1402","0","58.42","31.10"
"68","000","00","080","0014","0000","2001","1087","914","97","2098","3883","0","54.03","27.99"
"68","000","00","080","0014","0417","743","396","347","32","775","1362","0","56.90","29.07"
"68","000","00","080","0014","0418","707","398","309","39","746","1332","0","56.01","29.88"
"68","000","00","080","0014","0419","551","293","258","26","577","1189","0","48.53","24.64"
"68","000","00","080","0015","0000","1983","1081","902","112","2095","3409","0","61.45","31.71"
"68","000","00","080","0015","0428","747","421","326","53","800","1317","0","60.74","31.97"
"68","000","00","080","0015","0429","614","317","297","32","646","1028","0","62.84","30.84"
"68","000","00","080","0015","0430","622","343","279","27","649","1064","0","61.00","32.24"
"68","000","00","080","0016","0000","2120","1085","1035","115","2235","3700","0","60.41","29.32"
"68","000","00","080","0016","0432","705","357","348","39","744","1309","0","56.84","27.27"
"68","000","00","080","0016","0433","734","379","355","46","780","1153","0","67.65","32.87"
"68","000","00","080","0016","0434","681","349","332","30","711","1238","0","57.43","28.19"
"68","000","00","080","0017","0000","3855","1865","1990","212","4067","7208","0","56.42","25.87"
"68","000","00","080","0017","0441","760","329","431","54","814","1558","0","52.25","21.12"
"68","000","00","080","0017","0442","755","336","419","42","797","1295","0","61.54","25.95"
"68","000","00","080","0017","0443","756","353","403","22","778","1503","0","51.76","23.49"
"68","000","00","080","0017","0444","834","360","474","58","892","1507","0","59.19","23.89"
"68","000","00","080","0017","0445","750","487","263","36","786","1345","0","58.44","36.21"
"68","000","00","080","0018","0000","856","488","368","46","902","1459","0","61.82","33.45"
"68","000","00","080","0018","0455","856","488","368","46","902","1459","0","61.82","33.45"
"68","000","00","080","0019","0000","2015","1041","974","139","2154","3170","0","67.95","32.84"
"68","000","00","080","0019","0456","988","528","460","66","1054","1568","0","67.22","33.67"
"68","000","00","080","0019","0457","1027","513","514","73","1100","1602","0","68.66","32.02"
"68","000","00","080","0020","0000","1832","891","941","127","1959","3595","0","54.49","24.78"
"68","000","00","080","0020","0458","584","278","306","45","629","1167","0","53.90","23.82"
"68","000","00","080","0020","0459","625","313","312","50","675","1206","0","55.97","25.95"
"68","000","00","080","0020","0460","623","300","323","32","655","1222","0","53.60","24.55"
"68","000","00","080","0021","0000","924","452","472","63","987","1712","0","57.65","26.40"
"68","000","00","080","0021","0461","924","452","472","63","987","1712","0","57.65","26.40"
"68","000","00","080","0022","0000","3088","1542","1546","157","3245","5058","0","64.16","30.49"
"68","000","00","080","0022","0471","796","356","440","37","833","1243","0","67.02","28.64"
"68","000","00","080","0022","0472","767","432","335","40","807","1266","0","63.74","34.12"
"68","000","00","080","0022","0473","853","418","435","50","903","1472","0","61.35","28.40"
"68","000","00","080","0022","0474","672","336","336","30","702","1077","0","65.18","31.20"
"68","000","00","080","0023","0000","2349","1168","1181","123","2472","3966","0","62.33","29.45"
"68","000","00","080","0023","0477","713","379","334","50","763","1248","0","61.14","30.37"
"68","000","00","080","0023","0478","784","387","397","37","821","1362","0","60.28","28.41"
"68","000","00","080","0023","0479","852","402","450","36","888","1356","0","65.49","29.65"
"68","000","00","080","0024","0000","1838","940","898","112","1950","3400","0","57.35","27.65"
"68","000","00","080","0024","0448","732","368","364","58","790","1406","0","56.19","26.17"
"68","000","00","080","0024","0449","276","122","154","38","314","607","0","51.73","20.10"
"68","000","00","080","0024","0450","830","450","380","16","846","1387","0","60.99","32.44"
"68","000","00","080","0025","0000","1339","651","688","101","1440","2430","0","59.26","26.79"
"68","000","00","080","0025","0437","639","314","325","47","686","1145","0","59.91","27.42"
"68","000","00","080","0025","0438","700","337","363","54","754","1285","0","58.68","26.23"
"68","000","00","080","0026","0000","2072","1194","878","170","2242","4017","0","55.81","29.72"
"68","000","00","080","0026","0422","651","385","266","67","718","1176","0","61.05","32.74"
"68","000","00","080","0026","0423","780","441","339","60","840","1554","0","54.05","28.38"
"68","000","00","080","0026","0424","641","368","273","43","684","1287","0","53.15","28.59"
"68","000","00","080","0027","0000","2368","1078","1290","112","2480","4163","0","59.57","25.89"
"68","000","00","080","0027","0462","791","358","433","30","821","1428","0","57.49","25.07"
"68","000","00","080","0027","0463","776","378","398","61","837","1379","0","60.70","27.41"
"68","000","00","080","0027","0464","801","342","459","21","822","1356","0","60.62","25.22"
"68","000","00","080","0028","0000","2420","1242","1178","145","2565","4009","0","63.98","30.98"
"68","000","00","080","0028","0378","820","426","394","48","868","1341","0","64.73","31.77"
"68","000","00","080","0028","0379","831","427","404","46","877","1304","0","67.25","32.75"
"68","000","00","080","0028","0380","769","389","380","51","820","1364","0","60.12","28.52"
"68","000","00","080","0029","0000","1580","819","761","90","1670","2723","0","61.33","30.08"
"68","000","00","080","0029","0446","787","407","380","53","840","1309","0","64.17","31.09"
"68","000","00","080","0029","0447","793","412","381","37","830","1414","0","58.70","29.14"
"68","000","00","080","0030","0000","2094","1042","1052","116","2210","4134","0","53.46","25.21"
"68","000","00","080","0030","0468","760","382","378","53","813","1396","0","58.24","27.36"
"68","000","00","080","0030","0469","587","297","290","41","628","1364","0","46.04","21.77"
"68","000","00","080","0030","0470","747","363","384","22","769","1374","0","55.97","26.42"
"68","000","00","080","0031","0000","1930","1080","850","119","2049","3040","0","67.40","35.53"
"68","000","00","080","0031","0475","1001","579","422","52","1053","1560","0","67.50","37.12"
"68","000","00","080","0031","0476","929","501","428","67","996","1480","0","67.30","33.85"
"68","000","00","080","0032","0000","1174","627","547","76","1250","1980","0","63.13","31.67"
"68","000","00","080","0032","0420","650","357","293","44","694","1023","0","67.84","34.90"
"68","000","00","080","0032","0421","524","270","254","32","556","957","0","58.10","28.21"
"68","000","00","080","0033","0000","1756","960","796","114","1870","3486","0","53.64","27.54"
"68","000","00","080","0033","0425","542","300","242","51","593","1156","0","51.30","25.95"
"68","000","00","080","0033","0426","742","390","352","35","777","1277","0","60.85","30.54"
"68","000","00","080","0033","0427","472","270","202","28","500","1053","0","47.48","25.64"
"68","000","00","080","0034","0000","865","461","404","58","923","1484","0","62.20","31.06"
"68","000","00","080","0034","0431","865","461","404","58","923","1484","0","62.20","31.06"
"68","000","00","080","0035","0000","682","382","300","60","742","1357","0","54.68","28.15"
"68","000","00","080","0035","0454","682","382","300","60","742","1357","0","54.68","28.15"
"68","000","00","080","0036","0000","1158","516","642","78","1236","2154","0","57.38","23.96"
"68","000","00","080","0036","0482","574","238","336","56","630","1044","0","60.34","22.80"
"68","000","00","080","0036","0483","584","278","306","22","606","1110","0","54.59","25.05"
"68","000","00","080","0037","0000","1017","558","459","62","1079","1827","0","59.06","30.54"
"68","000","00","080","0037","0480","536","293","243","31","567","940","0","60.32","31.17"
"68","000","00","080","0037","0481","481","265","216","31","512","887","0","57.72","29.88"
"68","000","00","080","0038","0000","2477","1254","1223","117","2594","4702","0","55.17","26.67"
"68","000","00","080","0038","0403","891","444","447","40","931","1805","0","51.58","24.60"
"68","000","00","080","0038","0404","828","425","403","59","887","1409","0","62.95","30.16"
"68","000","00","080","0038","0405","758","385","373","18","776","1488","0","52.15","25.87"
"68","000","00","080","0039","0000","1631","849","782","103","1734","3015","0","57.51","28.16"
"68","000","00","080","0039","0413","901","479","422","75","976","1518","0","64.30","31.55"
"68","000","00","080","0039","0414","730","370","360","28","758","1497","0","50.63","24.72"
"68","000","00","080","0040","0000","1621","847","774","99","1720","2755","0","62.43","30.74"
"68","000","00","080","0040","0376","886","473","413","45","931","1552","0","59.99","30.48"
"68","000","00","080","0040","0377","735","374","361","54","789","1203","0","65.59","31.09"
"68","000","00","080","0041","0000","1363","667","696","99","1462","2437","0","59.99","27.37"
"68","000","00","080","0041","0435","674","355","319","66","740","1244","0","59.49","28.54"
"68","000","00","080","0041","0436","689","312","377","33","722","1193","0","60.52","26.15"
"68","000","00","080","0042","0000","2645","1296","1349","74","2719","4643","0","58.56","27.91"
"68","000","00","080","0042","0465","899","422","477","19","918","1616","0","56.81","26.11"
"68","000","00","080","0042","0466","1052","540","512","31","1083","1787","0","60.60","30.22"
"68","000","00","080","0042","0467","694","334","360","24","718","1240","0","57.90","26.94"
"68","000","00","080","0043","0000","2099","972","1127","95","2194","3806","0","57.65","25.54"
"68","000","00","080","0043","0484","759","344","415","25","784","1349","0","58.12","25.50"
"68","000","00","080","0043","0485","640","303","337","26","666","1192","0","55.87","25.42"
"68","000","00","080","0043","0486","700","325","375","44","744","1265","0","58.81","25.69"
"68","000","00","080","0044","0000","1607","829","778","70","1677","2605","0","64.38","31.82"
"68","000","00","080","0044","0388","784","423","361","40","824","1256","0","65.61","33.68"
"68","000","00","080","0044","0389","823","406","417","30","853","1349","0","63.23","30.10"
"68","000","00","080","0045","0000","1155","409","746","103","1258","2042","0","61.61","20.03"
"68","000","00","080","0045","0401","622","243","379","65","687","1083","0","63.43","22.44"
"68","000","00","080","0045","0402","533","166","367","38","571","959","0","59.54","17.31"
"68","000","00","080","0046","0000","2159","824","1335","202","2361","4113","0","57.40","20.03"
"68","000","00","080","0046","0451","731","295","436","70","801","1413","0","56.69","20.88"
"68","000","00","080","0046","0452","780","263","517","61","841","1382","0","60.85","19.03"
"68","000","00","080","0046","0453","648","266","382","71","719","1318","0","54.55","20.18"
"68","000","00","080","0047","0000","1331","694","637","113","1444","2639","0","54.72","26.30"
"68","000","00","080","0047","0408","654","341","313","55","709","1284","0","55.22","26.56"
"68","000","00","080","0047","0409","677","353","324","58","735","1355","0","54.24","26.05"
"68","000","00","080","0048","0000","1465","728","737","100","1565","2445","0","64.01","29.78"
"68","000","00","080","0048","0439","681","313","368","48","729","1103","0","66.09","28.38"
"68","000","00","080","0048","0440","784","415","369","52","836","1342","0","62.30","30.92"
"68","000","00","080","0049","0000","2122","1066","1056","104","2226","4047","0","55.00","26.34"
"68","000","00","080","0049","0367","652","322","330","43","695","1229","0","56.55","26.20"
"68","000","00","080","0049","0368","734","367","367","29","763","1444","0","52.84","25.42"
"68","000","00","080","0049","0369","736","377","359","32","768","1374","0","55.90","27.44"
"68","000","00","080","0050","0000","1476","754","722","66","1542","2845","0","54.20","26.50"
"68","000","00","080","0050","0370","727","368","359","15","742","1386","0","53.54","26.55"
"68","000","00","080","0050","0371","749","386","363","51","800","1459","0","54.83","26.46"
"68","000","00","080","0051","0000","1971","982","989","69","2040","4012","0","50.85","24.48"
"68","000","00","080","0051","0362","998","483","515","28","1026","1901","0","53.97","25.41"
"68","000","00","080","0051","0363","973","499","474","41","1014","2111","0","48.03","23.64"
"68","000","00","090","0000","0000","56850","25805","31045","2999","59849","101909","124679","58.73","25.32"
"68","000","00","090","0001","0000","2332","1096","1236","110","2442","4599","0","53.10","23.83"
"68","000","00","090","0001","1205","833","405","428","36","869","1668","0","52.10","24.28"
"68","000","00","090","0001","1206","725","337","388","39","764","1475","0","51.80","22.85"
"68","000","00","090","0001","1207","774","354","420","35","809","1456","0","55.56","24.31"
"68","000","00","090","0002","0000","3514","1639","1875","152","3666","6035","0","60.75","27.16"
"68","000","00","090","0002","1210","1162","494","668","49","1211","1752","0","69.12","28.20"
"68","000","00","090","0002","1211","1073","558","515","54","1127","1535","0","73.42","36.35"
"68","000","00","090","0002","1212","659","284","375","20","679","1709","0","39.73","16.62"
"68","000","00","090","0002","1213","620","303","317","29","649","1039","0","62.46","29.16"
"68","000","00","090","0003","0000","2116","1071","1045","132","2248","4510","0","49.84","23.75"
"68","000","00","090","0003","1216","688","372","316","59","747","1423","0","52.49","26.14"
"68","000","00","090","0003","1217","736","366","370","33","769","1649","0","46.63","22.20"
"68","000","00","090","0003","1218","692","333","359","40","732","1438","0","50.90","23.16"
"68","000","00","090","0004","0000","1755","836","919","111","1866","3097","0","60.25","26.99"
"68","000","00","090","0004","1271","899","422","477","29","928","1586","0","58.51","26.61"
"68","000","00","090","0004","1272","856","414","442","82","938","1511","0","62.08","27.40"
"68","000","00","090","0006","0000","1904","888","1016","137","2041","3649","0","55.93","24.34"
"68","000","00","090","0006","1222","612","291","321","51","663","1094","0","60.60","26.60"
"68","000","00","090","0006","1223","563","249","314","39","602","1178","0","51.10","21.14"
"68","000","00","090","0006","1224","729","348","381","47","776","1377","0","56.35","25.27"
"68","000","00","090","0007","0000","2128","1025","1103","109","2237","4206","0","53.19","24.37"
"68","000","00","090","0007","1227","750","384","366","39","789","1405","0","56.16","27.33"
"68","000","00","090","0007","1228","677","329","348","43","720","1375","0","52.36","23.93"
"68","000","00","090","0007","1229","701","312","389","27","728","1426","0","51.05","21.88"
"68","000","00","090","0008","0000","446","271","175","32","478","683","0","69.99","39.68"
"68","000","00","090","0008","1279","446","271","175","32","478","683","0","69.99","39.68"
"68","000","00","090","0009","0000","2418","1174","1244","117","2535","4328","0","58.57","27.13"
"68","000","00","090","0009","1232","761","384","377","33","794","1323","0","60.02","29.02"
"68","000","00","090","0009","1233","937","456","481","50","987","1739","0","56.76","26.22"
"68","000","00","090","0009","1234","720","334","386","34","754","1266","0","59.56","26.38"
"68","000","00","090","0010","0000","3205","1342","1863","144","3349","5405","0","61.96","24.83"
"68","000","00","090","0010","1240","828","342","486","23","851","1414","0","60.18","24.19"
"68","000","00","090","0010","1241","823","340","483","37","860","1368","0","62.87","24.85"
"68","000","00","090","0010","1242","779","320","459","39","818","1306","0","62.63","24.50"
"68","000","00","090","0010","1243","775","340","435","45","820","1317","0","62.26","25.82"
"68","000","00","090","0011","0000","1169","564","605","62","1231","1753","0","70.22","32.17"
"68","000","00","090","0011","1235","598","297","301","31","629","880","0","71.48","33.75"
"68","000","00","090","0011","1236","571","267","304","31","602","873","0","68.96","30.58"
"68","000","00","090","0012","0000","2270","1169","1101","139","2409","4066","0","59.25","28.75"
"68","000","00","090","0012","1273","786","412","374","59","845","1349","0","62.64","30.54"
"68","000","00","090","0012","1274","750","395","355","49","799","1329","0","60.12","29.72"
"68","000","00","090","0012","1275","734","362","372","31","765","1388","0","55.12","26.08"
"68","000","00","090","0013","0000","1940","911","1029","101","2041","3654","0","55.86","24.93"
"68","000","00","090","0013","1246","725","342","383","36","761","1314","0","57.91","26.03"
"68","000","00","090","0013","1247","603","277","326","43","646","1145","0","56.42","24.19"
"68","000","00","090","0013","1248","612","292","320","22","634","1195","0","53.05","24.44"
"68","000","00","090","0014","0000","2077","934","1143","115","2192","4078","0","53.75","22.90"
"68","000","00","090","0014","1254","608","249","359","52","660","1196","0","55.18","20.82"
"68","000","00","090","0014","1255","680","302","378","45","725","1352","0","53.62","22.34"
"68","000","00","090","0014","1256","789","383","406","18","807","1530","0","52.75","25.03"
"68","000","00","090","0015","0000","2035","781","1254","89","2124","3355","0","63.31","23.28"
"68","000","00","090","0015","1259","741","318","423","48","789","1176","0","67.09","27.04"
"68","000","00","090","0015","1260","592","217","375","23","615","1008","0","61.01","21.53"
"68","000","00","090","0015","1261","702","246","456","18","720","1171","0","61.49","21.01"
"68","000","00","090","0016","0000","509","246","263","37","546","796","0","68.59","30.90"
"68","000","00","090","0016","1276","509","246","263","37","546","796","0","68.59","30.90"
"68","000","00","090","0017","0000","892","448","444","69","961","1425","0","67.44","31.44"
"68","000","00","090","0017","1262","892","448","444","69","961","1425","0","67.44","31.44"
"68","000","00","090","0018","0000","1433","671","762","58","1491","2456","0","60.71","27.32"
"68","000","00","090","0018","1263","705","342","363","27","732","1267","0","57.77","26.99"
"68","000","00","090","0018","1264","728","329","399","31","759","1189","0","63.84","27.67"
"68","000","00","090","0019","0000","1713","727","986","70","1783","3001","0","59.41","24.23"
"68","000","00","090","0019","1265","855","378","477","24","879","1546","0","56.86","24.45"
"68","000","00","090","0019","1266","858","349","509","46","904","1455","0","62.13","23.99"
"68","000","00","090","0020","0000","1504","726","778","117","1621","2685","0","60.37","27.04"
"68","000","00","090","0020","1208","713","351","362","58","771","1281","0","60.19","27.40"
"68","000","00","090","0020","1209","791","375","416","59","850","1404","0","60.54","26.71"
"68","000","00","090","0021","0000","1452","746","706","71","1523","2585","0","58.92","28.86"
"68","000","00","090","0021","1214","671","359","312","30","701","1292","0","54.26","27.79"
"68","000","00","090","0021","1215","781","387","394","41","822","1293","0","63.57","29.93"
"68","000","00","090","0022","0000","2418","982","1436","85","2503","4134","0","60.55","23.75"
"68","000","00","090","0022","1219","886","356","530","30","916","1503","0","60.94","23.69"
"68","000","00","090","0022","1220","827","336","491","32","859","1524","0","56.36","22.05"
"68","000","00","090","0022","1221","705","290","415","23","728","1107","0","65.76","26.20"
"68","000","00","090","0023","0000","1750","807","943","103","1853","3400","0","54.50","23.74"
"68","000","00","090","0023","1225","866","433","433","52","918","1623","0","56.56","26.68"
"68","000","00","090","0023","1226","884","374","510","51","935","1777","0","52.62","21.05"
"68","000","00","090","0024","0000","1510","794","716","80","1590","2911","0","54.62","27.28"
"68","000","00","090","0024","1230","719","410","309","40","759","1323","0","57.37","30.99"
"68","000","00","090","0024","1231","791","384","407","40","831","1588","0","52.33","24.18"
"68","000","00","090","0025","0000","2387","1030","1357","127","2514","4014","0","62.63","25.66"
"68","000","00","090","0025","1237","926","407","519","35","961","1602","0","59.99","25.41"
"68","000","00","090","0025","1238","845","354","491","55","900","1328","0","67.77","26.66"
"68","000","00","090","0025","1239","616","269","347","37","653","1084","0","60.24","24.82"
"68","000","00","090","0026","0000","1852","745","1107","63","1915","3138","0","61.03","23.74"
"68","000","00","090","0026","1244","917","411","506","21","938","1617","0","58.01","25.42"
"68","000","00","090","0026","1245","935","334","601","42","977","1521","0","64.23","21.96"
"68","000","00","090","0027","0000","814","367","447","60","874","1442","0","60.61","25.45"
"68","000","00","090","0027","1249","814","367","447","60","874","1442","0","60.61","25.45"
"68","000","00","090","0028","0000","2019","849","1170","172","2191","3843","0","57.01","22.09"
"68","000","00","090","0028","1251","659","314","345","81","740","1279","0","57.86","24.55"
"68","000","00","090","0028","1252","665","268","397","58","723","1289","0","56.09","20.79"
"68","000","00","090","0028","1253","695","267","428","33","728","1275","0","57.10","20.94"
"68","000","00","090","0029","0000","1222","542","680","95","1317","2256","0","58.38","24.02"
"68","000","00","090","0029","1257","678","322","356","66","744","1235","0","60.24","26.07"
"68","000","00","090","0029","1258","544","220","324","29","573","1021","0","56.12","21.55"
"68","000","00","090","0030","0000","2084","737","1347","91","2175","3517","0","61.84","20.96"
"68","000","00","090","0030","1267","1046","383","663","38","1084","1755","0","61.77","21.82"
"68","000","00","090","0030","1268","1038","354","684","53","1091","1762","0","61.92","20.09"
"68","000","00","090","0031","0000","1957","779","1178","91","2048","3267","0","62.69","23.84"
"68","000","00","090","0031","1269","941","376","565","38","979","1669","0","58.66","22.53"
"68","000","00","090","0031","1270","1016","403","613","53","1069","1598","0","66.90","25.22"
"68","000","00","090","0032","0000","713","366","347","22","735","1534","0","47.91","23.86"
"68","000","00","090","0032","1250","713","366","347","22","735","1534","0","47.91","23.86"
"68","000","00","090","0033","0000","1312","542","770","38","1350","2087","0","64.69","25.97"
"68","000","00","090","0033","1277","698","276","422","20","718","1082","0","66.36","25.51"
"68","000","00","090","0033","1278","614","266","348","18","632","1005","0","62.89","26.47"
"68","000","00","100","0000","0000","103399","49269","54130","5153","108552","182885","227446","59.36","26.94"
"68","000","00","100","0001","0000","2629","1254","1375","172","2801","4583","0","61.12","27.36"
"68","000","00","100","0001","1038","980","432","548","58","1038","1678","0","61.86","25.74"
"68","000","00","100","0001","1039","866","443","423","76","942","1529","0","61.61","28.97"
"68","000","00","100","0001","1040","783","379","404","38","821","1376","0","59.67","27.54"
"68","000","00","100","0002","0000","2422","1256","1166","137","2559","4170","0","61.37","30.12"
"68","000","00","100","0002","1041","934","483","451","64","998","1628","0","61.30","29.67"
"68","000","00","100","0002","1042","719","388","331","49","768","1292","0","59.44","30.03"
"68","000","00","100","0002","1043","769","385","384","24","793","1250","0","63.44","30.80"
"68","000","00","100","0003","0000","3077","1531","1546","95","3172","5242","0","60.51","29.21"
"68","000","00","100","0003","1021","794","374","420","26","820","1243","0","65.97","30.09"
"68","000","00","100","0003","1022","740","354","386","17","757","1295","0","58.46","27.34"
"68","000","00","100","0003","1023","782","398","384","22","804","1379","0","58.30","28.86"
"68","000","00","100","0003","1024","761","405","356","30","791","1325","0","59.70","30.57"
"68","000","00","100","0004","0000","3209","1516","1693","137","3346","5245","0","63.79","28.90"
"68","000","00","100","0004","1011","733","383","350","63","796","1217","0","65.41","31.47"
"68","000","00","100","0004","1012","639","297","342","15","654","1063","0","61.52","27.94"
"68","000","00","100","0004","1013","967","435","532","28","995","1523","0","65.33","28.56"
"68","000","00","100","0004","1014","870","401","469","31","901","1442","0","62.48","27.81"
"68","000","00","100","0005","0000","2798","1306","1492","140","2938","5050","0","58.18","25.86"
"68","000","00","100","0005","1029","758","338","420","43","801","1309","0","61.19","25.82"
"68","000","00","100","0005","1030","761","336","425","31","792","1254","0","63.16","26.79"
"68","000","00","100","0005","1031","687","325","362","45","732","1254","0","58.37","25.92"
"68","000","00","100","0005","1032","592","307","285","21","613","1233","0","49.72","24.90"
"68","000","00","100","0006","0000","2168","1070","1098","109","2277","4189","0","54.36","25.54"
"68","000","00","100","0006","1004","735","383","352","36","771","1371","0","56.24","27.94"
"68","000","00","100","0006","1005","805","403","402","37","842","1451","0","58.03","27.77"
"68","000","00","100","0006","1006","628","284","344","36","664","1367","0","48.57","20.78"
"68","000","00","100","0007","0000","2111","973","1138","93","2204","3540","0","62.26","27.49"
"68","000","00","100","0007","1049","632","295","337","18","650","1109","0","58.61","26.60"
"68","000","00","100","0007","1050","731","360","371","42","773","1201","0","64.36","29.98"
"68","000","00","100","0007","1051","748","318","430","33","781","1230","0","63.50","25.85"
"68","000","00","100","0008","0000","3157","1513","1644","105","3262","6530","0","49.95","23.17"
"68","000","00","100","0008","1058","631","308","323","27","658","2300","0","28.61","13.39"
"68","000","00","100","0008","1059","667","339","328","22","689","1048","0","65.74","32.35"
"68","000","00","100","0008","1060","941","420","521","25","966","1572","0","61.45","26.72"
"68","000","00","100","0008","1061","918","446","472","31","949","1610","0","58.94","27.70"
"68","000","00","100","0009","0000","1349","673","676","74","1423","2308","0","61.66","29.16"
"68","000","00","100","0009","1044","586","304","282","36","622","1010","0","61.58","30.10"
"68","000","00","100","0009","1045","763","369","394","38","801","1298","0","61.71","28.43"
"68","000","00","100","0010","0000","2119","1112","1007","101","2220","3719","0","59.69","29.90"
"68","000","00","100","0010","1067","596","346","250","26","622","949","0","65.54","36.46"
"68","000","00","100","0010","1068","762","379","383","50","812","1379","0","58.88","27.48"
"68","000","00","100","0010","1069","761","387","374","25","786","1391","0","56.51","27.82"
"68","000","00","100","0011","0000","2396","1185","1211","133","2529","3855","0","65.60","30.74"
"68","000","00","100","0011","1072","726","371","355","32","758","1121","0","67.62","33.10"
"68","000","00","100","0011","1073","951","481","470","71","1022","1585","0","64.48","30.35"
"68","000","00","100","0011","1074","719","333","386","30","749","1149","0","65.19","28.98"
"68","000","00","100","0012","0000","2368","1161","1207","151","2519","4352","0","57.88","26.68"
"68","000","00","100","0012","0963","721","367","354","41","762","1403","0","54.31","26.16"
"68","000","00","100","0012","0964","862","433","429","63","925","1544","0","59.91","28.04"
"68","000","00","100","0012","0965","785","361","424","47","832","1405","0","59.22","25.69"
"68","000","00","100","0013","0000","2956","1445","1511","153","3109","5663","0","54.90","25.52"
"68","000","00","100","0013","0968","821","379","442","46","867","1558","0","55.65","24.33"
"68","000","00","100","0013","0969","697","326","371","38","735","1333","0","55.14","24.46"
"68","000","00","100","0013","0970","763","388","375","39","802","1422","0","56.40","27.29"
"68","000","00","100","0013","0971","675","352","323","30","705","1350","0","52.22","26.07"
"68","000","00","100","0014","0000","2479","1148","1331","160","2639","4692","0","56.24","24.47"
"68","000","00","100","0014","0995","723","296","427","39","762","1356","0","56.19","21.83"
"68","000","00","100","0014","0996","522","244","278","29","551","957","0","57.58","25.50"
"68","000","00","100","0014","0997","598","279","319","32","630","1203","0","52.37","23.19"
"68","000","00","100","0014","0998","636","329","307","60","696","1176","0","59.18","27.98"
"68","000","00","100","0015","0000","1313","573","740","70","1383","2196","0","62.98","26.09"
"68","000","00","100","0015","0986","591","244","347","29","620","1053","0","58.88","23.17"
"68","000","00","100","0015","0987","722","329","393","41","763","1143","0","66.75","28.78"
"68","000","00","100","0016","0000","2884","1326","1558","152","3036","4983","0","60.93","26.61"
"68","000","00","100","0016","0991","724","361","363","43","767","1256","0","61.07","28.74"
"68","000","00","100","0016","0992","661","300","361","45","706","1235","0","57.17","24.29"
"68","000","00","100","0016","0993","755","326","429","29","784","1258","0","62.32","25.91"
"68","000","00","100","0016","0994","744","339","405","35","779","1234","0","63.13","27.47"
"68","000","00","100","0017","0000","1570","712","858","132","1702","2773","0","61.38","25.68"
"68","000","00","100","0017","1093","745","332","413","78","823","1350","0","60.96","24.59"
"68","000","00","100","0017","1094","825","380","445","54","879","1423","0","61.77","26.70"
"68","000","00","100","0018","0000","1714","760","954","102","1816","3209","0","56.59","23.68"
"68","000","00","100","0018","1095","853","389","464","55","908","1637","0","55.47","23.76"
"68","000","00","100","0018","1096","861","371","490","47","908","1572","0","57.76","23.60"
"68","000","00","100","0019","0000","1359","548","811","90","1449","2423","0","59.80","22.62"
"68","000","00","100","0019","1100","582","266","316","50","632","1055","0","59.91","25.21"
"68","000","00","100","0019","1101","777","282","495","40","817","1368","0","59.72","20.61"
"68","000","00","100","0020","0000","1105","454","651","42","1147","1891","0","60.66","24.01"
"68","000","00","100","0020","1098","550","221","329","25","575","935","0","61.50","23.64"
"68","000","00","100","0020","1099","555","233","322","17","572","956","0","59.83","24.37"
"68","000","00","100","0021","0000","791","309","482","32","823","1357","0","60.65","22.77"
"68","000","00","100","0021","1097","791","309","482","32","823","1357","0","60.65","22.77"
"68","000","00","100","0022","0000","967","362","605","54","1021","1597","0","63.93","22.67"
"68","000","00","100","0022","1102","967","362","605","54","1021","1597","0","63.93","22.67"
"68","000","00","100","0023","0000","2293","1105","1188","131","2424","4190","0","57.85","26.37"
"68","000","00","100","0023","1078","696","392","304","37","733","1209","0","60.63","32.42"
"68","000","00","100","0023","1079","925","406","519","44","969","1641","0","59.05","24.74"
"68","000","00","100","0023","1080","672","307","365","50","722","1340","0","53.88","22.91"
"68","000","00","100","0024","0000","2974","1504","1470","170","3144","5274","0","59.61","28.52"
"68","000","00","100","0024","1089","581","329","252","34","615","1086","0","56.63","30.29"
"68","000","00","100","0024","1090","850","422","428","42","892","1401","0","63.67","30.12"
"68","000","00","100","0024","1091","721","393","328","38","759","1284","0","59.11","30.61"
"68","000","00","100","0024","1092","822","360","462","56","878","1503","0","58.42","23.95"
"68","000","00","100","0025","0000","1502","667","835","112","1614","2689","0","60.02","24.80"
"68","000","00","100","0025","1084","761","333","428","72","833","1325","0","62.87","25.13"
"68","000","00","100","0025","1085","741","334","407","40","781","1364","0","57.26","24.49"
"68","000","00","100","0026","0000","2261","1021","1240","143","2404","4254","0","56.51","24.00"
"68","000","00","100","0026","1086","820","353","467","47","867","1483","0","58.46","23.80"
"68","000","00","100","0026","1087","716","341","375","62","778","1451","0","53.62","23.50"
"68","000","00","100","0026","1088","725","327","398","34","759","1320","0","57.50","24.77"
"68","000","00","100","0027","0000","1541","778","763","97","1638","2980","0","54.97","26.11"
"68","000","00","100","0027","0966","696","358","338","50","746","1343","0","55.55","26.66"
"68","000","00","100","0027","0967","845","420","425","47","892","1637","0","54.49","25.66"
"68","000","00","100","0028","0000","4064","1973","2091","129","4193","6667","0","62.89","29.59"
"68","000","00","100","0028","1033","803","389","414","31","834","1274","0","65.46","30.53"
"68","000","00","100","0028","1034","841","427","414","26","867","1303","0","66.54","32.77"
"68","000","00","100","0028","1035","849","390","459","28","877","1353","0","64.82","28.82"
"68","000","00","100","0028","1036","777","404","373","24","801","1330","0","60.23","30.38"
"68","000","00","100","0028","1037","794","363","431","20","814","1407","0","57.85","25.80"
"68","000","00","100","0029","0000","934","452","482","62","996","1700","0","58.59","26.59"
"68","000","00","100","0029","0999","489","232","257","24","513","894","0","57.38","25.95"
"68","000","00","100","0029","1000","445","220","225","38","483","806","0","59.93","27.30"
"68","000","00","100","0030","0000","2417","1168","1249","160","2577","4438","0","58.07","26.32"
"68","000","00","100","0030","1001","917","441","476","51","968","1699","0","56.97","25.96"
"68","000","00","100","0030","1002","741","338","403","72","813","1346","0","60.40","25.11"
"68","000","00","100","0030","1003","759","389","370","37","796","1393","0","57.14","27.93"
"68","000","00","100","0031","0000","2275","1109","1166","94","2369","3825","0","61.93","28.99"
"68","000","00","100","0031","1015","829","395","434","23","852","1359","0","62.69","29.07"
"68","000","00","100","0031","1016","737","344","393","42","779","1201","0","64.86","28.64"
"68","000","00","100","0031","1017","709","370","339","29","738","1265","0","58.34","29.25"
"68","000","00","100","0032","0000","1847","913","934","83","1930","3370","0","57.27","27.09"
"68","000","00","100","0032","0988","534","291","243","32","566","973","0","58.17","29.91"
"68","000","00","100","0032","0989","613","299","314","51","664","1109","0","59.87","26.96"
"68","000","00","100","0032","0990","700","323","377","0","700","1288","0","54.35","25.08"
"68","000","00","100","0033","0000","3410","1629","1781","132","3542","6604","0","53.63","24.67"
"68","000","00","100","0033","0972","644","292","352","21","665","1329","0","50.04","21.97"
"68","000","00","100","0033","0973","670","338","332","26","696","1388","0","50.14","24.35"
"68","000","00","100","0033","0974","737","386","351","32","769","1259","0","61.08","30.66"
"68","000","00","100","0033","0975","687","339","348","22","709","1300","0","54.54","26.08"
"68","000","00","100","0033","0976","672","274","398","31","703","1328","0","52.94","20.63"
"68","000","00","100","0034","0000","2225","1106","1119","154","2379","4084","0","58.25","27.08"
"68","000","00","100","0034","1018","684","362","322","34","718","1254","0","57.26","28.87"
"68","000","00","100","0034","1019","780","373","407","51","831","1481","0","56.11","25.19"
"68","000","00","100","0034","1020","761","371","390","69","830","1349","0","61.53","27.50"
"68","000","00","100","0035","0000","1853","929","924","117","1970","2968","0","66.37","31.30"
"68","000","00","100","0035","1065","888","444","444","59","947","1454","0","65.13","30.54"
"68","000","00","100","0035","1066","965","485","480","58","1023","1514","0","67.57","32.03"
"68","000","00","100","0036","0000","2166","1033","1133","139","2305","3715","0","62.05","27.81"
"68","000","00","100","0036","1075","731","339","392","48","779","1312","0","59.38","25.84"
"68","000","00","100","0036","1076","704","352","352","46","750","1214","0","61.78","29.00"
"68","000","00","100","0036","1077","731","342","389","45","776","1189","0","65.26","28.76"
"68","000","00","100","0037","0000","3088","1493","1595","118","3206","4995","0","64.18","29.89"
"68","000","00","100","0037","1054","822","397","425","25","847","1234","0","68.64","32.17"
"68","000","00","100","0037","1055","580","278","302","29","609","879","0","69.28","31.63"
"68","000","00","100","0037","1056","835","413","422","31","866","1488","0","58.20","27.76"
"68","000","00","100","0037","1057","851","405","446","33","884","1394","0","63.41","29.05"
"68","000","00","100","0038","0000","2063","928","1135","150","2213","4107","0","53.88","22.60"
"68","000","00","100","0038","1081","629","295","334","67","696","1338","0","52.02","22.05"
"68","000","00","100","0038","1082","727","329","398","33","760","1280","0","59.38","25.70"
"68","000","00","100","0038","1083","707","304","403","50","757","1489","0","50.84","20.42"
"68","000","00","100","0039","0000","1747","846","901","81","1828","2751","0","66.45","30.75"
"68","000","00","100","0039","1070","810","390","420","28","838","1307","0","64.12","29.84"
"68","000","00","100","0039","1071","937","456","481","53","990","1444","0","68.56","31.58"
"68","000","00","100","0040","0000","859","473","386","26","885","1507","0","58.73","31.39"
"68","000","00","100","0040","1052","419","236","183","11","430","713","0","60.31","33.10"
"68","000","00","100","0040","1053","440","237","203","15","455","794","0","57.30","29.85"
"68","000","00","100","0041","0000","2186","1002","1184","71","2257","3643","0","61.95","27.50"
"68","000","00","100","0041","1046","722","334","388","15","737","1204","0","61.21","27.74"
"68","000","00","100","0041","1047","813","367","446","36","849","1349","0","62.94","27.21"
"68","000","00","100","0041","1048","651","301","350","20","671","1090","0","61.56","27.61"
"68","000","00","100","0042","0000","2997","1376","1621","94","3091","4749","0","65.09","28.97"
"68","000","00","100","0042","1025","731","353","378","24","755","1201","0","62.86","29.39"
"68","000","00","100","0042","1026","596","260","336","13","609","973","0","62.59","26.72"
"68","000","00","100","0042","1027","904","425","479","25","929","1314","0","70.70","32.34"
"68","000","00","100","0042","1028","766","338","428","32","798","1261","0","63.28","26.80"
"68","000","00","100","0043","0000","2971","1385","1586","100","3071","5371","0","57.18","25.79"
"68","000","00","100","0043","1007","722","334","388","26","748","1323","0","56.54","25.25"
"68","000","00","100","0043","1008","746","340","406","36","782","1363","0","57.37","24.94"
"68","000","00","100","0043","1009","736","336","400","22","758","1330","0","56.99","25.26"
"68","000","00","100","0043","1010","767","375","392","16","783","1355","0","57.79","27.68"
"68","000","00","100","0044","0000","2152","995","1157","55","2207","3690","0","59.81","26.96"
"68","000","00","100","0044","1062","676","318","358","19","695","1164","0","59.71","27.32"
"68","000","00","100","0044","1063","676","303","373","20","696","1163","0","59.85","26.05"
"68","000","00","100","0044","1064","800","374","426","16","816","1363","0","59.87","27.44"
"68","000","00","100","0045","0000","2883","1429","1454","156","3039","5041","0","60.29","28.35"
"68","000","00","100","0045","0977","814","432","382","28","842","1385","0","60.79","31.19"
"68","000","00","100","0045","0978","744","391","353","81","825","1231","0","67.02","31.76"
"68","000","00","100","0045","0979","717","312","405","27","744","1194","0","62.31","26.13"
"68","000","00","100","0045","0980","608","294","314","20","628","1231","0","51.02","23.88"
"68","000","00","100","0046","0000","3750","1768","1982","145","3895","6706","0","58.08","26.36"
"68","000","00","100","0046","0981","767","336","431","35","802","1338","0","59.94","25.11"
"68","000","00","100","0046","0982","657","334","323","22","679","1311","0","51.79","25.48"
"68","000","00","100","0046","0983","829","340","489","33","862","1363","0","63.24","24.94"
"68","000","00","100","0046","0984","829","419","410","41","870","1432","0","60.75","29.26"
"68","000","00","100","0046","0985","668","339","329","14","682","1262","0","54.04","26.86"
"68","000","00","110","0000","0000","24714","13073","11641","1846","26560","41177","49145","64.50","31.75"
"68","000","00","110","0001","0000","1555","780","775","119","1674","2779","0","60.24","28.07"
"68","000","00","110","0001","1280","816","433","383","64","880","1405","0","62.63","30.82"
"68","000","00","110","0001","1281","739","347","392","55","794","1374","0","57.79","25.25"
"68","000","00","110","0002","0000","2245","1106","1139","196","2441","3905","0","62.51","28.32"
"68","000","00","110","0002","1282","761","392","369","68","829","1340","0","61.87","29.25"
"68","000","00","110","0002","1283","699","337","362","55","754","1252","0","60.22","26.92"
"68","000","00","110","0002","1284","785","377","408","73","858","1313","0","65.35","28.71"
"68","000","00","110","0003","0000","801","411","390","48","849","1466","0","57.91","28.04"
"68","000","00","110","0003","1285","801","411","390","48","849","1466","0","57.91","28.04"
"68","000","00","110","0004","0000","2477","1263","1214","132","2609","4077","0","63.99","30.98"
"68","000","00","110","0004","1286","938","434","504","42","980","1472","0","66.58","29.48"
"68","000","00","110","0004","1287","735","380","355","39","774","1295","0","59.77","29.34"
"68","000","00","110","0004","1288","804","449","355","51","855","1310","0","65.27","34.27"
"68","000","00","110","0005","0000","2468","1250","1218","149","2617","4417","0","59.25","28.30"
"68","000","00","110","0005","1297","519","274","245","27","546","1056","0","51.70","25.95"
"68","000","00","110","0005","1298","621","298","323","32","653","1067","0","61.20","27.93"
"68","000","00","110","0005","1299","681","331","350","34","715","1186","0","60.29","27.91"
"68","000","00","110","0005","1300","647","347","300","56","703","1108","0","63.45","31.32"
"68","000","00","110","0006","0000","1325","690","635","76","1401","2506","0","55.91","27.53"
"68","000","00","110","0006","1293","671","358","313","46","717","1245","0","57.59","28.76"
"68","000","00","110","0006","1294","654","332","322","30","684","1261","0","54.24","26.33"
"68","000","00","110","0007","0000","1337","735","602","90","1427","2186","0","65.28","33.62"
"68","000","00","110","0007","1295","752","403","349","44","796","1217","0","65.41","33.11"
"68","000","00","110","0007","1296","585","332","253","46","631","969","0","65.12","34.26"
"68","000","00","110","0008","0000","898","511","387","92","990","1329","0","74.49","38.45"
"68","000","00","110","0008","1292","898","511","387","92","990","1329","0","74.49","38.45"
"68","000","00","110","0009","0000","865","478","387","88","953","1427","0","66.78","33.50"
"68","000","00","110","0009","1291","865","478","387","88","953","1427","0","66.78","33.50"
"68","000","00","110","0010","0000","1239","677","562","78","1317","2166","0","60.80","31.26"
"68","000","00","110","0010","1289","578","307","271","39","617","1078","0","57.24","28.48"
"68","000","00","110","0010","1290","661","370","291","39","700","1088","0","64.34","34.01"
"68","000","00","110","0011","0000","429","231","198","25","454","712","0","63.76","32.44"
"68","000","00","110","0011","1311","429","231","198","25","454","712","0","63.76","32.44"
"68","000","00","110","0012","0000","904","497","407","65","969","1679","0","57.71","29.60"
"68","000","00","110","0012","1313","904","497","407","65","969","1679","0","57.71","29.60"
"68","000","00","110","0013","0000","574","307","267","62","636","881","0","72.19","34.85"
"68","000","00","110","0013","1312","574","307","267","62","636","881","0","72.19","34.85"
"68","000","00","110","0014","0000","796","411","385","50","846","1253","0","67.52","32.80"
"68","000","00","110","0014","1314","796","411","385","50","846","1253","0","67.52","32.80"
"68","000","00","110","0015","0000","667","385","282","60","727","993","0","73.21","38.77"
"68","000","00","110","0015","1310","667","385","282","60","727","993","0","73.21","38.77"
"68","000","00","110","0016","0000","1436","775","661","116","1552","2127","0","72.97","36.44"
"68","000","00","110","0016","1308","536","292","244","43","579","805","0","71.93","36.27"
"68","000","00","110","0016","1309","900","483","417","73","973","1322","0","73.60","36.54"
"68","000","00","110","0017","0000","753","349","404","64","817","1051","0","77.74","33.21"
"68","000","00","110","0017","1307","753","349","404","64","817","1051","0","77.74","33.21"
"68","000","00","110","0018","0000","461","239","222","64","525","625","0","84.00","38.24"
"68","000","00","110","0018","1305","461","239","222","64","525","625","0","84.00","38.24"
"68","000","00","110","0019","0000","630","376","254","62","692","893","0","77.49","42.11"
"68","000","00","110","0019","1304","630","376","254","62","692","893","0","77.49","42.11"
"68","000","00","110","0020","0000","678","377","301","43","721","1036","0","69.59","36.39"
"68","000","00","110","0020","1306","678","377","301","43","721","1036","0","69.59","36.39"
"68","000","00","110","0021","0000","575","302","273","56","631","1046","0","60.33","28.87"
"68","000","00","110","0021","1303","575","302","273","56","631","1046","0","60.33","28.87"
"68","000","00","110","0022","0000","853","498","355","66","919","1283","0","71.63","38.82"
"68","000","00","110","0022","1301","853","498","355","66","919","1283","0","71.63","38.82"
"68","000","00","110","0023","0000","748","425","323","45","793","1340","0","59.18","31.72"
"68","000","00","110","0023","1302","748","425","323","45","793","1340","0","59.18","31.72"
"68","000","00","120","0000","0000","33394","18451","14943","2252","35646","58980","72514","60.44","31.28"
"68","000","00","120","0001","0000","1479","784","695","83","1562","2724","0","57.34","28.78"
"68","000","00","120","0001","1315","820","428","392","42","862","1332","0","64.71","32.13"
"68","000","00","120","0001","1316","659","356","303","41","700","1392","0","50.29","25.57"
"68","000","00","120","0002","0000","542","299","243","44","586","831","0","70.52","35.98"
"68","000","00","120","0002","1317","542","299","243","44","586","831","0","70.52","35.98"
"68","000","00","120","0003","0000","724","377","347","69","793","1237","0","64.11","30.48"
"68","000","00","120","0003","1318","724","377","347","69","793","1237","0","64.11","30.48"
"68","000","00","120","0004","0000","1322","684","638","66","1388","2019","0","68.75","33.88"
"68","000","00","120","0004","1319","616","339","277","26","642","895","0","71.73","37.88"
"68","000","00","120","0004","1320","706","345","361","40","746","1124","0","66.37","30.69"
"68","000","00","120","0005","0000","681","372","309","69","750","934","0","80.30","39.83"
"68","000","00","120","0005","1323","681","372","309","69","750","934","0","80.30","39.83"
"68","000","00","120","0006","0000","1254","657","597","84","1338","2129","0","62.85","30.86"
"68","000","00","120","0006","1321","732","374","358","68","800","1279","0","62.55","29.24"
"68","000","00","120","0006","1322","522","283","239","16","538","850","0","63.29","33.29"
"68","000","00","120","0007","0000","565","307","258","33","598","826","0","72.40","37.17"
"68","000","00","120","0007","1324","565","307","258","33","598","826","0","72.40","37.17"
"68","000","00","120","0008","0000","428","215","213","38","466","772","0","60.36","27.85"
"68","000","00","120","0008","1325","428","215","213","38","466","772","0","60.36","27.85"
"68","000","00","120","0009","0000","993","549","444","82","1075","1835","0","58.58","29.92"
"68","000","00","120","0009","1326","431","239","192","44","475","759","0","62.58","31.49"
"68","000","00","120","0009","1327","562","310","252","38","600","1076","0","55.76","28.81"
"68","000","00","120","0010","0000","1506","840","666","122","1628","2610","0","62.38","32.18"
"68","000","00","120","0010","1328","779","419","360","69","848","1260","0","67.30","33.25"
"68","000","00","120","0010","1329","727","421","306","53","780","1350","0","57.78","31.19"
"68","000","00","120","0011","0000","1555","885","670","103","1658","2611","0","63.50","33.90"
"68","000","00","120","0011","1330","753","402","351","48","801","1319","0","60.73","30.48"
"68","000","00","120","0011","1331","802","483","319","55","857","1292","0","66.33","37.38"
"68","000","00","120","0012","0000","1702","970","732","111","1813","3059","0","59.27","31.71"
"68","000","00","120","0012","1332","858","518","340","74","932","1497","0","62.26","34.60"
"68","000","00","120","0012","1333","844","452","392","37","881","1562","0","56.40","28.94"
"68","000","00","120","0013","0000","977","564","413","59","1036","1583","0","65.45","35.63"
"68","000","00","120","0013","1334","977","564","413","59","1036","1583","0","65.45","35.63"
"68","000","00","120","0014","0000","2799","1637","1162","167","2966","4636","0","63.98","35.31"
"68","000","00","120","0014","1335","662","406","256","40","702","1123","0","62.51","36.15"
"68","000","00","120","0014","1336","669","408","261","24","693","1069","0","64.83","38.17"
"68","000","00","120","0014","1337","718","405","313","52","770","1175","0","65.53","34.47"
"68","000","00","120","0014","1338","750","418","332","51","801","1269","0","63.12","32.94"
"68","000","00","120","0015","0000","2326","1182","1144","98","2424","3976","0","60.97","29.73"
"68","000","00","120","0015","1339","710","391","319","34","744","1240","0","60.00","31.53"
"68","000","00","120","0015","1340","821","427","394","34","855","1443","0","59.25","29.59"
"68","000","00","120","0015","1341","795","364","431","30","825","1293","0","63.81","28.15"
"68","000","00","120","0016","0000","1413","744","669","83","1496","2478","0","60.37","30.02"
"68","000","00","120","0016","1342","656","349","307","50","706","1055","0","66.92","33.08"
"68","000","00","120","0016","1343","757","395","362","33","790","1423","0","55.52","27.76"
"68","000","00","120","0017","0000","1730","927","803","135","1865","2911","0","64.07","31.84"
"68","000","00","120","0017","1344","920","481","439","71","991","1459","0","67.92","32.97"
"68","000","00","120","0017","1345","810","446","364","64","874","1452","0","60.19","30.72"
"68","000","00","120","0018","0000","1530","869","661","95","1625","2586","0","62.84","33.60"
"68","000","00","120","0018","1346","746","438","308","55","801","1265","0","63.32","34.62"
"68","000","00","120","0018","1347","784","431","353","40","824","1321","0","62.38","32.63"
"68","000","00","120","0019","0000","547","285","262","65","612","1010","0","60.59","28.22"
"68","000","00","120","0019","1348","547","285","262","65","612","1010","0","60.59","28.22"
"68","000","00","120","0020","0000","1300","751","549","102","1402","1937","0","72.38","38.77"
"68","000","00","120","0020","1349","667","370","297","59","726","988","0","73.48","37.45"
"68","000","00","120","0020","1350","633","381","252","43","676","949","0","71.23","40.15"
"68","000","00","120","0021","0000","1794","1079","715","116","1910","3541","0","53.94","30.47"
"68","000","00","120","0021","1351","858","533","325","64","922","1579","0","58.39","33.76"
"68","000","00","120","0021","1352","936","546","390","52","988","1962","0","50.36","27.83"
"68","000","00","120","0022","0000","2146","1228","918","208","2354","4864","0","48.40","25.25"
"68","000","00","120","0022","1357","690","393","297","68","758","1487","0","50.98","26.43"
"68","000","00","120","0022","1358","775","424","351","57","832","1725","0","48.23","24.58"
"68","000","00","120","0022","1359","681","411","270","83","764","1652","0","46.25","24.88"
"68","000","00","120","0023","0000","982","554","428","76","1058","1917","0","55.19","28.90"
"68","000","00","120","0023","1360","540","303","237","49","589","984","0","59.86","30.79"
"68","000","00","120","0023","1361","442","251","191","27","469","933","0","50.27","26.90"
"68","000","00","120","0024","0000","3099","1692","1407","144","3243","5954","0","54.47","28.42"
"68","000","00","120","0024","1353","721","381","340","33","754","1460","0","51.64","26.10"
"68","000","00","120","0024","1354","820","449","371","49","869","1488","0","58.40","30.17"
"68","000","00","120","0024","1355","815","438","377","24","839","1516","0","55.34","28.89"
"68","000","00","120","0024","1356","743","424","319","38","781","1490","0","52.42","28.46"
"68","000","00","130","0000","0000","5655","2343","3312","481","6136","10148","12943","60.47","23.09"
"68","000","00","130","0001","0000","1151","546","605","114","1265","2063","0","61.32","26.47"
"68","000","00","130","0001","0699","579","302","277","66","645","1013","0","63.67","29.81"
"68","000","00","130","0001","0700","572","244","328","48","620","1050","0","59.05","23.24"
"68","000","00","130","0002","0000","853","338","515","85","938","1433","0","65.46","23.59"
"68","000","00","130","0002","0701","853","338","515","85","938","1433","0","65.46","23.59"
"68","000","00","130","0003","0000","379","150","229","36","415","747","0","55.56","20.08"
"68","000","00","130","0003","0703","379","150","229","36","415","747","0","55.56","20.08"
"68","000","00","130","0004","0000","302","98","204","13","315","674","0","46.74","14.54"
"68","000","00","130","0004","0702","302","98","204","13","315","674","0","46.74","14.54"
"68","000","00","130","0005","0000","399","181","218","33","432","653","0","66.16","27.72"
"68","000","00","130","0005","0705","399","181","218","33","432","653","0","66.16","27.72"
"68","000","00","130","0006","0000","409","174","235","31","440","693","0","63.49","25.11"
"68","000","00","130","0006","0708","409","174","235","31","440","693","0","63.49","25.11"
"68","000","00","130","0007","0000","517","205","312","46","563","739","0","76.18","27.74"
"68","000","00","130","0007","0706","517","205","312","46","563","739","0","76.18","27.74"
"68","000","00","130","0008","0000","813","300","513","72","885","1280","0","69.14","23.44"
"68","000","00","130","0008","0709","813","300","513","72","885","1280","0","69.14","23.44"
"68","000","00","130","0009","0000","591","235","356","44","635","1092","0","58.15","21.52"
"68","000","00","130","0009","0704","591","235","356","44","635","1092","0","58.15","21.52"
"68","000","00","130","0010","0000","241","116","125","7","248","774","0","32.04","14.99"
"68","000","00","130","0010","0707","241","116","125","7","248","774","0","32.04","14.99"
"66","000","00","000","0000","0000","1255934","635136","620798","71765","1327699","2279661","2806458","58.24","27.86"
"66","000","00","010","0000","0000","7138","3939","3199","368","7506","13593","17511","55.22","28.98"
"66","000","00","010","0001","0000","766","455","311","41","807","1355","0","59.56","33.58"
"66","000","00","010","0001","1275","766","455","311","41","807","1355","0","59.56","33.58"
"66","000","00","010","0002","0000","916","532","384","54","970","1833","0","52.92","29.02"
"66","000","00","010","0002","1279","508","297","211","36","544","1061","0","51.27","27.99"
"66","000","00","010","0002","1280","408","235","173","18","426","772","0","55.18","30.44"
"66","000","00","010","0003","0000","764","422","342","37","801","1449","0","55.28","29.12"
"66","000","00","010","0003","1274","764","422","342","37","801","1449","0","55.28","29.12"
"66","000","00","010","0004","0000","784","399","385","28","812","1372","0","59.18","29.08"
"66","000","00","010","0004","1276","784","399","385","28","812","1372","0","59.18","29.08"
"66","000","00","010","0005","0000","986","510","476","58","1044","1847","0","56.52","27.61"
"66","000","00","010","0005","1277","527","265","262","19","546","968","0","56.40","27.38"
"66","000","00","010","0005","1278","459","245","214","39","498","879","0","56.66","27.87"
"66","000","00","010","0006","0000","827","459","368","44","871","1797","0","48.47","25.54"
"66","000","00","010","0006","1281","466","268","198","21","487","1161","0","41.95","23.08"
"66","000","00","010","0006","1282","361","191","170","23","384","636","0","60.38","30.03"
"66","000","00","010","0007","0000","1156","660","496","72","1228","2145","0","57.25","30.77"
"66","000","00","010","0007","1283","521","286","235","20","541","961","0","56.30","29.76"
"66","000","00","010","0007","1284","635","374","261","52","687","1184","0","58.02","31.59"
"66","000","00","010","0008","0000","939","502","437","34","973","1795","0","54.21","27.97"
"66","000","00","010","0008","1285","490","262","228","19","509","912","0","55.81","28.73"
"66","000","00","010","0008","1286","449","240","209","15","464","883","0","52.55","27.18"
"66","000","00","020","0000","0000","35834","18841","16993","1782","37616","63196","75328","59.52","29.81"
"66","000","00","020","0001","0000","1350","751","599","70","1420","2820","0","50.35","26.63"
"66","000","00","020","0001","1364","428","248","180","15","443","1110","0","39.91","22.34"
"66","000","00","020","0001","1365","502","259","243","28","530","904","0","58.63","28.65"
"66","000","00","020","0001","1366","420","244","176","27","447","806","0","55.46","30.27"
"66","000","00","020","0002","0000","1751","981","770","92","1843","2891","0","63.75","33.93"
"66","000","00","020","0002","1367","622","339","283","27","649","997","0","65.10","34.00"
"66","000","00","020","0002","1368","619","339","280","29","648","1051","0","61.66","32.25"
"66","000","00","020","0002","1369","510","303","207","36","546","843","0","64.77","35.94"
"66","000","00","020","0003","0000","2137","1233","904","90","2227","3597","0","61.91","34.28"
"66","000","00","020","0003","1370","783","430","353","21","804","1304","0","61.66","32.98"
"66","000","00","020","0003","1371","666","380","286","35","701","1151","0","60.90","33.01"
"66","000","00","020","0003","1372","688","423","265","34","722","1142","0","63.22","37.04"
"66","000","00","020","0004","0000","1661","939","722","68","1729","2695","0","64.16","34.84"
"66","000","00","020","0004","1373","803","448","355","38","841","1337","0","62.90","33.51"
"66","000","00","020","0004","1374","858","491","367","30","888","1358","0","65.39","36.16"
"66","000","00","020","0005","0000","1149","633","516","62","1211","1926","0","62.88","32.87"
"66","000","00","020","0005","1377","657","406","251","51","708","1066","0","66.42","38.09"
"66","000","00","020","0005","1378","492","227","265","11","503","860","0","58.49","26.40"
"66","000","00","020","0006","0000","1164","643","521","56","1220","2014","0","60.58","31.93"
"66","000","00","020","0006","1375","567","313","254","40","607","1008","0","60.22","31.05"
"66","000","00","020","0006","1376","597","330","267","16","613","1006","0","60.93","32.80"
"66","000","00","020","0007","0000","1485","867","618","71","1556","2383","0","65.30","36.38"
"66","000","00","020","0007","1379","509","282","227","21","530","808","0","65.59","34.90"
"66","000","00","020","0007","1380","466","291","175","24","490","765","0","64.05","38.04"
"66","000","00","020","0007","1381","510","294","216","26","536","810","0","66.17","36.30"
"66","000","00","020","0008","0000","1211","683","528","75","1286","2302","0","55.86","29.67"
"66","000","00","020","0008","1382","661","373","288","42","703","1236","0","56.88","30.18"
"66","000","00","020","0008","1383","550","310","240","33","583","1066","0","54.69","29.08"
"66","000","00","020","0009","0000","4008","2149","1859","151","4159","6771","0","61.42","31.74"
"66","000","00","020","0009","1384","689","397","292","28","717","1106","0","64.83","35.90"
"66","000","00","020","0009","1385","577","329","248","39","616","999","0","61.66","32.93"
"66","000","00","020","0009","1386","655","320","335","20","675","1120","0","60.27","28.57"
"66","000","00","020","0009","1387","811","447","364","38","849","1304","0","65.11","34.28"
"66","000","00","020","0009","1388","653","340","313","18","671","1104","0","60.78","30.80"
"66","000","00","020","0009","1389","623","316","307","8","631","1138","0","55.45","27.77"
"66","000","00","020","0010","0000","2511","1375","1136","90","2601","4620","0","56.30","29.76"
"66","000","00","020","0010","1390","633","362","271","26","659","1180","0","55.85","30.68"
"66","000","00","020","0010","1391","642","334","308","22","664","1117","0","59.44","29.90"
"66","000","00","020","0010","1392","649","361","288","19","668","1268","0","52.68","28.47"
"66","000","00","020","0010","1393","587","318","269","23","610","1055","0","57.82","30.14"
"66","000","00","020","0011","0000","1870","960","910","105","1975","3579","0","55.18","26.82"
"66","000","00","020","0011","1400","659","330","329","36","695","1300","0","53.46","25.38"
"66","000","00","020","0011","1401","553","304","249","39","592","1048","0","56.49","29.01"
"66","000","00","020","0011","1402","658","326","332","30","688","1231","0","55.89","26.48"
"66","000","00","020","0012","0000","1235","618","617","50","1285","2545","0","50.49","24.28"
"66","000","00","020","0012","1403","578","324","254","30","608","1241","0","48.99","26.11"
"66","000","00","020","0012","1404","657","294","363","20","677","1304","0","51.92","22.55"
"66","000","00","020","0013","0000","2166","935","1231","122","2288","3851","0","59.41","24.28"
"66","000","00","020","0013","1405","815","401","414","55","870","1348","0","64.54","29.75"
"66","000","00","020","0013","1406","647","284","363","26","673","1132","0","59.45","25.09"
"66","000","00","020","0013","1407","704","250","454","41","745","1371","0","54.34","18.23"
"66","000","00","020","0014","0000","961","405","556","59","1020","1674","0","60.93","24.19"
"66","000","00","020","0014","1412","442","181","261","24","466","764","0","60.99","23.69"
"66","000","00","020","0014","1413","519","224","295","35","554","910","0","60.88","24.62"
"66","000","00","020","0015","0000","2221","866","1355","151","2372","3866","0","61.36","22.40"
"66","000","00","020","0015","1408","609","274","335","50","659","1111","0","59.32","24.66"
"66","000","00","020","0015","1409","524","152","372","24","548","909","0","60.29","16.72"
"66","000","00","020","0015","1410","586","280","306","49","635","930","0","68.28","30.11"
"66","000","00","020","0015","1411","502","160","342","28","530","916","0","57.86","17.47"
"66","000","00","020","0016","0000","4899","2643","2256","264","5163","8546","0","60.41","30.93"
"66","000","00","020","0016","1414","752","396","356","49","801","1239","0","64.65","31.96"
"66","000","00","020","0016","1415","698","383","315","50","748","1244","0","60.13","30.79"
"66","000","00","020","0016","1416","616","303","313","26","642","1299","0","49.42","23.33"
"66","000","00","020","0016","1417","688","374","314","56","744","1243","0","59.86","30.09"
"66","000","00","020","0016","1418","755","445","310","26","781","1206","0","64.76","36.90"
"66","000","00","020","0016","1419","669","373","296","27","696","1165","0","59.74","32.02"
"66","000","00","020","0016","1420","721","369","352","30","751","1150","0","65.30","32.09"
"66","000","00","020","0017","0000","4055","2160","1895","206","4261","7116","0","59.88","30.35"
"66","000","00","020","0017","1394","735","381","354","52","787","1200","0","65.58","31.75"
"66","000","00","020","0017","1395","598","302","296","21","619","1115","0","55.52","27.09"
"66","000","00","020","0017","1396","493","266","227","24","517","961","0","53.80","27.68"
"66","000","00","020","0017","1397","730","392","338","49","779","1256","0","62.02","31.21"
"66","000","00","020","0017","1398","756","425","331","28","784","1261","0","62.17","33.70"
"66","000","00","020","0017","1399","743","394","349","32","775","1323","0","58.58","29.78"
"66","000","00","030","0000","0000","57528","29165","28363","2251","59779","102891","125154","58.10","28.35"
"66","000","00","030","0001","0000","1921","994","927","100","2021","3350","0","60.33","29.67"
"66","000","00","030","0001","1425","639","343","296","22","661","1081","0","61.15","31.73"
"66","000","00","030","0001","1426","675","360","315","42","717","1148","0","62.46","31.36"
"66","000","00","030","0001","1427","607","291","316","36","643","1121","0","57.36","25.96"
"66","000","00","030","0002","0000","2123","1120","1003","77","2200","3589","0","61.30","31.21"
"66","000","00","030","0002","1428","727","371","356","30","757","1165","0","64.98","31.85"
"66","000","00","030","0002","1429","698","381","317","16","714","1192","0","59.90","31.96"
"66","000","00","030","0002","1430","698","368","330","31","729","1232","0","59.17","29.87"
"66","000","00","030","0003","0000","2041","1037","1004","90","2131","3372","0","63.20","30.75"
"66","000","00","030","0003","1431","677","351","326","15","692","1096","0","63.14","32.03"
"66","000","00","030","0003","1432","759","378","381","44","803","1244","0","64.55","30.39"
"66","000","00","030","0003","1433","605","308","297","31","636","1032","0","61.63","29.84"
"66","000","00","030","0004","0000","1604","785","819","76","1680","2732","0","61.49","28.73"
"66","000","00","030","0004","1434","833","392","441","33","866","1323","0","65.46","29.63"
"66","000","00","030","0004","1435","771","393","378","43","814","1409","0","57.77","27.89"
"66","000","00","030","0005","0000","1508","800","708","58","1566","2441","0","64.15","32.77"
"66","000","00","030","0005","1436","687","369","318","21","708","1098","0","64.48","33.61"
"66","000","00","030","0005","1437","821","431","390","37","858","1343","0","63.89","32.09"
"66","000","00","030","0006","0000","1599","855","744","72","1671","2641","0","63.27","32.37"
"66","000","00","030","0006","1438","798","428","370","44","842","1279","0","65.83","33.46"
"66","000","00","030","0006","1439","801","427","374","28","829","1362","0","60.87","31.35"
"66","000","00","030","0007","0000","2441","1198","1243","72","2513","4326","0","58.09","27.69"
"66","000","00","030","0007","1440","832","392","440","32","864","1452","0","59.50","27.00"
"66","000","00","030","0007","1441","768","370","398","23","791","1418","0","55.78","26.09"
"66","000","00","030","0007","1442","841","436","405","17","858","1456","0","58.93","29.95"
"66","000","00","030","0008","0000","2265","1195","1070","124","2389","3683","0","64.87","32.45"
"66","000","00","030","0008","1443","810","418","392","53","863","1280","0","67.42","32.66"
"66","000","00","030","0008","1444","800","460","340","48","848","1256","0","67.52","36.62"
"66","000","00","030","0008","1445","655","317","338","23","678","1147","0","59.11","27.64"
"66","000","00","030","0009","0000","2669","1409","1260","144","2813","5089","0","55.28","27.69"
"66","000","00","030","0009","1446","631","328","303","42","673","1215","0","55.39","27.00"
"66","000","00","030","0009","1447","698","365","333","33","731","1365","0","53.55","26.74"
"66","000","00","030","0009","1448","648","350","298","39","687","1239","0","55.45","28.25"
"66","000","00","030","0009","1449","692","366","326","30","722","1270","0","56.85","28.82"
"66","000","00","030","0010","0000","2049","1047","1002","57","2106","3991","0","52.77","26.23"
"66","000","00","030","0010","1454","723","382","341","10","733","1390","0","52.73","27.48"
"66","000","00","030","0010","1455","698","350","348","33","731","1308","0","55.89","26.76"
"66","000","00","030","0010","1456","628","315","313","14","642","1293","0","49.65","24.36"
"66","000","00","030","0011","0000","4286","2058","2228","136","4422","7721","0","57.27","26.65"
"66","000","00","030","0011","1465","699","348","351","21","720","1277","0","56.38","27.25"
"66","000","00","030","0011","1466","785","372","413","22","807","1207","0","66.86","30.82"
"66","000","00","030","0011","1467","736","351","385","32","768","1328","0","57.83","26.43"
"66","000","00","030","0011","1468","618","293","325","14","632","1302","0","48.54","22.50"
"66","000","00","030","0011","1469","705","341","364","17","722","1399","0","51.61","24.37"
"66","000","00","030","0011","1470","743","353","390","30","773","1208","0","63.99","29.22"
"66","000","00","030","0012","0000","6262","3144","3118","207","6469","11404","0","56.73","27.57"
"66","000","00","030","0012","1475","728","353","375","24","752","1465","0","51.33","24.10"
"66","000","00","030","0012","1476","746","346","400","16","762","1426","0","53.44","24.26"
"66","000","00","030","0012","1477","829","423","406","33","862","1401","0","61.53","30.19"
"66","000","00","030","0012","1478","872","436","436","36","908","1475","0","61.56","29.56"
"66","000","00","030","0012","1479","770","422","348","26","796","1467","0","54.26","28.77"
"66","000","00","030","0012","1480","791","397","394","19","810","1402","0","57.77","28.32"
"66","000","00","030","0012","1481","730","363","367","12","742","1392","0","53.30","26.08"
"66","000","00","030","0012","1482","796","404","392","41","837","1376","0","60.83","29.36"
"66","000","00","030","0013","0000","4544","2243","2301","178","4722","8209","0","57.52","27.32"
"66","000","00","030","0013","1488","861","419","442","35","896","1564","0","57.29","26.79"
"66","000","00","030","0013","1489","773","367","406","22","795","1389","0","57.24","26.42"
"66","000","00","030","0013","1490","734","344","390","27","761","1300","0","58.54","26.46"
"66","000","00","030","0013","1491","671","356","315","46","717","1248","0","57.45","28.53"
"66","000","00","030","0013","1492","822","401","421","23","845","1499","0","56.37","26.75"
"66","000","00","030","0013","1493","683","356","327","25","708","1209","0","58.56","29.45"
"66","000","00","030","0014","0000","2220","1115","1105","101","2321","4065","0","57.10","27.43"
"66","000","00","030","0014","1494","721","365","356","41","762","1326","0","57.47","27.53"
"66","000","00","030","0014","1495","733","387","346","32","765","1341","0","57.05","28.86"
"66","000","00","030","0014","1496","766","363","403","28","794","1398","0","56.80","25.97"
"66","000","00","030","0015","0000","1023","567","456","39","1062","1735","0","61.21","32.68"
"66","000","00","030","0015","1421","508","293","215","18","526","845","0","62.25","34.67"
"66","000","00","030","0015","1422","515","274","241","21","536","890","0","60.22","30.79"
"66","000","00","030","0016","0000","1404","718","686","62","1466","2289","0","64.05","31.37"
"66","000","00","030","0016","1423","675","348","327","28","703","1154","0","60.92","30.16"
"66","000","00","030","0016","1424","729","370","359","34","763","1135","0","67.22","32.60"
"66","000","00","030","0017","0000","3114","1573","1541","111","3225","5476","0","58.89","28.73"
"66","000","00","030","0017","1450","843","428","415","25","868","1424","0","60.96","30.06"
"66","000","00","030","0017","1451","780","388","392","31","811","1389","0","58.39","27.93"
"66","000","00","030","0017","1452","742","387","355","47","789","1257","0","62.77","30.79"
"66","000","00","030","0017","1453","749","370","379","8","757","1406","0","53.84","26.32"
"66","000","00","030","0018","0000","1949","1015","934","92","2041","3320","0","61.48","30.57"
"66","000","00","030","0018","1457","627","315","312","23","650","1109","0","58.61","28.40"
"66","000","00","030","0018","1458","687","363","324","50","737","1147","0","64.25","31.65"
"66","000","00","030","0018","1459","635","337","298","19","654","1064","0","61.47","31.67"
"66","000","00","030","0019","0000","3455","1720","1735","128","3583","7160","0","50.04","24.02"
"66","000","00","030","0019","1460","807","418","389","28","835","1404","0","59.47","29.77"
"66","000","00","030","0019","1461","723","358","365","18","741","1900","0","39.00","18.84"
"66","000","00","030","0019","1462","649","325","324","34","683","1296","0","52.70","25.08"
"66","000","00","030","0019","1463","619","301","318","25","644","1351","0","47.67","22.28"
"66","000","00","030","0019","1464","657","318","339","23","680","1209","0","56.24","26.30"
"66","000","00","030","0020","0000","2448","1248","1200","113","2561","4502","0","56.89","27.72"
"66","000","00","030","0020","1471","615","298","317","33","648","1154","0","56.15","25.82"
"66","000","00","030","0020","1472","663","338","325","19","682","1235","0","55.22","27.37"
"66","000","00","030","0020","1473","597","315","282","31","628","1040","0","60.38","30.29"
"66","000","00","030","0020","1474","573","297","276","30","603","1073","0","56.20","27.68"
"66","000","00","030","0021","0000","3578","1752","1826","116","3694","6536","0","56.52","26.81"
"66","000","00","030","0021","1483","687","344","343","14","701","1390","0","50.43","24.75"
"66","000","00","030","0021","1484","696","331","365","27","723","1318","0","54.86","25.11"
"66","000","00","030","0021","1485","703","358","345","31","734","1315","0","55.82","27.22"
"66","000","00","030","0021","1486","803","389","414","26","829","1335","0","62.10","29.14"
"66","000","00","030","0021","1487","689","330","359","18","707","1178","0","60.02","28.01"
"66","000","00","030","0022","0000","3025","1572","1453","98","3123","5260","0","59.37","29.89"
"66","000","00","030","0022","1497","760","418","342","42","802","1228","0","65.31","34.04"
"66","000","00","030","0022","1498","807","413","394","23","830","1338","0","62.03","30.87"
"66","000","00","030","0022","1499","731","378","353","18","749","1334","0","56.15","28.34"
"66","000","00","030","0022","1500","727","363","364","15","742","1360","0","54.56","26.69"
"66","000","00","040","0000","0000","50452","26104","24348","1896","52348","90252","111620","58.00","28.92"
"66","000","00","040","0001","0000","881","472","409","35","916","1595","0","57.43","29.59"
"66","000","00","040","0001","1290","416","224","192","16","432","741","0","58.30","30.23"
"66","000","00","040","0001","1291","465","248","217","19","484","854","0","56.67","29.04"
"66","000","00","040","0002","0000","720","319","401","30","750","1279","0","58.64","24.94"
"66","000","00","040","0002","1289","720","319","401","30","750","1279","0","58.64","24.94"
"66","000","00","040","0003","0000","891","481","410","17","908","2253","0","40.30","21.35"
"66","000","00","040","0003","1287","449","239","210","10","459","1474","0","31.14","16.21"
"66","000","00","040","0003","1288","442","242","200","7","449","779","0","57.64","31.07"
"66","000","00","040","0004","0000","1228","609","619","37","1265","2122","0","59.61","28.70"
"66","000","00","040","0004","1295","640","328","312","16","656","1094","0","59.96","29.98"
"66","000","00","040","0004","1296","588","281","307","21","609","1028","0","59.24","27.33"
"66","000","00","040","0005","0000","705","349","356","39","744","1280","0","58.13","27.27"
"66","000","00","040","0005","1292","705","349","356","39","744","1280","0","58.13","27.27"
"66","000","00","040","0006","0000","962","471","491","25","987","1722","0","57.32","27.35"
"66","000","00","040","0006","1293","515","245","270","15","530","918","0","57.73","26.69"
"66","000","00","040","0006","1294","447","226","221","10","457","804","0","56.84","28.11"
"66","000","00","040","0007","0000","2687","1424","1263","108","2795","4548","0","61.46","31.31"
"66","000","00","040","0007","1297","575","298","277","23","598","991","0","60.34","30.07"
"66","000","00","040","0007","1298","674","357","317","23","697","1117","0","62.40","31.96"
"66","000","00","040","0007","1299","683","363","320","35","718","1171","0","61.32","31.00"
"66","000","00","040","0007","1300","755","406","349","27","782","1269","0","61.62","31.99"
"66","000","00","040","0008","0000","2250","1157","1093","67","2317","3697","0","62.67","31.30"
"66","000","00","040","0008","1301","758","378","380","14","772","1202","0","64.23","31.45"
"66","000","00","040","0008","1302","753","393","360","19","772","1249","0","61.81","31.47"
"66","000","00","040","0008","1303","739","386","353","34","773","1246","0","62.04","30.98"
"66","000","00","040","0009","0000","3008","1636","1372","141","3149","5355","0","58.80","30.55"
"66","000","00","040","0009","1304","690","374","316","20","710","1280","0","55.47","29.22"
"66","000","00","040","0009","1305","782","429","353","37","819","1307","0","62.66","32.82"
"66","000","00","040","0009","1306","685","377","308","30","715","1388","0","51.51","27.16"
"66","000","00","040","0009","1307","851","456","395","54","905","1380","0","65.58","33.04"
"66","000","00","040","0010","0000","1275","709","566","70","1345","2191","0","61.39","32.36"
"66","000","00","040","0010","1327","739","399","340","49","788","1226","0","64.27","32.54"
"66","000","00","040","0010","1328","536","310","226","21","557","965","0","57.72","32.12"
"66","000","00","040","0011","0000","1713","884","829","67","1780","3279","0","54.28","26.96"
"66","000","00","040","0011","1324","537","272","265","23","560","960","0","58.33","28.33"
"66","000","00","040","0011","1325","727","368","359","25","752","1381","0","54.45","26.65"
"66","000","00","040","0011","1326","449","244","205","19","468","938","0","49.89","26.01"
"66","000","00","040","0012","0000","1805","977","828","73","1878","3254","0","57.71","30.02"
"66","000","00","040","0012","1329","590","329","261","27","617","1024","0","60.25","32.13"
"66","000","00","040","0012","1330","633","323","310","20","653","1103","0","59.20","29.28"
"66","000","00","040","0012","1331","582","325","257","26","608","1127","0","53.95","28.84"
"66","000","00","040","0013","0000","1497","796","701","55","1552","2666","0","58.21","29.86"
"66","000","00","040","0013","1308","704","358","346","28","732","1248","0","58.65","28.69"
"66","000","00","040","0013","1309","793","438","355","27","820","1418","0","57.83","30.89"
"66","000","00","040","0014","0000","3468","1756","1712","105","3573","6111","0","58.47","28.74"
"66","000","00","040","0014","1310","698","393","305","23","721","1249","0","57.73","31.47"
"66","000","00","040","0014","1311","754","356","398","29","783","1249","0","62.69","28.50"
"66","000","00","040","0014","1312","711","379","332","22","733","1206","0","60.78","31.43"
"66","000","00","040","0014","1313","726","364","362","15","741","1259","0","58.86","28.91"
"66","000","00","040","0014","1314","579","264","315","16","595","1148","0","51.83","23.00"
"66","000","00","040","0015","0000","2850","1485","1365","101","2951","5368","0","54.97","27.66"
"66","000","00","040","0015","1334","670","347","323","28","698","1360","0","51.32","25.51"
"66","000","00","040","0015","1335","733","379","354","26","759","1343","0","56.52","28.22"
"66","000","00","040","0015","1336","722","375","347","22","744","1305","0","57.01","28.74"
"66","000","00","040","0015","1337","725","384","341","25","750","1360","0","55.15","28.24"
"66","000","00","040","0016","0000","2841","1441","1400","110","2951","5397","0","54.68","26.70"
"66","000","00","040","0016","1355","573","246","327","19","592","1048","0","56.49","23.47"
"66","000","00","040","0016","1356","547","286","261","7","554","1055","0","52.51","27.11"
"66","000","00","040","0016","1357","568","285","283","31","599","1130","0","53.01","25.22"
"66","000","00","040","0016","1358","574","317","257","29","603","1031","0","58.49","30.75"
"66","000","00","040","0016","1359","579","307","272","24","603","1133","0","53.22","27.10"
"66","000","00","040","0017","0000","3629","1807","1822","117","3746","6045","0","61.97","29.89"
"66","000","00","040","0017","1346","629","339","290","27","656","1123","0","58.41","30.19"
"66","000","00","040","0017","1347","700","378","322","25","725","1127","0","64.33","33.54"
"66","000","00","040","0017","1348","738","328","410","18","756","1206","0","62.69","27.20"
"66","000","00","040","0017","1349","729","368","361","27","756","1218","0","62.07","30.21"
"66","000","00","040","0017","1350","833","394","439","20","853","1371","0","62.22","28.74"
"66","000","00","040","0018","0000","2920","1536","1384","95","3015","5334","0","56.52","28.80"
"66","000","00","040","0018","1315","462","221","241","15","477","850","0","56.12","26.00"
"66","000","00","040","0018","1316","553","299","254","23","576","989","0","58.24","30.23"
"66","000","00","040","0018","1317","643","349","294","21","664","1193","0","55.66","29.25"
"66","000","00","040","0018","1318","658","364","294","19","677","1186","0","57.08","30.69"
"66","000","00","040","0018","1319","604","303","301","17","621","1116","0","55.65","27.15"
"66","000","00","040","0019","0000","2998","1539","1459","119","3117","5315","0","58.65","28.96"
"66","000","00","040","0019","1360","710","393","317","31","741","1369","0","54.13","28.71"
"66","000","00","040","0019","1361","751","413","338","35","786","1242","0","63.29","33.25"
"66","000","00","040","0019","1362","741","381","360","19","760","1340","0","56.72","28.43"
"66","000","00","040","0019","1363","796","352","444","34","830","1364","0","60.85","25.81"
"66","000","00","040","0020","0000","1486","839","647","85","1571","2607","0","60.26","32.18"
"66","000","00","040","0020","1341","785","429","356","46","831","1337","0","62.15","32.09"
"66","000","00","040","0020","1342","701","410","291","39","740","1270","0","58.27","32.28"
"66","000","00","040","0021","0000","1983","1112","871","73","2056","3355","0","61.28","33.14"
"66","000","00","040","0021","1338","639","345","294","23","662","1095","0","60.46","31.51"
"66","000","00","040","0021","1339","698","412","286","26","724","1177","0","61.51","35.00"
"66","000","00","040","0021","1340","646","355","291","24","670","1083","0","61.87","32.78"
"66","000","00","040","0022","0000","2494","1221","1273","82","2576","4734","0","54.41","25.79"
"66","000","00","040","0022","1351","611","303","308","13","624","1177","0","53.02","25.74"
"66","000","00","040","0022","1352","643","345","298","16","659","1169","0","56.37","29.51"
"66","000","00","040","0022","1353","612","305","307","26","638","1196","0","53.34","25.50"
"66","000","00","040","0022","1354","628","268","360","27","655","1192","0","54.95","22.48"
"66","000","00","040","0023","0000","2295","1123","1172","107","2402","4038","0","59.48","27.81"
"66","000","00","040","0023","1343","767","394","373","40","807","1356","0","59.51","29.06"
"66","000","00","040","0023","1344","722","360","362","45","767","1301","0","58.95","27.67"
"66","000","00","040","0023","1345","806","369","437","22","828","1381","0","59.96","26.72"
"66","000","00","040","0024","0000","1512","773","739","63","1575","2580","0","61.05","29.96"
"66","000","00","040","0024","1332","725","368","357","34","759","1222","0","62.11","30.11"
"66","000","00","040","0024","1333","787","405","382","29","816","1358","0","60.09","29.82"
"66","000","00","040","0025","0000","2354","1188","1166","75","2429","4127","0","58.86","28.79"
"66","000","00","040","0025","1320","625","276","349","15","640","1087","0","58.88","25.39"
"66","000","00","040","0025","1321","544","279","265","17","561","1032","0","54.36","27.03"
"66","000","00","040","0025","1322","601","322","279","26","627","1021","0","61.41","31.54"
"66","000","00","040","0025","1323","584","311","273","17","601","987","0","60.89","31.51"
"66","000","00","050","0000","0000","64485","32172","32313","2806","67291","119179","142250","56.46","26.99"
"66","000","00","050","0001","0000","1058","576","482","55","1113","1939","0","57.40","29.71"
"66","000","00","050","0001","1178","541","307","234","29","570","1018","0","55.99","30.16"
"66","000","00","050","0001","1179","517","269","248","26","543","921","0","58.96","29.21"
"66","000","00","050","0002","0000","1757","766","991","85","1842","3106","0","59.30","24.66"
"66","000","00","050","0002","1180","487","268","219","38","525","903","0","58.14","29.68"
"66","000","00","050","0002","1181","486","244","242","19","505","897","0","56.30","27.20"
"66","000","00","050","0002","1182","784","254","530","28","812","1306","0","62.17","19.45"
"66","000","00","050","0003","0000","675","383","292","33","708","1277","0","55.44","29.99"
"66","000","00","050","0003","1185","675","383","292","33","708","1277","0","55.44","29.99"
"66","000","00","050","0004","0000","727","335","392","37","764","1375","0","55.56","24.36"
"66","000","00","050","0004","1190","390","172","218","24","414","670","0","61.79","25.67"
"66","000","00","050","0004","1191","337","163","174","13","350","705","0","49.65","23.12"
"66","000","00","050","0005","0000","808","398","410","41","849","1557","0","54.53","25.56"
"66","000","00","050","0005","1188","367","189","178","19","386","639","0","60.41","29.58"
"66","000","00","050","0005","1189","441","209","232","22","463","918","0","50.44","22.77"
"66","000","00","050","0006","0000","1422","486","936","79","1501","2361","0","63.57","20.58"
"66","000","00","050","0006","1192","801","222","579","51","852","1283","0","66.41","17.30"
"66","000","00","050","0006","1193","621","264","357","28","649","1078","0","60.20","24.49"
"66","000","00","050","0007","0000","1759","883","876","96","1855","2967","0","62.52","29.76"
"66","000","00","050","0007","1194","968","512","456","54","1022","1620","0","63.09","31.60"
"66","000","00","050","0007","1195","791","371","420","42","833","1347","0","61.84","27.54"
"66","000","00","050","0008","0000","3195","1594","1601","163","3358","5444","0","61.68","29.28"
"66","000","00","050","0008","1196","847","438","409","42","889","1298","0","68.49","33.74"
"66","000","00","050","0008","1197","631","321","310","24","655","992","0","66.03","32.36"
"66","000","00","050","0008","1198","945","476","469","58","1003","1629","0","61.57","29.22"
"66","000","00","050","0008","1199","772","359","413","39","811","1525","0","53.18","23.54"
"66","000","00","050","0009","0000","1721","793","928","61","1782","3103","0","57.43","25.56"
"66","000","00","050","0009","1203","539","271","268","24","563","1031","0","54.61","26.29"
"66","000","00","050","0009","1204","602","274","328","19","621","1061","0","58.53","25.82"
"66","000","00","050","0009","1205","580","248","332","18","598","1011","0","59.15","24.53"
"66","000","00","050","0010","0000","1298","595","703","42","1340","2377","0","56.37","25.03"
"66","000","00","050","0010","1209","636","281","355","20","656","1156","0","56.75","24.31"
"66","000","00","050","0010","1210","662","314","348","22","684","1221","0","56.02","25.72"
"66","000","00","050","0011","0000","2171","1107","1064","95","2266","4070","0","55.68","27.20"
"66","000","00","050","0011","1211","716","381","335","39","755","1366","0","55.27","27.89"
"66","000","00","050","0011","1212","728","349","379","24","752","1340","0","56.12","26.04"
"66","000","00","050","0011","1213","727","377","350","32","759","1364","0","55.65","27.64"
"66","000","00","050","0012","0000","1158","591","567","55","1213","2125","0","57.08","27.81"
"66","000","00","050","0012","1214","582","300","282","42","624","1123","0","55.57","26.71"
"66","000","00","050","0012","1215","576","291","285","13","589","1002","0","58.78","29.04"
"66","000","00","050","0013","0000","2780","1429","1351","110","2890","5213","0","55.44","27.41"
"66","000","00","050","0013","1216","598","297","301","29","627","1128","0","55.59","26.33"
"66","000","00","050","0013","1217","620","327","293","20","640","1182","0","54.15","27.66"
"66","000","00","050","0013","1218","561","265","296","20","581","997","0","58.27","26.58"
"66","000","00","050","0013","1219","492","256","236","13","505","967","0","52.22","26.47"
"66","000","00","050","0013","1220","509","284","225","28","537","939","0","57.19","30.24"
"66","000","00","050","0014","0000","2071","1048","1023","81","2152","3937","0","54.66","26.62"
"66","000","00","050","0014","1221","595","302","293","18","613","1193","0","51.38","25.31"
"66","000","00","050","0014","1222","776","410","366","35","811","1399","0","57.97","29.31"
"66","000","00","050","0014","1223","700","336","364","28","728","1345","0","54.13","24.98"
"66","000","00","050","0015","0000","1919","918","1001","73","1992","4839","0","41.17","18.97"
"66","000","00","050","0015","1227","518","243","275","12","530","1981","0","26.75","12.27"
"66","000","00","050","0015","1228","741","349","392","38","779","1476","0","52.78","23.64"
"66","000","00","050","0015","1229","660","326","334","23","683","1382","0","49.42","23.59"
"66","000","00","050","0016","0000","2243","1186","1057","100","2343","4080","0","57.43","29.07"
"66","000","00","050","0016","1244","709","391","318","38","747","1224","0","61.03","31.94"
"66","000","00","050","0016","1245","726","381","345","44","770","1310","0","58.78","29.08"
"66","000","00","050","0016","1246","808","414","394","18","826","1546","0","53.43","26.78"
"66","000","00","050","0017","0000","1950","965","985","73","2023","3426","0","59.05","28.17"
"66","000","00","050","0017","1247","813","390","423","43","856","1416","0","60.45","27.54"
"66","000","00","050","0017","1248","509","260","249","18","527","908","0","58.04","28.63"
"66","000","00","050","0017","1249","628","315","313","12","640","1102","0","58.08","28.58"
"66","000","00","050","0018","0000","2722","1408","1314","85","2807","4792","0","58.58","29.38"
"66","000","00","050","0018","1250","789","430","359","14","803","1395","0","57.56","30.82"
"66","000","00","050","0018","1251","604","302","302","23","627","1076","0","58.27","28.07"
"66","000","00","050","0018","1252","670","373","297","22","692","1158","0","59.76","32.21"
"66","000","00","050","0018","1253","659","303","356","26","685","1163","0","58.90","26.05"
"66","000","00","050","0019","0000","1445","763","682","71","1516","2466","0","61.48","30.94"
"66","000","00","050","0019","1272","741","410","331","40","781","1295","0","60.31","31.66"
"66","000","00","050","0019","1273","704","353","351","31","735","1171","0","62.77","30.15"
"66","000","00","050","0020","0000","2551","1233","1318","103","2654","4701","0","56.46","26.23"
"66","000","00","050","0020","1206","844","446","398","45","889","1519","0","58.53","29.36"
"66","000","00","050","0020","1207","952","444","508","35","987","1867","0","52.87","23.78"
"66","000","00","050","0020","1208","755","343","412","23","778","1315","0","59.16","26.08"
"66","000","00","050","0021","0000","3347","1812","1535","151","3498","6212","0","56.31","29.17"
"66","000","00","050","0021","1254","688","348","340","45","733","1265","0","57.94","27.51"
"66","000","00","050","0021","1255","504","270","234","13","517","994","0","52.01","27.16"
"66","000","00","050","0021","1256","666","367","299","34","700","1217","0","57.52","30.16"
"66","000","00","050","0021","1257","689","390","299","24","713","1210","0","58.93","32.23"
"66","000","00","050","0021","1258","800","437","363","35","835","1526","0","54.72","28.64"
"66","000","00","050","0022","0000","2691","1336","1355","107","2798","4989","0","56.08","26.78"
"66","000","00","050","0022","1259","702","360","342","17","719","1314","0","54.72","27.40"
"66","000","00","050","0022","1260","701","362","339","45","746","1260","0","59.21","28.73"
"66","000","00","050","0022","1261","661","316","345","26","687","1225","0","56.08","25.80"
"66","000","00","050","0022","1262","627","298","329","19","646","1190","0","54.29","25.04"
"66","000","00","050","0023","0000","3059","1561","1498","110","3169","5713","0","55.47","27.32"
"66","000","00","050","0023","1265","736","362","374","30","766","1380","0","55.51","26.23"
"66","000","00","050","0023","1266","777","401","376","38","815","1449","0","56.25","27.67"
"66","000","00","050","0023","1267","801","436","365","15","816","1394","0","58.54","31.28"
"66","000","00","050","0023","1268","745","362","383","27","772","1490","0","51.81","24.30"
"66","000","00","050","0024","0000","1873","868","1005","61","1934","3528","0","54.82","24.60"
"66","000","00","050","0024","1239","667","328","339","24","691","1172","0","58.96","27.99"
"66","000","00","050","0024","1240","604","250","354","15","619","1197","0","51.71","20.89"
"66","000","00","050","0024","1241","602","290","312","22","624","1159","0","53.84","25.02"
"66","000","00","050","0025","0000","1892","852","1040","59","1951","3606","0","54.10","23.63"
"66","000","00","050","0025","1233","653","292","361","19","672","1368","0","49.12","21.35"
"66","000","00","050","0025","1234","608","297","311","21","629","1112","0","56.56","26.71"
"66","000","00","050","0025","1235","631","263","368","19","650","1126","0","57.73","23.36"
"66","000","00","050","0026","0000","669","415","254","40","709","1212","0","58.50","34.24"
"66","000","00","050","0026","1176","669","415","254","40","709","1212","0","58.50","34.24"
"66","000","00","050","0027","0000","859","514","345","47","906","1665","0","54.41","30.87"
"66","000","00","050","0027","1177","859","514","345","47","906","1665","0","54.41","30.87"
"66","000","00","050","0028","0000","1197","689","508","103","1300","2057","0","63.20","33.50"
"66","000","00","050","0028","1183","698","396","302","50","748","1225","0","61.06","32.33"
"66","000","00","050","0028","1184","499","293","206","53","552","832","0","66.35","35.22"
"66","000","00","050","0029","0000","915","516","399","46","961","1766","0","54.42","29.22"
"66","000","00","050","0029","1186","481","254","227","28","509","961","0","52.97","26.43"
"66","000","00","050","0029","1187","434","262","172","18","452","805","0","56.15","32.55"
"66","000","00","050","0030","0000","1807","878","929","111","1918","3089","0","62.09","28.42"
"66","000","00","050","0030","1200","547","285","262","39","586","1022","0","57.34","27.89"
"66","000","00","050","0030","1201","649","301","348","38","687","1050","0","65.43","28.67"
"66","000","00","050","0030","1202","611","292","319","34","645","1017","0","63.42","28.71"
"66","000","00","050","0031","0000","1666","808","858","51","1717","3263","0","52.62","24.76"
"66","000","00","050","0031","1224","560","264","296","17","577","1107","0","52.12","23.85"
"66","000","00","050","0031","1225","564","269","295","22","586","1050","0","55.81","25.62"
"66","000","00","050","0031","1226","542","275","267","12","554","1106","0","50.09","24.86"
"66","000","00","050","0032","0000","2090","999","1091","113","2203","4064","0","54.21","24.58"
"66","000","00","050","0032","1236","674","306","368","26","700","1239","0","56.50","24.70"
"66","000","00","050","0032","1237","700","341","359","52","752","1439","0","52.26","23.70"
"66","000","00","050","0032","1238","716","352","364","35","751","1386","0","54.18","25.40"
"66","000","00","050","0033","0000","1393","704","689","71","1464","2527","0","57.93","27.86"
"66","000","00","050","0033","1263","718","339","379","38","756","1288","0","58.70","26.32"
"66","000","00","050","0033","1264","675","365","310","33","708","1239","0","57.14","29.46"
"66","000","00","050","0034","0000","1956","896","1060","69","2025","3572","0","56.69","25.08"
"66","000","00","050","0034","1269","639","302","337","28","667","1137","0","58.66","26.56"
"66","000","00","050","0034","1270","661","292","369","20","681","1217","0","55.96","23.99"
"66","000","00","050","0034","1271","656","302","354","21","677","1218","0","55.58","24.79"
"66","000","00","050","0035","0000","1605","822","783","54","1659","3111","0","53.33","26.42"
"66","000","00","050","0035","1242","788","385","403","23","811","1580","0","51.33","24.37"
"66","000","00","050","0035","1243","817","437","380","31","848","1531","0","55.39","28.54"
"66","000","00","050","0036","0000","2036","1045","991","75","2111","3650","0","57.84","28.63"
"66","000","00","050","0036","1230","790","419","371","15","805","1279","0","62.94","32.76"
"66","000","00","050","0036","1231","692","342","350","46","738","1275","0","57.88","26.82"
"66","000","00","050","0036","1232","554","284","270","14","568","1096","0","51.82","25.91"
"66","000","00","060","0000","0000","96659","48180","48479","3748","100407","183718","230696","54.65","26.22"
"66","000","00","060","0001","0000","2808","1453","1355","95","2903","5174","0","56.11","28.08"
"66","000","00","060","0001","0732","717","385","332","26","743","1377","0","53.96","27.96"
"66","000","00","060","0001","0733","709","362","347","31","740","1241","0","59.63","29.17"
"66","000","00","060","0001","0734","708","375","333","28","736","1238","0","59.45","30.29"
"66","000","00","060","0001","0735","674","331","343","10","684","1318","0","51.90","25.11"
"66","000","00","060","0002","0000","3132","1591","1541","125","3257","5893","0","55.27","27.00"
"66","000","00","060","0002","0743","650","347","303","48","698","1143","0","61.07","30.36"
"66","000","00","060","0002","0744","621","329","292","24","645","1168","0","55.22","28.17"
"66","000","00","060","0002","0745","550","286","264","11","561","1135","0","49.43","25.20"
"66","000","00","060","0002","0746","576","281","295","14","590","1105","0","53.39","25.43"
"66","000","00","060","0002","0747","735","348","387","28","763","1342","0","56.86","25.93"
"66","000","00","060","0003","0000","2693","1404","1289","107","2800","6403","0","43.73","21.93"
"66","000","00","060","0003","0748","744","370","374","33","777","1523","0","51.02","24.29"
"66","000","00","060","0003","0749","670","352","318","23","693","1646","0","42.10","21.39"
"66","000","00","060","0003","0750","589","301","288","30","619","2017","0","30.69","14.92"
"66","000","00","060","0003","0751","690","381","309","21","711","1217","0","58.42","31.31"
"66","000","00","060","0004","0000","573","324","249","42","615","930","0","66.13","34.84"
"66","000","00","060","0004","0752","573","324","249","42","615","930","0","66.13","34.84"
"66","000","00","060","0005","0000","7212","3530","3682","197","7409","14278","0","51.89","24.72"
"66","000","00","060","0005","0753","702","315","387","36","738","1308","0","56.42","24.08"
"66","000","00","060","0005","0754","591","288","303","18","609","1268","0","48.03","22.71"
"66","000","00","060","0005","0755","631","307","324","19","650","1346","0","48.29","22.81"
"66","000","00","060","0005","0756","629","308","321","12","641","1303","0","49.19","23.64"
"66","000","00","060","0005","0757","616","287","329","18","634","1316","0","48.18","21.81"
"66","000","00","060","0005","0758","628","319","309","10","638","1322","0","48.26","24.13"
"66","000","00","060","0005","0759","639","309","330","12","651","1285","0","50.66","24.05"
"66","000","00","060","0005","0760","947","500","447","29","976","1605","0","60.81","31.15"
"66","000","00","060","0005","0761","596","294","302","13","609","1227","0","49.63","23.96"
"66","000","00","060","0005","0762","651","328","323","19","670","1184","0","56.59","27.70"
"66","000","00","060","0005","0763","582","275","307","11","593","1114","0","53.23","24.69"
"66","000","00","060","0006","0000","2571","1323","1248","86","2657","4962","0","53.55","26.66"
"66","000","00","060","0006","0764","689","354","335","36","725","1288","0","56.29","27.48"
"66","000","00","060","0006","0765","606","321","285","16","622","1197","0","51.96","26.82"
"66","000","00","060","0006","0766","600","299","301","18","618","1192","0","51.85","25.08"
"66","000","00","060","0006","0767","676","349","327","16","692","1285","0","53.85","27.16"
"66","000","00","060","0007","0000","2215","1084","1131","103","2318","4446","0","52.14","24.38"
"66","000","00","060","0007","0775","779","401","378","13","792","1548","0","51.16","25.90"
"66","000","00","060","0007","0776","660","311","349","40","700","1434","0","48.81","21.69"
"66","000","00","060","0007","0777","776","372","404","50","826","1464","0","56.42","25.41"
"66","000","00","060","0008","0000","1433","418","1015","85","1518","2509","0","60.50","16.66"
"66","000","00","060","0008","0782","712","217","495","36","748","1284","0","58.26","16.90"
"66","000","00","060","0008","0783","721","201","520","49","770","1225","0","62.86","16.41"
"66","000","00","060","0009","0000","2519","1282","1237","123","2642","4893","0","54.00","26.20"
"66","000","00","060","0009","0798","673","355","318","38","711","1286","0","55.29","27.60"
"66","000","00","060","0009","0799","599","293","306","34","633","1190","0","53.19","24.62"
"66","000","00","060","0009","0800","606","318","288","26","632","1304","0","48.47","24.39"
"66","000","00","060","0009","0801","641","316","325","25","666","1113","0","59.84","28.39"
"66","000","00","060","0010","0000","1537","817","720","74","1611","3052","0","52.79","26.77"
"66","000","00","060","0010","0784","485","256","229","23","508","1031","0","49.27","24.83"
"66","000","00","060","0010","0785","526","280","246","24","550","949","0","57.96","29.50"
"66","000","00","060","0010","0786","526","281","245","27","553","1072","0","51.59","26.21"
"66","000","00","060","0011","0000","2274","1274","1000","85","2359","3661","0","64.44","34.80"
"66","000","00","060","0011","0818","769","443","326","25","794","1201","0","66.11","36.89"
"66","000","00","060","0011","0819","796","460","336","42","838","1246","0","67.26","36.92"
"66","000","00","060","0011","0820","709","371","338","18","727","1214","0","59.88","30.56"
"66","000","00","060","0012","0000","1224","356","868","62","1286","2027","0","63.44","17.56"
"66","000","00","060","0012","0821","641","197","444","31","672","1027","0","65.43","19.18"
"66","000","00","060","0012","0822","583","159","424","31","614","1000","0","61.40","15.90"
"66","000","00","060","0013","0000","1622","760","862","102","1724","3133","0","55.03","24.26"
"66","000","00","060","0013","0823","504","262","242","38","542","996","0","54.42","26.31"
"66","000","00","060","0013","0824","527","262","265","36","563","1004","0","56.08","26.10"
"66","000","00","060","0013","0825","591","236","355","28","619","1133","0","54.63","20.83"
"66","000","00","060","0014","0000","2465","1200","1265","102","2567","4512","0","56.89","26.60"
"66","000","00","060","0014","0826","717","361","356","40","757","1197","0","63.24","30.16"
"66","000","00","060","0014","0827","602","271","331","37","639","1163","0","54.94","23.30"
"66","000","00","060","0014","0828","577","291","286","15","592","1073","0","55.17","27.12"
"66","000","00","060","0014","0829","569","277","292","10","579","1079","0","53.66","25.67"
"66","000","00","060","0015","0000","2541","1257","1284","134","2675","4819","0","55.51","26.08"
"66","000","00","060","0015","0830","594","324","270","33","627","1097","0","57.16","29.54"
"66","000","00","060","0015","0831","765","361","404","26","791","1373","0","57.61","26.29"
"66","000","00","060","0015","0832","546","270","276","47","593","1131","0","52.43","23.87"
"66","000","00","060","0015","0833","636","302","334","28","664","1218","0","54.52","24.79"
"66","000","00","060","0016","0000","1247","679","568","97","1344","2194","0","61.26","30.95"
"66","000","00","060","0016","0834","679","399","280","53","732","1187","0","61.67","33.61"
"66","000","00","060","0016","0835","568","280","288","44","612","1007","0","60.77","27.81"
"66","000","00","060","0017","0000","1778","851","927","77","1855","3276","0","56.62","25.98"
"66","000","00","060","0017","0836","600","265","335","11","611","1050","0","58.19","25.24"
"66","000","00","060","0017","0837","647","335","312","47","694","1172","0","59.22","28.58"
"66","000","00","060","0017","0838","531","251","280","19","550","1054","0","52.18","23.81"
"66","000","00","060","0018","0000","6182","3192","2990","261","6443","12322","0","52.29","25.90"
"66","000","00","060","0018","0839","858","494","364","72","930","1651","0","56.33","29.92"
"66","000","00","060","0018","0840","751","351","400","34","785","1365","0","57.51","25.71"
"66","000","00","060","0018","0841","741","376","365","33","774","1272","0","60.85","29.56"
"66","000","00","060","0018","0842","642","321","321","21","663","1350","0","49.11","23.78"
"66","000","00","060","0018","0843","638","343","295","17","655","1299","0","50.42","26.40"
"66","000","00","060","0018","0844","665","377","288","12","677","1376","0","49.20","27.40"
"66","000","00","060","0018","0845","603","274","329","29","632","1297","0","48.73","21.13"
"66","000","00","060","0018","0846","613","309","304","34","647","1354","0","47.78","22.82"
"66","000","00","060","0018","0847","671","347","324","9","680","1358","0","50.07","25.55"
"66","000","00","060","0019","0000","1639","837","802","63","1702","2894","0","58.81","28.92"
"66","000","00","060","0019","0848","827","443","384","31","858","1447","0","59.30","30.62"
"66","000","00","060","0019","0849","812","394","418","32","844","1447","0","58.33","27.23"
"66","000","00","060","0020","0000","2589","1397","1192","121","2710","4474","0","60.57","31.22"
"66","000","00","060","0020","0874","672","332","340","35","707","1188","0","59.51","27.95"
"66","000","00","060","0020","0875","664","409","255","29","693","1123","0","61.71","36.42"
"66","000","00","060","0020","0876","614","321","293","33","647","1067","0","60.64","30.08"
"66","000","00","060","0020","0877","639","335","304","24","663","1096","0","60.49","30.57"
"66","000","00","060","0021","0000","3262","1687","1575","132","3394","5924","0","57.29","28.48"
"66","000","00","060","0021","0802","693","373","320","31","724","1379","0","52.50","27.05"
"66","000","00","060","0021","0803","784","422","362","32","816","1323","0","61.68","31.90"
"66","000","00","060","0021","0804","788","401","387","27","815","1400","0","58.21","28.64"
"66","000","00","060","0021","0805","478","230","248","20","498","881","0","56.53","26.11"
"66","000","00","060","0021","0806","519","261","258","22","541","941","0","57.49","27.74"
"66","000","00","060","0022","0000","1964","979","985","74","2038","3503","0","58.18","27.95"
"66","000","00","060","0022","0807","666","315","351","24","690","1198","0","57.60","26.29"
"66","000","00","060","0022","0808","679","338","341","25","704","1105","0","63.71","30.59"
"66","000","00","060","0022","0809","619","326","293","25","644","1200","0","53.67","27.17"
"66","000","00","060","0023","0000","3348","1638","1710","122","3470","6340","0","54.73","25.84"
"66","000","00","060","0023","0813","621","304","317","23","644","1189","0","54.16","25.57"
"66","000","00","060","0023","0814","665","329","336","23","688","1204","0","57.14","27.33"
"66","000","00","060","0023","0815","645","332","313","28","673","1237","0","54.41","26.84"
"66","000","00","060","0023","0816","753","354","399","24","777","1370","0","56.72","25.84"
"66","000","00","060","0023","0817","664","319","345","24","688","1340","0","51.34","23.81"
"66","000","00","060","0024","0000","2212","994","1218","125","2337","4592","0","50.89","21.65"
"66","000","00","060","0024","0739","559","243","316","37","596","1172","0","50.85","20.73"
"66","000","00","060","0024","0740","609","234","375","45","654","1156","0","56.57","20.24"
"66","000","00","060","0024","0741","486","242","244","17","503","1114","0","45.15","21.72"
"66","000","00","060","0024","0742","558","275","283","26","584","1150","0","50.78","23.91"
"66","000","00","060","0025","0000","2103","1066","1037","72","2175","3934","0","55.29","27.10"
"66","000","00","060","0025","0790","670","344","326","22","692","1282","0","53.98","26.83"
"66","000","00","060","0025","0791","742","365","377","23","765","1343","0","56.96","27.18"
"66","000","00","060","0025","0792","691","357","334","27","718","1309","0","54.85","27.27"
"66","000","00","060","0026","0000","2149","1060","1089","74","2223","4256","0","52.23","24.91"
"66","000","00","060","0026","0736","710","354","356","18","728","1417","0","51.38","24.98"
"66","000","00","060","0026","0737","678","340","338","32","710","1419","0","50.04","23.96"
"66","000","00","060","0026","0738","761","366","395","24","785","1420","0","55.28","25.77"
"66","000","00","060","0027","0000","2541","1239","1302","75","2616","5050","0","51.80","24.53"
"66","000","00","060","0027","0768","697","345","352","28","725","1350","0","53.70","25.56"
"66","000","00","060","0027","0769","607","286","321","16","623","1243","0","50.12","23.01"
"66","000","00","060","0027","0770","656","319","337","22","678","1214","0","55.85","26.28"
"66","000","00","060","0027","0771","581","289","292","9","590","1243","0","47.47","23.25"
"66","000","00","060","0028","0000","2017","971","1046","73","2090","3908","0","53.48","24.85"
"66","000","00","060","0028","0772","666","330","336","36","702","1311","0","53.55","25.17"
"66","000","00","060","0028","0773","641","303","338","22","663","1293","0","51.28","23.43"
"66","000","00","060","0028","0774","710","338","372","15","725","1304","0","55.60","25.92"
"66","000","00","060","0029","0000","2828","1355","1473","89","2917","5095","0","57.25","26.59"
"66","000","00","060","0029","0778","848","406","442","50","898","1396","0","64.33","29.08"
"66","000","00","060","0029","0779","669","315","354","10","679","1164","0","58.33","27.06"
"66","000","00","060","0029","0780","719","325","394","12","731","1265","0","57.79","25.69"
"66","000","00","060","0029","0781","592","309","283","17","609","1270","0","47.95","24.33"
"66","000","00","060","0030","0000","1902","1007","895","66","1968","3405","0","57.80","29.57"
"66","000","00","060","0030","0787","692","372","320","22","714","1141","0","62.58","32.60"
"66","000","00","060","0030","0788","639","335","304","14","653","1158","0","56.39","28.93"
"66","000","00","060","0030","0789","571","300","271","30","601","1106","0","54.34","27.12"
"66","000","00","060","0031","0000","3401","1733","1668","117","3518","6762","0","52.03","25.63"
"66","000","00","060","0031","0793","679","359","320","40","719","1417","0","50.74","25.34"
"66","000","00","060","0031","0794","685","350","335","15","700","1363","0","51.36","25.68"
"66","000","00","060","0031","0795","696","383","313","23","719","1334","0","53.90","28.71"
"66","000","00","060","0031","0796","727","367","360","25","752","1337","0","56.25","27.45"
"66","000","00","060","0031","0797","614","274","340","14","628","1311","0","47.90","20.90"
"66","000","00","060","0032","0000","2482","1262","1220","96","2578","4154","0","62.06","30.38"
"66","000","00","060","0032","0810","822","375","447","40","862","1388","0","62.10","27.02"
"66","000","00","060","0032","0811","820","434","386","32","852","1375","0","61.96","31.56"
"66","000","00","060","0032","0812","840","453","387","24","864","1391","0","62.11","32.57"
"66","000","00","060","0033","0000","2276","1275","1001","103","2379","4133","0","57.56","30.85"
"66","000","00","060","0033","0864","781","449","332","23","804","1465","0","54.88","30.65"
"66","000","00","060","0033","0865","761","426","335","37","798","1351","0","59.07","31.53"
"66","000","00","060","0033","0866","734","400","334","43","777","1317","0","59.00","30.37"
"66","000","00","060","0034","0000","1761","876","885","62","1823","3101","0","58.79","28.25"
"66","000","00","060","0034","0867","602","289","313","26","628","1097","0","57.25","26.34"
"66","000","00","060","0034","0868","574","279","295","19","593","1010","0","58.71","27.62"
"66","000","00","060","0034","0869","585","308","277","17","602","994","0","60.56","30.99"
"66","000","00","060","0035","0000","2644","1351","1293","64","2708","4615","0","58.68","29.27"
"66","000","00","060","0035","0870","616","306","310","17","633","1117","0","56.67","27.39"
"66","000","00","060","0035","0871","748","382","366","18","766","1266","0","60.51","30.17"
"66","000","00","060","0035","0872","627","325","302","12","639","1148","0","55.66","28.31"
"66","000","00","060","0035","0873","653","338","315","17","670","1084","0","61.81","31.18"
"66","000","00","060","0036","0000","1341","681","660","39","1380","3163","0","43.63","21.53"
"66","000","00","060","0036","0862","668","347","321","28","696","1645","0","42.31","21.09"
"66","000","00","060","0036","0863","673","334","339","11","684","1518","0","45.06","22.00"
"66","000","00","060","0037","0000","1319","629","690","44","1363","2885","0","47.24","21.80"
"66","000","00","060","0037","0860","676","312","364","18","694","1433","0","48.43","21.77"
"66","000","00","060","0037","0861","643","317","326","26","669","1452","0","46.07","21.83"
"66","000","00","060","0038","0000","3959","1939","2020","89","4048","7445","0","54.37","26.04"
"66","000","00","060","0038","0854","641","312","329","8","649","1271","0","51.06","24.55"
"66","000","00","060","0038","0855","689","315","374","7","696","1178","0","59.08","26.74"
"66","000","00","060","0038","0856","714","362","352","23","737","1389","0","53.06","26.06"
"66","000","00","060","0038","0857","696","374","322","14","710","1217","0","58.34","30.73"
"66","000","00","060","0038","0858","645","294","351","23","668","1191","0","56.09","24.69"
"66","000","00","060","0038","0859","574","282","292","14","588","1199","0","49.04","23.52"
"66","000","00","060","0039","0000","2896","1409","1487","91","2987","5601","0","53.33","25.16"
"66","000","00","060","0039","0850","763","376","387","27","790","1394","0","56.67","26.97"
"66","000","00","060","0039","0851","725","350","375","20","745","1345","0","55.39","26.02"
"66","000","00","060","0039","0852","708","371","337","23","731","1417","0","51.59","26.18"
"66","000","00","060","0039","0853","700","312","388","21","721","1445","0","49.90","21.59"
"66","000","00","070","0000","0000","75874","38182","37692","2808","78682","139203","176996","56.52","27.43"
"66","000","00","070","0001","0000","4507","2353","2154","160","4667","8196","0","56.94","28.71"
"66","000","00","070","0001","0878","651","340","311","15","666","1165","0","57.17","29.18"
"66","000","00","070","0001","0879","643","324","319","41","684","1236","0","55.34","26.21"
"66","000","00","070","0001","0880","575","348","227","40","615","1052","0","58.46","33.08"
"66","000","00","070","0001","0881","760","414","346","23","783","1293","0","60.56","32.02"
"66","000","00","070","0001","0882","668","311","357","15","683","1213","0","56.31","25.64"
"66","000","00","070","0001","0883","637","299","338","13","650","1161","0","55.99","25.75"
"66","000","00","070","0001","0884","573","317","256","13","586","1076","0","54.46","29.46"
"66","000","00","070","0002","0000","6395","3274","3121","213","6608","11014","0","60.00","29.73"
"66","000","00","070","0002","0885","805","419","386","43","848","1353","0","62.68","30.97"
"66","000","00","070","0002","0886","802","445","357","28","830","1331","0","62.36","33.43"
"66","000","00","070","0002","0887","822","397","425","35","857","1515","0","56.57","26.20"
"66","000","00","070","0002","0888","807","403","404","22","829","1404","0","59.05","28.70"
"66","000","00","070","0002","0889","751","404","347","19","770","1358","0","56.70","29.75"
"66","000","00","070","0002","0890","755","381","374","16","771","1296","0","59.49","29.40"
"66","000","00","070","0002","0891","830","424","406","28","858","1420","0","60.42","29.86"
"66","000","00","070","0002","0892","823","401","422","22","845","1337","0","63.20","29.99"
"66","000","00","070","0003","0000","3450","1756","1694","150","3600","5781","0","62.27","30.38"
"66","000","00","070","0003","0893","743","367","376","32","775","1184","0","65.46","31.00"
"66","000","00","070","0003","0894","920","518","402","52","972","1486","0","65.41","34.86"
"66","000","00","070","0003","0895","883","431","452","21","904","1554","0","58.17","27.73"
"66","000","00","070","0003","0896","904","440","464","45","949","1557","0","60.95","28.26"
"66","000","00","070","0004","0000","2317","1237","1080","165","2482","4144","0","59.89","29.85"
"66","000","00","070","0004","0897","763","404","359","55","818","1442","0","56.73","28.02"
"66","000","00","070","0004","0898","767","391","376","42","809","1306","0","61.94","29.94"
"66","000","00","070","0004","0899","787","442","345","68","855","1396","0","61.25","31.66"
"66","000","00","070","0005","0000","3326","1606","1720","173","3499","6364","0","54.98","25.24"
"66","000","00","070","0005","0902","655","332","323","40","695","1139","0","61.02","29.15"
"66","000","00","070","0005","0903","674","316","358","32","706","1216","0","58.06","25.99"
"66","000","00","070","0005","0904","690","352","338","30","720","1203","0","59.85","29.26"
"66","000","00","070","0005","0905","725","342","383","53","778","1378","0","56.46","24.82"
"66","000","00","070","0005","0906","582","264","318","18","600","1428","0","42.02","18.49"
"66","000","00","070","0006","0000","898","440","458","46","944","1740","0","54.25","25.29"
"66","000","00","070","0006","0907","898","440","458","46","944","1740","0","54.25","25.29"
"66","000","00","070","0007","0000","5665","2943","2722","184","5849","11081","0","52.78","26.56"
"66","000","00","070","0007","0908","690","365","325","29","719","1388","0","51.80","26.30"
"66","000","00","070","0007","0909","565","291","274","27","592","1194","0","49.58","24.37"
"66","000","00","070","0007","0910","540","285","255","26","566","1052","0","53.80","27.09"
"66","000","00","070","0007","0911","751","404","347","15","766","1544","0","49.61","26.17"
"66","000","00","070","0007","0912","747","366","381","22","769","1387","0","55.44","26.39"
"66","000","00","070","0007","0913","672","333","339","24","696","1267","0","54.93","26.28"
"66","000","00","070","0007","0914","795","406","389","25","820","1442","0","56.87","28.16"
"66","000","00","070","0007","0915","905","493","412","16","921","1807","0","50.97","27.28"
"66","000","00","070","0008","0000","1460","735","725","63","1523","2784","0","54.71","26.40"
"66","000","00","070","0008","0920","793","384","409","47","840","1387","0","60.56","27.69"
"66","000","00","070","0008","0921","667","351","316","16","683","1397","0","48.89","25.13"
"66","000","00","070","0009","0000","2826","1482","1344","128","2954","5052","0","58.47","29.33"
"66","000","00","070","0009","0922","643","342","301","39","682","1180","0","57.80","28.98"
"66","000","00","070","0009","0923","628","336","292","35","663","1172","0","56.57","28.67"
"66","000","00","070","0009","0924","758","403","355","28","786","1299","0","60.51","31.02"
"66","000","00","070","0009","0925","797","401","396","26","823","1401","0","58.74","28.62"
"66","000","00","070","0010","0000","3694","1846","1848","111","3805","7003","0","54.33","26.36"
"66","000","00","070","0010","0926","747","405","342","19","766","1269","0","60.36","31.91"
"66","000","00","070","0010","0927","723","357","366","18","741","1324","0","55.97","26.96"
"66","000","00","070","0010","0928","703","362","341","27","730","1348","0","54.15","26.85"
"66","000","00","070","0010","0929","806","378","428","17","823","1645","0","50.03","22.98"
"66","000","00","070","0010","0930","715","344","371","30","745","1417","0","52.58","24.28"
"66","000","00","070","0011","0000","2989","1484","1505","110","3099","5078","0","61.03","29.22"
"66","000","00","070","0011","0946","687","335","352","25","712","1132","0","62.90","29.59"
"66","000","00","070","0011","0947","758","376","382","31","789","1364","0","57.84","27.57"
"66","000","00","070","0011","0948","780","412","368","19","799","1328","0","60.17","31.02"
"66","000","00","070","0011","0949","764","361","403","35","799","1254","0","63.72","28.79"
"66","000","00","070","0012","0000","3482","1820","1662","118","3600","6054","0","59.46","30.06"
"66","000","00","070","0012","0960","854","448","406","18","872","1513","0","57.63","29.61"
"66","000","00","070","0012","0961","862","458","404","28","890","1472","0","60.46","31.11"
"66","000","00","070","0012","0962","911","437","474","37","948","1534","0","61.80","28.49"
"66","000","00","070","0012","0963","855","477","378","35","890","1535","0","57.98","31.07"
"66","000","00","070","0013","0000","2300","1010","1290","95","2395","3893","0","61.52","25.94"
"66","000","00","070","0013","0942","571","229","342","31","602","881","0","68.33","25.99"
"66","000","00","070","0013","0943","596","252","344","23","619","990","0","62.53","25.45"
"66","000","00","070","0013","0944","518","229","289","27","545","901","0","60.49","25.42"
"66","000","00","070","0013","0945","615","300","315","14","629","1121","0","56.11","26.76"
"66","000","00","070","0014","0000","811","459","352","76","887","1281","0","69.24","35.83"
"66","000","00","070","0014","0900","337","168","169","38","375","555","0","67.57","30.27"
"66","000","00","070","0014","0901","474","291","183","38","512","726","0","70.52","40.08"
"66","000","00","070","0015","0000","2693","1399","1294","82","2775","4728","0","58.69","29.59"
"66","000","00","070","0015","0974","717","373","344","21","738","1344","0","54.91","27.75"
"66","000","00","070","0015","0975","640","336","304","17","657","1083","0","60.66","31.02"
"66","000","00","070","0015","0976","685","371","314","18","703","1165","0","60.34","31.85"
"66","000","00","070","0015","0977","651","319","332","26","677","1136","0","59.60","28.08"
"66","000","00","070","0016","0000","1962","990","972","65","2027","3645","0","55.61","27.16"
"66","000","00","070","0016","0967","653","316","337","15","668","1166","0","57.29","27.10"
"66","000","00","070","0016","0968","726","389","337","30","756","1393","0","54.27","27.93"
"66","000","00","070","0016","0969","583","285","298","20","603","1086","0","55.52","26.24"
"66","000","00","070","0017","0000","2711","1335","1376","92","2803","4992","0","56.15","26.74"
"66","000","00","070","0017","0970","761","359","402","29","790","1436","0","55.01","25.00"
"66","000","00","070","0017","0971","818","396","422","21","839","1516","0","55.34","26.12"
"66","000","00","070","0017","0972","552","284","268","21","573","976","0","58.71","29.10"
"66","000","00","070","0017","0973","580","296","284","21","601","1064","0","56.48","27.82"
"66","000","00","070","0018","0000","2473","1259","1214","87","2560","5278","0","48.50","23.85"
"66","000","00","070","0018","0964","879","475","404","41","920","1563","0","58.86","30.39"
"66","000","00","070","0018","0965","854","415","439","13","867","2272","0","38.16","18.27"
"66","000","00","070","0018","0966","740","369","371","33","773","1443","0","53.57","25.57"
"66","000","00","070","0019","0000","1882","947","935","73","1955","3482","0","56.15","27.20"
"66","000","00","070","0019","0981","619","310","309","24","643","1065","0","60.38","29.11"
"66","000","00","070","0019","0982","638","324","314","26","664","1228","0","54.07","26.38"
"66","000","00","070","0019","0983","625","313","312","23","648","1189","0","54.50","26.32"
"66","000","00","070","0020","0000","2416","1239","1177","119","2535","4229","0","59.94","29.30"
"66","000","00","070","0020","0978","738","365","373","37","775","1254","0","61.80","29.11"
"66","000","00","070","0020","0979","833","438","395","42","875","1499","0","58.37","29.22"
"66","000","00","070","0020","0980","845","436","409","40","885","1476","0","59.96","29.54"
"66","000","00","070","0021","0000","3255","1638","1617","92","3347","6341","0","52.78","25.83"
"66","000","00","070","0021","0950","634","302","332","19","653","1171","0","55.76","25.79"
"66","000","00","070","0021","0951","634","310","324","18","652","1238","0","52.67","25.04"
"66","000","00","070","0021","0952","584","309","275","23","607","1276","0","47.57","24.22"
"66","000","00","070","0021","0953","687","369","318","12","699","1396","0","50.07","26.43"
"66","000","00","070","0021","0954","716","348","368","20","736","1260","0","58.41","27.62"
"66","000","00","070","0022","0000","3857","1955","1902","104","3961","7568","0","52.34","25.83"
"66","000","00","070","0022","0955","841","418","423","18","859","1569","0","54.75","26.64"
"66","000","00","070","0022","0956","676","330","346","18","694","1371","0","50.62","24.07"
"66","000","00","070","0022","0957","831","414","417","24","855","1698","0","50.35","24.38"
"66","000","00","070","0022","0958","714","369","345","16","730","1378","0","52.98","26.78"
"66","000","00","070","0022","0959","795","424","371","28","823","1552","0","53.03","27.32"
"66","000","00","070","0023","0000","2831","1403","1428","114","2945","5123","0","57.49","27.39"
"66","000","00","070","0023","0916","707","376","331","46","753","1225","0","61.47","30.69"
"66","000","00","070","0023","0917","634","319","315","13","647","1187","0","54.51","26.87"
"66","000","00","070","0023","0918","731","342","389","33","764","1302","0","58.68","26.27"
"66","000","00","070","0023","0919","759","366","393","22","781","1409","0","55.43","25.98"
"66","000","00","070","0024","0000","4408","2090","2318","107","4515","8201","0","55.05","25.48"
"66","000","00","070","0024","0936","840","377","463","18","858","1411","0","60.81","26.72"
"66","000","00","070","0024","0937","759","339","420","31","790","1424","0","55.48","23.81"
"66","000","00","070","0024","0938","796","387","409","16","812","1556","0","52.19","24.87"
"66","000","00","070","0024","0939","668","331","337","10","678","1265","0","53.60","26.17"
"66","000","00","070","0024","0940","701","347","354","20","721","1250","0","57.68","27.76"
"66","000","00","070","0024","0941","644","309","335","12","656","1295","0","50.66","23.86"
"66","000","00","070","0025","0000","3266","1482","1784","81","3347","6151","0","54.41","24.09"
"66","000","00","070","0025","0931","650","297","353","20","670","1291","0","51.90","23.01"
"66","000","00","070","0025","0932","640","290","350","9","649","1211","0","53.59","23.95"
"66","000","00","070","0025","0933","721","301","420","13","734","1227","0","59.82","24.53"
"66","000","00","070","0025","0934","645","299","346","19","664","1226","0","54.16","24.39"
"66","000","00","070","0025","0935","610","295","315","20","630","1196","0","52.68","24.67"
"66","000","00","080","0000","0000","125367","61287","64080","5387","130754","237103","293869","55.15","25.85"
"66","000","00","080","0001","0000","1752","851","901","83","1835","3096","0","59.27","27.49"
"66","000","00","080","0001","1037","464","226","238","34","498","885","0","56.27","25.54"
"66","000","00","080","0001","1038","675","330","345","28","703","1164","0","60.40","28.35"
"66","000","00","080","0001","1039","613","295","318","21","634","1047","0","60.55","28.18"
"66","000","00","080","0002","0000","1699","794","905","62","1761","3271","0","53.84","24.27"
"66","000","00","080","0002","1031","630","316","314","19","649","1213","0","53.50","26.05"
"66","000","00","080","0002","1032","519","229","290","19","538","1001","0","53.75","22.88"
"66","000","00","080","0002","1033","550","249","301","24","574","1057","0","54.30","23.56"
"66","000","00","080","0003","0000","3648","1726","1922","165","3813","6700","0","56.91","25.76"
"66","000","00","080","0003","0984","704","300","404","31","735","1185","0","62.03","25.32"
"66","000","00","080","0003","0985","605","304","301","31","636","1164","0","54.64","26.12"
"66","000","00","080","0003","0986","565","253","312","27","592","1110","0","53.33","22.79"
"66","000","00","080","0003","0987","576","290","286","29","605","1111","0","54.46","26.10"
"66","000","00","080","0003","0988","614","304","310","20","634","1083","0","58.54","28.07"
"66","000","00","080","0003","0989","584","275","309","27","611","1047","0","58.36","26.27"
"66","000","00","080","0004","0000","2881","1357","1524","99","2980","5463","0","54.55","24.84"
"66","000","00","080","0004","1045","525","250","275","13","538","1046","0","51.43","23.90"
"66","000","00","080","0004","1046","666","329","337","33","699","1184","0","59.04","27.79"
"66","000","00","080","0004","1047","562","272","290","23","585","1060","0","55.19","25.66"
"66","000","00","080","0004","1048","542","253","289","14","556","1052","0","52.85","24.05"
"66","000","00","080","0004","1049","586","253","333","16","602","1121","0","53.70","22.57"
"66","000","00","080","0005","0000","2640","1269","1371","102","2742","4907","0","55.88","25.86"
"66","000","00","080","0005","1054","660","325","335","31","691","1185","0","58.31","27.43"
"66","000","00","080","0005","1055","618","295","323","19","637","1149","0","55.44","25.67"
"66","000","00","080","0005","1056","700","339","361","26","726","1287","0","56.41","26.34"
"66","000","00","080","0005","1057","662","310","352","26","688","1286","0","53.50","24.11"
"66","000","00","080","0006","0000","2339","1193","1146","130","2469","4486","0","55.04","26.59"
"66","000","00","080","0006","1109","566","300","266","36","602","1071","0","56.21","28.01"
"66","000","00","080","0006","1110","451","255","196","37","488","910","0","53.63","28.02"
"66","000","00","080","0006","1111","729","365","364","32","761","1235","0","61.62","29.55"
"66","000","00","080","0006","1112","593","273","320","25","618","1270","0","48.66","21.50"
"66","000","00","080","0007","0000","5044","2632","2412","201","5245","10129","0","51.78","25.98"
"66","000","00","080","0007","1170","1025","528","497","27","1052","1818","0","57.87","29.04"
"66","000","00","080","0007","1171","770","418","352","47","817","1598","0","51.13","26.16"
"66","000","00","080","0007","1172","755","369","386","37","792","1470","0","53.88","25.10"
"66","000","00","080","0007","1173","754","386","368","36","790","1501","0","52.63","25.72"
"66","000","00","080","0007","1174","896","467","429","25","921","1820","0","50.60","25.66"
"66","000","00","080","0007","1175","844","464","380","29","873","1922","0","45.42","24.14"
"66","000","00","080","0008","0000","6996","3497","3499","320","7316","13220","0","55.34","26.45"
"66","000","00","080","0008","1015","699","326","373","28","727","1310","0","55.50","24.89"
"66","000","00","080","0008","1016","562","253","309","29","591","1148","0","51.48","22.04"
"66","000","00","080","0008","1017","616","315","301","20","636","1152","0","55.21","27.34"
"66","000","00","080","0008","1018","679","367","312","41","720","1201","0","59.95","30.56"
"66","000","00","080","0008","1019","709","372","337","25","734","1353","0","54.25","27.49"
"66","000","00","080","0008","1020","679","353","326","31","710","1263","0","56.22","27.95"
"66","000","00","080","0008","1021","625","317","308","28","653","1322","0","49.39","23.98"
"66","000","00","080","0008","1022","654","314","340","38","692","1207","0","57.33","26.01"
"66","000","00","080","0008","1023","655","310","345","31","686","1203","0","57.02","25.77"
"66","000","00","080","0008","1024","624","300","324","26","650","1128","0","57.62","26.60"
"66","000","00","080","0008","1025","494","270","224","23","517","933","0","55.41","28.94"
"66","000","00","080","0009","0000","6541","3346","3195","282","6823","11940","0","57.14","28.02"
"66","000","00","080","0009","1142","672","332","340","30","702","1199","0","58.55","27.69"
"66","000","00","080","0009","1143","636","322","314","29","665","1140","0","58.33","28.25"
"66","000","00","080","0009","1144","711","379","332","29","740","1240","0","59.68","30.56"
"66","000","00","080","0009","1145","520","284","236","38","558","1100","0","50.73","25.82"
"66","000","00","080","0009","1146","648","311","337","33","681","1209","0","56.33","25.72"
"66","000","00","080","0009","1147","626","299","327","25","651","1149","0","56.66","26.02"
"66","000","00","080","0009","1148","721","370","351","26","747","1281","0","58.31","28.88"
"66","000","00","080","0009","1149","776","376","400","18","794","1320","0","60.15","28.48"
"66","000","00","080","0009","1150","580","304","276","29","609","1101","0","55.31","27.61"
"66","000","00","080","0009","1151","651","369","282","25","676","1201","0","56.29","30.72"
"66","000","00","080","0010","0000","5955","3057","2898","254","6209","11317","0","54.86","27.01"
"66","000","00","080","0010","1096","894","484","410","51","945","1631","0","57.94","29.68"
"66","000","00","080","0010","1097","638","356","282","50","688","1152","0","59.72","30.90"
"66","000","00","080","0010","1098","848","394","454","25","873","1473","0","59.27","26.75"
"66","000","00","080","0010","1099","783","423","360","19","802","1655","0","48.46","25.56"
"66","000","00","080","0010","1100","734","366","368","39","773","1324","0","58.38","27.64"
"66","000","00","080","0010","1101","604","301","303","32","636","1181","0","53.85","25.49"
"66","000","00","080","0010","1102","733","359","374","19","752","1525","0","49.31","23.54"
"66","000","00","080","0010","1103","721","374","347","19","740","1376","0","53.78","27.18"
"66","000","00","080","0011","0000","1158","652","506","63","1221","1963","0","62.20","33.21"
"66","000","00","080","0011","1107","664","374","290","38","702","1147","0","61.20","32.61"
"66","000","00","080","0011","1108","494","278","216","25","519","816","0","63.60","34.07"
"66","000","00","080","0012","0000","479","252","227","63","542","970","0","55.88","25.98"
"66","000","00","080","0012","1082","479","252","227","63","542","970","0","55.88","25.98"
"66","000","00","080","0013","0000","7766","3798","3968","254","8020","16146","0","49.67","23.52"
"66","000","00","080","0013","1159","449","211","238","8","457","1021","0","44.76","20.67"
"66","000","00","080","0013","1160","663","335","328","21","684","1456","0","46.98","23.01"
"66","000","00","080","0013","1161","868","424","444","12","880","1697","0","51.86","24.99"
"66","000","00","080","0013","1162","925","453","472","15","940","1723","0","54.56","26.29"
"66","000","00","080","0013","1163","575","271","304","16","591","1256","0","47.05","21.58"
"66","000","00","080","0013","1164","702","325","377","38","740","1447","0","51.14","22.46"
"66","000","00","080","0013","1165","422","224","198","38","460","830","0","55.42","26.99"
"66","000","00","080","0013","1166","767","384","383","48","815","1430","0","56.99","26.85"
"66","000","00","080","0013","1167","728","386","342","19","747","1438","0","51.95","26.84"
"66","000","00","080","0013","1168","851","406","445","23","874","1726","0","50.64","23.52"
"66","000","00","080","0013","1169","816","379","437","16","832","2122","0","39.21","17.86"
"66","000","00","080","0014","0000","1161","620","541","101","1262","2088","0","60.44","29.69"
"66","000","00","080","0014","0994","608","336","272","52","660","1053","0","62.68","31.91"
"66","000","00","080","0014","0995","553","284","269","49","602","1035","0","58.16","27.44"
"66","000","00","080","0015","0000","556","299","257","34","590","903","0","65.34","33.11"
"66","000","00","080","0015","1083","556","299","257","34","590","903","0","65.34","33.11"
"66","000","00","080","0016","0000","4722","2205","2517","167","4889","8476","0","57.68","26.01"
"66","000","00","080","0016","1117","609","293","316","16","625","1164","0","53.69","25.17"
"66","000","00","080","0016","1118","620","260","360","22","642","1044","0","61.49","24.90"
"66","000","00","080","0016","1119","670","355","315","35","705","1125","0","62.67","31.56"
"66","000","00","080","0016","1120","627","311","316","24","651","1102","0","59.07","28.22"
"66","000","00","080","0016","1121","711","316","395","30","741","1327","0","55.84","23.81"
"66","000","00","080","0016","1122","699","319","380","22","721","1274","0","56.59","25.04"
"66","000","00","080","0016","1123","786","351","435","18","804","1440","0","55.83","24.38"
"66","000","00","080","0017","0000","4225","2089","2136","198","4423","8988","0","49.21","23.24"
"66","000","00","080","0017","1000","612","303","309","21","633","1109","0","57.08","27.32"
"66","000","00","080","0017","1001","597","270","327","11","608","1164","0","52.23","23.20"
"66","000","00","080","0017","1002","344","184","160","16","360","1943","0","18.53","9.47"
"66","000","00","080","0017","1003","635","336","299","38","673","1108","0","60.74","30.32"
"66","000","00","080","0017","1004","686","315","371","28","714","1180","0","60.51","26.69"
"66","000","00","080","0017","1005","644","332","312","50","694","1217","0","57.03","27.28"
"66","000","00","080","0017","1006","707","349","358","34","741","1267","0","58.48","27.55"
"66","000","00","080","0018","0000","4906","2431","2475","191","5097","9216","0","55.31","26.38"
"66","000","00","080","0018","1007","578","252","326","18","596","1091","0","54.63","23.10"
"66","000","00","080","0018","1008","562","265","297","22","584","1058","0","55.20","25.05"
"66","000","00","080","0018","1009","746","368","378","21","767","1319","0","58.15","27.90"
"66","000","00","080","0018","1010","628","362","266","30","658","1233","0","53.37","29.36"
"66","000","00","080","0018","1011","782","370","412","19","801","1574","0","50.89","23.51"
"66","000","00","080","0018","1012","853","428","425","34","887","1547","0","57.34","27.67"
"66","000","00","080","0018","1013","757","386","371","47","804","1394","0","57.68","27.69"
"66","000","00","080","0019","0000","863","445","418","34","897","1513","0","59.29","29.41"
"66","000","00","080","0019","1040","863","445","418","34","897","1513","0","59.29","29.41"
"66","000","00","080","0020","0000","5214","2343","2871","197","5411","9499","0","56.96","24.67"
"66","000","00","080","0020","1088","677","305","372","27","704","1285","0","54.79","23.74"
"66","000","00","080","0020","1089","502","209","293","6","508","960","0","52.92","21.77"
"66","000","00","080","0020","1090","727","323","404","23","750","1197","0","62.66","26.98"
"66","000","00","080","0020","1091","679","344","335","20","699","1295","0","53.98","26.56"
"66","000","00","080","0020","1092","651","277","374","25","676","1148","0","58.89","24.13"
"66","000","00","080","0020","1093","587","261","326","10","597","1111","0","53.74","23.49"
"66","000","00","080","0020","1094","723","336","387","56","779","1251","0","62.27","26.86"
"66","000","00","080","0020","1095","668","288","380","30","698","1252","0","55.75","23.00"
"66","000","00","080","0021","0000","2830","1298","1532","170","3000","5140","0","58.37","25.25"
"66","000","00","080","0021","1084","847","398","449","52","899","1515","0","59.34","26.27"
"66","000","00","080","0021","1085","635","301","334","30","665","1151","0","57.78","26.15"
"66","000","00","080","0021","1086","655","310","345","55","710","1246","0","56.98","24.88"
"66","000","00","080","0021","1087","693","289","404","33","726","1228","0","59.12","23.53"
"66","000","00","080","0022","0000","628","293","335","26","654","993","0","65.86","29.51"
"66","000","00","080","0022","1014","628","293","335","26","654","993","0","65.86","29.51"
"66","000","00","080","0023","0000","3485","1713","1772","187","3672","6533","0","56.21","26.22"
"66","000","00","080","0023","1026","766","380","386","23","789","1485","0","53.13","25.59"
"66","000","00","080","0023","1027","669","303","366","39","708","1300","0","54.46","23.31"
"66","000","00","080","0023","1028","702","385","317","34","736","1204","0","61.13","31.98"
"66","000","00","080","0023","1029","730","346","384","49","779","1355","0","57.49","25.54"
"66","000","00","080","0023","1030","618","299","319","42","660","1189","0","55.51","25.15"
"66","000","00","080","0024","0000","2370","1146","1224","108","2478","4475","0","55.37","25.61"
"66","000","00","080","0024","1152","802","417","385","47","849","1527","0","55.60","27.31"
"66","000","00","080","0024","1153","561","262","299","14","575","1023","0","56.21","25.61"
"66","000","00","080","0024","1154","486","247","239","25","511","956","0","53.45","25.84"
"66","000","00","080","0024","1155","521","220","301","22","543","969","0","56.04","22.70"
"66","000","00","080","0025","0000","2080","969","1111","151","2231","4119","0","54.16","23.53"
"66","000","00","080","0025","1156","750","364","386","52","802","1538","0","52.15","23.67"
"66","000","00","080","0025","1157","635","286","349","54","689","1153","0","59.76","24.80"
"66","000","00","080","0025","1158","695","319","376","45","740","1428","0","51.82","22.34"
"66","000","00","080","0026","0000","2884","1473","1411","124","3008","5044","0","59.64","29.20"
"66","000","00","080","0026","1050","662","319","343","21","683","1139","0","59.96","28.01"
"66","000","00","080","0026","1051","710","372","338","29","739","1213","0","60.92","30.67"
"66","000","00","080","0026","1052","689","345","344","47","736","1327","0","55.46","26.00"
"66","000","00","080","0026","1053","823","437","386","27","850","1365","0","62.27","32.01"
"66","000","00","080","0027","0000","1556","787","769","63","1619","3053","0","53.03","25.78"
"66","000","00","080","0027","1066","592","271","321","24","616","1067","0","57.73","25.40"
"66","000","00","080","0027","1067","415","211","204","15","430","924","0","46.54","22.84"
"66","000","00","080","0027","1068","549","305","244","24","573","1062","0","53.95","28.72"
"66","000","00","080","0028","0000","2960","1508","1452","114","3074","5945","0","51.71","25.37"
"66","000","00","080","0028","1072","634","327","307","23","657","1286","0","51.09","25.43"
"66","000","00","080","0028","1073","665","322","343","27","692","1221","0","56.67","26.37"
"66","000","00","080","0028","1074","619","320","299","31","650","1344","0","48.36","23.81"
"66","000","00","080","0028","1075","585","303","282","23","608","1150","0","52.87","26.35"
"66","000","00","080","0028","1076","457","236","221","10","467","944","0","49.47","25.00"
"66","000","00","080","0029","0000","2701","1344","1357","101","2802","4633","0","60.48","29.01"
"66","000","00","080","0029","1113","687","364","323","21","708","1127","0","62.82","32.30"
"66","000","00","080","0029","1114","545","260","285","16","561","1045","0","53.68","24.88"
"66","000","00","080","0029","1115","736","367","369","28","764","1311","0","58.28","27.99"
"66","000","00","080","0029","1116","733","353","380","36","769","1150","0","66.87","30.70"
"66","000","00","080","0030","0000","2685","1281","1404","85","2770","5041","0","54.95","25.41"
"66","000","00","080","0030","1133","704","353","351","23","727","1274","0","57.06","27.71"
"66","000","00","080","0030","1134","628","294","334","24","652","1279","0","50.98","22.99"
"66","000","00","080","0030","1135","673","288","385","13","686","1241","0","55.28","23.21"
"66","000","00","080","0030","1136","680","346","334","25","705","1247","0","56.54","27.75"
"66","000","00","080","0031","0000","2474","1102","1372","102","2576","4587","0","56.16","24.02"
"66","000","00","080","0031","0996","665","324","341","33","698","1306","0","53.45","24.81"
"66","000","00","080","0031","0997","497","215","282","20","517","970","0","53.30","22.16"
"66","000","00","080","0031","0998","685","294","391","31","716","1189","0","60.22","24.73"
"66","000","00","080","0031","0999","627","269","358","18","645","1122","0","57.49","23.98"
"66","000","00","080","0032","0000","3458","1655","1803","111","3569","6519","0","54.75","25.39"
"66","000","00","080","0032","1137","655","332","323","16","671","1264","0","53.09","26.27"
"66","000","00","080","0032","1138","716","332","384","30","746","1281","0","58.24","25.92"
"66","000","00","080","0032","1139","694","334","360","30","724","1325","0","54.64","25.21"
"66","000","00","080","0032","1140","636","293","343","22","658","1200","0","54.83","24.42"
"66","000","00","080","0032","1141","757","364","393","13","770","1449","0","53.14","25.12"
"66","000","00","080","0033","0000","2741","1300","1441","91","2832","4918","0","57.58","26.43"
"66","000","00","080","0033","1129","742","318","424","15","757","1226","0","61.75","25.94"
"66","000","00","080","0033","1130","591","305","286","20","611","1142","0","53.50","26.71"
"66","000","00","080","0033","1131","671","320","351","30","701","1237","0","56.67","25.87"
"66","000","00","080","0033","1132","737","357","380","26","763","1313","0","58.11","27.19"
"66","000","00","080","0034","0000","1678","867","811","81","1759","3019","0","58.26","28.72"
"66","000","00","080","0034","1034","569","310","259","27","596","1061","0","56.17","29.22"
"66","000","00","080","0034","1035","448","242","206","33","481","827","0","58.16","29.26"
"66","000","00","080","0034","1036","661","315","346","21","682","1131","0","60.30","27.85"
"66","000","00","080","0035","0000","2314","1098","1216","90","2404","4555","0","52.78","24.11"
"66","000","00","080","0035","1041","559","273","286","24","583","1120","0","52.05","24.38"
"66","000","00","080","0035","1042","557","276","281","20","577","1094","0","52.74","25.23"
"66","000","00","080","0035","1043","588","283","305","31","619","1154","0","53.64","24.52"
"66","000","00","080","0035","1044","610","266","344","15","625","1187","0","52.65","22.41"
"66","000","00","080","0036","0000","1839","879","960","63","1902","3358","0","56.64","26.18"
"66","000","00","080","0036","1069","632","305","327","27","659","1110","0","59.37","27.48"
"66","000","00","080","0036","1070","546","236","310","15","561","1134","0","49.47","20.81"
"66","000","00","080","0036","1071","661","338","323","21","682","1114","0","61.22","30.34"
"66","000","00","080","0037","0000","2995","1418","1577","174","3169","6239","0","50.79","22.73"
"66","000","00","080","0037","1124","600","296","304","35","635","1292","0","49.15","22.91"
"66","000","00","080","0037","1125","588","281","307","52","640","1134","0","56.44","24.78"
"66","000","00","080","0037","1126","557","286","271","22","579","1257","0","46.06","22.75"
"66","000","00","080","0037","1127","667","289","378","38","705","1286","0","54.82","22.47"
"66","000","00","080","0037","1128","583","266","317","27","610","1270","0","48.03","20.94"
"66","000","00","080","0038","0000","2361","1133","1228","87","2448","4657","0","52.57","24.33"
"66","000","00","080","0038","1062","580","268","312","17","597","1112","0","53.69","24.10"
"66","000","00","080","0038","1063","599","291","308","23","622","1212","0","51.32","24.01"
"66","000","00","080","0038","1064","537","273","264","26","563","1106","0","50.90","24.68"
"66","000","00","080","0038","1065","645","301","344","21","666","1227","0","54.28","24.53"
"66","000","00","080","0039","0000","3510","1711","1799","130","3640","6505","0","55.96","26.30"
"66","000","00","080","0039","1077","682","308","374","15","697","1413","0","49.33","21.80"
"66","000","00","080","0039","1078","767","406","361","35","802","1423","0","56.36","28.53"
"66","000","00","080","0039","1079","662","312","350","23","685","1223","0","56.01","25.51"
"66","000","00","080","0039","1080","701","355","346","24","725","1251","0","57.95","28.38"
"66","000","00","080","0039","1081","698","330","368","33","731","1195","0","61.17","27.62"
"66","000","00","080","0040","0000","2204","1059","1145","99","2303","4243","0","54.28","24.96"
"66","000","00","080","0040","1058","552","254","298","20","572","1113","0","51.39","22.82"
"66","000","00","080","0040","1059","529","244","285","16","545","1004","0","54.28","24.30"
"66","000","00","080","0040","1060","608","298","310","38","646","1158","0","55.79","25.73"
"66","000","00","080","0040","1061","515","263","252","25","540","968","0","55.79","27.17"
"66","000","00","080","0041","0000","2932","1444","1488","129","3061","5516","0","55.49","26.18"
"66","000","00","080","0041","0990","839","430","409","41","880","1565","0","56.23","27.48"
"66","000","00","080","0041","0991","784","369","415","37","821","1320","0","62.20","27.95"
"66","000","00","080","0041","0992","624","294","330","32","656","1374","0","47.74","21.40"
"66","000","00","080","0041","0993","685","351","334","19","704","1257","0","56.01","27.92"
"66","000","00","080","0042","0000","2137","953","1184","101","2238","3720","0","60.16","25.62"
"66","000","00","080","0042","1104","733","323","410","45","778","1307","0","59.53","24.71"
"66","000","00","080","0042","1105","780","343","437","33","813","1371","0","59.30","25.02"
"66","000","00","080","0042","1106","624","287","337","23","647","1042","0","62.09","27.54"
"66","000","00","090","0000","0000","76718","40191","36527","3962","80680","132385","163214","60.94","30.36"
"66","000","00","090","0001","0000","1267","605","662","58","1325","2144","0","61.80","28.22"
"66","000","00","090","0001","0451","502","261","241","26","528","885","0","59.66","29.49"
"66","000","00","090","0001","0452","765","344","421","32","797","1259","0","63.30","27.32"
"66","000","00","090","0002","0000","500","286","214","29","529","866","0","61.09","33.03"
"66","000","00","090","0002","0454","500","286","214","29","529","866","0","61.09","33.03"
"66","000","00","090","0003","0000","538","290","248","34","572","756","0","75.66","38.36"
"66","000","00","090","0003","0455","538","290","248","34","572","756","0","75.66","38.36"
"66","000","00","090","0004","0000","586","332","254","28","614","1054","0","58.25","31.50"
"66","000","00","090","0004","0453","586","332","254","28","614","1054","0","58.25","31.50"
"66","000","00","090","0005","0000","474","241","233","45","519","735","0","70.61","32.79"
"66","000","00","090","0005","0456","474","241","233","45","519","735","0","70.61","32.79"
"66","000","00","090","0006","0000","447","246","201","16","463","663","0","69.83","37.10"
"66","000","00","090","0006","0481","447","246","201","16","463","663","0","69.83","37.10"
"66","000","00","090","0007","0000","349","205","144","31","380","567","0","67.02","36.16"
"66","000","00","090","0007","0482","349","205","144","31","380","567","0","67.02","36.16"
"66","000","00","090","0008","0000","940","488","452","44","984","1562","0","63.00","31.24"
"66","000","00","090","0008","0475","501","246","255","26","527","826","0","63.80","29.78"
"66","000","00","090","0008","0476","439","242","197","18","457","736","0","62.09","32.88"
"66","000","00","090","0009","0000","2670","1383","1287","138","2808","4574","0","61.39","30.24"
"66","000","00","090","0009","0483","654","336","318","25","679","1080","0","62.87","31.11"
"66","000","00","090","0009","0484","675","360","315","39","714","1170","0","61.03","30.77"
"66","000","00","090","0009","0485","681","341","340","35","716","1179","0","60.73","28.92"
"66","000","00","090","0009","0486","660","346","314","39","699","1145","0","61.05","30.22"
"66","000","00","090","0010","0000","1341","694","647","70","1411","2086","0","67.64","33.27"
"66","000","00","090","0010","0487","810","413","397","45","855","1229","0","69.57","33.60"
"66","000","00","090","0010","0488","531","281","250","25","556","857","0","64.88","32.79"
"66","000","00","090","0011","0000","754","406","348","51","805","1356","0","59.37","29.94"
"66","000","00","090","0011","0503","754","406","348","51","805","1356","0","59.37","29.94"
"66","000","00","090","0012","0000","667","352","315","31","698","1073","0","65.05","32.81"
"66","000","00","090","0012","0504","667","352","315","31","698","1073","0","65.05","32.81"
"66","000","00","090","0013","0000","1377","680","697","57","1434","2384","0","60.15","28.52"
"66","000","00","090","0013","0461","595","295","300","20","615","1025","0","60.00","28.78"
"66","000","00","090","0013","0462","782","385","397","37","819","1359","0","60.26","28.33"
"66","000","00","090","0014","0000","1691","845","846","87","1778","2834","0","62.74","29.82"
"66","000","00","090","0014","0463","825","426","399","43","868","1455","0","59.66","29.28"
"66","000","00","090","0014","0464","866","419","447","44","910","1379","0","65.99","30.38"
"66","000","00","090","0015","0000","2421","1355","1066","143","2564","3876","0","66.15","34.96"
"66","000","00","090","0015","0465","861","471","390","50","911","1430","0","63.71","32.94"
"66","000","00","090","0015","0466","818","466","352","60","878","1327","0","66.16","35.12"
"66","000","00","090","0015","0467","742","418","324","33","775","1119","0","69.26","37.35"
"66","000","00","090","0016","0000","5127","2687","2440","271","5398","8796","0","61.37","30.55"
"66","000","00","090","0016","0468","861","463","398","26","887","1353","0","65.56","34.22"
"66","000","00","090","0016","0469","811","422","389","60","871","1380","0","63.12","30.58"
"66","000","00","090","0016","0470","549","292","257","30","579","1026","0","56.43","28.46"
"66","000","00","090","0016","0471","818","407","411","43","861","1329","0","64.79","30.62"
"66","000","00","090","0016","0472","597","319","278","19","616","1075","0","57.30","29.67"
"66","000","00","090","0016","0473","825","413","412","62","887","1345","0","65.95","30.71"
"66","000","00","090","0016","0474","666","371","295","31","697","1288","0","54.11","28.80"
"66","000","00","090","0017","0000","857","445","412","35","892","1222","0","73.00","36.42"
"66","000","00","090","0017","0477","857","445","412","35","892","1222","0","73.00","36.42"
"66","000","00","090","0018","0000","1990","1040","950","131","2121","3243","0","65.40","32.07"
"66","000","00","090","0018","0478","739","401","338","31","770","1212","0","63.53","33.09"
"66","000","00","090","0018","0479","630","347","283","46","676","1006","0","67.20","34.49"
"66","000","00","090","0018","0480","621","292","329","54","675","1025","0","65.85","28.49"
"66","000","00","090","0019","0000","5177","2639","2538","237","5414","9510","0","56.93","27.75"
"66","000","00","090","0019","0491","719","357","362","37","756","1330","0","56.84","26.84"
"66","000","00","090","0019","0492","734","371","363","32","766","1353","0","56.61","27.42"
"66","000","00","090","0019","0493","711","391","320","47","758","1315","0","57.64","29.73"
"66","000","00","090","0019","0494","623","315","308","18","641","1321","0","48.52","23.85"
"66","000","00","090","0019","0495","717","344","373","35","752","1372","0","54.81","25.07"
"66","000","00","090","0019","0496","818","426","392","40","858","1351","0","63.51","31.53"
"66","000","00","090","0019","0497","855","435","420","28","883","1468","0","60.15","29.63"
"66","000","00","090","0020","0000","3523","1838","1685","158","3681","6011","0","61.24","30.58"
"66","000","00","090","0020","0498","683","350","333","43","726","1154","0","62.91","30.33"
"66","000","00","090","0020","0499","661","335","326","33","694","1092","0","63.55","30.68"
"66","000","00","090","0020","0500","759","429","330","25","784","1341","0","58.46","31.99"
"66","000","00","090","0020","0501","693","371","322","17","710","1142","0","62.17","32.49"
"66","000","00","090","0020","0502","727","353","374","40","767","1282","0","59.83","27.54"
"66","000","00","090","0021","0000","1625","823","802","81","1706","2831","0","60.26","29.07"
"66","000","00","090","0021","0489","800","415","385","37","837","1392","0","60.13","29.81"
"66","000","00","090","0021","0490","825","408","417","44","869","1439","0","60.39","28.35"
"66","000","00","090","0022","0000","3344","1782","1562","161","3505","6039","0","58.04","29.51"
"66","000","00","090","0022","0505","690","373","317","39","729","1684","0","43.29","22.15"
"66","000","00","090","0022","0506","626","321","305","21","647","1065","0","60.75","30.14"
"66","000","00","090","0022","0507","671","399","272","40","711","1068","0","66.57","37.36"
"66","000","00","090","0022","0508","722","360","362","36","758","1152","0","65.80","31.25"
"66","000","00","090","0022","0509","635","329","306","25","660","1070","0","61.68","30.75"
"66","000","00","090","0023","0000","5458","2880","2578","299","5757","9904","0","58.13","29.08"
"66","000","00","090","0023","0510","793","429","364","57","850","1438","0","59.11","29.83"
"66","000","00","090","0023","0511","784","437","347","46","830","1380","0","60.14","31.67"
"66","000","00","090","0023","0512","797","430","367","45","842","1474","0","57.12","29.17"
"66","000","00","090","0023","0513","711","384","327","42","753","1371","0","54.92","28.01"
"66","000","00","090","0023","0514","788","419","369","43","831","1414","0","58.77","29.63"
"66","000","00","090","0023","0515","721","338","383","35","756","1337","0","56.54","25.28"
"66","000","00","090","0023","0516","864","443","421","31","895","1490","0","60.07","29.73"
"66","000","00","090","0024","0000","2608","1356","1252","148","2756","4459","0","61.81","30.41"
"66","000","00","090","0024","0517","866","454","412","58","924","1501","0","61.56","30.25"
"66","000","00","090","0024","0518","842","452","390","39","881","1426","0","61.78","31.70"
"66","000","00","090","0024","0519","900","450","450","51","951","1532","0","62.08","29.37"
"66","000","00","090","0025","0000","5558","2773","2785","270","5828","10238","0","56.93","27.09"
"66","000","00","090","0025","0522","665","285","380","52","717","1317","0","54.44","21.64"
"66","000","00","090","0025","0523","737","343","394","31","768","1294","0","59.35","26.51"
"66","000","00","090","0025","0524","770","397","373","38","808","1342","0","60.21","29.58"
"66","000","00","090","0025","0525","744","354","390","32","776","1324","0","58.61","26.74"
"66","000","00","090","0025","0526","708","350","358","29","737","1359","0","54.23","25.75"
"66","000","00","090","0025","0527","684","362","322","21","705","1214","0","58.07","29.82"
"66","000","00","090","0025","0528","662","358","304","41","703","1125","0","62.49","31.82"
"66","000","00","090","0025","0529","588","324","264","26","614","1263","0","48.61","25.65"
"66","000","00","090","0026","0000","1525","803","722","63","1588","2520","0","63.02","31.87"
"66","000","00","090","0026","0520","702","359","343","28","730","1128","0","64.72","31.83"
"66","000","00","090","0026","0521","823","444","379","35","858","1392","0","61.64","31.90"
"66","000","00","090","0027","0000","7340","3842","3498","343","7683","12654","0","60.72","30.36"
"66","000","00","090","0027","0530","857","456","401","33","890","1547","0","57.53","29.48"
"66","000","00","090","0027","0531","856","445","411","37","893","1431","0","62.40","31.10"
"66","000","00","090","0027","0532","803","376","427","33","836","1358","0","61.56","27.69"
"66","000","00","090","0027","0533","886","475","411","35","921","1506","0","61.16","31.54"
"66","000","00","090","0027","0534","846","456","390","37","883","1442","0","61.23","31.62"
"66","000","00","090","0027","0535","787","385","402","41","828","1380","0","60.00","27.90"
"66","000","00","090","0027","0536","811","413","398","41","852","1419","0","60.04","29.11"
"66","000","00","090","0027","0537","669","392","277","39","708","1194","0","59.30","32.83"
"66","000","00","090","0027","0538","825","444","381","47","872","1377","0","63.33","32.24"
"66","000","00","090","0028","0000","2916","1483","1433","122","3038","4983","0","60.97","29.76"
"66","000","00","090","0028","0457","748","397","351","33","781","1304","0","59.89","30.44"
"66","000","00","090","0028","0458","736","381","355","38","774","1265","0","61.19","30.12"
"66","000","00","090","0028","0459","808","402","406","35","843","1376","0","61.26","29.22"
"66","000","00","090","0028","0460","624","303","321","16","640","1038","0","61.66","29.19"
"66","000","00","090","0029","0000","940","558","382","67","1007","1488","0","67.67","37.50"
"66","000","00","090","0029","0539","940","558","382","67","1007","1488","0","67.67","37.50"
"66","000","00","090","0030","0000","2977","1616","1361","128","3105","5144","0","60.36","31.42"
"66","000","00","090","0030","0540","844","470","374","42","886","1443","0","61.40","32.57"
"66","000","00","090","0030","0541","669","377","292","31","700","1147","0","61.03","32.87"
"66","000","00","090","0030","0542","679","357","322","25","704","1166","0","60.38","30.62"
"66","000","00","090","0030","0543","785","412","373","30","815","1388","0","58.72","29.68"
"66","000","00","090","0031","0000","1768","983","785","126","1894","3071","0","61.67","32.01"
"66","000","00","090","0031","0544","575","282","293","28","603","1097","0","54.97","25.71"
"66","000","00","090","0031","0545","649","374","275","68","717","1042","0","68.81","35.89"
"66","000","00","090","0031","0546","544","327","217","30","574","932","0","61.59","35.09"
"66","000","00","090","0032","0000","1881","1045","836","99","1980","3273","0","60.49","31.93"
"66","000","00","090","0032","0547","636","367","269","43","679","1029","0","65.99","35.67"
"66","000","00","090","0032","0548","617","347","270","40","657","1051","0","62.51","33.02"
"66","000","00","090","0032","0549","628","331","297","16","644","1193","0","53.98","27.75"
"66","000","00","090","0033","0000","1292","646","646","88","1380","2162","0","63.83","29.88"
"66","000","00","090","0033","0550","636","309","327","51","687","1056","0","65.06","29.26"
"66","000","00","090","0033","0551","656","337","319","37","693","1106","0","62.66","30.47"
"66","000","00","090","0034","0000","1796","926","870","115","1911","3197","0","59.77","28.96"
"66","000","00","090","0034","0552","623","311","312","35","658","1098","0","59.93","28.32"
"66","000","00","090","0034","0553","559","296","263","46","605","1040","0","58.17","28.46"
"66","000","00","090","0034","0554","614","319","295","34","648","1059","0","61.19","30.12"
"66","000","00","090","0035","0000","1119","633","486","64","1183","1962","0","60.30","32.26"
"66","000","00","090","0035","0555","526","303","223","40","566","902","0","62.75","33.59"
"66","000","00","090","0035","0556","593","330","263","24","617","1060","0","58.21","31.13"
"66","000","00","090","0036","0000","1875","985","890","94","1969","3148","0","62.55","31.29"
"66","000","00","090","0036","0557","658","333","325","25","683","1066","0","64.07","31.24"
"66","000","00","090","0036","0558","575","320","255","27","602","989","0","60.87","32.36"
"66","000","00","090","0036","0559","642","332","310","42","684","1093","0","62.58","30.38"
"66","000","00","100","0000","0000","23754","11112","12642","2304","26058","40967","47810","63.61","27.12"
"66","000","00","100","0001","0000","737","320","417","37","774","1316","0","58.81","24.32"
"66","000","00","100","0001","1817","737","320","417","37","774","1316","0","58.81","24.32"
"66","000","00","100","0002","0000","511","230","281","45","556","791","0","70.29","29.08"
"66","000","00","100","0002","1816","511","230","281","45","556","791","0","70.29","29.08"
"66","000","00","100","0003","0000","542","225","317","40","582","977","0","59.57","23.03"
"66","000","00","100","0003","1815","542","225","317","40","582","977","0","59.57","23.03"
"66","000","00","100","0004","0000","985","404","581","76","1061","1684","0","63.00","23.99"
"66","000","00","100","0004","1813","503","214","289","42","545","895","0","60.89","23.91"
"66","000","00","100","0004","1814","482","190","292","34","516","789","0","65.40","24.08"
"66","000","00","100","0005","0000","1129","513","616","64","1193","2026","0","58.88","25.32"
"66","000","00","100","0005","1811","562","256","306","35","597","1071","0","55.74","23.90"
"66","000","00","100","0005","1812","567","257","310","29","596","955","0","62.41","26.91"
"66","000","00","100","0006","0000","615","255","360","44","659","921","0","71.55","27.69"
"66","000","00","100","0006","1809","615","255","360","44","659","921","0","71.55","27.69"
"66","000","00","100","0007","0000","725","349","376","52","777","1345","0","57.77","25.95"
"66","000","00","100","0007","1810","725","349","376","52","777","1345","0","57.77","25.95"
"66","000","00","100","0008","0000","1880","814","1066","139","2019","3210","0","62.90","25.36"
"66","000","00","100","0008","1806","629","277","352","52","681","1108","0","61.46","25.00"
"66","000","00","100","0008","1807","682","291","391","43","725","1146","0","63.26","25.39"
"66","000","00","100","0008","1808","569","246","323","44","613","956","0","64.12","25.73"
"66","000","00","100","0009","0000","965","466","499","109","1074","1769","0","60.71","26.34"
"66","000","00","100","0009","1804","451","212","239","51","502","836","0","60.05","25.36"
"66","000","00","100","0009","1805","514","254","260","58","572","933","0","61.31","27.22"
"66","000","00","100","0010","0000","2115","943","1172","224","2339","3653","0","64.03","25.81"
"66","000","00","100","0010","1800","708","308","400","75","783","1187","0","65.96","25.95"
"66","000","00","100","0010","1801","839","368","471","82","921","1354","0","68.02","27.18"
"66","000","00","100","0010","1802","568","267","301","67","635","1112","0","57.10","24.01"
"66","000","00","100","0011","0000","731","369","362","78","809","1360","0","59.49","27.13"
"66","000","00","100","0011","1803","731","369","362","78","809","1360","0","59.49","27.13"
"66","000","00","100","0012","0000","2768","1313","1455","219","2987","4740","0","63.02","27.70"
"66","000","00","100","0012","1796","723","350","373","75","798","1304","0","61.20","26.84"
"66","000","00","100","0012","1797","690","353","337","54","744","1126","0","66.07","31.35"
"66","000","00","100","0012","1798","717","320","397","52","769","1178","0","65.28","27.16"
"66","000","00","100","0012","1799","638","290","348","38","676","1132","0","59.72","25.62"
"66","000","00","100","0013","0000","942","464","478","89","1031","1532","0","67.30","30.29"
"66","000","00","100","0013","1794","534","278","256","63","597","843","0","70.82","32.98"
"66","000","00","100","0013","1795","408","186","222","26","434","689","0","62.99","27.00"
"66","000","00","100","0014","0000","535","262","273","56","591","929","0","63.62","28.20"
"66","000","00","100","0014","1792","535","262","273","56","591","929","0","63.62","28.20"
"66","000","00","100","0015","0000","438","227","211","69","507","803","0","63.14","28.27"
"66","000","00","100","0015","1793","438","227","211","69","507","803","0","63.14","28.27"
"66","000","00","100","0016","0000","1173","614","559","163","1336","1791","0","74.60","34.28"
"66","000","00","100","0016","1790","654","354","300","64","718","951","0","75.50","37.22"
"66","000","00","100","0016","1791","519","260","259","99","618","840","0","73.57","30.95"
"66","000","00","100","0017","0000","600","315","285","68","668","1185","0","56.37","26.58"
"66","000","00","100","0017","1789","600","315","285","68","668","1185","0","56.37","26.58"
"66","000","00","100","0018","0000","1186","514","672","62","1248","1907","0","65.44","26.95"
"66","000","00","100","0018","1822","589","254","335","24","613","966","0","63.46","26.29"
"66","000","00","100","0018","1823","597","260","337","38","635","941","0","67.48","27.63"
"66","000","00","100","0019","0000","1076","471","605","110","1186","1942","0","61.07","24.25"
"66","000","00","100","0019","1818","365","158","207","30","395","691","0","57.16","22.87"
"66","000","00","100","0019","1819","711","313","398","80","791","1251","0","63.23","25.02"
"66","000","00","100","0020","0000","958","453","505","119","1077","1589","0","67.78","28.51"
"66","000","00","100","0020","1820","461","231","230","45","506","765","0","66.14","30.20"
"66","000","00","100","0020","1821","497","222","275","74","571","824","0","69.30","26.94"
"66","000","00","100","0021","0000","692","349","343","82","774","1125","0","68.80","31.02"
"66","000","00","100","0021","1824","692","349","343","82","774","1125","0","68.80","31.02"
"66","000","00","100","0022","0000","881","420","461","114","995","1746","0","56.99","24.05"
"66","000","00","100","0022","1825","414","199","215","63","477","880","0","54.20","22.61"
"66","000","00","100","0022","1826","467","221","246","51","518","866","0","59.82","25.52"
"66","000","00","100","0023","0000","348","181","167","50","398","674","0","59.05","26.85"
"66","000","00","100","0023","1827","348","181","167","50","398","674","0","59.05","26.85"
"66","000","00","100","0024","0000","406","225","181","54","460","633","0","72.67","35.55"
"66","000","00","100","0024","1828","406","225","181","54","460","633","0","72.67","35.55"
"66","000","00","100","0025","0000","816","416","400","141","957","1319","0","72.55","31.54"
"66","000","00","100","0025","1829","816","416","400","141","957","1319","0","72.55","31.54"
"66","000","00","110","0000","0000","34570","17484","17086","2749","37319","60315","74679","61.87","28.99"
"66","000","00","110","0001","0000","773","418","355","43","816","1260","0","64.76","33.17"
"66","000","00","110","0001","0001","773","418","355","43","816","1260","0","64.76","33.17"
"66","000","00","110","0002","0000","539","285","254","33","572","926","0","61.77","30.78"
"66","000","00","110","0002","0002","539","285","254","33","572","926","0","61.77","30.78"
"66","000","00","110","0003","0000","860","435","425","46","906","1445","0","62.70","30.10"
"66","000","00","110","0003","0003","394","194","200","22","416","650","0","64.00","29.85"
"66","000","00","110","0003","0004","466","241","225","24","490","795","0","61.64","30.31"
"66","000","00","110","0004","0000","385","180","205","27","412","710","0","58.03","25.35"
"66","000","00","110","0004","0005","385","180","205","27","412","710","0","58.03","25.35"
"66","000","00","110","0005","0000","1145","579","566","82","1227","1938","0","63.31","29.88"
"66","000","00","110","0005","0006","567","285","282","41","608","986","0","61.66","28.90"
"66","000","00","110","0005","0007","578","294","284","41","619","952","0","65.02","30.88"
"66","000","00","110","0006","0000","1146","613","533","71","1217","1978","0","61.53","30.99"
"66","000","00","110","0006","0008","557","341","216","31","588","1007","0","58.39","33.86"
"66","000","00","110","0006","0009","589","272","317","40","629","971","0","64.78","28.01"
"66","000","00","110","0007","0000","1866","897","969","139","2005","3210","0","62.46","27.94"
"66","000","00","110","0007","0010","558","262","296","33","591","1021","0","57.88","25.66"
"66","000","00","110","0007","0011","746","359","387","52","798","1190","0","67.06","30.17"
"66","000","00","110","0007","0012","562","276","286","54","616","999","0","61.66","27.63"
"66","000","00","110","0008","0000","1215","582","633","95","1310","1969","0","66.53","29.56"
"66","000","00","110","0008","0013","603","304","299","54","657","966","0","68.01","31.47"
"66","000","00","110","0008","0014","612","278","334","41","653","1003","0","65.10","27.72"
"66","000","00","110","0009","0000","2397","1113","1284","172","2569","4534","0","56.66","24.55"
"66","000","00","110","0009","0015","697","327","370","62","759","1329","0","57.11","24.60"
"66","000","00","110","0009","0016","542","254","288","27","569","1058","0","53.78","24.01"
"66","000","00","110","0009","0017","628","266","362","55","683","1200","0","56.92","22.17"
"66","000","00","110","0009","0018","530","266","264","28","558","947","0","58.92","28.09"
"66","000","00","110","0010","0000","480","279","201","38","518","799","0","64.83","34.92"
"66","000","00","110","0010","0019","480","279","201","38","518","799","0","64.83","34.92"
"66","000","00","110","0011","0000","528","281","247","33","561","850","0","66.00","33.06"
"66","000","00","110","0011","0020","528","281","247","33","561","850","0","66.00","33.06"
"66","000","00","110","0012","0000","1800","876","924","122","1922","3125","0","61.50","28.03"
"66","000","00","110","0012","0021","882","448","434","61","943","1562","0","60.37","28.68"
"66","000","00","110","0012","0022","918","428","490","61","979","1563","0","62.64","27.38"
"66","000","00","110","0013","0000","720","343","377","76","796","1130","0","70.44","30.35"
"66","000","00","110","0013","0023","720","343","377","76","796","1130","0","70.44","30.35"
"66","000","00","110","0014","0000","532","277","255","77","609","1016","0","59.94","27.26"
"66","000","00","110","0014","0024","532","277","255","77","609","1016","0","59.94","27.26"
"66","000","00","110","0015","0000","1008","502","506","78","1086","1710","0","63.51","29.36"
"66","000","00","110","0015","0025","554","283","271","48","602","917","0","65.65","30.86"
"66","000","00","110","0015","0026","454","219","235","30","484","793","0","61.03","27.62"
"66","000","00","110","0016","0000","2709","1340","1369","166","2875","4999","0","57.51","26.81"
"66","000","00","110","0016","0027","530","261","269","37","567","949","0","59.75","27.50"
"66","000","00","110","0016","0028","607","290","317","58","665","1042","0","63.82","27.83"
"66","000","00","110","0016","0029","540","272","268","26","566","1100","0","51.45","24.73"
"66","000","00","110","0016","0030","511","236","275","24","535","867","0","61.71","27.22"
"66","000","00","110","0016","0031","521","281","240","21","542","1041","0","52.07","26.99"
"66","000","00","110","0017","0000","1184","559","625","41","1225","1966","0","62.31","28.43"
"66","000","00","110","0017","0032","774","351","423","30","804","1214","0","66.23","28.91"
"66","000","00","110","0017","0033","410","208","202","11","421","752","0","55.98","27.66"
"66","000","00","110","0018","0000","1059","582","477","95","1154","1670","0","69.10","34.85"
"66","000","00","110","0018","0034","546","322","224","54","600","863","0","69.52","37.31"
"66","000","00","110","0018","0035","513","260","253","41","554","807","0","68.65","32.22"
"66","000","00","110","0019","0000","728","394","334","55","783","1300","0","60.23","30.31"
"66","000","00","110","0019","0036","728","394","334","55","783","1300","0","60.23","30.31"
"66","000","00","110","0020","0000","2661","1332","1329","176","2837","4360","0","65.07","30.55"
"66","000","00","110","0020","0037","759","362","397","54","813","1253","0","64.88","28.89"
"66","000","00","110","0020","0038","695","325","370","62","757","1131","0","66.93","28.74"
"66","000","00","110","0020","0039","534","301","233","30","564","923","0","61.11","32.61"
"66","000","00","110","0020","0040","673","344","329","30","703","1053","0","66.76","32.67"
"66","000","00","110","0021","0000","722","370","352","94","816","1164","0","70.10","31.79"
"66","000","00","110","0021","0041","722","370","352","94","816","1164","0","70.10","31.79"
"66","000","00","110","0022","0000","2119","1106","1013","183","2302","3762","0","61.19","29.40"
"66","000","00","110","0022","0042","762","384","378","64","826","1324","0","62.39","29.00"
"66","000","00","110","0022","0043","593","325","268","65","658","1098","0","59.93","29.60"
"66","000","00","110","0022","0044","764","397","367","54","818","1340","0","61.04","29.63"
"66","000","00","110","0023","0000","1351","701","650","139","1490","2401","0","62.06","29.20"
"66","000","00","110","0023","0045","591","319","272","85","676","1077","0","62.77","29.62"
"66","000","00","110","0023","0046","760","382","378","54","814","1324","0","61.48","28.85"
"66","000","00","110","0024","0000","2881","1441","1440","211","3092","5306","0","58.27","27.16"
"66","000","00","110","0024","0047","687","326","361","52","739","1211","0","61.02","26.92"
"66","000","00","110","0024","0048","768","383","385","62","830","1423","0","58.33","26.91"
"66","000","00","110","0024","0049","731","393","338","51","782","1375","0","56.87","28.58"
"66","000","00","110","0024","0050","695","339","356","46","741","1297","0","57.13","26.14"
"66","000","00","110","0025","0000","819","415","404","84","903","1427","0","63.28","29.08"
"66","000","00","110","0025","0051","370","160","210","28","398","631","0","63.07","25.36"
"66","000","00","110","0025","0052","449","255","194","56","505","796","0","63.44","32.04"
"66","000","00","110","0026","0000","917","460","457","116","1033","1590","0","64.97","28.93"
"66","000","00","110","0026","0053","448","224","224","63","511","850","0","60.12","26.35"
"66","000","00","110","0026","0054","469","236","233","53","522","740","0","70.54","31.89"
"66","000","00","110","0027","0000","665","364","301","66","731","1294","0","56.49","28.13"
"66","000","00","110","0027","0055","665","364","301","66","731","1294","0","56.49","28.13"
"66","000","00","110","0028","0000","515","281","234","39","554","1060","0","52.26","26.51"
"66","000","00","110","0028","0056","515","281","234","39","554","1060","0","52.26","26.51"
"66","000","00","110","0029","0000","846","479","367","152","998","1416","0","70.48","33.83"
"66","000","00","110","0029","0057","846","479","367","152","998","1416","0","70.48","33.83"
"66","000","00","120","0000","0000","42238","22040","20198","3801","46039","72792","88843","63.25","30.28"
"66","000","00","120","0001","0000","656","368","288","51","707","1027","0","68.84","35.83"
"66","000","00","120","0001","0099","656","368","288","51","707","1027","0","68.84","35.83"
"66","000","00","120","0002","0000","540","281","259","38","578","884","0","65.38","31.79"
"66","000","00","120","0002","0100","540","281","259","38","578","884","0","65.38","31.79"
"66","000","00","120","0003","0000","1377","709","668","98","1475","2271","0","64.95","31.22"
"66","000","00","120","0003","0101","533","295","238","28","561","851","0","65.92","34.67"
"66","000","00","120","0003","0102","844","414","430","70","914","1420","0","64.37","29.15"
"66","000","00","120","0004","0000","395","219","176","28","423","615","0","68.78","35.61"
"66","000","00","120","0004","0103","395","219","176","28","423","615","0","68.78","35.61"
"66","000","00","120","0005","0000","1008","538","470","58","1066","1679","0","63.49","32.04"
"66","000","00","120","0005","0104","498","272","226","39","537","815","0","65.89","33.37"
"66","000","00","120","0005","0105","510","266","244","19","529","864","0","61.23","30.79"
"66","000","00","120","0006","0000","908","505","403","81","989","1506","0","65.67","33.53"
"66","000","00","120","0006","0106","908","505","403","81","989","1506","0","65.67","33.53"
"66","000","00","120","0007","0000","417","214","203","28","445","656","0","67.84","32.62"
"66","000","00","120","0007","0107","417","214","203","28","445","656","0","67.84","32.62"
"66","000","00","120","0008","0000","295","156","139","1","296","366","0","80.87","42.62"
"66","000","00","120","0008","0108","295","156","139","1","296","366","0","80.87","42.62"
"66","000","00","120","0009","0000","1261","658","603","102","1363","2127","0","64.08","30.94"
"66","000","00","120","0009","0109","818","438","380","70","888","1383","0","64.21","31.67"
"66","000","00","120","0009","0110","443","220","223","32","475","744","0","63.84","29.57"
"66","000","00","120","0010","0000","5954","2990","2964","310","6264","9984","0","62.74","29.95"
"66","000","00","120","0010","0111","745","387","358","45","790","1247","0","63.35","31.03"
"66","000","00","120","0010","0112","901","457","444","55","956","1512","0","63.23","30.22"
"66","000","00","120","0010","0113","857","420","437","60","917","1556","0","58.93","26.99"
"66","000","00","120","0010","0114","810","424","386","45","855","1355","0","63.10","31.29"
"66","000","00","120","0010","0115","875","437","438","40","915","1407","0","65.03","31.06"
"66","000","00","120","0010","0116","908","446","462","42","950","1557","0","61.01","28.64"
"66","000","00","120","0010","0117","858","419","439","23","881","1350","0","65.26","31.04"
"66","000","00","120","0011","0000","885","500","385","127","1012","1415","0","71.52","35.34"
"66","000","00","120","0011","0118","885","500","385","127","1012","1415","0","71.52","35.34"
"66","000","00","120","0012","0000","816","430","386","117","933","1450","0","64.34","29.66"
"66","000","00","120","0012","0119","816","430","386","117","933","1450","0","64.34","29.66"
"66","000","00","120","0013","0000","2503","1233","1270","211","2714","4336","0","62.59","28.44"
"66","000","00","120","0013","0120","837","420","417","80","917","1473","0","62.25","28.51"
"66","000","00","120","0013","0121","963","461","502","86","1049","1639","0","64.00","28.13"
"66","000","00","120","0013","0122","703","352","351","45","748","1224","0","61.11","28.76"
"66","000","00","120","0014","0000","1903","1010","893","144","2047","3251","0","62.97","31.07"
"66","000","00","120","0014","0123","640","378","262","50","690","1122","0","61.50","33.69"
"66","000","00","120","0014","0124","805","410","395","72","877","1262","0","69.49","32.49"
"66","000","00","120","0014","0125","458","222","236","22","480","867","0","55.36","25.61"
"66","000","00","120","0015","0000","1255","656","599","129","1384","2049","0","67.55","32.02"
"66","000","00","120","0015","0126","632","346","286","84","716","1008","0","71.03","34.33"
"66","000","00","120","0015","0127","623","310","313","45","668","1041","0","64.17","29.78"
"66","000","00","120","0016","0000","3554","1945","1609","230","3784","7336","0","51.58","26.51"
"66","000","00","120","0016","0128","653","319","334","45","698","1376","0","50.73","23.18"
"66","000","00","120","0016","0129","743","411","332","54","797","1289","0","61.83","31.89"
"66","000","00","120","0016","0130","619","371","248","46","665","1177","0","56.50","31.52"
"66","000","00","120","0016","0131","695","395","300","49","744","1288","0","57.76","30.67"
"66","000","00","120","0016","0132","844","449","395","36","880","2206","0","39.89","20.35"
"66","000","00","120","0017","0000","1520","609","911","87","1607","2712","0","59.26","22.46"
"66","000","00","120","0017","0133","842","286","556","42","884","1530","0","57.78","18.69"
"66","000","00","120","0017","0134","678","323","355","45","723","1182","0","61.17","27.33"
"66","000","00","120","0018","0000","615","300","315","95","710","1224","0","58.01","24.51"
"66","000","00","120","0018","0135","615","300","315","95","710","1224","0","58.01","24.51"
"66","000","00","120","0019","0000","725","376","349","100","825","1252","0","65.89","30.03"
"66","000","00","120","0019","0136","725","376","349","100","825","1252","0","65.89","30.03"
"66","000","00","120","0020","0000","715","388","327","126","841","1180","0","71.27","32.88"
"66","000","00","120","0020","0137","715","388","327","126","841","1180","0","71.27","32.88"
"66","000","00","120","0021","0000","597","318","279","96","693","1113","0","62.26","28.57"
"66","000","00","120","0021","0138","597","318","279","96","693","1113","0","62.26","28.57"
"66","000","00","120","0022","0000","864","479","385","138","1002","1278","0","78.40","37.48"
"66","000","00","120","0022","0139","864","479","385","138","1002","1278","0","78.40","37.48"
"66","000","00","120","0023","0000","1124","621","503","145","1269","1952","0","65.01","31.81"
"66","000","00","120","0023","0140","593","328","265","75","668","1087","0","61.45","30.17"
"66","000","00","120","0023","0141","531","293","238","70","601","865","0","69.48","33.87"
"66","000","00","120","0024","0000","1254","723","531","122","1376","2158","0","63.76","33.50"
"66","000","00","120","0024","0142","653","391","262","60","713","1087","0","65.59","35.97"
"66","000","00","120","0024","0143","601","332","269","62","663","1071","0","61.90","31.00"
"66","000","00","120","0025","0000","1020","558","462","120","1140","1675","0","68.06","33.31"
"66","000","00","120","0025","0144","446","228","218","28","474","784","0","60.46","29.08"
"66","000","00","120","0025","0145","574","330","244","92","666","891","0","74.75","37.04"
"66","000","00","120","0026","0000","1163","638","525","150","1313","2372","0","55.35","26.90"
"66","000","00","120","0026","0146","660","353","307","85","745","1312","0","56.78","26.91"
"66","000","00","120","0026","0147","503","285","218","65","568","1060","0","53.58","26.89"
"66","000","00","120","0027","0000","4412","2263","2149","289","4701","7243","0","64.90","31.24"
"66","000","00","120","0027","0148","724","395","329","56","780","1269","0","61.47","31.13"
"66","000","00","120","0027","0149","897","459","438","52","949","1398","0","67.88","32.83"
"66","000","00","120","0027","0150","802","402","400","72","874","1279","0","68.33","31.43"
"66","000","00","120","0027","0151","1002","496","506","71","1073","1638","0","65.51","30.28"
"66","000","00","120","0027","0152","987","511","476","38","1025","1659","0","61.78","30.80"
"66","000","00","120","0028","0000","1648","837","811","172","1820","2667","0","68.24","31.38"
"66","000","00","120","0028","0153","737","366","371","85","822","1287","0","63.87","28.44"
"66","000","00","120","0028","0154","911","471","440","87","998","1380","0","72.32","34.13"
"66","000","00","120","0029","0000","627","330","297","76","703","1164","0","60.40","28.35"
"66","000","00","120","0029","0155","627","330","297","76","703","1164","0","60.40","28.35"
"66","000","00","120","0030","0000","621","320","301","100","721","1097","0","65.72","29.17"
"66","000","00","120","0030","0157","621","320","301","100","721","1097","0","65.72","29.17"
"66","000","00","120","0031","0000","785","419","366","125","910","1341","0","67.86","31.25"
"66","000","00","120","0031","0158","785","419","366","125","910","1341","0","67.86","31.25"
"66","000","00","120","0032","0000","821","449","372","107","928","1412","0","65.72","31.80"
"66","000","00","120","0032","0156","821","449","372","107","928","1412","0","65.72","31.80"
"66","000","00","130","0000","0000","43135","21864","21271","2822","45957","75506","96703","60.87","28.96"
"66","000","00","130","0001","0000","729","370","359","46","775","1273","0","60.88","29.07"
"66","000","00","130","0001","0199","424","226","198","26","450","728","0","61.81","31.04"
"66","000","00","130","0001","0200","305","144","161","20","325","545","0","59.63","26.42"
"66","000","00","130","0002","0000","1180","621","559","67","1247","1873","0","66.58","33.16"
"66","000","00","130","0002","0201","474","255","219","46","520","790","0","65.82","32.28"
"66","000","00","130","0002","0202","706","366","340","21","727","1083","0","67.13","33.80"
"66","000","00","130","0003","0000","528","301","227","28","556","830","0","66.99","36.27"
"66","000","00","130","0003","0203","528","301","227","28","556","830","0","66.99","36.27"
"66","000","00","130","0004","0000","277","141","136","21","298","456","0","65.35","30.92"
"66","000","00","130","0004","0204","277","141","136","21","298","456","0","65.35","30.92"
"66","000","00","130","0005","0000","1468","749","719","112","1580","2337","0","67.61","32.05"
"66","000","00","130","0005","0205","463","216","247","33","496","750","0","66.13","28.80"
"66","000","00","130","0005","0206","567","305","262","54","621","909","0","68.32","33.55"
"66","000","00","130","0005","0207","438","228","210","25","463","678","0","68.29","33.63"
"66","000","00","130","0006","0000","2694","1400","1294","206","2900","4311","0","67.27","32.48"
"66","000","00","130","0006","0211","709","351","358","53","762","1131","0","67.37","31.03"
"66","000","00","130","0006","0212","604","312","292","25","629","955","0","65.86","32.67"
"66","000","00","130","0006","0213","837","435","402","84","921","1350","0","68.22","32.22"
"66","000","00","130","0006","0214","544","302","242","44","588","875","0","67.20","34.51"
"66","000","00","130","0007","0000","3237","1724","1513","196","3433","5416","0","63.39","31.83"
"66","000","00","130","0007","0215","711","345","366","67","778","1184","0","65.71","29.14"
"66","000","00","130","0007","0216","750","417","333","40","790","1182","0","66.84","35.28"
"66","000","00","130","0007","0217","857","470","387","49","906","1483","0","61.09","31.69"
"66","000","00","130","0007","0218","919","492","427","40","959","1567","0","61.20","31.40"
"66","000","00","130","0008","0000","4082","2216","1866","209","4291","6744","0","63.63","32.86"
"66","000","00","130","0008","0219","687","400","287","59","746","1127","0","66.19","35.49"
"66","000","00","130","0008","0220","715","375","340","29","744","1170","0","63.59","32.05"
"66","000","00","130","0008","0221","672","371","301","41","713","1162","0","61.36","31.93"
"66","000","00","130","0008","0222","612","325","287","19","631","999","0","63.16","32.53"
"66","000","00","130","0008","0223","704","383","321","41","745","1174","0","63.46","32.62"
"66","000","00","130","0008","0224","692","362","330","20","712","1112","0","64.03","32.55"
"66","000","00","130","0009","0000","3964","1948","2016","274","4238","7323","0","57.87","26.60"
"66","000","00","130","0009","0225","485","222","263","35","520","926","0","56.16","23.97"
"66","000","00","130","0009","0226","476","223","253","33","509","860","0","59.19","25.93"
"66","000","00","130","0009","0227","640","317","323","49","689","1178","0","58.49","26.91"
"66","000","00","130","0009","0228","564","285","279","55","619","1084","0","57.10","26.29"
"66","000","00","130","0009","0229","578","318","260","47","625","1100","0","56.82","28.91"
"66","000","00","130","0009","0230","622","279","343","30","652","1140","0","57.19","24.47"
"66","000","00","130","0009","0231","599","304","295","25","624","1035","0","60.29","29.37"
"66","000","00","130","0010","0000","535","292","243","43","578","1065","0","54.27","27.42"
"66","000","00","130","0010","0232","535","292","243","43","578","1065","0","54.27","27.42"
"66","000","00","130","0011","0000","2730","1371","1359","180","2910","4895","0","59.45","28.01"
"66","000","00","130","0011","0236","513","246","267","51","564","974","0","57.91","25.26"
"66","000","00","130","0011","0237","523","263","260","33","556","894","0","62.19","29.42"
"66","000","00","130","0011","0238","631","322","309","46","677","1101","0","61.49","29.25"
"66","000","00","130","0011","0239","527","257","270","27","554","1022","0","54.21","25.15"
"66","000","00","130","0011","0240","536","283","253","23","559","904","0","61.84","31.31"
"66","000","00","130","0012","0000","2281","1157","1124","147","2428","3770","0","64.40","30.69"
"66","000","00","130","0012","0233","860","444","416","73","933","1366","0","68.30","32.50"
"66","000","00","130","0012","0234","650","311","339","51","701","1100","0","63.73","28.27"
"66","000","00","130","0012","0235","771","402","369","23","794","1304","0","60.89","30.83"
"66","000","00","130","0013","0000","920","462","458","95","1015","1702","0","59.64","27.14"
"66","000","00","130","0013","0241","372","202","170","47","419","662","0","63.29","30.51"
"66","000","00","130","0013","0242","548","260","288","48","596","1040","0","57.31","25.00"
"66","000","00","130","0014","0000","2925","1466","1459","174","3099","5355","0","57.87","27.38"
"66","000","00","130","0014","0243","775","412","363","56","831","1402","0","59.27","29.39"
"66","000","00","130","0014","0244","621","318","303","38","659","1225","0","53.80","25.96"
"66","000","00","130","0014","0245","740","367","373","38","778","1322","0","58.85","27.76"
"66","000","00","130","0014","0246","789","369","420","42","831","1406","0","59.10","26.24"
"66","000","00","130","0015","0000","1955","993","962","177","2132","3281","0","64.98","30.27"
"66","000","00","130","0015","0247","430","221","209","36","466","707","0","65.91","31.26"
"66","000","00","130","0015","0248","478","244","234","60","538","829","0","64.90","29.43"
"66","000","00","130","0015","0249","589","299","290","31","620","999","0","62.06","29.93"
"66","000","00","130","0015","0250","458","229","229","50","508","746","0","68.10","30.70"
"66","000","00","130","0016","0000","3189","1537","1652","170","3359","5771","0","58.20","26.63"
"66","000","00","130","0016","0251","672","342","330","51","723","1288","0","56.13","26.55"
"66","000","00","130","0016","0252","543","265","278","20","563","999","0","56.36","26.53"
"66","000","00","130","0016","0253","583","283","300","48","631","1117","0","56.49","25.34"
"66","000","00","130","0016","0254","659","326","333","36","695","1101","0","63.12","29.61"
"66","000","00","130","0016","0255","732","321","411","15","747","1266","0","59.00","25.36"
"66","000","00","130","0017","0000","2322","1121","1201","140","2462","4231","0","58.19","26.49"
"66","000","00","130","0017","0262","720","394","326","38","758","1299","0","58.35","30.33"
"66","000","00","130","0017","0263","466","179","287","29","495","935","0","52.94","19.14"
"66","000","00","130","0017","0264","498","230","268","27","525","907","0","57.88","25.36"
"66","000","00","130","0017","0265","638","318","320","46","684","1090","0","62.75","29.17"
"66","000","00","130","0018","0000","1292","564","728","71","1363","2232","0","61.07","25.27"
"66","000","00","130","0018","0266","685","302","383","50","735","1202","0","61.15","25.12"
"66","000","00","130","0018","0267","607","262","345","21","628","1030","0","60.97","25.44"
"66","000","00","130","0019","0000","1134","584","550","101","1235","2035","0","60.69","28.70"
"66","000","00","130","0019","0268","542","294","248","59","601","1061","0","56.64","27.71"
"66","000","00","130","0019","0269","592","290","302","42","634","974","0","65.09","29.77"
"66","000","00","130","0020","0000","1986","1064","922","159","2145","3295","0","65.10","32.29"
"66","000","00","130","0020","0208","793","433","360","72","865","1278","0","67.68","33.88"
"66","000","00","130","0020","0209","662","340","322","51","713","1081","0","65.96","31.45"
"66","000","00","130","0020","0210","531","291","240","36","567","936","0","60.58","31.09"
"66","000","00","130","0021","0000","3707","1783","1924","206","3913","7311","0","53.52","24.39"
"66","000","00","130","0021","0256","744","393","351","50","794","1405","0","56.51","27.97"
"66","000","00","130","0021","0257","657","346","311","20","677","1299","0","52.12","26.64"
"66","000","00","130","0021","0258","640","264","376","67","707","1119","0","63.18","23.59"
"66","000","00","130","0021","0259","527","255","272","21","548","1032","0","53.10","24.71"
"66","000","00","130","0021","0260","385","176","209","21","406","869","0","46.72","20.25"
"66","000","00","130","0021","0261","754","349","405","27","781","1587","0","49.21","21.99"
"66","000","00","140","0000","0000","26874","14026","12848","2106","28980","47727","59685","60.72","29.39"
"66","000","00","140","0001","0000","1810","921","889","133","1943","3515","0","55.28","26.20"
"66","000","00","140","0001","0159","552","240","312","39","591","1061","0","55.70","22.62"
"66","000","00","140","0001","0160","595","330","265","44","639","1204","0","53.07","27.41"
"66","000","00","140","0001","0161","663","351","312","50","713","1250","0","57.04","28.08"
"66","000","00","140","0002","0000","1156","646","510","103","1259","1905","0","66.09","33.91"
"66","000","00","140","0002","0162","651","384","267","48","699","1075","0","65.02","35.72"
"66","000","00","140","0002","0163","505","262","243","55","560","830","0","67.47","31.57"
"66","000","00","140","0003","0000","2131","1042","1089","171","2302","3709","0","62.07","28.09"
"66","000","00","140","0003","0164","564","280","284","60","624","960","0","65.00","29.17"
"66","000","00","140","0003","0165","835","400","435","50","885","1440","0","61.46","27.78"
"66","000","00","140","0003","0166","732","362","370","61","793","1309","0","60.58","27.65"
"66","000","00","140","0004","0000","291","164","127","29","320","468","0","68.38","35.04"
"66","000","00","140","0004","0167","291","164","127","29","320","468","0","68.38","35.04"
"66","000","00","140","0005","0000","692","362","330","64","756","1105","0","68.42","32.76"
"66","000","00","140","0005","0168","692","362","330","64","756","1105","0","68.42","32.76"
"66","000","00","140","0006","0000","435","215","220","39","474","743","0","63.80","28.94"
"66","000","00","140","0006","0169","435","215","220","39","474","743","0","63.80","28.94"
"66","000","00","140","0007","0000","3345","1712","1633","284","3629","5934","0","61.16","28.85"
"66","000","00","140","0007","0170","521","257","264","62","583","1014","0","57.50","25.35"
"66","000","00","140","0007","0171","758","380","378","58","816","1252","0","65.18","30.35"
"66","000","00","140","0007","0172","520","290","230","30","550","945","0","58.20","30.69"
"66","000","00","140","0007","0173","768","377","391","81","849","1337","0","63.50","28.20"
"66","000","00","140","0007","0174","778","408","370","53","831","1386","0","59.96","29.44"
"66","000","00","140","0008","0000","3049","1656","1393","210","3259","5378","0","60.60","30.79"
"66","000","00","140","0008","0175","804","466","338","95","899","1343","0","66.94","34.70"
"66","000","00","140","0008","0176","713","375","338","34","747","1262","0","59.19","29.71"
"66","000","00","140","0008","0177","687","376","311","42","729","1301","0","56.03","28.90"
"66","000","00","140","0008","0178","845","439","406","39","884","1472","0","60.05","29.82"
"66","000","00","140","0009","0000","2927","1545","1382","145","3072","5002","0","61.42","30.89"
"66","000","00","140","0009","0179","744","394","350","55","799","1236","0","64.64","31.88"
"66","000","00","140","0009","0180","673","358","315","51","724","1225","0","59.10","29.22"
"66","000","00","140","0009","0181","787","415","372","18","805","1264","0","63.69","32.83"
"66","000","00","140","0009","0182","723","378","345","21","744","1277","0","58.26","29.60"
"66","000","00","140","0010","0000","4239","2181","2058","333","4572","7448","0","61.39","29.28"
"66","000","00","140","0010","0183","572","294","278","37","609","937","0","64.99","31.38"
"66","000","00","140","0010","0184","726","392","334","65","791","1271","0","62.23","30.84"
"66","000","00","140","0010","0185","816","439","377","53","869","1491","0","58.28","29.44"
"66","000","00","140","0010","0186","626","318","308","65","691","1140","0","60.61","27.89"
"66","000","00","140","0010","0187","713","346","367","67","780","1184","0","65.88","29.22"
"66","000","00","140","0010","0188","786","392","394","46","832","1425","0","58.39","27.51"
"66","000","00","140","0011","0000","3097","1605","1492","238","3335","5519","0","60.43","29.08"
"66","000","00","140","0011","0189","782","420","362","49","831","1414","0","58.77","29.70"
"66","000","00","140","0011","0190","745","367","378","60","805","1298","0","62.02","28.27"
"66","000","00","140","0011","0191","679","351","328","67","746","1232","0","60.55","28.49"
"66","000","00","140","0011","0192","891","467","424","62","953","1575","0","60.51","29.65"
"66","000","00","140","0012","0000","1231","626","605","112","1343","2373","0","56.60","26.38"
"66","000","00","140","0012","0193","532","273","259","73","605","983","0","61.55","27.77"
"66","000","00","140","0012","0194","699","353","346","39","738","1390","0","53.09","25.40"
"66","000","00","140","0013","0000","1194","654","540","131","1325","2198","0","60.28","29.75"
"66","000","00","140","0013","0195","527","289","238","42","569","1043","0","54.55","27.71"
"66","000","00","140","0013","0196","667","365","302","89","756","1155","0","65.45","31.60"
"66","000","00","140","0014","0000","1277","697","580","114","1391","2430","0","57.24","28.68"
"66","000","00","140","0014","0197","715","375","340","63","778","1379","0","56.42","27.19"
"66","000","00","140","0014","0198","562","322","240","51","613","1051","0","58.33","30.64"
"66","000","00","150","0000","0000","25058","12434","12624","2229","27287","43735","53640","62.39","28.43"
"66","000","00","150","0001","0000","1024","461","563","100","1124","1989","0","56.51","23.18"
"66","000","00","150","0001","0410","441","231","210","39","480","832","0","57.69","27.76"
"66","000","00","150","0001","0411","583","230","353","61","644","1157","0","55.66","19.88"
"66","000","00","150","0002","0000","567","277","290","83","650","991","0","65.59","27.95"
"66","000","00","150","0002","0412","567","277","290","83","650","991","0","65.59","27.95"
"66","000","00","150","0003","0000","1715","823","892","93","1808","2986","0","60.55","27.56"
"66","000","00","150","0003","0413","612","324","288","31","643","1091","0","58.94","29.70"
"66","000","00","150","0003","0414","571","255","316","36","607","985","0","61.62","25.89"
"66","000","00","150","0003","0415","532","244","288","26","558","910","0","61.32","26.81"
"66","000","00","150","0004","0000","2112","1012","1100","186","2298","3537","0","64.97","28.61"
"66","000","00","150","0004","0418","697","344","353","64","761","1119","0","68.01","30.74"
"66","000","00","150","0004","0419","677","332","345","53","730","1115","0","65.47","29.78"
"66","000","00","150","0004","0420","738","336","402","69","807","1303","0","61.93","25.79"
"66","000","00","150","0005","0000","1211","614","597","141","1352","2100","0","64.38","29.24"
"66","000","00","150","0005","0421","561","283","278","49","610","963","0","63.34","29.39"
"66","000","00","150","0005","0422","650","331","319","92","742","1137","0","65.26","29.11"
"66","000","00","150","0006","0000","2711","1320","1391","205","2916","4583","0","63.63","28.80"
"66","000","00","150","0006","0423","626","304","322","66","692","1132","0","61.13","26.86"
"66","000","00","150","0006","0424","711","340","371","38","749","1119","0","66.93","30.38"
"66","000","00","150","0006","0425","715","341","374","51","766","1221","0","62.74","27.93"
"66","000","00","150","0006","0426","659","335","324","50","709","1111","0","63.82","30.15"
"66","000","00","150","0007","0000","1005","533","472","94","1099","1873","0","58.68","28.46"
"66","000","00","150","0007","0427","483","242","241","50","533","937","0","56.88","25.83"
"66","000","00","150","0007","0428","522","291","231","44","566","936","0","60.47","31.09"
"66","000","00","150","0008","0000","1727","887","840","137","1864","3277","0","56.88","27.07"
"66","000","00","150","0008","0429","655","322","333","45","700","1167","0","59.98","27.59"
"66","000","00","150","0008","0430","591","306","285","55","646","1119","0","57.73","27.35"
"66","000","00","150","0008","0431","481","259","222","37","518","991","0","52.27","26.14"
"66","000","00","150","0009","0000","2039","965","1074","141","2180","3424","0","63.67","28.18"
"66","000","00","150","0009","0432","762","329","433","45","807","1250","0","64.56","26.32"
"66","000","00","150","0009","0433","626","307","319","46","672","1063","0","63.22","28.88"
"66","000","00","150","0009","0434","651","329","322","50","701","1111","0","63.10","29.61"
"66","000","00","150","0010","0000","1356","695","661","107","1463","2307","0","63.42","30.13"
"66","000","00","150","0010","0435","693","364","329","65","758","1163","0","65.18","31.30"
"66","000","00","150","0010","0436","663","331","332","42","705","1144","0","61.63","28.93"
"66","000","00","150","0011","0000","1403","679","724","151","1554","2164","0","71.81","31.38"
"66","000","00","150","0011","0437","772","377","395","83","855","1166","0","73.33","32.33"
"66","000","00","150","0011","0438","631","302","329","68","699","998","0","70.04","30.26"
"66","000","00","150","0012","0000","814","425","389","81","895","1524","0","58.73","27.89"
"66","000","00","150","0012","0439","365","178","187","22","387","693","0","55.84","25.69"
"66","000","00","150","0012","0440","449","247","202","59","508","831","0","61.13","29.72"
"66","000","00","150","0013","0000","1198","600","598","128","1326","2040","0","65.00","29.41"
"66","000","00","150","0013","0441","616","311","305","91","707","1010","0","70.00","30.79"
"66","000","00","150","0013","0442","582","289","293","37","619","1030","0","60.10","28.06"
"66","000","00","150","0014","0000","1902","921","981","163","2065","3126","0","66.06","29.46"
"66","000","00","150","0014","0443","672","327","345","61","733","1094","0","67.00","29.89"
"66","000","00","150","0014","0444","674","343","331","46","720","1097","0","65.63","31.27"
"66","000","00","150","0014","0445","556","251","305","56","612","935","0","65.45","26.84"
"66","000","00","150","0015","0000","778","390","388","67","845","1372","0","61.59","28.43"
"66","000","00","150","0015","0450","778","390","388","67","845","1372","0","61.59","28.43"
"66","000","00","150","0016","0000","1085","606","479","120","1205","2080","0","57.93","29.13"
"66","000","00","150","0016","0448","557","317","240","48","605","1011","0","59.84","31.36"
"66","000","00","150","0016","0449","528","289","239","72","600","1069","0","56.13","27.03"
"66","000","00","150","0017","0000","1109","604","505","77","1186","1893","0","62.65","31.91"
"66","000","00","150","0017","0446","589","328","261","37","626","948","0","66.03","34.60"
"66","000","00","150","0017","0447","520","276","244","40","560","945","0","59.26","29.21"
"66","000","00","150","0018","0000","1302","622","680","155","1457","2469","0","59.01","25.19"
"66","000","00","150","0018","0416","654","297","357","83","737","1322","0","55.75","22.47"
"66","000","00","150","0018","0417","648","325","323","72","720","1147","0","62.77","28.33"
"66","000","00","160","0000","0000","30529","16614","13915","2272","32801","53074","64299","61.80","31.30"
"66","000","00","160","0001","0000","1641","859","782","129","1770","3040","0","58.22","28.26"
"66","000","00","160","0001","0560","582","309","273","48","630","1024","0","61.52","30.18"
"66","000","00","160","0001","0561","544","272","272","46","590","936","0","63.03","29.06"
"66","000","00","160","0001","0562","515","278","237","35","550","1080","0","50.93","25.74"
"66","000","00","160","0002","0000","1425","711","714","113","1538","2207","0","69.69","32.22"
"66","000","00","160","0002","0563","764","389","375","60","824","1195","0","68.95","32.55"
"66","000","00","160","0002","0564","661","322","339","53","714","1012","0","70.55","31.82"
"66","000","00","160","0003","0000","1534","803","731","127","1661","2533","0","65.57","31.70"
"66","000","00","160","0003","0565","775","402","373","62","837","1284","0","65.19","31.31"
"66","000","00","160","0003","0566","759","401","358","65","824","1249","0","65.97","32.11"
"66","000","00","160","0004","0000","1375","805","570","115","1490","2156","0","69.11","37.34"
"66","000","00","160","0004","0567","713","447","266","62","775","1119","0","69.26","39.95"
"66","000","00","160","0004","0568","662","358","304","53","715","1037","0","68.95","34.52"
"66","000","00","160","0005","0000","4204","2222","1982","285","4489","7388","0","60.76","30.08"
"66","000","00","160","0005","0577","677","341","336","59","736","1288","0","57.14","26.48"
"66","000","00","160","0005","0578","730","389","341","49","779","1236","0","63.03","31.47"
"66","000","00","160","0005","0579","825","407","418","32","857","1384","0","61.92","29.41"
"66","000","00","160","0005","0580","622","325","297","56","678","1113","0","60.92","29.20"
"66","000","00","160","0005","0581","665","395","270","44","709","1192","0","59.48","33.14"
"66","000","00","160","0005","0582","685","365","320","45","730","1175","0","62.13","31.06"
"66","000","00","160","0006","0000","2935","1638","1297","179","3114","5042","0","61.76","32.49"
"66","000","00","160","0006","0583","745","409","336","66","811","1362","0","59.54","30.03"
"66","000","00","160","0006","0584","650","365","285","39","689","1065","0","64.69","34.27"
"66","000","00","160","0006","0585","844","476","368","35","879","1413","0","62.21","33.69"
"66","000","00","160","0006","0586","696","388","308","39","735","1202","0","61.15","32.28"
"66","000","00","160","0007","0000","1424","814","610","83","1507","2456","0","61.36","33.14"
"66","000","00","160","0007","0587","667","387","280","41","708","1131","0","62.60","34.22"
"66","000","00","160","0007","0588","757","427","330","42","799","1325","0","60.30","32.23"
"66","000","00","160","0008","0000","1466","798","668","99","1565","2759","0","56.72","28.92"
"66","000","00","160","0008","0593","783","416","367","49","832","1409","0","59.05","29.52"
"66","000","00","160","0008","0594","683","382","301","50","733","1350","0","54.30","28.30"
"66","000","00","160","0009","0000","2372","1248","1124","119","2491","4334","0","57.48","28.80"
"66","000","00","160","0009","0589","729","404","325","31","760","1181","0","64.35","34.21"
"66","000","00","160","0009","0590","605","312","293","37","642","1086","0","59.12","28.73"
"66","000","00","160","0009","0591","470","239","231","20","490","924","0","53.03","25.87"
"66","000","00","160","0009","0592","568","293","275","31","599","1143","0","52.41","25.63"
"66","000","00","160","0010","0000","3746","1982","1764","240","3986","6868","0","58.04","28.86"
"66","000","00","160","0010","0595","671","332","339","35","706","1249","0","56.53","26.58"
"66","000","00","160","0010","0596","615","322","293","52","667","1232","0","54.14","26.14"
"66","000","00","160","0010","0597","556","319","237","47","603","1018","0","59.23","31.34"
"66","000","00","160","0010","0598","688","374","314","41","729","1233","0","59.12","30.33"
"66","000","00","160","0010","0599","535","275","260","27","562","980","0","57.35","28.06"
"66","000","00","160","0010","0600","681","360","321","38","719","1156","0","62.20","31.14"
"66","000","00","160","0011","0000","1513","835","678","122","1635","2431","0","67.26","34.35"
"66","000","00","160","0011","0601","710","405","305","75","785","1163","0","67.50","34.82"
"66","000","00","160","0011","0602","803","430","373","47","850","1268","0","67.03","33.91"
"66","000","00","160","0012","0000","1548","889","659","164","1712","2703","0","63.34","32.89"
"66","000","00","160","0012","0603","791","444","347","92","883","1426","0","61.92","31.14"
"66","000","00","160","0012","0604","757","445","312","72","829","1277","0","64.92","34.85"
"66","000","00","160","0013","0000","1175","632","543","112","1287","2183","0","58.96","28.95"
"66","000","00","160","0013","0569","697","386","311","74","771","1207","0","63.88","31.98"
"66","000","00","160","0013","0570","478","246","232","38","516","976","0","52.87","25.20"
"66","000","00","160","0014","0000","2345","1364","981","214","2559","3984","0","64.23","34.24"
"66","000","00","160","0014","0573","808","462","346","77","885","1358","0","65.17","34.02"
"66","000","00","160","0014","0574","797","461","336","67","864","1338","0","64.57","34.45"
"66","000","00","160","0014","0575","740","441","299","70","810","1288","0","62.89","34.24"
"66","000","00","160","0015","0000","1235","655","580","115","1350","2008","0","67.23","32.62"
"66","000","00","160","0015","0571","586","320","266","60","646","906","0","71.30","35.32"
"66","000","00","160","0015","0572","649","335","314","55","704","1102","0","63.88","30.40"
"66","000","00","160","0016","0000","591","359","232","56","647","982","0","65.89","36.56"
"66","000","00","160","0016","0576","591","359","232","56","647","982","0","65.89","36.56"
"66","000","00","170","0000","0000","48341","24709","23632","2455","50796","88782","108570","57.21","27.83"
"66","000","00","170","0001","0000","5634","2917","2717","232","5866","10566","0","55.52","27.61"
"66","000","00","170","0001","0663","696","353","343","34","730","1293","0","56.46","27.30"
"66","000","00","170","0001","0664","637","316","321","26","663","1221","0","54.30","25.88"
"66","000","00","170","0001","0665","618","342","276","30","648","1232","0","52.60","27.76"
"66","000","00","170","0001","0666","581","301","280","15","596","1042","0","57.20","28.89"
"66","000","00","170","0001","0667","575","298","277","17","592","1133","0","52.25","26.30"
"66","000","00","170","0001","0668","724","366","358","23","747","1401","0","53.32","26.12"
"66","000","00","170","0001","0669","500","264","236","22","522","915","0","57.05","28.85"
"66","000","00","170","0001","0670","739","396","343","29","768","1329","0","57.79","29.80"
"66","000","00","170","0001","0671","564","281","283","36","600","1000","0","60.00","28.10"
"66","000","00","170","0002","0000","769","437","332","57","826","1197","0","69.01","36.51"
"66","000","00","170","0002","0660","769","437","332","57","826","1197","0","69.01","36.51"
"66","000","00","170","0003","0000","1276","636","640","77","1353","2352","0","57.53","27.04"
"66","000","00","170","0003","0661","610","310","300","40","650","1108","0","58.66","27.98"
"66","000","00","170","0003","0662","666","326","340","37","703","1244","0","56.51","26.21"
"66","000","00","170","0004","0000","5551","2661","2890","288","5839","10313","0","56.62","25.80"
"66","000","00","170","0004","0672","853","395","458","55","908","1451","0","62.58","27.22"
"66","000","00","170","0004","0673","798","392","406","46","844","1391","0","60.68","28.18"
"66","000","00","170","0004","0674","791","393","398","52","843","1402","0","60.13","28.03"
"66","000","00","170","0004","0675","585","270","315","19","604","1059","0","57.03","25.50"
"66","000","00","170","0004","0676","693","328","365","41","734","1296","0","56.64","25.31"
"66","000","00","170","0004","0677","618","297","321","20","638","1326","0","48.11","22.40"
"66","000","00","170","0004","0678","640","292","348","34","674","1282","0","52.57","22.78"
"66","000","00","170","0004","0679","573","294","279","21","594","1106","0","53.71","26.58"
"66","000","00","170","0005","0000","2788","1370","1418","119","2907","5236","0","55.52","26.17"
"66","000","00","170","0005","0680","863","433","430","41","904","1527","0","59.20","28.36"
"66","000","00","170","0005","0681","636","319","317","29","665","1218","0","54.60","26.19"
"66","000","00","170","0005","0682","665","337","328","22","687","1284","0","53.50","26.25"
"66","000","00","170","0005","0683","624","281","343","27","651","1207","0","53.94","23.28"
"66","000","00","170","0006","0000","4826","2467","2359","195","5021","9147","0","54.89","26.97"
"66","000","00","170","0006","0698","759","357","402","29","788","1380","0","57.10","25.87"
"66","000","00","170","0006","0699","740","387","353","47","787","1271","0","61.92","30.45"
"66","000","00","170","0006","0700","682","349","333","36","718","1360","0","52.79","25.66"
"66","000","00","170","0006","0701","604","307","297","16","620","1272","0","48.74","24.14"
"66","000","00","170","0006","0702","757","429","328","25","782","1375","0","56.87","31.20"
"66","000","00","170","0006","0703","634","318","316","24","658","1255","0","52.43","25.34"
"66","000","00","170","0006","0704","650","320","330","18","668","1234","0","54.13","25.93"
"66","000","00","170","0007","0000","6475","3379","3096","309","6784","11711","0","57.93","28.85"
"66","000","00","170","0007","0705","767","404","363","32","799","1397","0","57.19","28.92"
"66","000","00","170","0007","0706","731","368","363","32","763","1201","0","63.53","30.64"
"66","000","00","170","0007","0707","756","395","361","28","784","1304","0","60.12","30.29"
"66","000","00","170","0007","0708","675","381","294","35","710","1191","0","59.61","31.99"
"66","000","00","170","0007","0709","805","425","380","49","854","1430","0","59.72","29.72"
"66","000","00","170","0007","0710","755","406","349","53","808","1424","0","56.74","28.51"
"66","000","00","170","0007","0711","737","386","351","26","763","1258","0","60.65","30.68"
"66","000","00","170","0007","0712","600","304","296","30","630","1337","0","47.12","22.74"
"66","000","00","170","0007","0713","649","310","339","24","673","1169","0","57.57","26.52"
"66","000","00","170","0008","0000","1567","856","711","101","1668","2808","0","59.40","30.48"
"66","000","00","170","0008","0714","842","477","365","53","895","1473","0","60.76","32.38"
"66","000","00","170","0008","0715","725","379","346","48","773","1335","0","57.90","28.39"
"66","000","00","170","0009","0000","3322","1778","1544","181","3503","5876","0","59.62","30.26"
"66","000","00","170","0009","0716","809","410","399","29","838","1457","0","57.52","28.14"
"66","000","00","170","0009","0717","785","440","345","52","837","1444","0","57.96","30.47"
"66","000","00","170","0009","0718","871","443","428","58","929","1515","0","61.32","29.24"
"66","000","00","170","0009","0719","857","485","372","42","899","1460","0","61.58","33.22"
"66","000","00","170","0010","0000","2651","1406","1245","148","2799","4675","0","59.87","30.07"
"66","000","00","170","0010","0720","653","346","307","25","678","1212","0","55.94","28.55"
"66","000","00","170","0010","0721","711","426","285","46","757","1216","0","62.25","35.03"
"66","000","00","170","0010","0722","677","338","339","35","712","1169","0","60.91","28.91"
"66","000","00","170","0010","0723","610","296","314","42","652","1078","0","60.48","27.46"
"66","000","00","170","0011","0000","2095","1131","964","176","2271","3866","0","58.74","29.26"
"66","000","00","170","0011","0724","566","345","221","49","615","1055","0","58.29","32.70"
"66","000","00","170","0011","0725","457","247","210","34","491","805","0","60.99","30.68"
"66","000","00","170","0011","0726","555","289","266","59","614","1011","0","60.73","28.59"
"66","000","00","170","0011","0727","517","250","267","34","551","995","0","55.38","25.13"
"66","000","00","170","0012","0000","777","433","344","33","810","1494","0","54.22","28.98"
"66","000","00","170","0012","0728","777","433","344","33","810","1494","0","54.22","28.98"
"66","000","00","170","0013","0000","2203","1130","1073","142","2345","4172","0","56.21","27.09"
"66","000","00","170","0013","0729","824","439","385","54","878","1410","0","62.27","31.13"
"66","000","00","170","0013","0730","762","385","377","49","811","1354","0","59.90","28.43"
"66","000","00","170","0013","0731","617","306","311","39","656","1408","0","46.59","21.73"
"66","000","00","170","0014","0000","2305","1111","1194","138","2443","4191","0","58.29","26.51"
"66","000","00","170","0014","0684","664","314","350","37","701","1279","0","54.81","24.55"
"66","000","00","170","0014","0685","741","329","412","55","796","1208","0","65.89","27.24"
"66","000","00","170","0014","0686","343","185","158","26","369","658","0","56.08","28.12"
"66","000","00","170","0014","0687","557","283","274","20","577","1046","0","55.16","27.06"
"66","000","00","170","0015","0000","3536","1730","1806","134","3670","6652","0","55.17","26.01"
"66","000","00","170","0015","0688","624","311","313","34","658","1309","0","50.27","23.76"
"66","000","00","170","0015","0689","563","257","306","24","587","1012","0","58.00","25.40"
"66","000","00","170","0015","0690","554","277","277","28","582","929","0","62.65","29.82"
"66","000","00","170","0015","0691","613","295","318","18","631","1105","0","57.10","26.70"
"66","000","00","170","0015","0692","587","282","305","7","594","1136","0","52.29","24.82"
"66","000","00","170","0015","0693","595","308","287","23","618","1161","0","53.23","26.53"
"66","000","00","170","0016","0000","2566","1267","1299","125","2691","4526","0","59.46","27.99"
"66","000","00","170","0016","0694","824","411","413","30","854","1388","0","61.53","29.61"
"66","000","00","170","0016","0695","647","315","332","44","691","1191","0","58.02","26.45"
"66","000","00","170","0016","0696","480","233","247","25","505","858","0","58.86","27.16"
"66","000","00","170","0016","0697","615","308","307","26","641","1089","0","58.86","28.28"
"66","000","00","180","0000","0000","41715","20817","20898","2786","44501","76234","95154","58.37","27.31"
"66","000","00","180","0001","0000","2307","1086","1221","153","2460","4160","0","59.13","26.11"
"66","000","00","180","0001","0609","797","359","438","52","849","1372","0","61.88","26.17"
"66","000","00","180","0001","0610","775","358","417","53","828","1408","0","58.81","25.43"
"66","000","00","180","0001","0611","735","369","366","48","783","1380","0","56.74","26.74"
"66","000","00","180","0002","0000","5412","2726","2686","382","5794","8974","0","64.56","30.38"
"66","000","00","180","0002","0641","914","472","442","59","973","1543","0","63.06","30.59"
"66","000","00","180","0002","0642","915","453","462","50","965","1482","0","65.11","30.57"
"66","000","00","180","0002","0643","805","418","387","59","864","1400","0","61.71","29.86"
"66","000","00","180","0002","0644","952","437","515","67","1019","1504","0","67.75","29.06"
"66","000","00","180","0002","0645","909","480","429","81","990","1533","0","64.58","31.31"
"66","000","00","180","0002","0646","917","466","451","66","983","1512","0","65.01","30.82"
"66","000","00","180","0003","0000","3260","1598","1662","230","3490","5977","0","58.39","26.74"
"66","000","00","180","0003","0647","799","365","434","66","865","1584","0","54.61","23.04"
"66","000","00","180","0003","0648","895","461","434","78","973","1567","0","62.09","29.42"
"66","000","00","180","0003","0649","725","342","383","46","771","1364","0","56.52","25.07"
"66","000","00","180","0003","0650","841","430","411","40","881","1462","0","60.26","29.41"
"66","000","00","180","0004","0000","2069","1076","993","177","2246","3278","0","68.52","32.82"
"66","000","00","180","0004","0651","630","313","317","38","668","1014","0","65.88","30.87"
"66","000","00","180","0004","0652","694","373","321","73","767","1136","0","67.52","32.83"
"66","000","00","180","0004","0653","745","390","355","66","811","1128","0","71.90","34.57"
"66","000","00","180","0005","0000","1909","783","1126","188","2097","3486","0","60.15","22.46"
"66","000","00","180","0005","0657","606","223","383","88","694","1219","0","56.93","18.29"
"66","000","00","180","0005","0658","601","277","324","41","642","1039","0","61.79","26.66"
"66","000","00","180","0005","0659","702","283","419","59","761","1228","0","61.97","23.05"
"66","000","00","180","0006","0000","2245","1110","1135","166","2411","4174","0","57.76","26.59"
"66","000","00","180","0006","0654","755","372","383","67","822","1374","0","59.83","27.07"
"66","000","00","180","0006","0655","837","439","398","44","881","1514","0","58.19","29.00"
"66","000","00","180","0006","0656","653","299","354","55","708","1286","0","55.05","23.25"
"66","000","00","180","0007","0000","2698","1405","1293","150","2848","5139","0","55.42","27.34"
"66","000","00","180","0007","0616","665","342","323","59","724","1255","0","57.69","27.25"
"66","000","00","180","0007","0617","771","418","353","38","809","1447","0","55.91","28.89"
"66","000","00","180","0007","0618","597","329","268","40","637","1159","0","54.96","28.39"
"66","000","00","180","0007","0619","665","316","349","13","678","1278","0","53.05","24.73"
"66","000","00","180","0008","0000","2285","1187","1098","140","2425","4674","0","51.88","25.40"
"66","000","00","180","0008","0627","761","392","369","60","821","1636","0","50.18","23.96"
"66","000","00","180","0008","0628","803","418","385","49","852","1543","0","55.22","27.09"
"66","000","00","180","0008","0629","721","377","344","31","752","1495","0","50.30","25.22"
"66","000","00","180","0009","0000","3213","1679","1534","213","3426","6167","0","55.55","27.23"
"66","000","00","180","0009","0630","787","395","392","36","823","1549","0","53.13","25.50"
"66","000","00","180","0009","0631","768","415","353","46","814","1466","0","55.53","28.31"
"66","000","00","180","0009","0632","794","427","367","80","874","1513","0","57.77","28.22"
"66","000","00","180","0009","0633","864","442","422","51","915","1639","0","55.83","26.97"
"66","000","00","180","0010","0000","3219","1593","1626","185","3404","5795","0","58.74","27.49"
"66","000","00","180","0010","0620","784","402","382","39","823","1385","0","59.42","29.03"
"66","000","00","180","0010","0621","820","437","383","53","873","1539","0","56.73","28.40"
"66","000","00","180","0010","0622","788","372","416","59","847","1379","0","61.42","26.98"
"66","000","00","180","0010","0623","827","382","445","34","861","1492","0","57.71","25.60"
"66","000","00","180","0011","0000","2283","1132","1151","104","2387","4419","0","54.02","25.62"
"66","000","00","180","0011","0624","760","385","375","26","786","1501","0","52.37","25.65"
"66","000","00","180","0011","0625","743","361","382","37","780","1430","0","54.55","25.24"
"66","000","00","180","0011","0626","780","386","394","41","821","1488","0","55.17","25.94"
"66","000","00","180","0012","0000","3113","1645","1468","203","3316","5912","0","56.09","27.82"
"66","000","00","180","0012","0605","865","416","449","55","920","1560","0","58.97","26.67"
"66","000","00","180","0012","0606","789","427","362","53","842","1404","0","59.97","30.41"
"66","000","00","180","0012","0607","706","379","327","39","745","1502","0","49.60","25.23"
"66","000","00","180","0012","0608","753","423","330","56","809","1446","0","55.95","29.25"
"66","000","00","180","0013","0000","3351","1627","1724","199","3550","5815","0","61.05","27.98"
"66","000","00","180","0013","0612","836","387","449","49","885","1519","0","58.26","25.48"
"66","000","00","180","0013","0613","837","387","450","61","898","1461","0","61.46","26.49"
"66","000","00","180","0013","0614","842","421","421","34","876","1445","0","60.62","29.13"
"66","000","00","180","0013","0615","836","432","404","55","891","1390","0","64.10","31.08"
"66","000","00","180","0014","0000","2603","1323","1280","189","2792","4854","0","57.52","27.26"
"66","000","00","180","0014","0634","606","306","300","47","653","1289","0","50.66","23.74"
"66","000","00","180","0014","0635","670","335","335","48","718","1235","0","58.14","27.13"
"66","000","00","180","0014","0636","641","298","343","46","687","1150","0","59.74","25.91"
"66","000","00","180","0014","0637","686","384","302","48","734","1180","0","62.20","32.54"
"66","000","00","180","0015","0000","1748","847","901","107","1855","3410","0","54.40","24.84"
"66","000","00","180","0015","0638","556","261","295","30","586","1084","0","54.06","24.08"
"66","000","00","180","0015","0639","578","272","306","24","602","1060","0","56.79","25.66"
"66","000","00","180","0015","0640","614","314","300","53","667","1266","0","52.69","24.80"
"66","000","00","190","0000","0000","11466","5888","5578","1322","12788","19892","23327","64.29","29.60"
"66","000","00","190","0001","0000","1734","838","896","110","1844","3168","0","58.21","26.45"
"66","000","00","190","0001","1841","592","281","311","48","640","1014","0","63.12","27.71"
"66","000","00","190","0001","1842","553","280","273","21","574","1116","0","51.43","25.09"
"66","000","00","190","0001","1843","589","277","312","41","630","1038","0","60.69","26.69"
"66","000","00","190","0002","0000","906","458","448","74","980","1743","0","56.22","26.28"
"66","000","00","190","0002","1844","458","240","218","36","494","889","0","55.57","27.00"
"66","000","00","190","0002","1845","448","218","230","38","486","854","0","56.91","25.53"
"66","000","00","190","0003","0000","753","364","389","90","843","1309","0","64.40","27.81"
"66","000","00","190","0003","1846","753","364","389","90","843","1309","0","64.40","27.81"
"66","000","00","190","0004","0000","537","306","231","50","587","968","0","60.64","31.61"
"66","000","00","190","0004","1847","537","306","231","50","587","968","0","60.64","31.61"
"66","000","00","190","0005","0000","707","430","277","106","813","1096","0","74.18","39.23"
"66","000","00","190","0005","1848","707","430","277","106","813","1096","0","74.18","39.23"
"66","000","00","190","0006","0000","1100","525","575","101","1201","1786","0","67.25","29.40"
"66","000","00","190","0006","1849","558","265","293","61","619","942","0","65.71","28.13"
"66","000","00","190","0006","1850","542","260","282","40","582","844","0","68.96","30.81"
"66","000","00","190","0007","0000","1736","943","793","249","1985","2859","0","69.43","32.98"
"66","000","00","190","0007","1851","640","313","327","61","701","1021","0","68.66","30.66"
"66","000","00","190","0007","1852","600","324","276","127","727","1007","0","72.19","32.17"
"66","000","00","190","0007","1853","496","306","190","61","557","831","0","67.03","36.82"
"66","000","00","190","0008","0000","394","159","235","45","439","570","0","77.02","27.89"
"66","000","00","190","0008","1854","394","159","235","45","439","570","0","77.02","27.89"
"66","000","00","190","0009","0000","1459","808","651","215","1674","2789","0","60.02","28.97"
"66","000","00","190","0009","1855","509","271","238","80","589","965","0","61.04","28.08"
"66","000","00","190","0009","1856","456","289","167","62","518","865","0","59.88","33.41"
"66","000","00","190","0009","1857","494","248","246","73","567","959","0","59.12","25.86"
"66","000","00","190","0010","0000","754","378","376","96","850","1154","0","73.66","32.76"
"66","000","00","190","0010","1858","754","378","376","96","850","1154","0","73.66","32.76"
"66","000","00","190","0011","0000","504","306","198","74","578","838","0","68.97","36.52"
"66","000","00","190","0011","1859","124","70","54","14","138","213","0","64.79","32.86"
"66","000","00","190","0011","1860","380","236","144","60","440","625","0","70.40","37.76"
"66","000","00","190","0012","0000","263","107","156","24","287","543","0","52.85","19.71"
"66","000","00","190","0012","1861","263","107","156","24","287","543","0","52.85","19.71"
"66","000","00","190","0013","0000","619","266","353","88","707","1069","0","66.14","24.88"
"66","000","00","190","0013","1862","502","217","285","68","570","864","0","65.97","25.12"
"66","000","00","190","0013","1863","117","49","68","20","137","205","0","66.83","23.90"
"66","000","00","200","0000","0000","7174","3345","3829","577","7751","12198","14152","63.54","27.42"
"66","000","00","200","0001","0000","764","370","394","43","807","1149","0","70.23","32.20"
"66","000","00","200","0001","1830","764","370","394","43","807","1149","0","70.23","32.20"
"66","000","00","200","0002","0000","899","440","459","69","968","1469","0","65.90","29.95"
"66","000","00","200","0002","1831","899","440","459","69","968","1469","0","65.90","29.95"
"66","000","00","200","0003","0000","654","298","356","72","726","1150","0","63.13","25.91"
"66","000","00","200","0003","1832","654","298","356","72","726","1150","0","63.13","25.91"
"66","000","00","200","0004","0000","617","306","311","43","660","1181","0","55.88","25.91"
"66","000","00","200","0004","1833","617","306","311","43","660","1181","0","55.88","25.91"
"66","000","00","200","0005","0000","369","192","177","43","412","607","0","67.87","31.63"
"66","000","00","200","0005","1834","369","192","177","43","412","607","0","67.87","31.63"
"66","000","00","200","0006","0000","857","394","463","59","916","1400","0","65.43","28.14"
"66","000","00","200","0006","1835","857","394","463","59","916","1400","0","65.43","28.14"
"66","000","00","200","0007","0000","1033","462","571","99","1132","1731","0","65.40","26.69"
"66","000","00","200","0007","1836","405","209","196","38","443","648","0","68.36","32.25"
"66","000","00","200","0007","1837","628","253","375","61","689","1083","0","63.62","23.36"
"66","000","00","200","0008","0000","515","238","277","38","553","963","0","57.42","24.71"
"66","000","00","200","0008","1838","515","238","277","38","553","963","0","57.42","24.71"
"66","000","00","200","0009","0000","803","325","478","42","845","1364","0","61.95","23.83"
"66","000","00","200","0009","1839","803","325","478","42","845","1364","0","61.95","23.83"
"66","000","00","200","0010","0000","663","320","343","69","732","1184","0","61.82","27.03"
"66","000","00","200","0010","1840","663","320","343","69","732","1184","0","61.82","27.03"
"66","000","00","210","0000","0000","15449","7189","8260","1614","17063","26181","31286","65.17","27.46"
"66","000","00","210","0001","0000","643","278","365","82","725","1072","0","67.63","25.93"
"66","000","00","210","0001","0075","643","278","365","82","725","1072","0","67.63","25.93"
"66","000","00","210","0002","0000","1160","551","609","119","1279","2109","0","60.64","26.13"
"66","000","00","210","0002","0076","529","237","292","55","584","988","0","59.11","23.99"
"66","000","00","210","0002","0077","631","314","317","64","695","1121","0","62.00","28.01"
"66","000","00","210","0003","0000","1085","541","544","149","1234","1813","0","68.06","29.84"
"66","000","00","210","0003","0087","629","311","318","96","725","1028","0","70.53","30.25"
"66","000","00","210","0003","0088","456","230","226","53","509","785","0","64.84","29.30"
"66","000","00","210","0004","0000","2626","1034","1592","241","2867","4516","0","63.49","22.90"
"66","000","00","210","0004","0078","623","252","371","48","671","1055","0","63.60","23.89"
"66","000","00","210","0004","0079","518","238","280","36","554","817","0","67.81","29.13"
"66","000","00","210","0004","0080","717","214","503","67","784","1274","0","61.54","16.80"
"66","000","00","210","0004","0081","768","330","438","90","858","1370","0","62.63","24.09"
"66","000","00","210","0005","0000","2039","926","1113","143","2182","3313","0","65.86","27.95"
"66","000","00","210","0005","0089","673","348","325","40","713","1076","0","66.26","32.34"
"66","000","00","210","0005","0090","640","261","379","54","694","1045","0","66.41","24.98"
"66","000","00","210","0005","0091","726","317","409","49","775","1192","0","65.02","26.59"
"66","000","00","210","0006","0000","3505","1705","1800","307","3812","6161","0","61.87","27.67"
"66","000","00","210","0006","0082","619","310","309","57","676","1022","0","66.14","30.33"
"66","000","00","210","0006","0083","619","284","335","52","671","1115","0","60.18","25.47"
"66","000","00","210","0006","0084","771","363","408","57","828","1381","0","59.96","26.29"
"66","000","00","210","0006","0085","716","345","371","84","800","1304","0","61.35","26.46"
"66","000","00","210","0006","0086","780","403","377","57","837","1339","0","62.51","30.10"
"66","000","00","210","0007","0000","740","348","392","110","850","1335","0","63.67","26.07"
"66","000","00","210","0007","0095","740","348","392","110","850","1335","0","63.67","26.07"
"66","000","00","210","0008","0000","758","333","425","63","821","1181","0","69.52","28.20"
"66","000","00","210","0008","0094","758","333","425","63","821","1181","0","69.52","28.20"
"66","000","00","210","0009","0000","1167","560","607","131","1298","2062","0","62.95","27.16"
"66","000","00","210","0009","0092","493","249","244","65","558","916","0","60.92","27.18"
"66","000","00","210","0009","0093","674","311","363","66","740","1146","0","64.57","27.14"
"66","000","00","210","0010","0000","1000","551","449","151","1151","1486","0","77.46","37.08"
"66","000","00","210","0010","0096","506","298","208","76","582","775","0","75.10","38.45"
"66","000","00","210","0010","0097","494","253","241","75","569","711","0","80.03","35.58"
"66","000","00","210","0011","0000","726","362","364","118","844","1133","0","74.49","31.95"
"66","000","00","210","0011","0098","726","362","364","118","844","1133","0","74.49","31.95"
"66","000","00","220","0000","0000","8934","4625","4309","1029","9963","15654","18241","63.65","29.55"
"66","000","00","220","0001","0000","536","327","209","96","632","997","0","63.39","32.80"
"66","000","00","220","0001","0058","536","327","209","96","632","997","0","63.39","32.80"
"66","000","00","220","0002","0000","469","258","211","60","529","969","0","54.59","26.63"
"66","000","00","220","0002","0059","469","258","211","60","529","969","0","54.59","26.63"
"66","000","00","220","0003","0000","1352","710","642","150","1502","2552","0","58.86","27.82"
"66","000","00","220","0003","0060","666","367","299","84","750","1205","0","62.24","30.46"
"66","000","00","220","0003","0061","686","343","343","66","752","1347","0","55.83","25.46"
"66","000","00","220","0004","0000","899","483","416","88","987","1450","0","68.07","33.31"
"66","000","00","220","0004","0064","575","293","282","51","626","851","0","73.56","34.43"
"66","000","00","220","0004","0065","324","190","134","37","361","599","0","60.27","31.72"
"66","000","00","220","0005","0000","636","352","284","70","706","1096","0","64.42","32.12"
"66","000","00","220","0005","0063","636","352","284","70","706","1096","0","64.42","32.12"
"66","000","00","220","0006","0000","713","369","344","77","790","1149","0","68.76","32.11"
"66","000","00","220","0006","0062","713","369","344","77","790","1149","0","68.76","32.11"
"66","000","00","220","0007","0000","539","252","287","65","604","846","0","71.39","29.79"
"66","000","00","220","0007","0066","539","252","287","65","604","846","0","71.39","29.79"
"66","000","00","220","0008","0000","905","467","438","84","989","1663","0","59.47","28.08"
"66","000","00","220","0008","0067","643","326","317","47","690","1234","0","55.92","26.42"
"66","000","00","220","0008","0068","262","141","121","37","299","429","0","69.70","32.87"
"66","000","00","220","0009","0000","618","307","311","101","719","988","0","72.77","31.07"
"66","000","00","220","0009","0069","618","307","311","101","719","988","0","72.77","31.07"
"66","000","00","220","0010","0000","705","327","378","77","782","1335","0","58.58","24.49"
"66","000","00","220","0010","0070","305","135","170","25","330","593","0","55.65","22.77"
"66","000","00","220","0010","0071","400","192","208","52","452","742","0","60.92","25.88"
"66","000","00","220","0011","0000","912","440","472","100","1012","1662","0","60.89","26.47"
"66","000","00","220","0011","0072","510","254","256","53","563","906","0","62.14","28.04"
"66","000","00","220","0011","0073","402","186","216","47","449","756","0","59.39","24.60"
"66","000","00","220","0012","0000","650","333","317","61","711","947","0","75.08","35.16"
"66","000","00","220","0012","0074","650","333","317","61","711","947","0","75.08","35.16"
"66","000","00","230","0000","0000","35869","18086","17783","2078","37947","62965","77726","60.27","28.72"
"66","000","00","230","0001","0000","4778","2437","2341","233","5011","8403","0","59.63","29.00"
"66","000","00","230","0001","0360","850","410","440","44","894","1435","0","62.30","28.57"
"66","000","00","230","0001","0361","771","420","351","30","801","1371","0","58.42","30.63"
"66","000","00","230","0001","0362","684","364","320","46","730","1241","0","58.82","29.33"
"66","000","00","230","0001","0363","769","385","384","36","805","1438","0","55.98","26.77"
"66","000","00","230","0001","0364","783","401","382","35","818","1359","0","60.19","29.51"
"66","000","00","230","0001","0365","921","457","464","42","963","1559","0","61.77","29.31"
"66","000","00","230","0002","0000","1544","833","711","75","1619","2604","0","62.17","31.99"
"66","000","00","230","0002","0366","754","436","318","29","783","1174","0","66.70","37.14"
"66","000","00","230","0002","0367","790","397","393","46","836","1430","0","58.46","27.76"
"66","000","00","230","0003","0000","3321","1715","1606","176","3497","6412","0","54.54","26.75"
"66","000","00","230","0003","0368","760","414","346","35","795","1376","0","57.78","30.09"
"66","000","00","230","0003","0369","830","413","417","24","854","1695","0","50.38","24.37"
"66","000","00","230","0003","0370","471","212","259","51","522","1006","0","51.89","21.07"
"66","000","00","230","0003","0371","848","464","384","31","879","1569","0","56.02","29.57"
"66","000","00","230","0003","0372","412","212","200","35","447","766","0","58.36","27.68"
"66","000","00","230","0004","0000","3182","1570","1612","150","3332","6049","0","55.08","25.95"
"66","000","00","230","0004","0373","888","433","455","57","945","1666","0","56.72","25.99"
"66","000","00","230","0004","0374","707","369","338","22","729","1425","0","51.16","25.89"
"66","000","00","230","0004","0375","824","391","433","40","864","1496","0","57.75","26.14"
"66","000","00","230","0004","0376","763","377","386","31","794","1462","0","54.31","25.79"
"66","000","00","230","0005","0000","1471","727","744","108","1579","2531","0","62.39","28.72"
"66","000","00","230","0005","0377","787","382","405","62","849","1328","0","63.93","28.77"
"66","000","00","230","0005","0378","684","345","339","46","730","1203","0","60.68","28.68"
"66","000","00","230","0006","0000","6748","3410","3338","310","7058","12251","0","57.61","27.83"
"66","000","00","230","0006","0379","853","399","454","45","898","1470","0","61.09","27.14"
"66","000","00","230","0006","0380","691","353","338","26","717","1201","0","59.70","29.39"
"66","000","00","230","0006","0381","696","360","336","48","744","1171","0","63.54","30.74"
"66","000","00","230","0006","0382","564","270","294","23","587","1060","0","55.38","25.47"
"66","000","00","230","0006","0383","608","345","263","42","650","1032","0","62.98","33.43"
"66","000","00","230","0006","0384","632","304","328","28","660","1125","0","58.67","27.02"
"66","000","00","230","0006","0385","731","384","347","24","755","1440","0","52.43","26.67"
"66","000","00","230","0006","0386","672","363","309","33","705","1238","0","56.95","29.32"
"66","000","00","230","0006","0387","760","355","405","26","786","1348","0","58.31","26.34"
"66","000","00","230","0006","0388","541","277","264","15","556","1166","0","47.68","23.76"
"66","000","00","230","0007","0000","4227","2093","2134","155","4382","7363","0","59.51","28.43"
"66","000","00","230","0007","0389","796","421","375","37","833","1302","0","63.98","32.33"
"66","000","00","230","0007","0390","730","352","378","31","761","1355","0","56.16","25.98"
"66","000","00","230","0007","0391","781","366","415","16","797","1313","0","60.70","27.88"
"66","000","00","230","0007","0392","598","296","302","23","621","1038","0","59.83","28.52"
"66","000","00","230","0007","0393","655","321","334","27","682","1100","0","62.00","29.18"
"66","000","00","230","0007","0394","667","337","330","21","688","1255","0","54.82","26.85"
"66","000","00","230","0008","0000","942","491","451","65","1007","1517","0","66.38","32.37"
"66","000","00","230","0008","0395","362","203","159","28","390","596","0","65.44","34.06"
"66","000","00","230","0008","0396","580","288","292","37","617","921","0","66.99","31.27"
"66","000","00","230","0009","0000","1057","528","529","87","1144","1654","0","69.17","31.92"
"66","000","00","230","0009","0397","1057","528","529","87","1144","1654","0","69.17","31.92"
"66","000","00","230","0010","0000","1120","563","557","94","1214","2020","0","60.10","27.87"
"66","000","00","230","0010","0398","469","254","215","52","521","870","0","59.89","29.20"
"66","000","00","230","0010","0399","651","309","342","42","693","1150","0","60.26","26.87"
"66","000","00","230","0011","0000","1394","711","683","118","1512","2189","0","69.07","32.48"
"66","000","00","230","0011","0400","782","400","382","68","850","1235","0","68.83","32.39"
"66","000","00","230","0011","0401","612","311","301","50","662","954","0","69.39","32.60"
"66","000","00","230","0012","0000","2583","1243","1340","203","2786","4182","0","66.62","29.72"
"66","000","00","230","0012","0402","845","397","448","78","923","1333","0","69.24","29.78"
"66","000","00","230","0012","0403","967","454","513","82","1049","1576","0","66.56","28.81"
"66","000","00","230","0012","0404","771","392","379","43","814","1273","0","63.94","30.79"
"66","000","00","230","0013","0000","1325","707","618","79","1404","2078","0","67.56","34.02"
"66","000","00","230","0013","0405","626","355","271","41","667","1009","0","66.11","35.18"
"66","000","00","230","0013","0406","699","352","347","38","737","1069","0","68.94","32.93"
"66","000","00","230","0014","0000","873","433","440","73","946","1594","0","59.35","27.16"
"66","000","00","230","0014","0407","873","433","440","73","946","1594","0","59.35","27.16"
"66","000","00","230","0015","0000","797","389","408","75","872","1323","0","65.91","29.40"
"66","000","00","230","0015","0408","797","389","408","75","872","1323","0","65.91","29.40"
"66","000","00","230","0016","0000","507","236","271","77","584","795","0","73.46","29.69"
"66","000","00","230","0016","0409","507","236","271","77","584","795","0","73.46","29.69"
"66","000","00","240","0000","0000","26805","13482","13323","1846","28651","46441","56093","61.69","29.03"
"66","000","00","240","0001","0000","2451","1281","1170","194","2645","4212","0","62.80","30.41"
"66","000","00","240","0001","0321","902","492","410","70","972","1513","0","64.24","32.52"
"66","000","00","240","0001","0322","732","365","367","66","798","1307","0","61.06","27.93"
"66","000","00","240","0001","0323","817","424","393","58","875","1392","0","62.86","30.46"
"66","000","00","240","0002","0000","538","255","283","35","573","840","0","68.21","30.36"
"66","000","00","240","0002","0324","538","255","283","35","573","840","0","68.21","30.36"
"66","000","00","240","0003","0000","2063","1051","1012","133","2196","3360","0","65.36","31.28"
"66","000","00","240","0003","0325","742","345","397","52","794","1184","0","67.06","29.14"
"66","000","00","240","0003","0326","704","392","312","43","747","1213","0","61.58","32.32"
"66","000","00","240","0003","0327","617","314","303","38","655","963","0","68.02","32.61"
"66","000","00","240","0004","0000","818","394","424","65","883","1449","0","60.94","27.19"
"66","000","00","240","0004","0328","818","394","424","65","883","1449","0","60.94","27.19"
"66","000","00","240","0005","0000","1325","655","670","135","1460","2322","0","62.88","28.21"
"66","000","00","240","0005","0329","692","350","342","80","772","1168","0","66.10","29.97"
"66","000","00","240","0005","0330","633","305","328","55","688","1154","0","59.62","26.43"
"66","000","00","240","0006","0000","1543","721","822","121","1664","2479","0","67.12","29.08"
"66","000","00","240","0006","0331","803","374","429","77","880","1324","0","66.47","28.25"
"66","000","00","240","0006","0332","740","347","393","44","784","1155","0","67.88","30.04"
"66","000","00","240","0007","0000","1581","784","797","118","1699","2913","0","58.32","26.91"
"66","000","00","240","0007","0333","475","234","241","45","520","931","0","55.85","25.13"
"66","000","00","240","0007","0334","466","241","225","19","485","814","0","59.58","29.61"
"66","000","00","240","0007","0335","640","309","331","54","694","1168","0","59.42","26.46"
"66","000","00","240","0008","0000","1225","583","642","75","1300","2115","0","61.47","27.57"
"66","000","00","240","0008","0336","455","206","249","32","487","824","0","59.10","25.00"
"66","000","00","240","0008","0337","770","377","393","43","813","1291","0","62.97","29.20"
"66","000","00","240","0009","0000","438","216","222","39","477","784","0","60.84","27.55"
"66","000","00","240","0009","0338","438","216","222","39","477","784","0","60.84","27.55"
"66","000","00","240","0010","0000","1062","491","571","88","1150","1653","0","69.57","29.70"
"66","000","00","240","0010","0339","1062","491","571","88","1150","1653","0","69.57","29.70"
"66","000","00","240","0011","0000","1092","571","521","83","1175","1658","0","70.87","34.44"
"66","000","00","240","0011","0340","1092","571","521","83","1175","1658","0","70.87","34.44"
"66","000","00","240","0012","0000","608","301","307","68","676","906","0","74.61","33.22"
"66","000","00","240","0012","0341","608","301","307","68","676","906","0","74.61","33.22"
"66","000","00","240","0013","0000","865","460","405","46","911","1296","0","70.29","35.49"
"66","000","00","240","0013","0342","865","460","405","46","911","1296","0","70.29","35.49"
"66","000","00","240","0014","0000","3928","1913","2015","211","4139","7240","0","57.17","26.42"
"66","000","00","240","0014","0343","739","348","391","49","788","1365","0","57.73","25.49"
"66","000","00","240","0014","0344","616","330","286","38","654","1204","0","54.32","27.41"
"66","000","00","240","0014","0345","694","337","357","50","744","1304","0","57.06","25.84"
"66","000","00","240","0014","0346","631","318","313","25","656","1080","0","60.74","29.44"
"66","000","00","240","0014","0347","636","298","338","29","665","1176","0","56.55","25.34"
"66","000","00","240","0014","0348","612","282","330","20","632","1111","0","56.89","25.38"
"66","000","00","240","0015","0000","2820","1492","1328","161","2981","5046","0","59.08","29.57"
"66","000","00","240","0015","0349","820","441","379","52","872","1431","0","60.94","30.82"
"66","000","00","240","0015","0350","736","387","349","42","778","1262","0","61.65","30.67"
"66","000","00","240","0015","0351","656","354","302","30","686","1222","0","56.14","28.97"
"66","000","00","240","0015","0352","608","310","298","37","645","1131","0","57.03","27.41"
"66","000","00","240","0016","0000","2700","1487","1213","160","2860","4840","0","59.09","30.72"
"66","000","00","240","0016","0353","788","448","340","49","837","1426","0","58.70","31.42"
"66","000","00","240","0016","0354","649","350","299","40","689","1119","0","61.57","31.28"
"66","000","00","240","0016","0355","628","345","283","51","679","1101","0","61.67","31.34"
"66","000","00","240","0016","0356","635","344","291","20","655","1194","0","54.86","28.81"
"66","000","00","240","0017","0000","1748","827","921","114","1862","3328","0","55.95","24.85"
"66","000","00","240","0017","0357","600","310","290","33","633","1204","0","52.57","25.75"
"66","000","00","240","0017","0358","654","287","367","45","699","1137","0","61.48","25.24"
"66","000","00","240","0017","0359","494","230","264","36","530","987","0","53.70","23.30"
"66","000","00","250","0000","0000","34460","17621","16839","2505","36965","63178","77730","58.51","27.89"
"66","000","00","250","0001","0000","1557","764","793","118","1675","3008","0","55.68","25.40"
"66","000","00","250","0001","0270","469","236","233","45","514","903","0","56.92","26.14"
"66","000","00","250","0001","0271","386","183","203","27","413","808","0","51.11","22.65"
"66","000","00","250","0001","0272","702","345","357","46","748","1297","0","57.67","26.60"
"66","000","00","250","0002","0000","1572","808","764","92","1664","2745","0","60.62","29.44"
"66","000","00","250","0002","0273","780","430","350","53","833","1327","0","62.77","32.40"
"66","000","00","250","0002","0274","792","378","414","39","831","1418","0","58.60","26.66"
"66","000","00","250","0003","0000","1062","511","551","91","1153","1767","0","65.25","28.92"
"66","000","00","250","0003","0275","563","285","278","43","606","918","0","66.01","31.05"
"66","000","00","250","0003","0276","499","226","273","48","547","849","0","64.43","26.62"
"66","000","00","250","0004","0000","2018","1051","967","153","2171","3624","0","59.91","29.00"
"66","000","00","250","0004","0277","783","439","344","57","840","1368","0","61.40","32.09"
"66","000","00","250","0004","0278","680","351","329","42","722","1200","0","60.17","29.25"
"66","000","00","250","0004","0279","555","261","294","54","609","1056","0","57.67","24.72"
"66","000","00","250","0005","0000","617","343","274","74","691","1008","0","68.55","34.03"
"66","000","00","250","0005","0280","617","343","274","74","691","1008","0","68.55","34.03"
"66","000","00","250","0006","0000","1345","706","639","141","1486","2154","0","68.99","32.78"
"66","000","00","250","0006","0281","789","414","375","98","887","1309","0","67.76","31.63"
"66","000","00","250","0006","0282","556","292","264","43","599","845","0","70.89","34.56"
"66","000","00","250","0007","0000","2581","1408","1173","230","2811","4864","0","57.79","28.95"
"66","000","00","250","0007","0283","728","389","339","56","784","1424","0","55.06","27.32"
"66","000","00","250","0007","0284","738","377","361","85","823","1383","0","59.51","27.26"
"66","000","00","250","0007","0285","685","348","337","53","738","1282","0","57.57","27.15"
"66","000","00","250","0007","0286","430","294","136","36","466","775","0","60.13","37.94"
"66","000","00","250","0008","0000","1661","907","754","167","1828","2830","0","64.59","32.05"
"66","000","00","250","0008","0287","832","466","366","89","921","1474","0","62.48","31.61"
"66","000","00","250","0008","0288","829","441","388","78","907","1356","0","66.89","32.52"
"66","000","00","250","0009","0000","2795","1484","1311","253","3048","4722","0","64.55","31.43"
"66","000","00","250","0009","0289","730","377","353","58","788","1164","0","67.70","32.39"
"66","000","00","250","0009","0290","692","374","318","69","761","1247","0","61.03","29.99"
"66","000","00","250","0009","0291","712","360","352","79","791","1210","0","65.37","29.75"
"66","000","00","250","0009","0292","661","373","288","47","708","1101","0","64.31","33.88"
"66","000","00","250","0010","0000","3098","1579","1519","217","3315","5545","0","59.78","28.48"
"66","000","00","250","0010","0293","788","407","381","55","843","1481","0","56.92","27.48"
"66","000","00","250","0010","0294","769","406","363","60","829","1385","0","59.86","29.31"
"66","000","00","250","0010","0295","750","359","391","37","787","1389","0","56.66","25.85"
"66","000","00","250","0010","0296","791","407","384","65","856","1290","0","66.36","31.55"
"66","000","00","250","0011","0000","3919","1937","1982","272","4191","7561","0","55.43","25.62"
"66","000","00","250","0011","0297","773","374","399","77","850","1474","0","57.67","25.37"
"66","000","00","250","0011","0298","738","388","350","50","788","1540","0","51.17","25.19"
"66","000","00","250","0011","0299","758","363","395","66","824","1381","0","59.67","26.29"
"66","000","00","250","0011","0300","509","243","266","30","539","952","0","56.62","25.53"
"66","000","00","250","0011","0301","503","257","246","14","517","924","0","55.95","27.81"
"66","000","00","250","0011","0302","638","312","326","35","673","1290","0","52.17","24.19"
"66","000","00","250","0012","0000","1479","729","750","97","1576","2694","0","58.50","27.06"
"66","000","00","250","0012","0303","804","401","403","53","857","1489","0","57.56","26.93"
"66","000","00","250","0012","0304","675","328","347","44","719","1205","0","59.67","27.22"
"66","000","00","250","0013","0000","3070","1563","1507","234","3304","6107","0","54.10","25.59"
"66","000","00","250","0013","0305","726","360","366","55","781","1480","0","52.77","24.32"
"66","000","00","250","0013","0306","542","269","273","47","589","1146","0","51.40","23.47"
"66","000","00","250","0013","0307","552","245","307","48","600","1067","0","56.23","22.96"
"66","000","00","250","0013","0308","572","339","233","51","623","1113","0","55.97","30.46"
"66","000","00","250","0013","0309","678","350","328","33","711","1301","0","54.65","26.90"
"66","000","00","250","0014","0000","1073","590","483","112","1185","1508","0","78.58","39.12"
"66","000","00","250","0014","0310","1073","590","483","112","1185","1508","0","78.58","39.12"
"66","000","00","250","0015","0000","2355","1158","1197","89","2444","4671","0","52.32","24.79"
"66","000","00","250","0015","0311","547","270","277","23","570","1137","0","50.13","23.75"
"66","000","00","250","0015","0312","539","300","239","22","561","960","0","58.44","31.25"
"66","000","00","250","0015","0313","645","294","351","18","663","1358","0","48.82","21.65"
"66","000","00","250","0015","0314","624","294","330","26","650","1216","0","53.45","24.18"
"66","000","00","250","0016","0000","4258","2083","2175","165","4423","8370","0","52.84","24.89"
"66","000","00","250","0016","0315","731","377","354","31","762","1442","0","52.84","26.14"
"66","000","00","250","0016","0316","741","355","386","43","784","1465","0","53.52","24.23"
"66","000","00","250","0016","0317","734","381","353","23","757","1443","0","52.46","26.40"
"66","000","00","250","0016","0318","665","316","349","23","688","1371","0","50.18","23.05"
"66","000","00","250","0016","0319","654","308","346","19","673","1287","0","52.29","23.93"
"66","000","00","250","0016","0320","733","346","387","26","759","1362","0","55.73","25.40"
"66","000","00","260","0000","0000","31286","15320","15966","2174","33460","53647","64062","62.37","28.56"
"66","000","00","260","0001","0000","716","339","377","20","736","1178","0","62.48","28.78"
"66","000","00","260","0001","1741","716","339","377","20","736","1178","0","62.48","28.78"
"66","000","00","260","0002","0000","5031","2377","2654","332","5363","9107","0","58.89","26.10"
"66","000","00","260","0002","1742","544","266","278","34","578","1106","0","52.26","24.05"
"66","000","00","260","0002","1743","636","310","326","34","670","1120","0","59.82","27.68"
"66","000","00","260","0002","1744","681","316","365","50","731","1191","0","61.38","26.53"
"66","000","00","260","0002","1745","603","286","317","38","641","1056","0","60.70","27.08"
"66","000","00","260","0002","1746","650","293","357","54","704","1179","0","59.71","24.85"
"66","000","00","260","0002","1747","561","253","308","39","600","995","0","60.30","25.43"
"66","000","00","260","0002","1748","631","336","295","36","667","1225","0","54.45","27.43"
"66","000","00","260","0002","1749","725","317","408","47","772","1235","0","62.51","25.67"
"66","000","00","260","0003","0000","2575","1230","1345","178","2753","4584","0","60.06","26.83"
"66","000","00","260","0003","1750","681","318","363","31","712","1156","0","61.59","27.51"
"66","000","00","260","0003","1751","667","327","340","62","729","1209","0","60.30","27.05"
"66","000","00","260","0003","1752","618","273","345","49","667","1157","0","57.65","23.60"
"66","000","00","260","0003","1753","609","312","297","36","645","1062","0","60.73","29.38"
"66","000","00","260","0004","0000","1388","672","716","50","1438","2216","0","64.89","30.32"
"66","000","00","260","0004","1754","691","346","345","28","719","1043","0","68.94","33.17"
"66","000","00","260","0004","1755","697","326","371","22","719","1173","0","61.30","27.79"
"66","000","00","260","0005","0000","1210","578","632","80","1290","1916","0","67.33","30.17"
"66","000","00","260","0005","1756","722","323","399","34","756","1091","0","69.29","29.61"
"66","000","00","260","0005","1757","488","255","233","46","534","825","0","64.73","30.91"
"66","000","00","260","0006","0000","683","317","366","51","734","1223","0","60.02","25.92"
"66","000","00","260","0006","1758","683","317","366","51","734","1223","0","60.02","25.92"
"66","000","00","260","0007","0000","623","313","310","51","674","997","0","67.60","31.39"
"66","000","00","260","0007","1759","623","313","310","51","674","997","0","67.60","31.39"
"66","000","00","260","0008","0000","3181","1430","1751","148","3329","5610","0","59.34","25.49"
"66","000","00","260","0008","1760","594","271","323","31","625","1040","0","60.10","26.06"
"66","000","00","260","0008","1761","699","322","377","19","718","1212","0","59.24","26.57"
"66","000","00","260","0008","1762","646","257","389","36","682","1115","0","61.17","23.05"
"66","000","00","260","0008","1763","650","312","338","38","688","1220","0","56.39","25.57"
"66","000","00","260","0008","1764","592","268","324","24","616","1023","0","60.22","26.20"
"66","000","00","260","0009","0000","1757","839","918","117","1874","2829","0","66.24","29.66"
"66","000","00","260","0009","1783","651","291","360","44","695","1033","0","67.28","28.17"
"66","000","00","260","0009","1784","583","305","278","41","624","965","0","64.66","31.61"
"66","000","00","260","0009","1785","523","243","280","32","555","831","0","66.79","29.24"
"66","000","00","260","0010","0000","2231","1131","1100","136","2367","3873","0","61.12","29.20"
"66","000","00","260","0010","1765","735","339","396","40","775","1267","0","61.17","26.76"
"66","000","00","260","0010","1766","695","370","325","31","726","1246","0","58.27","29.70"
"66","000","00","260","0010","1767","801","422","379","65","866","1360","0","63.68","31.03"
"66","000","00","260","0011","0000","1155","548","607","90","1245","1815","0","68.60","30.19"
"66","000","00","260","0011","1768","667","313","354","45","712","982","0","72.51","31.87"
"66","000","00","260","0011","1769","488","235","253","45","533","833","0","63.99","28.21"
"66","000","00","260","0012","0000","1299","661","638","113","1412","2416","0","58.44","27.36"
"66","000","00","260","0012","1770","730","369","361","67","797","1368","0","58.26","26.97"
"66","000","00","260","0012","1771","569","292","277","46","615","1048","0","58.68","27.86"
"66","000","00","260","0013","0000","1431","799","632","98","1529","2564","0","59.63","31.16"
"66","000","00","260","0013","1772","741","453","288","45","786","1328","0","59.19","34.11"
"66","000","00","260","0013","1773","690","346","344","53","743","1236","0","60.11","27.99"
"66","000","00","260","0014","0000","1325","686","639","127","1452","2485","0","58.43","27.61"
"66","000","00","260","0014","1779","648","352","296","67","715","1250","0","57.20","28.16"
"66","000","00","260","0014","1780","677","334","343","60","737","1235","0","59.68","27.04"
"66","000","00","260","0015","0000","1060","543","517","77","1137","2004","0","56.74","27.10"
"66","000","00","260","0015","1781","505","262","243","37","542","937","0","57.84","27.96"
"66","000","00","260","0015","1782","555","281","274","40","595","1067","0","55.76","26.34"
"66","000","00","260","0016","0000","723","370","353","89","812","1091","0","74.43","33.91"
"66","000","00","260","0016","1786","723","370","353","89","812","1091","0","74.43","33.91"
"66","000","00","260","0017","0000","1308","684","624","107","1415","2255","0","62.75","30.33"
"66","000","00","260","0017","1787","667","356","311","55","722","1106","0","65.28","32.19"
"66","000","00","260","0017","1788","641","328","313","52","693","1149","0","60.31","28.55"
"66","000","00","260","0018","0000","1423","802","621","133","1556","2228","0","69.84","36.00"
"66","000","00","260","0018","1774","712","379","333","67","779","1104","0","70.56","34.33"
"66","000","00","260","0018","1775","711","423","288","66","777","1124","0","69.13","37.63"
"66","000","00","260","0019","0000","1377","596","781","95","1472","2008","0","73.31","29.68"
"66","000","00","260","0019","1776","689","308","381","41","730","1009","0","72.35","30.53"
"66","000","00","260","0019","1777","688","288","400","54","742","999","0","74.27","28.83"
"66","000","00","260","0020","0000","790","405","385","82","872","1248","0","69.87","32.45"
"66","000","00","260","0020","1778","790","405","385","82","872","1248","0","69.87","32.45"
"66","000","00","270","0000","0000","81252","41417","39835","4757","86009","159382","195646","53.96","25.99"
"66","000","00","270","0001","0000","2737","1442","1295","161","2898","5102","0","56.80","28.26"
"66","000","00","270","0001","1501","697","364","333","36","733","1300","0","56.38","28.00"
"66","000","00","270","0001","1502","771","390","381","54","825","1327","0","62.17","29.39"
"66","000","00","270","0001","1503","594","312","282","33","627","1252","0","50.08","24.92"
"66","000","00","270","0001","1504","675","376","299","38","713","1223","0","58.30","30.74"
"66","000","00","270","0002","0000","3472","1768","1704","223","3695","6113","0","60.44","28.92"
"66","000","00","270","0002","1505","942","468","474","69","1011","1556","0","64.97","30.08"
"66","000","00","270","0002","1506","774","404","370","69","843","1331","0","63.34","30.35"
"66","000","00","270","0002","1507","779","387","392","38","817","1458","0","56.04","26.54"
"66","000","00","270","0002","1508","977","509","468","47","1024","1768","0","57.92","28.79"
"66","000","00","270","0003","0000","2032","1087","945","131","2163","3932","0","55.01","27.64"
"66","000","00","270","0003","1514","733","399","334","51","784","1493","0","52.51","26.72"
"66","000","00","270","0003","1515","656","365","291","45","701","1216","0","57.65","30.02"
"66","000","00","270","0003","1516","643","323","320","35","678","1223","0","55.44","26.41"
"66","000","00","270","0004","0000","1603","867","736","109","1712","3089","0","55.42","28.07"
"66","000","00","270","0004","1522","555","296","259","43","598","982","0","60.90","30.14"
"66","000","00","270","0004","1523","523","264","259","31","554","1076","0","51.49","24.54"
"66","000","00","270","0004","1524","525","307","218","35","560","1031","0","54.32","29.78"
"66","000","00","270","0005","0000","1308","672","636","108","1416","2778","0","50.97","24.19"
"66","000","00","270","0005","1536","592","301","291","77","669","1308","0","51.15","23.01"
"66","000","00","270","0005","1537","716","371","345","31","747","1470","0","50.82","25.24"
"66","000","00","270","0006","0000","2011","992","1019","112","2123","4004","0","53.02","24.78"
"66","000","00","270","0006","1528","671","328","343","28","699","1453","0","48.11","22.57"
"66","000","00","270","0006","1529","694","356","338","55","749","1321","0","56.70","26.95"
"66","000","00","270","0006","1530","646","308","338","29","675","1230","0","54.88","25.04"
"66","000","00","270","0007","0000","2941","1538","1403","191","3132","6051","0","51.76","25.42"
"66","000","00","270","0007","1559","932","470","462","50","982","1786","0","54.98","26.32"
"66","000","00","270","0007","1560","686","365","321","40","726","1450","0","50.07","25.17"
"66","000","00","270","0007","1561","662","351","311","67","729","1401","0","52.03","25.05"
"66","000","00","270","0007","1562","661","352","309","34","695","1414","0","49.15","24.89"
"66","000","00","270","0008","0000","1521","701","820","81","1602","3678","0","43.56","19.06"
"66","000","00","270","0008","1554","841","368","473","40","881","1637","0","53.82","22.48"
"66","000","00","270","0008","1555","680","333","347","41","721","2041","0","35.33","16.32"
"66","000","00","270","0009","0000","1856","914","942","105","1961","3179","0","61.69","28.75"
"66","000","00","270","0009","1540","682","338","344","39","721","1119","0","64.43","30.21"
"66","000","00","270","0009","1541","589","304","285","36","625","1026","0","60.92","29.63"
"66","000","00","270","0009","1542","585","272","313","30","615","1034","0","59.48","26.31"
"66","000","00","270","0010","0000","2573","1214","1359","137","2710","5035","0","53.82","24.11"
"66","000","00","270","0010","1547","684","351","333","51","735","1337","0","54.97","26.25"
"66","000","00","270","0010","1548","803","336","467","43","846","1492","0","56.70","22.52"
"66","000","00","270","0010","1549","566","287","279","5","571","1099","0","51.96","26.11"
"66","000","00","270","0010","1550","520","240","280","38","558","1107","0","50.41","21.68"
"66","000","00","270","0011","0000","3927","1907","2020","168","4095","7657","0","53.48","24.91"
"66","000","00","270","0011","1570","735","352","383","29","764","1509","0","50.63","23.33"
"66","000","00","270","0011","1571","812","403","409","51","863","1474","0","58.55","27.34"
"66","000","00","270","0011","1572","792","417","375","15","807","1729","0","46.67","24.12"
"66","000","00","270","0011","1573","901","433","468","50","951","1528","0","62.24","28.34"
"66","000","00","270","0011","1574","687","302","385","23","710","1417","0","50.11","21.31"
"66","000","00","270","0012","0000","3747","1872","1875","216","3963","7437","0","53.29","25.17"
"66","000","00","270","0012","1583","724","399","325","58","782","1389","0","56.30","28.73"
"66","000","00","270","0012","1584","710","349","361","57","767","1414","0","54.24","24.68"
"66","000","00","270","0012","1585","733","360","373","53","786","1404","0","55.98","25.64"
"66","000","00","270","0012","1586","801","366","435","13","814","1650","0","49.33","22.18"
"66","000","00","270","0012","1587","779","398","381","35","814","1580","0","51.52","25.19"
"66","000","00","270","0013","0000","3336","1616","1720","144","3480","6633","0","52.46","24.36"
"66","000","00","270","0013","1598","812","375","437","48","860","1493","0","57.60","25.12"
"66","000","00","270","0013","1599","594","330","264","22","616","1201","0","51.29","27.48"
"66","000","00","270","0013","1600","601","271","330","29","630","1133","0","55.60","23.92"
"66","000","00","270","0013","1601","619","292","327","15","634","1406","0","45.09","20.77"
"66","000","00","270","0013","1602","710","348","362","30","740","1400","0","52.86","24.86"
"66","000","00","270","0014","0000","901","474","427","97","998","1718","0","58.09","27.59"
"66","000","00","270","0014","1603","476","244","232","51","527","852","0","61.85","28.64"
"66","000","00","270","0014","1604","425","230","195","46","471","866","0","54.39","26.56"
"66","000","00","270","0015","0000","588","319","269","72","660","1144","0","57.69","27.88"
"66","000","00","270","0015","1606","588","319","269","72","660","1144","0","57.69","27.88"
"66","000","00","270","0016","0000","1779","913","866","164","1943","3107","0","62.54","29.39"
"66","000","00","270","0016","1607","847","405","442","75","922","1615","0","57.09","25.08"
"66","000","00","270","0016","1608","932","508","424","89","1021","1492","0","68.43","34.05"
"66","000","00","270","0017","0000","1398","825","573","122","1520","2911","0","52.22","28.34"
"66","000","00","270","0017","1613","682","420","262","48","730","1445","0","50.52","29.07"
"66","000","00","270","0017","1614","716","405","311","74","790","1466","0","53.89","27.63"
"66","000","00","270","0018","0000","2515","1363","1152","194","2709","4655","0","58.20","29.28"
"66","000","00","270","0018","1617","616","351","265","53","669","1137","0","58.84","30.87"
"66","000","00","270","0018","1618","602","329","273","56","658","1213","0","54.25","27.12"
"66","000","00","270","0018","1619","643","330","313","45","688","1027","0","66.99","32.13"
"66","000","00","270","0018","1620","654","353","301","40","694","1278","0","54.30","27.62"
"66","000","00","270","0019","0000","350","195","155","41","391","612","0","63.89","31.86"
"66","000","00","270","0019","1612","350","195","155","41","391","612","0","63.89","31.86"
"66","000","00","270","0020","0000","3482","1806","1676","182","3664","6652","0","55.08","27.15"
"66","000","00","270","0020","1509","739","371","368","45","784","1422","0","55.13","26.09"
"66","000","00","270","0020","1510","611","315","296","44","655","1262","0","51.90","24.96"
"66","000","00","270","0020","1511","730","381","349","36","766","1352","0","56.66","28.18"
"66","000","00","270","0020","1512","675","345","330","29","704","1295","0","54.36","26.64"
"66","000","00","270","0020","1513","727","394","333","28","755","1321","0","57.15","29.83"
"66","000","00","270","0021","0000","2036","1049","987","119","2155","3959","0","54.43","26.50"
"66","000","00","270","0021","1525","720","347","373","32","752","1376","0","54.65","25.22"
"66","000","00","270","0021","1526","661","374","287","49","710","1284","0","55.30","29.13"
"66","000","00","270","0021","1527","655","328","327","38","693","1299","0","53.35","25.25"
"66","000","00","270","0022","0000","1979","1062","917","93","2072","3827","0","54.14","27.75"
"66","000","00","270","0022","1531","669","364","305","33","702","1155","0","60.78","31.52"
"66","000","00","270","0022","1532","652","348","304","37","689","1363","0","50.55","25.53"
"66","000","00","270","0022","1533","658","350","308","23","681","1309","0","52.02","26.74"
"66","000","00","270","0023","0000","1343","691","652","67","1410","2715","0","51.93","25.45"
"66","000","00","270","0023","1534","686","349","337","42","728","1370","0","53.14","25.47"
"66","000","00","270","0023","1535","657","342","315","25","682","1345","0","50.71","25.43"
"66","000","00","270","0024","0000","1650","905","745","97","1747","3524","0","49.57","25.68"
"66","000","00","270","0024","1517","520","298","222","35","555","1153","0","48.14","25.85"
"66","000","00","270","0024","1518","603","321","282","27","630","1142","0","55.17","28.11"
"66","000","00","270","0024","1519","527","286","241","35","562","1229","0","45.73","23.27"
"66","000","00","270","0025","0000","1103","593","510","81","1184","2115","0","55.98","28.04"
"66","000","00","270","0025","1520","603","320","283","32","635","1193","0","53.23","26.82"
"66","000","00","270","0025","1521","500","273","227","49","549","922","0","59.54","29.61"
"66","000","00","270","0026","0000","1263","642","621","122","1385","2772","0","49.96","23.16"
"66","000","00","270","0026","1538","648","358","290","76","724","1474","0","49.12","24.29"
"66","000","00","270","0026","1539","615","284","331","46","661","1298","0","50.92","21.88"
"66","000","00","270","0027","0000","3074","1541","1533","82","3156","5863","0","53.83","26.28"
"66","000","00","270","0027","1588","663","358","305","31","694","1210","0","57.36","29.59"
"66","000","00","270","0027","1589","673","328","345","18","691","1326","0","52.11","24.74"
"66","000","00","270","0027","1590","909","458","451","17","926","1775","0","52.17","25.80"
"66","000","00","270","0027","1591","829","397","432","16","845","1552","0","54.45","25.58"
"66","000","00","270","0028","0000","4043","2106","1937","152","4195","8058","0","52.06","26.14"
"66","000","00","270","0028","1592","716","347","369","28","744","1526","0","48.75","22.74"
"66","000","00","270","0028","1593","768","413","355","41","809","1469","0","55.07","28.11"
"66","000","00","270","0028","1594","747","382","365","40","787","1541","0","51.07","24.79"
"66","000","00","270","0028","1595","708","381","327","17","725","1301","0","55.73","29.29"
"66","000","00","270","0028","1596","420","229","191","4","424","834","0","50.84","27.46"
"66","000","00","270","0028","1597","684","354","330","22","706","1387","0","50.90","25.52"
"66","000","00","270","0029","0000","2951","1455","1496","109","3060","5585","0","54.79","26.05"
"66","000","00","270","0029","1575","799","377","422","44","843","1454","0","57.98","25.93"
"66","000","00","270","0029","1576","708","364","344","25","733","1317","0","55.66","27.64"
"66","000","00","270","0029","1577","616","334","282","20","636","1231","0","51.67","27.13"
"66","000","00","270","0029","1578","828","380","448","20","848","1583","0","53.57","24.01"
"66","000","00","270","0030","0000","2574","1304","1270","135","2709","5618","0","48.22","23.21"
"66","000","00","270","0030","1579","603","305","298","24","627","1358","0","46.17","22.46"
"66","000","00","270","0030","1580","691","343","348","30","721","1471","0","49.01","23.32"
"66","000","00","270","0030","1581","605","319","286","43","648","1346","0","48.14","23.70"
"66","000","00","270","0030","1582","675","337","338","38","713","1443","0","49.41","23.35"
"66","000","00","270","0031","0000","2824","1419","1405","146","2970","5880","0","50.51","24.13"
"66","000","00","270","0031","1563","737","376","361","54","791","1593","0","49.65","23.60"
"66","000","00","270","0031","1564","781","378","403","29","810","1492","0","54.29","25.34"
"66","000","00","270","0031","1565","678","343","335","31","709","1369","0","51.79","25.05"
"66","000","00","270","0031","1566","628","322","306","32","660","1426","0","46.28","22.58"
"66","000","00","270","0032","0000","1980","1083","897","127","2107","4191","0","50.27","25.84"
"66","000","00","270","0032","1567","951","534","417","54","1005","1953","0","51.46","27.34"
"66","000","00","270","0032","1568","552","299","253","27","579","1157","0","50.04","25.84"
"66","000","00","270","0032","1569","477","250","227","46","523","1081","0","48.38","23.13"
"66","000","00","270","0033","0000","1764","797","967","93","1857","3701","0","50.18","21.53"
"66","000","00","270","0033","1551","630","285","345","32","662","1251","0","52.92","22.78"
"66","000","00","270","0033","1552","533","253","280","20","553","1096","0","50.46","23.08"
"66","000","00","270","0033","1553","601","259","342","41","642","1354","0","47.42","19.13"
"66","000","00","270","0034","0000","2155","1028","1127","132","2287","4193","0","54.54","24.52"
"66","000","00","270","0034","1556","775","367","408","60","835","1533","0","54.47","23.94"
"66","000","00","270","0034","1557","693","352","341","36","729","1372","0","53.13","25.66"
"66","000","00","270","0034","1558","687","309","378","36","723","1288","0","56.13","23.99"
"66","000","00","270","0035","0000","1287","634","653","67","1354","2428","0","55.77","26.11"
"66","000","00","270","0035","1543","744","351","393","29","773","1430","0","54.06","24.55"
"66","000","00","270","0035","1544","543","283","260","38","581","998","0","58.22","28.36"
"66","000","00","270","0036","0000","1141","492","649","80","1221","2083","0","58.62","23.62"
"66","000","00","270","0036","1545","574","262","312","47","621","1028","0","60.41","25.49"
"66","000","00","270","0036","1546","567","230","337","33","600","1055","0","56.87","21.80"
"66","000","00","270","0037","0000","796","420","376","48","844","1498","0","56.34","28.04"
"66","000","00","270","0037","1605","796","420","376","48","844","1498","0","56.34","28.04"
"66","000","00","270","0038","0000","1804","938","866","113","1917","3474","0","55.18","27.00"
"66","000","00","270","0038","1609","676","354","322","49","725","1265","0","57.31","27.98"
"66","000","00","270","0038","1610","757","396","361","32","789","1412","0","55.88","28.05"
"66","000","00","270","0038","1611","371","188","183","32","403","797","0","50.56","23.59"
"66","000","00","270","0039","0000","1408","773","635","136","1544","2411","0","64.04","32.06"
"66","000","00","270","0039","1615","706","391","315","72","778","1213","0","64.14","32.23"
"66","000","00","270","0039","1616","702","382","320","64","766","1198","0","63.94","31.89"
"66","000","00","280","0000","0000","91594","46805","44789","4909","96503","170164","211238","56.71","27.51"
"66","000","00","280","0001","0000","2015","1046","969","132","2147","3669","0","58.52","28.51"
"66","000","00","280","0001","1630","740","388","352","52","792","1377","0","57.52","28.18"
"66","000","00","280","0001","1631","693","363","330","46","739","1209","0","61.12","30.02"
"66","000","00","280","0001","1632","582","295","287","34","616","1083","0","56.88","27.24"
"66","000","00","280","0002","0000","5342","2754","2588","276","5618","10281","0","54.64","26.79"
"66","000","00","280","0002","1633","1018","518","500","54","1072","1786","0","60.02","29.00"
"66","000","00","280","0002","1634","1067","520","547","68","1135","2695","0","42.12","19.29"
"66","000","00","280","0002","1635","893","518","375","51","944","1735","0","54.41","29.86"
"66","000","00","280","0002","1636","726","372","354","21","747","1313","0","56.89","28.33"
"66","000","00","280","0002","1637","642","313","329","21","663","1093","0","60.66","28.64"
"66","000","00","280","0002","1638","996","513","483","61","1057","1659","0","63.71","30.92"
"66","000","00","280","0003","0000","1895","1035","860","131","2026","3475","0","58.30","29.78"
"66","000","00","280","0003","1643","632","371","261","49","681","1129","0","60.32","32.86"
"66","000","00","280","0003","1644","674","336","338","40","714","1276","0","55.96","26.33"
"66","000","00","280","0003","1645","589","328","261","42","631","1070","0","58.97","30.65"
"66","000","00","280","0004","0000","3645","1833","1812","173","3818","6669","0","57.25","27.49"
"66","000","00","280","0004","1686","723","379","344","29","752","1338","0","56.20","28.33"
"66","000","00","280","0004","1687","714","362","352","39","753","1319","0","57.09","27.45"
"66","000","00","280","0004","1688","755","327","428","38","793","1312","0","60.44","24.92"
"66","000","00","280","0004","1689","699","380","319","31","730","1261","0","57.89","30.13"
"66","000","00","280","0004","1690","754","385","369","36","790","1439","0","54.90","26.75"
"66","000","00","280","0005","0000","3785","1977","1808","195","3980","7143","0","55.72","27.68"
"66","000","00","280","0005","1646","944","484","460","33","977","1773","0","55.10","27.30"
"66","000","00","280","0005","1647","649","344","305","31","680","1182","0","57.53","29.10"
"66","000","00","280","0005","1648","787","396","391","45","832","1535","0","54.20","25.80"
"66","000","00","280","0005","1649","765","406","359","54","819","1573","0","52.07","25.81"
"66","000","00","280","0005","1650","640","347","293","32","672","1080","0","62.22","32.13"
"66","000","00","280","0006","0000","2305","1114","1191","133","2438","4208","0","57.94","26.47"
"66","000","00","280","0006","1700","775","336","439","50","825","1398","0","59.01","24.03"
"66","000","00","280","0006","1701","700","347","353","33","733","1236","0","59.30","28.07"
"66","000","00","280","0006","1702","830","431","399","50","880","1574","0","55.91","27.38"
"66","000","00","280","0007","0000","2844","1514","1330","142","2986","5321","0","56.12","28.45"
"66","000","00","280","0007","1703","755","418","337","44","799","1396","0","57.23","29.94"
"66","000","00","280","0007","1704","699","386","313","41","740","1305","0","56.70","29.58"
"66","000","00","280","0007","1705","671","331","340","23","694","1322","0","52.50","25.04"
"66","000","00","280","0007","1706","719","379","340","34","753","1298","0","58.01","29.20"
"66","000","00","280","0008","0000","4266","2086","2180","184","4450","8118","0","54.82","25.70"
"66","000","00","280","0008","1651","704","358","346","30","734","1393","0","52.69","25.70"
"66","000","00","280","0008","1652","758","371","387","33","791","1448","0","54.63","25.62"
"66","000","00","280","0008","1653","717","335","382","34","751","1330","0","56.47","25.19"
"66","000","00","280","0008","1654","735","361","374","30","765","1345","0","56.88","26.84"
"66","000","00","280","0008","1655","697","352","345","28","725","1349","0","53.74","26.09"
"66","000","00","280","0008","1656","655","309","346","29","684","1253","0","54.59","24.66"
"66","000","00","280","0009","0000","1715","837","878","124","1839","3275","0","56.15","25.56"
"66","000","00","280","0009","1661","846","394","452","77","923","1630","0","56.63","24.17"
"66","000","00","280","0009","1662","869","443","426","47","916","1645","0","55.68","26.93"
"66","000","00","280","0010","0000","2793","1451","1342","168","2961","5273","0","56.15","27.52"
"66","000","00","280","0010","1719","798","396","402","56","854","1427","0","59.85","27.75"
"66","000","00","280","0010","1720","620","321","299","29","649","1225","0","52.98","26.20"
"66","000","00","280","0010","1721","688","367","321","39","727","1371","0","53.03","26.77"
"66","000","00","280","0010","1722","687","367","320","44","731","1250","0","58.48","29.36"
"66","000","00","280","0011","0000","4378","2339","2039","248","4626","7664","0","60.36","30.52"
"66","000","00","280","0011","1728","744","381","363","43","787","1349","0","58.34","28.24"
"66","000","00","280","0011","1729","1003","537","466","40","1043","1583","0","65.89","33.92"
"66","000","00","280","0011","1730","962","505","457","57","1019","1725","0","59.07","29.28"
"66","000","00","280","0011","1731","904","517","387","44","948","1552","0","61.08","33.31"
"66","000","00","280","0011","1732","765","399","366","64","829","1455","0","56.98","27.42"
"66","000","00","280","0012","0000","2180","1218","962","115","2295","3950","0","58.10","30.84"
"66","000","00","280","0012","1663","605","332","273","50","655","1121","0","58.43","29.62"
"66","000","00","280","0012","1664","834","480","354","28","862","1430","0","60.28","33.57"
"66","000","00","280","0012","1665","741","406","335","37","778","1399","0","55.61","29.02"
"66","000","00","280","0013","0000","542","329","213","40","582","921","0","63.19","35.72"
"66","000","00","280","0013","1666","542","329","213","40","582","921","0","63.19","35.72"
"66","000","00","280","0014","0000","4366","2363","2003","257","4623","8054","0","57.40","29.34"
"66","000","00","280","0014","1667","711","382","329","35","746","1405","0","53.10","27.19"
"66","000","00","280","0014","1668","720","399","321","34","754","1274","0","59.18","31.32"
"66","000","00","280","0014","1669","678","375","303","46","724","1219","0","59.39","30.76"
"66","000","00","280","0014","1670","760","428","332","40","800","1453","0","55.06","29.46"
"66","000","00","280","0014","1671","728","397","331","57","785","1334","0","58.85","29.76"
"66","000","00","280","0014","1672","769","382","387","45","814","1369","0","59.46","27.90"
"66","000","00","280","0015","0000","2684","1420","1264","275","2959","4839","0","61.15","29.34"
"66","000","00","280","0015","1677","841","466","375","119","960","1430","0","67.13","32.59"
"66","000","00","280","0015","1678","922","501","421","79","1001","1640","0","61.04","30.55"
"66","000","00","280","0015","1679","921","453","468","77","998","1769","0","56.42","25.61"
"66","000","00","280","0016","0000","4133","2121","2012","259","4392","8051","0","54.55","26.34"
"66","000","00","280","0016","1680","704","340","364","48","752","1451","0","51.83","23.43"
"66","000","00","280","0016","1681","692","341","351","54","746","1333","0","55.96","25.58"
"66","000","00","280","0016","1682","700","355","345","43","743","1363","0","54.51","26.05"
"66","000","00","280","0016","1683","662","369","293","44","706","1243","0","56.80","29.69"
"66","000","00","280","0016","1684","636","343","293","48","684","1241","0","55.12","27.64"
"66","000","00","280","0016","1685","739","373","366","22","761","1420","0","53.59","26.27"
"66","000","00","280","0017","0000","5994","3003","2991","331","6325","11198","0","56.48","26.82"
"66","000","00","280","0017","1733","762","401","361","54","816","1377","0","59.26","29.12"
"66","000","00","280","0017","1734","772","383","389","40","812","1416","0","57.34","27.05"
"66","000","00","280","0017","1735","774","356","418","56","830","1474","0","56.31","24.15"
"66","000","00","280","0017","1736","714","365","349","49","763","1352","0","56.43","27.00"
"66","000","00","280","0017","1737","797","382","415","30","827","1437","0","57.55","26.58"
"66","000","00","280","0017","1738","713","360","353","36","749","1402","0","53.42","25.68"
"66","000","00","280","0017","1739","662","351","311","40","702","1298","0","54.08","27.04"
"66","000","00","280","0017","1740","800","405","395","26","826","1442","0","57.28","28.09"
"66","000","00","280","0018","0000","4943","2615","2328","269","5212","9197","0","56.67","28.43"
"66","000","00","280","0018","1713","877","520","357","52","929","1652","0","56.23","31.48"
"66","000","00","280","0018","1714","803","435","368","56","859","1576","0","54.51","27.60"
"66","000","00","280","0018","1715","805","409","396","45","850","1373","0","61.91","29.79"
"66","000","00","280","0018","1716","840","418","422","37","877","1551","0","56.54","26.95"
"66","000","00","280","0018","1717","869","436","433","40","909","1639","0","55.46","26.60"
"66","000","00","280","0018","1718","749","397","352","39","788","1406","0","56.05","28.24"
"66","000","00","280","0019","0000","4947","2502","2445","309","5256","10324","0","50.91","24.23"
"66","000","00","280","0019","1621","992","405","587","68","1060","1888","0","56.14","21.45"
"66","000","00","280","0019","1622","709","369","340","38","747","1512","0","49.40","24.40"
"66","000","00","280","0019","1623","655","351","304","40","695","1593","0","43.63","22.03"
"66","000","00","280","0019","1624","654","331","323","41","695","1251","0","55.56","26.46"
"66","000","00","280","0019","1625","695","373","322","57","752","1391","0","54.06","26.82"
"66","000","00","280","0019","1626","557","283","274","42","599","1144","0","52.36","24.74"
"66","000","00","280","0019","1627","685","390","295","23","708","1545","0","45.83","25.24"
"66","000","00","280","0020","0000","1390","708","682","97","1487","2697","0","55.14","26.25"
"66","000","00","280","0020","1628","699","358","341","45","744","1391","0","53.49","25.74"
"66","000","00","280","0020","1629","691","350","341","52","743","1306","0","56.89","26.80"
"66","000","00","280","0021","0000","2873","1372","1501","118","2991","5499","0","54.39","24.95"
"66","000","00","280","0021","1639","708","339","369","44","752","1372","0","54.81","24.71"
"66","000","00","280","0021","1640","637","335","302","29","666","1356","0","49.12","24.71"
"66","000","00","280","0021","1641","805","365","440","23","828","1483","0","55.83","24.61"
"66","000","00","280","0021","1642","723","333","390","22","745","1288","0","57.84","25.85"
"66","000","00","280","0022","0000","2294","1191","1103","114","2408","4036","0","59.66","29.51"
"66","000","00","280","0022","1691","815","434","381","38","853","1512","0","56.42","28.70"
"66","000","00","280","0022","1692","665","335","330","37","702","1183","0","59.34","28.32"
"66","000","00","280","0022","1693","814","422","392","39","853","1341","0","63.61","31.47"
"66","000","00","280","0023","0000","5520","2647","2873","144","5664","9491","0","59.68","27.89"
"66","000","00","280","0023","1694","918","452","466","25","943","1612","0","58.50","28.04"
"66","000","00","280","0023","1695","889","417","472","34","923","1530","0","60.33","27.25"
"66","000","00","280","0023","1696","975","472","503","9","984","1544","0","63.73","30.57"
"66","000","00","280","0023","1697","924","417","507","30","954","1588","0","60.08","26.26"
"66","000","00","280","0023","1698","906","439","467","24","930","1581","0","58.82","27.77"
"66","000","00","280","0023","1699","908","450","458","22","930","1636","0","56.85","27.51"
"66","000","00","280","0024","0000","4694","2260","2434","190","4884","8350","0","58.49","27.07"
"66","000","00","280","0024","1707","752","364","388","32","784","1470","0","53.33","24.76"
"66","000","00","280","0024","1708","787","378","409","29","816","1331","0","61.31","28.40"
"66","000","00","280","0024","1709","769","339","430","35","804","1316","0","61.09","25.76"
"66","000","00","280","0024","1710","745","410","335","48","793","1293","0","61.33","31.71"
"66","000","00","280","0024","1711","782","343","439","29","811","1438","0","56.40","23.85"
"66","000","00","280","0024","1712","859","426","433","17","876","1502","0","58.32","28.36"
"66","000","00","280","0025","0000","2784","1351","1433","129","2913","5242","0","55.57","25.77"
"66","000","00","280","0025","1657","688","356","332","38","726","1315","0","55.21","27.07"
"66","000","00","280","0025","1658","654","309","345","26","680","1253","0","54.27","24.66"
"66","000","00","280","0025","1659","735","341","394","34","769","1433","0","53.66","23.80"
"66","000","00","280","0025","1660","707","345","362","31","738","1241","0","59.47","27.80"
"66","000","00","280","0026","0000","4367","2234","2133","183","4550","7544","0","60.31","29.61"
"66","000","00","280","0026","1723","892","421","471","43","935","1548","0","60.40","27.20"
"66","000","00","280","0026","1724","846","436","410","51","897","1507","0","59.52","28.93"
"66","000","00","280","0026","1725","864","447","417","41","905","1469","0","61.61","30.43"
"66","000","00","280","0026","1726","931","484","447","23","954","1636","0","58.31","29.58"
"66","000","00","280","0026","1727","834","446","388","25","859","1384","0","62.07","32.23"
"66","000","00","280","0027","0000","2900","1485","1415","173","3073","5675","0","54.15","26.17"
"66","000","00","280","0027","1673","792","411","381","46","838","1584","0","52.90","25.95"
"66","000","00","280","0027","1674","682","348","334","43","725","1369","0","52.96","25.42"
"66","000","00","280","0027","1675","784","405","379","39","823","1438","0","57.23","28.16"
"66","000","00","280","0027","1676","642","321","321","45","687","1284","0","53.50","25.00"
"66","000","00","290","0000","0000","5376","2197","3179","422","5798","9307","10936","62.30","23.61"
"66","000","00","290","0001","0000","1077","442","635","86","1163","1879","0","61.89","23.52"
"66","000","00","290","0001","1864","502","237","265","40","542","936","0","57.91","25.32"
"66","000","00","290","0001","1865","575","205","370","46","621","943","0","65.85","21.74"
"66","000","00","290","0002","0000","250","134","116","28","278","451","0","61.64","29.71"
"66","000","00","290","0002","1866","250","134","116","28","278","451","0","61.64","29.71"
"66","000","00","290","0003","0000","939","407","532","74","1013","1583","0","63.99","25.71"
"66","000","00","290","0003","1867","533","220","313","37","570","952","0","59.87","23.11"
"66","000","00","290","0003","1868","406","187","219","37","443","631","0","70.21","29.64"
"66","000","00","290","0004","0000","273","115","158","13","286","444","0","64.41","25.90"
"66","000","00","290","0004","1874","273","115","158","13","286","444","0","64.41","25.90"
"66","000","00","290","0005","0000","623","229","394","50","673","1032","0","65.21","22.19"
"66","000","00","290","0005","1869","147","61","86","14","161","272","0","59.19","22.43"
"66","000","00","290","0005","1870","270","84","186","10","280","445","0","62.92","18.88"
"66","000","00","290","0005","1871","206","84","122","26","232","315","0","73.65","26.67"
"66","000","00","290","0006","0000","654","255","399","19","673","1101","0","61.13","23.16"
"66","000","00","290","0006","1872","490","208","282","9","499","760","0","65.66","27.37"
"66","000","00","290","0006","1873","164","47","117","10","174","341","0","51.03","13.78"
"66","000","00","290","0007","0000","953","387","566","86","1039","1911","0","54.37","20.25"
"66","000","00","290","0007","1875","189","80","109","28","217","358","0","60.61","22.35"
"66","000","00","290","0007","1876","354","157","197","29","383","750","0","51.07","20.93"
"66","000","00","290","0007","1877","218","79","139","19","237","525","0","45.14","15.05"
"66","000","00","290","0007","1878","192","71","121","10","202","278","0","72.66","25.54"
"66","000","00","290","0008","0000","607","228","379","66","673","906","0","74.28","25.17"
"66","000","00","290","0008","1879","67","25","42","13","80","147","0","54.42","17.01"
"66","000","00","290","0008","1880","540","203","337","53","593","759","0","78.13","26.75"
"67","000","00","000","0000","0000","823473","490678","332795","55652","879125","1551209","1850955","56.67","31.63"
"67","000","00","010","0000","0000","31665","17790","13875","1883","33548","62180","74850","53.95","28.61"
"67","000","00","010","0001","0000","2235","1083","1152","112","2347","4381","0","53.57","24.72"
"67","000","00","010","0001","0115","561","280","281","27","588","1246","0","47.19","22.47"
"67","000","00","010","0001","0116","542","231","311","31","573","1059","0","54.11","21.81"
"67","000","00","010","0001","0117","530","285","245","21","551","985","0","55.94","28.93"
"67","000","00","010","0001","0118","602","287","315","33","635","1091","0","58.20","26.31"
"67","000","00","010","0002","0000","1093","613","480","44","1137","2143","0","53.06","28.60"
"67","000","00","010","0002","0119","565","322","243","20","585","1097","0","53.33","29.35"
"67","000","00","010","0002","0120","528","291","237","24","552","1046","0","52.77","27.82"
"67","000","00","010","0003","0000","1498","845","653","96","1594","2708","0","58.86","31.20"
"67","000","00","010","0003","0121","691","406","285","40","731","1315","0","55.59","30.87"
"67","000","00","010","0003","0122","807","439","368","56","863","1393","0","61.95","31.51"
"67","000","00","010","0007","0000","1345","774","571","85","1430","2665","0","53.66","29.04"
"67","000","00","010","0007","0126","517","282","235","34","551","977","0","56.40","28.86"
"67","000","00","010","0007","0127","414","227","187","17","431","861","0","50.06","26.36"
"67","000","00","010","0007","0128","414","265","149","34","448","827","0","54.17","32.04"
"67","000","00","010","0008","0000","2034","1071","963","103","2137","3859","0","55.38","27.75"
"67","000","00","010","0008","0129","647","346","301","43","690","1240","0","55.65","27.90"
"67","000","00","010","0008","0130","654","357","297","38","692","1269","0","54.53","28.13"
"67","000","00","010","0008","0131","733","368","365","22","755","1350","0","55.93","27.26"
"67","000","00","010","0009","0000","537","314","223","20","557","1069","0","52.10","29.37"
"67","000","00","010","0009","0137","537","314","223","20","557","1069","0","52.10","29.37"
"67","000","00","010","0010","0000","684","421","263","47","731","1381","0","52.93","30.49"
"67","000","00","010","0010","0138","684","421","263","47","731","1381","0","52.93","30.49"
"67","000","00","010","0012","0000","1074","607","467","61","1135","2248","0","50.49","27.00"
"67","000","00","010","0012","0141","537","314","223","41","578","1104","0","52.36","28.44"
"67","000","00","010","0012","0142","537","293","244","20","557","1144","0","48.69","25.61"
"67","000","00","010","0013","0000","824","428","396","29","853","1707","0","49.97","25.07"
"67","000","00","010","0013","0139","380","187","193","17","397","808","0","49.13","23.14"
"67","000","00","010","0013","0140","444","241","203","12","456","899","0","50.72","26.81"
"67","000","00","010","0014","0000","1360","798","562","80","1440","3045","0","47.29","26.21"
"67","000","00","010","0014","0143","456","262","194","22","478","941","0","50.80","27.84"
"67","000","00","010","0014","0144","424","261","163","29","453","966","0","46.89","27.02"
"67","000","00","010","0014","0145","480","275","205","29","509","1138","0","44.73","24.17"
"67","000","00","010","0015","0000","2236","1268","968","116","2352","4358","0","53.97","29.10"
"67","000","00","010","0015","0154","629","347","282","45","674","1265","0","53.28","27.43"
"67","000","00","010","0015","0155","471","273","198","32","503","877","0","57.35","31.13"
"67","000","00","010","0015","0156","476","257","219","15","491","1030","0","47.67","24.95"
"67","000","00","010","0015","0157","660","391","269","24","684","1186","0","57.67","32.97"
"67","000","00","010","0016","0000","852","477","375","67","919","1575","0","58.35","30.29"
"67","000","00","010","0016","0158","530","290","240","49","579","896","0","64.62","32.37"
"67","000","00","010","0016","0159","322","187","135","18","340","679","0","50.07","27.54"
"67","000","00","010","0017","0000","711","450","261","75","786","1305","0","60.23","34.48"
"67","000","00","010","0017","0160","711","450","261","75","786","1305","0","60.23","34.48"
"67","000","00","010","0018","0000","876","603","273","91","967","1643","0","58.86","36.70"
"67","000","00","010","0018","0161","727","496","231","75","802","1397","0","57.41","35.50"
"67","000","00","010","0018","0162","149","107","42","16","165","246","0","67.07","43.50"
"67","000","00","010","0019","0000","945","606","339","86","1031","1670","0","61.74","36.29"
"67","000","00","010","0019","0163","501","307","194","29","530","931","0","56.93","32.98"
"67","000","00","010","0019","0164","444","299","145","57","501","739","0","67.79","40.46"
"67","000","00","010","0020","0000","1864","1039","825","111","1975","3522","0","56.08","29.50"
"67","000","00","010","0020","0165","571","337","234","35","606","1122","0","54.01","30.04"
"67","000","00","010","0020","0166","688","382","306","38","726","1323","0","54.88","28.87"
"67","000","00","010","0020","0167","605","320","285","38","643","1077","0","59.70","29.71"
"67","000","00","010","0021","0000","990","593","397","77","1067","1808","0","59.02","32.80"
"67","000","00","010","0021","0168","549","338","211","52","601","996","0","60.34","33.94"
"67","000","00","010","0021","0169","441","255","186","25","466","812","0","57.39","31.40"
"67","000","00","010","0025","0000","709","469","240","90","799","1496","0","53.41","31.35"
"67","000","00","010","0025","0172","278","176","102","21","299","632","0","47.31","27.85"
"67","000","00","010","0025","0173","431","293","138","69","500","864","0","57.87","33.91"
"67","000","00","010","0026","0000","431","307","124","35","466","832","0","56.01","36.90"
"67","000","00","010","0026","0170","236","172","64","19","255","471","0","54.14","36.52"
"67","000","00","010","0026","0171","195","135","60","16","211","361","0","58.45","37.40"
"67","000","00","010","0027","0000","2204","1159","1045","137","2341","4804","0","48.73","24.13"
"67","000","00","010","0027","0146","595","313","282","39","634","1239","0","51.17","25.26"
"67","000","00","010","0027","0147","512","250","262","33","545","1198","0","45.49","20.87"
"67","000","00","010","0027","0148","476","253","223","42","518","1060","0","48.87","23.87"
"67","000","00","010","0027","0149","621","343","278","23","644","1307","0","49.27","26.24"
"67","000","00","010","0028","0000","2435","1321","1114","122","2557","5115","0","49.99","25.83"
"67","000","00","010","0028","0150","658","377","281","29","687","1354","0","50.74","27.84"
"67","000","00","010","0028","0151","643","329","314","24","667","1361","0","49.01","24.17"
"67","000","00","010","0028","0152","518","272","246","32","550","1141","0","48.20","23.84"
"67","000","00","010","0028","0153","616","343","273","37","653","1259","0","51.87","27.24"
"67","000","00","010","0029","0000","3495","1831","1664","109","3604","6391","0","56.39","28.65"
"67","000","00","010","0029","0132","659","376","283","28","687","1212","0","56.68","31.02"
"67","000","00","010","0029","0133","705","322","383","22","727","1334","0","54.50","24.14"
"67","000","00","010","0029","0134","685","350","335","22","707","1223","0","57.81","28.62"
"67","000","00","010","0029","0135","728","397","331","25","753","1289","0","58.42","30.80"
"67","000","00","010","0029","0136","718","386","332","12","730","1333","0","54.76","28.96"
"67","000","00","010","0030","0000","1233","713","520","90","1323","2455","0","53.89","29.04"
"67","000","00","010","0030","0123","455","258","197","35","490","829","0","59.11","31.12"
"67","000","00","010","0030","0124","462","274","188","24","486","944","0","51.48","29.03"
"67","000","00","010","0030","0125","316","181","135","31","347","682","0","50.88","26.54"
"67","000","00","020","0000","0000","11071","7115","3956","1058","12129","21164","24464","57.31","33.62"
"67","000","00","020","0001","0000","735","495","240","93","828","1501","0","55.16","32.98"
"67","000","00","020","0001","0084","520","365","155","65","585","1055","0","55.45","34.60"
"67","000","00","020","0001","0085","215","130","85","28","243","446","0","54.48","29.15"
"67","000","00","020","0008","0000","1892","1150","742","179","2071","3570","0","58.01","32.21"
"67","000","00","020","0008","0092","525","336","189","68","593","1042","0","56.91","32.25"
"67","000","00","020","0008","0093","732","430","302","65","797","1318","0","60.47","32.63"
"67","000","00","020","0008","0094","635","384","251","46","681","1210","0","56.28","31.74"
"67","000","00","020","0010","0000","409","295","114","35","444","867","0","51.21","34.03"
"67","000","00","020","0010","0098","409","295","114","35","444","867","0","51.21","34.03"
"67","000","00","020","0011","0000","1815","1092","723","116","1931","3746","0","51.55","29.15"
"67","000","00","020","0011","0095","692","403","289","42","734","1428","0","51.40","28.22"
"67","000","00","020","0011","0096","655","404","251","41","696","1267","0","54.93","31.89"
"67","000","00","020","0011","0097","468","285","183","33","501","1051","0","47.67","27.12"
"67","000","00","020","0014","0000","660","420","240","82","742","1559","0","47.59","26.94"
"67","000","00","020","0014","0106","406","256","150","68","474","883","0","53.68","28.99"
"67","000","00","020","0014","0107","254","164","90","14","268","676","0","39.64","24.26"
"67","000","00","020","0026","0000","838","535","303","44","882","1371","0","64.33","39.02"
"67","000","00","020","0026","0086","366","226","140","19","385","614","0","62.70","36.81"
"67","000","00","020","0026","0087","195","126","69","17","212","285","0","74.39","44.21"
"67","000","00","020","0026","0088","277","183","94","8","285","472","0","60.38","38.77"
"67","000","00","020","0027","0000","840","474","366","52","892","1489","0","59.91","31.83"
"67","000","00","020","0027","0089","406","236","170","23","429","726","0","59.09","32.51"
"67","000","00","020","0027","0090","157","93","64","9","166","297","0","55.89","31.31"
"67","000","00","020","0027","0091","277","145","132","20","297","466","0","63.73","31.12"
"67","000","00","020","0028","0000","821","541","280","66","887","1447","0","61.30","37.39"
"67","000","00","020","0028","0101","416","292","124","16","432","744","0","58.06","39.25"
"67","000","00","020","0028","0102","156","99","57","18","174","261","0","66.67","37.93"
"67","000","00","020","0028","0103","249","150","99","32","281","442","0","63.57","33.94"
"67","000","00","020","0029","0000","698","462","236","68","766","1506","0","50.86","30.68"
"67","000","00","020","0029","0099","424","283","141","39","463","809","0","57.23","34.98"
"67","000","00","020","0029","0100","274","179","95","29","303","697","0","43.47","25.68"
"67","000","00","020","0030","0000","450","314","136","60","510","932","0","54.72","33.69"
"67","000","00","020","0030","0104","285","197","88","40","325","571","0","56.92","34.50"
"67","000","00","020","0030","0105","165","117","48","20","185","361","0","51.25","32.41"
"67","000","00","020","0031","0000","589","419","170","69","658","1020","0","64.51","41.08"
"67","000","00","020","0031","0111","402","295","107","40","442","695","0","63.60","42.45"
"67","000","00","020","0031","0112","187","124","63","29","216","325","0","66.46","38.15"
"67","000","00","020","0032","0000","474","306","168","72","546","852","0","64.08","35.92"
"67","000","00","020","0032","0108","102","74","28","18","120","196","0","61.22","37.76"
"67","000","00","020","0032","0109","221","130","91","27","248","360","0","68.89","36.11"
"67","000","00","020","0032","0110","151","102","49","27","178","296","0","60.14","34.46"
"67","000","00","020","0033","0000","850","612","238","122","972","1304","0","74.54","46.93"
"67","000","00","020","0033","0113","615","439","176","95","710","876","0","81.05","50.11"
"67","000","00","020","0033","0114","235","173","62","27","262","428","0","61.21","40.42"
"67","000","00","030","0000","0000","12116","7902","4214","1713","13829","23163","26271","59.70","34.11"
"67","000","00","030","0001","0000","828","507","321","99","927","1614","0","57.43","31.41"
"67","000","00","030","0001","0030","482","299","183","56","538","930","0","57.85","32.15"
"67","000","00","030","0001","0031","346","208","138","43","389","684","0","56.87","30.41"
"67","000","00","030","0002","0000","1462","946","516","94","1556","2831","0","54.96","33.42"
"67","000","00","030","0002","0032","422","282","140","26","448","807","0","55.51","34.94"
"67","000","00","030","0002","0033","492","323","169","33","525","940","0","55.85","34.36"
"67","000","00","030","0002","0034","548","341","207","35","583","1084","0","53.78","31.46"
"67","000","00","030","0003","0000","622","402","220","77","699","1326","0","52.71","30.32"
"67","000","00","030","0003","0035","622","402","220","77","699","1326","0","52.71","30.32"
"67","000","00","030","0004","0000","788","497","291","83","871","1537","0","56.67","32.34"
"67","000","00","030","0004","0036","336","217","119","56","392","680","0","57.65","31.91"
"67","000","00","030","0004","0037","452","280","172","27","479","857","0","55.89","32.67"
"67","000","00","030","0005","0000","547","341","206","81","628","871","0","72.10","39.15"
"67","000","00","030","0005","0038","547","341","206","81","628","871","0","72.10","39.15"
"67","000","00","030","0006","0000","644","431","213","105","749","1266","0","59.16","34.04"
"67","000","00","030","0006","0039","386","264","122","78","464","756","0","61.38","34.92"
"67","000","00","030","0006","0040","258","167","91","27","285","510","0","55.88","32.75"
"67","000","00","030","0007","0000","269","179","90","31","300","422","0","71.09","42.42"
"67","000","00","030","0007","0041","269","179","90","31","300","422","0","71.09","42.42"
"67","000","00","030","0008","0000","360","250","110","58","418","558","0","74.91","44.80"
"67","000","00","030","0008","0042","360","250","110","58","418","558","0","74.91","44.80"
"67","000","00","030","0009","0000","148","94","54","31","179","342","0","52.34","27.49"
"67","000","00","030","0009","0043","148","94","54","31","179","342","0","52.34","27.49"
"67","000","00","030","0010","0000","189","138","51","45","234","465","0","50.32","29.68"
"67","000","00","030","0010","0044","189","138","51","45","234","465","0","50.32","29.68"
"67","000","00","030","0011","0000","483","330","153","106","589","1116","0","52.78","29.57"
"67","000","00","030","0011","0047","187","115","72","36","223","396","0","56.31","29.04"
"67","000","00","030","0011","0048","296","215","81","70","366","720","0","50.83","29.86"
"67","000","00","030","0012","0000","473","309","164","82","555","932","0","59.55","33.15"
"67","000","00","030","0012","0045","307","211","96","46","353","579","0","60.97","36.44"
"67","000","00","030","0012","0046","166","98","68","36","202","353","0","57.22","27.76"
"67","000","00","030","0014","0000","611","392","219","70","681","1302","0","52.30","30.11"
"67","000","00","030","0014","0051","298","187","111","36","334","658","0","50.76","28.42"
"67","000","00","030","0014","0052","313","205","108","34","347","644","0","53.88","31.83"
"67","000","00","030","0018","0000","491","295","196","84","575","825","0","69.70","35.76"
"67","000","00","030","0018","0055","491","295","196","84","575","825","0","69.70","35.76"
"67","000","00","030","0019","0000","321","202","119","56","377","676","0","55.77","29.88"
"67","000","00","030","0019","0056","321","202","119","56","377","676","0","55.77","29.88"
"67","000","00","030","0020","0000","637","406","231","108","745","1278","0","58.29","31.77"
"67","000","00","030","0020","0057","637","406","231","108","745","1278","0","58.29","31.77"
"67","000","00","030","0021","0000","377","242","135","43","420","674","0","62.31","35.91"
"67","000","00","030","0021","0058","377","242","135","43","420","674","0","62.31","35.91"
"67","000","00","030","0022","0000","424","268","156","47","471","623","0","75.60","43.02"
"67","000","00","030","0022","0059","424","268","156","47","471","623","0","75.60","43.02"
"67","000","00","030","0025","0000","953","656","297","139","1092","1848","0","59.09","35.50"
"67","000","00","030","0025","0049","394","278","116","73","467","748","0","62.43","37.17"
"67","000","00","030","0025","0050","559","378","181","66","625","1100","0","56.82","34.36"
"67","000","00","030","0026","0000","836","569","267","147","983","1398","0","70.31","40.70"
"67","000","00","030","0026","0053","326","206","120","69","395","593","0","66.61","34.74"
"67","000","00","030","0026","0054","510","363","147","78","588","805","0","73.04","45.09"
"67","000","00","030","0027","0000","653","448","205","127","780","1259","0","61.95","35.58"
"67","000","00","030","0027","0060","441","294","147","92","533","789","0","67.55","37.26"
"67","000","00","030","0027","0061","212","154","58","35","247","470","0","52.55","32.77"
"67","000","00","040","0000","0000","9831","6083","3748","1132","10963","17959","20406","61.04","33.87"
"67","000","00","040","0001","0000","923","541","382","80","1003","1783","0","56.25","30.34"
"67","000","00","040","0001","0174","593","354","239","58","651","1132","0","57.51","31.27"
"67","000","00","040","0001","0175","330","187","143","22","352","651","0","54.07","28.73"
"67","000","00","040","0002","0000","881","522","359","77","958","1548","0","61.89","33.72"
"67","000","00","040","0002","0176","383","215","168","34","417","680","0","61.32","31.62"
"67","000","00","040","0002","0177","498","307","191","43","541","868","0","62.33","35.37"
"67","000","00","040","0003","0000","617","392","225","51","668","1109","0","60.23","35.35"
"67","000","00","040","0003","0178","617","392","225","51","668","1109","0","60.23","35.35"
"67","000","00","040","0004","0000","1573","940","633","154","1727","2715","0","63.61","34.62"
"67","000","00","040","0004","0179","454","292","162","53","507","855","0","59.30","34.15"
"67","000","00","040","0004","0180","597","358","239","52","649","1012","0","64.13","35.38"
"67","000","00","040","0004","0181","522","290","232","49","571","848","0","67.33","34.20"
"67","000","00","040","0005","0000","667","409","258","70","737","1330","0","55.41","30.75"
"67","000","00","040","0005","0182","667","409","258","70","737","1330","0","55.41","30.75"
"67","000","00","040","0006","0000","405","229","176","36","441","694","0","63.54","33.00"
"67","000","00","040","0006","0183","236","131","105","17","253","376","0","67.29","34.84"
"67","000","00","040","0006","0184","169","98","71","19","188","318","0","59.12","30.82"
"67","000","00","040","0007","0000","903","553","350","106","1009","1396","0","72.28","39.61"
"67","000","00","040","0007","0185","443","254","189","60","503","665","0","75.64","38.20"
"67","000","00","040","0007","0186","460","299","161","46","506","731","0","69.22","40.90"
"67","000","00","040","0008","0000","861","535","326","111","972","1674","0","58.06","31.96"
"67","000","00","040","0008","0187","324","215","109","44","368","663","0","55.51","32.43"
"67","000","00","040","0008","0188","386","218","168","53","439","744","0","59.01","29.30"
"67","000","00","040","0008","0189","151","102","49","14","165","267","0","61.80","38.20"
"67","000","00","040","0009","0000","723","459","264","90","813","1223","0","66.48","37.53"
"67","000","00","040","0009","0190","369","227","142","48","417","635","0","65.67","35.75"
"67","000","00","040","0009","0191","354","232","122","42","396","588","0","67.35","39.46"
"67","000","00","040","0010","0000","362","272","90","28","390","632","0","61.71","43.04"
"67","000","00","040","0010","0192","362","272","90","28","390","632","0","61.71","43.04"
"67","000","00","040","0011","0000","634","425","209","102","736","1283","0","57.37","33.13"
"67","000","00","040","0011","0193","542","366","176","83","625","1097","0","56.97","33.36"
"67","000","00","040","0011","0194","92","59","33","19","111","186","0","59.68","31.72"
"67","000","00","040","0012","0000","585","377","208","75","660","1135","0","58.15","33.22"
"67","000","00","040","0012","0195","497","323","174","67","564","994","0","56.74","32.49"
"67","000","00","040","0012","0196","88","54","34","8","96","141","0","68.09","38.30"
"67","000","00","040","0013","0000","697","429","268","152","849","1437","0","59.08","29.85"
"67","000","00","040","0013","0197","381","227","154","93","474","814","0","58.23","27.89"
"67","000","00","040","0013","0198","244","153","91","40","284","479","0","59.29","31.94"
"67","000","00","040","0013","0199","72","49","23","19","91","144","0","63.19","34.03"
"67","000","00","050","0000","0000","10638","6858","3780","1403","12041","19407","21941","62.04","35.34"
"67","000","00","050","0001","0000","745","458","287","44","789","1550","0","50.90","29.55"
"67","000","00","050","0001","0001","353","225","128","24","377","673","0","56.02","33.43"
"67","000","00","050","0001","0002","392","233","159","20","412","877","0","46.98","26.57"
"67","000","00","050","0002","0000","719","481","238","113","832","1218","0","68.31","39.49"
"67","000","00","050","0002","0003","420","287","133","76","496","722","0","68.70","39.75"
"67","000","00","050","0002","0004","299","194","105","37","336","496","0","67.74","39.11"
"67","000","00","050","0003","0000","664","406","258","76","740","1218","0","60.76","33.33"
"67","000","00","050","0003","0005","529","317","212","64","593","997","0","59.48","31.80"
"67","000","00","050","0003","0006","135","89","46","12","147","221","0","66.52","40.27"
"67","000","00","050","0004","0000","594","406","188","76","670","1222","0","54.83","33.22"
"67","000","00","050","0004","0007","186","115","71","31","217","425","0","51.06","27.06"
"67","000","00","050","0004","0008","408","291","117","45","453","797","0","56.84","36.51"
"67","000","00","050","0010","0000","764","558","206","141","905","1274","0","71.04","43.80"
"67","000","00","050","0010","0021","506","379","127","85","591","866","0","68.24","43.76"
"67","000","00","050","0010","0022","258","179","79","56","314","408","0","76.96","43.87"
"67","000","00","050","0011","0000","772","491","281","89","861","1553","0","55.44","31.62"
"67","000","00","050","0011","0023","313","206","107","44","357","611","0","58.43","33.72"
"67","000","00","050","0011","0024","459","285","174","45","504","942","0","53.50","30.25"
"67","000","00","050","0012","0000","704","439","265","44","748","1212","0","61.72","36.22"
"67","000","00","050","0012","0025","704","439","265","44","748","1212","0","61.72","36.22"
"67","000","00","050","0013","0000","647","401","246","98","745","1163","0","64.06","34.48"
"67","000","00","050","0013","0026","340","219","121","55","395","636","0","62.11","34.43"
"67","000","00","050","0013","0027","307","182","125","43","350","527","0","66.41","34.54"
"67","000","00","050","0014","0000","825","534","291","84","909","1683","0","54.01","31.73"
"67","000","00","050","0014","0028","252","166","86","33","285","570","0","50.00","29.12"
"67","000","00","050","0014","0029","573","368","205","51","624","1113","0","56.06","33.06"
"67","000","00","050","0018","0000","701","410","291","115","816","1286","0","63.45","31.88"
"67","000","00","050","0018","0013","198","120","78","39","237","335","0","70.75","35.82"
"67","000","00","050","0018","0014","329","198","131","40","369","586","0","62.97","33.79"
"67","000","00","050","0018","0015","174","92","82","36","210","365","0","57.53","25.21"
"67","000","00","050","0019","0000","640","434","206","103","743","934","0","79.55","46.47"
"67","000","00","050","0019","0016","339","235","104","56","395","497","0","79.48","47.28"
"67","000","00","050","0019","0017","301","199","102","47","348","437","0","79.63","45.54"
"67","000","00","050","0022","0000","1070","659","411","167","1237","1862","0","66.43","35.39"
"67","000","00","050","0022","0018","497","295","202","98","595","903","0","65.89","32.67"
"67","000","00","050","0022","0019","285","185","100","41","326","453","0","71.96","40.84"
"67","000","00","050","0022","0020","288","179","109","28","316","506","0","62.45","35.38"
"67","000","00","050","0023","0000","1232","836","396","148","1380","2070","0","66.67","40.39"
"67","000","00","050","0023","0009","587","405","182","90","677","1010","0","67.03","40.10"
"67","000","00","050","0023","0010","645","431","214","58","703","1060","0","66.32","40.66"
"67","000","00","050","0024","0000","561","345","216","105","666","1162","0","57.31","29.69"
"67","000","00","050","0024","0011","360","220","140","70","430","732","0","58.74","30.05"
"67","000","00","050","0024","0012","201","125","76","35","236","430","0","54.88","29.07"
"67","000","00","060","0000","0000","8043","5120","2923","1426","9469","17240","19436","54.92","29.70"
"67","000","00","060","0001","0000","586","341","245","79","665","1363","0","48.79","25.02"
"67","000","00","060","0001","0062","586","341","245","79","665","1363","0","48.79","25.02"
"67","000","00","060","0002","0000","1048","689","359","107","1155","2375","0","48.63","29.01"
"67","000","00","060","0002","0063","501","329","172","43","544","1104","0","49.28","29.80"
"67","000","00","060","0002","0064","547","360","187","64","611","1271","0","48.07","28.32"
"67","000","00","060","0003","0000","603","402","201","102","705","1352","0","52.14","29.73"
"67","000","00","060","0003","0065","299","206","93","48","347","686","0","50.58","30.03"
"67","000","00","060","0003","0066","304","196","108","54","358","666","0","53.75","29.43"
"67","000","00","060","0004","0000","364","251","113","74","438","884","0","49.55","28.39"
"67","000","00","060","0004","0068","364","251","113","74","438","884","0","49.55","28.39"
"67","000","00","060","0005","0000","412","253","159","88","500","996","0","50.20","25.40"
"67","000","00","060","0005","0067","412","253","159","88","500","996","0","50.20","25.40"
"67","000","00","060","0006","0000","608","381","227","180","788","1124","0","70.11","33.90"
"67","000","00","060","0006","0069","299","182","117","106","405","591","0","68.53","30.80"
"67","000","00","060","0006","0070","309","199","110","74","383","533","0","71.86","37.34"
"67","000","00","060","0007","0000","471","308","163","67","538","799","0","67.33","38.55"
"67","000","00","060","0007","0071","471","308","163","67","538","799","0","67.33","38.55"
"67","000","00","060","0008","0000","164","112","52","32","196","401","0","48.88","27.93"
"67","000","00","060","0008","0075","164","112","52","32","196","401","0","48.88","27.93"
"67","000","00","060","0009","0000","205","149","56","38","243","360","0","67.50","41.39"
"67","000","00","060","0009","0076","205","149","56","38","243","360","0","67.50","41.39"
"67","000","00","060","0010","0000","297","207","90","51","348","400","0","87.00","51.75"
"67","000","00","060","0010","0077","297","207","90","51","348","400","0","87.00","51.75"
"67","000","00","060","0011","0000","695","409","286","82","777","1959","0","39.66","20.88"
"67","000","00","060","0011","0078","359","222","137","18","377","1137","0","33.16","19.53"
"67","000","00","060","0011","0079","336","187","149","64","400","822","0","48.66","22.75"
"67","000","00","060","0012","0000","228","160","68","78","306","595","0","51.43","26.89"
"67","000","00","060","0012","0080","228","160","68","78","306","595","0","51.43","26.89"
"67","000","00","060","0013","0000","563","369","194","129","692","1010","0","68.51","36.53"
"67","000","00","060","0013","0081","563","369","194","129","692","1010","0","68.51","36.53"
"67","000","00","060","0014","0000","521","312","209","144","665","1009","0","65.91","30.92"
"67","000","00","060","0014","0082","521","312","209","144","665","1009","0","65.91","30.92"
"67","000","00","060","0015","0000","365","199","166","82","447","851","0","52.53","23.38"
"67","000","00","060","0015","0083","365","199","166","82","447","851","0","52.53","23.38"
"67","000","00","060","0016","0000","913","578","335","93","1006","1762","0","57.09","32.80"
"67","000","00","060","0016","0072","336","227","109","30","366","717","0","51.05","31.66"
"67","000","00","060","0016","0073","263","174","89","27","290","464","0","62.50","37.50"
"67","000","00","060","0016","0074","314","177","137","36","350","581","0","60.24","30.46"
"67","000","00","070","0000","0000","20088","13355","6733","1488","21576","36513","42944","59.09","36.58"
"67","000","00","070","0003","0000","1259","780","479","86","1345","2538","0","52.99","30.73"
"67","000","00","070","0003","0410","451","271","180","21","472","915","0","51.58","29.62"
"67","000","00","070","0003","0411","391","243","148","32","423","803","0","52.68","30.26"
"67","000","00","070","0003","0412","417","266","151","33","450","820","0","54.88","32.44"
"67","000","00","070","0004","0000","1184","787","397","81","1265","2368","0","53.42","33.23"
"67","000","00","070","0004","0413","328","225","103","26","354","702","0","50.43","32.05"
"67","000","00","070","0004","0414","380","238","142","24","404","796","0","50.75","29.90"
"67","000","00","070","0004","0415","476","324","152","31","507","870","0","58.28","37.24"
"67","000","00","070","0005","0000","1141","733","408","70","1211","2091","0","57.91","35.05"
"67","000","00","070","0005","0408","486","318","168","31","517","874","0","59.15","36.38"
"67","000","00","070","0005","0409","655","415","240","39","694","1217","0","57.03","34.10"
"67","000","00","070","0006","0000","956","608","348","42","998","1877","0","53.17","32.39"
"67","000","00","070","0006","0416","509","315","194","17","526","970","0","54.23","32.47"
"67","000","00","070","0006","0417","447","293","154","25","472","907","0","52.04","32.30"
"67","000","00","070","0007","0000","681","437","244","69","750","1374","0","54.59","31.80"
"67","000","00","070","0007","0418","391","240","151","36","427","751","0","56.86","31.96"
"67","000","00","070","0007","0419","290","197","93","33","323","623","0","51.85","31.62"
"67","000","00","070","0009","0000","1898","1277","621","99","1997","3383","0","59.03","37.75"
"67","000","00","070","0009","0420","625","419","206","32","657","1075","0","61.12","38.98"
"67","000","00","070","0009","0421","692","469","223","29","721","1233","0","58.48","38.04"
"67","000","00","070","0009","0422","581","389","192","38","619","1075","0","57.58","36.19"
"67","000","00","070","0010","0000","679","499","180","63","742","1057","0","70.20","47.21"
"67","000","00","070","0010","0423","679","499","180","63","742","1057","0","70.20","47.21"
"67","000","00","070","0011","0000","1440","921","519","82","1522","2746","0","55.43","33.54"
"67","000","00","070","0011","0424","424","272","152","36","460","806","0","57.07","33.75"
"67","000","00","070","0011","0425","466","291","175","26","492","872","0","56.42","33.37"
"67","000","00","070","0011","0426","550","358","192","20","570","1068","0","53.37","33.52"
"67","000","00","070","0014","0000","1167","686","481","80","1247","2245","0","55.55","30.56"
"67","000","00","070","0014","0429","355","182","173","11","366","682","0","53.67","26.69"
"67","000","00","070","0014","0430","368","223","145","23","391","725","0","53.93","30.76"
"67","000","00","070","0014","0431","444","281","163","46","490","838","0","58.47","33.53"
"67","000","00","070","0015","0000","1006","682","324","73","1079","1623","0","66.48","42.02"
"67","000","00","070","0015","0432","482","322","160","29","511","808","0","63.24","39.85"
"67","000","00","070","0015","0433","524","360","164","44","568","815","0","69.69","44.17"
"67","000","00","070","0017","0000","1127","789","338","89","1216","2237","0","54.36","35.27"
"67","000","00","070","0017","0434","636","447","189","46","682","1306","0","52.22","34.23"
"67","000","00","070","0017","0435","491","342","149","43","534","931","0","57.36","36.73"
"67","000","00","070","0019","0000","1257","867","390","115","1372","1997","0","68.70","43.42"
"67","000","00","070","0019","0436","578","398","180","50","628","934","0","67.24","42.61"
"67","000","00","070","0019","0437","388","257","131","35","423","624","0","67.79","41.19"
"67","000","00","070","0019","0438","291","212","79","30","321","439","0","73.12","48.29"
"67","000","00","070","0021","0000","643","442","201","42","685","1278","0","53.60","34.59"
"67","000","00","070","0021","0439","643","442","201","42","685","1278","0","53.60","34.59"
"67","000","00","070","0022","0000","578","396","182","79","657","1122","0","58.56","35.29"
"67","000","00","070","0022","0440","578","396","182","79","657","1122","0","58.56","35.29"
"67","000","00","070","0024","0000","820","578","242","59","879","1249","0","70.38","46.28"
"67","000","00","070","0024","0441","330","226","104","32","362","529","0","68.43","42.72"
"67","000","00","070","0024","0442","490","352","138","27","517","720","0","71.81","48.89"
"67","000","00","070","0028","0000","448","300","148","44","492","906","0","54.30","33.11"
"67","000","00","070","0028","0445","448","300","148","44","492","906","0","54.30","33.11"
"67","000","00","070","0030","0000","1099","743","356","57","1156","1806","0","64.01","41.14"
"67","000","00","070","0030","0406","723","483","240","37","760","1159","0","65.57","41.67"
"67","000","00","070","0030","0407","376","260","116","20","396","647","0","61.21","40.19"
"67","000","00","070","0031","0000","1097","768","329","122","1219","1592","0","76.57","48.24"
"67","000","00","070","0031","0443","576","407","169","53","629","821","0","76.61","49.57"
"67","000","00","070","0031","0444","521","361","160","69","590","771","0","76.52","46.82"
"67","000","00","070","0032","0000","879","600","279","72","951","1628","0","58.42","36.86"
"67","000","00","070","0032","0446","582","421","161","44","626","1062","0","58.95","39.64"
"67","000","00","070","0032","0447","297","179","118","28","325","566","0","57.42","31.63"
"67","000","00","070","0033","0000","729","462","267","64","793","1396","0","56.81","33.09"
"67","000","00","070","0033","0427","370","230","140","27","397","667","0","59.52","34.48"
"67","000","00","070","0033","0428","359","232","127","37","396","729","0","54.32","31.82"
"67","000","00","080","0000","0000","10922","6901","4021","1222","12144","19725","22672","61.57","34.99"
"67","000","00","080","0001","0000","732","423","309","70","802","1429","0","56.12","29.60"
"67","000","00","080","0001","0364","369","215","154","32","401","712","0","56.32","30.20"
"67","000","00","080","0001","0365","363","208","155","38","401","717","0","55.93","29.01"
"67","000","00","080","0002","0000","1090","685","405","120","1210","1900","0","63.68","36.05"
"67","000","00","080","0002","0366","536","318","218","62","598","946","0","63.21","33.62"
"67","000","00","080","0002","0367","554","367","187","58","612","954","0","64.15","38.47"
"67","000","00","080","0003","0000","914","539","375","122","1036","1517","0","68.29","35.53"
"67","000","00","080","0003","0368","429","257","172","56","485","699","0","69.38","36.77"
"67","000","00","080","0003","0369","485","282","203","66","551","818","0","67.36","34.47"
"67","000","00","080","0004","0000","773","452","321","94","867","1498","0","57.88","30.17"
"67","000","00","080","0004","0370","352","209","143","57","409","681","0","60.06","30.69"
"67","000","00","080","0004","0371","421","243","178","37","458","817","0","56.06","29.74"
"67","000","00","080","0005","0000","1110","685","425","112","1222","1953","0","62.57","35.07"
"67","000","00","080","0005","0372","546","329","217","66","612","958","0","63.88","34.34"
"67","000","00","080","0005","0373","564","356","208","46","610","995","0","61.31","35.78"
"67","000","00","080","0006","0000","1099","677","422","94","1193","2030","0","58.77","33.35"
"67","000","00","080","0006","0374","488","310","178","29","517","996","0","51.91","31.12"
"67","000","00","080","0006","0375","611","367","244","65","676","1034","0","65.38","35.49"
"67","000","00","080","0011","0000","1057","692","365","123","1180","1738","0","67.89","39.82"
"67","000","00","080","0011","0380","582","379","203","77","659","890","0","74.04","42.58"
"67","000","00","080","0011","0381","475","313","162","46","521","848","0","61.44","36.91"
"67","000","00","080","0012","0000","513","325","188","63","576","818","0","70.42","39.73"
"67","000","00","080","0012","0382","513","325","188","63","576","818","0","70.42","39.73"
"67","000","00","080","0013","0000","775","495","280","83","858","1205","0","71.20","41.08"
"67","000","00","080","0013","0383","414","263","151","45","459","626","0","73.32","42.01"
"67","000","00","080","0013","0384","361","232","129","38","399","579","0","68.91","40.07"
"67","000","00","080","0016","0000","1164","783","381","113","1277","2067","0","61.78","37.88"
"67","000","00","080","0016","0378","650","438","212","61","711","1050","0","67.71","41.71"
"67","000","00","080","0016","0379","514","345","169","52","566","1017","0","55.65","33.92"
"67","000","00","080","0017","0000","645","433","212","88","733","1484","0","49.39","29.18"
"67","000","00","080","0017","0376","307","210","97","57","364","671","0","54.25","31.30"
"67","000","00","080","0017","0377","338","223","115","31","369","813","0","45.39","27.43"
"67","000","00","080","0018","0000","1050","712","338","140","1190","2086","0","57.05","34.13"
"67","000","00","080","0018","0385","585","389","196","82","667","1107","0","60.25","35.14"
"67","000","00","080","0018","0386","465","323","142","58","523","979","0","53.42","32.99"
"67","000","00","090","0000","0000","10078","6298","3780","1132","11210","18332","21347","61.15","34.36"
"67","000","00","090","0001","0000","1469","899","570","141","1610","2771","0","58.10","32.44"
"67","000","00","090","0001","0387","415","257","158","41","456","772","0","59.07","33.29"
"67","000","00","090","0001","0388","312","177","135","27","339","580","0","58.45","30.52"
"67","000","00","090","0001","0389","742","465","277","73","815","1419","0","57.43","32.77"
"67","000","00","090","0002","0000","1507","991","516","206","1713","2544","0","67.33","38.95"
"67","000","00","090","0002","0390","863","575","288","93","956","1462","0","65.39","39.33"
"67","000","00","090","0002","0391","644","416","228","113","757","1082","0","69.96","38.45"
"67","000","00","090","0003","0000","697","416","281","57","754","1283","0","58.77","32.42"
"67","000","00","090","0003","0392","697","416","281","57","754","1283","0","58.77","32.42"
"67","000","00","090","0005","0000","961","588","373","99","1060","1862","0","56.93","31.58"
"67","000","00","090","0005","0393","479","266","213","57","536","973","0","55.09","27.34"
"67","000","00","090","0005","0394","482","322","160","42","524","889","0","58.94","36.22"
"67","000","00","090","0006","0000","1666","998","668","178","1844","3200","0","57.63","31.19"
"67","000","00","090","0006","0395","671","422","249","68","739","1318","0","56.07","32.02"
"67","000","00","090","0006","0396","476","284","192","54","530","924","0","57.36","30.74"
"67","000","00","090","0006","0397","519","292","227","56","575","958","0","60.02","30.48"
"67","000","00","090","0007","0000","977","644","333","99","1076","1982","0","54.29","32.49"
"67","000","00","090","0007","0398","531","355","176","52","583","1132","0","51.50","31.36"
"67","000","00","090","0007","0399","446","289","157","47","493","850","0","58.00","34.00"
"67","000","00","090","0008","0000","885","549","336","106","991","1527","0","64.90","35.95"
"67","000","00","090","0008","0400","570","374","196","89","659","944","0","69.81","39.62"
"67","000","00","090","0008","0401","315","175","140","17","332","583","0","56.95","30.02"
"67","000","00","090","0009","0000","828","524","304","63","891","1320","0","67.50","39.70"
"67","000","00","090","0009","0402","828","524","304","63","891","1320","0","67.50","39.70"
"67","000","00","090","0010","0000","451","262","189","43","494","605","0","81.65","43.31"
"67","000","00","090","0010","0403","451","262","189","43","494","605","0","81.65","43.31"
"67","000","00","090","0011","0000","315","210","105","54","369","682","0","54.11","30.79"
"67","000","00","090","0011","0404","315","210","105","54","369","682","0","54.11","30.79"
"67","000","00","090","0012","0000","322","217","105","86","408","556","0","73.38","39.03"
"67","000","00","090","0012","0405","322","217","105","86","408","556","0","73.38","39.03"
"67","000","00","100","0000","0000","10170","6744","3426","943","11113","18104","20875","61.38","37.25"
"67","000","00","100","0001","0000","1216","778","438","132","1348","1988","0","67.81","39.13"
"67","000","00","100","0001","0448","660","410","250","64","724","1059","0","68.37","38.72"
"67","000","00","100","0001","0449","556","368","188","68","624","929","0","67.17","39.61"
"67","000","00","100","0002","0000","1535","1065","470","131","1666","3115","0","53.48","34.19"
"67","000","00","100","0002","0450","483","329","154","44","527","985","0","53.50","33.40"
"67","000","00","100","0002","0451","499","357","142","38","537","1019","0","52.70","35.03"
"67","000","00","100","0002","0452","553","379","174","49","602","1111","0","54.19","34.11"
"67","000","00","100","0005","0000","237","167","70","38","275","387","0","71.06","43.15"
"67","000","00","100","0005","0455","237","167","70","38","275","387","0","71.06","43.15"
"67","000","00","100","0006","0000","1098","689","409","118","1216","1901","0","63.97","36.24"
"67","000","00","100","0006","0456","546","344","202","49","595","902","0","65.96","38.14"
"67","000","00","100","0006","0457","552","345","207","69","621","999","0","62.16","34.53"
"67","000","00","100","0007","0000","1682","999","683","122","1804","3432","0","52.56","29.11"
"67","000","00","100","0007","0458","437","274","163","30","467","890","0","52.47","30.79"
"67","000","00","100","0007","0459","622","357","265","66","688","1209","0","56.91","29.53"
"67","000","00","100","0007","0460","623","368","255","26","649","1333","0","48.69","27.61"
"67","000","00","100","0008","0000","780","522","258","38","818","1196","0","68.39","43.65"
"67","000","00","100","0008","0461","780","522","258","38","818","1196","0","68.39","43.65"
"67","000","00","100","0013","0000","404","288","116","42","446","807","0","55.27","35.69"
"67","000","00","100","0013","0468","404","288","116","42","446","807","0","55.27","35.69"
"67","000","00","100","0014","0000","627","436","191","67","694","1155","0","60.09","37.75"
"67","000","00","100","0014","0453","497","358","139","54","551","892","0","61.77","40.13"
"67","000","00","100","0014","0454","130","78","52","13","143","263","0","54.37","29.66"
"67","000","00","100","0015","0000","1532","996","536","161","1693","2399","0","70.57","41.52"
"67","000","00","100","0015","0464","231","154","77","9","240","461","0","52.06","33.41"
"67","000","00","100","0015","0465","453","295","158","64","517","678","0","76.25","43.51"
"67","000","00","100","0015","0466","540","345","195","49","589","768","0","76.69","44.92"
"67","000","00","100","0015","0467","308","202","106","39","347","492","0","70.53","41.06"
"67","000","00","100","0016","0000","1059","804","255","94","1153","1724","0","66.88","46.64"
"67","000","00","100","0016","0462","745","564","181","64","809","1181","0","68.50","47.76"
"67","000","00","100","0016","0463","314","240","74","30","344","543","0","63.35","44.20"
"67","000","00","110","0000","0000","4154","2736","1418","445","4599","7964","8879","57.75","34.35"
"67","000","00","110","0001","0000","451","286","165","69","520","915","0","56.83","31.26"
"67","000","00","110","0001","0469","339","242","97","49","388","693","0","55.99","34.92"
"67","000","00","110","0001","0470","112","44","68","20","132","222","0","59.46","19.82"
"67","000","00","110","0002","0000","302","208","94","37","339","598","0","56.69","34.78"
"67","000","00","110","0002","0471","302","208","94","37","339","598","0","56.69","34.78"
"67","000","00","110","0003","0000","849","570","279","79","928","1377","0","67.39","41.39"
"67","000","00","110","0003","0472","849","570","279","79","928","1377","0","67.39","41.39"
"67","000","00","110","0004","0000","367","219","148","29","396","841","0","47.09","26.04"
"67","000","00","110","0004","0473","367","219","148","29","396","841","0","47.09","26.04"
"67","000","00","110","0005","0000","449","297","152","54","503","715","0","70.35","41.54"
"67","000","00","110","0005","0474","449","297","152","54","503","715","0","70.35","41.54"
"67","000","00","110","0006","0000","266","182","84","15","281","578","0","48.62","31.49"
"67","000","00","110","0006","0475","266","182","84","15","281","578","0","48.62","31.49"
"67","000","00","110","0007","0000","387","260","127","20","407","951","0","42.80","27.34"
"67","000","00","110","0007","0476","387","260","127","20","407","951","0","42.80","27.34"
"67","000","00","110","0008","0000","326","215","111","53","379","678","0","55.90","31.71"
"67","000","00","110","0008","0477","326","215","111","53","379","678","0","55.90","31.71"
"67","000","00","110","0009","0000","492","305","187","62","554","792","0","69.95","38.51"
"67","000","00","110","0009","0478","492","305","187","62","554","792","0","69.95","38.51"
"67","000","00","110","0010","0000","265","194","71","27","292","519","0","56.26","37.38"
"67","000","00","110","0010","0479","265","194","71","27","292","519","0","56.26","37.38"
"67","000","00","120","0000","0000","25380","15379","10001","1747","27127","48885","58070","55.49","31.46"
"67","000","00","120","0001","0000","1214","707","507","88","1302","2078","0","62.66","34.02"
"67","000","00","120","0001","0296","561","335","226","41","602","1004","0","59.96","33.37"
"67","000","00","120","0001","0297","653","372","281","47","700","1074","0","65.18","34.64"
"67","000","00","120","0002","0000","1319","831","488","89","1408","2743","0","51.33","30.30"
"67","000","00","120","0002","0298","658","428","230","43","701","1329","0","52.75","32.20"
"67","000","00","120","0002","0299","661","403","258","46","707","1414","0","50.00","28.50"
"67","000","00","120","0003","0000","2592","1496","1096","207","2799","5452","0","51.34","27.44"
"67","000","00","120","0003","0300","496","314","182","34","530","1064","0","49.81","29.51"
"67","000","00","120","0003","0301","535","316","219","44","579","1089","0","53.17","29.02"
"67","000","00","120","0003","0302","493","286","207","23","516","1020","0","50.59","28.04"
"67","000","00","120","0003","0303","513","306","207","56","569","1120","0","50.80","27.32"
"67","000","00","120","0003","0304","555","274","281","50","605","1159","0","52.20","23.64"
"67","000","00","120","0004","0000","2181","1253","928","157","2338","4161","0","56.19","30.11"
"67","000","00","120","0004","0314","530","307","223","44","574","1000","0","57.40","30.70"
"67","000","00","120","0004","0315","516","291","225","34","550","966","0","56.94","30.12"
"67","000","00","120","0004","0316","609","349","260","34","643","1175","0","54.72","29.70"
"67","000","00","120","0004","0317","526","306","220","45","571","1020","0","55.98","30.00"
"67","000","00","120","0005","0000","2978","1728","1250","161","3139","5582","0","56.23","30.96"
"67","000","00","120","0005","0305","555","307","248","27","582","990","0","58.79","31.01"
"67","000","00","120","0005","0306","592","340","252","13","605","1109","0","54.55","30.66"
"67","000","00","120","0005","0307","577","323","254","29","606","1101","0","55.04","29.34"
"67","000","00","120","0005","0308","626","375","251","45","671","1209","0","55.50","31.02"
"67","000","00","120","0005","0309","628","383","245","47","675","1173","0","57.54","32.65"
"67","000","00","120","0006","0000","1983","1120","863","106","2089","3953","0","52.85","28.33"
"67","000","00","120","0006","0322","706","399","307","40","746","1346","0","55.42","29.64"
"67","000","00","120","0006","0323","671","394","277","38","709","1344","0","52.75","29.32"
"67","000","00","120","0006","0324","606","327","279","28","634","1263","0","50.20","25.89"
"67","000","00","120","0007","0000","1025","626","399","88","1113","2034","0","54.72","30.78"
"67","000","00","120","0007","0325","537","322","215","49","586","1099","0","53.32","29.30"
"67","000","00","120","0007","0326","488","304","184","39","527","935","0","56.36","32.51"
"67","000","00","120","0012","0000","1104","705","399","101","1205","2101","0","57.35","33.56"
"67","000","00","120","0012","0331","597","381","216","52","649","1149","0","56.48","33.16"
"67","000","00","120","0012","0332","507","324","183","49","556","952","0","58.40","34.03"
"67","000","00","120","0019","0000","914","610","304","66","980","1648","0","59.47","37.01"
"67","000","00","120","0019","0338","689","465","224","47","736","1285","0","57.28","36.19"
"67","000","00","120","0019","0339","225","145","80","19","244","363","0","67.22","39.94"
"67","000","00","120","0020","0000","1102","759","343","82","1184","2323","0","50.97","32.67"
"67","000","00","120","0020","0340","341","247","94","23","364","753","0","48.34","32.80"
"67","000","00","120","0020","0341","328","206","122","27","355","695","0","51.08","29.64"
"67","000","00","120","0020","0342","433","306","127","32","465","875","0","53.14","34.97"
"67","000","00","120","0022","0000","524","343","181","70","594","1014","0","58.58","33.83"
"67","000","00","120","0022","0329","358","239","119","40","398","651","0","61.14","36.71"
"67","000","00","120","0022","0330","166","104","62","30","196","363","0","53.99","28.65"
"67","000","00","120","0023","0000","2407","1398","1009","115","2522","4935","0","51.10","28.33"
"67","000","00","120","0023","0310","554","322","232","30","584","1131","0","51.64","28.47"
"67","000","00","120","0023","0311","645","363","282","44","689","1340","0","51.42","27.09"
"67","000","00","120","0023","0312","614","369","245","25","639","1241","0","51.49","29.73"
"67","000","00","120","0023","0313","594","344","250","16","610","1223","0","49.88","28.13"
"67","000","00","120","0024","0000","1182","762","420","64","1246","2039","0","61.11","37.37"
"67","000","00","120","0024","0327","685","447","238","49","734","1131","0","64.90","39.52"
"67","000","00","120","0024","0328","497","315","182","15","512","908","0","56.39","34.69"
"67","000","00","120","0025","0000","983","647","336","112","1095","1709","0","64.07","37.86"
"67","000","00","120","0025","0333","480","333","147","74","554","821","0","67.48","40.56"
"67","000","00","120","0025","0334","503","314","189","38","541","888","0","60.92","35.36"
"67","000","00","120","0026","0000","1468","982","486","155","1623","2640","0","61.48","37.20"
"67","000","00","120","0026","0335","552","368","184","56","608","990","0","61.41","37.17"
"67","000","00","120","0026","0336","492","316","176","66","558","896","0","62.28","35.27"
"67","000","00","120","0026","0337","424","298","126","33","457","754","0","60.61","39.52"
"67","000","00","120","0027","0000","2404","1412","992","86","2490","4473","0","55.67","31.57"
"67","000","00","120","0027","0318","521","295","226","16","537","1071","0","50.14","27.54"
"67","000","00","120","0027","0319","642","404","238","34","676","1113","0","60.74","36.30"
"67","000","00","120","0027","0320","536","287","249","21","557","952","0","58.51","30.15"
"67","000","00","120","0027","0321","705","426","279","15","720","1337","0","53.85","31.86"
"67","000","00","130","0000","0000","11198","7268","3930","851","12049","21630","24765","55.71","33.60"
"67","000","00","130","0001","0000","1875","1187","688","150","2025","3692","0","54.85","32.15"
"67","000","00","130","0001","0226","508","338","170","26","534","955","0","55.92","35.39"
"67","000","00","130","0001","0227","505","311","194","48","553","1048","0","52.77","29.68"
"67","000","00","130","0001","0228","435","271","164","43","478","863","0","55.39","31.40"
"67","000","00","130","0001","0229","427","267","160","33","460","826","0","55.69","32.32"
"67","000","00","130","0002","0000","1374","855","519","87","1461","2340","0","62.44","36.54"
"67","000","00","130","0002","0233","664","436","228","33","697","1120","0","62.23","38.93"
"67","000","00","130","0002","0234","710","419","291","54","764","1220","0","62.62","34.34"
"67","000","00","130","0003","0000","507","340","167","42","549","1138","0","48.24","29.88"
"67","000","00","130","0003","0239","340","229","111","30","370","780","0","47.44","29.36"
"67","000","00","130","0003","0240","167","111","56","12","179","358","0","50.00","31.01"
"67","000","00","130","0004","0000","398","265","133","11","409","751","0","54.46","35.29"
"67","000","00","130","0004","0241","398","265","133","11","409","751","0","54.46","35.29"
"67","000","00","130","0005","0000","1075","677","398","69","1144","1907","0","59.99","35.50"
"67","000","00","130","0005","0223","373","215","158","27","400","593","0","67.45","36.26"
"67","000","00","130","0005","0224","467","321","146","23","490","900","0","54.44","35.67"
"67","000","00","130","0005","0225","235","141","94","19","254","414","0","61.35","34.06"
"67","000","00","130","0006","0000","1196","756","440","70","1266","2419","0","52.34","31.25"
"67","000","00","130","0006","0218","404","268","136","32","436","804","0","54.23","33.33"
"67","000","00","130","0006","0219","356","213","143","16","372","701","0","53.07","30.39"
"67","000","00","130","0006","0220","436","275","161","22","458","914","0","50.11","30.09"
"67","000","00","130","0007","0000","1040","683","357","74","1114","1825","0","61.04","37.42"
"67","000","00","130","0007","0221","565","392","173","30","595","1020","0","58.33","38.43"
"67","000","00","130","0007","0222","475","291","184","44","519","805","0","64.47","36.15"
"67","000","00","130","0008","0000","562","407","155","49","611","1145","0","53.36","35.55"
"67","000","00","130","0008","0236","562","407","155","49","611","1145","0","53.36","35.55"
"67","000","00","130","0009","0000","446","325","121","38","484","958","0","50.52","33.92"
"67","000","00","130","0009","0242","446","325","121","38","484","958","0","50.52","33.92"
"67","000","00","130","0010","0000","909","560","349","84","993","1983","0","50.08","28.24"
"67","000","00","130","0010","0230","359","198","161","32","391","702","0","55.70","28.21"
"67","000","00","130","0010","0231","307","187","120","23","330","703","0","46.94","26.60"
"67","000","00","130","0010","0232","243","175","68","29","272","578","0","47.06","30.28"
"67","000","00","130","0011","0000","485","313","172","36","521","923","0","56.45","33.91"
"67","000","00","130","0011","0235","485","313","172","36","521","923","0","56.45","33.91"
"67","000","00","130","0012","0000","729","499","230","95","824","1247","0","66.08","40.02"
"67","000","00","130","0012","0243","323","220","103","43","366","549","0","66.67","40.07"
"67","000","00","130","0012","0244","236","152","84","36","272","394","0","69.04","38.58"
"67","000","00","130","0012","0245","170","127","43","16","186","304","0","61.18","41.78"
"67","000","00","130","0013","0000","602","401","201","46","648","1302","0","49.77","30.80"
"67","000","00","130","0013","0237","343","236","107","29","372","759","0","49.01","31.09"
"67","000","00","130","0013","0238","259","165","94","17","276","543","0","50.83","30.39"
"67","000","00","140","0000","0000","10873","6890","3983","1192","12065","21249","24707","56.78","32.43"
"67","000","00","140","0001","0000","1520","970","550","123","1643","3051","0","53.85","31.79"
"67","000","00","140","0001","0343","449","283","166","40","489","897","0","54.52","31.55"
"67","000","00","140","0001","0344","476","327","149","40","516","873","0","59.11","37.46"
"67","000","00","140","0001","0345","595","360","235","43","638","1281","0","49.80","28.10"
"67","000","00","140","0002","0000","1240","797","443","98","1338","2500","0","53.52","31.88"
"67","000","00","140","0002","0349","432","295","137","31","463","901","0","51.39","32.74"
"67","000","00","140","0002","0350","441","284","157","25","466","870","0","53.56","32.64"
"67","000","00","140","0002","0351","367","218","149","42","409","729","0","56.10","29.90"
"67","000","00","140","0003","0000","840","536","304","87","927","1611","0","57.54","33.27"
"67","000","00","140","0003","0352","633","389","244","56","689","1221","0","56.43","31.86"
"67","000","00","140","0003","0353","207","147","60","31","238","390","0","61.03","37.69"
"67","000","00","140","0004","0000","725","440","285","87","812","1569","0","51.75","28.04"
"67","000","00","140","0004","0354","357","219","138","48","405","743","0","54.51","29.48"
"67","000","00","140","0004","0355","368","221","147","39","407","826","0","49.27","26.76"
"67","000","00","140","0005","0000","837","547","290","93","930","1454","0","63.96","37.62"
"67","000","00","140","0005","0356","837","547","290","93","930","1454","0","63.96","37.62"
"67","000","00","140","0006","0000","656","404","252","110","766","1438","0","53.27","28.09"
"67","000","00","140","0006","0357","656","404","252","110","766","1438","0","53.27","28.09"
"67","000","00","140","0007","0000","392","257","135","75","467","761","0","61.37","33.77"
"67","000","00","140","0007","0358","392","257","135","75","467","761","0","61.37","33.77"
"67","000","00","140","0008","0000","840","532","308","94","934","1376","0","67.88","38.66"
"67","000","00","140","0008","0359","840","532","308","94","934","1376","0","67.88","38.66"
"67","000","00","140","0009","0000","798","513","285","96","894","1324","0","67.52","38.75"
"67","000","00","140","0009","0360","798","513","285","96","894","1324","0","67.52","38.75"
"67","000","00","140","0010","0000","675","458","217","106","781","1294","0","60.36","35.39"
"67","000","00","140","0010","0361","457","311","146","76","533","936","0","56.94","33.23"
"67","000","00","140","0010","0362","218","147","71","30","248","358","0","69.27","41.06"
"67","000","00","140","0011","0000","411","238","173","64","475","783","0","60.66","30.40"
"67","000","00","140","0011","0363","411","238","173","64","475","783","0","60.66","30.40"
"67","000","00","140","0012","0000","1939","1198","741","159","2098","4088","0","51.32","29.31"
"67","000","00","140","0012","0346","616","388","228","58","674","1349","0","49.96","28.76"
"67","000","00","140","0012","0347","651","400","251","63","714","1260","0","56.67","31.75"
"67","000","00","140","0012","0348","672","410","262","38","710","1479","0","48.01","27.72"
"67","000","00","150","0000","0000","9479","6246","3233","900","10379","18886","21453","54.96","33.07"
"67","000","00","150","0001","0000","551","367","184","48","599","950","0","63.05","38.63"
"67","000","00","150","0001","0271","240","148","92","11","251","492","0","51.02","30.08"
"67","000","00","150","0001","0272","311","219","92","37","348","458","0","75.98","47.82"
"67","000","00","150","0002","0000","394","262","132","42","436","653","0","66.77","40.12"
"67","000","00","150","0002","0273","394","262","132","42","436","653","0","66.77","40.12"
"67","000","00","150","0004","0000","425","276","149","23","448","786","0","57.00","35.11"
"67","000","00","150","0004","0274","425","276","149","23","448","786","0","57.00","35.11"
"67","000","00","150","0005","0000","533","346","187","48","581","807","0","72.00","42.87"
"67","000","00","150","0005","0275","533","346","187","48","581","807","0","72.00","42.87"
"67","000","00","150","0006","0000","195","141","54","17","212","427","0","49.65","33.02"
"67","000","00","150","0006","0276","195","141","54","17","212","427","0","49.65","33.02"
"67","000","00","150","0007","0000","227","171","56","22","249","396","0","62.88","43.18"
"67","000","00","150","0007","0277","227","171","56","22","249","396","0","62.88","43.18"
"67","000","00","150","0008","0000","629","441","188","35","664","1534","0","43.29","28.75"
"67","000","00","150","0008","0279","348","239","109","20","368","794","0","46.35","30.10"
"67","000","00","150","0008","0280","281","202","79","15","296","740","0","40.00","27.30"
"67","000","00","150","0009","0000","208","137","71","3","211","353","0","59.77","38.81"
"67","000","00","150","0009","0281","208","137","71","3","211","353","0","59.77","38.81"
"67","000","00","150","0010","0000","409","286","123","38","447","811","0","55.12","35.27"
"67","000","00","150","0010","0282","409","286","123","38","447","811","0","55.12","35.27"
"67","000","00","150","0011","0000","383","240","143","35","418","743","0","56.26","32.30"
"67","000","00","150","0011","0283","383","240","143","35","418","743","0","56.26","32.30"
"67","000","00","150","0012","0000","1299","825","474","120","1419","2440","0","58.16","33.81"
"67","000","00","150","0012","0284","426","278","148","36","462","829","0","55.73","33.53"
"67","000","00","150","0012","0285","410","260","150","37","447","773","0","57.83","33.64"
"67","000","00","150","0012","0286","463","287","176","47","510","838","0","60.86","34.25"
"67","000","00","150","0015","0000","845","545","300","76","921","1824","0","50.49","29.88"
"67","000","00","150","0015","0287","536","333","203","43","579","1140","0","50.79","29.21"
"67","000","00","150","0015","0288","309","212","97","33","342","684","0","50.00","30.99"
"67","000","00","150","0017","0000","270","190","80","29","299","649","0","46.07","29.28"
"67","000","00","150","0017","0278","270","190","80","29","299","649","0","46.07","29.28"
"67","000","00","150","0018","0000","490","337","153","79","569","1135","0","50.13","29.69"
"67","000","00","150","0018","0289","200","141","59","31","231","564","0","40.96","25.00"
"67","000","00","150","0018","0290","290","196","94","48","338","571","0","59.19","34.33"
"67","000","00","150","0019","0000","917","632","285","103","1020","1818","0","56.11","34.76"
"67","000","00","150","0019","0291","565","357","208","48","613","1146","0","53.49","31.15"
"67","000","00","150","0019","0292","352","275","77","55","407","672","0","60.57","40.92"
"67","000","00","150","0021","0000","484","301","183","58","542","954","0","56.81","31.55"
"67","000","00","150","0021","0293","484","301","183","58","542","954","0","56.81","31.55"
"67","000","00","150","0022","0000","598","354","244","68","666","1274","0","52.28","27.79"
"67","000","00","150","0022","0294","598","354","244","68","666","1274","0","52.28","27.79"
"67","000","00","150","0023","0000","622","395","227","56","678","1332","0","50.90","29.65"
"67","000","00","150","0023","0295","622","395","227","56","678","1332","0","50.90","29.65"
"67","000","00","160","0000","0000","9102","6039","3063","889","9991","16800","18693","59.47","35.95"
"67","000","00","160","0001","0000","662","409","253","47","709","1105","0","64.16","37.01"
"67","000","00","160","0001","0246","662","409","253","47","709","1105","0","64.16","37.01"
"67","000","00","160","0013","0000","416","302","114","29","445","832","0","53.49","36.30"
"67","000","00","160","0013","0263","416","302","114","29","445","832","0","53.49","36.30"
"67","000","00","160","0014","0000","193","121","72","10","203","598","0","33.95","20.23"
"67","000","00","160","0014","0264","193","121","72","10","203","598","0","33.95","20.23"
"67","000","00","160","0015","0000","496","342","154","64","560","1268","0","44.16","26.97"
"67","000","00","160","0015","0265","272","193","79","38","310","650","0","47.69","29.69"
"67","000","00","160","0015","0266","224","149","75","26","250","618","0","40.45","24.11"
"67","000","00","160","0016","0000","514","382","132","54","568","1117","0","50.85","34.20"
"67","000","00","160","0016","0267","514","382","132","54","568","1117","0","50.85","34.20"
"67","000","00","160","0017","0000","912","640","272","100","1012","1771","0","57.14","36.14"
"67","000","00","160","0017","0268","407","278","129","57","464","756","0","61.38","36.77"
"67","000","00","160","0017","0269","505","362","143","43","548","1015","0","53.99","35.67"
"67","000","00","160","0018","0000","641","454","187","65","706","1000","0","70.60","45.40"
"67","000","00","160","0018","0270","641","454","187","65","706","1000","0","70.60","45.40"
"67","000","00","160","0019","0000","589","447","142","54","643","1101","0","58.40","40.60"
"67","000","00","160","0019","0258","324","246","78","33","357","578","0","61.76","42.56"
"67","000","00","160","0019","0259","265","201","64","21","286","523","0","54.68","38.43"
"67","000","00","160","0020","0000","1318","829","489","119","1437","2264","0","63.47","36.62"
"67","000","00","160","0020","0247","460","288","172","35","495","772","0","64.12","37.31"
"67","000","00","160","0020","0248","384","237","147","31","415","631","0","65.77","37.56"
"67","000","00","160","0020","0249","474","304","170","53","527","861","0","61.21","35.31"
"67","000","00","160","0021","0000","1396","869","527","153","1549","2367","0","65.44","36.71"
"67","000","00","160","0021","0250","373","210","163","37","410","667","0","61.47","31.48"
"67","000","00","160","0021","0251","511","307","204","64","575","847","0","67.89","36.25"
"67","000","00","160","0021","0252","290","208","82","39","329","508","0","64.76","40.94"
"67","000","00","160","0021","0253","222","144","78","13","235","345","0","68.12","41.74"
"67","000","00","160","0022","0000","1222","781","441","128","1350","1928","0","70.02","40.51"
"67","000","00","160","0022","0254","357","232","125","52","409","559","0","73.17","41.50"
"67","000","00","160","0022","0255","222","145","77","19","241","368","0","65.49","39.40"
"67","000","00","160","0022","0256","351","223","128","30","381","551","0","69.15","40.47"
"67","000","00","160","0022","0257","292","181","111","27","319","450","0","70.89","40.22"
"67","000","00","160","0023","0000","743","463","280","66","809","1449","0","55.83","31.95"
"67","000","00","160","0023","0260","267","166","101","27","294","541","0","54.34","30.68"
"67","000","00","160","0023","0261","265","173","92","19","284","518","0","54.83","33.40"
"67","000","00","160","0023","0262","211","124","87","20","231","390","0","59.23","31.79"
"67","000","00","170","0000","0000","5167","3361","1806","737","5904","9179","10213","64.32","36.62"
"67","000","00","170","0001","0000","668","422","246","98","766","1256","0","60.99","33.60"
"67","000","00","170","0001","0206","395","264","131","61","456","671","0","67.96","39.34"
"67","000","00","170","0001","0207","273","158","115","37","310","585","0","52.99","27.01"
"67","000","00","170","0002","0000","212","148","64","22","234","435","0","53.79","34.02"
"67","000","00","170","0002","0211","212","148","64","22","234","435","0","53.79","34.02"
"67","000","00","170","0005","0000","485","310","175","88","573","778","0","73.65","39.85"
"67","000","00","170","0005","0202","262","165","97","55","317","437","0","72.54","37.76"
"67","000","00","170","0005","0203","223","145","78","33","256","341","0","75.07","42.52"
"67","000","00","170","0006","0000","570","354","216","86","656","891","0","73.63","39.73"
"67","000","00","170","0006","0212","570","354","216","86","656","891","0","73.63","39.73"
"67","000","00","170","0007","0000","502","351","151","52","554","1132","0","48.94","31.01"
"67","000","00","170","0007","0214","206","135","71","4","210","639","0","32.86","21.13"
"67","000","00","170","0007","0215","296","216","80","48","344","493","0","69.78","43.81"
"67","000","00","170","0009","0000","461","307","154","41","502","672","0","74.70","45.68"
"67","000","00","170","0009","0204","219","146","73","18","237","324","0","73.15","45.06"
"67","000","00","170","0009","0205","242","161","81","23","265","348","0","76.15","46.26"
"67","000","00","170","0011","0000","467","274","193","91","558","700","0","79.71","39.14"
"67","000","00","170","0011","0213","467","274","193","91","558","700","0","79.71","39.14"
"67","000","00","170","0013","0000","503","317","186","86","589","808","0","72.90","39.23"
"67","000","00","170","0013","0200","274","181","93","32","306","432","0","70.83","41.90"
"67","000","00","170","0013","0201","229","136","93","54","283","376","0","75.27","36.17"
"67","000","00","170","0014","0000","738","466","272","101","839","1331","0","63.04","35.01"
"67","000","00","170","0014","0208","288","176","112","39","327","539","0","60.67","32.65"
"67","000","00","170","0014","0209","276","165","111","41","317","506","0","62.65","32.61"
"67","000","00","170","0014","0210","174","125","49","21","195","286","0","68.18","43.71"
"67","000","00","170","0015","0000","561","412","149","72","633","1176","0","53.83","35.03"
"67","000","00","170","0015","0216","255","181","74","36","291","581","0","50.09","31.15"
"67","000","00","170","0015","0217","306","231","75","36","342","595","0","57.48","38.82"
"67","000","00","180","0000","0000","19067","11188","7879","1701","20768","36196","42454","57.38","30.91"
"67","000","00","180","0001","0000","1642","903","739","145","1787","2977","0","60.03","30.33"
"67","000","00","180","0001","0625","583","300","283","52","635","1027","0","61.83","29.21"
"67","000","00","180","0001","0626","575","319","256","44","619","1061","0","58.34","30.07"
"67","000","00","180","0001","0627","484","284","200","49","533","889","0","59.96","31.95"
"67","000","00","180","0002","0000","2102","1198","904","132","2234","3929","0","56.86","30.49"
"67","000","00","180","0002","0628","598","335","263","31","629","1157","0","54.36","28.95"
"67","000","00","180","0002","0629","461","272","189","29","490","806","0","60.79","33.75"
"67","000","00","180","0002","0630","499","290","209","23","522","950","0","54.95","30.53"
"67","000","00","180","0002","0631","544","301","243","49","593","1016","0","58.37","29.63"
"67","000","00","180","0003","0000","1257","703","554","95","1352","2620","0","51.60","26.83"
"67","000","00","180","0003","0632","451","252","199","35","486","884","0","54.98","28.51"
"67","000","00","180","0003","0633","407","215","192","31","438","765","0","57.25","28.10"
"67","000","00","180","0003","0634","399","236","163","29","428","971","0","44.08","24.30"
"67","000","00","180","0004","0000","2116","1229","887","159","2275","4284","0","53.10","28.69"
"67","000","00","180","0004","0635","614","341","273","36","650","1277","0","50.90","26.70"
"67","000","00","180","0004","0636","487","285","202","38","525","981","0","53.52","29.05"
"67","000","00","180","0004","0637","592","352","240","53","645","1250","0","51.60","28.16"
"67","000","00","180","0004","0638","423","251","172","32","455","776","0","58.63","32.35"
"67","000","00","180","0009","0000","1777","1017","760","134","1911","3102","0","61.61","32.79"
"67","000","00","180","0009","0639","556","322","234","30","586","950","0","61.68","33.89"
"67","000","00","180","0009","0640","530","306","224","42","572","972","0","58.85","31.48"
"67","000","00","180","0009","0641","691","389","302","62","753","1180","0","63.81","32.97"
"67","000","00","180","0010","0000","1160","724","436","74","1234","2078","0","59.38","34.84"
"67","000","00","180","0010","0642","631","369","262","27","658","1107","0","59.44","33.33"
"67","000","00","180","0010","0643","529","355","174","47","576","971","0","59.32","36.56"
"67","000","00","180","0011","0000","726","429","297","53","779","1442","0","54.02","29.75"
"67","000","00","180","0011","0644","726","429","297","53","779","1442","0","54.02","29.75"
"67","000","00","180","0012","0000","1775","1005","770","154","1929","3164","0","60.97","31.76"
"67","000","00","180","0012","0645","672","393","279","45","717","1179","0","60.81","33.33"
"67","000","00","180","0012","0646","642","355","287","42","684","1218","0","56.16","29.15"
"67","000","00","180","0012","0647","461","257","204","67","528","767","0","68.84","33.51"
"67","000","00","180","0013","0000","1397","836","561","116","1513","2681","0","56.43","31.18"
"67","000","00","180","0013","0648","648","428","220","94","742","1300","0","57.08","32.92"
"67","000","00","180","0013","0649","749","408","341","22","771","1381","0","55.83","29.54"
"67","000","00","180","0014","0000","1101","664","437","140","1241","2051","0","60.51","32.37"
"67","000","00","180","0014","0650","533","333","200","76","609","980","0","62.14","33.98"
"67","000","00","180","0014","0651","568","331","237","64","632","1071","0","59.01","30.91"
"67","000","00","180","0015","0000","1017","605","412","93","1110","2075","0","53.49","29.16"
"67","000","00","180","0015","0652","617","375","242","58","675","1124","0","60.05","33.36"
"67","000","00","180","0015","0653","400","230","170","35","435","951","0","45.74","24.19"
"67","000","00","180","0016","0000","759","467","292","109","868","1661","0","52.26","28.12"
"67","000","00","180","0016","0654","441","275","166","55","496","962","0","51.56","28.59"
"67","000","00","180","0016","0655","318","192","126","54","372","699","0","53.22","27.47"
"67","000","00","180","0017","0000","267","183","84","43","310","402","0","77.11","45.52"
"67","000","00","180","0017","0656","267","183","84","43","310","402","0","77.11","45.52"
"67","000","00","180","0018","0000","989","585","404","114","1103","1981","0","55.68","29.53"
"67","000","00","180","0018","0657","493","293","200","39","532","984","0","54.07","29.78"
"67","000","00","180","0018","0658","496","292","204","75","571","997","0","57.27","29.29"
"67","000","00","180","0019","0000","483","295","188","71","554","876","0","63.24","33.68"
"67","000","00","180","0019","0659","483","295","188","71","554","876","0","63.24","33.68"
"67","000","00","180","0020","0000","499","345","154","69","568","873","0","65.06","39.52"
"67","000","00","180","0020","0660","499","345","154","69","568","873","0","65.06","39.52"
"67","000","00","190","0000","0000","21284","13285","7999","1206","22490","41223","51740","54.56","32.23"
"67","000","00","190","0001","0000","514","309","205","24","538","1088","0","49.45","28.40"
"67","000","00","190","0001","0525","514","309","205","24","538","1088","0","49.45","28.40"
"67","000","00","190","0002","0000","1983","1140","843","75","2058","3825","0","53.80","29.80"
"67","000","00","190","0002","0526","735","380","355","22","757","1348","0","56.16","28.19"
"67","000","00","190","0002","0527","612","378","234","29","641","1127","0","56.88","33.54"
"67","000","00","190","0002","0528","636","382","254","24","660","1350","0","48.89","28.30"
"67","000","00","190","0003","0000","2817","1642","1175","124","2941","5335","0","55.13","30.78"
"67","000","00","190","0003","0529","745","420","325","25","770","1367","0","56.33","30.72"
"67","000","00","190","0003","0530","723","432","291","33","756","1352","0","55.92","31.95"
"67","000","00","190","0003","0531","728","430","298","30","758","1441","0","52.60","29.84"
"67","000","00","190","0003","0532","621","360","261","36","657","1175","0","55.91","30.64"
"67","000","00","190","0004","0000","1261","786","475","60","1321","2643","0","49.98","29.74"
"67","000","00","190","0004","0533","694","425","269","25","719","1513","0","47.52","28.09"
"67","000","00","190","0004","0534","567","361","206","35","602","1130","0","53.27","31.95"
"67","000","00","190","0005","0000","958","612","346","54","1012","1723","0","58.73","35.52"
"67","000","00","190","0005","0535","495","308","187","34","529","920","0","57.50","33.48"
"67","000","00","190","0005","0536","463","304","159","20","483","803","0","60.15","37.86"
"67","000","00","190","0008","0000","751","469","282","57","808","1549","0","52.16","30.28"
"67","000","00","190","0008","0538","751","469","282","57","808","1549","0","52.16","30.28"
"67","000","00","190","0009","0000","623","454","169","58","681","1228","0","55.46","36.97"
"67","000","00","190","0009","0539","623","454","169","58","681","1228","0","55.46","36.97"
"67","000","00","190","0010","0000","1009","661","348","52","1061","1974","0","53.75","33.49"
"67","000","00","190","0010","0540","543","349","194","26","569","1035","0","54.98","33.72"
"67","000","00","190","0010","0541","466","312","154","26","492","939","0","52.40","33.23"
"67","000","00","190","0011","0000","591","380","211","24","615","1201","0","51.21","31.64"
"67","000","00","190","0011","0542","591","380","211","24","615","1201","0","51.21","31.64"
"67","000","00","190","0012","0000","955","585","370","50","1005","1900","0","52.89","30.79"
"67","000","00","190","0012","0543","509","316","193","31","540","1012","0","53.36","31.23"
"67","000","00","190","0012","0544","446","269","177","19","465","888","0","52.36","30.29"
"67","000","00","190","0013","0000","398","275","123","27","425","652","0","65.18","42.18"
"67","000","00","190","0013","0545","398","275","123","27","425","652","0","65.18","42.18"
"67","000","00","190","0014","0000","541","378","163","51","592","1007","0","58.79","37.54"
"67","000","00","190","0014","0546","541","378","163","51","592","1007","0","58.79","37.54"
"67","000","00","190","0015","0000","1001","663","338","72","1073","1630","0","65.83","40.67"
"67","000","00","190","0015","0547","1001","663","338","72","1073","1630","0","65.83","40.67"
"67","000","00","190","0018","0000","941","586","355","52","993","1614","0","61.52","36.31"
"67","000","00","190","0018","0550","941","586","355","52","993","1614","0","61.52","36.31"
"67","000","00","190","0019","0000","860","548","312","73","933","1568","0","59.50","34.95"
"67","000","00","190","0019","0551","860","548","312","73","933","1568","0","59.50","34.95"
"67","000","00","190","0020","0000","521","377","144","48","569","1032","0","55.14","36.53"
"67","000","00","190","0020","0552","521","377","144","48","569","1032","0","55.14","36.53"
"67","000","00","190","0021","0000","2235","1370","865","144","2379","4448","0","53.48","30.80"
"67","000","00","190","0021","0553","795","515","280","62","857","1405","0","61.00","36.65"
"67","000","00","190","0021","0554","796","483","313","48","844","1439","0","58.65","33.56"
"67","000","00","190","0021","0555","644","372","272","34","678","1604","0","42.27","23.19"
"67","000","00","190","0022","0000","645","374","271","41","686","1075","0","63.81","34.79"
"67","000","00","190","0022","0537","645","374","271","41","686","1075","0","63.81","34.79"
"67","000","00","190","0023","0000","950","629","321","101","1051","1886","0","55.73","33.35"
"67","000","00","190","0023","0548","534","377","157","59","593","1061","0","55.89","35.53"
"67","000","00","190","0023","0549","416","252","164","42","458","825","0","55.52","30.55"
"67","000","00","190","0024","0000","1730","1047","683","19","1749","3845","0","45.49","27.23"
"67","000","00","190","0024","0556","511","316","195","7","518","1262","0","41.05","25.04"
"67","000","00","190","0024","0557","553","309","244","5","558","1197","0","46.62","25.81"
"67","000","00","190","0024","0558","666","422","244","7","673","1386","0","48.56","30.45"
"67","000","00","200","0000","0000","16910","10474","6436","1140","18050","30620","37467","58.95","34.21"
"67","000","00","200","0001","0000","1406","819","587","69","1475","2850","0","51.75","28.74"
"67","000","00","200","0001","0585","441","280","161","16","457","893","0","51.18","31.35"
"67","000","00","200","0001","0586","557","312","245","36","593","1032","0","57.46","30.23"
"67","000","00","200","0001","0587","408","227","181","17","425","925","0","45.95","24.54"
"67","000","00","200","0002","0000","3218","1921","1297","176","3394","6380","0","53.20","30.11"
"67","000","00","200","0002","0588","598","373","225","34","632","1200","0","52.67","31.08"
"67","000","00","200","0002","0589","647","386","261","32","679","1209","0","56.16","31.93"
"67","000","00","200","0002","0590","538","312","226","32","570","1044","0","54.60","29.89"
"67","000","00","200","0002","0591","551","310","241","27","578","1072","0","53.92","28.92"
"67","000","00","200","0002","0592","511","304","207","33","544","935","0","58.18","32.51"
"67","000","00","200","0002","0593","373","236","137","18","391","920","0","42.50","25.65"
"67","000","00","200","0003","0000","1552","1040","512","87","1639","2781","0","58.94","37.40"
"67","000","00","200","0003","0594","554","369","185","25","579","923","0","62.73","39.98"
"67","000","00","200","0003","0595","552","377","175","35","587","1054","0","55.69","35.77"
"67","000","00","200","0003","0596","446","294","152","27","473","804","0","58.83","36.57"
"67","000","00","200","0004","0000","426","283","143","56","482","688","0","70.06","41.13"
"67","000","00","200","0004","0597","426","283","143","56","482","688","0","70.06","41.13"
"67","000","00","200","0005","0000","493","312","181","47","540","848","0","63.68","36.79"
"67","000","00","200","0005","0598","493","312","181","47","540","848","0","63.68","36.79"
"67","000","00","200","0006","0000","932","561","371","65","997","1507","0","66.16","37.23"
"67","000","00","200","0006","0599","567","335","232","47","614","871","0","70.49","38.46"
"67","000","00","200","0006","0600","365","226","139","18","383","636","0","60.22","35.53"
"67","000","00","200","0007","0000","1900","1120","780","148","2048","3358","0","60.99","33.35"
"67","000","00","200","0007","0601","633","375","258","66","699","1146","0","60.99","32.72"
"67","000","00","200","0007","0602","614","357","257","36","650","1104","0","58.88","32.34"
"67","000","00","200","0007","0603","653","388","265","46","699","1108","0","63.09","35.02"
"67","000","00","200","0008","0000","2364","1544","820","174","2538","4418","0","57.45","34.95"
"67","000","00","200","0008","0604","600","365","235","36","636","1158","0","54.92","31.52"
"67","000","00","200","0008","0605","521","348","173","53","574","1041","0","55.14","33.43"
"67","000","00","200","0008","0606","671","434","237","56","727","1229","0","59.15","35.31"
"67","000","00","200","0008","0607","572","397","175","29","601","990","0","60.71","40.10"
"67","000","00","200","0009","0000","1127","733","394","104","1231","1737","0","70.87","42.20"
"67","000","00","200","0009","0608","540","352","188","47","587","843","0","69.63","41.76"
"67","000","00","200","0009","0609","587","381","206","57","644","894","0","72.04","42.62"
"67","000","00","200","0010","0000","1784","1104","680","112","1896","3221","0","58.86","34.28"
"67","000","00","200","0010","0610","485","266","219","27","512","868","0","58.99","30.65"
"67","000","00","200","0010","0611","653","423","230","45","698","1202","0","58.07","35.19"
"67","000","00","200","0010","0612","646","415","231","40","686","1151","0","59.60","36.06"
"67","000","00","200","0011","0000","1708","1037","671","102","1810","2832","0","63.91","36.62"
"67","000","00","200","0011","0613","421","265","156","28","449","671","0","66.92","39.49"
"67","000","00","200","0011","0614","629","368","261","49","678","1010","0","67.13","36.44"
"67","000","00","200","0011","0615","658","404","254","25","683","1151","0","59.34","35.10"
"67","000","00","210","0000","0000","14787","9223","5564","1400","16187","25368","29936","63.81","36.36"
"67","000","00","210","0001","0000","1316","838","478","132","1448","2039","0","71.02","41.10"
"67","000","00","210","0001","0559","773","481","292","62","835","1179","0","70.82","40.80"
"67","000","00","210","0001","0560","543","357","186","70","613","860","0","71.28","41.51"
"67","000","00","210","0002","0000","1108","657","451","92","1200","1962","0","61.16","33.49"
"67","000","00","210","0002","0561","585","335","250","55","640","1095","0","58.45","30.59"
"67","000","00","210","0002","0562","523","322","201","37","560","867","0","64.59","37.14"
"67","000","00","210","0003","0000","818","515","303","87","905","1338","0","67.64","38.49"
"67","000","00","210","0003","0563","358","228","130","39","397","633","0","62.72","36.02"
"67","000","00","210","0003","0564","460","287","173","48","508","705","0","72.06","40.71"
"67","000","00","210","0004","0000","1309","840","469","142","1451","2110","0","68.77","39.81"
"67","000","00","210","0004","0565","671","431","240","73","744","1075","0","69.21","40.09"
"67","000","00","210","0004","0566","638","409","229","69","707","1035","0","68.31","39.52"
"67","000","00","210","0006","0000","775","476","299","102","877","1431","0","61.29","33.26"
"67","000","00","210","0006","0567","394","244","150","37","431","695","0","62.01","35.11"
"67","000","00","210","0006","0568","381","232","149","65","446","736","0","60.60","31.52"
"67","000","00","210","0007","0000","1131","743","388","77","1208","1704","0","70.89","43.60"
"67","000","00","210","0007","0569","541","366","175","31","572","826","0","69.25","44.31"
"67","000","00","210","0007","0570","590","377","213","46","636","878","0","72.44","42.94"
"67","000","00","210","0008","0000","1647","993","654","121","1768","2809","0","62.94","35.35"
"67","000","00","210","0008","0571","622","353","269","49","671","1103","0","60.83","32.00"
"67","000","00","210","0008","0572","547","347","200","40","587","928","0","63.25","37.39"
"67","000","00","210","0008","0573","478","293","185","32","510","778","0","65.55","37.66"
"67","000","00","210","0009","0000","1480","928","552","139","1619","2586","0","62.61","35.89"
"67","000","00","210","0009","0574","726","457","269","55","781","1319","0","59.21","34.65"
"67","000","00","210","0009","0575","754","471","283","84","838","1267","0","66.14","37.17"
"67","000","00","210","0012","0000","408","272","136","40","448","682","0","65.69","39.88"
"67","000","00","210","0012","0578","408","272","136","40","448","682","0","65.69","39.88"
"67","000","00","210","0013","0000","1395","863","532","131","1526","2401","0","63.56","35.94"
"67","000","00","210","0013","0579","714","433","281","73","787","1247","0","63.11","34.72"
"67","000","00","210","0013","0580","681","430","251","58","739","1154","0","64.04","37.26"
"67","000","00","210","0014","0000","1282","794","488","134","1416","2491","0","56.84","31.87"
"67","000","00","210","0014","0581","617","376","241","57","674","1140","0","59.12","32.98"
"67","000","00","210","0014","0582","665","418","247","77","742","1351","0","54.92","30.94"
"67","000","00","210","0017","0000","786","503","283","80","866","1543","0","56.12","32.60"
"67","000","00","210","0017","0583","459","303","156","46","505","968","0","52.17","31.30"
"67","000","00","210","0017","0584","327","200","127","34","361","575","0","62.78","34.78"
"67","000","00","210","0018","0000","1332","801","531","123","1455","2272","0","64.04","35.26"
"67","000","00","210","0018","0576","630","397","233","66","696","1109","0","62.76","35.80"
"67","000","00","210","0018","0577","702","404","298","57","759","1163","0","65.26","34.74"
"67","000","00","220","0000","0000","3131","1996","1135","302","3433","6207","7001","55.31","32.16"
"67","000","00","220","0001","0000","678","444","234","79","757","1592","0","47.55","27.89"
"67","000","00","220","0001","0616","387","250","137","53","440","816","0","53.92","30.64"
"67","000","00","220","0001","0617","291","194","97","26","317","776","0","40.85","25.00"
"67","000","00","220","0002","0000","765","478","287","70","835","1439","0","58.03","33.22"
"67","000","00","220","0002","0618","373","228","145","34","407","709","0","57.40","32.16"
"67","000","00","220","0002","0619","392","250","142","36","428","730","0","58.63","34.25"
"67","000","00","220","0003","0000","472","279","193","43","515","1017","0","50.64","27.43"
"67","000","00","220","0003","0620","472","279","193","43","515","1017","0","50.64","27.43"
"67","000","00","220","0004","0000","578","385","193","52","630","902","0","69.84","42.68"
"67","000","00","220","0004","0621","578","385","193","52","630","902","0","69.84","42.68"
"67","000","00","220","0005","0000","244","169","75","25","269","536","0","50.19","31.53"
"67","000","00","220","0005","0622","244","169","75","25","269","536","0","50.19","31.53"
"67","000","00","220","0006","0000","167","83","84","6","173","357","0","48.46","23.25"
"67","000","00","220","0006","0623","167","83","84","6","173","357","0","48.46","23.25"
"67","000","00","220","0007","0000","227","158","69","27","254","364","0","69.78","43.41"
"67","000","00","220","0007","0624","227","158","69","27","254","364","0","69.78","43.41"
"67","000","00","230","0000","0000","5727","3260","2467","652","6379","11581","13153","55.08","28.15"
"67","000","00","230","0001","0000","605","329","276","64","669","1142","0","58.58","28.81"
"67","000","00","230","0001","0499","605","329","276","64","669","1142","0","58.58","28.81"
"67","000","00","230","0002","0000","1665","902","763","140","1805","3471","0","52.00","25.99"
"67","000","00","230","0002","0500","462","262","200","43","505","946","0","53.38","27.70"
"67","000","00","230","0002","0501","383","211","172","40","423","766","0","55.22","27.55"
"67","000","00","230","0002","0502","343","191","152","13","356","801","0","44.44","23.85"
"67","000","00","230","0002","0503","477","238","239","44","521","958","0","54.38","24.84"
"67","000","00","230","0003","0000","562","319","243","71","633","1158","0","54.66","27.55"
"67","000","00","230","0003","0504","290","149","141","40","330","567","0","58.20","26.28"
"67","000","00","230","0003","0505","272","170","102","31","303","591","0","51.27","28.76"
"67","000","00","230","0004","0000","639","371","268","69","708","1343","0","52.72","27.62"
"67","000","00","230","0004","0506","404","228","176","43","447","870","0","51.38","26.21"
"67","000","00","230","0004","0507","235","143","92","26","261","473","0","55.18","30.23"
"67","000","00","230","0005","0000","308","170","138","45","353","476","0","74.16","35.71"
"67","000","00","230","0005","0508","308","170","138","45","353","476","0","74.16","35.71"
"67","000","00","230","0006","0000","220","118","102","21","241","459","0","52.51","25.71"
"67","000","00","230","0006","0509","220","118","102","21","241","459","0","52.51","25.71"
"67","000","00","230","0007","0000","357","233","124","59","416","685","0","60.73","34.01"
"67","000","00","230","0007","0510","357","233","124","59","416","685","0","60.73","34.01"
"67","000","00","230","0008","0000","641","368","273","90","731","1399","0","52.25","26.30"
"67","000","00","230","0008","0511","289","156","133","35","324","657","0","49.32","23.74"
"67","000","00","230","0008","0512","352","212","140","55","407","742","0","54.85","28.57"
"67","000","00","230","0009","0000","346","229","117","69","415","546","0","76.01","41.94"
"67","000","00","230","0009","0513","346","229","117","69","415","546","0","76.01","41.94"
"67","000","00","230","0010","0000","384","221","163","24","408","902","0","45.23","24.50"
"67","000","00","230","0010","0514","384","221","163","24","408","902","0","45.23","24.50"
"67","000","00","240","0000","0000","3885","2125","1760","412","4297","7947","8886","54.07","26.74"
"67","000","00","240","0001","0000","717","370","347","51","768","1712","0","44.86","21.61"
"67","000","00","240","0001","0480","344","187","157","23","367","912","0","40.24","20.50"
"67","000","00","240","0001","0481","373","183","190","28","401","800","0","50.13","22.88"
"67","000","00","240","0002","0000","465","273","192","30","495","1079","0","45.88","25.30"
"67","000","00","240","0002","0482","465","273","192","30","495","1079","0","45.88","25.30"
"67","000","00","240","0003","0000","419","218","201","80","499","662","0","75.38","32.93"
"67","000","00","240","0003","0483","419","218","201","80","499","662","0","75.38","32.93"
"67","000","00","240","0004","0000","419","249","170","28","447","916","0","48.80","27.18"
"67","000","00","240","0004","0484","419","249","170","28","447","916","0","48.80","27.18"
"67","000","00","240","0005","0000","541","321","220","59","600","850","0","70.59","37.76"
"67","000","00","240","0005","0485","541","321","220","59","600","850","0","70.59","37.76"
"67","000","00","240","0006","0000","363","205","158","54","417","615","0","67.80","33.33"
"67","000","00","240","0006","0486","363","205","158","54","417","615","0","67.80","33.33"
"67","000","00","240","0007","0000","961","489","472","110","1071","2113","0","50.69","23.14"
"67","000","00","240","0007","0487","501","258","243","57","558","1125","0","49.60","22.93"
"67","000","00","240","0007","0488","460","231","229","53","513","988","0","51.92","23.38"
"67","000","00","250","0000","0000","3895","2319","1576","645","4540","7259","8143","62.54","31.95"
"67","000","00","250","0001","0000","848","510","338","132","980","1308","0","74.92","38.99"
"67","000","00","250","0001","0489","421","260","161","68","489","658","0","74.32","39.51"
"67","000","00","250","0001","0490","427","250","177","64","491","650","0","75.54","38.46"
"67","000","00","250","0002","0000","385","233","152","40","425","745","0","57.05","31.28"
"67","000","00","250","0002","0491","385","233","152","40","425","745","0","57.05","31.28"
"67","000","00","250","0003","0000","258","152","106","40","298","393","0","75.83","38.68"
"67","000","00","250","0003","0494","258","152","106","40","298","393","0","75.83","38.68"
"67","000","00","250","0004","0000","320","219","101","41","361","524","0","68.89","41.79"
"67","000","00","250","0004","0495","320","219","101","41","361","524","0","68.89","41.79"
"67","000","00","250","0005","0000","359","214","145","69","428","585","0","73.16","36.58"
"67","000","00","250","0005","0492","359","214","145","69","428","585","0","73.16","36.58"
"67","000","00","250","0006","0000","404","226","178","85","489","707","0","69.17","31.97"
"67","000","00","250","0006","0493","404","226","178","85","489","707","0","69.17","31.97"
"67","000","00","250","0007","0000","424","238","186","49","473","1087","0","43.51","21.90"
"67","000","00","250","0007","0496","424","238","186","49","473","1087","0","43.51","21.90"
"67","000","00","250","0008","0000","528","323","205","120","648","988","0","65.59","32.69"
"67","000","00","250","0008","0497","528","323","205","120","648","988","0","65.59","32.69"
"67","000","00","250","0009","0000","369","204","165","69","438","922","0","47.51","22.13"
"67","000","00","250","0009","0498","369","204","165","69","438","922","0","47.51","22.13"
"67","000","00","260","0000","0000","2298","1472","826","255","2553","4026","4374","63.41","36.56"
"67","000","00","260","0001","0000","232","138","94","25","257","348","0","73.85","39.66"
"67","000","00","260","0001","0515","232","138","94","25","257","348","0","73.85","39.66"
"67","000","00","260","0002","0000","386","259","127","34","420","595","0","70.59","43.53"
"67","000","00","260","0002","0516","386","259","127","34","420","595","0","70.59","43.53"
"67","000","00","260","0003","0000","254","169","85","33","287","434","0","66.13","38.94"
"67","000","00","260","0003","0517","254","169","85","33","287","434","0","66.13","38.94"
"67","000","00","260","0004","0000","352","203","149","39","391","690","0","56.67","29.42"
"67","000","00","260","0004","0518","352","203","149","39","391","690","0","56.67","29.42"
"67","000","00","260","0005","0000","232","141","91","36","268","336","0","79.76","41.96"
"67","000","00","260","0005","0519","232","141","91","36","268","336","0","79.76","41.96"
"67","000","00","260","0006","0000","150","90","60","7","157","337","0","46.59","26.71"
"67","000","00","260","0006","0520","150","90","60","7","157","337","0","46.59","26.71"
"67","000","00","260","0007","0000","157","116","41","11","168","459","0","36.60","25.27"
"67","000","00","260","0007","0524","157","116","41","11","168","459","0","36.60","25.27"
"67","000","00","260","0008","0000","259","174","85","28","287","390","0","73.59","44.62"
"67","000","00","260","0008","0521","259","174","85","28","287","390","0","73.59","44.62"
"67","000","00","260","0009","0000","180","111","69","34","214","269","0","79.55","41.26"
"67","000","00","260","0009","0522","180","111","69","34","214","269","0","79.55","41.26"
"67","000","00","260","0010","0000","96","71","25","8","104","168","0","61.90","42.26"
"67","000","00","260","0010","0523","96","71","25","8","104","168","0","61.90","42.26"
"67","000","00","270","0000","0000","33676","19618","14058","2152","35828","64723","76782","55.36","30.31"
"67","000","00","270","0001","0000","2875","1810","1065","194","3069","5284","0","58.08","34.25"
"67","000","00","270","0001","1388","719","488","231","49","768","1313","0","58.49","37.17"
"67","000","00","270","0001","1389","744","441","303","52","796","1358","0","58.62","32.47"
"67","000","00","270","0001","1390","753","476","277","47","800","1421","0","56.30","33.50"
"67","000","00","270","0001","1391","659","405","254","46","705","1192","0","59.14","33.98"
"67","000","00","270","0002","0000","1437","951","486","101","1538","2709","0","56.77","35.11"
"67","000","00","270","0002","1392","798","507","291","44","842","1460","0","57.67","34.73"
"67","000","00","270","0002","1393","639","444","195","57","696","1249","0","55.72","35.55"
"67","000","00","270","0003","0000","1318","775","543","85","1403","2559","0","54.83","30.29"
"67","000","00","270","0003","1394","695","415","280","59","754","1296","0","58.18","32.02"
"67","000","00","270","0003","1395","623","360","263","26","649","1263","0","51.39","28.50"
"67","000","00","270","0004","0000","4050","2231","1819","166","4216","8203","0","51.40","27.20"
"67","000","00","270","0004","1396","552","329","223","29","581","1090","0","53.30","30.18"
"67","000","00","270","0004","1397","606","320","286","22","628","1121","0","56.02","28.55"
"67","000","00","270","0004","1398","515","293","222","28","543","1053","0","51.57","27.83"
"67","000","00","270","0004","1399","485","262","223","20","505","1146","0","44.07","22.86"
"67","000","00","270","0004","1400","726","371","355","22","748","1384","0","54.05","26.81"
"67","000","00","270","0004","1401","610","319","291","17","627","1362","0","46.04","23.42"
"67","000","00","270","0004","1402","556","337","219","28","584","1047","0","55.78","32.19"
"67","000","00","270","0005","0000","4680","2718","1962","196","4876","8836","0","55.18","30.76"
"67","000","00","270","0005","1403","800","470","330","32","832","1405","0","59.22","33.45"
"67","000","00","270","0005","1404","640","367","273","18","658","1312","0","50.15","27.97"
"67","000","00","270","0005","1405","844","459","385","43","887","1463","0","60.63","31.37"
"67","000","00","270","0005","1406","589","356","233","18","607","1148","0","52.87","31.01"
"67","000","00","270","0005","1407","706","391","315","31","737","1303","0","56.56","30.01"
"67","000","00","270","0005","1408","558","347","211","23","581","1065","0","54.55","32.58"
"67","000","00","270","0005","1409","543","328","215","31","574","1140","0","50.35","28.77"
"67","000","00","270","0006","0000","1936","1084","852","102","2038","3326","0","61.27","32.59"
"67","000","00","270","0006","1410","720","397","323","44","764","1218","0","62.73","32.59"
"67","000","00","270","0006","1411","574","329","245","30","604","941","0","64.19","34.96"
"67","000","00","270","0006","1412","642","358","284","28","670","1167","0","57.41","30.68"
"67","000","00","270","0007","0000","4587","2719","1868","232","4819","9230","0","52.21","29.46"
"67","000","00","270","0007","1413","743","477","266","46","789","1387","0","56.89","34.39"
"67","000","00","270","0007","1414","775","448","327","45","820","1464","0","56.01","30.60"
"67","000","00","270","0007","1415","707","427","280","43","750","1346","0","55.72","31.72"
"67","000","00","270","0007","1416","600","365","235","43","643","1297","0","49.58","28.14"
"67","000","00","270","0007","1417","509","305","204","16","525","1233","0","42.58","24.74"
"67","000","00","270","0007","1418","437","270","167","14","451","892","0","50.56","30.27"
"67","000","00","270","0007","1419","552","282","270","20","572","1098","0","52.09","25.68"
"67","000","00","270","0007","1420","264","145","119","5","269","513","0","52.44","28.27"
"67","000","00","270","0008","0000","3029","1838","1191","195","3224","5883","0","54.80","31.24"
"67","000","00","270","0008","1421","393","251","142","26","419","837","0","50.06","29.99"
"67","000","00","270","0008","1422","351","223","128","19","370","718","0","51.53","31.06"
"67","000","00","270","0008","1423","708","416","292","42","750","1408","0","53.27","29.55"
"67","000","00","270","0008","1424","368","203","165","21","389","747","0","52.07","27.18"
"67","000","00","270","0008","1425","537","339","198","35","572","982","0","58.25","34.52"
"67","000","00","270","0008","1426","672","406","266","52","724","1191","0","60.79","34.09"
"67","000","00","270","0011","0000","1234","734","500","51","1285","2628","0","48.90","27.93"
"67","000","00","270","0011","1429","672","411","261","37","709","1350","0","52.52","30.44"
"67","000","00","270","0011","1430","562","323","239","14","576","1278","0","45.07","25.27"
"67","000","00","270","0012","0000","2351","1202","1149","173","2524","4729","0","53.37","25.42"
"67","000","00","270","0012","1431","660","346","314","32","692","1385","0","49.96","24.98"
"67","000","00","270","0012","1432","687","335","352","52","739","1262","0","58.56","26.55"
"67","000","00","270","0012","1433","691","340","351","69","760","1438","0","52.85","23.64"
"67","000","00","270","0012","1434","313","181","132","20","333","644","0","51.71","28.11"
"67","000","00","270","0013","0000","779","254","525","59","838","1431","0","58.56","17.75"
"67","000","00","270","0013","1435","779","254","525","59","838","1431","0","58.56","17.75"
"67","000","00","270","0014","0000","548","272","276","16","564","1129","0","49.96","24.09"
"67","000","00","270","0014","1436","548","272","276","16","564","1129","0","49.96","24.09"
"67","000","00","270","0015","0000","969","611","358","117","1086","2023","0","53.68","30.20"
"67","000","00","270","0015","1437","564","343","221","66","630","1108","0","56.86","30.96"
"67","000","00","270","0015","1438","405","268","137","51","456","915","0","49.84","29.29"
"67","000","00","270","0016","0000","1413","898","515","171","1584","2067","0","76.63","43.44"
"67","000","00","270","0016","1439","608","404","204","83","691","891","0","77.55","45.34"
"67","000","00","270","0016","1440","805","494","311","88","893","1176","0","75.94","42.01"
"67","000","00","270","0017","0000","1240","764","476","177","1417","2539","0","55.81","30.09"
"67","000","00","270","0017","1441","555","346","209","73","628","1134","0","55.38","30.51"
"67","000","00","270","0017","1442","685","418","267","104","789","1405","0","56.16","29.75"
"67","000","00","270","0019","0000","1230","757","473","117","1347","2147","0","62.74","35.26"
"67","000","00","270","0019","1427","701","434","267","75","776","1203","0","64.51","36.08"
"67","000","00","270","0019","1428","529","323","206","42","571","944","0","60.49","34.22"
"67","000","00","280","0000","0000","31110","18705","12405","1950","33060","56324","67903","58.70","33.21"
"67","000","00","280","0001","0000","3292","1963","1329","189","3481","5701","0","61.06","34.43"
"67","000","00","280","0001","1443","669","375","294","38","707","1164","0","60.74","32.22"
"67","000","00","280","0001","1444","685","394","291","38","723","1126","0","64.21","34.99"
"67","000","00","280","0001","1445","599","370","229","25","624","977","0","63.87","37.87"
"67","000","00","280","0001","1446","666","394","272","35","701","1167","0","60.07","33.76"
"67","000","00","280","0001","1447","673","430","243","53","726","1267","0","57.30","33.94"
"67","000","00","280","0002","0000","1965","1204","761","119","2084","3771","0","55.26","31.93"
"67","000","00","280","0002","1452","469","276","193","26","495","957","0","51.72","28.84"
"67","000","00","280","0002","1453","416","255","161","19","435","931","0","46.72","27.39"
"67","000","00","280","0002","1454","538","351","187","39","577","942","0","61.25","37.26"
"67","000","00","280","0002","1455","542","322","220","35","577","941","0","61.32","34.22"
"67","000","00","280","0003","0000","1270","703","567","78","1348","2228","0","60.50","31.55"
"67","000","00","280","0003","1485","711","391","320","39","750","1236","0","60.68","31.63"
"67","000","00","280","0003","1486","559","312","247","39","598","992","0","60.28","31.45"
"67","000","00","280","0004","0000","1570","910","660","77","1647","3135","0","52.54","29.03"
"67","000","00","280","0004","1458","545","304","241","31","576","1022","0","56.36","29.75"
"67","000","00","280","0004","1459","507","309","198","26","533","1050","0","50.76","29.43"
"67","000","00","280","0004","1460","518","297","221","20","538","1063","0","50.61","27.94"
"67","000","00","280","0005","0000","1630","973","657","87","1717","3143","0","54.63","30.96"
"67","000","00","280","0005","1464","509","306","203","26","535","1019","0","52.50","30.03"
"67","000","00","280","0005","1465","593","344","249","44","637","1087","0","58.60","31.65"
"67","000","00","280","0005","1466","528","323","205","17","545","1037","0","52.56","31.15"
"67","000","00","280","0006","0000","1776","1079","697","124","1900","3199","0","59.39","33.73"
"67","000","00","280","0006","1470","602","374","228","42","644","1106","0","58.23","33.82"
"67","000","00","280","0006","1471","568","357","211","55","623","997","0","62.49","35.81"
"67","000","00","280","0006","1472","606","348","258","27","633","1096","0","57.76","31.75"
"67","000","00","280","0007","0000","1199","740","459","67","1266","2204","0","57.44","33.58"
"67","000","00","280","0007","1473","621","389","232","31","652","1116","0","58.42","34.86"
"67","000","00","280","0007","1474","578","351","227","36","614","1088","0","56.43","32.26"
"67","000","00","280","0008","0000","952","558","394","67","1019","1734","0","58.77","32.18"
"67","000","00","280","0008","1475","534","312","222","36","570","985","0","57.87","31.68"
"67","000","00","280","0008","1476","418","246","172","31","449","749","0","59.95","32.84"
"67","000","00","280","0009","0000","1608","961","647","97","1705","2971","0","57.39","32.35"
"67","000","00","280","0009","1477","532","338","194","28","560","1015","0","55.17","33.30"
"67","000","00","280","0009","1478","496","266","230","26","522","882","0","59.18","30.16"
"67","000","00","280","0009","1479","580","357","223","43","623","1074","0","58.01","33.24"
"67","000","00","280","0010","0000","390","222","168","40","430","688","0","62.50","32.27"
"67","000","00","280","0010","1480","390","222","168","40","430","688","0","62.50","32.27"
"67","000","00","280","0011","0000","1059","674","385","90","1149","1847","0","62.21","36.49"
"67","000","00","280","0011","1481","595","382","213","48","643","987","0","65.15","38.70"
"67","000","00","280","0011","1482","464","292","172","42","506","860","0","58.84","33.95"
"67","000","00","280","0012","0000","836","501","335","64","900","1779","0","50.59","28.16"
"67","000","00","280","0012","1483","487","284","203","44","531","873","0","60.82","32.53"
"67","000","00","280","0012","1484","349","217","132","20","369","906","0","40.73","23.95"
"67","000","00","280","0013","0000","1412","870","542","106","1518","2664","0","56.98","32.66"
"67","000","00","280","0013","1487","427","277","150","24","451","823","0","54.80","33.66"
"67","000","00","280","0013","1488","460","276","184","31","491","890","0","55.17","31.01"
"67","000","00","280","0013","1489","525","317","208","51","576","951","0","60.57","33.33"
"67","000","00","280","0014","0000","1872","1137","735","104","1976","3321","0","59.50","34.24"
"67","000","00","280","0014","1490","410","218","192","22","432","711","0","60.76","30.66"
"67","000","00","280","0014","1491","579","349","230","41","620","973","0","63.72","35.87"
"67","000","00","280","0014","1492","465","324","141","16","481","830","0","57.95","39.04"
"67","000","00","280","0014","1493","418","246","172","25","443","807","0","54.89","30.48"
"67","000","00","280","0015","0000","1039","684","355","109","1148","1855","0","61.89","36.87"
"67","000","00","280","0015","1494","476","298","178","46","522","888","0","58.78","33.56"
"67","000","00","280","0015","1495","563","386","177","63","626","967","0","64.74","39.92"
"67","000","00","280","0016","0000","1057","673","384","91","1148","1608","0","71.39","41.85"
"67","000","00","280","0016","1496","605","383","222","48","653","911","0","71.68","42.04"
"67","000","00","280","0016","1497","452","290","162","43","495","697","0","71.02","41.61"
"67","000","00","280","0017","0000","1879","1134","745","84","1963","2996","0","65.52","37.85"
"67","000","00","280","0017","1498","606","376","230","27","633","988","0","64.07","38.06"
"67","000","00","280","0017","1499","619","388","231","30","649","943","0","68.82","41.15"
"67","000","00","280","0017","1500","654","370","284","27","681","1065","0","63.94","34.74"
"67","000","00","280","0018","0000","2228","1301","927","107","2335","4086","0","57.15","31.84"
"67","000","00","280","0018","1448","561","289","272","18","579","967","0","59.88","29.89"
"67","000","00","280","0018","1449","570","354","216","43","613","1089","0","56.29","32.51"
"67","000","00","280","0018","1450","554","316","238","20","574","1000","0","57.40","31.60"
"67","000","00","280","0018","1451","543","342","201","26","569","1030","0","55.24","33.20"
"67","000","00","280","0019","0000","1342","798","544","82","1424","2373","0","60.01","33.63"
"67","000","00","280","0019","1467","454","272","182","28","482","839","0","57.45","32.42"
"67","000","00","280","0019","1468","577","330","247","40","617","979","0","63.02","33.71"
"67","000","00","280","0019","1469","311","196","115","14","325","555","0","58.56","35.32"
"67","000","00","280","0020","0000","1144","700","444","85","1229","2179","0","56.40","32.12"
"67","000","00","280","0020","1456","582","343","239","40","622","1088","0","57.17","31.53"
"67","000","00","280","0020","1457","562","357","205","45","607","1091","0","55.64","32.72"
"67","000","00","280","0021","0000","1590","920","670","83","1673","2842","0","58.87","32.37"
"67","000","00","280","0021","1461","518","318","200","34","552","930","0","59.35","34.19"
"67","000","00","280","0021","1462","536","284","252","22","558","915","0","60.98","31.04"
"67","000","00","280","0021","1463","536","318","218","27","563","997","0","56.47","31.90"
"67","000","00","290","0000","0000","16642","10438","6204","1612","18254","28988","33464","62.97","36.01"
"67","000","00","290","0001","0000","1216","744","472","100","1316","2223","0","59.20","33.47"
"67","000","00","290","0001","1501","505","309","196","48","553","939","0","58.89","32.91"
"67","000","00","290","0001","1502","711","435","276","52","763","1284","0","59.42","33.88"
"67","000","00","290","0002","0000","1076","649","427","85","1161","1963","0","59.14","33.06"
"67","000","00","290","0002","1503","480","276","204","35","515","926","0","55.62","29.81"
"67","000","00","290","0002","1504","596","373","223","50","646","1037","0","62.30","35.97"
"67","000","00","290","0003","0000","1799","1101","698","169","1968","3090","0","63.69","35.63"
"67","000","00","290","0003","1505","526","320","206","50","576","917","0","62.81","34.90"
"67","000","00","290","0003","1506","563","346","217","56","619","956","0","64.75","36.19"
"67","000","00","290","0003","1507","710","435","275","63","773","1217","0","63.52","35.74"
"67","000","00","290","0004","0000","1321","866","455","119","1440","2420","0","59.50","35.79"
"67","000","00","290","0004","1508","663","420","243","66","729","1262","0","57.77","33.28"
"67","000","00","290","0004","1509","658","446","212","53","711","1158","0","61.40","38.51"
"67","000","00","290","0005","0000","678","442","236","89","767","1011","0","75.87","43.72"
"67","000","00","290","0005","1510","678","442","236","89","767","1011","0","75.87","43.72"
"67","000","00","290","0006","0000","342","209","133","47","389","669","0","58.15","31.24"
"67","000","00","290","0006","1511","342","209","133","47","389","669","0","58.15","31.24"
"67","000","00","290","0007","0000","1739","1131","608","113","1852","3120","0","59.36","36.25"
"67","000","00","290","0007","1512","531","316","215","23","554","1115","0","49.69","28.34"
"67","000","00","290","0007","1513","634","486","148","46","680","1030","0","66.02","47.18"
"67","000","00","290","0007","1514","574","329","245","44","618","975","0","63.38","33.74"
"67","000","00","290","0008","0000","1558","924","634","141","1699","2983","0","56.96","30.98"
"67","000","00","290","0008","1515","540","337","203","55","595","1048","0","56.77","32.16"
"67","000","00","290","0008","1516","486","258","228","49","535","952","0","56.20","27.10"
"67","000","00","290","0008","1517","532","329","203","37","569","983","0","57.88","33.47"
"67","000","00","290","0009","0000","1252","801","451","110","1362","1889","0","72.10","42.40"
"67","000","00","290","0009","1518","626","409","217","42","668","943","0","70.84","43.37"
"67","000","00","290","0009","1519","626","392","234","68","694","946","0","73.36","41.44"
"67","000","00","290","0012","0000","946","606","340","129","1075","1399","0","76.84","43.32"
"67","000","00","290","0012","1524","492","319","173","62","554","720","0","76.94","44.31"
"67","000","00","290","0012","1525","454","287","167","67","521","679","0","76.73","42.27"
"67","000","00","290","0013","0000","574","360","214","105","679","1113","0","61.01","32.35"
"67","000","00","290","0013","1526","405","245","160","73","478","783","0","61.05","31.29"
"67","000","00","290","0013","1527","169","115","54","32","201","330","0","60.91","34.85"
"67","000","00","290","0016","0000","995","640","355","67","1062","1887","0","56.28","33.92"
"67","000","00","290","0016","1530","462","272","190","32","494","874","0","56.52","31.12"
"67","000","00","290","0016","1531","533","368","165","35","568","1013","0","56.07","36.33"
"67","000","00","290","0017","0000","313","197","116","23","336","446","0","75.34","44.17"
"67","000","00","290","0017","1532","313","197","116","23","336","446","0","75.34","44.17"
"67","000","00","290","0018","0000","1945","1191","754","213","2158","3339","0","64.63","35.67"
"67","000","00","290","0018","1520","469","289","180","34","503","741","0","67.88","39.00"
"67","000","00","290","0018","1521","366","215","151","31","397","594","0","66.84","36.20"
"67","000","00","290","0018","1522","524","335","189","74","598","931","0","64.23","35.98"
"67","000","00","290","0018","1523","586","352","234","74","660","1073","0","61.51","32.81"
"67","000","00","290","0020","0000","888","577","311","102","990","1436","0","68.94","40.18"
"67","000","00","290","0020","1528","474","303","171","55","529","752","0","70.35","40.29"
"67","000","00","290","0020","1529","414","274","140","47","461","684","0","67.40","40.06"
"67","000","00","300","0000","0000","2044","1206","838","302","2346","3369","3611","69.63","35.80"
"67","000","00","300","0001","0000","611","370","241","82","693","966","0","71.74","38.30"
"67","000","00","300","0001","1533","611","370","241","82","693","966","0","71.74","38.30"
"67","000","00","300","0002","0000","266","164","102","41","307","568","0","54.05","28.87"
"67","000","00","300","0002","1534","266","164","102","41","307","568","0","54.05","28.87"
"67","000","00","300","0003","0000","61","40","21","4","65","132","0","49.24","30.30"
"67","000","00","300","0003","1535","61","40","21","4","65","132","0","49.24","30.30"
"67","000","00","300","0004","0000","213","115","98","18","231","361","0","63.99","31.86"
"67","000","00","300","0004","1536","213","115","98","18","231","361","0","63.99","31.86"
"67","000","00","300","0005","0000","200","123","77","25","225","277","0","81.23","44.40"
"67","000","00","300","0005","1537","200","123","77","25","225","277","0","81.23","44.40"
"67","000","00","300","0006","0000","162","91","71","20","182","269","0","67.66","33.83"
"67","000","00","300","0006","1538","162","91","71","20","182","269","0","67.66","33.83"
"67","000","00","300","0007","0000","272","147","125","58","330","387","0","85.27","37.98"
"67","000","00","300","0007","1539","272","147","125","58","330","387","0","85.27","37.98"
"67","000","00","300","0008","0000","259","156","103","54","313","409","0","76.53","38.14"
"67","000","00","300","0008","1540","259","156","103","54","313","409","0","76.53","38.14"
"67","000","00","310","0000","0000","100775","57404","43371","4800","105575","192461","233801","54.86","29.83"
"67","000","00","310","0001","0000","2693","1553","1140","116","2809","5483","0","51.23","28.32"
"67","000","00","310","0001","0803","684","380","304","29","713","1319","0","54.06","28.81"
"67","000","00","310","0001","0804","674","409","265","31","705","1388","0","50.79","29.47"
"67","000","00","310","0001","0805","738","439","299","41","779","1367","0","56.99","32.11"
"67","000","00","310","0001","0806","597","325","272","15","612","1409","0","43.44","23.07"
"67","000","00","310","0002","0000","3531","2093","1438","137","3668","6719","0","54.59","31.15"
"67","000","00","310","0002","0814","723","444","279","31","754","1347","0","55.98","32.96"
"67","000","00","310","0002","0815","573","338","235","21","594","1296","0","45.83","26.08"
"67","000","00","310","0002","0816","704","394","310","32","736","1270","0","57.95","31.02"
"67","000","00","310","0002","0817","736","438","298","19","755","1311","0","57.59","33.41"
"67","000","00","310","0002","0818","795","479","316","34","829","1495","0","55.45","32.04"
"67","000","00","310","0003","0000","4010","2371","1639","227","4237","8760","0","48.37","27.07"
"67","000","00","310","0003","0825","719","427","292","36","755","1368","0","55.19","31.21"
"67","000","00","310","0003","0826","706","437","269","39","745","1302","0","57.22","33.56"
"67","000","00","310","0003","0827","767","460","307","48","815","1384","0","58.89","33.24"
"67","000","00","310","0003","0828","610","352","258","28","638","1354","0","47.12","26.00"
"67","000","00","310","0003","0829","478","268","210","32","510","1894","0","26.93","14.15"
"67","000","00","310","0003","0830","730","427","303","44","774","1458","0","53.09","29.29"
"67","000","00","310","0004","0000","3768","2283","1485","182","3950","6989","0","56.52","32.67"
"67","000","00","310","0004","0831","545","336","209","21","566","1013","0","55.87","33.17"
"67","000","00","310","0004","0832","587","356","231","44","631","1113","0","56.69","31.99"
"67","000","00","310","0004","0833","632","370","262","24","656","1152","0","56.94","32.12"
"67","000","00","310","0004","0834","809","477","332","24","833","1393","0","59.80","34.24"
"67","000","00","310","0004","0835","533","342","191","25","558","1036","0","53.86","33.01"
"67","000","00","310","0004","0836","662","402","260","44","706","1282","0","55.07","31.36"
"67","000","00","310","0005","0000","2816","1546","1270","113","2929","5387","0","54.37","28.70"
"67","000","00","310","0005","0846","556","317","239","28","584","1076","0","54.28","29.46"
"67","000","00","310","0005","0847","530","274","256","18","548","1132","0","48.41","24.20"
"67","000","00","310","0005","0848","604","370","234","23","627","1092","0","57.42","33.88"
"67","000","00","310","0005","0849","574","294","280","24","598","1039","0","57.56","28.30"
"67","000","00","310","0005","0850","552","291","261","20","572","1048","0","54.58","27.77"
"67","000","00","310","0006","0000","1306","776","530","80","1386","2377","0","58.31","32.65"
"67","000","00","310","0006","0892","683","432","251","45","728","1205","0","60.41","35.85"
"67","000","00","310","0006","0893","623","344","279","35","658","1172","0","56.14","29.35"
"67","000","00","310","0007","0000","1677","967","710","86","1763","2745","0","64.23","35.23"
"67","000","00","310","0007","0894","844","493","351","50","894","1324","0","67.52","37.24"
"67","000","00","310","0007","0895","833","474","359","36","869","1421","0","61.15","33.36"
"67","000","00","310","0008","0000","1122","686","436","68","1190","1826","0","65.17","37.57"
"67","000","00","310","0008","0863","530","323","207","16","546","952","0","57.35","33.93"
"67","000","00","310","0008","0864","592","363","229","52","644","874","0","73.68","41.53"
"67","000","00","310","0009","0000","791","443","348","72","863","1446","0","59.68","30.64"
"67","000","00","310","0009","0865","523","298","225","44","567","933","0","60.77","31.94"
"67","000","00","310","0009","0866","268","145","123","28","296","513","0","57.70","28.27"
"67","000","00","310","0010","0000","2590","1589","1001","117","2707","4705","0","57.53","33.77"
"67","000","00","310","0010","0867","727","446","281","21","748","1280","0","58.44","34.84"
"67","000","00","310","0010","0868","572","352","220","26","598","1048","0","57.06","33.59"
"67","000","00","310","0010","0869","700","437","263","39","739","1265","0","58.42","34.55"
"67","000","00","310","0010","0870","591","354","237","31","622","1112","0","55.94","31.83"
"67","000","00","310","0011","0000","1126","687","439","72","1198","2142","0","55.93","32.07"
"67","000","00","310","0011","0879","419","237","182","21","440","843","0","52.19","28.11"
"67","000","00","310","0011","0880","707","450","257","51","758","1299","0","58.35","34.64"
"67","000","00","310","0012","0000","1816","1146","670","129","1945","3355","0","57.97","34.16"
"67","000","00","310","0012","0903","564","365","199","50","614","1100","0","55.82","33.18"
"67","000","00","310","0012","0904","535","346","189","42","577","986","0","58.52","35.09"
"67","000","00","310","0012","0905","717","435","282","37","754","1269","0","59.42","34.28"
"67","000","00","310","0013","0000","1834","1138","696","84","1918","3384","0","56.68","33.63"
"67","000","00","310","0013","0906","589","380","209","29","618","1090","0","56.70","34.86"
"67","000","00","310","0013","0907","600","373","227","31","631","1148","0","54.97","32.49"
"67","000","00","310","0013","0908","645","385","260","24","669","1146","0","58.38","33.60"
"67","000","00","310","0014","0000","4013","2359","1654","214","4227","7055","0","59.91","33.44"
"67","000","00","310","0014","0909","671","427","244","55","726","1169","0","62.10","36.53"
"67","000","00","310","0014","0910","651","375","276","34","685","1079","0","63.48","34.75"
"67","000","00","310","0014","0911","757","439","318","37","794","1331","0","59.65","32.98"
"67","000","00","310","0014","0912","626","372","254","22","648","1120","0","57.86","33.21"
"67","000","00","310","0014","0913","692","406","286","25","717","1177","0","60.92","34.49"
"67","000","00","310","0014","0914","616","340","276","41","657","1179","0","55.73","28.84"
"67","000","00","310","0015","0000","1933","1177","756","128","2061","3752","0","54.93","31.37"
"67","000","00","310","0015","0915","689","411","278","41","730","1323","0","55.18","31.07"
"67","000","00","310","0015","0916","621","384","237","45","666","1205","0","55.27","31.87"
"67","000","00","310","0015","0917","623","382","241","42","665","1224","0","54.33","31.21"
"67","000","00","310","0016","0000","3025","1792","1233","140","3165","5583","0","56.69","32.10"
"67","000","00","310","0016","0918","561","317","244","33","594","1056","0","56.25","30.02"
"67","000","00","310","0016","0919","662","412","250","34","696","1176","0","59.18","35.03"
"67","000","00","310","0016","0920","665","370","295","25","690","1190","0","57.98","31.09"
"67","000","00","310","0016","0921","559","339","220","20","579","1111","0","52.12","30.51"
"67","000","00","310","0016","0922","578","354","224","28","606","1050","0","57.71","33.71"
"67","000","00","310","0017","0000","2269","1367","902","163","2432","3962","0","61.38","34.50"
"67","000","00","310","0017","0923","813","491","322","41","854","1453","0","58.77","33.79"
"67","000","00","310","0017","0924","722","429","293","68","790","1296","0","60.96","33.10"
"67","000","00","310","0017","0925","734","447","287","54","788","1213","0","64.96","36.85"
"67","000","00","310","0018","0000","1122","710","412","65","1187","2069","0","57.37","34.32"
"67","000","00","310","0018","0901","518","311","207","21","539","999","0","53.95","31.13"
"67","000","00","310","0018","0902","604","399","205","44","648","1070","0","60.56","37.29"
"67","000","00","310","0019","0000","887","380","507","98","985","1856","0","53.07","20.47"
"67","000","00","310","0019","0930","419","173","246","63","482","964","0","50.00","17.95"
"67","000","00","310","0019","0931","468","207","261","35","503","892","0","56.39","23.21"
"67","000","00","310","0020","0000","4148","2007","2141","197","4345","8227","0","52.81","24.40"
"67","000","00","310","0020","0935","707","335","372","29","736","1226","0","60.03","27.32"
"67","000","00","310","0020","0936","749","354","395","46","795","1382","0","57.53","25.62"
"67","000","00","310","0020","0937","592","298","294","32","624","1294","0","48.22","23.03"
"67","000","00","310","0020","0938","545","250","295","33","578","1184","0","48.82","21.11"
"67","000","00","310","0020","0939","553","300","253","13","566","1270","0","44.57","23.62"
"67","000","00","310","0020","0940","414","207","207","24","438","773","0","56.66","26.78"
"67","000","00","310","0020","0941","588","263","325","20","608","1098","0","55.37","23.95"
"67","000","00","310","0021","0000","965","441","524","59","1024","1845","0","55.50","23.90"
"67","000","00","310","0021","0933","456","180","276","25","481","837","0","57.47","21.51"
"67","000","00","310","0021","0934","509","261","248","34","543","1008","0","53.87","25.89"
"67","000","00","310","0022","0000","607","291","316","37","644","1217","0","52.92","23.91"
"67","000","00","310","0022","0949","607","291","316","37","644","1217","0","52.92","23.91"
"67","000","00","310","0023","0000","3360","2038","1322","170","3530","6027","0","58.57","33.81"
"67","000","00","310","0023","0896","697","410","287","30","727","1247","0","58.30","32.88"
"67","000","00","310","0023","0897","668","375","293","37","705","1171","0","60.20","32.02"
"67","000","00","310","0023","0898","727","470","257","44","771","1226","0","62.89","38.34"
"67","000","00","310","0023","0899","650","399","251","32","682","1214","0","56.18","32.87"
"67","000","00","310","0023","0900","618","384","234","27","645","1169","0","55.18","32.85"
"67","000","00","310","0024","0000","1067","454","613","67","1134","1954","0","58.03","23.23"
"67","000","00","310","0024","0950","584","216","368","33","617","963","0","64.07","22.43"
"67","000","00","310","0024","0951","483","238","245","34","517","991","0","52.17","24.02"
"67","000","00","310","0025","0000","1749","910","839","80","1829","3174","0","57.62","28.67"
"67","000","00","310","0025","0954","538","286","252","23","561","1040","0","53.94","27.50"
"67","000","00","310","0025","0955","623","330","293","34","657","1097","0","59.89","30.08"
"67","000","00","310","0025","0956","588","294","294","23","611","1037","0","58.92","28.35"
"67","000","00","310","0026","0000","3738","1989","1749","169","3907","7632","0","51.19","26.06"
"67","000","00","310","0026","0957","718","388","330","29","747","1432","0","52.16","27.09"
"67","000","00","310","0026","0958","621","313","308","26","647","1311","0","49.35","23.87"
"67","000","00","310","0026","0959","690","362","328","32","722","1269","0","56.90","28.53"
"67","000","00","310","0026","0960","694","382","312","45","739","1362","0","54.26","28.05"
"67","000","00","310","0026","0961","483","271","212","14","497","1146","0","43.37","23.65"
"67","000","00","310","0026","0962","532","273","259","23","555","1112","0","49.91","24.55"
"67","000","00","310","0027","0000","3140","1928","1212","154","3294","5996","0","54.94","32.15"
"67","000","00","310","0027","0884","628","386","242","35","663","1167","0","56.81","33.08"
"67","000","00","310","0027","0885","670","437","233","43","713","1228","0","58.06","35.59"
"67","000","00","310","0027","0886","637","379","258","20","657","1243","0","52.86","30.49"
"67","000","00","310","0027","0887","695","411","284","36","731","1360","0","53.75","30.22"
"67","000","00","310","0027","0888","510","315","195","20","530","998","0","53.11","31.56"
"67","000","00","310","0028","0000","346","156","190","20","366","701","0","52.21","22.25"
"67","000","00","310","0028","0932","346","156","190","20","366","701","0","52.21","22.25"
"67","000","00","310","0029","0000","2743","1601","1142","107","2850","5521","0","51.62","29.00"
"67","000","00","310","0029","0874","548","334","214","24","572","1147","0","49.87","29.12"
"67","000","00","310","0029","0875","524","302","222","21","545","979","0","55.67","30.85"
"67","000","00","310","0029","0876","553","327","226","13","566","1202","0","47.09","27.20"
"67","000","00","310","0029","0877","509","278","231","21","530","1065","0","49.77","26.10"
"67","000","00","310","0029","0878","609","360","249","28","637","1128","0","56.47","31.91"
"67","000","00","310","0030","0000","3857","2082","1775","177","4034","7512","0","53.70","27.72"
"67","000","00","310","0030","0819","553","306","247","29","582","1180","0","49.32","25.93"
"67","000","00","310","0030","0820","686","380","306","27","713","1272","0","56.05","29.87"
"67","000","00","310","0030","0821","629","318","311","21","650","1226","0","53.02","25.94"
"67","000","00","310","0030","0822","653","356","297","31","684","1226","0","55.79","29.04"
"67","000","00","310","0030","0823","668","341","327","37","705","1299","0","54.27","26.25"
"67","000","00","310","0030","0824","668","381","287","32","700","1309","0","53.48","29.11"
"67","000","00","310","0031","0000","2664","1430","1234","108","2772","5276","0","52.54","27.10"
"67","000","00","310","0031","0810","621","353","268","45","666","1267","0","52.57","27.86"
"67","000","00","310","0031","0811","697","412","285","31","728","1300","0","56.00","31.69"
"67","000","00","310","0031","0812","660","337","323","20","680","1365","0","49.82","24.69"
"67","000","00","310","0031","0813","686","328","358","12","698","1344","0","51.93","24.40"
"67","000","00","310","0032","0000","1602","891","711","42","1644","3379","0","48.65","26.37"
"67","000","00","310","0032","0807","487","282","205","9","496","1089","0","45.55","25.90"
"67","000","00","310","0032","0808","559","297","262","14","573","1143","0","50.13","25.98"
"67","000","00","310","0032","0809","556","312","244","19","575","1147","0","50.13","27.20"
"67","000","00","310","0033","0000","3512","2097","1415","77","3589","7174","0","50.03","29.23"
"67","000","00","310","0033","0851","770","435","335","27","797","1638","0","48.66","26.56"
"67","000","00","310","0033","0852","884","544","340","12","896","1628","0","55.04","33.42"
"67","000","00","310","0033","0853","804","471","333","14","818","1641","0","49.85","28.70"
"67","000","00","310","0033","0854","352","212","140","18","370","611","0","60.56","34.70"
"67","000","00","310","0033","0855","702","435","267","6","708","1656","0","42.75","26.27"
"67","000","00","310","0034","0000","2242","1258","984","107","2349","4629","0","50.75","27.18"
"67","000","00","310","0034","0859","506","260","246","18","524","1063","0","49.29","24.46"
"67","000","00","310","0034","0860","553","314","239","26","579","1302","0","44.47","24.12"
"67","000","00","310","0034","0861","633","377","256","35","668","1209","0","55.25","31.18"
"67","000","00","310","0034","0862","550","307","243","28","578","1055","0","54.79","29.10"
"67","000","00","310","0035","0000","1522","891","631","52","1574","2914","0","54.02","30.58"
"67","000","00","310","0035","0856","483","282","201","23","506","889","0","56.92","31.72"
"67","000","00","310","0035","0857","548","318","230","15","563","1044","0","53.93","30.46"
"67","000","00","310","0035","0858","491","291","200","14","505","981","0","51.48","29.66"
"67","000","00","310","0036","0000","1927","1121","806","100","2027","3704","0","54.72","30.26"
"67","000","00","310","0036","0881","651","384","267","34","685","1113","0","61.55","34.50"
"67","000","00","310","0036","0882","579","360","219","40","619","1107","0","55.92","32.52"
"67","000","00","310","0036","0883","697","377","320","26","723","1484","0","48.72","25.40"
"67","000","00","310","0037","0000","4721","2444","2277","221","4942","8935","0","55.31","27.35"
"67","000","00","310","0037","0942","795","391","404","25","820","1558","0","52.63","25.10"
"67","000","00","310","0037","0943","655","341","314","36","691","1303","0","53.03","26.17"
"67","000","00","310","0037","0944","597","309","288","43","640","1153","0","55.51","26.80"
"67","000","00","310","0037","0945","639","340","299","22","661","1208","0","54.72","28.15"
"67","000","00","310","0037","0946","723","391","332","42","765","1293","0","59.16","30.24"
"67","000","00","310","0037","0947","732","372","360","30","762","1374","0","55.46","27.07"
"67","000","00","310","0037","0948","580","300","280","23","603","1046","0","57.65","28.68"
"67","000","00","310","0038","0000","4072","2352","1720","168","4240","7231","0","58.64","32.53"
"67","000","00","310","0038","0840","725","433","292","26","751","1209","0","62.12","35.81"
"67","000","00","310","0038","0841","641","368","273","19","660","1073","0","61.51","34.30"
"67","000","00","310","0038","0842","704","404","300","40","744","1212","0","61.39","33.33"
"67","000","00","310","0038","0843","696","447","249","44","740","1207","0","61.31","37.03"
"67","000","00","310","0038","0844","683","374","309","23","706","1285","0","54.94","29.11"
"67","000","00","310","0038","0845","623","326","297","16","639","1245","0","51.33","26.18"
"67","000","00","310","0039","0000","1597","819","778","80","1677","2697","0","62.18","30.37"
"67","000","00","310","0039","0952","834","400","434","37","871","1394","0","62.48","28.69"
"67","000","00","310","0039","0953","763","419","344","43","806","1303","0","61.86","32.16"
"67","000","00","310","0040","0000","2775","1670","1105","128","2903","4958","0","58.55","33.68"
"67","000","00","310","0040","0926","698","435","263","35","733","1252","0","58.55","34.74"
"67","000","00","310","0040","0927","713","420","293","25","738","1268","0","58.20","33.12"
"67","000","00","310","0040","0928","733","446","287","40","773","1291","0","59.88","34.55"
"67","000","00","310","0040","0929","631","369","262","28","659","1147","0","57.45","32.17"
"67","000","00","310","0041","0000","1989","1113","876","70","2059","3734","0","55.14","29.81"
"67","000","00","310","0041","0837","560","315","245","9","569","1106","0","51.45","28.48"
"67","000","00","310","0041","0838","685","395","290","35","720","1252","0","57.51","31.55"
"67","000","00","310","0041","0839","744","403","341","26","770","1376","0","55.96","29.29"
"67","000","00","310","0042","0000","2268","1258","1010","63","2331","4474","0","52.10","28.12"
"67","000","00","310","0042","0889","850","475","375","10","860","1575","0","54.60","30.16"
"67","000","00","310","0042","0890","668","385","283","28","696","1388","0","50.14","27.74"
"67","000","00","310","0042","0891","750","398","352","25","775","1511","0","51.29","26.34"
"67","000","00","310","0043","0000","1835","1100","735","56","1891","3955","0","47.81","27.81"
"67","000","00","310","0043","0871","512","304","208","17","529","1097","0","48.22","27.71"
"67","000","00","310","0043","0872","614","361","253","10","624","1416","0","44.07","25.49"
"67","000","00","310","0043","0873","709","435","274","29","738","1442","0","51.18","30.17"
"67","000","00","320","0000","0000","77912","42221","35691","2900","80812","146044","179965","55.33","28.91"
"67","000","00","320","0001","0000","1015","599","416","32","1047","2079","0","50.36","28.81"
"67","000","00","320","0001","1383","502","291","211","11","513","1030","0","49.81","28.25"
"67","000","00","320","0001","1384","513","308","205","21","534","1049","0","50.91","29.36"
"67","000","00","320","0002","0000","1381","765","616","67","1448","2732","0","53.00","28.00"
"67","000","00","320","0002","1378","723","407","316","41","764","1440","0","53.06","28.26"
"67","000","00","320","0002","1379","658","358","300","26","684","1292","0","52.94","27.71"
"67","000","00","320","0003","0000","3494","1786","1708","172","3666","6321","0","58.00","28.26"
"67","000","00","320","0003","1314","666","360","306","46","712","1254","0","56.78","28.71"
"67","000","00","320","0003","1315","759","363","396","55","814","1321","0","61.62","27.48"
"67","000","00","320","0003","1316","652","336","316","27","679","1213","0","55.98","27.70"
"67","000","00","320","0003","1317","692","322","370","23","715","1261","0","56.70","25.54"
"67","000","00","320","0003","1318","725","405","320","21","746","1272","0","58.65","31.84"
"67","000","00","320","0004","0000","1437","806","631","62","1499","2694","0","55.64","29.92"
"67","000","00","320","0004","1261","495","275","220","20","515","866","0","59.47","31.76"
"67","000","00","320","0004","1262","493","278","215","25","518","903","0","57.36","30.79"
"67","000","00","320","0004","1263","449","253","196","17","466","925","0","50.38","27.35"
"67","000","00","320","0005","0000","2215","1243","972","91","2306","4358","0","52.91","28.52"
"67","000","00","320","0005","1285","447","252","195","13","460","927","0","49.62","27.18"
"67","000","00","320","0005","1286","705","380","325","22","727","1352","0","53.77","28.11"
"67","000","00","320","0005","1287","528","310","218","23","551","1030","0","53.50","30.10"
"67","000","00","320","0005","1288","535","301","234","33","568","1049","0","54.15","28.69"
"67","000","00","320","0006","0000","2266","1253","1013","111","2377","4394","0","54.10","28.52"
"67","000","00","320","0006","1322","734","398","336","51","785","1452","0","54.06","27.41"
"67","000","00","320","0006","1323","704","366","338","35","739","1421","0","52.01","25.76"
"67","000","00","320","0006","1324","828","489","339","25","853","1521","0","56.08","32.15"
"67","000","00","320","0007","0000","1473","828","645","63","1536","2700","0","56.89","30.67"
"67","000","00","320","0007","1356","473","281","192","29","502","882","0","56.92","31.86"
"67","000","00","320","0007","1357","467","250","217","9","476","917","0","51.91","27.26"
"67","000","00","320","0007","1358","533","297","236","25","558","901","0","61.93","32.96"
"67","000","00","320","0008","0000","2363","1250","1113","66","2429","4504","0","53.93","27.75"
"67","000","00","320","0008","1359","654","382","272","15","669","1270","0","52.68","30.08"
"67","000","00","320","0008","1360","508","255","253","13","521","974","0","53.49","26.18"
"67","000","00","320","0008","1361","602","296","306","22","624","1148","0","54.36","25.78"
"67","000","00","320","0008","1362","599","317","282","16","615","1112","0","55.31","28.51"
"67","000","00","320","0009","0000","1301","683","618","54","1355","2261","0","59.93","30.21"
"67","000","00","320","0009","1373","579","308","271","20","599","1044","0","57.38","29.50"
"67","000","00","320","0009","1374","722","375","347","34","756","1217","0","62.12","30.81"
"67","000","00","320","0010","0000","1487","826","661","37","1524","2760","0","55.22","29.93"
"67","000","00","320","0010","1271","508","271","237","15","523","915","0","57.16","29.62"
"67","000","00","320","0010","1272","424","239","185","14","438","805","0","54.41","29.69"
"67","000","00","320","0010","1273","555","316","239","8","563","1040","0","54.13","30.38"
"67","000","00","320","0011","0000","575","350","225","19","594","1268","0","46.85","27.60"
"67","000","00","320","0011","1274","575","350","225","19","594","1268","0","46.85","27.60"
"67","000","00","320","0012","0000","2047","1050","997","58","2105","3770","0","55.84","27.85"
"67","000","00","320","0012","1385","707","336","371","12","719","1284","0","56.00","26.17"
"67","000","00","320","0012","1386","624","328","296","18","642","1145","0","56.07","28.65"
"67","000","00","320","0012","1387","716","386","330","28","744","1341","0","55.48","28.78"
"67","000","00","320","0013","0000","2585","1406","1179","72","2657","5060","0","52.51","27.79"
"67","000","00","320","0013","1340","657","362","295","20","677","1295","0","52.28","27.95"
"67","000","00","320","0013","1341","652","344","308","19","671","1198","0","56.01","28.71"
"67","000","00","320","0013","1342","638","344","294","10","648","1326","0","48.87","25.94"
"67","000","00","320","0013","1343","638","356","282","23","661","1241","0","53.26","28.69"
"67","000","00","320","0014","0000","2650","1491","1159","84","2734","4903","0","55.76","30.41"
"67","000","00","320","0014","1325","702","401","301","17","719","1206","0","59.62","33.25"
"67","000","00","320","0014","1326","728","422","306","24","752","1385","0","54.30","30.47"
"67","000","00","320","0014","1327","678","381","297","22","700","1250","0","56.00","30.48"
"67","000","00","320","0014","1328","542","287","255","21","563","1062","0","53.01","27.02"
"67","000","00","320","0015","0000","805","420","385","32","837","1490","0","56.17","28.19"
"67","000","00","320","0015","1281","805","420","385","32","837","1490","0","56.17","28.19"
"67","000","00","320","0016","0000","757","440","317","49","806","1421","0","56.72","30.96"
"67","000","00","320","0016","1280","757","440","317","49","806","1421","0","56.72","30.96"
"67","000","00","320","0017","0000","2350","1218","1132","82","2432","4374","0","55.60","27.85"
"67","000","00","320","0017","1346","596","295","301","36","632","1102","0","57.35","26.77"
"67","000","00","320","0017","1347","521","281","240","16","537","999","0","53.75","28.13"
"67","000","00","320","0017","1348","563","286","277","12","575","1071","0","53.69","26.70"
"67","000","00","320","0017","1349","670","356","314","18","688","1202","0","57.24","29.62"
"67","000","00","320","0018","0000","817","432","385","43","860","1434","0","59.97","30.13"
"67","000","00","320","0018","1377","817","432","385","43","860","1434","0","59.97","30.13"
"67","000","00","320","0019","0000","2666","1509","1157","84","2750","4821","0","57.04","31.30"
"67","000","00","320","0019","1300","761","446","315","22","783","1372","0","57.07","32.51"
"67","000","00","320","0019","1301","729","388","341","21","750","1358","0","55.23","28.57"
"67","000","00","320","0019","1302","694","399","295","34","728","1200","0","60.67","33.25"
"67","000","00","320","0019","1303","482","276","206","7","489","891","0","54.88","30.98"
"67","000","00","320","0020","0000","2313","1330","983","104","2417","4225","0","57.21","31.48"
"67","000","00","320","0020","1380","726","436","290","33","759","1358","0","55.89","32.11"
"67","000","00","320","0020","1381","741","402","339","28","769","1387","0","55.44","28.98"
"67","000","00","320","0020","1382","846","492","354","43","889","1480","0","60.07","33.24"
"67","000","00","320","0021","0000","858","499","359","46","904","1670","0","54.13","29.88"
"67","000","00","320","0021","1269","367","218","149","29","396","713","0","55.54","30.58"
"67","000","00","320","0021","1270","491","281","210","17","508","957","0","53.08","29.36"
"67","000","00","320","0022","0000","2198","1086","1112","89","2287","3978","0","57.49","27.30"
"67","000","00","320","0022","1369","547","295","252","21","568","995","0","57.09","29.65"
"67","000","00","320","0022","1370","566","271","295","17","583","1003","0","58.13","27.02"
"67","000","00","320","0022","1371","514","237","277","26","540","985","0","54.82","24.06"
"67","000","00","320","0022","1372","571","283","288","25","596","995","0","59.90","28.44"
"67","000","00","320","0023","0000","535","286","249","12","547","972","0","56.28","29.42"
"67","000","00","320","0023","1264","535","286","249","12","547","972","0","56.28","29.42"
"67","000","00","320","0024","0000","2236","1270","966","55","2291","4356","0","52.59","29.16"
"67","000","00","320","0024","1289","479","277","202","12","491","944","0","52.01","29.34"
"67","000","00","320","0024","1290","437","238","199","10","447","907","0","49.28","26.24"
"67","000","00","320","0024","1291","646","371","275","15","661","1247","0","53.01","29.75"
"67","000","00","320","0024","1292","674","384","290","18","692","1258","0","55.01","30.52"
"67","000","00","320","0025","0000","2576","1435","1141","118","2694","4959","0","54.33","28.94"
"67","000","00","320","0025","1329","653","381","272","32","685","1293","0","52.98","29.47"
"67","000","00","320","0025","1330","686","375","311","21","707","1290","0","54.81","29.07"
"67","000","00","320","0025","1331","558","308","250","26","584","1124","0","51.96","27.40"
"67","000","00","320","0025","1332","679","371","308","39","718","1252","0","57.35","29.63"
"67","000","00","320","0026","0000","1848","1051","797","101","1949","3171","0","61.46","33.14"
"67","000","00","320","0026","1319","602","332","270","26","628","1037","0","60.56","32.02"
"67","000","00","320","0026","1320","790","479","311","50","840","1367","0","61.45","35.04"
"67","000","00","320","0026","1321","456","240","216","25","481","767","0","62.71","31.29"
"67","000","00","320","0027","0000","1921","1032","889","66","1987","3327","0","59.72","31.02"
"67","000","00","320","0027","1366","765","392","373","35","800","1292","0","61.92","30.34"
"67","000","00","320","0027","1367","527","285","242","13","540","967","0","55.84","29.47"
"67","000","00","320","0027","1368","629","355","274","18","647","1068","0","60.58","33.24"
"67","000","00","320","0028","0000","763","455","308","54","817","1522","0","53.68","29.89"
"67","000","00","320","0028","1279","763","455","308","54","817","1522","0","53.68","29.89"
"67","000","00","320","0029","0000","2129","1108","1021","93","2222","3994","0","55.63","27.74"
"67","000","00","320","0029","1275","528","264","264","39","567","961","0","59.00","27.47"
"67","000","00","320","0029","1276","526","271","255","23","549","1026","0","53.51","26.41"
"67","000","00","320","0029","1277","549","307","242","16","565","1032","0","54.75","29.75"
"67","000","00","320","0029","1278","526","266","260","15","541","975","0","55.49","27.28"
"67","000","00","320","0030","0000","1314","649","665","50","1364","2257","0","60.43","28.75"
"67","000","00","320","0030","1375","605","289","316","31","636","1069","0","59.49","27.03"
"67","000","00","320","0030","1376","709","360","349","19","728","1188","0","61.28","30.30"
"67","000","00","320","0031","0000","1528","782","746","50","1578","2725","0","57.91","28.70"
"67","000","00","320","0031","1363","464","238","226","9","473","832","0","56.85","28.61"
"67","000","00","320","0031","1364","505","262","243","25","530","890","0","59.55","29.44"
"67","000","00","320","0031","1365","559","282","277","16","575","1003","0","57.33","28.12"
"67","000","00","320","0032","0000","2190","1147","1043","88","2278","4188","0","54.39","27.39"
"67","000","00","320","0032","1296","618","316","302","13","631","1127","0","55.99","28.04"
"67","000","00","320","0032","1297","598","334","264","32","630","1107","0","56.91","30.17"
"67","000","00","320","0032","1298","497","240","257","28","525","1019","0","51.52","23.55"
"67","000","00","320","0032","1299","477","257","220","15","492","935","0","52.62","27.49"
"67","000","00","320","0033","0000","1510","784","726","46","1556","2705","0","57.52","28.98"
"67","000","00","320","0033","1312","720","352","368","27","747","1246","0","59.95","28.25"
"67","000","00","320","0033","1313","790","432","358","19","809","1459","0","55.45","29.61"
"67","000","00","320","0034","0000","1152","691","461","40","1192","2130","0","55.96","32.44"
"67","000","00","320","0034","1344","571","348","223","25","596","1060","0","56.23","32.83"
"67","000","00","320","0034","1345","581","343","238","15","596","1070","0","55.70","32.06"
"67","000","00","320","0035","0000","1362","721","641","50","1412","2731","0","51.70","26.40"
"67","000","00","320","0035","1304","419","217","202","10","429","885","0","48.47","24.52"
"67","000","00","320","0035","1305","530","290","240","22","552","995","0","55.48","29.15"
"67","000","00","320","0035","1306","413","214","199","18","431","851","0","50.65","25.15"
"67","000","00","320","0036","0000","908","552","356","22","930","1667","0","55.79","33.11"
"67","000","00","320","0036","1267","451","277","174","4","455","791","0","57.52","35.02"
"67","000","00","320","0036","1268","457","275","182","18","475","876","0","54.22","31.39"
"67","000","00","320","0037","0000","904","493","411","34","938","1829","0","51.28","26.95"
"67","000","00","320","0037","1265","500","266","234","16","516","952","0","54.20","27.94"
"67","000","00","320","0037","1266","404","227","177","18","422","877","0","48.12","25.88"
"67","000","00","320","0038","0000","1396","801","595","61","1457","2741","0","53.16","29.22"
"67","000","00","320","0038","1282","390","245","145","20","410","770","0","53.25","31.82"
"67","000","00","320","0038","1283","518","281","237","23","541","934","0","57.92","30.09"
"67","000","00","320","0038","1284","488","275","213","18","506","1037","0","48.79","26.52"
"67","000","00","320","0039","0000","1969","1038","931","72","2041","3688","0","55.34","28.15"
"67","000","00","320","0039","1293","651","342","309","25","676","1129","0","59.88","30.29"
"67","000","00","320","0039","1294","673","333","340","12","685","1326","0","51.66","25.11"
"67","000","00","320","0039","1295","645","363","282","35","680","1233","0","55.15","29.44"
"67","000","00","320","0040","0000","1702","925","777","72","1774","4163","0","42.61","22.22"
"67","000","00","320","0040","1258","617","349","268","28","645","1961","0","32.89","17.80"
"67","000","00","320","0040","1259","631","347","284","24","655","1227","0","53.38","28.28"
"67","000","00","320","0040","1260","454","229","225","20","474","975","0","48.62","23.49"
"67","000","00","320","0041","0000","3095","1617","1478","88","3183","5486","0","58.02","29.48"
"67","000","00","320","0041","1307","617","297","320","16","633","1053","0","60.11","28.21"
"67","000","00","320","0041","1308","695","364","331","15","710","1224","0","58.01","29.74"
"67","000","00","320","0041","1309","640","354","286","18","658","1174","0","56.05","30.15"
"67","000","00","320","0041","1310","622","317","305","25","647","1103","0","58.66","28.74"
"67","000","00","320","0041","1311","521","285","236","14","535","932","0","57.40","30.58"
"67","000","00","320","0042","0000","1660","948","712","72","1732","3152","0","54.95","30.08"
"67","000","00","320","0042","1337","570","340","230","28","598","1146","0","52.18","29.67"
"67","000","00","320","0042","1338","509","274","235","17","526","990","0","53.13","27.68"
"67","000","00","320","0042","1339","581","334","247","27","608","1016","0","59.84","32.87"
"67","000","00","320","0043","0000","2563","1371","1192","55","2618","4533","0","57.75","30.24"
"67","000","00","320","0043","1333","682","393","289","17","699","1186","0","58.94","33.14"
"67","000","00","320","0043","1334","649","332","317","21","670","1056","0","63.45","31.44"
"67","000","00","320","0043","1335","628","310","318","9","637","1161","0","54.87","26.70"
"67","000","00","320","0043","1336","604","336","268","8","612","1130","0","54.16","29.73"
"67","000","00","320","0044","0000","1394","726","668","30","1424","2425","0","58.72","29.94"
"67","000","00","320","0044","1350","630","348","282","10","640","1100","0","58.18","31.64"
"67","000","00","320","0044","1351","764","378","386","20","784","1325","0","59.17","28.53"
"67","000","00","320","0045","0000","2204","1069","1135","54","2258","4106","0","54.99","26.04"
"67","000","00","320","0045","1352","570","278","292","15","585","1035","0","56.52","26.86"
"67","000","00","320","0045","1353","578","335","243","14","592","1051","0","56.33","31.87"
"67","000","00","320","0045","1354","500","263","237","15","515","1021","0","50.44","25.76"
"67","000","00","320","0045","1355","556","193","363","10","566","999","0","56.66","19.32"
"67","000","00","330","0000","0000","56117","33640","22477","3309","59426","104690","120892","56.76","32.13"
"67","000","00","330","0001","0000","877","464","413","32","909","1549","0","58.68","29.95"
"67","000","00","330","0001","1175","402","210","192","16","418","762","0","54.86","27.56"
"67","000","00","330","0001","1176","475","254","221","16","491","787","0","62.39","32.27"
"67","000","00","330","0003","0000","642","327","315","18","660","1387","0","47.58","23.58"
"67","000","00","330","0003","1177","642","327","315","18","660","1387","0","47.58","23.58"
"67","000","00","330","0004","0000","998","587","411","34","1032","1944","0","53.09","30.20"
"67","000","00","330","0004","1178","603","345","258","21","624","1222","0","51.06","28.23"
"67","000","00","330","0004","1179","395","242","153","13","408","722","0","56.51","33.52"
"67","000","00","330","0005","0000","1163","716","447","72","1235","2080","0","59.38","34.42"
"67","000","00","330","0005","1188","583","356","227","38","621","1054","0","58.92","33.78"
"67","000","00","330","0005","1189","580","360","220","34","614","1026","0","59.84","35.09"
"67","000","00","330","0006","0000","1106","679","427","76","1182","2111","0","55.99","32.16"
"67","000","00","330","0006","1190","602","359","243","41","643","1167","0","55.10","30.76"
"67","000","00","330","0006","1191","504","320","184","35","539","944","0","57.10","33.90"
"67","000","00","330","0007","0000","1263","742","521","42","1305","2594","0","50.31","28.60"
"67","000","00","330","0007","1183","430","229","201","11","441","854","0","51.64","26.81"
"67","000","00","330","0007","1184","416","275","141","12","428","841","0","50.89","32.70"
"67","000","00","330","0007","1185","417","238","179","19","436","899","0","48.50","26.47"
"67","000","00","330","0008","0000","1636","944","692","88","1724","3006","0","57.35","31.40"
"67","000","00","330","0008","1180","498","291","207","20","518","904","0","57.30","32.19"
"67","000","00","330","0008","1181","651","373","278","31","682","1145","0","59.56","32.58"
"67","000","00","330","0008","1182","487","280","207","37","524","957","0","54.75","29.26"
"67","000","00","330","0009","0000","1558","924","634","118","1676","2789","0","60.09","33.13"
"67","000","00","330","0009","1203","527","331","196","39","566","942","0","60.08","35.14"
"67","000","00","330","0009","1204","491","274","217","49","540","852","0","63.38","32.16"
"67","000","00","330","0009","1205","540","319","221","30","570","995","0","57.29","32.06"
"67","000","00","330","0011","0000","1951","1201","750","140","2091","3973","0","52.63","30.23"
"67","000","00","330","0011","1210","437","264","173","34","471","904","0","52.10","29.20"
"67","000","00","330","0011","1211","482","280","202","29","511","893","0","57.22","31.35"
"67","000","00","330","0011","1212","544","350","194","54","598","1138","0","52.55","30.76"
"67","000","00","330","0011","1213","488","307","181","23","511","1038","0","49.23","29.58"
"67","000","00","330","0013","0000","1942","1200","742","123","2065","3379","0","61.11","35.51"
"67","000","00","330","0013","1214","585","348","237","43","628","1014","0","61.93","34.32"
"67","000","00","330","0013","1215","591","370","221","37","628","1060","0","59.25","34.91"
"67","000","00","330","0013","1216","766","482","284","43","809","1305","0","61.99","36.93"
"67","000","00","330","0014","0000","1052","677","375","66","1118","2015","0","55.48","33.60"
"67","000","00","330","0014","1243","568","368","200","39","607","1094","0","55.48","33.64"
"67","000","00","330","0014","1244","484","309","175","27","511","921","0","55.48","33.55"
"67","000","00","330","0015","0000","1134","753","381","93","1227","2061","0","59.53","36.54"
"67","000","00","330","0015","1240","565","363","202","47","612","1065","0","57.46","34.08"
"67","000","00","330","0015","1241","569","390","179","46","615","996","0","61.75","39.16"
"67","000","00","330","0016","0000","625","470","155","52","677","1147","0","59.02","40.98"
"67","000","00","330","0016","1242","625","470","155","52","677","1147","0","59.02","40.98"
"67","000","00","330","0017","0000","1940","1249","691","94","2034","3905","0","52.09","31.98"
"67","000","00","330","0017","1245","665","447","218","52","717","1269","0","56.50","35.22"
"67","000","00","330","0017","1246","637","395","242","16","653","1401","0","46.61","28.19"
"67","000","00","330","0017","1247","638","407","231","26","664","1235","0","53.77","32.96"
"67","000","00","330","0018","0000","1303","842","461","77","1380","2598","0","53.12","32.41"
"67","000","00","330","0018","1256","517","346","171","40","557","1001","0","55.64","34.57"
"67","000","00","330","0018","1257","786","496","290","37","823","1597","0","51.53","31.06"
"67","000","00","330","0019","0000","1186","765","421","88","1274","2057","0","61.93","37.19"
"67","000","00","330","0019","1254","629","386","243","44","673","1074","0","62.66","35.94"
"67","000","00","330","0019","1255","557","379","178","44","601","983","0","61.14","38.56"
"67","000","00","330","0020","0000","1260","823","437","126","1386","2426","0","57.13","33.92"
"67","000","00","330","0020","1252","568","363","205","65","633","1105","0","57.29","32.85"
"67","000","00","330","0020","1253","692","460","232","61","753","1321","0","57.00","34.82"
"67","000","00","330","0021","0000","1126","574","552","52","1178","2092","0","56.31","27.44"
"67","000","00","330","0021","1166","554","275","279","22","576","1035","0","55.65","26.57"
"67","000","00","330","0021","1167","572","299","273","30","602","1057","0","56.95","28.29"
"67","000","00","330","0022","0000","2238","1253","985","142","2380","4305","0","55.28","29.11"
"67","000","00","330","0022","1168","570","361","209","49","619","1151","0","53.78","31.36"
"67","000","00","330","0022","1169","515","275","240","26","541","947","0","57.13","29.04"
"67","000","00","330","0022","1170","457","252","205","25","482","915","0","52.68","27.54"
"67","000","00","330","0022","1171","696","365","331","42","738","1292","0","57.12","28.25"
"67","000","00","330","0023","0000","1715","896","819","112","1827","3272","0","55.84","27.38"
"67","000","00","330","0023","1163","486","263","223","26","512","887","0","57.72","29.65"
"67","000","00","330","0023","1164","583","323","260","48","631","1184","0","53.29","27.28"
"67","000","00","330","0023","1165","646","310","336","38","684","1201","0","56.95","25.81"
"67","000","00","330","0024","0000","1679","632","1047","100","1779","3191","0","55.75","19.81"
"67","000","00","330","0024","1172","512","194","318","27","539","1004","0","53.69","19.32"
"67","000","00","330","0024","1173","609","212","397","46","655","1093","0","59.93","19.40"
"67","000","00","330","0024","1174","558","226","332","27","585","1094","0","53.47","20.66"
"67","000","00","330","0025","0000","1167","730","437","56","1223","2087","0","58.60","34.98"
"67","000","00","330","0025","1186","601","374","227","26","627","1111","0","56.44","33.66"
"67","000","00","330","0025","1187","566","356","210","30","596","976","0","61.07","36.48"
"67","000","00","330","0026","0000","1726","1116","610","114","1840","3093","0","59.49","36.08"
"67","000","00","330","0026","1220","853","559","294","52","905","1477","0","61.27","37.85"
"67","000","00","330","0026","1221","873","557","316","62","935","1616","0","57.86","34.47"
"67","000","00","330","0027","0000","1630","959","671","89","1719","3071","0","55.98","31.23"
"67","000","00","330","0027","1192","543","332","211","25","568","1041","0","54.56","31.89"
"67","000","00","330","0027","1193","551","334","217","25","576","1002","0","57.49","33.33"
"67","000","00","330","0027","1194","536","293","243","39","575","1028","0","55.93","28.50"
"67","000","00","330","0028","0000","2289","1374","915","112","2401","4680","0","51.30","29.36"
"67","000","00","330","0028","1199","602","364","238","22","624","1201","0","51.96","30.31"
"67","000","00","330","0028","1200","550","345","205","25","575","1205","0","47.72","28.63"
"67","000","00","330","0028","1201","545","303","242","35","580","1135","0","51.10","26.70"
"67","000","00","330","0028","1202","592","362","230","30","622","1139","0","54.61","31.78"
"67","000","00","330","0029","0000","1381","794","587","69","1450","2600","0","55.77","30.54"
"67","000","00","330","0029","1228","751","428","323","43","794","1592","0","49.87","26.88"
"67","000","00","330","0029","1229","630","366","264","26","656","1008","0","65.08","36.31"
"67","000","00","330","0030","0000","2659","1637","1022","174","2833","5373","0","52.73","30.47"
"67","000","00","330","0030","1232","788","457","331","44","832","1593","0","52.23","28.69"
"67","000","00","330","0030","1233","518","332","186","47","565","1113","0","50.76","29.83"
"67","000","00","330","0030","1234","610","376","234","36","646","1222","0","52.86","30.77"
"67","000","00","330","0030","1235","743","472","271","47","790","1445","0","54.67","32.66"
"67","000","00","330","0031","0000","733","463","270","45","778","1414","0","55.02","32.74"
"67","000","00","330","0031","1236","432","267","165","35","467","862","0","54.18","30.97"
"67","000","00","330","0031","1237","301","196","105","10","311","552","0","56.34","35.51"
"67","000","00","330","0032","0000","2960","1801","1159","144","3104","4852","0","63.97","37.12"
"67","000","00","330","0032","1224","746","427","319","33","779","1183","0","65.85","36.09"
"67","000","00","330","0032","1225","651","400","251","42","693","1074","0","64.53","37.24"
"67","000","00","330","0032","1226","748","464","284","42","790","1198","0","65.94","38.73"
"67","000","00","330","0032","1227","815","510","305","27","842","1397","0","60.27","36.51"
"67","000","00","330","0033","0000","2028","1162","866","124","2152","3411","0","63.09","34.07"
"67","000","00","330","0033","1222","813","473","340","55","868","1432","0","60.61","33.03"
"67","000","00","330","0033","1223","1215","689","526","69","1284","1979","0","64.88","34.82"
"67","000","00","330","0034","0000","2395","1393","1002","125","2520","4582","0","55.00","30.40"
"67","000","00","330","0034","1217","804","446","358","53","857","1655","0","51.78","26.95"
"67","000","00","330","0034","1218","797","468","329","51","848","1485","0","57.10","31.52"
"67","000","00","330","0034","1219","794","479","315","21","815","1442","0","56.52","33.22"
"67","000","00","330","0035","0000","2476","1492","984","60","2536","4824","0","52.57","30.93"
"67","000","00","330","0035","1195","518","329","189","19","537","1100","0","48.82","29.91"
"67","000","00","330","0035","1196","559","309","250","9","568","1145","0","49.61","26.99"
"67","000","00","330","0035","1197","747","446","301","14","761","1291","0","58.95","34.55"
"67","000","00","330","0035","1198","652","408","244","18","670","1288","0","52.02","31.68"
"67","000","00","330","0036","0000","947","574","373","74","1021","1650","0","61.88","34.79"
"67","000","00","330","0036","1238","539","316","223","43","582","911","0","63.89","34.69"
"67","000","00","330","0036","1239","408","258","150","31","439","739","0","59.40","34.91"
"67","000","00","330","0037","0000","1068","703","365","67","1135","1688","0","67.24","41.65"
"67","000","00","330","0037","1250","655","443","212","39","694","1007","0","68.92","43.99"
"67","000","00","330","0037","1251","413","260","153","28","441","681","0","64.76","38.18"
"67","000","00","330","0038","0000","906","621","285","105","1011","1596","0","63.35","38.91"
"67","000","00","330","0038","1248","519","364","155","53","572","915","0","62.51","39.78"
"67","000","00","330","0038","1249","387","257","130","52","439","681","0","64.46","37.74"
"67","000","00","330","0039","0000","1253","774","479","78","1331","2336","0","56.98","33.13"
"67","000","00","330","0039","1230","619","389","230","45","664","1150","0","57.74","33.83"
"67","000","00","330","0039","1231","634","385","249","33","667","1186","0","56.24","32.46"
"67","000","00","330","0040","0000","2105","1329","776","128","2233","3552","0","62.87","37.42"
"67","000","00","330","0040","1206","518","345","173","36","554","878","0","63.10","39.29"
"67","000","00","330","0040","1207","450","266","184","23","473","791","0","59.80","33.63"
"67","000","00","330","0040","1208","624","414","210","49","673","1008","0","66.77","41.07"
"67","000","00","330","0040","1209","513","304","209","20","533","875","0","60.91","34.74"
"67","000","00","340","0000","0000","55221","31225","23996","2633","57854","105633","125974","54.77","29.56"
"67","000","00","340","0001","0000","1672","952","720","102","1774","3218","0","55.13","29.58"
"67","000","00","340","0001","0963","474","260","214","32","506","1106","0","45.75","23.51"
"67","000","00","340","0001","0964","583","335","248","27","610","1061","0","57.49","31.57"
"67","000","00","340","0001","0965","615","357","258","43","658","1051","0","62.61","33.97"
"67","000","00","340","0004","0000","996","442","554","43","1039","1794","0","57.92","24.64"
"67","000","00","340","0004","0976","527","213","314","23","550","946","0","58.14","22.52"
"67","000","00","340","0004","0977","469","229","240","20","489","848","0","57.67","27.00"
"67","000","00","340","0005","0000","1276","686","590","51","1327","2261","0","58.69","30.34"
"67","000","00","340","0005","0972","590","329","261","33","623","1118","0","55.72","29.43"
"67","000","00","340","0005","0973","686","357","329","18","704","1143","0","61.59","31.23"
"67","000","00","340","0007","0000","977","534","443","54","1031","1855","0","55.58","28.79"
"67","000","00","340","0007","0981","483","267","216","24","507","883","0","57.42","30.24"
"67","000","00","340","0007","0982","494","267","227","30","524","972","0","53.91","27.47"
"67","000","00","340","0008","0000","1198","643","555","58","1256","2099","0","59.84","30.63"
"67","000","00","340","0008","0983","633","342","291","21","654","1094","0","59.78","31.26"
"67","000","00","340","0008","0984","565","301","264","37","602","1005","0","59.90","29.95"
"67","000","00","340","0018","0000","1922","1184","738","104","2026","4001","0","50.64","29.59"
"67","000","00","340","0018","1053","446","286","160","31","477","967","0","49.33","29.58"
"67","000","00","340","0018","1054","441","273","168","29","470","951","0","49.42","28.71"
"67","000","00","340","0018","1055","487","287","200","15","502","939","0","53.46","30.56"
"67","000","00","340","0018","1056","548","338","210","29","577","1144","0","50.44","29.55"
"67","000","00","340","0019","0000","1011","523","488","42","1053","1760","0","59.83","29.72"
"67","000","00","340","0019","0974","542","272","270","25","567","954","0","59.43","28.51"
"67","000","00","340","0019","0975","469","251","218","17","486","806","0","60.30","31.14"
"67","000","00","340","0020","0000","2472","1445","1027","69","2541","4544","0","55.92","31.80"
"67","000","00","340","0020","1028","629","355","274","18","647","1191","0","54.32","29.81"
"67","000","00","340","0020","1029","547","320","227","13","560","1056","0","53.03","30.30"
"67","000","00","340","0020","1030","698","398","300","16","714","1226","0","58.24","32.46"
"67","000","00","340","0020","1031","598","372","226","22","620","1071","0","57.89","34.73"
"67","000","00","340","0023","0000","1490","908","582","101","1591","2959","0","53.77","30.69"
"67","000","00","340","0023","1011","505","303","202","33","538","1028","0","52.33","29.47"
"67","000","00","340","0023","1012","465","287","178","35","500","897","0","55.74","32.00"
"67","000","00","340","0023","1013","520","318","202","33","553","1034","0","53.48","30.75"
"67","000","00","340","0024","0000","2120","1238","882","95","2215","4356","0","50.85","28.42"
"67","000","00","340","0024","1014","743","454","289","44","787","1515","0","51.95","29.97"
"67","000","00","340","0024","1015","736","405","331","28","764","1500","0","50.93","27.00"
"67","000","00","340","0024","1016","641","379","262","23","664","1341","0","49.52","28.26"
"67","000","00","340","0025","0000","1736","997","739","46","1782","3253","0","54.78","30.65"
"67","000","00","340","0025","1042","526","284","242","22","548","970","0","56.49","29.28"
"67","000","00","340","0025","1043","661","373","288","20","681","1239","0","54.96","30.10"
"67","000","00","340","0025","1044","549","340","209","4","553","1044","0","52.97","32.57"
"67","000","00","340","0026","0000","2630","1532","1098","106","2736","5117","0","53.47","29.94"
"67","000","00","340","0026","1048","455","295","160","19","474","842","0","56.29","35.04"
"67","000","00","340","0026","1049","460","257","203","15","475","894","0","53.13","28.75"
"67","000","00","340","0026","1050","489","313","176","31","520","1000","0","52.00","31.30"
"67","000","00","340","0026","1051","557","300","257","17","574","1093","0","52.52","27.45"
"67","000","00","340","0026","1052","669","367","302","24","693","1288","0","53.80","28.49"
"67","000","00","340","0032","0000","678","394","284","31","709","1321","0","53.67","29.83"
"67","000","00","340","0032","0985","678","394","284","31","709","1321","0","53.67","29.83"
"67","000","00","340","0033","0000","884","494","390","52","936","1717","0","54.51","28.77"
"67","000","00","340","0033","1000","426","222","204","25","451","802","0","56.23","27.68"
"67","000","00","340","0033","1001","458","272","186","27","485","915","0","53.01","29.73"
"67","000","00","340","0038","0000","1873","1034","839","74","1947","3966","0","49.09","26.07"
"67","000","00","340","0038","0966","755","404","351","24","779","1577","0","49.40","25.62"
"67","000","00","340","0038","0967","457","280","177","17","474","1064","0","44.55","26.32"
"67","000","00","340","0038","0968","661","350","311","33","694","1325","0","52.38","26.42"
"67","000","00","340","0039","0000","1658","909","749","137","1795","2881","0","62.30","31.55"
"67","000","00","340","0039","0986","831","445","386","67","898","1434","0","62.62","31.03"
"67","000","00","340","0039","0987","827","464","363","70","897","1447","0","61.99","32.07"
"67","000","00","340","0040","0000","2120","1200","920","75","2195","4159","0","52.78","28.85"
"67","000","00","340","0040","1024","555","320","235","29","584","1094","0","53.38","29.25"
"67","000","00","340","0040","1025","559","315","244","11","570","1075","0","53.02","29.30"
"67","000","00","340","0040","1026","560","309","251","22","582","1102","0","52.81","28.04"
"67","000","00","340","0040","1027","446","256","190","13","459","888","0","51.69","28.83"
"67","000","00","340","0041","0000","1592","922","670","94","1686","2772","0","60.82","33.26"
"67","000","00","340","0041","1036","526","302","224","36","562","965","0","58.24","31.30"
"67","000","00","340","0041","1037","539","306","233","31","570","885","0","64.41","34.58"
"67","000","00","340","0041","1038","527","314","213","27","554","922","0","60.09","34.06"
"67","000","00","340","0042","0000","1725","1044","681","78","1803","3484","0","51.75","29.97"
"67","000","00","340","0042","1045","591","364","227","27","618","1205","0","51.29","30.21"
"67","000","00","340","0042","1046","595","363","232","34","629","1145","0","54.93","31.70"
"67","000","00","340","0042","1047","539","317","222","17","556","1134","0","49.03","27.95"
"67","000","00","340","0043","0000","1849","1085","764","48","1897","3430","0","55.31","31.63"
"67","000","00","340","0043","1057","594","353","241","27","621","1108","0","56.05","31.86"
"67","000","00","340","0043","1058","642","356","286","6","648","1219","0","53.16","29.20"
"67","000","00","340","0043","1059","613","376","237","15","628","1103","0","56.94","34.09"
"67","000","00","340","0044","0000","1967","913","1054","118","2085","3604","0","57.85","25.33"
"67","000","00","340","0044","0978","639","337","302","41","680","1120","0","60.71","30.09"
"67","000","00","340","0044","0979","647","263","384","37","684","1301","0","52.57","20.22"
"67","000","00","340","0044","0980","681","313","368","40","721","1183","0","60.95","26.46"
"67","000","00","340","0045","0000","1709","1010","699","112","1821","3233","0","56.33","31.24"
"67","000","00","340","0045","0969","638","372","266","44","682","1221","0","55.86","30.47"
"67","000","00","340","0045","0970","511","311","200","31","542","992","0","54.64","31.35"
"67","000","00","340","0045","0971","560","327","233","37","597","1020","0","58.53","32.06"
"67","000","00","340","0046","0000","2746","1513","1233","154","2900","4927","0","58.86","30.71"
"67","000","00","340","0046","0988","505","228","277","33","538","920","0","58.48","24.78"
"67","000","00","340","0046","0989","587","285","302","20","607","1012","0","59.98","28.16"
"67","000","00","340","0046","0990","499","308","191","39","538","899","0","59.84","34.26"
"67","000","00","340","0046","0991","572","334","238","37","609","984","0","61.89","33.94"
"67","000","00","340","0046","0992","583","358","225","25","608","1112","0","54.68","32.19"
"67","000","00","340","0047","0000","2062","1229","833","119","2181","3671","0","59.41","33.48"
"67","000","00","340","0047","1007","514","304","210","37","551","875","0","62.97","34.74"
"67","000","00","340","0047","1008","460","299","161","29","489","791","0","61.82","37.80"
"67","000","00","340","0047","1009","496","287","209","22","518","894","0","57.94","32.10"
"67","000","00","340","0047","1010","592","339","253","31","623","1111","0","56.08","30.51"
"67","000","00","340","0048","0000","2279","1060","1219","135","2414","4549","0","53.07","23.30"
"67","000","00","340","0048","0993","613","244","369","43","656","1236","0","53.07","19.74"
"67","000","00","340","0048","0994","503","210","293","30","533","982","0","54.28","21.38"
"67","000","00","340","0048","0995","631","280","351","31","662","1283","0","51.60","21.82"
"67","000","00","340","0048","0996","532","326","206","31","563","1048","0","53.72","31.11"
"67","000","00","340","0049","0000","1407","804","603","85","1492","2837","0","52.59","28.34"
"67","000","00","340","0049","0997","461","272","189","36","497","935","0","53.16","29.09"
"67","000","00","340","0049","0998","480","273","207","23","503","947","0","53.12","28.83"
"67","000","00","340","0049","0999","466","259","207","26","492","955","0","51.52","27.12"
"67","000","00","340","0050","0000","1265","756","509","71","1336","2513","0","53.16","30.08"
"67","000","00","340","0050","1005","631","405","226","43","674","1209","0","55.75","33.50"
"67","000","00","340","0050","1006","634","351","283","28","662","1304","0","50.77","26.92"
"67","000","00","340","0051","0000","1760","1063","697","84","1844","3877","0","47.56","27.42"
"67","000","00","340","0051","1002","608","381","227","27","635","1193","0","53.23","31.94"
"67","000","00","340","0051","1003","661","408","253","40","701","1228","0","57.08","33.22"
"67","000","00","340","0051","1004","491","274","217","17","508","1456","0","34.89","18.82"
"67","000","00","340","0052","0000","1835","1051","784","44","1879","3618","0","51.93","29.05"
"67","000","00","340","0052","1017","562","311","251","12","574","1110","0","51.71","28.02"
"67","000","00","340","0052","1018","799","460","339","13","812","1560","0","52.05","29.49"
"67","000","00","340","0052","1019","474","280","194","19","493","948","0","52.00","29.54"
"67","000","00","340","0053","0000","2392","1329","1063","71","2463","4367","0","56.40","30.43"
"67","000","00","340","0053","1020","524","286","238","20","544","961","0","56.61","29.76"
"67","000","00","340","0053","1021","581","331","250","21","602","1094","0","55.03","30.26"
"67","000","00","340","0053","1022","678","389","289","17","695","1167","0","59.55","33.33"
"67","000","00","340","0053","1023","609","323","286","13","622","1145","0","54.32","28.21"
"67","000","00","340","0054","0000","1276","821","455","80","1356","2426","0","55.89","33.84"
"67","000","00","340","0054","1032","667","423","244","36","703","1341","0","52.42","31.54"
"67","000","00","340","0054","1033","609","398","211","44","653","1085","0","60.18","36.68"
"67","000","00","340","0055","0000","1144","646","498","34","1178","2144","0","54.94","30.13"
"67","000","00","340","0055","1034","521","300","221","10","531","1009","0","52.63","29.73"
"67","000","00","340","0055","1035","623","346","277","24","647","1135","0","57.00","30.48"
"67","000","00","340","0056","0000","1500","864","636","66","1566","2920","0","53.63","29.59"
"67","000","00","340","0056","1039","550","302","248","21","571","1018","0","56.09","29.67"
"67","000","00","340","0056","1040","452","267","185","24","476","924","0","51.52","28.90"
"67","000","00","340","0056","1041","498","295","203","21","519","978","0","53.07","30.16"
"67","000","00","350","0000","0000","88269","53414","34855","5670","93939","161811","198627","58.05","33.01"
"67","000","00","350","0001","0000","1517","905","612","78","1595","2843","0","56.10","31.83"
"67","000","00","350","0001","0661","793","493","300","57","850","1473","0","57.71","33.47"
"67","000","00","350","0001","0662","724","412","312","21","745","1370","0","54.38","30.07"
"67","000","00","350","0002","0000","2761","1582","1179","173","2934","4645","0","63.16","34.06"
"67","000","00","350","0002","0675","690","388","302","69","759","1159","0","65.49","33.48"
"67","000","00","350","0002","0676","714","400","314","31","745","1178","0","63.24","33.96"
"67","000","00","350","0002","0677","698","421","277","42","740","1171","0","63.19","35.95"
"67","000","00","350","0002","0678","659","373","286","31","690","1137","0","60.69","32.81"
"67","000","00","350","0003","0000","2436","1463","973","164","2600","4523","0","57.48","32.35"
"67","000","00","350","0003","0663","555","335","220","49","604","1034","0","58.41","32.40"
"67","000","00","350","0003","0664","680","413","267","54","734","1228","0","59.77","33.63"
"67","000","00","350","0003","0665","612","367","245","36","648","1135","0","57.09","32.33"
"67","000","00","350","0003","0666","589","348","241","25","614","1126","0","54.53","30.91"
"67","000","00","350","0004","0000","2705","1570","1135","197","2902","4911","0","59.09","31.97"
"67","000","00","350","0004","0667","672","369","303","48","720","1198","0","60.10","30.80"
"67","000","00","350","0004","0668","791","491","300","39","830","1360","0","61.03","36.10"
"67","000","00","350","0004","0669","728","403","325","85","813","1256","0","64.73","32.09"
"67","000","00","350","0004","0670","514","307","207","25","539","1097","0","49.13","27.99"
"67","000","00","350","0005","0000","2240","1354","886","151","2391","4301","0","55.59","31.48"
"67","000","00","350","0005","0671","565","333","232","68","633","1148","0","55.14","29.01"
"67","000","00","350","0005","0672","560","355","205","29","589","1065","0","55.31","33.33"
"67","000","00","350","0005","0673","560","358","202","38","598","1131","0","52.87","31.65"
"67","000","00","350","0005","0674","555","308","247","16","571","957","0","59.67","32.18"
"67","000","00","350","0006","0000","1426","872","554","89","1515","2727","0","55.56","31.98"
"67","000","00","350","0006","0704","751","457","294","41","792","1431","0","55.35","31.94"
"67","000","00","350","0006","0705","675","415","260","48","723","1296","0","55.79","32.02"
"67","000","00","350","0007","0000","2067","1235","832","95","2162","3538","0","61.11","34.91"
"67","000","00","350","0007","0697","673","425","248","38","711","1114","0","63.82","38.15"
"67","000","00","350","0007","0698","692","411","281","43","735","1153","0","63.75","35.65"
"67","000","00","350","0007","0699","702","399","303","14","716","1271","0","56.33","31.39"
"67","000","00","350","0008","0000","2296","1438","858","140","2436","4432","0","54.96","32.45"
"67","000","00","350","0008","0684","569","336","233","17","586","1158","0","50.60","29.02"
"67","000","00","350","0008","0685","549","329","220","25","574","1053","0","54.51","31.24"
"67","000","00","350","0008","0686","608","433","175","68","676","1105","0","61.18","39.19"
"67","000","00","350","0008","0687","570","340","230","30","600","1116","0","53.76","30.47"
"67","000","00","350","0009","0000","3453","2104","1349","172","3625","6147","0","58.97","34.23"
"67","000","00","350","0009","0688","737","480","257","40","777","1223","0","63.53","39.25"
"67","000","00","350","0009","0689","780","477","303","49","829","1472","0","56.32","32.40"
"67","000","00","350","0009","0690","673","420","253","29","702","1201","0","58.45","34.97"
"67","000","00","350","0009","0691","611","362","249","26","637","1055","0","60.38","34.31"
"67","000","00","350","0009","0692","652","365","287","28","680","1196","0","56.86","30.52"
"67","000","00","350","0010","0000","3526","1994","1532","181","3707","6207","0","59.72","32.13"
"67","000","00","350","0010","0679","655","358","297","44","699","1176","0","59.44","30.44"
"67","000","00","350","0010","0680","939","546","393","37","976","1677","0","58.20","32.56"
"67","000","00","350","0010","0681","757","430","327","28","785","1260","0","62.30","34.13"
"67","000","00","350","0010","0682","584","328","256","40","624","1044","0","59.77","31.42"
"67","000","00","350","0010","0683","591","332","259","32","623","1050","0","59.33","31.62"
"67","000","00","350","0011","0000","1059","580","479","62","1121","2060","0","54.42","28.16"
"67","000","00","350","0011","0724","610","349","261","42","652","1131","0","57.65","30.86"
"67","000","00","350","0011","0725","449","231","218","20","469","929","0","50.48","24.87"
"67","000","00","350","0012","0000","1029","634","395","120","1149","1751","0","65.62","36.21"
"67","000","00","350","0012","0732","514","322","192","63","577","897","0","64.33","35.90"
"67","000","00","350","0012","0733","515","312","203","57","572","854","0","66.98","36.53"
"67","000","00","350","0013","0000","2675","1591","1084","195","2870","4634","0","61.93","34.33"
"67","000","00","350","0013","0726","800","470","330","40","840","1403","0","59.87","33.50"
"67","000","00","350","0013","0727","626","373","253","68","694","994","0","69.82","37.53"
"67","000","00","350","0013","0728","620","369","251","46","666","1085","0","61.38","34.01"
"67","000","00","350","0013","0729","629","379","250","41","670","1152","0","58.16","32.90"
"67","000","00","350","0014","0000","508","332","176","46","554","1122","0","49.38","29.59"
"67","000","00","350","0014","0730","508","332","176","46","554","1122","0","49.38","29.59"
"67","000","00","350","0015","0000","2728","1705","1023","139","2867","5478","0","52.34","31.12"
"67","000","00","350","0015","0717","651","415","236","41","692","1286","0","53.81","32.27"
"67","000","00","350","0015","0718","703","446","257","46","749","1400","0","53.50","31.86"
"67","000","00","350","0015","0719","691","412","279","27","718","1411","0","50.89","29.20"
"67","000","00","350","0015","0720","683","432","251","25","708","1381","0","51.27","31.28"
"67","000","00","350","0016","0000","1558","944","614","137","1695","2705","0","62.66","34.90"
"67","000","00","350","0016","0747","867","530","337","64","931","1457","0","63.90","36.38"
"67","000","00","350","0016","0748","691","414","277","73","764","1248","0","61.22","33.17"
"67","000","00","350","0017","0000","1353","809","544","78","1431","2479","0","57.72","32.63"
"67","000","00","350","0017","0783","728","462","266","44","772","1448","0","53.31","31.91"
"67","000","00","350","0017","0784","625","347","278","34","659","1031","0","63.92","33.66"
"67","000","00","350","0018","0000","3588","2075","1513","200","3788","7808","0","48.51","26.58"
"67","000","00","350","0018","0749","655","379","276","55","710","1372","0","51.75","27.62"
"67","000","00","350","0018","0750","653","380","273","41","694","1281","0","54.18","29.66"
"67","000","00","350","0018","0751","646","370","276","27","673","1257","0","53.54","29.44"
"67","000","00","350","0018","0752","657","379","278","29","686","1350","0","50.81","28.07"
"67","000","00","350","0018","0753","665","385","280","37","702","1284","0","54.67","29.98"
"67","000","00","350","0018","0754","312","182","130","11","323","1264","0","25.55","14.40"
"67","000","00","350","0019","0000","834","478","356","54","888","1526","0","58.19","31.32"
"67","000","00","350","0019","0801","413","248","165","27","440","773","0","56.92","32.08"
"67","000","00","350","0019","0802","421","230","191","27","448","753","0","59.50","30.54"
"67","000","00","350","0020","0000","2446","1430","1016","149","2595","4642","0","55.90","30.81"
"67","000","00","350","0020","0755","638","367","271","48","686","1243","0","55.19","29.53"
"67","000","00","350","0020","0756","559","346","213","26","585","1075","0","54.42","32.19"
"67","000","00","350","0020","0757","630","363","267","46","676","1184","0","57.09","30.66"
"67","000","00","350","0020","0758","619","354","265","29","648","1140","0","56.84","31.05"
"67","000","00","350","0021","0000","1889","1137","752","131","2020","3643","0","55.45","31.21"
"67","000","00","350","0021","0744","734","450","284","69","803","1378","0","58.27","32.66"
"67","000","00","350","0021","0745","600","344","256","28","628","1256","0","50.00","27.39"
"67","000","00","350","0021","0746","555","343","212","34","589","1009","0","58.37","33.99"
"67","000","00","350","0022","0000","1720","1048","672","103","1823","3261","0","55.90","32.14"
"67","000","00","350","0022","0739","517","331","186","52","569","991","0","57.42","33.40"
"67","000","00","350","0022","0740","552","339","213","23","575","1012","0","56.82","33.50"
"67","000","00","350","0022","0741","651","378","273","28","679","1258","0","53.97","30.05"
"67","000","00","350","0023","0000","1281","808","473","111","1392","2071","0","67.21","39.01"
"67","000","00","350","0023","0742","610","373","237","49","659","959","0","68.72","38.89"
"67","000","00","350","0023","0743","671","435","236","62","733","1112","0","65.92","39.12"
"67","000","00","350","0024","0000","586","359","227","77","663","1011","0","65.58","35.51"
"67","000","00","350","0024","0738","586","359","227","77","663","1011","0","65.58","35.51"
"67","000","00","350","0025","0000","1156","725","431","99","1255","1860","0","67.47","38.98"
"67","000","00","350","0025","0734","624","359","265","54","678","925","0","73.30","38.81"
"67","000","00","350","0025","0735","532","366","166","45","577","935","0","61.71","39.14"
"67","000","00","350","0026","0000","1320","817","503","135","1455","2548","0","57.10","32.06"
"67","000","00","350","0026","0736","635","371","264","79","714","1247","0","57.26","29.75"
"67","000","00","350","0026","0737","685","446","239","56","741","1301","0","56.96","34.28"
"67","000","00","350","0027","0000","826","496","330","78","904","1572","0","57.51","31.55"
"67","000","00","350","0027","0785","446","273","173","45","491","808","0","60.77","33.79"
"67","000","00","350","0027","0786","380","223","157","33","413","764","0","54.06","29.19"
"67","000","00","350","0028","0000","978","645","333","69","1047","1503","0","69.66","42.91"
"67","000","00","350","0028","0792","591","393","198","49","640","853","0","75.03","46.07"
"67","000","00","350","0028","0793","387","252","135","20","407","650","0","62.62","38.77"
"67","000","00","350","0029","0000","517","313","204","16","533","1018","0","52.36","30.75"
"67","000","00","350","0029","0794","517","313","204","16","533","1018","0","52.36","30.75"
"67","000","00","350","0030","0000","1862","1154","708","135","1997","3178","0","62.84","36.31"
"67","000","00","350","0030","0787","476","320","156","51","527","815","0","64.66","39.26"
"67","000","00","350","0030","0788","544","335","209","34","578","965","0","59.90","34.72"
"67","000","00","350","0030","0789","842","499","343","50","892","1398","0","63.81","35.69"
"67","000","00","350","0031","0000","791","496","295","40","831","1394","0","59.61","35.58"
"67","000","00","350","0031","0791","791","496","295","40","831","1394","0","59.61","35.58"
"67","000","00","350","0032","0000","874","544","330","129","1003","1432","0","70.04","37.99"
"67","000","00","350","0032","0790","874","544","330","129","1003","1432","0","70.04","37.99"
"67","000","00","350","0033","0000","714","436","278","64","778","1240","0","62.74","35.16"
"67","000","00","350","0033","0795","367","219","148","45","412","568","0","72.54","38.56"
"67","000","00","350","0033","0796","347","217","130","19","366","672","0","54.46","32.29"
"67","000","00","350","0035","0000","563","345","218","62","625","846","0","73.88","40.78"
"67","000","00","350","0035","0798","563","345","218","62","625","846","0","73.88","40.78"
"67","000","00","350","0036","0000","1120","730","390","110","1230","1823","0","67.47","40.04"
"67","000","00","350","0036","0799","627","411","216","61","688","978","0","70.35","42.02"
"67","000","00","350","0036","0800","493","319","174","49","542","845","0","64.14","37.75"
"67","000","00","350","0037","0000","1211","755","456","76","1287","2068","0","62.23","36.51"
"67","000","00","350","0037","0695","661","407","254","29","690","1115","0","61.88","36.50"
"67","000","00","350","0037","0696","550","348","202","47","597","953","0","62.64","36.52"
"67","000","00","350","0038","0000","1355","859","496","111","1466","2646","0","55.40","32.46"
"67","000","00","350","0038","0693","656","432","224","71","727","1340","0","54.25","32.24"
"67","000","00","350","0038","0694","699","427","272","40","739","1306","0","56.58","32.70"
"67","000","00","350","0039","0000","2351","1397","954","119","2470","4233","0","58.35","33.00"
"67","000","00","350","0039","0700","554","339","215","41","595","1040","0","57.21","32.60"
"67","000","00","350","0039","0701","662","387","275","24","686","1126","0","60.92","34.37"
"67","000","00","350","0039","0702","601","372","229","38","639","1065","0","60.00","34.93"
"67","000","00","350","0039","0703","534","299","235","16","550","1002","0","54.89","29.84"
"67","000","00","350","0040","0000","1596","1004","592","99","1695","2927","0","57.91","34.30"
"67","000","00","350","0040","0762","531","304","227","31","562","979","0","57.41","31.05"
"67","000","00","350","0040","0763","567","370","197","21","588","1022","0","57.53","36.20"
"67","000","00","350","0040","0764","498","330","168","47","545","926","0","58.86","35.64"
"67","000","00","350","0041","0000","2377","1474","903","136","2513","4112","0","61.11","35.85"
"67","000","00","350","0041","0765","730","445","285","33","763","1305","0","58.47","34.10"
"67","000","00","350","0041","0766","787","503","284","54","841","1366","0","61.57","36.82"
"67","000","00","350","0041","0767","860","526","334","49","909","1441","0","63.08","36.50"
"67","000","00","350","0042","0000","2011","1285","726","134","2145","3504","0","61.22","36.67"
"67","000","00","350","0042","0780","618","403","215","42","660","1094","0","60.33","36.84"
"67","000","00","350","0042","0781","717","456","261","48","765","1213","0","63.07","37.59"
"67","000","00","350","0042","0782","676","426","250","44","720","1197","0","60.15","35.59"
"67","000","00","350","0043","0000","2312","1355","957","111","2423","4214","0","57.50","32.15"
"67","000","00","350","0043","0706","850","487","363","48","898","1505","0","59.67","32.36"
"67","000","00","350","0043","0707","772","470","302","39","811","1419","0","57.15","33.12"
"67","000","00","350","0043","0708","690","398","292","24","714","1290","0","55.35","30.85"
"67","000","00","350","0044","0000","2152","1271","881","109","2261","3883","0","58.23","32.73"
"67","000","00","350","0044","0709","544","329","215","25","569","1026","0","55.46","32.07"
"67","000","00","350","0044","0710","609","367","242","23","632","1020","0","61.96","35.98"
"67","000","00","350","0044","0711","454","269","185","30","484","908","0","53.30","29.63"
"67","000","00","350","0044","0712","545","306","239","31","576","929","0","62.00","32.94"
"67","000","00","350","0045","0000","2291","1408","883","113","2404","4293","0","56.00","32.80"
"67","000","00","350","0045","0713","540","357","183","29","569","1096","0","51.92","32.57"
"67","000","00","350","0045","0714","597","370","227","25","622","1046","0","59.46","35.37"
"67","000","00","350","0045","0715","632","381","251","26","658","1196","0","55.02","31.86"
"67","000","00","350","0045","0716","522","300","222","33","555","955","0","58.12","31.41"
"67","000","00","350","0046","0000","2077","1248","829","114","2191","4182","0","52.39","29.84"
"67","000","00","350","0046","0771","586","369","217","33","619","1142","0","54.20","32.31"
"67","000","00","350","0046","0772","472","270","202","19","491","1012","0","48.52","26.68"
"67","000","00","350","0046","0773","538","321","217","25","563","956","0","58.89","33.58"
"67","000","00","350","0046","0774","481","288","193","37","518","1072","0","48.32","26.87"
"67","000","00","350","0047","0000","1595","959","636","126","1721","3210","0","53.61","29.88"
"67","000","00","350","0047","0759","477","268","209","26","503","956","0","52.62","28.03"
"67","000","00","350","0047","0760","561","334","227","53","614","1164","0","52.75","28.69"
"67","000","00","350","0047","0761","557","357","200","47","604","1090","0","55.41","32.75"
"67","000","00","350","0048","0000","891","519","372","74","965","1574","0","61.31","32.97"
"67","000","00","350","0048","0731","891","519","372","74","965","1574","0","61.31","32.97"
"67","000","00","350","0049","0000","2085","1297","788","69","2154","3921","0","54.93","33.08"
"67","000","00","350","0049","0768","603","372","231","36","639","1024","0","62.40","36.33"
"67","000","00","350","0049","0769","851","544","307","32","883","1847","0","47.81","29.45"
"67","000","00","350","0049","0770","631","381","250","1","632","1050","0","60.19","36.29"
"67","000","00","350","0050","0000","2905","1771","1134","152","3057","5245","0","58.28","33.77"
"67","000","00","350","0050","0775","490","318","172","34","524","967","0","54.19","32.89"
"67","000","00","350","0050","0776","563","336","227","24","587","909","0","64.58","36.96"
"67","000","00","350","0050","0777","632","396","236","27","659","1193","0","55.24","33.19"
"67","000","00","350","0050","0778","638","371","267","31","669","1095","0","61.10","33.88"
"67","000","00","350","0050","0779","582","350","232","36","618","1081","0","57.17","32.38"
"67","000","00","350","0051","0000","1940","1212","728","78","2018","3509","0","57.51","34.54"
"67","000","00","350","0051","0721","612","368","244","30","642","1053","0","60.97","34.95"
"67","000","00","350","0051","0722","627","391","236","21","648","1168","0","55.48","33.48"
"67","000","00","350","0051","0723","701","453","248","27","728","1288","0","56.52","35.17"
"67","000","00","350","0052","0000","718","452","266","70","788","1411","0","55.85","32.03"
"67","000","00","350","0052","0797","718","452","266","70","788","1411","0","55.85","32.03"
"67","000","00","360","0000","0000","27782","15905","11877","1092","28874","56149","67775","51.42","28.33"
"67","000","00","360","0002","0000","1125","645","480","61","1186","1979","0","59.93","32.59"
"67","000","00","360","0002","1161","441","244","197","37","478","858","0","55.71","28.44"
"67","000","00","360","0002","1162","684","401","283","24","708","1121","0","63.16","35.77"
"67","000","00","360","0004","0000","221","138","83","23","244","412","0","59.22","33.50"
"67","000","00","360","0004","1153","221","138","83","23","244","412","0","59.22","33.50"
"67","000","00","360","0005","0000","2536","1451","1085","66","2602","5031","0","51.72","28.84"
"67","000","00","360","0005","1123","551","321","230","19","570","1206","0","47.26","26.62"
"67","000","00","360","0005","1124","593","335","258","9","602","1131","0","53.23","29.62"
"67","000","00","360","0005","1125","716","420","296","22","738","1340","0","55.07","31.34"
"67","000","00","360","0005","1126","676","375","301","16","692","1354","0","51.11","27.70"
"67","000","00","360","0006","0000","2068","1131","937","73","2141","4116","0","52.02","27.48"
"67","000","00","360","0006","1127","696","368","328","22","718","1438","0","49.93","25.59"
"67","000","00","360","0006","1128","677","379","298","22","699","1345","0","51.97","28.18"
"67","000","00","360","0006","1129","695","384","311","29","724","1333","0","54.31","28.81"
"67","000","00","360","0007","0000","2394","1329","1065","75","2469","4743","0","52.06","28.02"
"67","000","00","360","0007","1130","608","326","282","21","629","1150","0","54.70","28.35"
"67","000","00","360","0007","1131","607","358","249","19","626","1288","0","48.60","27.80"
"67","000","00","360","0007","1132","586","334","252","18","604","1175","0","51.40","28.43"
"67","000","00","360","0007","1133","593","311","282","17","610","1130","0","53.98","27.52"
"67","000","00","360","0008","0000","3271","1862","1409","106","3377","7128","0","47.38","26.12"
"67","000","00","360","0008","1134","670","401","269","28","698","1492","0","46.78","26.88"
"67","000","00","360","0008","1135","660","384","276","22","682","1344","0","50.74","28.57"
"67","000","00","360","0008","1136","502","278","224","10","512","1408","0","36.36","19.74"
"67","000","00","360","0008","1137","674","411","263","30","704","1383","0","50.90","29.72"
"67","000","00","360","0008","1138","765","388","377","16","781","1501","0","52.03","25.85"
"67","000","00","360","0009","0000","2626","1464","1162","88","2714","5184","0","52.35","28.24"
"67","000","00","360","0009","1119","608","332","276","35","643","1106","0","58.14","30.02"
"67","000","00","360","0009","1120","701","401","300","6","707","1453","0","48.66","27.60"
"67","000","00","360","0009","1121","633","356","277","21","654","1279","0","51.13","27.83"
"67","000","00","360","0009","1122","684","375","309","26","710","1346","0","52.75","27.86"
"67","000","00","360","0010","0000","3744","2097","1647","108","3852","7806","0","49.35","26.86"
"67","000","00","360","0010","1147","741","417","324","22","763","1336","0","57.11","31.21"
"67","000","00","360","0010","1148","632","351","281","36","668","1183","0","56.47","29.67"
"67","000","00","360","0010","1149","623","327","296","9","632","1256","0","50.32","26.04"
"67","000","00","360","0010","1150","592","304","288","20","612","1244","0","49.20","24.44"
"67","000","00","360","0010","1151","595","353","242","12","607","1289","0","47.09","27.39"
"67","000","00","360","0010","1152","561","345","216","9","570","1498","0","38.05","23.03"
"67","000","00","360","0011","0000","3652","2074","1578","115","3767","7856","0","47.95","26.40"
"67","000","00","360","0011","1141","573","320","253","20","593","1350","0","43.93","23.70"
"67","000","00","360","0011","1142","565","295","270","21","586","1216","0","48.19","24.26"
"67","000","00","360","0011","1143","637","336","301","17","654","1306","0","50.08","25.73"
"67","000","00","360","0011","1144","571","326","245","24","595","1245","0","47.79","26.18"
"67","000","00","360","0011","1145","731","452","279","15","746","1483","0","50.30","30.48"
"67","000","00","360","0011","1146","575","345","230","18","593","1256","0","47.21","27.47"
"67","000","00","360","0012","0000","1525","911","614","55","1580","2958","0","53.41","30.80"
"67","000","00","360","0012","1139","764","445","319","28","792","1466","0","54.02","30.35"
"67","000","00","360","0012","1140","761","466","295","27","788","1492","0","52.82","31.23"
"67","000","00","360","0015","0000","1612","974","638","94","1706","3161","0","53.97","30.81"
"67","000","00","360","0015","1154","796","474","322","31","827","1600","0","51.69","29.63"
"67","000","00","360","0015","1155","816","500","316","63","879","1561","0","56.31","32.03"
"67","000","00","360","0016","0000","1628","1021","607","112","1740","3074","0","56.60","33.21"
"67","000","00","360","0016","1156","542","324","218","37","579","1067","0","54.26","30.37"
"67","000","00","360","0016","1157","512","318","194","23","535","1007","0","53.13","31.58"
"67","000","00","360","0016","1158","574","379","195","52","626","1000","0","62.60","37.90"
"67","000","00","360","0017","0000","1380","808","572","116","1496","2701","0","55.39","29.91"
"67","000","00","360","0017","1159","729","416","313","60","789","1353","0","58.31","30.75"
"67","000","00","360","0017","1160","651","392","259","56","707","1348","0","52.45","29.08"
"67","000","00","370","0000","0000","32966","19475","13491","1358","34324","62210","77021","55.17","31.31"
"67","000","00","370","0005","0000","1924","1174","750","69","1993","3508","0","56.81","33.47"
"67","000","00","370","0005","1060","614","383","231","21","635","1235","0","51.42","31.01"
"67","000","00","370","0005","1061","657","405","252","26","683","1147","0","59.55","35.31"
"67","000","00","370","0005","1062","653","386","267","22","675","1126","0","59.95","34.28"
"67","000","00","370","0007","0000","1354","761","593","49","1403","2902","0","48.35","26.22"
"67","000","00","370","0007","1063","514","295","219","22","536","1025","0","52.29","28.78"
"67","000","00","370","0007","1064","438","250","188","9","447","956","0","46.76","26.15"
"67","000","00","370","0007","1065","402","216","186","18","420","921","0","45.60","23.45"
"67","000","00","370","0009","0000","1182","662","520","40","1222","2596","0","47.07","25.50"
"67","000","00","370","0009","1066","596","355","241","18","614","1302","0","47.16","27.27"
"67","000","00","370","0009","1067","586","307","279","22","608","1294","0","46.99","23.72"
"67","000","00","370","0011","0000","1121","707","414","51","1172","2331","0","50.28","30.33"
"67","000","00","370","0011","1068","593","379","214","28","621","1207","0","51.45","31.40"
"67","000","00","370","0011","1069","528","328","200","23","551","1124","0","49.02","29.18"
"67","000","00","370","0016","0000","1221","701","520","52","1273","2451","0","51.94","28.60"
"67","000","00","370","0016","1070","606","346","260","30","636","1234","0","51.54","28.04"
"67","000","00","370","0016","1071","615","355","260","22","637","1217","0","52.34","29.17"
"67","000","00","370","0022","0000","1827","1110","717","74","1901","3101","0","61.30","35.79"
"67","000","00","370","0022","1072","411","254","157","14","425","717","0","59.27","35.43"
"67","000","00","370","0022","1073","520","321","199","29","549","885","0","62.03","36.27"
"67","000","00","370","0022","1074","437","260","177","15","452","733","0","61.66","35.47"
"67","000","00","370","0022","1075","459","275","184","16","475","766","0","62.01","35.90"
"67","000","00","370","0025","0000","1761","1067","694","76","1837","3410","0","53.87","31.29"
"67","000","00","370","0025","1076","486","303","183","21","507","992","0","51.11","30.54"
"67","000","00","370","0025","1077","590","356","234","30","620","1089","0","56.93","32.69"
"67","000","00","370","0025","1078","685","408","277","25","710","1329","0","53.42","30.70"
"67","000","00","370","0031","0000","1334","754","580","43","1377","2518","0","54.69","29.94"
"67","000","00","370","0031","1079","657","392","265","13","670","1314","0","50.99","29.83"
"67","000","00","370","0031","1080","677","362","315","30","707","1204","0","58.72","30.07"
"67","000","00","370","0033","0000","3067","1682","1385","101","3168","5514","0","57.45","30.50"
"67","000","00","370","0033","1081","619","346","273","14","633","1062","0","59.60","32.58"
"67","000","00","370","0033","1082","627","336","291","32","659","1053","0","62.58","31.91"
"67","000","00","370","0033","1083","560","316","244","19","579","1034","0","56.00","30.56"
"67","000","00","370","0033","1084","602","307","295","18","620","1136","0","54.58","27.02"
"67","000","00","370","0033","1085","659","377","282","18","677","1229","0","55.09","30.68"
"67","000","00","370","0034","0000","2770","1583","1187","82","2852","4731","0","60.28","33.46"
"67","000","00","370","0034","1086","732","405","327","19","751","1238","0","60.66","32.71"
"67","000","00","370","0034","1087","662","375","287","21","683","1165","0","58.63","32.19"
"67","000","00","370","0034","1088","714","435","279","31","745","1145","0","65.07","37.99"
"67","000","00","370","0034","1089","662","368","294","11","673","1183","0","56.89","31.11"
"67","000","00","370","0039","0000","1689","1061","628","65","1754","3536","0","49.60","30.01"
"67","000","00","370","0039","1090","385","228","157","14","399","842","0","47.39","27.08"
"67","000","00","370","0039","1091","397","262","135","15","412","829","0","49.70","31.60"
"67","000","00","370","0039","1092","478","293","185","21","499","1012","0","49.31","28.95"
"67","000","00","370","0039","1093","429","278","151","15","444","853","0","52.05","32.59"
"67","000","00","370","0040","0000","1520","930","590","43","1563","2988","0","52.31","31.12"
"67","000","00","370","0040","1094","549","339","210","18","567","1049","0","54.05","32.32"
"67","000","00","370","0040","1095","522","311","211","11","533","1039","0","51.30","29.93"
"67","000","00","370","0040","1096","449","280","169","14","463","900","0","51.44","31.11"
"67","000","00","370","0041","0000","1177","643","534","41","1218","2391","0","50.94","26.89"
"67","000","00","370","0041","1097","609","302","307","25","634","1225","0","51.76","24.65"
"67","000","00","370","0041","1098","568","341","227","16","584","1166","0","50.09","29.25"
"67","000","00","370","0042","0000","1524","903","621","63","1587","2922","0","54.31","30.90"
"67","000","00","370","0042","1099","506","297","209","19","525","1034","0","50.77","28.72"
"67","000","00","370","0042","1100","547","332","215","24","571","1032","0","55.33","32.17"
"67","000","00","370","0042","1101","471","274","197","20","491","856","0","57.36","32.01"
"67","000","00","370","0043","0000","1186","710","476","61","1247","1898","0","65.70","37.41"
"67","000","00","370","0043","1102","603","370","233","40","643","1015","0","63.35","36.45"
"67","000","00","370","0043","1103","583","340","243","21","604","883","0","68.40","38.51"
"67","000","00","370","0044","0000","1939","1194","745","110","2049","3657","0","56.03","32.65"
"67","000","00","370","0044","1104","598","342","256","29","627","1357","0","46.20","25.20"
"67","000","00","370","0044","1105","641","415","226","30","671","1127","0","59.54","36.82"
"67","000","00","370","0044","1106","700","437","263","51","751","1173","0","64.02","37.25"
"67","000","00","370","0045","0000","1179","710","469","40","1219","2362","0","51.61","30.06"
"67","000","00","370","0045","1107","648","410","238","18","666","1188","0","56.06","34.51"
"67","000","00","370","0045","1108","531","300","231","22","553","1174","0","47.10","25.55"
"67","000","00","370","0046","0000","1040","629","411","68","1108","1830","0","60.55","34.37"
"67","000","00","370","0046","1109","517","331","186","51","568","919","0","61.81","36.02"
"67","000","00","370","0046","1110","523","298","225","17","540","911","0","59.28","32.71"
"67","000","00","370","0047","0000","1924","1245","679","122","2046","3732","0","54.82","33.36"
"67","000","00","370","0047","1111","528","327","201","23","551","1036","0","53.19","31.56"
"67","000","00","370","0047","1112","415","275","140","24","439","781","0","56.21","35.21"
"67","000","00","370","0047","1113","486","304","182","31","517","1001","0","51.65","30.37"
"67","000","00","370","0047","1114","495","339","156","44","539","914","0","58.97","37.09"
"67","000","00","370","0048","0000","2227","1249","978","108","2335","3832","0","60.93","32.59"
"67","000","00","370","0048","1115","525","342","183","30","555","844","0","65.76","40.52"
"67","000","00","370","0048","1116","691","397","294","48","739","1158","0","63.82","34.28"
"67","000","00","370","0048","1117","554","253","301","20","574","952","0","60.29","26.58"
"67","000","00","370","0048","1118","457","257","200","10","467","878","0","53.19","29.27"
"64","000","00","000","0000","0000","1230092","717904","512188","71148","1301240","2286249","2723495","56.92","31.40"
"64","000","00","010","0000","0000","11556","7249","4307","618","12174","19930","22483","61.08","36.37"
"64","000","00","010","0001","0000","750","503","247","26","776","1201","0","64.61","41.88"
"64","000","00","010","0001","0945","750","503","247","26","776","1201","0","64.61","41.88"
"64","000","00","010","0002","0000","221","141","80","18","239","318","0","75.16","44.34"
"64","000","00","010","0002","0946","221","141","80","18","239","318","0","75.16","44.34"
"64","000","00","010","0003","0000","394","270","124","28","422","592","0","71.28","45.61"
"64","000","00","010","0003","0947","394","270","124","28","422","592","0","71.28","45.61"
"64","000","00","010","0004","0000","628","354","274","26","654","1209","0","54.09","29.28"
"64","000","00","010","0004","0948","628","354","274","26","654","1209","0","54.09","29.28"
"64","000","00","010","0005","0000","612","364","248","23","635","1214","0","52.31","29.98"
"64","000","00","010","0005","0949","612","364","248","23","635","1214","0","52.31","29.98"
"64","000","00","010","0006","0000","1138","673","465","56","1194","1820","0","65.60","36.98"
"64","000","00","010","0006","0950","491","285","206","25","516","786","0","65.65","36.26"
"64","000","00","010","0006","0951","647","388","259","31","678","1034","0","65.57","37.52"
"64","000","00","010","0007","0000","495","287","208","30","525","765","0","68.63","37.52"
"64","000","00","010","0007","0952","495","287","208","30","525","765","0","68.63","37.52"
"64","000","00","010","0008","0000","342","220","122","18","360","520","0","69.23","42.31"
"64","000","00","010","0008","0953","342","220","122","18","360","520","0","69.23","42.31"
"64","000","00","010","0009","0000","672","441","231","17","689","1395","0","49.39","31.61"
"64","000","00","010","0009","0954","672","441","231","17","689","1395","0","49.39","31.61"
"64","000","00","010","0010","0000","379","237","142","25","404","696","0","58.05","34.05"
"64","000","00","010","0010","0955","379","237","142","25","404","696","0","58.05","34.05"
"64","000","00","010","0011","0000","822","501","321","38","860","1477","0","58.23","33.92"
"64","000","00","010","0011","0956","406","236","170","28","434","745","0","58.26","31.68"
"64","000","00","010","0011","0957","416","265","151","10","426","732","0","58.20","36.20"
"64","000","00","010","0012","0000","529","348","181","28","557","713","0","78.12","48.81"
"64","000","00","010","0012","0958","529","348","181","28","557","713","0","78.12","48.81"
"64","000","00","010","0013","0000","471","304","167","26","497","882","0","56.35","34.47"
"64","000","00","010","0013","0959","471","304","167","26","497","882","0","56.35","34.47"
"64","000","00","010","0014","0000","608","383","225","41","649","1021","0","63.57","37.51"
"64","000","00","010","0014","0960","608","383","225","41","649","1021","0","63.57","37.51"
"64","000","00","010","0015","0000","542","327","215","33","575","965","0","59.59","33.89"
"64","000","00","010","0015","0961","542","327","215","33","575","965","0","59.59","33.89"
"64","000","00","010","0016","0000","426","260","166","16","442","725","0","60.97","35.86"
"64","000","00","010","0016","0962","426","260","166","16","442","725","0","60.97","35.86"
"64","000","00","010","0017","0000","961","617","344","66","1027","1821","0","56.40","33.88"
"64","000","00","010","0017","0963","510","319","191","42","552","899","0","61.40","35.48"
"64","000","00","010","0017","0964","451","298","153","24","475","922","0","51.52","32.32"
"64","000","00","010","0018","0000","636","398","238","41","677","1045","0","64.78","38.09"
"64","000","00","010","0018","0965","636","398","238","41","677","1045","0","64.78","38.09"
"64","000","00","010","0019","0000","336","220","116","24","360","503","0","71.57","43.74"
"64","000","00","010","0019","0966","336","220","116","24","360","503","0","71.57","43.74"
"64","000","00","010","0020","0000","317","191","126","24","341","528","0","64.58","36.17"
"64","000","00","010","0020","0967","317","191","126","24","341","528","0","64.58","36.17"
"64","000","00","010","0021","0000","277","210","67","14","291","520","0","55.96","40.38"
"64","000","00","010","0021","0968","277","210","67","14","291","520","0","55.96","40.38"
"64","000","00","020","0000","0000","58438","33128","25310","2640","61078","111997","139041","54.54","29.58"
"64","000","00","020","0001","0000","935","507","428","68","1003","1841","0","54.48","27.54"
"64","000","00","020","0001","0862","462","241","221","39","501","923","0","54.28","26.11"
"64","000","00","020","0001","0863","473","266","207","29","502","918","0","54.68","28.98"
"64","000","00","020","0002","0000","967","393","574","59","1026","1834","0","55.94","21.43"
"64","000","00","020","0002","0864","425","153","272","29","454","832","0","54.57","18.39"
"64","000","00","020","0002","0865","542","240","302","30","572","1002","0","57.09","23.95"
"64","000","00","020","0003","0000","2019","1037","982","121","2140","3820","0","56.02","27.15"
"64","000","00","020","0003","0866","729","427","302","54","783","1374","0","56.99","31.08"
"64","000","00","020","0003","0867","698","342","356","36","734","1294","0","56.72","26.43"
"64","000","00","020","0003","0868","592","268","324","31","623","1152","0","54.08","23.26"
"64","000","00","020","0004","0000","1837","1184","653","96","1933","3204","0","60.33","36.95"
"64","000","00","020","0004","0869","555","383","172","31","586","963","0","60.85","39.77"
"64","000","00","020","0004","0870","634","400","234","35","669","1149","0","58.22","34.81"
"64","000","00","020","0004","0871","648","401","247","30","678","1092","0","62.09","36.72"
"64","000","00","020","0005","0000","775","464","311","39","814","1233","0","66.02","37.63"
"64","000","00","020","0005","0872","775","464","311","39","814","1233","0","66.02","37.63"
"64","000","00","020","0006","0000","524","359","165","32","556","1013","0","54.89","35.44"
"64","000","00","020","0006","0873","524","359","165","32","556","1013","0","54.89","35.44"
"64","000","00","020","0007","0000","1421","821","600","84","1505","2332","0","64.54","35.21"
"64","000","00","020","0007","0874","707","413","294","48","755","1142","0","66.11","36.16"
"64","000","00","020","0007","0875","714","408","306","36","750","1190","0","63.03","34.29"
"64","000","00","020","0008","0000","1780","1012","768","124","1904","3512","0","54.21","28.82"
"64","000","00","020","0008","0876","578","325","253","46","624","1196","0","52.17","27.17"
"64","000","00","020","0008","0877","578","335","243","39","617","1142","0","54.03","29.33"
"64","000","00","020","0008","0878","624","352","272","39","663","1174","0","56.47","29.98"
"64","000","00","020","0009","0000","379","74","305","13","392","648","0","60.49","11.42"
"64","000","00","020","0009","0879","379","74","305","13","392","648","0","60.49","11.42"
"64","000","00","020","0010","0000","712","411","301","58","770","1153","0","66.78","35.65"
"64","000","00","020","0010","0880","712","411","301","58","770","1153","0","66.78","35.65"
"64","000","00","020","0011","0000","870","546","324","62","932","1855","0","50.24","29.43"
"64","000","00","020","0011","0881","870","546","324","62","932","1855","0","50.24","29.43"
"64","000","00","020","0012","0000","1723","1106","617","108","1831","3228","0","56.72","34.26"
"64","000","00","020","0012","0882","882","563","319","55","937","1627","0","57.59","34.60"
"64","000","00","020","0012","0883","841","543","298","53","894","1601","0","55.84","33.92"
"64","000","00","020","0013","0000","1398","916","482","87","1485","2455","0","60.49","37.31"
"64","000","00","020","0013","0884","726","506","220","46","772","1201","0","64.28","42.13"
"64","000","00","020","0013","0885","672","410","262","41","713","1254","0","56.86","32.70"
"64","000","00","020","0014","0000","1705","1085","620","100","1805","2853","0","63.27","38.03"
"64","000","00","020","0014","0886","740","452","288","34","774","1216","0","63.65","37.17"
"64","000","00","020","0014","0887","965","633","332","66","1031","1637","0","62.98","38.67"
"64","000","00","020","0015","0000","7284","4120","3164","219","7503","14932","0","50.25","27.59"
"64","000","00","020","0015","0888","743","391","352","20","763","1356","0","56.27","28.83"
"64","000","00","020","0015","0889","704","440","264","32","736","1414","0","52.05","31.12"
"64","000","00","020","0015","0890","807","465","342","35","842","1543","0","54.57","30.14"
"64","000","00","020","0015","0891","763","416","347","10","773","1523","0","50.76","27.31"
"64","000","00","020","0015","0892","689","379","310","15","704","1486","0","47.38","25.50"
"64","000","00","020","0015","0893","670","348","322","22","692","1588","0","43.58","21.91"
"64","000","00","020","0015","0894","755","425","330","27","782","1570","0","49.81","27.07"
"64","000","00","020","0015","0895","779","448","331","18","797","1474","0","54.07","30.39"
"64","000","00","020","0015","0896","755","446","309","21","776","1543","0","50.29","28.90"
"64","000","00","020","0015","0897","619","362","257","19","638","1435","0","44.46","25.23"
"64","000","00","020","0016","0000","11405","6313","5092","255","11660","22704","0","51.36","27.81"
"64","000","00","020","0016","0898","756","439","317","19","775","1541","0","50.29","28.49"
"64","000","00","020","0016","0899","896","500","396","16","912","1862","0","48.98","26.85"
"64","000","00","020","0016","0900","986","545","441","32","1018","2018","0","50.45","27.01"
"64","000","00","020","0016","0901","790","418","372","11","801","1588","0","50.44","26.32"
"64","000","00","020","0016","0902","924","517","407","18","942","1896","0","49.68","27.27"
"64","000","00","020","0016","0903","1022","583","439","21","1043","2063","0","50.56","28.26"
"64","000","00","020","0016","0904","848","481","367","18","866","1678","0","51.61","28.67"
"64","000","00","020","0016","0905","865","424","441","25","890","1640","0","54.27","25.85"
"64","000","00","020","0016","0906","895","504","391","25","920","1730","0","53.18","29.13"
"64","000","00","020","0016","0907","933","564","369","20","953","1858","0","51.29","30.36"
"64","000","00","020","0016","0908","870","466","404","17","887","1656","0","53.56","28.14"
"64","000","00","020","0016","0909","798","444","354","21","819","1588","0","51.57","27.96"
"64","000","00","020","0016","0910","822","428","394","12","834","1586","0","52.59","26.99"
"64","000","00","020","0017","0000","7368","3813","3555","198","7566","15648","0","48.35","24.37"
"64","000","00","020","0017","0911","790","432","358","19","809","1615","0","50.09","26.75"
"64","000","00","020","0017","0912","715","367","348","15","730","1528","0","47.77","24.02"
"64","000","00","020","0017","0913","761","389","372","14","775","1707","0","45.40","22.79"
"64","000","00","020","0017","0914","756","420","336","23","779","1607","0","48.48","26.14"
"64","000","00","020","0017","0915","686","350","336","13","699","1583","0","44.16","22.11"
"64","000","00","020","0017","0916","733","405","328","28","761","1450","0","52.48","27.93"
"64","000","00","020","0017","0917","729","396","333","21","750","1537","0","48.80","25.76"
"64","000","00","020","0017","0918","717","366","351","21","738","1503","0","49.10","24.35"
"64","000","00","020","0017","0919","801","369","432","26","827","1618","0","51.11","22.81"
"64","000","00","020","0017","0920","680","319","361","18","698","1500","0","46.53","21.27"
"64","000","00","020","0018","0000","2050","1072","978","72","2122","3656","0","58.04","29.32"
"64","000","00","020","0018","0921","976","490","486","30","1006","1755","0","57.32","27.92"
"64","000","00","020","0018","0922","1074","582","492","42","1116","1901","0","58.71","30.62"
"64","000","00","020","0019","0000","1772","916","856","95","1867","3066","0","60.89","29.88"
"64","000","00","020","0019","0923","870","416","454","54","924","1540","0","60.00","27.01"
"64","000","00","020","0019","0924","902","500","402","41","943","1526","0","61.80","32.77"
"64","000","00","020","0020","0000","1295","565","730","45","1340","2360","0","56.78","23.94"
"64","000","00","020","0020","0925","577","266","311","29","606","1066","0","56.85","24.95"
"64","000","00","020","0020","0926","718","299","419","16","734","1294","0","56.72","23.11"
"64","000","00","020","0021","0000","512","337","175","40","552","1101","0","50.14","30.61"
"64","000","00","020","0021","0927","512","337","175","40","552","1101","0","50.14","30.61"
"64","000","00","020","0022","0000","624","417","207","38","662","1069","0","61.93","39.01"
"64","000","00","020","0022","0928","624","417","207","38","662","1069","0","61.93","39.01"
"64","000","00","020","0023","0000","561","362","199","35","596","1875","0","31.79","19.31"
"64","000","00","020","0023","0929","561","362","199","35","596","1875","0","31.79","19.31"
"64","000","00","020","0024","0000","671","408","263","39","710","1212","0","58.58","33.66"
"64","000","00","020","0024","0930","671","408","263","39","710","1212","0","58.58","33.66"
"64","000","00","020","0025","0000","675","406","269","31","706","1166","0","60.55","34.82"
"64","000","00","020","0025","0931","675","406","269","31","706","1166","0","60.55","34.82"
"64","000","00","020","0026","0000","718","395","323","58","776","1230","0","63.09","32.11"
"64","000","00","020","0026","0932","718","395","323","58","776","1230","0","63.09","32.11"
"64","000","00","020","0027","0000","649","384","265","44","693","1051","0","65.94","36.54"
"64","000","00","020","0027","0933","649","384","265","44","693","1051","0","65.94","36.54"
"64","000","00","020","0028","0000","883","531","352","34","917","1318","0","69.58","40.29"
"64","000","00","020","0028","0934","883","531","352","34","917","1318","0","69.58","40.29"
"64","000","00","020","0029","0000","351","221","130","21","372","584","0","63.70","37.84"
"64","000","00","020","0029","0935","351","221","130","21","372","584","0","63.70","37.84"
"64","000","00","020","0030","0000","417","281","136","33","450","733","0","61.39","38.34"
"64","000","00","020","0030","0936","417","281","136","33","450","733","0","61.39","38.34"
"64","000","00","020","0031","0000","459","298","161","25","484","868","0","55.76","34.33"
"64","000","00","020","0031","0937","459","298","161","25","484","868","0","55.76","34.33"
"64","000","00","020","0032","0000","597","394","203","61","658","914","0","71.99","43.11"
"64","000","00","020","0032","0938","597","394","203","61","658","914","0","71.99","43.11"
"64","000","00","020","0033","0000","449","311","138","20","469","688","0","68.17","45.20"
"64","000","00","020","0033","0939","449","311","138","20","469","688","0","68.17","45.20"
"64","000","00","020","0034","0000","586","378","208","54","640","1134","0","56.44","33.33"
"64","000","00","020","0034","0940","586","378","208","54","640","1134","0","56.44","33.33"
"64","000","00","020","0035","0000","537","350","187","34","571","1041","0","54.85","33.62"
"64","000","00","020","0035","0941","537","350","187","34","571","1041","0","54.85","33.62"
"64","000","00","020","0036","0000","605","417","188","52","657","1252","0","52.48","33.31"
"64","000","00","020","0036","0942","605","417","188","52","657","1252","0","52.48","33.31"
"64","000","00","020","0037","0000","566","319","247","52","618","904","0","68.36","35.29"
"64","000","00","020","0037","0943","566","319","247","52","618","904","0","68.36","35.29"
"64","000","00","020","0038","0000","359","205","154","34","393","510","0","77.06","40.20"
"64","000","00","020","0038","0944","359","205","154","34","393","510","0","77.06","40.20"
"64","000","00","030","0000","0000","80432","42738","37694","2969","83401","159056","194669","52.43","26.87"
"64","000","00","030","0001","0000","813","455","358","62","875","2524","0","34.67","18.03"
"64","000","00","030","0001","0590","287","157","130","18","305","1605","0","19.00","9.78"
"64","000","00","030","0001","0591","526","298","228","44","570","919","0","62.02","32.43"
"64","000","00","030","0002","0000","497","330","167","46","543","923","0","58.83","35.75"
"64","000","00","030","0002","0592","497","330","167","46","543","923","0","58.83","35.75"
"64","000","00","030","0003","0000","348","218","130","24","372","498","0","74.70","43.78"
"64","000","00","030","0003","0593","348","218","130","24","372","498","0","74.70","43.78"
"64","000","00","030","0004","0000","352","247","105","23","375","576","0","65.10","42.88"
"64","000","00","030","0004","0594","352","247","105","23","375","576","0","65.10","42.88"
"64","000","00","030","0005","0000","251","184","67","4","255","477","0","53.46","38.57"
"64","000","00","030","0005","0595","251","184","67","4","255","477","0","53.46","38.57"
"64","000","00","030","0006","0000","477","338","139","25","502","761","0","65.97","44.42"
"64","000","00","030","0006","0596","477","338","139","25","502","761","0","65.97","44.42"
"64","000","00","030","0007","0000","498","350","148","38","536","798","0","67.17","43.86"
"64","000","00","030","0007","0597","498","350","148","38","536","798","0","67.17","43.86"
"64","000","00","030","0008","0000","381","273","108","23","404","683","0","59.15","39.97"
"64","000","00","030","0008","0598","381","273","108","23","404","683","0","59.15","39.97"
"64","000","00","030","0009","0000","1702","1021","681","109","1811","3112","0","58.19","32.81"
"64","000","00","030","0009","0599","818","497","321","58","876","1429","0","61.30","34.78"
"64","000","00","030","0009","0600","884","524","360","51","935","1683","0","55.56","31.13"
"64","000","00","030","0011","0000","736","298","438","41","777","1460","0","53.22","20.41"
"64","000","00","030","0011","0601","736","298","438","41","777","1460","0","53.22","20.41"
"64","000","00","030","0012","0000","233","96","137","7","240","336","0","71.43","28.57"
"64","000","00","030","0012","0602","233","96","137","7","240","336","0","71.43","28.57"
"64","000","00","030","0013","0000","227","88","139","8","235","525","0","44.76","16.76"
"64","000","00","030","0013","0603","227","88","139","8","235","525","0","44.76","16.76"
"64","000","00","030","0015","0000","827","349","478","62","889","1629","0","54.57","21.42"
"64","000","00","030","0015","0604","827","349","478","62","889","1629","0","54.57","21.42"
"64","000","00","030","0016","0000","1267","616","651","44","1311","2310","0","56.75","26.67"
"64","000","00","030","0016","0605","629","306","323","29","658","1141","0","57.67","26.82"
"64","000","00","030","0016","0606","638","310","328","15","653","1169","0","55.86","26.52"
"64","000","00","030","0017","0000","1357","331","1026","63","1420","2393","0","59.34","13.83"
"64","000","00","030","0017","0607","694","163","531","35","729","1194","0","61.06","13.65"
"64","000","00","030","0017","0608","663","168","495","28","691","1199","0","57.63","14.01"
"64","000","00","030","0019","0000","380","158","222","9","389","738","0","52.71","21.41"
"64","000","00","030","0019","0609","380","158","222","9","389","738","0","52.71","21.41"
"64","000","00","030","0021","0000","535","385","150","39","574","878","0","65.38","43.85"
"64","000","00","030","0021","0610","535","385","150","39","574","878","0","65.38","43.85"
"64","000","00","030","0022","0000","399","270","129","21","420","687","0","61.14","39.30"
"64","000","00","030","0022","0611","399","270","129","21","420","687","0","61.14","39.30"
"64","000","00","030","0023","0000","194","120","74","11","205","302","0","67.88","39.74"
"64","000","00","030","0023","0612","194","120","74","11","205","302","0","67.88","39.74"
"64","000","00","030","0024","0000","314","199","115","18","332","493","0","67.34","40.37"
"64","000","00","030","0024","0613","314","199","115","18","332","493","0","67.34","40.37"
"64","000","00","030","0025","0000","255","177","78","11","266","459","0","57.95","38.56"
"64","000","00","030","0025","0614","255","177","78","11","266","459","0","57.95","38.56"
"64","000","00","030","0026","0000","386","267","119","13","399","642","0","62.15","41.59"
"64","000","00","030","0026","0615","386","267","119","13","399","642","0","62.15","41.59"
"64","000","00","030","0027","0000","240","167","73","19","259","374","0","69.25","44.65"
"64","000","00","030","0027","0616","240","167","73","19","259","374","0","69.25","44.65"
"64","000","00","030","0028","0000","289","193","96","6","295","534","0","55.24","36.14"
"64","000","00","030","0028","0617","289","193","96","6","295","534","0","55.24","36.14"
"64","000","00","030","0029","0000","452","290","162","25","477","794","0","60.08","36.52"
"64","000","00","030","0029","0618","452","290","162","25","477","794","0","60.08","36.52"
"64","000","00","030","0030","0000","665","295","370","98","763","1205","0","63.32","24.48"
"64","000","00","030","0030","0619","665","295","370","98","763","1205","0","63.32","24.48"
"64","000","00","030","0031","0000","566","329","237","42","608","876","0","69.41","37.56"
"64","000","00","030","0031","0620","566","329","237","42","608","876","0","69.41","37.56"
"64","000","00","030","0032","0000","2862","966","1896","187","3049","5362","0","56.86","18.02"
"64","000","00","030","0032","0621","721","253","468","57","778","1360","0","57.21","18.60"
"64","000","00","030","0032","0622","595","201","394","46","641","1176","0","54.51","17.09"
"64","000","00","030","0032","0623","408","162","246","27","435","761","0","57.16","21.29"
"64","000","00","030","0032","0624","520","171","349","23","543","911","0","59.60","18.77"
"64","000","00","030","0032","0625","618","179","439","34","652","1154","0","56.50","15.51"
"64","000","00","030","0034","0000","1632","746","886","35","1667","3070","0","54.30","24.30"
"64","000","00","030","0034","0626","876","388","488","12","888","1552","0","57.22","25.00"
"64","000","00","030","0034","0627","756","358","398","23","779","1518","0","51.32","23.58"
"64","000","00","030","0035","0000","733","364","369","13","746","1574","0","47.40","23.13"
"64","000","00","030","0035","0628","733","364","369","13","746","1574","0","47.40","23.13"
"64","000","00","030","0036","0000","1370","445","925","74","1444","2533","0","57.01","17.57"
"64","000","00","030","0036","0629","764","201","563","52","816","1365","0","59.78","14.73"
"64","000","00","030","0036","0630","606","244","362","22","628","1168","0","53.77","20.89"
"64","000","00","030","0037","0000","775","244","531","55","830","1361","0","60.98","17.93"
"64","000","00","030","0037","0631","775","244","531","55","830","1361","0","60.98","17.93"
"64","000","00","030","0038","0000","697","233","464","50","747","1453","0","51.41","16.04"
"64","000","00","030","0038","0632","697","233","464","50","747","1453","0","51.41","16.04"
"64","000","00","030","0039","0000","6609","3476","3133","266","6875","13271","0","51.80","26.19"
"64","000","00","030","0039","0633","723","366","357","49","772","1417","0","54.48","25.83"
"64","000","00","030","0039","0634","770","422","348","27","797","1435","0","55.54","29.41"
"64","000","00","030","0039","0635","689","371","318","14","703","1390","0","50.58","26.69"
"64","000","00","030","0039","0636","726","389","337","26","752","1512","0","49.74","25.73"
"64","000","00","030","0039","0637","706","345","361","26","732","1437","0","50.94","24.01"
"64","000","00","030","0039","0638","714","365","349","17","731","1510","0","48.41","24.17"
"64","000","00","030","0039","0639","789","451","338","51","840","1501","0","55.96","30.05"
"64","000","00","030","0039","0640","704","354","350","22","726","1479","0","49.09","23.94"
"64","000","00","030","0039","0641","788","413","375","34","822","1590","0","51.70","25.97"
"64","000","00","030","0040","0000","12083","6846","5237","323","12406","24187","0","51.29","28.30"
"64","000","00","030","0040","0642","828","484","344","37","865","1479","0","58.49","32.72"
"64","000","00","030","0040","0643","832","548","284","33","865","1524","0","56.76","35.96"
"64","000","00","030","0040","0644","831","516","315","39","870","1492","0","58.31","34.58"
"64","000","00","030","0040","0645","760","445","315","20","780","1444","0","54.02","30.82"
"64","000","00","030","0040","0646","726","364","362","12","738","1600","0","46.13","22.75"
"64","000","00","030","0040","0647","739","393","346","13","752","1490","0","50.47","26.38"
"64","000","00","030","0040","0648","714","423","291","3","717","1538","0","46.62","27.50"
"64","000","00","030","0040","0649","747","434","313","13","760","1572","0","48.35","27.61"
"64","000","00","030","0040","0650","777","402","375","13","790","1491","0","52.98","26.96"
"64","000","00","030","0040","0651","785","435","350","27","812","1553","0","52.29","28.01"
"64","000","00","030","0040","0652","735","395","340","17","752","1527","0","49.25","25.87"
"64","000","00","030","0040","0653","690","399","291","16","706","1496","0","47.19","26.67"
"64","000","00","030","0040","0654","766","448","318","21","787","1557","0","50.55","28.77"
"64","000","00","030","0040","0655","712","390","322","25","737","1494","0","49.33","26.10"
"64","000","00","030","0040","0656","720","363","357","15","735","1454","0","50.55","24.97"
"64","000","00","030","0040","0657","721","407","314","19","740","1476","0","50.14","27.57"
"64","000","00","030","0041","0000","2421","1585","836","116","2537","4533","0","55.97","34.97"
"64","000","00","030","0041","0658","847","527","320","32","879","1581","0","55.60","33.33"
"64","000","00","030","0041","0659","787","550","237","43","830","1410","0","58.87","39.01"
"64","000","00","030","0041","0660","787","508","279","41","828","1542","0","53.70","32.94"
"64","000","00","030","0042","0000","6549","3581","2968","200","6749","12965","0","52.06","27.62"
"64","000","00","030","0042","0661","782","464","318","27","809","1423","0","56.85","32.61"
"64","000","00","030","0042","0662","780","418","362","27","807","1517","0","53.20","27.55"
"64","000","00","030","0042","0663","652","362","290","17","669","1383","0","48.37","26.17"
"64","000","00","030","0042","0664","716","407","309","32","748","1453","0","51.48","28.01"
"64","000","00","030","0042","0665","720","389","331","20","740","1375","0","53.82","28.29"
"64","000","00","030","0042","0666","775","433","342","20","795","1510","0","52.65","28.68"
"64","000","00","030","0042","0667","712","372","340","21","733","1413","0","51.88","26.33"
"64","000","00","030","0042","0668","698","384","314","13","711","1433","0","49.62","26.80"
"64","000","00","030","0042","0669","714","352","362","23","737","1458","0","50.55","24.14"
"64","000","00","030","0043","0000","13491","7376","6115","370","13861","27428","0","50.54","26.89"
"64","000","00","030","0043","0670","754","393","361","30","784","1485","0","52.79","26.46"
"64","000","00","030","0043","0671","708","433","275","28","736","1437","0","51.22","30.13"
"64","000","00","030","0043","0672","808","444","364","23","831","1522","0","54.60","29.17"
"64","000","00","030","0043","0673","728","435","293","23","751","1398","0","53.72","31.12"
"64","000","00","030","0043","0674","646","373","273","21","667","1410","0","47.30","26.45"
"64","000","00","030","0043","0675","767","388","379","18","785","1592","0","49.31","24.37"
"64","000","00","030","0043","0676","741","412","329","17","758","1541","0","49.19","26.74"
"64","000","00","030","0043","0677","672","365","307","21","693","1451","0","47.76","25.16"
"64","000","00","030","0043","0678","733","453","280","15","748","1473","0","50.78","30.75"
"64","000","00","030","0043","0679","751","398","353","28","779","1478","0","52.71","26.93"
"64","000","00","030","0043","0680","688","376","312","19","707","1373","0","51.49","27.39"
"64","000","00","030","0043","0681","794","412","382","15","809","1607","0","50.34","25.64"
"64","000","00","030","0043","0682","832","453","379","16","848","1722","0","49.25","26.31"
"64","000","00","030","0043","0683","787","410","377","16","803","1581","0","50.79","25.93"
"64","000","00","030","0043","0684","782","445","337","26","808","1664","0","48.56","26.74"
"64","000","00","030","0043","0685","788","417","371","13","801","1682","0","47.62","24.79"
"64","000","00","030","0043","0686","758","416","342","21","779","1478","0","52.71","28.15"
"64","000","00","030","0043","0687","754","353","401","20","774","1534","0","50.46","23.01"
"64","000","00","030","0044","0000","16569","8832","7737","389","16958","34332","0","49.39","25.73"
"64","000","00","030","0044","0688","725","363","362","9","734","1447","0","50.73","25.09"
"64","000","00","030","0044","0689","732","395","337","13","745","1557","0","47.85","25.37"
"64","000","00","030","0044","0690","706","346","360","17","723","1556","0","46.47","22.24"
"64","000","00","030","0044","0691","693","399","294","19","712","1463","0","48.67","27.27"
"64","000","00","030","0044","0692","762","381","381","25","787","1566","0","50.26","24.33"
"64","000","00","030","0044","0693","810","428","382","14","824","1598","0","51.56","26.78"
"64","000","00","030","0044","0694","739","422","317","19","758","1556","0","48.71","27.12"
"64","000","00","030","0044","0695","756","376","380","14","770","1561","0","49.33","24.09"
"64","000","00","030","0044","0696","712","382","330","13","725","1434","0","50.56","26.64"
"64","000","00","030","0044","0697","805","472","333","20","825","1641","0","50.27","28.76"
"64","000","00","030","0044","0698","759","414","345","12","771","1513","0","50.96","27.36"
"64","000","00","030","0044","0699","713","400","313","22","735","1582","0","46.46","25.28"
"64","000","00","030","0044","0700","671","304","367","14","685","1477","0","46.38","20.58"
"64","000","00","030","0044","0701","795","438","357","23","818","1657","0","49.37","26.43"
"64","000","00","030","0044","0702","796","448","348","9","805","1712","0","47.02","26.17"
"64","000","00","030","0044","0703","846","468","378","21","867","1764","0","49.15","26.53"
"64","000","00","030","0044","0704","798","407","391","24","822","1624","0","50.62","25.06"
"64","000","00","030","0044","0705","766","434","332","22","788","1553","0","50.74","27.95"
"64","000","00","030","0044","0706","653","348","305","19","672","1384","0","48.55","25.14"
"64","000","00","030","0044","0707","796","472","324","17","813","1563","0","52.02","30.20"
"64","000","00","030","0044","0708","834","376","458","25","859","1693","0","50.74","22.21"
"64","000","00","030","0044","0709","702","359","343","18","720","1431","0","50.31","25.09"
"64","000","00","040","0000","0000","81813","46211","35602","3641","85454","154554","190823","55.29","29.90"
"64","000","00","040","0001","0000","11299","6562","4737","373","11672","21317","0","54.75","30.78"
"64","000","00","040","0001","0462","612","362","250","13","625","1011","0","61.82","35.81"
"64","000","00","040","0001","0463","574","369","205","32","606","998","0","60.72","36.97"
"64","000","00","040","0001","0464","687","408","279","34","721","1171","0","61.57","34.84"
"64","000","00","040","0001","0465","595","362","233","7","602","1266","0","47.55","28.59"
"64","000","00","040","0001","0466","715","443","272","26","741","1242","0","59.66","35.67"
"64","000","00","040","0001","0467","777","399","378","19","796","1319","0","60.35","30.25"
"64","000","00","040","0001","0468","802","457","345","37","839","1539","0","54.52","29.69"
"64","000","00","040","0001","0469","605","360","245","12","617","1202","0","51.33","29.95"
"64","000","00","040","0001","0470","718","348","370","26","744","1425","0","52.21","24.42"
"64","000","00","040","0001","0471","712","398","314","19","731","1440","0","50.76","27.64"
"64","000","00","040","0001","0472","664","380","284","33","697","1273","0","54.75","29.85"
"64","000","00","040","0001","0473","741","449","292","32","773","1234","0","62.64","36.39"
"64","000","00","040","0001","0474","972","570","402","43","1015","1901","0","53.39","29.98"
"64","000","00","040","0001","0475","649","363","286","15","664","1345","0","49.37","26.99"
"64","000","00","040","0001","0476","735","438","297","12","747","1404","0","53.21","31.20"
"64","000","00","040","0001","0477","741","456","285","13","754","1547","0","48.74","29.48"
"64","000","00","040","0002","0000","2196","1283","913","66","2262","4438","0","50.97","28.91"
"64","000","00","040","0002","0478","681","412","269","28","709","1425","0","49.75","28.91"
"64","000","00","040","0002","0479","764","424","340","18","782","1546","0","50.58","27.43"
"64","000","00","040","0002","0480","751","447","304","20","771","1467","0","52.56","30.47"
"64","000","00","040","0003","0000","2896","1835","1061","111","3007","6234","0","48.24","29.44"
"64","000","00","040","0003","0481","646","456","190","35","681","1345","0","50.63","33.90"
"64","000","00","040","0003","0482","588","373","215","19","607","1198","0","50.67","31.14"
"64","000","00","040","0003","0483","563","325","238","21","584","1246","0","46.87","26.08"
"64","000","00","040","0003","0484","590","348","242","19","609","1286","0","47.36","27.06"
"64","000","00","040","0003","0485","509","333","176","17","526","1159","0","45.38","28.73"
"64","000","00","040","0004","0000","1428","880","548","70","1498","3031","0","49.42","29.03"
"64","000","00","040","0004","0486","500","323","177","31","531","989","0","53.69","32.66"
"64","000","00","040","0004","0487","473","284","189","15","488","1027","0","47.52","27.65"
"64","000","00","040","0004","0488","455","273","182","24","479","1015","0","47.19","26.90"
"64","000","00","040","0005","0000","1681","1092","589","78","1759","3148","0","55.88","34.69"
"64","000","00","040","0005","0492","844","548","296","41","885","1574","0","56.23","34.82"
"64","000","00","040","0005","0493","837","544","293","37","874","1574","0","55.53","34.56"
"64","000","00","040","0006","0000","1268","766","502","64","1332","3097","0","43.01","24.73"
"64","000","00","040","0006","0489","344","228","116","16","360","1187","0","30.33","19.21"
"64","000","00","040","0006","0490","469","273","196","25","494","947","0","52.16","28.83"
"64","000","00","040","0006","0491","455","265","190","23","478","963","0","49.64","27.52"
"64","000","00","040","0007","0000","2276","1271","1005","134","2410","3965","0","60.78","32.06"
"64","000","00","040","0007","0494","755","431","324","43","798","1238","0","64.46","34.81"
"64","000","00","040","0007","0495","835","451","384","43","878","1504","0","58.38","29.99"
"64","000","00","040","0007","0496","686","389","297","48","734","1223","0","60.02","31.81"
"64","000","00","040","0008","0000","2480","1298","1182","115","2595","4506","0","57.59","28.81"
"64","000","00","040","0008","0497","589","343","246","41","630","1091","0","57.75","31.44"
"64","000","00","040","0008","0498","596","294","302","31","627","1071","0","58.54","27.45"
"64","000","00","040","0008","0499","556","278","278","20","576","1100","0","52.36","25.27"
"64","000","00","040","0008","0500","739","383","356","23","762","1244","0","61.25","30.79"
"64","000","00","040","0009","0000","1645","1147","498","86","1731","2743","0","63.11","41.82"
"64","000","00","040","0009","0501","540","335","205","33","573","923","0","62.08","36.29"
"64","000","00","040","0009","0502","553","408","145","28","581","897","0","64.77","45.48"
"64","000","00","040","0009","0503","552","404","148","25","577","923","0","62.51","43.77"
"64","000","00","040","0010","0000","1289","893","396","68","1357","1992","0","68.12","44.83"
"64","000","00","040","0010","0504","552","398","154","19","571","890","0","64.16","44.72"
"64","000","00","040","0010","0505","737","495","242","49","786","1102","0","71.32","44.92"
"64","000","00","040","0011","0000","1987","1343","644","95","2082","3738","0","55.70","35.93"
"64","000","00","040","0011","0506","781","541","240","41","822","1343","0","61.21","40.28"
"64","000","00","040","0011","0507","740","518","222","45","785","1316","0","59.65","39.36"
"64","000","00","040","0011","0508","466","284","182","9","475","1079","0","44.02","26.32"
"64","000","00","040","0012","0000","950","692","258","57","1007","1480","0","68.04","46.76"
"64","000","00","040","0012","0509","950","692","258","57","1007","1480","0","68.04","46.76"
"64","000","00","040","0013","0000","1833","1147","686","112","1945","3343","0","58.18","34.31"
"64","000","00","040","0013","0510","541","361","180","37","578","978","0","59.10","36.91"
"64","000","00","040","0013","0511","686","435","251","42","728","1206","0","60.36","36.07"
"64","000","00","040","0013","0512","606","351","255","33","639","1159","0","55.13","30.28"
"64","000","00","040","0014","0000","7581","3800","3781","218","7799","15739","0","49.55","24.14"
"64","000","00","040","0014","0513","711","384","327","16","727","1426","0","50.98","26.93"
"64","000","00","040","0014","0514","691","314","377","18","709","1464","0","48.43","21.45"
"64","000","00","040","0014","0515","671","321","350","19","690","1381","0","49.96","23.24"
"64","000","00","040","0014","0516","721","366","355","22","743","1422","0","52.25","25.74"
"64","000","00","040","0014","0517","652","340","312","27","679","1362","0","49.85","24.96"
"64","000","00","040","0014","0518","681","325","356","18","699","1326","0","52.71","24.51"
"64","000","00","040","0014","0519","670","351","319","21","691","1511","0","45.73","23.23"
"64","000","00","040","0014","0520","648","327","321","17","665","1364","0","48.75","23.97"
"64","000","00","040","0014","0521","630","324","306","22","652","1370","0","47.59","23.65"
"64","000","00","040","0014","0522","786","356","430","16","802","1672","0","47.97","21.29"
"64","000","00","040","0014","0523","720","392","328","22","742","1441","0","51.49","27.20"
"64","000","00","040","0015","0000","407","179","228","4","411","609","0","67.49","29.39"
"64","000","00","040","0015","0524","407","179","228","4","411","609","0","67.49","29.39"
"64","000","00","040","0016","0000","1178","649","529","69","1247","1943","0","64.18","33.40"
"64","000","00","040","0016","0525","586","328","258","35","621","960","0","64.69","34.17"
"64","000","00","040","0016","0526","592","321","271","34","626","983","0","63.68","32.66"
"64","000","00","040","0017","0000","1364","710","654","74","1438","2353","0","61.11","30.17"
"64","000","00","040","0017","0527","615","324","291","35","650","930","0","69.89","34.84"
"64","000","00","040","0017","0528","749","386","363","39","788","1423","0","55.38","27.13"
"64","000","00","040","0018","0000","1625","885","740","117","1742","2802","0","62.17","31.58"
"64","000","00","040","0018","0529","811","513","298","51","862","1392","0","61.93","36.85"
"64","000","00","040","0018","0530","814","372","442","66","880","1410","0","62.41","26.38"
"64","000","00","040","0019","0000","1492","796","696","64","1556","2717","0","57.27","29.30"
"64","000","00","040","0019","0531","804","431","373","46","850","1460","0","58.22","29.52"
"64","000","00","040","0019","0532","688","365","323","18","706","1257","0","56.17","29.04"
"64","000","00","040","0020","0000","992","551","441","61","1053","1980","0","53.18","27.83"
"64","000","00","040","0020","0533","507","302","205","32","539","989","0","54.50","30.54"
"64","000","00","040","0020","0534","485","249","236","29","514","991","0","51.87","25.13"
"64","000","00","040","0021","0000","1198","730","468","72","1270","1970","0","64.47","37.06"
"64","000","00","040","0021","0535","527","339","188","40","567","894","0","63.42","37.92"
"64","000","00","040","0021","0536","671","391","280","32","703","1076","0","65.33","36.34"
"64","000","00","040","0022","0000","2922","1490","1432","112","3034","5208","0","58.26","28.61"
"64","000","00","040","0022","0537","727","374","353","34","761","1263","0","60.25","29.61"
"64","000","00","040","0022","0538","776","393","383","27","803","1360","0","59.04","28.90"
"64","000","00","040","0022","0539","690","367","323","24","714","1279","0","55.82","28.69"
"64","000","00","040","0022","0540","729","356","373","27","756","1306","0","57.89","27.26"
"64","000","00","040","0023","0000","708","397","311","66","774","1323","0","58.50","30.01"
"64","000","00","040","0023","0541","708","397","311","66","774","1323","0","58.50","30.01"
"64","000","00","040","0024","0000","2365","1308","1057","131","2496","4131","0","60.42","31.66"
"64","000","00","040","0024","0542","571","319","252","32","603","1026","0","58.77","31.09"
"64","000","00","040","0024","0543","624","356","268","29","653","1037","0","62.97","34.33"
"64","000","00","040","0024","0544","550","288","262","31","581","990","0","58.69","29.09"
"64","000","00","040","0024","0545","620","345","275","39","659","1078","0","61.13","32.00"
"64","000","00","040","0025","0000","1235","685","550","87","1322","2446","0","54.05","28.00"
"64","000","00","040","0025","0546","647","386","261","42","689","1244","0","55.39","31.03"
"64","000","00","040","0025","0547","588","299","289","45","633","1202","0","52.66","24.88"
"64","000","00","040","0026","0000","1694","919","775","70","1764","3098","0","56.94","29.66"
"64","000","00","040","0026","0548","595","324","271","12","607","1088","0","55.79","29.78"
"64","000","00","040","0026","0549","498","294","204","35","533","930","0","57.31","31.61"
"64","000","00","040","0026","0550","601","301","300","23","624","1080","0","57.78","27.87"
"64","000","00","040","0027","0000","1098","574","524","67","1165","1913","0","60.90","30.01"
"64","000","00","040","0027","0551","545","301","244","25","570","921","0","61.89","32.68"
"64","000","00","040","0027","0552","553","273","280","42","595","992","0","59.98","27.52"
"64","000","00","040","0028","0000","1663","846","817","74","1737","2955","0","58.78","28.63"
"64","000","00","040","0028","0553","603","283","320","25","628","1037","0","60.56","27.29"
"64","000","00","040","0028","0554","547","268","279","16","563","953","0","59.08","28.12"
"64","000","00","040","0028","0555","513","295","218","33","546","965","0","56.58","30.57"
"64","000","00","040","0029","0000","1776","949","827","95","1871","3138","0","59.62","30.24"
"64","000","00","040","0029","0556","613","314","299","37","650","1082","0","60.07","29.02"
"64","000","00","040","0029","0557","574","329","245","38","612","997","0","61.38","33.00"
"64","000","00","040","0029","0558","589","306","283","20","609","1059","0","57.51","28.90"
"64","000","00","040","0030","0000","1186","628","558","70","1256","1998","0","62.86","31.43"
"64","000","00","040","0030","0559","585","332","253","50","635","1009","0","62.93","32.90"
"64","000","00","040","0030","0560","601","296","305","20","621","989","0","62.79","29.93"
"64","000","00","040","0031","0000","2439","1404","1035","109","2548","4510","0","56.50","31.13"
"64","000","00","040","0031","0561","628","362","266","37","665","1137","0","58.49","31.84"
"64","000","00","040","0031","0562","552","323","229","19","571","1148","0","49.74","28.14"
"64","000","00","040","0031","0563","619","351","268","28","647","1100","0","58.82","31.91"
"64","000","00","040","0031","0564","640","368","272","25","665","1125","0","59.11","32.71"
"64","000","00","040","0032","0000","1827","948","879","121","1948","3291","0","59.19","28.81"
"64","000","00","040","0032","0565","630","334","296","36","666","1103","0","60.38","30.28"
"64","000","00","040","0032","0566","585","290","295","38","623","1067","0","58.39","27.18"
"64","000","00","040","0032","0567","612","324","288","47","659","1121","0","58.79","28.90"
"64","000","00","040","0033","0000","4002","2030","1972","185","4187","7955","0","52.63","25.52"
"64","000","00","040","0033","0568","521","248","273","26","547","1073","0","50.98","23.11"
"64","000","00","040","0033","0569","529","277","252","42","571","1047","0","54.54","26.46"
"64","000","00","040","0033","0570","525","253","272","28","553","1003","0","55.13","25.22"
"64","000","00","040","0033","0571","454","240","214","25","479","927","0","51.67","25.89"
"64","000","00","040","0033","0572","480","250","230","21","501","970","0","51.65","25.77"
"64","000","00","040","0033","0573","480","230","250","23","503","1014","0","49.61","22.68"
"64","000","00","040","0033","0574","496","264","232","8","504","999","0","50.45","26.43"
"64","000","00","040","0033","0575","517","268","249","12","529","922","0","57.38","29.07"
"64","000","00","040","0034","0000","2403","1224","1179","96","2499","4907","0","50.93","24.94"
"64","000","00","040","0034","0576","587","298","289","34","621","1215","0","51.11","24.53"
"64","000","00","040","0034","0577","577","281","296","25","602","1220","0","49.34","23.03"
"64","000","00","040","0034","0578","636","321","315","19","655","1281","0","51.13","25.06"
"64","000","00","040","0034","0579","603","324","279","18","621","1191","0","52.14","27.20"
"64","000","00","040","0035","0000","4134","2278","1856","105","4239","7940","0","53.39","28.69"
"64","000","00","040","0035","0580","741","408","333","35","776","1363","0","56.93","29.93"
"64","000","00","040","0035","0581","714","371","343","24","738","1274","0","57.93","29.12"
"64","000","00","040","0035","0582","846","456","390","11","857","1549","0","55.33","29.44"
"64","000","00","040","0035","0583","710","411","299","11","721","1422","0","50.70","28.90"
"64","000","00","040","0035","0584","540","305","235","3","543","1166","0","46.57","26.16"
"64","000","00","040","0035","0585","583","327","256","21","604","1166","0","51.80","28.04"
"64","000","00","040","0036","0000","1067","662","405","52","1119","1967","0","56.89","33.66"
"64","000","00","040","0036","0586","1067","662","405","52","1119","1967","0","56.89","33.66"
"64","000","00","040","0037","0000","2229","1360","869","93","2322","4629","0","50.16","29.38"
"64","000","00","040","0037","0587","733","466","267","49","782","1457","0","53.67","31.98"
"64","000","00","040","0037","0588","707","420","287","26","733","1435","0","51.08","29.27"
"64","000","00","040","0037","0589","789","474","315","18","807","1737","0","46.46","27.29"
"64","000","00","050","0000","0000","147118","86581","60537","6580","153698","277021","329835","55.48","31.25"
"64","000","00","050","0001","0000","1735","1101","634","85","1820","3681","0","49.44","29.91"
"64","000","00","050","0001","0989","499","306","193","15","514","1184","0","43.41","25.84"
"64","000","00","050","0001","0990","624","392","232","23","647","1266","0","51.11","30.96"
"64","000","00","050","0001","0991","612","403","209","47","659","1231","0","53.53","32.74"
"64","000","00","050","0002","0000","3487","1901","1586","152","3639","7101","0","51.25","26.77"
"64","000","00","050","0002","0992","668","373","295","48","716","1370","0","52.26","27.23"
"64","000","00","050","0002","0993","753","334","419","28","781","1465","0","53.31","22.80"
"64","000","00","050","0002","0994","729","438","291","27","756","1362","0","55.51","32.16"
"64","000","00","050","0002","0995","652","358","294","26","678","1406","0","48.22","25.46"
"64","000","00","050","0002","0996","685","398","287","23","708","1498","0","47.26","26.57"
"64","000","00","050","0003","0000","1914","1167","747","95","2009","3705","0","54.22","31.50"
"64","000","00","050","0003","0997","658","429","229","23","681","1245","0","54.70","34.46"
"64","000","00","050","0003","0998","649","388","261","37","686","1242","0","55.23","31.24"
"64","000","00","050","0003","0999","607","350","257","35","642","1218","0","52.71","28.74"
"64","000","00","050","0004","0000","1944","1144","800","64","2008","3780","0","53.12","30.26"
"64","000","00","050","0004","1000","619","362","257","19","638","1286","0","49.61","28.15"
"64","000","00","050","0004","1001","648","397","251","12","660","1232","0","53.57","32.22"
"64","000","00","050","0004","1002","677","385","292","33","710","1262","0","56.26","30.51"
"64","000","00","050","0005","0000","3184","1936","1248","157","3341","6730","0","49.64","28.77"
"64","000","00","050","0005","1003","626","365","261","31","657","1321","0","49.74","27.63"
"64","000","00","050","0005","1004","615","386","229","33","648","1296","0","50.00","29.78"
"64","000","00","050","0005","1005","660","412","248","37","697","1338","0","52.09","30.79"
"64","000","00","050","0005","1006","644","386","258","36","680","1400","0","48.57","27.57"
"64","000","00","050","0005","1007","639","387","252","20","659","1375","0","47.93","28.15"
"64","000","00","050","0006","0000","1754","1081","673","67","1821","3319","0","54.87","32.57"
"64","000","00","050","0006","1008","534","361","173","20","554","980","0","56.53","36.84"
"64","000","00","050","0006","1009","581","339","242","23","604","1063","0","56.82","31.89"
"64","000","00","050","0006","1010","639","381","258","24","663","1276","0","51.96","29.86"
"64","000","00","050","0007","0000","9791","5435","4356","320","10111","20141","0","50.20","26.98"
"64","000","00","050","0007","1011","726","439","287","29","755","1432","0","52.72","30.66"
"64","000","00","050","0007","1012","650","356","294","14","664","1403","0","47.33","25.37"
"64","000","00","050","0007","1013","718","405","313","16","734","1453","0","50.52","27.87"
"64","000","00","050","0007","1014","709","370","339","14","723","1424","0","50.77","25.98"
"64","000","00","050","0007","1015","713","445","268","41","754","1424","0","52.95","31.25"
"64","000","00","050","0007","1016","697","434","263","31","728","1423","0","51.16","30.50"
"64","000","00","050","0007","1017","500","390","110","31","531","1448","0","36.67","26.93"
"64","000","00","050","0007","1018","687","400","287","30","717","1476","0","48.58","27.10"
"64","000","00","050","0007","1019","683","346","337","21","704","1464","0","48.09","23.63"
"64","000","00","050","0007","1020","770","395","375","18","788","1430","0","55.10","27.62"
"64","000","00","050","0007","1021","732","397","335","20","752","1464","0","51.37","27.12"
"64","000","00","050","0007","1022","738","304","434","15","753","1406","0","53.56","21.62"
"64","000","00","050","0007","1023","684","341","343","24","708","1409","0","50.25","24.20"
"64","000","00","050","0007","1024","784","413","371","16","800","1485","0","53.87","27.81"
"64","000","00","050","0008","0000","4140","2398","1742","191","4331","8129","0","53.28","29.50"
"64","000","00","050","0008","1025","675","411","264","30","705","1341","0","52.57","30.65"
"64","000","00","050","0008","1026","714","422","292","45","759","1391","0","54.57","30.34"
"64","000","00","050","0008","1027","684","378","306","32","716","1298","0","55.16","29.12"
"64","000","00","050","0008","1028","684","391","293","33","717","1347","0","53.23","29.03"
"64","000","00","050","0008","1029","706","426","280","27","733","1361","0","53.86","31.30"
"64","000","00","050","0008","1030","677","370","307","24","701","1391","0","50.40","26.60"
"64","000","00","050","0009","0000","3361","1930","1431","132","3493","6742","0","51.81","28.63"
"64","000","00","050","0009","1031","699","407","292","30","729","1334","0","54.65","30.51"
"64","000","00","050","0009","1032","701","400","301","22","723","1374","0","52.62","29.11"
"64","000","00","050","0009","1033","664","379","285","29","693","1326","0","52.26","28.58"
"64","000","00","050","0009","1034","642","391","251","28","670","1335","0","50.19","29.29"
"64","000","00","050","0009","1035","655","353","302","23","678","1373","0","49.38","25.71"
"64","000","00","050","0010","0000","1029","607","422","39","1068","1840","0","58.04","32.99"
"64","000","00","050","0010","1036","520","296","224","30","550","966","0","56.94","30.64"
"64","000","00","050","0010","1037","509","311","198","9","518","874","0","59.27","35.58"
"64","000","00","050","0011","0000","852","501","351","43","895","1480","0","60.47","33.85"
"64","000","00","050","0011","1038","491","276","215","18","509","811","0","62.76","34.03"
"64","000","00","050","0011","1039","361","225","136","25","386","669","0","57.70","33.63"
"64","000","00","050","0012","0000","2678","1556","1122","97","2775","4886","0","56.79","31.85"
"64","000","00","050","0012","1040","730","407","323","27","757","1289","0","58.73","31.57"
"64","000","00","050","0012","1041","622","379","243","30","652","1128","0","57.80","33.60"
"64","000","00","050","0012","1042","683","381","302","20","703","1269","0","55.40","30.02"
"64","000","00","050","0012","1043","643","389","254","20","663","1200","0","55.25","32.42"
"64","000","00","050","0013","0000","2247","1219","1028","80","2327","4062","0","57.29","30.01"
"64","000","00","050","0013","1044","808","431","377","20","828","1402","0","59.06","30.74"
"64","000","00","050","0013","1045","693","371","322","24","717","1287","0","55.71","28.83"
"64","000","00","050","0013","1046","746","417","329","36","782","1373","0","56.96","30.37"
"64","000","00","050","0014","0000","2311","1232","1079","58","2369","4268","0","55.51","28.87"
"64","000","00","050","0014","1047","792","424","368","20","812","1435","0","56.59","29.55"
"64","000","00","050","0014","1048","731","380","351","25","756","1406","0","53.77","27.03"
"64","000","00","050","0014","1049","788","428","360","13","801","1427","0","56.13","29.99"
"64","000","00","050","0015","0000","3661","2060","1601","133","3794","6880","0","55.15","29.94"
"64","000","00","050","0015","1050","797","453","344","24","821","1409","0","58.27","32.15"
"64","000","00","050","0015","1051","781","440","341","21","802","1484","0","54.04","29.65"
"64","000","00","050","0015","1052","692","398","294","35","727","1343","0","54.13","29.64"
"64","000","00","050","0015","1053","686","382","304","34","720","1272","0","56.60","30.03"
"64","000","00","050","0015","1054","705","387","318","19","724","1372","0","52.77","28.21"
"64","000","00","050","0016","0000","1770","1012","758","93","1863","3313","0","56.23","30.55"
"64","000","00","050","0016","1055","515","279","236","29","544","990","0","54.95","28.18"
"64","000","00","050","0016","1056","660","380","280","32","692","1230","0","56.26","30.89"
"64","000","00","050","0016","1057","595","353","242","32","627","1093","0","57.37","32.30"
"64","000","00","050","0017","0000","2536","1524","1012","89","2625","4746","0","55.31","32.11"
"64","000","00","050","0017","1058","662","362","300","15","677","1191","0","56.84","30.39"
"64","000","00","050","0017","1059","595","336","259","27","622","1259","0","49.40","26.69"
"64","000","00","050","0017","1060","645","412","233","17","662","1171","0","56.53","35.18"
"64","000","00","050","0017","1061","634","414","220","30","664","1125","0","59.02","36.80"
"64","000","00","050","0018","0000","1758","1039","719","92","1850","3698","0","50.03","28.10"
"64","000","00","050","0018","1062","602","359","243","25","627","1238","0","50.65","29.00"
"64","000","00","050","0018","1063","560","323","237","38","598","1182","0","50.59","27.33"
"64","000","00","050","0018","1064","596","357","239","29","625","1278","0","48.90","27.93"
"64","000","00","050","0019","0000","3273","1911","1362","147","3420","6192","0","55.23","30.86"
"64","000","00","050","0019","1065","795","491","304","67","862","1452","0","59.37","33.82"
"64","000","00","050","0019","1066","828","483","345","45","873","1540","0","56.69","31.36"
"64","000","00","050","0019","1067","804","456","348","11","815","1587","0","51.35","28.73"
"64","000","00","050","0019","1068","846","481","365","24","870","1613","0","53.94","29.82"
"64","000","00","050","0020","0000","1519","895","624","86","1605","2659","0","60.36","33.66"
"64","000","00","050","0020","1069","806","485","321","51","857","1385","0","61.88","35.02"
"64","000","00","050","0020","1070","713","410","303","35","748","1274","0","58.71","32.18"
"64","000","00","050","0021","0000","1462","786","676","44","1506","2948","0","51.09","26.66"
"64","000","00","050","0021","1071","739","369","370","21","760","1450","0","52.41","25.45"
"64","000","00","050","0021","1072","723","417","306","23","746","1498","0","49.80","27.84"
"64","000","00","050","0022","0000","3782","2077","1705","110","3892","7213","0","53.96","28.80"
"64","000","00","050","0022","1073","725","377","348","19","744","1421","0","52.36","26.53"
"64","000","00","050","0022","1074","719","416","303","17","736","1434","0","51.32","29.01"
"64","000","00","050","0022","1075","748","444","304","30","778","1402","0","55.49","31.67"
"64","000","00","050","0022","1076","786","436","350","23","809","1469","0","55.07","29.68"
"64","000","00","050","0022","1077","804","404","400","21","825","1487","0","55.48","27.17"
"64","000","00","050","0023","0000","1395","782","613","55","1450","2897","0","50.05","26.99"
"64","000","00","050","0023","1078","716","405","311","33","749","1476","0","50.75","27.44"
"64","000","00","050","0023","1079","679","377","302","22","701","1421","0","49.33","26.53"
"64","000","00","050","0024","0000","1293","726","567","67","1360","2428","0","56.01","29.90"
"64","000","00","050","0024","1080","663","358","305","36","699","1218","0","57.39","29.39"
"64","000","00","050","0024","1081","630","368","262","31","661","1210","0","54.63","30.41"
"64","000","00","050","0025","0000","2781","1582","1199","86","2867","5514","0","51.99","28.69"
"64","000","00","050","0025","1082","625","386","239","23","648","1341","0","48.32","28.78"
"64","000","00","050","0025","1083","658","370","288","32","690","1340","0","51.49","27.61"
"64","000","00","050","0025","1084","715","379","336","11","726","1355","0","53.58","27.97"
"64","000","00","050","0025","1085","783","447","336","20","803","1478","0","54.33","30.24"
"64","000","00","050","0026","0000","2521","1415","1106","93","2614","4574","0","57.15","30.94"
"64","000","00","050","0026","1086","926","557","369","38","964","1559","0","61.83","35.73"
"64","000","00","050","0026","1087","698","387","311","34","732","1372","0","53.35","28.21"
"64","000","00","050","0026","1088","897","471","426","21","918","1643","0","55.87","28.67"
"64","000","00","050","0027","0000","3351","1846","1505","122","3473","6594","0","52.67","28.00"
"64","000","00","050","0027","1089","683","382","301","19","702","1249","0","56.20","30.58"
"64","000","00","050","0027","1090","659","373","286","29","688","1276","0","53.92","29.23"
"64","000","00","050","0027","1091","619","349","270","22","641","1312","0","48.86","26.60"
"64","000","00","050","0027","1092","719","379","340","33","752","1395","0","53.91","27.17"
"64","000","00","050","0027","1093","671","363","308","19","690","1362","0","50.66","26.65"
"64","000","00","050","0028","0000","2093","1226","867","94","2187","3770","0","58.01","32.52"
"64","000","00","050","0028","1094","706","456","250","32","738","1274","0","57.93","35.79"
"64","000","00","050","0028","1095","803","415","388","14","817","1413","0","57.82","29.37"
"64","000","00","050","0028","1096","584","355","229","48","632","1083","0","58.36","32.78"
"64","000","00","050","0029","0000","2576","1501","1075","90","2666","6441","0","41.39","23.30"
"64","000","00","050","0029","1097","820","474","346","27","847","3158","0","26.82","15.01"
"64","000","00","050","0029","1098","962","554","408","26","988","1664","0","59.38","33.29"
"64","000","00","050","0029","1099","794","473","321","37","831","1619","0","51.33","29.22"
"64","000","00","050","0030","0000","4075","2303","1772","149","4224","7575","0","55.76","30.40"
"64","000","00","050","0030","1100","889","501","388","44","933","1556","0","59.96","32.20"
"64","000","00","050","0030","1101","836","476","360","33","869","1476","0","58.88","32.25"
"64","000","00","050","0030","1102","745","432","313","30","775","1427","0","54.31","30.27"
"64","000","00","050","0030","1103","852","472","380","13","865","1572","0","55.03","30.03"
"64","000","00","050","0030","1104","753","422","331","29","782","1544","0","50.65","27.33"
"64","000","00","050","0031","0000","1928","1128","800","84","2012","3725","0","54.01","30.28"
"64","000","00","050","0031","1105","657","405","252","31","688","1223","0","56.26","33.12"
"64","000","00","050","0031","1106","677","385","292","35","712","1257","0","56.64","30.63"
"64","000","00","050","0031","1107","594","338","256","18","612","1245","0","49.16","27.15"
"64","000","00","050","0032","0000","1405","901","504","52","1457","2797","0","52.09","32.21"
"64","000","00","050","0032","1108","680","424","256","33","713","1331","0","53.57","31.86"
"64","000","00","050","0032","1109","725","477","248","19","744","1466","0","50.75","32.54"
"64","000","00","050","0033","0000","2455","1492","963","149","2604","5082","0","51.24","29.36"
"64","000","00","050","0033","1110","821","519","302","69","890","1695","0","52.51","30.62"
"64","000","00","050","0033","1111","798","476","322","44","842","1649","0","51.06","28.87"
"64","000","00","050","0033","1112","836","497","339","36","872","1738","0","50.17","28.60"
"64","000","00","050","0034","0000","1222","723","499","83","1305","2469","0","52.86","29.28"
"64","000","00","050","0034","1113","578","352","226","43","621","1164","0","53.35","30.24"
"64","000","00","050","0034","1114","644","371","273","40","684","1305","0","52.41","28.43"
"64","000","00","050","0035","0000","911","570","341","52","963","1739","0","55.38","32.78"
"64","000","00","050","0035","1115","443","269","174","30","473","874","0","54.12","30.78"
"64","000","00","050","0035","1116","468","301","167","22","490","865","0","56.65","34.80"
"64","000","00","050","0036","0000","1669","1088","581","94","1763","2874","0","61.34","37.86"
"64","000","00","050","0036","1117","867","546","321","51","918","1512","0","60.71","36.11"
"64","000","00","050","0036","1118","802","542","260","43","845","1362","0","62.04","39.79"
"64","000","00","050","0037","0000","1680","1042","638","75","1755","3369","0","52.09","30.93"
"64","000","00","050","0037","1119","579","351","228","18","597","1222","0","48.85","28.72"
"64","000","00","050","0037","1120","590","392","198","38","628","1120","0","56.07","35.00"
"64","000","00","050","0037","1121","511","299","212","19","530","1027","0","51.61","29.11"
"64","000","00","050","0038","0000","5441","3112","2329","183","5624","11426","0","49.22","27.24"
"64","000","00","050","0038","1122","684","424","260","17","701","1411","0","49.68","30.05"
"64","000","00","050","0038","1123","724","430","294","28","752","1521","0","49.44","28.27"
"64","000","00","050","0038","1124","737","389","348","16","753","1568","0","48.02","24.81"
"64","000","00","050","0038","1125","651","436","215","44","695","1313","0","52.93","33.21"
"64","000","00","050","0038","1126","712","397","315","21","733","1477","0","49.63","26.88"
"64","000","00","050","0038","1127","644","354","290","17","661","1398","0","47.28","25.32"
"64","000","00","050","0038","1128","667","369","298","25","692","1398","0","49.50","26.39"
"64","000","00","050","0038","1129","622","313","309","15","637","1340","0","47.54","23.36"
"64","000","00","050","0039","0000","1978","1179","799","82","2060","3587","0","57.43","32.87"
"64","000","00","050","0039","1130","662","383","279","41","703","1209","0","58.15","31.68"
"64","000","00","050","0039","1131","709","417","292","20","729","1269","0","57.45","32.86"
"64","000","00","050","0039","1132","607","379","228","21","628","1109","0","56.63","34.17"
"64","000","00","050","0040","0000","1126","705","421","49","1175","1747","0","67.26","40.35"
"64","000","00","050","0040","1133","525","320","205","22","547","846","0","64.66","37.83"
"64","000","00","050","0040","1134","601","385","216","27","628","901","0","69.70","42.73"
"64","000","00","050","0041","0000","1453","875","578","72","1525","2607","0","58.50","33.56"
"64","000","00","050","0041","1135","764","412","352","36","800","1317","0","60.74","31.28"
"64","000","00","050","0041","1136","689","463","226","36","725","1290","0","56.20","35.89"
"64","000","00","050","0042","0000","1241","829","412","100","1341","2564","0","52.30","32.33"
"64","000","00","050","0042","1137","612","416","196","43","655","1328","0","49.32","31.33"
"64","000","00","050","0042","1138","629","413","216","57","686","1236","0","55.50","33.41"
"64","000","00","050","0043","0000","855","561","294","61","916","1669","0","54.88","33.61"
"64","000","00","050","0043","1139","397","268","129","37","434","794","0","54.66","33.75"
"64","000","00","050","0043","1140","458","293","165","24","482","875","0","55.09","33.49"
"64","000","00","050","0044","0000","2452","1406","1046","110","2562","4385","0","58.43","32.06"
"64","000","00","050","0044","1141","661","376","285","33","694","1268","0","54.73","29.65"
"64","000","00","050","0044","1142","938","514","424","42","980","1632","0","60.05","31.50"
"64","000","00","050","0044","1143","853","516","337","35","888","1485","0","59.80","34.75"
"64","000","00","050","0045","0000","2312","1343","969","111","2423","4050","0","59.83","33.16"
"64","000","00","050","0045","1144","804","460","344","38","842","1349","0","62.42","34.10"
"64","000","00","050","0045","1145","735","425","310","36","771","1304","0","59.13","32.59"
"64","000","00","050","0045","1146","773","458","315","37","810","1397","0","57.98","32.78"
"64","000","00","050","0046","0000","1727","1070","657","65","1792","2900","0","61.79","36.90"
"64","000","00","050","0046","1147","871","534","337","31","902","1443","0","62.51","37.01"
"64","000","00","050","0046","1148","856","536","320","34","890","1457","0","61.08","36.79"
"64","000","00","050","0047","0000","1350","835","515","56","1406","2413","0","58.27","34.60"
"64","000","00","050","0047","1149","542","338","204","26","568","966","0","58.80","34.99"
"64","000","00","050","0047","1150","808","497","311","30","838","1447","0","57.91","34.35"
"64","000","00","050","0048","0000","663","437","226","35","698","1165","0","59.91","37.51"
"64","000","00","050","0048","1151","663","437","226","35","698","1165","0","59.91","37.51"
"64","000","00","050","0049","0000","810","521","289","22","832","1430","0","58.18","36.43"
"64","000","00","050","0049","1152","810","521","289","22","832","1430","0","58.18","36.43"
"64","000","00","050","0050","0000","851","500","351","41","892","1313","0","67.94","38.08"
"64","000","00","050","0050","1153","851","500","351","41","892","1313","0","67.94","38.08"
"64","000","00","050","0051","0000","527","296","231","32","559","847","0","66.00","34.95"
"64","000","00","050","0051","1154","527","296","231","32","559","847","0","66.00","34.95"
"64","000","00","050","0052","0000","1558","939","619","67","1625","2482","0","65.47","37.83"
"64","000","00","050","0052","1155","823","495","328","42","865","1339","0","64.60","36.97"
"64","000","00","050","0052","1156","735","444","291","25","760","1143","0","66.49","38.85"
"64","000","00","050","0053","0000","1228","754","474","52","1280","1935","0","66.15","38.97"
"64","000","00","050","0053","1157","606","368","238","33","639","922","0","69.31","39.91"
"64","000","00","050","0053","1158","622","386","236","19","641","1013","0","63.28","38.10"
"64","000","00","050","0054","0000","935","580","355","49","984","1766","0","55.72","32.84"
"64","000","00","050","0054","1159","459","282","177","23","482","870","0","55.40","32.41"
"64","000","00","050","0054","1160","476","298","178","26","502","896","0","56.03","33.26"
"64","000","00","050","0055","0000","888","558","330","61","949","1316","0","72.11","42.40"
"64","000","00","050","0055","1161","888","558","330","61","949","1316","0","72.11","42.40"
"64","000","00","050","0056","0000","433","259","174","25","458","713","0","64.24","36.33"
"64","000","00","050","0056","1162","433","259","174","25","458","713","0","64.24","36.33"
"64","000","00","050","0057","0000","618","401","217","31","649","966","0","67.18","41.51"
"64","000","00","050","0057","1163","618","401","217","31","649","966","0","67.18","41.51"
"64","000","00","050","0058","0000","872","520","352","41","913","1417","0","64.43","36.70"
"64","000","00","050","0058","1164","872","520","352","41","913","1417","0","64.43","36.70"
"64","000","00","050","0059","0000","1164","722","442","52","1216","1801","0","67.52","40.09"
"64","000","00","050","0059","1165","567","353","214","28","595","907","0","65.60","38.92"
"64","000","00","050","0059","1166","597","369","228","24","621","894","0","69.46","41.28"
"64","000","00","050","0060","0000","1875","1116","759","120","1995","2915","0","68.44","38.28"
"64","000","00","050","0060","1167","969","563","406","64","1033","1540","0","67.08","36.56"
"64","000","00","050","0060","1168","906","553","353","56","962","1375","0","69.96","40.22"
"64","000","00","050","0061","0000","2054","1176","878","111","2165","3506","0","61.75","33.54"
"64","000","00","050","0061","1169","647","377","270","38","685","1096","0","62.50","34.40"
"64","000","00","050","0061","1170","756","466","290","32","788","1233","0","63.91","37.79"
"64","000","00","050","0061","1171","651","333","318","41","692","1177","0","58.79","28.29"
"64","000","00","050","0062","0000","2089","1288","801","99","2188","3522","0","62.12","36.57"
"64","000","00","050","0062","1172","687","407","280","27","714","1180","0","60.51","34.49"
"64","000","00","050","0062","1173","759","483","276","42","801","1263","0","63.42","38.24"
"64","000","00","050","0062","1174","643","398","245","30","673","1079","0","62.37","36.89"
"64","000","00","050","0063","0000","981","617","364","61","1042","1606","0","64.88","38.42"
"64","000","00","050","0063","1175","981","617","364","61","1042","1606","0","64.88","38.42"
"64","000","00","050","0064","0000","958","628","330","55","1013","1601","0","63.27","39.23"
"64","000","00","050","0064","1176","515","336","179","24","539","846","0","63.71","39.72"
"64","000","00","050","0064","1177","443","292","151","31","474","755","0","62.78","38.68"
"64","000","00","050","0065","0000","1202","720","482","48","1250","2098","0","59.58","34.32"
"64","000","00","050","0065","1178","721","432","289","15","736","1251","0","58.83","34.53"
"64","000","00","050","0065","1179","481","288","193","33","514","847","0","60.68","34.00"
"64","000","00","050","0066","0000","360","249","111","35","395","638","0","61.91","39.03"
"64","000","00","050","0066","1180","360","249","111","35","395","638","0","61.91","39.03"
"64","000","00","050","0067","0000","460","306","154","25","485","846","0","57.33","36.17"
"64","000","00","050","0067","1181","460","306","154","25","485","846","0","57.33","36.17"
"64","000","00","050","0068","0000","676","449","227","54","730","1291","0","56.55","34.78"
"64","000","00","050","0068","1182","676","449","227","54","730","1291","0","56.55","34.78"
"64","000","00","050","0069","0000","749","446","303","39","788","1278","0","61.66","34.90"
"64","000","00","050","0069","1183","749","446","303","39","788","1278","0","61.66","34.90"
"64","000","00","050","0070","0000","380","240","140","16","396","712","0","55.62","33.71"
"64","000","00","050","0070","1184","380","240","140","16","396","712","0","55.62","33.71"
"64","000","00","050","0072","0000","638","384","254","39","677","1094","0","61.88","35.10"
"64","000","00","050","0072","1185","638","384","254","39","677","1094","0","61.88","35.10"
"64","000","00","050","0073","0000","2166","1274","892","81","2247","3728","0","60.27","34.17"
"64","000","00","050","0073","1186","704","396","308","35","739","1241","0","59.55","31.91"
"64","000","00","050","0073","1187","736","456","280","20","756","1222","0","61.87","37.32"
"64","000","00","050","0073","1188","726","422","304","26","752","1265","0","59.45","33.36"
"64","000","00","050","0074","0000","599","334","265","52","651","973","0","66.91","34.33"
"64","000","00","050","0074","1189","599","334","265","52","651","973","0","66.91","34.33"
"64","000","00","050","0075","0000","486","271","215","30","516","1092","0","47.25","24.82"
"64","000","00","050","0075","1190","486","271","215","30","516","1092","0","47.25","24.82"
"64","000","00","050","0076","0000","1005","600","405","58","1063","1831","0","58.06","32.77"
"64","000","00","050","0076","1191","482","294","188","36","518","879","0","58.93","33.45"
"64","000","00","050","0076","1192","523","306","217","22","545","952","0","57.25","32.14"
"64","000","00","050","0077","0000","559","381","178","49","608","903","0","67.33","42.19"
"64","000","00","050","0077","1193","559","381","178","49","608","903","0","67.33","42.19"
"64","000","00","050","0078","0000","695","437","258","44","739","1227","0","60.23","35.62"
"64","000","00","050","0078","1194","695","437","258","44","739","1227","0","60.23","35.62"
"64","000","00","050","0079","0000","854","485","369","44","898","1674","0","53.64","28.97"
"64","000","00","050","0079","1195","854","485","369","44","898","1674","0","53.64","28.97"
"64","000","00","050","0081","0000","1262","795","467","83","1345","2246","0","59.88","35.40"
"64","000","00","050","0081","1196","653","416","237","56","709","1142","0","62.08","36.43"
"64","000","00","050","0081","1197","609","379","230","27","636","1104","0","57.61","34.33"
"64","000","00","050","0082","0000","639","421","218","44","683","1172","0","58.28","35.92"
"64","000","00","050","0082","1198","639","421","218","44","683","1172","0","58.28","35.92"
"64","000","00","050","0083","0000","710","425","285","58","768","1201","0","63.95","35.39"
"64","000","00","050","0083","1199","710","425","285","58","768","1201","0","63.95","35.39"
"64","000","00","050","0084","0000","666","424","242","60","726","993","0","73.11","42.70"
"64","000","00","050","0084","1200","666","424","242","60","726","993","0","73.11","42.70"
"64","000","00","050","0085","0000","618","380","238","34","652","1051","0","62.04","36.16"
"64","000","00","050","0085","1201","618","380","238","34","652","1051","0","62.04","36.16"
"64","000","00","050","0086","0000","695","410","285","27","722","1095","0","65.94","37.44"
"64","000","00","050","0086","1202","695","410","285","27","722","1095","0","65.94","37.44"
"64","000","00","050","0087","0000","676","404","272","38","714","973","0","73.38","41.52"
"64","000","00","050","0087","1203","676","404","272","38","714","973","0","73.38","41.52"
"64","000","00","050","0088","0000","1041","682","359","60","1101","1895","0","58.10","35.99"
"64","000","00","050","0088","1204","511","356","155","21","532","901","0","59.05","39.51"
"64","000","00","050","0088","1205","530","326","204","39","569","994","0","57.24","32.80"
"64","000","00","060","0000","0000","22847","13270","9577","1024","23871","41460","48721","57.58","32.01"
"64","000","00","060","0001","0000","882","470","412","42","924","1653","0","55.90","28.43"
"64","000","00","060","0001","1231","373","196","177","19","392","745","0","52.62","26.31"
"64","000","00","060","0001","1232","509","274","235","23","532","908","0","58.59","30.18"
"64","000","00","060","0002","0000","545","298","247","28","573","951","0","60.25","31.34"
"64","000","00","060","0002","1233","545","298","247","28","573","951","0","60.25","31.34"
"64","000","00","060","0003","0000","1418","766","652","62","1480","2684","0","55.14","28.54"
"64","000","00","060","0003","1234","712","393","319","28","740","1340","0","55.22","29.33"
"64","000","00","060","0003","1235","706","373","333","34","740","1344","0","55.06","27.75"
"64","000","00","060","0004","0000","569","314","255","19","588","940","0","62.55","33.40"
"64","000","00","060","0004","1236","569","314","255","19","588","940","0","62.55","33.40"
"64","000","00","060","0005","0000","693","377","316","41","734","1203","0","61.01","31.34"
"64","000","00","060","0005","1237","693","377","316","41","734","1203","0","61.01","31.34"
"64","000","00","060","0006","0000","367","195","172","21","388","599","0","64.77","32.55"
"64","000","00","060","0006","1238","367","195","172","21","388","599","0","64.77","32.55"
"64","000","00","060","0007","0000","467","278","189","14","481","955","0","50.37","29.11"
"64","000","00","060","0007","1239","467","278","189","14","481","955","0","50.37","29.11"
"64","000","00","060","0008","0000","912","502","410","33","945","1682","0","56.18","29.85"
"64","000","00","060","0008","1240","473","248","225","16","489","817","0","59.85","30.35"
"64","000","00","060","0008","1241","439","254","185","17","456","865","0","52.72","29.36"
"64","000","00","060","0009","0000","452","284","168","26","478","868","0","55.07","32.72"
"64","000","00","060","0009","1242","452","284","168","26","478","868","0","55.07","32.72"
"64","000","00","060","0010","0000","461","274","187","13","474","683","0","69.40","40.12"
"64","000","00","060","0010","1243","461","274","187","13","474","683","0","69.40","40.12"
"64","000","00","060","0011","0000","706","418","288","33","739","1319","0","56.03","31.69"
"64","000","00","060","0011","1244","706","418","288","33","739","1319","0","56.03","31.69"
"64","000","00","060","0012","0000","359","245","114","13","372","688","0","54.07","35.61"
"64","000","00","060","0012","1245","359","245","114","13","372","688","0","54.07","35.61"
"64","000","00","060","0013","0000","1149","697","452","54","1203","2021","0","59.52","34.49"
"64","000","00","060","0013","1246","607","369","238","26","633","1021","0","62.00","36.14"
"64","000","00","060","0013","1247","542","328","214","28","570","1000","0","57.00","32.80"
"64","000","00","060","0014","0000","1467","846","621","56","1523","2684","0","56.74","31.52"
"64","000","00","060","0014","1248","719","417","302","23","742","1317","0","56.34","31.66"
"64","000","00","060","0014","1249","748","429","319","33","781","1367","0","57.13","31.38"
"64","000","00","060","0015","0000","1233","696","537","47","1280","2080","0","61.54","33.46"
"64","000","00","060","0015","1250","640","386","254","21","661","1102","0","59.98","35.03"
"64","000","00","060","0015","1251","593","310","283","26","619","978","0","63.29","31.70"
"64","000","00","060","0016","0000","866","472","394","42","908","1497","0","60.65","31.53"
"64","000","00","060","0016","1252","465","244","221","23","488","769","0","63.46","31.73"
"64","000","00","060","0016","1253","401","228","173","19","420","728","0","57.69","31.32"
"64","000","00","060","0017","0000","1712","998","714","61","1773","3086","0","57.45","32.34"
"64","000","00","060","0017","1254","538","302","236","21","559","1003","0","55.73","30.11"
"64","000","00","060","0017","1255","575","342","233","15","590","1053","0","56.03","32.48"
"64","000","00","060","0017","1256","599","354","245","25","624","1030","0","60.58","34.37"
"64","000","00","060","0018","0000","768","373","395","32","800","1267","0","63.14","29.44"
"64","000","00","060","0018","1257","768","373","395","32","800","1267","0","63.14","29.44"
"64","000","00","060","0019","0000","525","321","204","22","547","987","0","55.42","32.52"
"64","000","00","060","0019","1258","525","321","204","22","547","987","0","55.42","32.52"
"64","000","00","060","0020","0000","388","241","147","22","410","765","0","53.59","31.50"
"64","000","00","060","0020","1259","388","241","147","22","410","765","0","53.59","31.50"
"64","000","00","060","0021","0000","492","281","211","16","508","922","0","55.10","30.48"
"64","000","00","060","0021","1260","492","281","211","16","508","922","0","55.10","30.48"
"64","000","00","060","0022","0000","1084","694","390","39","1123","1820","0","61.70","38.13"
"64","000","00","060","0022","1261","533","353","180","19","552","887","0","62.23","39.80"
"64","000","00","060","0022","1262","551","341","210","20","571","933","0","61.20","36.55"
"64","000","00","060","0023","0000","1195","647","548","54","1249","2593","0","48.17","24.95"
"64","000","00","060","0023","1263","506","287","219","20","526","1277","0","41.19","22.47"
"64","000","00","060","0023","1264","689","360","329","34","723","1316","0","54.94","27.36"
"64","000","00","060","0024","0000","342","216","126","9","351","638","0","55.02","33.86"
"64","000","00","060","0024","1265","342","216","126","9","351","638","0","55.02","33.86"
"64","000","00","060","0025","0000","525","333","192","41","566","971","0","58.29","34.29"
"64","000","00","060","0025","1266","525","333","192","41","566","971","0","58.29","34.29"
"64","000","00","060","0026","0000","473","305","168","23","496","930","0","53.33","32.80"
"64","000","00","060","0026","1267","473","305","168","23","496","930","0","53.33","32.80"
"64","000","00","060","0027","0000","428","260","168","17","445","871","0","51.09","29.85"
"64","000","00","060","0027","1268","428","260","168","17","445","871","0","51.09","29.85"
"64","000","00","060","0028","0000","432","257","175","33","465","861","0","54.01","29.85"
"64","000","00","060","0028","1269","432","257","175","33","465","861","0","54.01","29.85"
"64","000","00","060","0029","0000","442","284","158","22","464","824","0","56.31","34.47"
"64","000","00","060","0029","1270","442","284","158","22","464","824","0","56.31","34.47"
"64","000","00","060","0030","0000","425","262","163","14","439","687","0","63.90","38.14"
"64","000","00","060","0030","1271","425","262","163","14","439","687","0","63.90","38.14"
"64","000","00","060","0031","0000","402","242","160","25","427","635","0","67.24","38.11"
"64","000","00","060","0031","1272","402","242","160","25","427","635","0","67.24","38.11"
"64","000","00","060","0032","0000","668","424","244","50","718","1096","0","65.51","38.69"
"64","000","00","060","0032","1273","668","424","244","50","718","1096","0","65.51","38.69"
"64","000","00","070","0000","0000","12727","7443","5284","549","13276","23332","26424","56.90","31.90"
"64","000","00","070","0001","0000","455","313","142","17","472","796","0","59.30","39.32"
"64","000","00","070","0001","1206","455","313","142","17","472","796","0","59.30","39.32"
"64","000","00","070","0002","0000","576","323","253","35","611","1218","0","50.16","26.52"
"64","000","00","070","0002","1207","576","323","253","35","611","1218","0","50.16","26.52"
"64","000","00","070","0003","0000","711","447","264","43","754","1254","0","60.13","35.65"
"64","000","00","070","0003","1208","711","447","264","43","754","1254","0","60.13","35.65"
"64","000","00","070","0004","0000","417","275","142","23","440","790","0","55.70","34.81"
"64","000","00","070","0004","1209","417","275","142","23","440","790","0","55.70","34.81"
"64","000","00","070","0005","0000","511","321","190","14","525","869","0","60.41","36.94"
"64","000","00","070","0005","1210","511","321","190","14","525","869","0","60.41","36.94"
"64","000","00","070","0006","0000","1817","1028","789","65","1882","3408","0","55.22","30.16"
"64","000","00","070","0006","1211","626","342","284","16","642","1159","0","55.39","29.51"
"64","000","00","070","0006","1212","605","359","246","14","619","1109","0","55.82","32.37"
"64","000","00","070","0006","1213","586","327","259","35","621","1140","0","54.47","28.68"
"64","000","00","070","0007","0000","333","187","146","15","348","596","0","58.39","31.38"
"64","000","00","070","0007","1214","333","187","146","15","348","596","0","58.39","31.38"
"64","000","00","070","0008","0000","619","367","252","21","640","1148","0","55.75","31.97"
"64","000","00","070","0008","1215","619","367","252","21","640","1148","0","55.75","31.97"
"64","000","00","070","0009","0000","950","569","381","33","983","1793","0","54.82","31.73"
"64","000","00","070","0009","1216","490","290","200","16","506","879","0","57.57","32.99"
"64","000","00","070","0009","1217","460","279","181","17","477","914","0","52.19","30.53"
"64","000","00","070","0010","0000","461","267","194","16","477","789","0","60.46","33.84"
"64","000","00","070","0010","1218","461","267","194","16","477","789","0","60.46","33.84"
"64","000","00","070","0011","0000","568","323","245","20","588","960","0","61.25","33.65"
"64","000","00","070","0011","1219","568","323","245","20","588","960","0","61.25","33.65"
"64","000","00","070","0012","0000","466","287","179","23","489","1025","0","47.71","28.00"
"64","000","00","070","0012","1220","466","287","179","23","489","1025","0","47.71","28.00"
"64","000","00","070","0013","0000","459","267","192","19","478","868","0","55.07","30.76"
"64","000","00","070","0013","1221","459","267","192","19","478","868","0","55.07","30.76"
"64","000","00","070","0014","0000","789","428","361","31","820","1353","0","60.61","31.63"
"64","000","00","070","0014","1222","382","208","174","10","392","652","0","60.12","31.90"
"64","000","00","070","0014","1223","407","220","187","21","428","701","0","61.06","31.38"
"64","000","00","070","0015","0000","570","321","249","34","604","1066","0","56.66","30.11"
"64","000","00","070","0015","1224","570","321","249","34","604","1066","0","56.66","30.11"
"64","000","00","070","0016","0000","534","298","236","19","553","919","0","60.17","32.43"
"64","000","00","070","0016","1225","534","298","236","19","553","919","0","60.17","32.43"
"64","000","00","070","0017","0000","858","473","385","47","905","1553","0","58.27","30.46"
"64","000","00","070","0017","1226","384","219","165","20","404","735","0","54.97","29.80"
"64","000","00","070","0017","1227","474","254","220","27","501","818","0","61.25","31.05"
"64","000","00","070","0018","0000","536","310","226","39","575","979","0","58.73","31.66"
"64","000","00","070","0018","1228","536","310","226","39","575","979","0","58.73","31.66"
"64","000","00","070","0019","0000","490","286","204","12","502","898","0","55.90","31.85"
"64","000","00","070","0019","1229","490","286","204","12","502","898","0","55.90","31.85"
"64","000","00","070","0020","0000","607","353","254","23","630","1050","0","60.00","33.62"
"64","000","00","070","0020","1230","607","353","254","23","630","1050","0","60.00","33.62"
"64","000","00","080","0000","0000","75512","42866","32646","3374","78886","137947","162214","57.19","31.07"
"64","000","00","080","0001","0000","331","175","156","16","347","626","0","55.43","27.96"
"64","000","00","080","0001","1274","331","175","156","16","347","626","0","55.43","27.96"
"64","000","00","080","0002","0000","710","406","304","21","731","1434","0","50.98","28.31"
"64","000","00","080","0002","1275","396","220","176","13","409","768","0","53.26","28.65"
"64","000","00","080","0002","1276","314","186","128","8","322","666","0","48.35","27.93"
"64","000","00","080","0003","0000","654","382","272","34","688","1119","0","61.48","34.14"
"64","000","00","080","0003","1277","654","382","272","34","688","1119","0","61.48","34.14"
"64","000","00","080","0004","0000","987","615","372","76","1063","1528","0","69.57","40.25"
"64","000","00","080","0004","1278","462","267","195","34","496","743","0","66.76","35.94"
"64","000","00","080","0004","1279","525","348","177","42","567","785","0","72.23","44.33"
"64","000","00","080","0005","0000","765","412","353","38","803","1339","0","59.97","30.77"
"64","000","00","080","0005","1280","366","195","171","21","387","679","0","57.00","28.72"
"64","000","00","080","0005","1281","399","217","182","17","416","660","0","63.03","32.88"
"64","000","00","080","0006","0000","785","481","304","49","834","1336","0","62.43","36.00"
"64","000","00","080","0006","1282","395","258","137","16","411","680","0","60.44","37.94"
"64","000","00","080","0006","1283","390","223","167","33","423","656","0","64.48","33.99"
"64","000","00","080","0007","0000","758","420","338","29","787","1484","0","53.03","28.30"
"64","000","00","080","0007","1284","349","170","179","17","366","763","0","47.97","22.28"
"64","000","00","080","0007","1285","409","250","159","12","421","721","0","58.39","34.67"
"64","000","00","080","0008","0000","251","179","72","1","252","488","0","51.64","36.68"
"64","000","00","080","0008","1286","251","179","72","1","252","488","0","51.64","36.68"
"64","000","00","080","0009","0000","957","536","421","57","1014","1748","0","58.01","30.66"
"64","000","00","080","0009","1287","483","289","194","24","507","885","0","57.29","32.66"
"64","000","00","080","0009","1288","474","247","227","33","507","863","0","58.75","28.62"
"64","000","00","080","0010","0000","1547","858","689","72","1619","3602","0","44.95","23.82"
"64","000","00","080","0010","1289","497","306","191","17","514","1093","0","47.03","28.00"
"64","000","00","080","0010","1290","561","299","262","28","589","1273","0","46.27","23.49"
"64","000","00","080","0010","1291","489","253","236","27","516","1236","0","41.75","20.47"
"64","000","00","080","0011","0000","506","275","231","27","533","864","0","61.69","31.83"
"64","000","00","080","0011","1292","506","275","231","27","533","864","0","61.69","31.83"
"64","000","00","080","0012","0000","661","370","291","21","682","1205","0","56.60","30.71"
"64","000","00","080","0012","1293","661","370","291","21","682","1205","0","56.60","30.71"
"64","000","00","080","0013","0000","851","538","313","52","903","1591","0","56.76","33.82"
"64","000","00","080","0013","1294","442","277","165","30","472","813","0","58.06","34.07"
"64","000","00","080","0013","1295","409","261","148","22","431","778","0","55.40","33.55"
"64","000","00","080","0014","0000","651","355","296","31","682","1145","0","59.56","31.00"
"64","000","00","080","0014","1296","651","355","296","31","682","1145","0","59.56","31.00"
"64","000","00","080","0015","0000","976","632","344","42","1018","1605","0","63.43","39.38"
"64","000","00","080","0015","1297","465","300","165","23","488","812","0","60.10","36.95"
"64","000","00","080","0015","1298","511","332","179","19","530","793","0","66.83","41.87"
"64","000","00","080","0016","0000","548","315","233","22","570","1027","0","55.50","30.67"
"64","000","00","080","0016","1299","548","315","233","22","570","1027","0","55.50","30.67"
"64","000","00","080","0017","0000","1465","856","609","68","1533","2816","0","54.44","30.40"
"64","000","00","080","0017","1300","507","304","203","27","534","891","0","59.93","34.12"
"64","000","00","080","0017","1301","474","290","184","26","500","929","0","53.82","31.22"
"64","000","00","080","0017","1302","484","262","222","15","499","996","0","50.10","26.31"
"64","000","00","080","0018","0000","1143","672","471","58","1201","1995","0","60.20","33.68"
"64","000","00","080","0018","1303","591","377","214","20","611","1015","0","60.20","37.14"
"64","000","00","080","0018","1304","552","295","257","38","590","980","0","60.20","30.10"
"64","000","00","080","0019","0000","1530","884","646","44","1574","2823","0","55.76","31.31"
"64","000","00","080","0019","1305","509","300","209","16","525","931","0","56.39","32.22"
"64","000","00","080","0019","1306","483","277","206","14","497","941","0","52.82","29.44"
"64","000","00","080","0019","1307","538","307","231","14","552","951","0","58.04","32.28"
"64","000","00","080","0020","0000","1006","564","442","25","1031","1810","0","56.96","31.16"
"64","000","00","080","0020","1308","499","250","249","10","509","883","0","57.64","28.31"
"64","000","00","080","0020","1309","507","314","193","15","522","927","0","56.31","33.87"
"64","000","00","080","0021","0000","891","503","388","34","925","2520","0","36.71","19.96"
"64","000","00","080","0021","1310","672","384","288","31","703","1226","0","57.34","31.32"
"64","000","00","080","0021","1311","219","119","100","3","222","1294","0","17.16","9.20"
"64","000","00","080","0022","0000","1821","1051","770","59","1880","3187","0","58.99","32.98"
"64","000","00","080","0022","1312","601","331","270","13","614","1026","0","59.84","32.26"
"64","000","00","080","0022","1313","651","385","266","20","671","1200","0","55.92","32.08"
"64","000","00","080","0022","1314","569","335","234","26","595","961","0","61.91","34.86"
"64","000","00","080","0023","0000","1192","640","552","29","1221","2074","0","58.87","30.86"
"64","000","00","080","0023","1315","678","391","287","13","691","1177","0","58.71","33.22"
"64","000","00","080","0023","1316","514","249","265","16","530","897","0","59.09","27.76"
"64","000","00","080","0024","0000","1263","650","613","41","1304","2102","0","62.04","30.92"
"64","000","00","080","0024","1317","622","300","322","21","643","1047","0","61.41","28.65"
"64","000","00","080","0024","1318","641","350","291","20","661","1055","0","62.65","33.18"
"64","000","00","080","0025","0000","727","406","321","26","753","1336","0","56.36","30.39"
"64","000","00","080","0025","1319","360","215","145","12","372","660","0","56.36","32.58"
"64","000","00","080","0025","1320","367","191","176","14","381","676","0","56.36","28.25"
"64","000","00","080","0026","0000","359","221","138","12","371","638","0","58.15","34.64"
"64","000","00","080","0026","1321","359","221","138","12","371","638","0","58.15","34.64"
"64","000","00","080","0027","0000","586","374","212","29","615","1168","0","52.65","32.02"
"64","000","00","080","0027","1322","280","186","94","13","293","562","0","52.14","33.10"
"64","000","00","080","0027","1323","306","188","118","16","322","606","0","53.14","31.02"
"64","000","00","080","0028","0000","1488","870","618","66","1554","2459","0","63.20","35.38"
"64","000","00","080","0028","1324","566","343","223","29","595","949","0","62.70","36.14"
"64","000","00","080","0028","1325","493","289","204","21","514","778","0","66.07","37.15"
"64","000","00","080","0028","1326","429","238","191","16","445","732","0","60.79","32.51"
"64","000","00","080","0029","0000","809","447","362","47","856","1452","0","58.95","30.79"
"64","000","00","080","0029","1327","408","236","172","21","429","754","0","56.90","31.30"
"64","000","00","080","0029","1328","401","211","190","26","427","698","0","61.17","30.23"
"64","000","00","080","0030","0000","1421","832","589","56","1477","2614","0","56.50","31.83"
"64","000","00","080","0030","1329","442","268","174","11","453","884","0","51.24","30.32"
"64","000","00","080","0030","1330","489","292","197","13","502","871","0","57.63","33.52"
"64","000","00","080","0030","1331","490","272","218","32","522","859","0","60.77","31.66"
"64","000","00","080","0031","0000","950","477","473","27","977","1729","0","56.51","27.59"
"64","000","00","080","0031","1332","461","259","202","16","477","852","0","55.99","30.40"
"64","000","00","080","0031","1333","489","218","271","11","500","877","0","57.01","24.86"
"64","000","00","080","0032","0000","1339","678","661","62","1401","2584","0","54.22","26.24"
"64","000","00","080","0032","1334","438","210","228","26","464","814","0","57.00","25.80"
"64","000","00","080","0032","1335","428","227","201","14","442","851","0","51.94","26.67"
"64","000","00","080","0032","1336","473","241","232","22","495","919","0","53.86","26.22"
"64","000","00","080","0033","0000","1365","762","603","40","1405","2597","0","54.10","29.34"
"64","000","00","080","0033","1337","485","256","229","11","496","873","0","56.82","29.32"
"64","000","00","080","0033","1338","425","241","184","17","442","819","0","53.97","29.43"
"64","000","00","080","0033","1339","455","265","190","12","467","905","0","51.60","29.28"
"64","000","00","080","0034","0000","812","451","361","39","851","1455","0","58.49","31.00"
"64","000","00","080","0034","1340","406","229","177","20","426","713","0","59.75","32.12"
"64","000","00","080","0034","1341","406","222","184","19","425","742","0","57.28","29.92"
"64","000","00","080","0035","0000","1012","543","469","34","1046","1967","0","53.18","27.61"
"64","000","00","080","0035","1342","495","265","230","13","508","992","0","51.21","26.71"
"64","000","00","080","0035","1343","517","278","239","21","538","975","0","55.18","28.51"
"64","000","00","080","0036","0000","1074","543","531","49","1123","2019","0","55.62","26.89"
"64","000","00","080","0036","1344","516","267","249","25","541","1022","0","52.94","26.13"
"64","000","00","080","0036","1345","558","276","282","24","582","997","0","58.38","27.68"
"64","000","00","080","0037","0000","1349","745","604","47","1396","2457","0","56.82","30.32"
"64","000","00","080","0037","1346","668","392","276","21","689","1241","0","55.52","31.59"
"64","000","00","080","0037","1347","681","353","328","26","707","1216","0","58.14","29.03"
"64","000","00","080","0038","0000","777","428","349","30","807","1416","0","56.99","30.23"
"64","000","00","080","0038","1348","370","209","161","15","385","673","0","57.21","31.05"
"64","000","00","080","0038","1349","407","219","188","15","422","743","0","56.80","29.48"
"64","000","00","080","0039","0000","738","498","240","49","787","1319","0","59.67","37.76"
"64","000","00","080","0039","1350","350","228","122","22","372","665","0","55.94","34.29"
"64","000","00","080","0039","1351","388","270","118","27","415","654","0","63.46","41.28"
"64","000","00","080","0040","0000","946","587","359","58","1004","1532","0","65.54","38.32"
"64","000","00","080","0040","1352","455","284","171","26","481","732","0","65.71","38.80"
"64","000","00","080","0040","1353","491","303","188","32","523","800","0","65.38","37.88"
"64","000","00","080","0041","0000","1258","685","573","52","1310","2014","0","65.04","34.01"
"64","000","00","080","0041","1354","678","374","304","41","719","1082","0","66.45","34.57"
"64","000","00","080","0041","1355","580","311","269","11","591","932","0","63.41","33.37"
"64","000","00","080","0042","0000","1909","1079","830","75","1984","3630","0","54.66","29.72"
"64","000","00","080","0042","1356","509","304","205","22","531","954","0","55.66","31.87"
"64","000","00","080","0042","1357","410","225","185","18","428","808","0","52.97","27.85"
"64","000","00","080","0042","1358","468","282","186","12","480","875","0","54.86","32.23"
"64","000","00","080","0042","1359","522","268","254","23","545","993","0","54.88","26.99"
"64","000","00","080","0043","0000","855","473","382","43","898","1632","0","55.02","28.98"
"64","000","00","080","0043","1360","472","242","230","25","497","878","0","56.61","27.56"
"64","000","00","080","0043","1361","383","231","152","18","401","754","0","53.18","30.64"
"64","000","00","080","0044","0000","979","531","448","33","1012","1707","0","59.29","31.11"
"64","000","00","080","0044","1362","470","252","218","5","475","835","0","56.89","30.18"
"64","000","00","080","0044","1363","509","279","230","28","537","872","0","61.58","32.00"
"64","000","00","080","0045","0000","1869","1030","839","74","1943","3597","0","54.02","28.63"
"64","000","00","080","0045","1364","630","302","328","19","649","1182","0","54.91","25.55"
"64","000","00","080","0045","1365","644","377","267","29","673","1237","0","54.41","30.48"
"64","000","00","080","0045","1366","595","351","244","26","621","1178","0","52.72","29.80"
"64","000","00","080","0046","0000","1061","615","446","52","1113","1710","0","65.09","35.96"
"64","000","00","080","0046","1367","515","289","226","20","535","841","0","63.61","34.36"
"64","000","00","080","0046","1368","546","326","220","32","578","869","0","66.51","37.51"
"64","000","00","080","0047","0000","868","383","485","36","904","1465","0","61.71","26.14"
"64","000","00","080","0047","1369","436","209","227","16","452","719","0","62.87","29.07"
"64","000","00","080","0047","1370","432","174","258","20","452","746","0","60.59","23.32"
"64","000","00","080","0048","0000","792","462","330","42","834","1305","0","63.91","35.40"
"64","000","00","080","0048","1371","401","230","171","22","423","686","0","61.66","33.53"
"64","000","00","080","0048","1372","391","232","159","20","411","619","0","66.40","37.48"
"64","000","00","080","0049","0000","1343","825","518","75","1418","2549","0","55.63","32.37"
"64","000","00","080","0049","1373","715","429","286","31","746","1386","0","53.82","30.95"
"64","000","00","080","0049","1374","628","396","232","44","672","1163","0","57.78","34.05"
"64","000","00","080","0050","0000","596","339","257","33","629","1194","0","52.68","28.39"
"64","000","00","080","0050","1375","596","339","257","33","629","1194","0","52.68","28.39"
"64","000","00","080","0051","0000","533","288","245","38","571","965","0","59.17","29.84"
"64","000","00","080","0051","1376","533","288","245","38","571","965","0","59.17","29.84"
"64","000","00","080","0052","0000","1025","666","359","67","1092","1693","0","64.50","39.34"
"64","000","00","080","0052","1377","513","352","161","34","547","845","0","64.73","41.66"
"64","000","00","080","0052","1378","512","314","198","33","545","848","0","64.27","37.03"
"64","000","00","080","0053","0000","1014","582","432","67","1081","1897","0","56.98","30.68"
"64","000","00","080","0053","1379","593","349","244","38","631","1030","0","61.26","33.88"
"64","000","00","080","0053","1380","421","233","188","29","450","867","0","51.90","26.87"
"64","000","00","080","0054","0000","1276","742","534","76","1352","2448","0","55.23","30.31"
"64","000","00","080","0054","1381","644","397","247","39","683","1238","0","55.17","32.07"
"64","000","00","080","0054","1382","632","345","287","37","669","1210","0","55.29","28.51"
"64","000","00","080","0055","0000","1427","866","561","88","1515","2466","0","61.44","35.12"
"64","000","00","080","0055","1383","693","413","280","49","742","1224","0","60.62","33.74"
"64","000","00","080","0055","1384","734","453","281","39","773","1242","0","62.24","36.47"
"64","000","00","080","0056","0000","1286","724","562","50","1336","2437","0","54.82","29.71"
"64","000","00","080","0056","1385","611","355","256","26","637","1121","0","56.82","31.67"
"64","000","00","080","0056","1386","675","369","306","24","699","1316","0","53.12","28.04"
"64","000","00","080","0057","0000","944","577","367","76","1020","1714","0","59.51","33.66"
"64","000","00","080","0057","1387","477","275","202","33","510","856","0","59.58","32.13"
"64","000","00","080","0057","1388","467","302","165","43","510","858","0","59.44","35.20"
"64","000","00","080","0058","0000","1129","651","478","61","1190","1950","0","61.03","33.38"
"64","000","00","080","0058","1389","616","345","271","32","648","1006","0","64.41","34.29"
"64","000","00","080","0058","1390","513","306","207","29","542","944","0","57.42","32.42"
"64","000","00","080","0059","0000","1216","692","524","45","1261","2200","0","57.32","31.45"
"64","000","00","080","0059","1391","599","341","258","27","626","1078","0","58.07","31.63"
"64","000","00","080","0059","1392","617","351","266","18","635","1122","0","56.60","31.28"
"64","000","00","080","0060","0000","1415","814","601","35","1450","2524","0","57.45","32.25"
"64","000","00","080","0060","1393","442","235","207","6","448","818","0","54.77","28.73"
"64","000","00","080","0060","1394","420","227","193","9","429","791","0","54.24","28.70"
"64","000","00","080","0060","1395","553","352","201","20","573","915","0","62.62","38.47"
"64","000","00","080","0061","0000","2359","1276","1083","106","2465","4577","0","53.86","27.88"
"64","000","00","080","0061","1396","618","332","286","28","646","1190","0","54.29","27.90"
"64","000","00","080","0061","1397","574","296","278","24","598","979","0","61.08","30.23"
"64","000","00","080","0061","1398","556","330","226","24","580","1160","0","50.00","28.45"
"64","000","00","080","0061","1399","611","318","293","30","641","1248","0","51.36","25.48"
"64","000","00","080","0062","0000","1968","1095","873","71","2039","3392","0","60.11","32.28"
"64","000","00","080","0062","1400","692","365","327","20","712","1141","0","62.40","31.99"
"64","000","00","080","0062","1401","643","364","279","22","665","1123","0","59.22","32.41"
"64","000","00","080","0062","1402","633","366","267","29","662","1128","0","58.69","32.45"
"64","000","00","080","0063","0000","1832","1034","798","68","1900","3242","0","58.61","31.89"
"64","000","00","080","0063","1403","641","362","279","19","660","1097","0","60.16","33.00"
"64","000","00","080","0063","1404","604","350","254","23","627","1084","0","57.84","32.29"
"64","000","00","080","0063","1405","587","322","265","26","613","1061","0","57.78","30.35"
"64","000","00","080","0064","0000","1911","1023","888","101","2012","3823","0","52.63","26.76"
"64","000","00","080","0064","1406","610","326","284","48","658","1292","0","50.93","25.23"
"64","000","00","080","0064","1407","617","337","280","35","652","1261","0","51.70","26.72"
"64","000","00","080","0064","1408","684","360","324","18","702","1270","0","55.28","28.35"
"64","000","00","080","0065","0000","1226","754","472","39","1265","2210","0","57.24","34.12"
"64","000","00","080","0065","1409","554","342","212","14","568","1091","0","52.06","31.35"
"64","000","00","080","0065","1410","672","412","260","25","697","1119","0","62.29","36.82"
"64","000","00","080","0066","0000","1341","700","641","45","1386","2290","0","60.52","30.57"
"64","000","00","080","0066","1411","673","349","324","22","695","1133","0","61.34","30.80"
"64","000","00","080","0066","1412","668","351","317","23","691","1157","0","59.72","30.34"
"64","000","00","080","0067","0000","1978","1157","821","109","2087","3422","0","60.99","33.81"
"64","000","00","080","0067","1413","665","380","285","40","705","1142","0","61.73","33.27"
"64","000","00","080","0067","1414","667","391","276","32","699","1148","0","60.89","34.06"
"64","000","00","080","0067","1415","646","386","260","37","683","1132","0","60.34","34.10"
"64","000","00","080","0068","0000","1144","668","476","51","1195","1855","0","64.42","36.01"
"64","000","00","080","0068","1416","542","334","208","26","568","873","0","65.06","38.26"
"64","000","00","080","0068","1417","602","334","268","25","627","982","0","63.85","34.01"
"64","000","00","080","0069","0000","957","504","453","49","1006","1829","0","55.00","27.56"
"64","000","00","080","0069","1418","499","269","230","24","523","920","0","56.85","29.24"
"64","000","00","080","0069","1419","458","235","223","25","483","909","0","53.14","25.85"
"64","000","00","090","0000","0000","84406","49954","34452","4882","89288","153711","180047","58.09","32.50"
"64","000","00","090","0001","0000","4237","2674","1563","297","4534","8872","0","51.10","30.14"
"64","000","00","090","0001","1652","444","299","145","36","480","884","0","54.30","33.82"
"64","000","00","090","0001","1653","430","232","198","38","468","825","0","56.73","28.12"
"64","000","00","090","0001","1654","576","360","216","31","607","1176","0","51.62","30.61"
"64","000","00","090","0001","1655","574","355","219","34","608","1163","0","52.28","30.52"
"64","000","00","090","0001","1656","544","349","195","26","570","1201","0","47.46","29.06"
"64","000","00","090","0001","1657","510","337","173","29","539","1145","0","47.07","29.43"
"64","000","00","090","0001","1658","592","367","225","57","649","1219","0","53.24","30.11"
"64","000","00","090","0001","1659","567","375","192","46","613","1259","0","48.69","29.79"
"64","000","00","090","0002","0000","1339","865","474","110","1449","2208","0","65.63","39.18"
"64","000","00","090","0002","1660","508","326","182","27","535","797","0","67.13","40.90"
"64","000","00","090","0002","1661","479","316","163","37","516","784","0","65.82","40.31"
"64","000","00","090","0002","1662","352","223","129","46","398","627","0","63.48","35.57"
"64","000","00","090","0003","0000","2642","1694","948","173","2815","4806","0","58.57","35.25"
"64","000","00","090","0003","1663","581","397","184","42","623","1046","0","59.56","37.95"
"64","000","00","090","0003","1664","516","297","219","25","541","966","0","56.00","30.75"
"64","000","00","090","0003","1665","570","379","191","50","620","999","0","62.06","37.94"
"64","000","00","090","0003","1666","416","270","146","18","434","768","0","56.51","35.16"
"64","000","00","090","0003","1667","559","351","208","38","597","1027","0","58.13","34.18"
"64","000","00","090","0004","0000","1253","751","502","116","1369","2135","0","64.12","35.18"
"64","000","00","090","0004","1668","595","321","274","67","662","1013","0","65.35","31.69"
"64","000","00","090","0004","1669","658","430","228","49","707","1122","0","63.01","38.32"
"64","000","00","090","0005","0000","758","496","262","88","846","1230","0","68.78","40.33"
"64","000","00","090","0005","1670","758","496","262","88","846","1230","0","68.78","40.33"
"64","000","00","090","0006","0000","1025","609","416","86","1111","1810","0","61.38","33.65"
"64","000","00","090","0006","1671","539","340","199","49","588","914","0","64.33","37.20"
"64","000","00","090","0006","1672","486","269","217","37","523","896","0","58.37","30.02"
"64","000","00","090","0007","0000","1007","669","338","56","1063","2800","0","37.96","23.89"
"64","000","00","090","0007","1673","589","385","204","36","625","1140","0","54.82","33.77"
"64","000","00","090","0007","1674","418","284","134","20","438","1660","0","26.39","17.11"
"64","000","00","090","0008","0000","298","204","94","16","314","585","0","53.68","34.87"
"64","000","00","090","0008","1675","298","204","94","16","314","585","0","53.68","34.87"
"64","000","00","090","0009","0000","723","511","212","50","773","1385","0","55.81","36.90"
"64","000","00","090","0009","1676","723","511","212","50","773","1385","0","55.81","36.90"
"64","000","00","090","0010","0000","807","551","256","47","854","1325","0","64.45","41.58"
"64","000","00","090","0010","1677","807","551","256","47","854","1325","0","64.45","41.58"
"64","000","00","090","0011","0000","1071","649","422","116","1187","2126","0","55.83","30.53"
"64","000","00","090","0011","1678","479","296","183","59","538","913","0","58.93","32.42"
"64","000","00","090","0011","1679","592","353","239","57","649","1213","0","53.50","29.10"
"64","000","00","090","0012","0000","614","427","187","48","662","1000","0","66.20","42.70"
"64","000","00","090","0012","1680","614","427","187","48","662","1000","0","66.20","42.70"
"64","000","00","090","0013","0000","345","247","98","47","392","624","0","62.82","39.58"
"64","000","00","090","0013","1681","345","247","98","47","392","624","0","62.82","39.58"
"64","000","00","090","0014","0000","426","290","136","26","452","656","0","68.90","44.21"
"64","000","00","090","0014","1682","426","290","136","26","452","656","0","68.90","44.21"
"64","000","00","090","0015","0000","802","565","237","68","870","1218","0","71.43","46.39"
"64","000","00","090","0015","1683","802","565","237","68","870","1218","0","71.43","46.39"
"64","000","00","090","0016","0000","951","647","304","55","1006","1572","0","63.99","41.16"
"64","000","00","090","0016","1684","491","322","169","27","518","788","0","65.74","40.86"
"64","000","00","090","0016","1685","460","325","135","28","488","784","0","62.24","41.45"
"64","000","00","090","0017","0000","1065","703","362","98","1163","1924","0","60.45","36.54"
"64","000","00","090","0017","1686","539","371","168","50","589","943","0","62.46","39.34"
"64","000","00","090","0017","1687","526","332","194","48","574","981","0","58.51","33.84"
"64","000","00","090","0018","0000","1070","705","365","119","1189","1842","0","64.55","38.27"
"64","000","00","090","0018","1688","578","383","195","47","625","963","0","64.90","39.77"
"64","000","00","090","0018","1689","492","322","170","72","564","879","0","64.16","36.63"
"64","000","00","090","0019","0000","2241","1394","847","140","2381","3812","0","62.46","36.57"
"64","000","00","090","0019","1690","746","495","251","61","807","1242","0","64.98","39.86"
"64","000","00","090","0019","1691","801","498","303","38","839","1335","0","62.85","37.30"
"64","000","00","090","0019","1692","694","401","293","41","735","1235","0","59.51","32.47"
"64","000","00","090","0020","0000","449","270","179","45","494","879","0","56.20","30.72"
"64","000","00","090","0020","1693","449","270","179","45","494","879","0","56.20","30.72"
"64","000","00","090","0021","0000","1585","870","715","58","1643","2685","0","61.19","32.40"
"64","000","00","090","0021","1694","827","440","387","26","853","1353","0","63.05","32.52"
"64","000","00","090","0021","1695","758","430","328","32","790","1332","0","59.31","32.28"
"64","000","00","090","0022","0000","523","337","186","47","570","793","0","71.88","42.50"
"64","000","00","090","0022","1696","523","337","186","47","570","793","0","71.88","42.50"
"64","000","00","090","0023","0000","617","386","231","34","651","1062","0","61.30","36.35"
"64","000","00","090","0023","1697","617","386","231","34","651","1062","0","61.30","36.35"
"64","000","00","090","0024","0000","2867","1099","1768","138","3005","4979","0","60.35","22.07"
"64","000","00","090","0024","1698","708","200","508","44","752","1165","0","64.55","17.17"
"64","000","00","090","0024","1699","793","261","532","51","844","1320","0","63.94","19.77"
"64","000","00","090","0024","1700","615","210","405","25","640","1094","0","58.50","19.20"
"64","000","00","090","0024","1701","751","428","323","18","769","1400","0","54.93","30.57"
"64","000","00","090","0025","0000","1074","334","740","77","1151","1873","0","61.45","17.83"
"64","000","00","090","0025","1702","582","179","403","44","626","964","0","64.94","18.57"
"64","000","00","090","0025","1703","492","155","337","33","525","909","0","57.76","17.05"
"64","000","00","090","0028","0000","1700","948","752","83","1783","3086","0","57.78","30.72"
"64","000","00","090","0028","1704","513","312","201","31","544","959","0","56.73","32.53"
"64","000","00","090","0028","1705","645","363","282","18","663","1144","0","57.95","31.73"
"64","000","00","090","0028","1706","542","273","269","34","576","983","0","58.60","27.77"
"64","000","00","090","0029","0000","1999","1053","946","81","2080","3690","0","56.37","28.54"
"64","000","00","090","0029","1707","639","369","270","35","674","1179","0","57.17","31.30"
"64","000","00","090","0029","1708","753","379","374","32","785","1279","0","61.38","29.63"
"64","000","00","090","0029","1709","607","305","302","14","621","1232","0","50.41","24.76"
"64","000","00","090","0030","0000","682","386","296","43","725","1208","0","60.02","31.95"
"64","000","00","090","0030","1710","682","386","296","43","725","1208","0","60.02","31.95"
"64","000","00","090","0031","0000","1264","685","579","53","1317","2210","0","59.59","31.00"
"64","000","00","090","0031","1711","626","345","281","28","654","1051","0","62.23","32.83"
"64","000","00","090","0031","1712","638","340","298","25","663","1159","0","57.20","29.34"
"64","000","00","090","0032","0000","1426","720","706","34","1460","2604","0","56.07","27.65"
"64","000","00","090","0032","1713","747","390","357","24","771","1365","0","56.48","28.57"
"64","000","00","090","0032","1714","679","330","349","10","689","1239","0","55.61","26.63"
"64","000","00","090","0033","0000","1075","640","435","78","1153","1959","0","58.86","32.67"
"64","000","00","090","0033","1715","557","351","206","48","605","955","0","63.35","36.75"
"64","000","00","090","0033","1716","518","289","229","30","548","1004","0","54.58","28.78"
"64","000","00","090","0034","0000","1355","695","660","77","1432","2526","0","56.69","27.51"
"64","000","00","090","0034","1717","708","357","351","42","750","1284","0","58.41","27.80"
"64","000","00","090","0034","1718","647","338","309","35","682","1242","0","54.91","27.21"
"64","000","00","090","0035","0000","1443","823","620","77","1520","2875","0","52.87","28.63"
"64","000","00","090","0035","1719","732","418","314","47","779","1432","0","54.40","29.19"
"64","000","00","090","0035","1720","711","405","306","30","741","1443","0","51.35","28.07"
"64","000","00","090","0036","0000","1358","816","542","97","1455","2859","0","50.89","28.54"
"64","000","00","090","0036","1721","493","287","206","37","530","1014","0","52.27","28.30"
"64","000","00","090","0036","1722","480","292","188","35","515","960","0","53.65","30.42"
"64","000","00","090","0036","1723","385","237","148","25","410","885","0","46.33","26.78"
"64","000","00","090","0037","0000","2723","1505","1218","105","2828","5365","0","52.71","28.05"
"64","000","00","090","0037","1724","643","396","247","31","674","1294","0","52.09","30.60"
"64","000","00","090","0037","1725","667","342","325","18","685","1212","0","56.52","28.22"
"64","000","00","090","0037","1726","734","425","309","40","774","1524","0","50.79","27.89"
"64","000","00","090","0037","1727","679","342","337","16","695","1335","0","52.06","25.62"
"64","000","00","090","0038","0000","1716","904","812","81","1797","3090","0","58.16","29.26"
"64","000","00","090","0038","1728","926","486","440","27","953","1743","0","54.68","27.88"
"64","000","00","090","0038","1729","790","418","372","54","844","1347","0","62.66","31.03"
"64","000","00","090","0039","0000","1291","783","508","66","1357","2448","0","55.43","31.99"
"64","000","00","090","0039","1730","633","400","233","45","678","1229","0","55.17","32.55"
"64","000","00","090","0039","1731","658","383","275","21","679","1219","0","55.70","31.42"
"64","000","00","090","0040","0000","1496","921","575","90","1586","2513","0","63.11","36.65"
"64","000","00","090","0040","1732","748","455","293","48","796","1260","0","63.17","36.11"
"64","000","00","090","0040","1733","748","466","282","42","790","1253","0","63.05","37.19"
"64","000","00","090","0041","0000","1003","605","398","53","1056","2004","0","52.69","30.19"
"64","000","00","090","0041","1734","502","301","201","18","520","991","0","52.47","30.37"
"64","000","00","090","0041","1735","501","304","197","35","536","1013","0","52.91","30.01"
"64","000","00","090","0042","0000","3497","1981","1516","115","3612","6409","0","56.36","30.91"
"64","000","00","090","0042","1736","777","491","286","24","801","1361","0","58.85","36.08"
"64","000","00","090","0042","1737","799","452","347","41","840","1456","0","57.69","31.04"
"64","000","00","090","0042","1738","595","321","274","10","605","1044","0","57.95","30.75"
"64","000","00","090","0042","1739","686","373","313","18","704","1338","0","52.62","27.88"
"64","000","00","090","0042","1740","640","344","296","22","662","1210","0","54.71","28.43"
"64","000","00","090","0043","0000","1370","782","588","67","1437","2382","0","60.33","32.83"
"64","000","00","090","0043","1741","713","399","314","20","733","1220","0","60.08","32.70"
"64","000","00","090","0043","1742","657","383","274","47","704","1162","0","60.59","32.96"
"64","000","00","090","0044","0000","2033","1097","936","65","2098","3800","0","55.21","28.87"
"64","000","00","090","0044","1743","738","415","323","24","762","1348","0","56.53","30.79"
"64","000","00","090","0044","1744","629","345","284","24","653","1212","0","53.88","28.47"
"64","000","00","090","0044","1745","666","337","329","17","683","1240","0","55.08","27.18"
"64","000","00","090","0045","0000","1844","1065","779","94","1938","3221","0","60.17","33.06"
"64","000","00","090","0045","1746","648","370","278","30","678","1139","0","59.53","32.48"
"64","000","00","090","0045","1747","543","325","218","25","568","946","0","60.04","34.36"
"64","000","00","090","0045","1748","653","370","283","39","692","1136","0","60.92","32.57"
"64","000","00","090","0046","0000","1008","625","383","48","1056","1868","0","56.53","33.46"
"64","000","00","090","0046","1749","516","345","171","30","546","953","0","57.29","36.20"
"64","000","00","090","0046","1750","492","280","212","18","510","915","0","55.74","30.60"
"64","000","00","090","0047","0000","2333","1430","903","161","2494","4333","0","57.56","33.00"
"64","000","00","090","0047","1751","519","335","184","36","555","1022","0","54.31","32.78"
"64","000","00","090","0047","1752","646","422","224","51","697","1134","0","61.46","37.21"
"64","000","00","090","0047","1753","503","297","206","49","552","928","0","59.48","32.00"
"64","000","00","090","0047","1754","665","376","289","25","690","1249","0","55.24","30.10"
"64","000","00","090","0048","0000","1467","848","619","92","1559","2504","0","62.26","33.87"
"64","000","00","090","0048","1755","749","436","313","53","802","1265","0","63.40","34.47"
"64","000","00","090","0048","1756","718","412","306","39","757","1239","0","61.10","33.25"
"64","000","00","090","0049","0000","2343","1340","1003","109","2452","4189","0","58.53","31.99"
"64","000","00","090","0049","1757","548","315","233","31","579","1019","0","56.82","30.91"
"64","000","00","090","0049","1758","643","374","269","34","677","1162","0","58.26","32.19"
"64","000","00","090","0049","1759","549","304","245","20","569","968","0","58.78","31.40"
"64","000","00","090","0049","1760","603","347","256","24","627","1040","0","60.29","33.37"
"64","000","00","090","0050","0000","1086","702","384","71","1157","2115","0","54.70","33.19"
"64","000","00","090","0050","1761","583","378","205","44","627","1124","0","55.78","33.63"
"64","000","00","090","0050","1762","503","324","179","27","530","991","0","53.48","32.69"
"64","000","00","090","0051","0000","936","585","351","63","999","1712","0","58.35","34.17"
"64","000","00","090","0051","1763","447","263","184","38","485","861","0","56.33","30.55"
"64","000","00","090","0051","1764","489","322","167","25","514","851","0","60.40","37.84"
"64","000","00","090","0052","0000","1972","1195","777","93","2065","3250","0","63.54","36.77"
"64","000","00","090","0052","1765","664","396","268","45","709","1027","0","69.04","38.56"
"64","000","00","090","0052","1766","627","411","216","24","651","1007","0","64.65","40.81"
"64","000","00","090","0052","1767","681","388","293","24","705","1216","0","57.98","31.91"
"64","000","00","090","0053","0000","1815","1110","705","87","1902","3263","0","58.29","34.02"
"64","000","00","090","0053","1768","601","375","226","36","637","1059","0","60.15","35.41"
"64","000","00","090","0053","1769","524","329","195","15","539","969","0","55.62","33.95"
"64","000","00","090","0053","1770","690","406","284","36","726","1235","0","58.79","32.87"
"64","000","00","090","0054","0000","1724","1091","633","82","1806","3095","0","58.35","35.25"
"64","000","00","090","0054","1771","857","569","288","33","890","1526","0","58.32","37.29"
"64","000","00","090","0054","1772","867","522","345","49","916","1569","0","58.38","33.27"
"64","000","00","090","0055","0000","1542","1026","516","88","1630","2415","0","67.49","42.48"
"64","000","00","090","0055","1773","742","496","246","62","804","1222","0","65.79","40.59"
"64","000","00","090","0055","1774","800","530","270","26","826","1193","0","69.24","44.43"
"64","000","00","090","0056","0000","1295","782","513","47","1342","2389","0","56.17","32.73"
"64","000","00","090","0056","1775","657","382","275","25","682","1102","0","61.89","34.66"
"64","000","00","090","0056","1776","638","400","238","22","660","1287","0","51.28","31.08"
"64","000","00","090","0057","0000","1427","912","515","92","1519","2364","0","64.26","38.58"
"64","000","00","090","0057","1777","689","427","262","30","719","1153","0","62.36","37.03"
"64","000","00","090","0057","1778","738","485","253","62","800","1211","0","66.06","40.05"
"64","000","00","090","0058","0000","1370","818","552","71","1441","2420","0","59.55","33.80"
"64","000","00","090","0058","1779","705","413","292","39","744","1279","0","58.17","32.29"
"64","000","00","090","0058","1780","665","405","260","32","697","1141","0","61.09","35.50"
"64","000","00","090","0059","0000","1269","810","459","80","1349","2228","0","60.55","36.36"
"64","000","00","090","0059","1781","596","355","241","53","649","1071","0","60.60","33.15"
"64","000","00","090","0059","1782","673","455","218","27","700","1157","0","60.50","39.33"
"64","000","00","090","0060","0000","2122","1310","812","90","2212","4176","0","52.97","31.37"
"64","000","00","090","0060","1783","669","387","282","31","700","1317","0","53.15","29.38"
"64","000","00","090","0060","1784","718","496","222","36","754","1386","0","54.40","35.79"
"64","000","00","090","0060","1785","735","427","308","23","758","1473","0","51.46","28.99"
"64","000","00","090","0061","0000","1633","1014","619","94","1727","2940","0","58.74","34.49"
"64","000","00","090","0061","1786","493","295","198","24","517","944","0","54.77","31.25"
"64","000","00","090","0061","1787","489","343","146","33","522","870","0","60.00","39.43"
"64","000","00","090","0061","1788","651","376","275","37","688","1126","0","61.10","33.39"
"64","000","00","100","0000","0000","12211","8052","4159","1267","13478","23237","26760","58.00","34.65"
"64","000","00","100","0001","0000","629","426","203","65","694","1122","0","61.85","37.97"
"64","000","00","100","0001","0969","629","426","203","65","694","1122","0","61.85","37.97"
"64","000","00","100","0002","0000","480","284","196","41","521","982","0","53.05","28.92"
"64","000","00","100","0002","0970","480","284","196","41","521","982","0","53.05","28.92"
"64","000","00","100","0003","0000","773","522","251","68","841","1460","0","57.60","35.75"
"64","000","00","100","0003","0971","773","522","251","68","841","1460","0","57.60","35.75"
"64","000","00","100","0004","0000","988","693","295","98","1086","2159","0","50.30","32.10"
"64","000","00","100","0004","0972","519","353","166","51","570","1121","0","50.85","31.49"
"64","000","00","100","0004","0973","469","340","129","47","516","1038","0","49.71","32.76"
"64","000","00","100","0005","0000","1264","749","515","171","1435","2755","0","52.09","27.19"
"64","000","00","100","0005","0974","624","397","227","67","691","1326","0","52.11","29.94"
"64","000","00","100","0005","0975","640","352","288","104","744","1429","0","52.06","24.63"
"64","000","00","100","0006","0000","859","577","282","104","963","1433","0","67.20","40.27"
"64","000","00","100","0006","0976","859","577","282","104","963","1433","0","67.20","40.27"
"64","000","00","100","0007","0000","615","310","305","60","675","1350","0","50.00","22.96"
"64","000","00","100","0007","0977","615","310","305","60","675","1350","0","50.00","22.96"
"64","000","00","100","0008","0000","1232","761","471","140","1372","2465","0","55.66","30.87"
"64","000","00","100","0008","0978","630","368","262","84","714","1277","0","55.91","28.82"
"64","000","00","100","0008","0979","602","393","209","56","658","1188","0","55.39","33.08"
"64","000","00","100","0009","0000","1069","741","328","59","1128","1962","0","57.49","37.77"
"64","000","00","100","0009","0980","438","292","146","21","459","940","0","48.83","31.06"
"64","000","00","100","0009","0981","631","449","182","38","669","1022","0","65.46","43.93"
"64","000","00","100","0010","0000","1450","995","455","143","1593","2610","0","61.03","38.12"
"64","000","00","100","0010","0982","608","433","175","58","666","1054","0","63.19","41.08"
"64","000","00","100","0010","0983","842","562","280","85","927","1556","0","59.58","36.12"
"64","000","00","100","0011","0000","928","653","275","105","1033","1718","0","60.13","38.01"
"64","000","00","100","0011","0984","532","389","143","70","602","985","0","61.12","39.49"
"64","000","00","100","0011","0985","396","264","132","35","431","733","0","58.80","36.02"
"64","000","00","100","0012","0000","519","376","143","46","565","841","0","67.18","44.71"
"64","000","00","100","0012","0986","519","376","143","46","565","841","0","67.18","44.71"
"64","000","00","100","0013","0000","1405","965","440","167","1572","2380","0","66.05","40.55"
"64","000","00","100","0013","0987","710","507","203","88","798","1153","0","69.21","43.97"
"64","000","00","100","0013","0988","695","458","237","79","774","1227","0","63.08","37.33"
"64","000","00","110","0000","0000","69267","41051","28216","3824","73091","128907","154713","56.70","31.85"
"64","000","00","110","0001","0000","1293","792","501","72","1365","2128","0","64.14","37.22"
"64","000","00","110","0001","1789","652","352","300","25","677","1044","0","64.85","33.72"
"64","000","00","110","0001","1790","641","440","201","47","688","1084","0","63.47","40.59"
"64","000","00","110","0002","0000","1698","931","767","59","1757","2918","0","60.21","31.91"
"64","000","00","110","0002","1791","851","468","383","15","866","1388","0","62.39","33.72"
"64","000","00","110","0002","1792","847","463","384","44","891","1530","0","58.24","30.26"
"64","000","00","110","0003","0000","1263","652","611","59","1322","2325","0","56.86","28.04"
"64","000","00","110","0003","1793","606","301","305","25","631","1059","0","59.58","28.42"
"64","000","00","110","0003","1794","657","351","306","34","691","1266","0","54.58","27.73"
"64","000","00","110","0004","0000","777","435","342","42","819","1576","0","51.97","27.60"
"64","000","00","110","0004","1795","777","435","342","42","819","1576","0","51.97","27.60"
"64","000","00","110","0005","0000","1418","851","567","84","1502","2884","0","52.08","29.51"
"64","000","00","110","0005","1796","714","439","275","38","752","1432","0","52.51","30.66"
"64","000","00","110","0005","1797","704","412","292","46","750","1452","0","51.65","28.37"
"64","000","00","110","0006","0000","1330","808","522","83","1413","2449","0","57.70","32.99"
"64","000","00","110","0006","1798","636","402","234","38","674","1163","0","57.95","34.57"
"64","000","00","110","0006","1799","694","406","288","45","739","1286","0","57.47","31.57"
"64","000","00","110","0007","0000","1483","871","612","59","1542","2939","0","52.47","29.64"
"64","000","00","110","0007","1800","700","426","274","20","720","1661","0","43.35","25.65"
"64","000","00","110","0007","1801","783","445","338","39","822","1278","0","64.32","34.82"
"64","000","00","110","0008","0000","1120","678","442","91","1211","2084","0","58.11","32.53"
"64","000","00","110","0008","1802","615","385","230","47","662","1083","0","61.13","35.55"
"64","000","00","110","0008","1803","505","293","212","44","549","1001","0","54.85","29.27"
"64","000","00","110","0009","0000","1217","736","481","57","1274","2499","0","50.98","29.45"
"64","000","00","110","0009","1804","657","375","282","34","691","1325","0","52.15","28.30"
"64","000","00","110","0009","1805","560","361","199","23","583","1174","0","49.66","30.75"
"64","000","00","110","0010","0000","2657","1605","1052","148","2805","5411","0","51.84","29.66"
"64","000","00","110","0010","1806","769","448","321","39","808","1470","0","54.97","30.48"
"64","000","00","110","0010","1807","612","363","249","41","653","1238","0","52.75","29.32"
"64","000","00","110","0010","1808","613","385","228","48","661","1345","0","49.14","28.62"
"64","000","00","110","0010","1809","663","409","254","20","683","1358","0","50.29","30.12"
"64","000","00","110","0011","0000","1327","760","567","64","1391","2300","0","60.48","33.04"
"64","000","00","110","0011","1810","658","375","283","38","696","1132","0","61.48","33.13"
"64","000","00","110","0011","1811","669","385","284","26","695","1168","0","59.50","32.96"
"64","000","00","110","0012","0000","1883","1159","724","103","1986","3407","0","58.29","34.02"
"64","000","00","110","0012","1812","682","417","265","36","718","1250","0","57.44","33.36"
"64","000","00","110","0012","1813","604","385","219","32","636","1066","0","59.66","36.12"
"64","000","00","110","0012","1814","597","357","240","35","632","1091","0","57.93","32.72"
"64","000","00","110","0013","0000","1530","915","615","62","1592","2624","0","60.67","34.87"
"64","000","00","110","0013","1815","734","434","300","25","759","1338","0","56.73","32.44"
"64","000","00","110","0013","1816","796","481","315","37","833","1286","0","64.77","37.40"
"64","000","00","110","0014","0000","1990","1070","920","88","2078","3729","0","55.73","28.69"
"64","000","00","110","0014","1817","677","357","320","36","713","1302","0","54.76","27.42"
"64","000","00","110","0014","1818","629","344","285","30","659","1213","0","54.33","28.36"
"64","000","00","110","0014","1819","684","369","315","22","706","1214","0","58.15","30.40"
"64","000","00","110","0015","0000","2089","1208","881","89","2178","4233","0","51.45","28.54"
"64","000","00","110","0015","1820","710","439","271","30","740","1477","0","50.10","29.72"
"64","000","00","110","0015","1821","683","406","277","36","719","1352","0","53.18","30.03"
"64","000","00","110","0015","1822","696","363","333","23","719","1404","0","51.21","25.85"
"64","000","00","110","0016","0000","1369","795","574","69","1438","2397","0","59.99","33.17"
"64","000","00","110","0016","1823","697","413","284","36","733","1194","0","61.39","34.59"
"64","000","00","110","0016","1824","672","382","290","33","705","1203","0","58.60","31.75"
"64","000","00","110","0017","0000","1630","900","730","104","1734","3041","0","57.02","29.60"
"64","000","00","110","0017","1825","808","435","373","67","875","1504","0","58.18","28.92"
"64","000","00","110","0017","1826","822","465","357","37","859","1537","0","55.89","30.25"
"64","000","00","110","0018","0000","1570","844","726","114","1684","2815","0","59.82","29.98"
"64","000","00","110","0018","1827","819","454","365","71","890","1452","0","61.29","31.27"
"64","000","00","110","0018","1828","751","390","361","43","794","1363","0","58.25","28.61"
"64","000","00","110","0019","0000","1197","577","620","57","1254","2216","0","56.59","26.04"
"64","000","00","110","0019","1829","617","280","337","36","653","1102","0","59.26","25.41"
"64","000","00","110","0019","1830","580","297","283","21","601","1114","0","53.95","26.66"
"64","000","00","110","0020","0000","2215","1161","1054","119","2334","3891","0","59.98","29.84"
"64","000","00","110","0020","1831","772","405","367","41","813","1357","0","59.91","29.85"
"64","000","00","110","0020","1832","797","397","400","42","839","1356","0","61.87","29.28"
"64","000","00","110","0020","1833","646","359","287","36","682","1178","0","57.89","30.48"
"64","000","00","110","0021","0000","1822","1041","781","101","1923","3090","0","62.23","33.69"
"64","000","00","110","0021","1834","925","539","386","51","976","1498","0","65.15","35.98"
"64","000","00","110","0021","1835","897","502","395","50","947","1592","0","59.48","31.53"
"64","000","00","110","0022","0000","5813","3493","2320","273","6086","10940","0","55.63","31.93"
"64","000","00","110","0022","1836","589","373","216","36","625","1233","0","50.69","30.25"
"64","000","00","110","0022","1837","772","427","345","37","809","1308","0","61.85","32.65"
"64","000","00","110","0022","1838","674","416","258","42","716","1243","0","57.60","33.47"
"64","000","00","110","0022","1839","810","482","328","43","853","1552","0","54.96","31.06"
"64","000","00","110","0022","1840","860","520","340","27","887","1501","0","59.09","34.64"
"64","000","00","110","0022","1841","683","403","280","20","703","1257","0","55.93","32.06"
"64","000","00","110","0022","1842","799","469","330","40","839","1370","0","61.24","34.23"
"64","000","00","110","0022","1843","626","403","223","28","654","1476","0","44.31","27.30"
"64","000","00","110","0023","0000","2336","1379","957","118","2454","4119","0","59.58","33.48"
"64","000","00","110","0023","1844","678","403","275","42","720","1306","0","55.13","30.86"
"64","000","00","110","0023","1845","901","534","367","36","937","1457","0","64.31","36.65"
"64","000","00","110","0023","1846","757","442","315","40","797","1356","0","58.78","32.60"
"64","000","00","110","0024","0000","1239","720","519","79","1318","2432","0","54.19","29.61"
"64","000","00","110","0024","1847","641","350","291","47","688","1183","0","58.16","29.59"
"64","000","00","110","0024","1848","598","370","228","32","630","1249","0","50.44","29.62"
"64","000","00","110","0025","0000","1770","1033","737","89","1859","3034","0","61.27","34.05"
"64","000","00","110","0025","1849","935","530","405","50","985","1618","0","60.88","32.76"
"64","000","00","110","0025","1850","835","503","332","39","874","1416","0","61.72","35.52"
"64","000","00","110","0026","0000","1364","855","509","95","1459","2773","0","52.61","30.83"
"64","000","00","110","0026","1851","640","407","233","69","709","1260","0","56.27","32.30"
"64","000","00","110","0026","1852","724","448","276","26","750","1513","0","49.57","29.61"
"64","000","00","110","0027","0000","2973","1821","1152","154","3127","5950","0","52.55","30.61"
"64","000","00","110","0027","1853","603","416","187","31","634","1140","0","55.61","36.49"
"64","000","00","110","0027","1854","571","331","240","28","599","1180","0","50.76","28.05"
"64","000","00","110","0027","1855","603","381","222","32","635","1139","0","55.75","33.45"
"64","000","00","110","0027","1856","548","313","235","33","581","1140","0","50.96","27.46"
"64","000","00","110","0027","1857","648","380","268","30","678","1351","0","50.19","28.13"
"64","000","00","110","0028","0000","2483","1485","998","94","2577","4567","0","56.43","32.52"
"64","000","00","110","0028","1858","820","523","297","28","848","1188","0","71.38","44.02"
"64","000","00","110","0028","1859","564","367","197","10","574","1198","0","47.91","30.63"
"64","000","00","110","0028","1860","590","317","273","34","624","1150","0","54.26","27.57"
"64","000","00","110","0028","1861","509","278","231","22","531","1031","0","51.50","26.96"
"64","000","00","110","0029","0000","1921","1123","798","92","2013","3750","0","53.68","29.95"
"64","000","00","110","0029","1862","717","408","309","42","759","1355","0","56.01","30.11"
"64","000","00","110","0029","1863","617","377","240","40","657","1092","0","60.16","34.52"
"64","000","00","110","0029","1864","587","338","249","10","597","1303","0","45.82","25.94"
"64","000","00","110","0030","0000","1642","1032","610","102","1744","2500","0","69.76","41.28"
"64","000","00","110","0030","1865","773","493","280","41","814","1137","0","71.59","43.36"
"64","000","00","110","0030","1866","869","539","330","61","930","1363","0","68.23","39.55"
"64","000","00","110","0031","0000","3995","2444","1551","183","4178","7399","0","56.47","33.03"
"64","000","00","110","0031","1867","803","513","290","34","837","1491","0","56.14","34.41"
"64","000","00","110","0031","1868","839","502","337","35","874","1512","0","57.80","33.20"
"64","000","00","110","0031","1869","865","527","338","42","907","1519","0","59.71","34.69"
"64","000","00","110","0031","1870","730","435","295","32","762","1406","0","54.20","30.94"
"64","000","00","110","0031","1871","758","467","291","40","798","1471","0","54.25","31.75"
"64","000","00","110","0032","0000","2034","1224","810","135","2169","3482","0","62.29","35.15"
"64","000","00","110","0032","1872","628","404","224","53","681","1028","0","66.25","39.30"
"64","000","00","110","0032","1873","738","433","305","41","779","1260","0","61.83","34.37"
"64","000","00","110","0032","1874","668","387","281","41","709","1194","0","59.38","32.41"
"64","000","00","110","0033","0000","1535","923","612","151","1686","3029","0","55.66","30.47"
"64","000","00","110","0033","1875","669","410","259","49","718","1367","0","52.52","29.99"
"64","000","00","110","0033","1876","866","513","353","102","968","1662","0","58.24","30.87"
"64","000","00","110","0034","0000","1380","856","524","127","1507","2971","0","50.72","28.81"
"64","000","00","110","0034","1877","660","417","243","45","705","1466","0","48.09","28.44"
"64","000","00","110","0034","1878","720","439","281","82","802","1505","0","53.29","29.17"
"64","000","00","110","0035","0000","1221","751","470","97","1318","2129","0","61.91","35.27"
"64","000","00","110","0035","1879","574","353","221","55","629","1028","0","61.19","34.34"
"64","000","00","110","0035","1880","647","398","249","42","689","1101","0","62.58","36.15"
"64","000","00","110","0036","0000","1713","1119","594","85","1798","2949","0","60.97","37.95"
"64","000","00","110","0036","1881","851","574","277","51","902","1459","0","61.82","39.34"
"64","000","00","110","0036","1882","862","545","317","34","896","1490","0","60.13","36.58"
"64","000","00","110","0037","0000","1267","810","457","99","1366","2411","0","56.66","33.60"
"64","000","00","110","0037","1883","665","428","237","38","703","1201","0","58.53","35.64"
"64","000","00","110","0037","1884","602","382","220","61","663","1210","0","54.79","31.57"
"64","000","00","110","0038","0000","1703","1194","509","127","1830","3516","0","52.05","33.96"
"64","000","00","110","0038","1885","539","368","171","31","570","1068","0","53.37","34.46"
"64","000","00","110","0038","1886","602","417","185","49","651","1247","0","52.21","33.44"
"64","000","00","110","0038","1887","562","409","153","47","609","1201","0","50.71","34.05"
"64","000","00","120","0000","0000","155903","88268","67635","7126","163029","294220","355601","55.41","30.00"
"64","000","00","120","0001","0000","220","132","88","9","229","388","0","59.02","34.02"
"64","000","00","120","0001","1472","220","132","88","9","229","388","0","59.02","34.02"
"64","000","00","120","0002","0000","322","223","99","20","342","559","0","61.18","39.89"
"64","000","00","120","0002","1471","322","223","99","20","342","559","0","61.18","39.89"
"64","000","00","120","0003","0000","656","395","261","50","706","1227","0","57.54","32.19"
"64","000","00","120","0003","1473","656","395","261","50","706","1227","0","57.54","32.19"
"64","000","00","120","0004","0000","505","240","265","19","524","823","0","63.67","29.16"
"64","000","00","120","0004","1486","505","240","265","19","524","823","0","63.67","29.16"
"64","000","00","120","0005","0000","433","269","164","22","455","818","0","55.62","32.89"
"64","000","00","120","0005","1479","433","269","164","22","455","818","0","55.62","32.89"
"64","000","00","120","0006","0000","1388","781","607","45","1433","2584","0","55.46","30.22"
"64","000","00","120","0006","1474","678","372","306","28","706","1218","0","57.96","30.54"
"64","000","00","120","0006","1475","710","409","301","17","727","1366","0","53.22","29.94"
"64","000","00","120","0007","0000","536","278","258","21","557","960","0","58.02","28.96"
"64","000","00","120","0007","1420","536","278","258","21","557","960","0","58.02","28.96"
"64","000","00","120","0008","0000","1940","987","953","103","2043","3171","0","64.43","31.13"
"64","000","00","120","0008","1499","694","393","301","45","739","1084","0","68.17","36.25"
"64","000","00","120","0008","1500","615","276","339","44","659","1092","0","60.35","25.27"
"64","000","00","120","0008","1501","631","318","313","14","645","995","0","64.82","31.96"
"64","000","00","120","0009","0000","4645","2725","1920","158","4803","10144","0","47.35","26.86"
"64","000","00","120","0009","1431","705","434","271","31","736","1427","0","51.58","30.41"
"64","000","00","120","0009","1432","673","383","290","13","686","1563","0","43.89","24.50"
"64","000","00","120","0009","1433","731","429","302","16","747","1562","0","47.82","27.46"
"64","000","00","120","0009","1434","549","299","250","18","567","1296","0","43.75","23.07"
"64","000","00","120","0009","1435","710","429","281","16","726","1578","0","46.01","27.19"
"64","000","00","120","0009","1436","595","335","260","21","616","1345","0","45.80","24.91"
"64","000","00","120","0009","1437","682","416","266","43","725","1373","0","52.80","30.30"
"64","000","00","120","0010","0000","424","232","192","20","444","763","0","58.19","30.41"
"64","000","00","120","0010","1421","424","232","192","20","444","763","0","58.19","30.41"
"64","000","00","120","0011","0000","1751","1035","716","70","1821","3450","0","52.78","30.00"
"64","000","00","120","0011","1442","682","443","239","26","708","1225","0","57.80","36.16"
"64","000","00","120","0011","1443","547","311","236","17","564","1034","0","54.55","30.08"
"64","000","00","120","0011","1444","522","281","241","27","549","1191","0","46.10","23.59"
"64","000","00","120","0012","0000","2629","1474","1155","166","2795","4617","0","60.54","31.93"
"64","000","00","120","0012","1424","648","370","278","39","687","1112","0","61.78","33.27"
"64","000","00","120","0012","1425","650","370","280","40","690","1149","0","60.05","32.20"
"64","000","00","120","0012","1426","696","382","314","39","735","1254","0","58.61","30.46"
"64","000","00","120","0012","1427","635","352","283","48","683","1102","0","61.98","31.94"
"64","000","00","120","0013","0000","1216","657","559","73","1289","2362","0","54.57","27.82"
"64","000","00","120","0013","1507","616","333","283","43","659","1246","0","52.89","26.73"
"64","000","00","120","0013","1508","600","324","276","30","630","1116","0","56.45","29.03"
"64","000","00","120","0014","0000","2963","1597","1366","149","3112","5637","0","55.21","28.33"
"64","000","00","120","0014","1530","765","440","325","47","812","1440","0","56.39","30.56"
"64","000","00","120","0014","1531","687","398","289","32","719","1343","0","53.54","29.64"
"64","000","00","120","0014","1532","751","383","368","39","790","1442","0","54.79","26.56"
"64","000","00","120","0014","1533","760","376","384","31","791","1412","0","56.02","26.63"
"64","000","00","120","0015","0000","2198","708","1490","106","2304","4000","0","57.60","17.70"
"64","000","00","120","0015","1534","686","271","415","12","698","1237","0","56.43","21.91"
"64","000","00","120","0015","1535","819","230","589","52","871","1503","0","57.95","15.30"
"64","000","00","120","0015","1536","693","207","486","42","735","1260","0","58.33","16.43"
"64","000","00","120","0016","0000","2423","1452","971","144","2567","4528","0","56.69","32.07"
"64","000","00","120","0016","1614","640","405","235","45","685","1206","0","56.80","33.58"
"64","000","00","120","0016","1615","500","273","227","32","532","947","0","56.18","28.83"
"64","000","00","120","0016","1616","656","378","278","46","702","1280","0","54.84","29.53"
"64","000","00","120","0016","1617","627","396","231","21","648","1095","0","59.18","36.16"
"64","000","00","120","0017","0000","3409","2115","1294","138","3547","6448","0","55.01","32.80"
"64","000","00","120","0017","1575","614","396","218","18","632","1218","0","51.89","32.51"
"64","000","00","120","0017","1576","837","523","314","33","870","1526","0","57.01","34.27"
"64","000","00","120","0017","1577","835","484","351","38","873","1555","0","56.14","31.13"
"64","000","00","120","0017","1578","554","326","228","19","573","1101","0","52.04","29.61"
"64","000","00","120","0017","1579","569","386","183","30","599","1048","0","57.16","36.83"
"64","000","00","120","0018","0000","2591","1393","1198","148","2739","4832","0","56.68","28.83"
"64","000","00","120","0018","1509","623","345","278","40","663","1129","0","58.72","30.56"
"64","000","00","120","0018","1510","593","344","249","27","620","1166","0","53.17","29.50"
"64","000","00","120","0018","1511","628","293","335","43","671","1223","0","54.87","23.96"
"64","000","00","120","0018","1512","747","411","336","38","785","1314","0","59.74","31.28"
"64","000","00","120","0019","0000","2299","1238","1061","103","2402","4286","0","56.04","28.88"
"64","000","00","120","0019","1490","508","281","227","27","535","930","0","57.53","30.22"
"64","000","00","120","0019","1491","521","272","249","28","549","1034","0","53.09","26.31"
"64","000","00","120","0019","1492","530","263","267","13","543","1056","0","51.42","24.91"
"64","000","00","120","0019","1493","740","422","318","35","775","1266","0","61.22","33.33"
"64","000","00","120","0020","0000","2053","1030","1023","70","2123","3598","0","59.01","28.63"
"64","000","00","120","0020","1502","680","354","326","24","704","1179","0","59.71","30.03"
"64","000","00","120","0020","1503","708","332","376","23","731","1228","0","59.53","27.04"
"64","000","00","120","0020","1504","665","344","321","23","688","1191","0","57.77","28.88"
"64","000","00","120","0021","0000","769","477","292","44","813","3298","0","24.65","14.46"
"64","000","00","120","0021","1481","543","344","199","35","578","1029","0","56.17","33.43"
"64","000","00","120","0021","1482","226","133","93","9","235","2269","0","10.36","5.86"
"64","000","00","120","0022","0000","1496","707","789","67","1563","2738","0","57.09","25.82"
"64","000","00","120","0022","1537","689","333","356","32","721","1320","0","54.62","25.23"
"64","000","00","120","0022","1538","807","374","433","35","842","1418","0","59.38","26.38"
"64","000","00","120","0024","0000","1684","1024","660","87","1771","3388","0","52.27","30.22"
"64","000","00","120","0024","1440","782","481","301","42","824","1567","0","52.58","30.70"
"64","000","00","120","0024","1441","902","543","359","45","947","1821","0","52.00","29.82"
"64","000","00","120","0025","0000","1651","987","664","53","1704","2871","0","59.35","34.38"
"64","000","00","120","0025","1555","816","494","322","25","841","1445","0","58.20","34.19"
"64","000","00","120","0025","1556","835","493","342","28","863","1426","0","60.52","34.57"
"64","000","00","120","0026","0000","2313","1385","928","103","2416","4491","0","53.80","30.84"
"64","000","00","120","0026","1551","479","306","173","33","512","906","0","56.51","33.77"
"64","000","00","120","0026","1552","585","345","240","26","611","1126","0","54.26","30.64"
"64","000","00","120","0026","1553","610","361","249","19","629","1126","0","55.86","32.06"
"64","000","00","120","0026","1554","639","373","266","25","664","1333","0","49.81","27.98"
"64","000","00","120","0027","0000","3150","1982","1168","175","3325","5791","0","57.42","34.23"
"64","000","00","120","0027","1596","702","404","298","40","742","1321","0","56.17","30.58"
"64","000","00","120","0027","1597","576","380","196","45","621","1018","0","61.00","37.33"
"64","000","00","120","0027","1598","621","409","212","26","647","1164","0","55.58","35.14"
"64","000","00","120","0027","1599","607","382","225","30","637","1135","0","56.12","33.66"
"64","000","00","120","0027","1600","644","407","237","34","678","1153","0","58.80","35.30"
"64","000","00","120","0028","0000","1632","1026","606","96","1728","3018","0","57.26","34.00"
"64","000","00","120","0028","1606","455","301","154","23","478","876","0","54.57","34.36"
"64","000","00","120","0028","1607","631","381","250","46","677","1110","0","60.99","34.32"
"64","000","00","120","0028","1608","546","344","202","27","573","1032","0","55.52","33.33"
"64","000","00","120","0029","0000","2787","1712","1075","135","2922","5438","0","53.73","31.48"
"64","000","00","120","0029","1642","543","324","219","24","567","1009","0","56.19","32.11"
"64","000","00","120","0029","1643","571","354","217","17","588","1050","0","56.00","33.71"
"64","000","00","120","0029","1644","569","390","179","33","602","1187","0","50.72","32.86"
"64","000","00","120","0029","1645","594","344","250","35","629","1185","0","53.08","29.03"
"64","000","00","120","0029","1646","510","300","210","26","536","1007","0","53.23","29.79"
"64","000","00","120","0030","0000","2641","1358","1283","110","2751","5313","0","51.78","25.56"
"64","000","00","120","0030","1516","668","371","297","32","700","1384","0","50.58","26.81"
"64","000","00","120","0030","1517","641","227","414","30","671","1179","0","56.91","19.25"
"64","000","00","120","0030","1518","716","393","323","19","735","1412","0","52.05","27.83"
"64","000","00","120","0030","1519","616","367","249","29","645","1338","0","48.21","27.43"
"64","000","00","120","0031","0000","2294","1145","1149","112","2406","4625","0","52.02","24.76"
"64","000","00","120","0031","1513","722","367","355","36","758","1453","0","52.17","25.26"
"64","000","00","120","0031","1514","671","312","359","20","691","1468","0","47.07","21.25"
"64","000","00","120","0031","1515","901","466","435","56","957","1704","0","56.16","27.35"
"64","000","00","120","0032","0000","1843","1168","675","101","1944","3273","0","59.40","35.69"
"64","000","00","120","0032","1634","582","388","194","33","615","1073","0","57.32","36.16"
"64","000","00","120","0032","1635","607","365","242","38","645","1103","0","58.48","33.09"
"64","000","00","120","0032","1636","654","415","239","30","684","1097","0","62.35","37.83"
"64","000","00","120","0033","0000","2808","1643","1165","117","2925","4970","0","58.85","33.06"
"64","000","00","120","0033","1565","757","468","289","41","798","1349","0","59.15","34.69"
"64","000","00","120","0033","1566","649","396","253","41","690","1139","0","60.58","34.77"
"64","000","00","120","0033","1567","754","438","316","25","779","1356","0","57.45","32.30"
"64","000","00","120","0033","1568","648","341","307","10","658","1126","0","58.44","30.28"
"64","000","00","120","0034","0000","1994","1137","857","83","2077","3555","0","58.42","31.98"
"64","000","00","120","0034","1539","655","375","280","37","692","1123","0","61.62","33.39"
"64","000","00","120","0034","1540","658","365","293","22","680","1158","0","58.72","31.52"
"64","000","00","120","0034","1541","681","397","284","24","705","1274","0","55.34","31.16"
"64","000","00","120","0035","0000","3599","2042","1557","176","3775","6247","0","60.43","32.69"
"64","000","00","120","0035","1526","831","475","356","48","879","1415","0","62.12","33.57"
"64","000","00","120","0035","1527","935","552","383","41","976","1547","0","63.09","35.68"
"64","000","00","120","0035","1528","833","467","366","51","884","1449","0","61.01","32.23"
"64","000","00","120","0035","1529","1000","548","452","36","1036","1836","0","56.43","29.85"
"64","000","00","120","0036","0000","2107","1309","798","109","2216","3835","0","57.78","34.13"
"64","000","00","120","0036","1572","629","411","218","48","677","1165","0","58.11","35.28"
"64","000","00","120","0036","1573","711","445","266","28","739","1250","0","59.12","35.60"
"64","000","00","120","0036","1574","767","453","314","33","800","1420","0","56.34","31.90"
"64","000","00","120","0037","0000","1702","955","747","74","1776","3104","0","57.22","30.77"
"64","000","00","120","0037","1542","559","320","239","25","584","1039","0","56.21","30.80"
"64","000","00","120","0037","1543","582","338","244","17","599","1073","0","55.82","31.50"
"64","000","00","120","0037","1544","561","297","264","32","593","992","0","59.78","29.94"
"64","000","00","120","0038","0000","1196","750","446","86","1282","2331","0","55.00","32.18"
"64","000","00","120","0038","1545","564","358","206","47","611","1124","0","54.36","31.85"
"64","000","00","120","0038","1546","632","392","240","39","671","1207","0","55.59","32.48"
"64","000","00","120","0039","0000","4296","2215","2081","129","4425","8542","0","51.80","25.93"
"64","000","00","120","0039","1456","732","363","369","13","745","1383","0","53.87","26.25"
"64","000","00","120","0039","1457","685","319","366","20","705","1381","0","51.05","23.10"
"64","000","00","120","0039","1458","736","400","336","25","761","1408","0","54.05","28.41"
"64","000","00","120","0039","1459","744","388","356","33","777","1493","0","52.04","25.99"
"64","000","00","120","0039","1460","687","368","319","12","699","1451","0","48.17","25.36"
"64","000","00","120","0039","1461","712","377","335","26","738","1426","0","51.75","26.44"
"64","000","00","120","0040","0000","6616","3867","2749","195","6811","13723","0","49.63","28.18"
"64","000","00","120","0040","1588","835","547","288","31","866","1717","0","50.44","31.86"
"64","000","00","120","0040","1589","813","442","371","32","845","1667","0","50.69","26.51"
"64","000","00","120","0040","1590","819","478","341","22","841","1664","0","50.54","28.73"
"64","000","00","120","0040","1591","749","461","288","18","767","1661","0","46.18","27.75"
"64","000","00","120","0040","1592","805","446","359","28","833","1753","0","47.52","25.44"
"64","000","00","120","0040","1593","861","487","374","22","883","1677","0","52.65","29.04"
"64","000","00","120","0040","1594","920","502","418","22","942","1753","0","53.74","28.64"
"64","000","00","120","0040","1595","814","504","310","20","834","1831","0","45.55","27.53"
"64","000","00","120","0041","0000","1000","524","476","56","1056","1801","0","58.63","29.09"
"64","000","00","120","0041","1422","479","255","224","27","506","820","0","61.71","31.10"
"64","000","00","120","0041","1423","521","269","252","29","550","981","0","56.07","27.42"
"64","000","00","120","0042","0000","1729","957","772","119","1848","3155","0","58.57","30.33"
"64","000","00","120","0042","1483","545","278","267","24","569","1012","0","56.23","27.47"
"64","000","00","120","0042","1484","583","336","247","54","637","1064","0","59.87","31.58"
"64","000","00","120","0042","1485","601","343","258","41","642","1079","0","59.50","31.79"
"64","000","00","120","0043","0000","1726","1048","678","79","1805","2876","0","62.76","36.44"
"64","000","00","120","0043","1640","882","538","344","37","919","1457","0","63.07","36.93"
"64","000","00","120","0043","1641","844","510","334","42","886","1419","0","62.44","35.94"
"64","000","00","120","0044","0000","2788","1503","1285","181","2969","5363","0","55.36","28.03"
"64","000","00","120","0044","1494","558","301","257","48","606","1164","0","52.06","25.86"
"64","000","00","120","0044","1495","481","249","232","23","504","916","0","55.02","27.18"
"64","000","00","120","0044","1496","541","285","256","27","568","1049","0","54.15","27.17"
"64","000","00","120","0044","1497","675","366","309","38","713","1234","0","57.78","29.66"
"64","000","00","120","0044","1498","533","302","231","45","578","1000","0","57.80","30.20"
"64","000","00","120","0045","0000","1031","463","568","54","1085","1922","0","56.45","24.09"
"64","000","00","120","0045","1505","520","221","299","26","546","965","0","56.58","22.90"
"64","000","00","120","0045","1506","511","242","269","28","539","957","0","56.32","25.29"
"64","000","00","120","0046","0000","2449","1363","1086","132","2581","4379","0","58.94","31.13"
"64","000","00","120","0046","1476","871","494","377","35","906","1454","0","62.31","33.98"
"64","000","00","120","0046","1477","783","444","339","60","843","1457","0","57.86","30.47"
"64","000","00","120","0046","1478","795","425","370","37","832","1468","0","56.68","28.95"
"64","000","00","120","0047","0000","1598","829","769","86","1684","2959","0","56.91","28.02"
"64","000","00","120","0047","1487","535","309","226","55","590","950","0","62.11","32.53"
"64","000","00","120","0047","1488","502","218","284","7","509","958","0","53.13","22.76"
"64","000","00","120","0047","1489","561","302","259","24","585","1051","0","55.66","28.73"
"64","000","00","120","0048","0000","3212","1906","1306","125","3337","5990","0","55.71","31.82"
"64","000","00","120","0048","1451","664","400","264","29","693","1229","0","56.39","32.55"
"64","000","00","120","0048","1452","753","444","309","37","790","1458","0","54.18","30.45"
"64","000","00","120","0048","1453","588","370","218","21","609","1041","0","58.50","35.54"
"64","000","00","120","0048","1454","668","415","253","21","689","1156","0","59.60","35.90"
"64","000","00","120","0048","1455","539","277","262","17","556","1106","0","50.27","25.05"
"64","000","00","120","0049","0000","2333","1399","934","126","2459","4541","0","54.15","30.81"
"64","000","00","120","0049","1649","761","454","307","39","800","1421","0","56.30","31.95"
"64","000","00","120","0049","1650","825","467","358","33","858","1715","0","50.03","27.23"
"64","000","00","120","0049","1651","747","478","269","54","801","1405","0","57.01","34.02"
"64","000","00","120","0050","0000","1326","643","683","84","1410","2486","0","56.72","25.86"
"64","000","00","120","0050","1520","692","333","359","49","741","1249","0","59.33","26.66"
"64","000","00","120","0050","1521","634","310","324","35","669","1237","0","54.08","25.06"
"64","000","00","120","0051","0000","607","347","260","34","641","1014","0","63.21","34.22"
"64","000","00","120","0051","1480","607","347","260","34","641","1014","0","63.21","34.22"
"64","000","00","120","0053","0000","1957","1182","775","117","2074","3803","0","54.54","31.08"
"64","000","00","120","0053","1428","717","425","292","44","761","1369","0","55.59","31.04"
"64","000","00","120","0053","1429","637","392","245","33","670","1204","0","55.65","32.56"
"64","000","00","120","0053","1430","603","365","238","40","643","1230","0","52.28","29.67"
"64","000","00","120","0054","0000","846","493","353","66","912","1782","0","51.18","27.67"
"64","000","00","120","0054","1618","447","261","186","44","491","929","0","52.85","28.09"
"64","000","00","120","0054","1619","399","232","167","22","421","853","0","49.36","27.20"
"64","000","00","120","0055","0000","4425","2717","1708","157","4582","8571","0","53.46","31.70"
"64","000","00","120","0055","1628","646","417","229","23","669","1225","0","54.61","34.04"
"64","000","00","120","0055","1629","640","418","222","39","679","1230","0","55.20","33.98"
"64","000","00","120","0055","1630","825","470","355","23","848","1613","0","52.57","29.14"
"64","000","00","120","0055","1631","957","577","380","26","983","1941","0","50.64","29.73"
"64","000","00","120","0055","1632","729","457","272","23","752","1398","0","53.79","32.69"
"64","000","00","120","0055","1633","628","378","250","23","651","1164","0","55.93","32.47"
"64","000","00","120","0056","0000","4032","2037","1995","193","4225","7817","0","54.05","26.06"
"64","000","00","120","0056","1445","750","242","508","43","793","1503","0","52.76","16.10"
"64","000","00","120","0056","1446","651","376","275","46","697","1177","0","59.22","31.95"
"64","000","00","120","0056","1447","644","351","293","39","683","1216","0","56.17","28.87"
"64","000","00","120","0056","1448","625","348","277","28","653","1400","0","46.64","24.86"
"64","000","00","120","0056","1449","591","298","293","15","606","1091","0","55.55","27.31"
"64","000","00","120","0056","1450","771","422","349","22","793","1430","0","55.45","29.51"
"64","000","00","120","0057","0000","2379","1433","946","148","2527","4211","0","60.01","34.03"
"64","000","00","120","0057","1637","756","442","314","56","812","1397","0","58.12","31.64"
"64","000","00","120","0057","1638","769","474","295","40","809","1341","0","60.33","35.35"
"64","000","00","120","0057","1639","854","517","337","52","906","1473","0","61.51","35.10"
"64","000","00","120","0058","0000","1408","844","564","51","1459","2556","0","57.08","33.02"
"64","000","00","120","0058","1438","779","464","315","15","794","1397","0","56.84","33.21"
"64","000","00","120","0058","1439","629","380","249","36","665","1159","0","57.38","32.79"
"64","000","00","120","0059","0000","2054","1140","914","63","2117","3906","0","54.20","29.19"
"64","000","00","120","0059","1462","638","327","311","23","661","1237","0","53.44","26.43"
"64","000","00","120","0059","1463","730","428","302","22","752","1335","0","56.33","32.06"
"64","000","00","120","0059","1464","686","385","301","18","704","1334","0","52.77","28.86"
"64","000","00","120","0060","0000","4748","2549","2199","146","4894","9130","0","53.60","27.92"
"64","000","00","120","0060","1465","938","500","438","28","966","1715","0","56.33","29.15"
"64","000","00","120","0060","1466","830","444","386","31","861","1595","0","53.98","27.84"
"64","000","00","120","0060","1467","756","393","363","18","774","1496","0","51.74","26.27"
"64","000","00","120","0060","1468","749","427","322","24","773","1405","0","55.02","30.39"
"64","000","00","120","0060","1469","694","373","321","19","713","1362","0","52.35","27.39"
"64","000","00","120","0060","1470","781","412","369","26","807","1557","0","51.83","26.46"
"64","000","00","120","0061","0000","1022","456","566","52","1074","1940","0","55.36","23.51"
"64","000","00","120","0061","1522","544","256","288","35","579","976","0","59.32","26.23"
"64","000","00","120","0061","1523","478","200","278","17","495","964","0","51.35","20.75"
"64","000","00","120","0062","0000","1388","704","684","71","1459","2594","0","56.25","27.14"
"64","000","00","120","0062","1524","746","355","391","46","792","1430","0","55.38","24.83"
"64","000","00","120","0062","1525","642","349","293","25","667","1164","0","57.30","29.98"
"64","000","00","120","0063","0000","1422","722","700","42","1464","2421","0","60.47","29.82"
"64","000","00","120","0063","1547","738","385","353","25","763","1267","0","60.22","30.39"
"64","000","00","120","0063","1548","684","337","347","17","701","1154","0","60.75","29.20"
"64","000","00","120","0064","0000","1223","740","483","39","1262","2148","0","58.75","34.45"
"64","000","00","120","0064","1549","622","388","234","19","641","1038","0","61.75","37.38"
"64","000","00","120","0064","1550","601","352","249","20","621","1110","0","55.95","31.71"
"64","000","00","120","0065","0000","2128","1205","923","107","2235","3594","0","62.19","33.53"
"64","000","00","120","0065","1569","623","378","245","48","671","1072","0","62.59","35.26"
"64","000","00","120","0065","1570","645","383","262","32","677","1097","0","61.71","34.91"
"64","000","00","120","0065","1571","860","444","416","27","887","1425","0","62.25","31.16"
"64","000","00","120","0066","0000","1460","890","570","62","1522","2456","0","61.97","36.24"
"64","000","00","120","0066","1557","804","467","337","26","830","1398","0","59.37","33.40"
"64","000","00","120","0066","1558","656","423","233","36","692","1058","0","65.41","39.98"
"64","000","00","120","0067","0000","2070","1180","890","80","2150","4116","0","52.24","28.67"
"64","000","00","120","0067","1562","630","374","256","28","658","1299","0","50.65","28.79"
"64","000","00","120","0067","1563","670","392","278","28","698","1332","0","52.40","29.43"
"64","000","00","120","0067","1564","770","414","356","24","794","1485","0","53.47","27.88"
"64","000","00","120","0068","0000","2079","1148","931","62","2141","3852","0","55.58","29.80"
"64","000","00","120","0068","1559","750","417","333","22","772","1390","0","55.54","30.00"
"64","000","00","120","0068","1560","678","359","319","20","698","1266","0","55.13","28.36"
"64","000","00","120","0068","1561","651","372","279","20","671","1196","0","56.10","31.10"
"64","000","00","120","0069","0000","1266","689","577","61","1327","2387","0","55.59","28.86"
"64","000","00","120","0069","1583","616","336","280","32","648","1156","0","56.06","29.07"
"64","000","00","120","0069","1584","650","353","297","29","679","1231","0","55.16","28.68"
"64","000","00","120","0070","0000","2382","1360","1022","128","2510","4363","0","57.53","31.17"
"64","000","00","120","0070","1585","775","434","341","48","823","1477","0","55.72","29.38"
"64","000","00","120","0070","1586","770","430","340","37","807","1335","0","60.45","32.21"
"64","000","00","120","0070","1587","837","496","341","43","880","1551","0","56.74","31.98"
"64","000","00","120","0071","0000","2367","1396","971","88","2455","4328","0","56.72","32.26"
"64","000","00","120","0071","1580","806","450","356","33","839","1415","0","59.29","31.80"
"64","000","00","120","0071","1581","845","485","360","39","884","1525","0","57.97","31.80"
"64","000","00","120","0071","1582","716","461","255","16","732","1388","0","52.74","33.21"
"64","000","00","120","0072","0000","2387","1438","949","132","2519","4394","0","57.33","32.73"
"64","000","00","120","0072","1609","766","483","283","56","822","1443","0","56.96","33.47"
"64","000","00","120","0072","1610","765","438","327","53","818","1384","0","59.10","31.65"
"64","000","00","120","0072","1611","856","517","339","23","879","1567","0","56.09","32.99"
"64","000","00","120","0073","0000","1520","950","570","64","1584","2640","0","60.00","35.98"
"64","000","00","120","0073","1612","746","463","283","27","773","1269","0","60.91","36.49"
"64","000","00","120","0073","1613","774","487","287","37","811","1371","0","59.15","35.52"
"64","000","00","120","0074","0000","1377","785","592","55","1432","2286","0","62.64","34.34"
"64","000","00","120","0074","1624","640","351","289","31","671","1026","0","65.40","34.21"
"64","000","00","120","0074","1625","737","434","303","24","761","1260","0","60.40","34.44"
"64","000","00","120","0075","0000","2746","1615","1131","109","2855","5397","0","52.90","29.92"
"64","000","00","120","0075","1620","626","342","284","20","646","1267","0","50.99","26.99"
"64","000","00","120","0075","1621","615","363","252","17","632","1365","0","46.30","26.59"
"64","000","00","120","0075","1622","763","464","299","43","806","1383","0","58.28","33.55"
"64","000","00","120","0075","1623","742","446","296","29","771","1382","0","55.79","32.27"
"64","000","00","120","0076","0000","1423","845","578","73","1496","2493","0","60.01","33.89"
"64","000","00","120","0076","1626","766","460","306","44","810","1315","0","61.60","34.98"
"64","000","00","120","0076","1627","657","385","272","29","686","1178","0","58.23","32.68"
"64","000","00","120","0077","0000","1389","875","514","85","1474","2557","0","57.65","34.22"
"64","000","00","120","0077","1647","701","464","237","41","742","1284","0","57.79","36.14"
"64","000","00","120","0077","1648","688","411","277","44","732","1273","0","57.50","32.29"
"64","000","00","120","0078","0000","3427","2043","1384","113","3540","6246","0","56.68","32.71"
"64","000","00","120","0078","1601","764","451","313","32","796","1292","0","61.61","34.91"
"64","000","00","120","0078","1602","712","433","279","25","737","1312","0","56.17","33.00"
"64","000","00","120","0078","1603","639","400","239","25","664","1230","0","53.98","32.52"
"64","000","00","120","0078","1604","653","382","271","18","671","1200","0","55.92","31.83"
"64","000","00","120","0078","1605","659","377","282","13","672","1212","0","55.45","31.11"
"64","000","00","130","0000","0000","31665","19926","11739","2776","34441","57583","68471","59.81","34.60"
"64","000","00","130","0001","0000","1498","922","576","138","1636","2789","0","58.66","33.06"
"64","000","00","130","0001","1975","676","406","270","71","747","1187","0","62.93","34.20"
"64","000","00","130","0001","1976","822","516","306","67","889","1602","0","55.49","32.21"
"64","000","00","130","0002","0000","1718","1024","694","108","1826","2922","0","62.49","35.04"
"64","000","00","130","0002","1977","579","358","221","41","620","1037","0","59.79","34.52"
"64","000","00","130","0002","1978","553","320","233","29","582","931","0","62.51","34.37"
"64","000","00","130","0002","1979","586","346","240","38","624","954","0","65.41","36.27"
"64","000","00","130","0003","0000","2005","1230","775","152","2157","4027","0","53.56","30.54"
"64","000","00","130","0003","1980","659","394","265","49","708","1303","0","54.34","30.24"
"64","000","00","130","0003","1981","598","371","227","37","635","1222","0","51.96","30.36"
"64","000","00","130","0003","1982","748","465","283","66","814","1502","0","54.19","30.96"
"64","000","00","130","0004","0000","1326","811","515","95","1421","2622","0","54.20","30.93"
"64","000","00","130","0004","1983","680","427","253","39","719","1346","0","53.42","31.72"
"64","000","00","130","0004","1984","646","384","262","56","702","1276","0","55.02","30.09"
"64","000","00","130","0005","0000","1617","970","647","142","1759","2862","0","61.46","33.89"
"64","000","00","130","0005","1985","850","531","319","73","923","1484","0","62.20","35.78"
"64","000","00","130","0005","1986","767","439","328","69","836","1378","0","60.67","31.86"
"64","000","00","130","0006","0000","1219","793","426","137","1356","2411","0","56.24","32.89"
"64","000","00","130","0006","1987","545","342","203","43","588","1211","0","48.55","28.24"
"64","000","00","130","0006","1988","674","451","223","94","768","1200","0","64.00","37.58"
"64","000","00","130","0007","0000","2282","1463","819","201","2483","4497","0","55.21","32.53"
"64","000","00","130","0007","1989","569","351","218","35","604","1151","0","52.48","30.50"
"64","000","00","130","0007","1990","670","435","235","68","738","1322","0","55.82","32.90"
"64","000","00","130","0007","1991","413","271","142","35","448","869","0","51.55","31.19"
"64","000","00","130","0007","1992","630","406","224","63","693","1155","0","60.00","35.15"
"64","000","00","130","0008","0000","1006","638","368","86","1092","1727","0","63.23","36.94"
"64","000","00","130","0008","1993","534","342","192","42","576","895","0","64.36","38.21"
"64","000","00","130","0008","1994","472","296","176","44","516","832","0","62.02","35.58"
"64","000","00","130","0009","0000","1758","1175","583","200","1958","3321","0","58.96","35.38"
"64","000","00","130","0009","1995","523","364","159","59","582","1032","0","56.40","35.27"
"64","000","00","130","0009","1996","544","365","179","70","614","1056","0","58.14","34.56"
"64","000","00","130","0009","1997","691","446","245","71","762","1233","0","61.80","36.17"
"64","000","00","130","0010","0000","1001","644","357","94","1095","1644","0","66.61","39.17"
"64","000","00","130","0010","1998","1001","644","357","94","1095","1644","0","66.61","39.17"
"64","000","00","130","0011","0000","864","510","354","94","958","1499","0","63.91","34.02"
"64","000","00","130","0011","1999","311","154","157","33","344","546","0","63.00","28.21"
"64","000","00","130","0011","2000","553","356","197","61","614","953","0","64.43","37.36"
"64","000","00","130","0012","0000","987","568","419","65","1052","1882","0","55.90","30.18"
"64","000","00","130","0012","2001","521","302","219","17","538","1014","0","53.06","29.78"
"64","000","00","130","0012","2002","466","266","200","48","514","868","0","59.22","30.65"
"64","000","00","130","0013","0000","2040","1229","811","118","2158","3976","0","54.28","30.91"
"64","000","00","130","0013","2003","757","447","310","32","789","1573","0","50.16","28.42"
"64","000","00","130","0013","2004","665","415","250","42","707","1241","0","56.97","33.44"
"64","000","00","130","0013","2005","618","367","251","44","662","1162","0","56.97","31.58"
"64","000","00","130","0014","0000","850","531","319","105","955","1283","0","74.43","41.39"
"64","000","00","130","0014","2006","850","531","319","105","955","1283","0","74.43","41.39"
"64","000","00","130","0015","0000","1100","722","378","84","1184","1876","0","63.11","38.49"
"64","000","00","130","0015","2007","593","392","201","39","632","1018","0","62.08","38.51"
"64","000","00","130","0015","2008","507","330","177","45","552","858","0","64.34","38.46"
"64","000","00","130","0016","0000","1162","757","405","110","1272","1691","0","75.22","44.77"
"64","000","00","130","0016","2009","563","394","169","53","616","818","0","75.31","48.17"
"64","000","00","130","0016","2010","599","363","236","57","656","873","0","75.14","41.58"
"64","000","00","130","0017","0000","1033","704","329","105","1138","1693","0","67.22","41.58"
"64","000","00","130","0017","2011","589","403","186","57","646","961","0","67.22","41.94"
"64","000","00","130","0017","2012","444","301","143","48","492","732","0","67.21","41.12"
"64","000","00","130","0018","0000","423","307","116","51","474","848","0","55.90","36.20"
"64","000","00","130","0018","2013","423","307","116","51","474","848","0","55.90","36.20"
"64","000","00","130","0019","0000","343","250","93","48","391","710","0","55.07","35.21"
"64","000","00","130","0019","2014","343","250","93","48","391","710","0","55.07","35.21"
"64","000","00","130","0020","0000","1623","1019","604","108","1731","2838","0","60.99","35.91"
"64","000","00","130","0020","2015","797","496","301","34","831","1415","0","58.73","35.05"
"64","000","00","130","0020","2016","826","523","303","74","900","1423","0","63.25","36.75"
"64","000","00","130","0021","0000","1341","789","552","95","1436","2332","0","61.58","33.83"
"64","000","00","130","0021","2017","759","426","333","45","804","1320","0","60.91","32.27"
"64","000","00","130","0021","2018","582","363","219","50","632","1012","0","62.45","35.87"
"64","000","00","130","0022","0000","1902","1169","733","159","2061","3333","0","61.84","35.07"
"64","000","00","130","0022","2019","676","439","237","53","729","1183","0","61.62","37.11"
"64","000","00","130","0022","2020","585","339","246","65","650","1058","0","61.44","32.04"
"64","000","00","130","0022","2021","641","391","250","41","682","1092","0","62.45","35.81"
"64","000","00","130","0023","0000","1270","795","475","111","1381","2635","0","52.41","30.17"
"64","000","00","130","0023","2022","669","426","243","64","733","1322","0","55.45","32.22"
"64","000","00","130","0023","2023","601","369","232","47","648","1313","0","49.35","28.10"
"64","000","00","130","0024","0000","1297","906","391","170","1467","2165","0","67.76","41.85"
"64","000","00","130","0024","2024","676","495","181","112","788","1063","0","74.13","46.57"
"64","000","00","130","0024","2025","621","411","210","58","679","1102","0","61.62","37.30"
"64","000","00","140","0000","0000","52140","31040","21100","3502","55642","95328","111379","58.37","32.56"
"64","000","00","140","0001","0000","695","476","219","75","770","1318","0","58.42","36.12"
"64","000","00","140","0001","1888","351","257","94","41","392","660","0","59.39","38.94"
"64","000","00","140","0001","1889","344","219","125","34","378","658","0","57.45","33.28"
"64","000","00","140","0002","0000","2827","1660","1167","170","2997","5674","0","52.82","29.26"
"64","000","00","140","0002","1890","747","455","292","54","801","1310","0","61.15","34.73"
"64","000","00","140","0002","1891","424","260","164","38","462","865","0","53.41","30.06"
"64","000","00","140","0002","1892","370","224","146","19","389","719","0","54.10","31.15"
"64","000","00","140","0002","1893","221","127","94","30","251","407","0","61.67","31.20"
"64","000","00","140","0002","1894","635","362","273","5","640","1221","0","52.42","29.65"
"64","000","00","140","0002","1895","430","232","198","24","454","1152","0","39.41","20.14"
"64","000","00","140","0003","0000","3229","2009","1220","247","3476","6498","0","53.49","30.92"
"64","000","00","140","0003","1896","521","337","184","26","547","1078","0","50.74","31.26"
"64","000","00","140","0003","1897","573","337","236","54","627","1051","0","59.66","32.06"
"64","000","00","140","0003","1898","593","364","229","39","632","1141","0","55.39","31.90"
"64","000","00","140","0003","1899","512","341","171","57","569","1046","0","54.40","32.60"
"64","000","00","140","0003","1900","454","291","163","30","484","985","0","49.14","29.54"
"64","000","00","140","0003","1901","576","339","237","41","617","1197","0","51.55","28.32"
"64","000","00","140","0004","0000","1416","928","488","116","1532","2383","0","64.29","38.94"
"64","000","00","140","0004","1902","703","462","241","37","740","1220","0","60.66","37.87"
"64","000","00","140","0004","1903","713","466","247","79","792","1163","0","68.10","40.07"
"64","000","00","140","0005","0000","2618","1573","1045","206","2824","4548","0","62.09","34.59"
"64","000","00","140","0005","1904","760","474","286","37","797","1288","0","61.88","36.80"
"64","000","00","140","0005","1905","631","376","255","24","655","1154","0","56.76","32.58"
"64","000","00","140","0005","1906","634","344","290","68","702","1054","0","66.60","32.64"
"64","000","00","140","0005","1907","593","379","214","77","670","1052","0","63.69","36.03"
"64","000","00","140","0006","0000","2701","1689","1012","174","2875","4740","0","60.65","35.63"
"64","000","00","140","0006","1908","744","459","285","25","769","1255","0","61.27","36.57"
"64","000","00","140","0006","1909","696","440","256","45","741","1233","0","60.10","35.69"
"64","000","00","140","0006","1910","631","408","223","68","699","1180","0","59.24","34.58"
"64","000","00","140","0006","1911","630","382","248","36","666","1072","0","62.13","35.63"
"64","000","00","140","0007","0000","2301","1493","808","105","2406","3841","0","62.64","38.87"
"64","000","00","140","0007","1912","740","473","267","41","781","1209","0","64.60","39.12"
"64","000","00","140","0007","1913","850","556","294","35","885","1365","0","64.84","40.73"
"64","000","00","140","0007","1914","711","464","247","29","740","1267","0","58.41","36.62"
"64","000","00","140","0008","0000","1347","755","592","95","1442","2234","0","64.55","33.80"
"64","000","00","140","0008","1915","733","393","340","40","773","1263","0","61.20","31.12"
"64","000","00","140","0008","1916","614","362","252","55","669","971","0","68.90","37.28"
"64","000","00","140","0009","0000","5465","3288","2177","313","5778","10478","0","55.14","31.38"
"64","000","00","140","0009","1917","706","450","256","35","741","1289","0","57.49","34.91"
"64","000","00","140","0009","1918","592","349","243","34","626","1219","0","51.35","28.63"
"64","000","00","140","0009","1919","589","355","234","51","640","1237","0","51.74","28.70"
"64","000","00","140","0009","1920","717","437","280","42","759","1348","0","56.31","32.42"
"64","000","00","140","0009","1921","769","458","311","28","797","1371","0","58.13","33.41"
"64","000","00","140","0009","1922","745","421","324","46","791","1390","0","56.91","30.29"
"64","000","00","140","0009","1923","733","401","332","58","791","1323","0","59.79","30.31"
"64","000","00","140","0009","1924","614","417","197","19","633","1301","0","48.65","32.05"
"64","000","00","140","0010","0000","4084","2355","1729","246","4330","7437","0","58.22","31.67"
"64","000","00","140","0010","1925","580","346","234","34","614","1020","0","60.20","33.92"
"64","000","00","140","0010","1926","529","313","216","52","581","1065","0","54.55","29.39"
"64","000","00","140","0010","1927","605","324","281","33","638","1068","0","59.74","30.34"
"64","000","00","140","0010","1928","416","250","166","30","446","745","0","59.87","33.56"
"64","000","00","140","0010","1929","469","267","202","24","493","917","0","53.76","29.12"
"64","000","00","140","0010","1930","741","411","330","40","781","1371","0","56.97","29.98"
"64","000","00","140","0010","1931","744","444","300","33","777","1251","0","62.11","35.49"
"64","000","00","140","0011","0000","1044","687","357","74","1118","1751","0","63.85","39.23"
"64","000","00","140","0011","1932","626","411","215","34","660","1031","0","64.02","39.86"
"64","000","00","140","0011","1933","418","276","142","40","458","720","0","63.61","38.33"
"64","000","00","140","0012","0000","918","569","349","100","1018","1616","0","63.00","35.21"
"64","000","00","140","0012","1934","504","316","188","70","574","901","0","63.71","35.07"
"64","000","00","140","0012","1935","414","253","161","30","444","715","0","62.10","35.38"
"64","000","00","140","0013","0000","1334","752","582","113","1447","2383","0","60.72","31.56"
"64","000","00","140","0013","1936","650","338","312","59","709","1161","0","61.07","29.11"
"64","000","00","140","0013","1937","684","414","270","54","738","1222","0","60.39","33.88"
"64","000","00","140","0014","0000","1881","1251","630","172","2053","2859","0","71.81","43.76"
"64","000","00","140","0014","1938","643","412","231","57","700","974","0","71.87","42.30"
"64","000","00","140","0014","1939","602","424","178","44","646","929","0","69.54","45.64"
"64","000","00","140","0014","1940","636","415","221","71","707","956","0","73.95","43.41"
"64","000","00","140","0015","0000","890","579","311","40","930","1558","0","59.69","37.16"
"64","000","00","140","0015","1941","464","302","162","23","487","851","0","57.23","35.49"
"64","000","00","140","0015","1942","426","277","149","17","443","707","0","62.66","39.18"
"64","000","00","140","0016","0000","2889","1661","1228","155","3044","6054","0","50.28","27.44"
"64","000","00","140","0016","1943","600","354","246","37","637","1090","0","58.44","32.48"
"64","000","00","140","0016","1944","644","364","280","27","671","1247","0","53.81","29.19"
"64","000","00","140","0016","1945","583","353","230","30","613","1067","0","57.45","33.08"
"64","000","00","140","0016","1946","431","227","204","28","459","1322","0","34.72","17.17"
"64","000","00","140","0016","1947","631","363","268","33","664","1328","0","50.00","27.33"
"64","000","00","140","0017","0000","4073","2191","1882","256","4329","7229","0","59.88","30.31"
"64","000","00","140","0017","1948","732","433","299","48","780","1303","0","59.86","33.23"
"64","000","00","140","0017","1949","688","366","322","36","724","1230","0","58.86","29.76"
"64","000","00","140","0017","1950","739","362","377","55","794","1211","0","65.57","29.89"
"64","000","00","140","0017","1951","523","284","239","42","565","894","0","63.20","31.77"
"64","000","00","140","0017","1952","646","362","284","48","694","1284","0","54.05","28.19"
"64","000","00","140","0017","1953","745","384","361","27","772","1307","0","59.07","29.38"
"64","000","00","140","0018","0000","298","148","150","30","328","542","0","60.52","27.31"
"64","000","00","140","0018","1954","298","148","150","30","328","542","0","60.52","27.31"
"64","000","00","140","0019","0000","3787","2228","1559","218","4005","6642","0","60.30","33.54"
"64","000","00","140","0019","1955","464","279","185","42","506","1005","0","50.35","27.76"
"64","000","00","140","0019","1956","673","394","279","32","705","1180","0","59.75","33.39"
"64","000","00","140","0019","1957","762","420","342","33","795","1086","0","73.20","38.67"
"64","000","00","140","0019","1958","649","396","253","38","687","1179","0","58.27","33.59"
"64","000","00","140","0019","1959","612","356","256","39","651","1057","0","61.59","33.68"
"64","000","00","140","0019","1960","627","383","244","34","661","1135","0","58.24","33.74"
"64","000","00","140","0020","0000","1210","774","436","85","1295","2152","0","60.18","35.97"
"64","000","00","140","0020","1961","514","321","193","43","557","939","0","59.32","34.19"
"64","000","00","140","0020","1962","696","453","243","42","738","1213","0","60.84","37.35"
"64","000","00","140","0021","0000","985","616","369","83","1068","1512","0","70.63","40.74"
"64","000","00","140","0021","1963","464","300","164","40","504","681","0","74.01","44.05"
"64","000","00","140","0021","1964","521","316","205","43","564","831","0","67.87","38.03"
"64","000","00","140","0022","0000","952","585","367","78","1030","1795","0","57.38","32.59"
"64","000","00","140","0022","1965","456","268","188","37","493","921","0","53.53","29.10"
"64","000","00","140","0022","1966","496","317","179","41","537","874","0","61.44","36.27"
"64","000","00","140","0023","0000","2031","1297","734","164","2195","3678","0","59.68","35.26"
"64","000","00","140","0023","1967","754","506","248","48","802","1284","0","62.46","39.41"
"64","000","00","140","0023","1968","647","407","240","75","722","1190","0","60.67","34.20"
"64","000","00","140","0023","1969","630","384","246","41","671","1204","0","55.73","31.89"
"64","000","00","140","0025","0000","3165","1476","1689","187","3352","6406","0","52.33","23.04"
"64","000","00","140","0025","1970","612","247","365","56","668","1273","0","52.47","19.40"
"64","000","00","140","0025","1971","707","331","376","29","736","1286","0","57.23","25.74"
"64","000","00","140","0025","1972","647","306","341","33","680","1260","0","53.97","24.29"
"64","000","00","140","0025","1973","555","280","275","29","584","1229","0","47.52","22.78"
"64","000","00","140","0025","1974","644","312","332","40","684","1358","0","50.37","22.97"
"64","000","00","150","0000","0000","18851","11786","7065","1543","20394","35294","40723","57.78","33.39"
"64","000","00","150","0001","0000","1364","804","560","71","1435","2623","0","54.71","30.65"
"64","000","00","150","0001","0829","702","432","270","40","742","1319","0","56.25","32.75"
"64","000","00","150","0001","0830","662","372","290","31","693","1304","0","53.14","28.53"
"64","000","00","150","0002","0000","2357","1317","1040","182","2539","5078","0","50.00","25.94"
"64","000","00","150","0002","0831","614","347","267","47","661","1377","0","48.00","25.20"
"64","000","00","150","0002","0832","507","285","222","48","555","1201","0","46.21","23.73"
"64","000","00","150","0002","0833","645","386","259","37","682","1273","0","53.57","30.32"
"64","000","00","150","0002","0834","591","299","292","50","641","1227","0","52.24","24.37"
"64","000","00","150","0003","0000","2119","1227","892","160","2279","3975","0","57.33","30.87"
"64","000","00","150","0003","0835","745","388","357","75","820","1469","0","55.82","26.41"
"64","000","00","150","0003","0836","698","418","280","42","740","1219","0","60.71","34.29"
"64","000","00","150","0003","0837","676","421","255","43","719","1287","0","55.87","32.71"
"64","000","00","150","0004","0000","1357","968","389","98","1455","2269","0","64.13","42.66"
"64","000","00","150","0004","0838","631","479","152","51","682","1059","0","64.40","45.23"
"64","000","00","150","0004","0839","726","489","237","47","773","1210","0","63.88","40.41"
"64","000","00","150","0005","0000","1181","769","412","91","1272","2135","0","59.58","36.02"
"64","000","00","150","0005","0840","553","364","189","45","598","1085","0","55.12","33.55"
"64","000","00","150","0005","0841","628","405","223","46","674","1050","0","64.19","38.57"
"64","000","00","150","0006","0000","1873","1182","691","149","2022","3335","0","60.63","35.44"
"64","000","00","150","0006","0842","699","446","253","50","749","1231","0","60.84","36.23"
"64","000","00","150","0006","0843","570","361","209","43","613","1011","0","60.63","35.71"
"64","000","00","150","0006","0844","604","375","229","56","660","1093","0","60.38","34.31"
"64","000","00","150","0007","0000","512","369","143","55","567","986","0","57.51","37.42"
"64","000","00","150","0007","0845","512","369","143","55","567","986","0","57.51","37.42"
"64","000","00","150","0008","0000","512","323","189","75","587","964","0","60.89","33.51"
"64","000","00","150","0008","0846","512","323","189","75","587","964","0","60.89","33.51"
"64","000","00","150","0009","0000","531","347","184","39","570","941","0","60.57","36.88"
"64","000","00","150","0009","0847","531","347","184","39","570","941","0","60.57","36.88"
"64","000","00","150","0010","0000","643","421","222","71","714","1401","0","50.96","30.05"
"64","000","00","150","0010","0848","643","421","222","71","714","1401","0","50.96","30.05"
"64","000","00","150","0011","0000","944","626","318","84","1028","1446","0","71.09","43.29"
"64","000","00","150","0011","0849","482","320","162","40","522","725","0","72.00","44.14"
"64","000","00","150","0011","0850","462","306","156","44","506","721","0","70.18","42.44"
"64","000","00","150","0012","0000","652","430","222","53","705","1271","0","55.47","33.83"
"64","000","00","150","0012","0851","652","430","222","53","705","1271","0","55.47","33.83"
"64","000","00","150","0013","0000","857","611","246","63","920","1690","0","54.44","36.15"
"64","000","00","150","0013","0852","455","332","123","33","488","826","0","59.08","40.19"
"64","000","00","150","0013","0853","402","279","123","30","432","864","0","50.00","32.29"
"64","000","00","150","0014","0000","1450","941","509","109","1559","2389","0","65.26","39.39"
"64","000","00","150","0014","0854","714","460","254","47","761","1206","0","63.10","38.14"
"64","000","00","150","0014","0855","736","481","255","62","798","1183","0","67.46","40.66"
"64","000","00","150","0015","0000","525","310","215","49","574","964","0","59.54","32.16"
"64","000","00","150","0015","0856","525","310","215","49","574","964","0","59.54","32.16"
"64","000","00","150","0016","0000","739","478","261","78","817","1452","0","56.27","32.92"
"64","000","00","150","0016","0857","379","228","151","51","430","741","0","58.03","30.77"
"64","000","00","150","0016","0858","360","250","110","27","387","711","0","54.43","35.16"
"64","000","00","150","0017","0000","908","450","458","87","995","1727","0","57.61","26.06"
"64","000","00","150","0017","0859","499","302","197","53","552","947","0","58.29","31.89"
"64","000","00","150","0017","0860","409","148","261","34","443","780","0","56.79","18.97"
"64","000","00","150","0018","0000","327","213","114","29","356","648","0","54.94","32.87"
"64","000","00","150","0018","0861","327","213","114","29","356","648","0","54.94","32.87"
"64","000","00","160","0000","0000","15303","9615","5688","1040","16343","29172","33671","56.02","32.96"
"64","000","00","160","0001","0000","413","243","170","54","467","872","0","53.56","27.87"
"64","000","00","160","0001","0710","413","243","170","54","467","872","0","53.56","27.87"
"64","000","00","160","0002","0000","1651","999","652","96","1747","3126","0","55.89","31.96"
"64","000","00","160","0002","0711","551","356","195","62","613","947","0","64.73","37.59"
"64","000","00","160","0002","0712","562","317","245","12","574","1106","0","51.90","28.66"
"64","000","00","160","0002","0713","538","326","212","22","560","1073","0","52.19","30.38"
"64","000","00","160","0003","0000","2585","1601","984","150","2735","4784","0","57.17","33.47"
"64","000","00","160","0003","0714","536","334","202","26","562","1008","0","55.75","33.13"
"64","000","00","160","0003","0715","465","308","157","40","505","968","0","52.17","31.82"
"64","000","00","160","0003","0716","584","367","217","25","609","1006","0","60.54","36.48"
"64","000","00","160","0003","0717","584","350","234","34","618","1021","0","60.53","34.28"
"64","000","00","160","0003","0718","416","242","174","25","441","781","0","56.47","30.99"
"64","000","00","160","0004","0000","917","593","324","86","1003","1586","0","63.24","37.39"
"64","000","00","160","0004","0737","398","276","122","49","447","695","0","64.32","39.71"
"64","000","00","160","0004","0738","519","317","202","37","556","891","0","62.40","35.58"
"64","000","00","160","0005","0000","1406","934","472","121","1527","2602","0","58.69","35.90"
"64","000","00","160","0005","0722","537","337","200","43","580","1026","0","56.53","32.85"
"64","000","00","160","0005","0723","500","331","169","45","545","841","0","64.80","39.36"
"64","000","00","160","0005","0724","369","266","103","33","402","735","0","54.69","36.19"
"64","000","00","160","0006","0000","2820","1787","1033","182","3002","5259","0","57.08","33.98"
"64","000","00","160","0006","0725","658","437","221","57","715","1081","0","66.14","40.43"
"64","000","00","160","0006","0726","561","342","219","18","579","1111","0","52.12","30.78"
"64","000","00","160","0006","0727","539","354","185","49","588","1079","0","54.49","32.81"
"64","000","00","160","0006","0728","541","328","213","34","575","1013","0","56.76","32.38"
"64","000","00","160","0006","0729","521","326","195","24","545","975","0","55.90","33.44"
"64","000","00","160","0007","0000","2532","1504","1028","155","2687","4800","0","55.98","31.33"
"64","000","00","160","0007","0730","678","414","264","37","715","1238","0","57.75","33.44"
"64","000","00","160","0007","0731","635","373","262","45","680","1248","0","54.49","29.89"
"64","000","00","160","0007","0732","644","382","262","43","687","1190","0","57.73","32.10"
"64","000","00","160","0007","0733","575","335","240","30","605","1124","0","53.83","29.80"
"64","000","00","160","0008","0000","1547","962","585","122","1669","3078","0","54.22","31.25"
"64","000","00","160","0008","0734","563","361","202","50","613","1052","0","58.27","34.32"
"64","000","00","160","0008","0735","552","343","209","29","581","1137","0","51.10","30.17"
"64","000","00","160","0008","0736","432","258","174","43","475","889","0","53.43","29.02"
"64","000","00","160","0009","0000","1432","992","440","74","1506","3065","0","49.14","32.37"
"64","000","00","160","0009","0719","475","357","118","23","498","1023","0","48.68","34.90"
"64","000","00","160","0009","0720","517","326","191","24","541","1028","0","52.63","31.71"
"64","000","00","160","0009","0721","440","309","131","27","467","1014","0","46.06","30.47"
"64","000","00","170","0000","0000","41571","25322","16249","2012","43583","78843","94814","55.28","32.12"
"64","000","00","170","0001","0000","2454","1493","961","92","2546","4528","0","56.23","32.97"
"64","000","00","170","0001","0739","819","493","326","35","854","1435","0","59.51","34.36"
"64","000","00","170","0001","0740","854","536","318","20","874","1601","0","54.59","33.48"
"64","000","00","170","0001","0741","781","464","317","37","818","1492","0","54.83","31.10"
"64","000","00","170","0002","0000","3839","2384","1455","197","4036","8060","0","50.07","29.58"
"64","000","00","170","0002","0742","662","433","229","39","701","1372","0","51.09","31.56"
"64","000","00","170","0002","0743","563","366","197","36","599","1144","0","52.36","31.99"
"64","000","00","170","0002","0744","637","434","203","44","681","1277","0","53.33","33.99"
"64","000","00","170","0002","0745","587","371","216","26","613","1309","0","46.83","28.34"
"64","000","00","170","0002","0746","678","368","310","18","696","1467","0","47.44","25.09"
"64","000","00","170","0002","0747","712","412","300","34","746","1491","0","50.03","27.63"
"64","000","00","170","0003","0000","1478","907","571","99","1577","2545","0","61.96","35.64"
"64","000","00","170","0003","0748","729","466","263","45","774","1294","0","59.81","36.01"
"64","000","00","170","0003","0749","749","441","308","54","803","1251","0","64.19","35.25"
"64","000","00","170","0004","0000","2026","1235","791","165","2191","3608","0","60.73","34.23"
"64","000","00","170","0004","0750","646","390","256","43","689","1138","0","60.54","34.27"
"64","000","00","170","0004","0751","632","396","236","74","706","1119","0","63.09","35.39"
"64","000","00","170","0004","0752","748","449","299","48","796","1351","0","58.92","33.23"
"64","000","00","170","0005","0000","456","289","167","36","492","827","0","59.49","34.95"
"64","000","00","170","0005","0753","456","289","167","36","492","827","0","59.49","34.95"
"64","000","00","170","0006","0000","2659","1733","926","162","2821","5301","0","53.22","32.69"
"64","000","00","170","0006","0754","736","471","265","46","782","1330","0","58.80","35.41"
"64","000","00","170","0006","0755","494","325","169","27","521","1332","0","39.11","24.40"
"64","000","00","170","0006","0756","765","507","258","51","816","1344","0","60.71","37.72"
"64","000","00","170","0006","0757","664","430","234","38","702","1295","0","54.21","33.20"
"64","000","00","170","0007","0000","4775","2995","1780","193","4968","9022","0","55.07","33.20"
"64","000","00","170","0007","0758","762","513","249","30","792","1506","0","52.59","34.06"
"64","000","00","170","0007","0759","708","436","272","16","724","1557","0","46.50","28.00"
"64","000","00","170","0007","0760","796","506","290","44","840","1465","0","57.34","34.54"
"64","000","00","170","0007","0761","871","515","356","38","909","1599","0","56.85","32.21"
"64","000","00","170","0007","0762","816","488","328","21","837","1430","0","58.53","34.13"
"64","000","00","170","0007","0763","822","537","285","44","866","1465","0","59.11","36.66"
"64","000","00","170","0008","0000","1348","943","405","87","1435","2134","0","67.24","44.19"
"64","000","00","170","0008","0764","624","441","183","39","663","987","0","67.17","44.68"
"64","000","00","170","0008","0765","724","502","222","48","772","1147","0","67.31","43.77"
"64","000","00","170","0009","0000","8915","5162","3753","304","9219","18080","0","50.99","28.55"
"64","000","00","170","0009","0766","788","467","321","30","818","1485","0","55.08","31.45"
"64","000","00","170","0009","0767","768","527","241","30","798","1492","0","53.49","35.32"
"64","000","00","170","0009","0768","697","409","288","16","713","1447","0","49.27","28.27"
"64","000","00","170","0009","0769","678","398","280","41","719","1372","0","52.41","29.01"
"64","000","00","170","0009","0770","745","413","332","30","775","1415","0","54.77","29.19"
"64","000","00","170","0009","0771","728","408","320","19","747","1539","0","48.54","26.51"
"64","000","00","170","0009","0772","673","368","305","33","706","1382","0","51.09","26.63"
"64","000","00","170","0009","0773","718","428","290","19","737","1434","0","51.39","29.85"
"64","000","00","170","0009","0774","715","402","313","20","735","1438","0","51.11","27.96"
"64","000","00","170","0009","0775","694","366","328","22","716","1378","0","51.96","26.56"
"64","000","00","170","0009","0776","694","381","313","17","711","1457","0","48.80","26.15"
"64","000","00","170","0009","0777","1017","595","422","27","1044","2241","0","46.59","26.55"
"64","000","00","170","0010","0000","1398","851","547","103","1501","2839","0","52.87","29.98"
"64","000","00","170","0010","0778","715","448","267","57","772","1495","0","51.64","29.97"
"64","000","00","170","0010","0779","683","403","280","46","729","1344","0","54.24","29.99"
"64","000","00","170","0011","0000","1401","917","484","128","1529","2461","0","62.13","37.26"
"64","000","00","170","0011","0780","683","439","244","72","755","1234","0","61.18","35.58"
"64","000","00","170","0011","0781","718","478","240","56","774","1227","0","63.08","38.96"
"64","000","00","170","0012","0000","963","564","399","61","1024","1551","0","66.02","36.36"
"64","000","00","170","0012","0782","963","564","399","61","1024","1551","0","66.02","36.36"
"64","000","00","170","0013","0000","2627","1598","1029","129","2756","5154","0","53.47","31.01"
"64","000","00","170","0013","0783","646","417","229","36","682","1371","0","49.74","30.42"
"64","000","00","170","0013","0784","662","391","271","39","701","1263","0","55.50","30.96"
"64","000","00","170","0013","0785","646","359","287","21","667","1258","0","53.02","28.54"
"64","000","00","170","0013","0786","673","431","242","33","706","1262","0","55.94","34.15"
"64","000","00","170","0014","0000","2065","1216","849","77","2142","3765","0","56.89","32.30"
"64","000","00","170","0014","0787","724","416","308","42","766","1260","0","60.79","33.02"
"64","000","00","170","0014","0788","657","400","257","23","680","1250","0","54.40","32.00"
"64","000","00","170","0014","0789","684","400","284","12","696","1255","0","55.46","31.87"
"64","000","00","170","0015","0000","3728","2205","1523","136","3864","6784","0","56.96","32.50"
"64","000","00","170","0015","0790","790","477","313","43","833","1372","0","60.71","34.77"
"64","000","00","170","0015","0791","708","418","290","22","730","1331","0","54.85","31.40"
"64","000","00","170","0015","0792","740","424","316","20","760","1314","0","57.84","32.27"
"64","000","00","170","0015","0793","686","390","296","17","703","1297","0","54.20","30.07"
"64","000","00","170","0015","0794","804","496","308","34","838","1470","0","57.01","33.74"
"64","000","00","170","0016","0000","1439","830","609","43","1482","2184","0","67.86","38.00"
"64","000","00","170","0016","0795","714","401","313","25","739","1073","0","68.87","37.37"
"64","000","00","170","0016","0796","725","429","296","18","743","1111","0","66.88","38.61"
"64","000","00","180","0000","0000","21023","12343","8680","1071","22094","38419","44015","57.51","32.13"
"64","000","00","180","0001","0000","5165","3022","2143","278","5443","10034","0","54.25","30.12"
"64","000","00","180","0001","0797","700","393","307","53","753","1226","0","61.42","32.06"
"64","000","00","180","0001","0798","677","392","285","46","723","1190","0","60.76","32.94"
"64","000","00","180","0001","0799","691","401","290","38","729","1301","0","56.03","30.82"
"64","000","00","180","0001","0800","704","407","297","34","738","1321","0","55.87","30.81"
"64","000","00","180","0001","0801","613","339","274","32","645","1362","0","47.36","24.89"
"64","000","00","180","0001","0802","607","342","265","29","636","1262","0","50.40","27.10"
"64","000","00","180","0001","0803","617","378","239","40","657","1202","0","54.66","31.45"
"64","000","00","180","0001","0804","556","370","186","6","562","1170","0","48.03","31.62"
"64","000","00","180","0002","0000","2497","1470","1027","90","2587","4738","0","54.60","31.03"
"64","000","00","180","0002","0805","751","440","311","28","779","1340","0","58.13","32.84"
"64","000","00","180","0002","0806","686","437","249","34","720","1164","0","61.86","37.54"
"64","000","00","180","0002","0807","466","257","209","9","475","1040","0","45.67","24.71"
"64","000","00","180","0002","0808","594","336","258","19","613","1194","0","51.34","28.14"
"64","000","00","180","0003","0000","5223","2879","2344","175","5398","9447","0","57.14","30.48"
"64","000","00","180","0003","0809","697","426","271","18","715","1189","0","60.13","35.83"
"64","000","00","180","0003","0810","713","368","345","44","757","1279","0","59.19","28.77"
"64","000","00","180","0003","0811","654","382","272","18","672","1222","0","54.99","31.26"
"64","000","00","180","0003","0812","581","306","275","14","595","1100","0","54.09","27.82"
"64","000","00","180","0003","0813","573","285","288","11","584","1058","0","55.20","26.94"
"64","000","00","180","0003","0814","692","386","306","16","708","1248","0","56.73","30.93"
"64","000","00","180","0003","0815","681","409","272","36","717","1168","0","61.39","35.02"
"64","000","00","180","0003","0816","632","317","315","18","650","1183","0","54.95","26.80"
"64","000","00","180","0004","0000","2019","1233","786","150","2169","3383","0","64.11","36.45"
"64","000","00","180","0004","0817","714","438","276","60","774","1198","0","64.61","36.56"
"64","000","00","180","0004","0818","669","401","268","55","724","1116","0","64.87","35.93"
"64","000","00","180","0004","0819","636","394","242","35","671","1069","0","62.77","36.86"
"64","000","00","180","0005","0000","3578","2179","1399","222","3800","6430","0","59.10","33.89"
"64","000","00","180","0005","0820","709","431","278","47","756","1200","0","63.00","35.92"
"64","000","00","180","0005","0821","910","552","358","52","962","1593","0","60.39","34.65"
"64","000","00","180","0005","0822","687","435","252","46","733","1330","0","55.11","32.71"
"64","000","00","180","0005","0823","672","405","267","38","710","1252","0","56.71","32.35"
"64","000","00","180","0005","0824","600","356","244","39","639","1055","0","60.57","33.74"
"64","000","00","180","0006","0000","392","265","127","33","425","659","0","64.49","40.21"
"64","000","00","180","0006","0825","392","265","127","33","425","659","0","64.49","40.21"
"64","000","00","180","0007","0000","2149","1295","854","123","2272","3728","0","60.94","34.74"
"64","000","00","180","0007","0826","742","471","271","47","789","1278","0","61.74","36.85"
"64","000","00","180","0007","0827","692","414","278","46","738","1206","0","61.19","34.33"
"64","000","00","180","0007","0828","715","410","305","30","745","1244","0","59.89","32.96"
"64","000","00","190","0000","0000","45173","25546","19627","2784","47957","78564","95159","61.04","32.52"
"64","000","00","190","0001","0000","585","336","249","33","618","1011","0","61.13","33.23"
"64","000","00","190","0001","0289","585","336","249","33","618","1011","0","61.13","33.23"
"64","000","00","190","0002","0000","2123","1219","904","112","2235","4197","0","53.25","29.04"
"64","000","00","190","0002","0282","712","381","331","30","742","1288","0","57.61","29.58"
"64","000","00","190","0002","0283","414","277","137","28","442","1053","0","41.98","26.31"
"64","000","00","190","0002","0284","499","280","219","23","522","1000","0","52.20","28.00"
"64","000","00","190","0002","0285","498","281","217","31","529","856","0","61.80","32.83"
"64","000","00","190","0003","0000","1692","922","770","76","1768","3029","0","58.37","30.44"
"64","000","00","190","0003","0286","461","264","197","19","480","878","0","54.67","30.07"
"64","000","00","190","0003","0287","579","338","241","23","602","1026","0","58.67","32.94"
"64","000","00","190","0003","0288","652","320","332","34","686","1125","0","60.98","28.44"
"64","000","00","190","0004","0000","559","328","231","35","594","918","0","64.71","35.73"
"64","000","00","190","0004","0290","559","328","231","35","594","918","0","64.71","35.73"
"64","000","00","190","0005","0000","2266","1203","1063","105","2371","4040","0","58.69","29.78"
"64","000","00","190","0005","0295","750","447","303","46","796","1284","0","61.99","34.81"
"64","000","00","190","0005","0296","775","417","358","33","808","1383","0","58.42","30.15"
"64","000","00","190","0005","0297","741","339","402","26","767","1373","0","55.86","24.69"
"64","000","00","190","0006","0000","945","634","311","67","1012","1346","0","75.19","47.10"
"64","000","00","190","0006","0291","945","634","311","67","1012","1346","0","75.19","47.10"
"64","000","00","190","0007","0000","1500","488","1012","68","1568","2695","0","58.18","18.11"
"64","000","00","190","0007","0347","680","214","466","24","704","1239","0","56.82","17.27"
"64","000","00","190","0007","0348","625","169","456","38","663","1151","0","57.60","14.68"
"64","000","00","190","0007","0349","195","105","90","6","201","305","0","65.90","34.43"
"64","000","00","190","0008","0000","191","109","82","6","197","328","0","60.06","33.23"
"64","000","00","190","0008","0354","191","109","82","6","197","328","0","60.06","33.23"
"64","000","00","190","0009","0000","1411","849","562","87","1498","2717","0","55.13","31.25"
"64","000","00","190","0009","0315","693","422","271","44","737","1272","0","57.94","33.18"
"64","000","00","190","0009","0316","718","427","291","43","761","1445","0","52.66","29.55"
"64","000","00","190","0010","0000","940","602","338","66","1006","1404","0","71.65","42.88"
"64","000","00","190","0010","0331","940","602","338","66","1006","1404","0","71.65","42.88"
"64","000","00","190","0011","0000","1906","1053","853","117","2023","3436","0","58.88","30.65"
"64","000","00","190","0011","0326","658","371","287","43","701","1218","0","57.55","30.46"
"64","000","00","190","0011","0327","569","308","261","30","599","1001","0","59.84","30.77"
"64","000","00","190","0011","0328","679","374","305","44","723","1217","0","59.41","30.73"
"64","000","00","190","0012","0000","2960","1595","1365","197","3157","5277","0","59.83","30.23"
"64","000","00","190","0012","0322","731","423","308","60","791","1263","0","62.63","33.49"
"64","000","00","190","0012","0323","801","442","359","52","853","1339","0","63.70","33.01"
"64","000","00","190","0012","0324","738","378","360","43","781","1280","0","61.02","29.53"
"64","000","00","190","0012","0325","690","352","338","42","732","1395","0","52.47","25.23"
"64","000","00","190","0013","0000","913","421","492","71","984","1512","0","65.08","27.84"
"64","000","00","190","0013","0352","484","239","245","48","532","803","0","66.25","29.76"
"64","000","00","190","0013","0353","429","182","247","23","452","709","0","63.75","25.67"
"64","000","00","190","0014","0000","417","308","109","50","467","738","0","63.28","41.73"
"64","000","00","190","0014","0342","417","308","109","50","467","738","0","63.28","41.73"
"64","000","00","190","0015","0000","609","368","241","54","663","829","0","79.98","44.39"
"64","000","00","190","0015","0345","609","368","241","54","663","829","0","79.98","44.39"
"64","000","00","190","0016","0000","1804","1028","776","99","1903","3147","0","60.47","32.67"
"64","000","00","190","0016","0319","615","373","242","29","644","988","0","65.18","37.75"
"64","000","00","190","0016","0320","585","331","254","40","625","1001","0","62.44","33.07"
"64","000","00","190","0016","0321","604","324","280","30","634","1158","0","54.75","27.98"
"64","000","00","190","0017","0000","2061","1240","821","113","2174","3702","0","58.73","33.50"
"64","000","00","190","0017","0298","687","422","265","50","737","1184","0","62.25","35.64"
"64","000","00","190","0017","0299","623","371","252","26","649","1191","0","54.49","31.15"
"64","000","00","190","0017","0300","751","447","304","37","788","1327","0","59.38","33.69"
"64","000","00","190","0018","0000","2178","1152","1026","110","2288","3962","0","57.75","29.08"
"64","000","00","190","0018","0292","725","409","316","37","762","1300","0","58.62","31.46"
"64","000","00","190","0018","0293","735","397","338","43","778","1329","0","58.54","29.87"
"64","000","00","190","0018","0294","718","346","372","30","748","1333","0","56.11","25.96"
"64","000","00","190","0019","0000","3603","2127","1476","148","3751","6574","0","57.06","32.35"
"64","000","00","190","0019","0301","642","388","254","32","674","1184","0","56.93","32.77"
"64","000","00","190","0019","0302","712","440","272","40","752","1246","0","60.35","35.31"
"64","000","00","190","0019","0303","690","381","309","16","706","1260","0","56.03","30.24"
"64","000","00","190","0019","0304","758","451","307","33","791","1349","0","58.64","33.43"
"64","000","00","190","0019","0305","801","467","334","27","828","1535","0","53.94","30.42"
"64","000","00","190","0020","0000","2912","1656","1256","172","3084","5695","0","54.15","29.08"
"64","000","00","190","0020","0306","783","449","334","54","837","1513","0","55.32","29.68"
"64","000","00","190","0020","0307","866","475","391","43","909","1653","0","54.99","28.74"
"64","000","00","190","0020","0308","661","372","289","35","696","1423","0","48.91","26.14"
"64","000","00","190","0020","0309","602","360","242","40","642","1106","0","58.05","32.55"
"64","000","00","190","0021","0000","1018","615","403","58","1076","1789","0","60.15","34.38"
"64","000","00","190","0021","0311","536","314","222","40","576","966","0","59.63","32.51"
"64","000","00","190","0021","0312","482","301","181","18","500","823","0","60.75","36.57"
"64","000","00","190","0022","0000","1235","689","546","54","1289","1908","0","67.56","36.11"
"64","000","00","190","0022","0332","589","363","226","28","617","884","0","69.80","41.06"
"64","000","00","190","0022","0333","646","326","320","26","672","1024","0","65.63","31.84"
"64","000","00","190","0023","0000","1062","650","412","81","1143","1792","0","63.78","36.27"
"64","000","00","190","0023","0334","464","308","156","52","516","828","0","62.32","37.20"
"64","000","00","190","0023","0335","598","342","256","29","627","964","0","65.04","35.48"
"64","000","00","190","0024","0000","638","384","254","50","688","1018","0","67.58","37.72"
"64","000","00","190","0024","0336","638","384","254","50","688","1018","0","67.58","37.72"
"64","000","00","190","0025","0000","1059","667","392","116","1175","1622","0","72.44","41.12"
"64","000","00","190","0025","0313","524","336","188","74","598","801","0","74.66","41.95"
"64","000","00","190","0025","0314","535","331","204","42","577","821","0","70.28","40.32"
"64","000","00","190","0026","0000","1991","1334","657","152","2143","3228","0","66.39","41.33"
"64","000","00","190","0026","0337","618","435","183","40","658","981","0","67.07","44.34"
"64","000","00","190","0026","0338","587","391","196","60","647","968","0","66.84","40.39"
"64","000","00","190","0026","0339","786","508","278","52","838","1279","0","65.52","39.72"
"64","000","00","190","0027","0000","1058","681","377","96","1154","1673","0","68.98","40.71"
"64","000","00","190","0027","0340","873","552","321","86","959","1390","0","68.99","39.71"
"64","000","00","190","0027","0341","185","129","56","10","195","283","0","68.90","45.58"
"64","000","00","190","0028","0000","1016","701","315","87","1103","1493","0","73.88","46.95"
"64","000","00","190","0028","0343","479","318","161","42","521","698","0","74.64","45.56"
"64","000","00","190","0028","0344","537","383","154","45","582","795","0","73.21","48.18"
"64","000","00","190","0029","0000","640","373","267","66","706","950","0","74.32","39.26"
"64","000","00","190","0029","0346","640","373","267","66","706","950","0","74.32","39.26"
"64","000","00","190","0030","0000","1129","564","565","73","1202","2009","0","59.83","28.07"
"64","000","00","190","0030","0329","491","239","252","36","527","854","0","61.71","27.99"
"64","000","00","190","0030","0330","638","325","313","37","675","1155","0","58.44","28.14"
"64","000","00","190","0031","0000","511","333","178","46","557","662","0","84.14","50.30"
"64","000","00","190","0031","0310","511","333","178","46","557","662","0","84.14","50.30"
"64","000","00","190","0032","0000","1169","640","529","75","1244","2157","0","57.67","29.67"
"64","000","00","190","0032","0317","522","287","235","28","550","914","0","60.18","31.40"
"64","000","00","190","0032","0318","647","353","294","47","694","1243","0","55.83","28.40"
"64","000","00","190","0033","0000","1072","277","795","44","1116","1706","0","65.42","16.24"
"64","000","00","190","0033","0350","549","154","395","25","574","868","0","66.13","17.74"
"64","000","00","190","0033","0351","523","123","400","19","542","838","0","64.68","14.68"
"64","000","00","200","0000","0000","20160","12792","7368","1223","21383","34409","40306","62.14","37.18"
"64","000","00","200","0001","0000","1217","706","511","71","1288","2005","0","64.24","35.21"
"64","000","00","200","0001","0428","595","356","239","37","632","932","0","67.81","38.20"
"64","000","00","200","0001","0429","622","350","272","34","656","1073","0","61.14","32.62"
"64","000","00","200","0002","0000","616","395","221","49","665","1019","0","65.26","38.76"
"64","000","00","200","0002","0430","616","395","221","49","665","1019","0","65.26","38.76"
"64","000","00","200","0003","0000","1391","867","524","74","1465","2155","0","67.98","40.23"
"64","000","00","200","0003","0431","731","449","282","38","769","1137","0","67.63","39.49"
"64","000","00","200","0003","0432","660","418","242","36","696","1018","0","68.37","41.06"
"64","000","00","200","0004","0000","1625","1029","596","113","1738","2556","0","68.00","40.26"
"64","000","00","200","0004","0433","782","484","298","58","840","1307","0","64.27","37.03"
"64","000","00","200","0004","0434","843","545","298","55","898","1249","0","71.90","43.63"
"64","000","00","200","0005","0000","820","533","287","64","884","1142","0","77.41","46.67"
"64","000","00","200","0005","0435","820","533","287","64","884","1142","0","77.41","46.67"
"64","000","00","200","0006","0000","1226","815","411","91","1317","2191","0","60.11","37.20"
"64","000","00","200","0006","0436","550","357","193","46","596","984","0","60.57","36.28"
"64","000","00","200","0006","0437","676","458","218","45","721","1207","0","59.73","37.95"
"64","000","00","200","0007","0000","846","601","245","53","899","1329","0","67.64","45.22"
"64","000","00","200","0007","0438","424","306","118","28","452","649","0","69.65","47.15"
"64","000","00","200","0007","0439","422","295","127","25","447","680","0","65.74","43.38"
"64","000","00","200","0008","0000","1743","1026","717","98","1841","3123","0","58.95","32.85"
"64","000","00","200","0008","0440","662","405","257","37","699","1234","0","56.65","32.82"
"64","000","00","200","0008","0441","681","402","279","39","720","1186","0","60.71","33.90"
"64","000","00","200","0008","0442","400","219","181","22","422","703","0","60.03","31.15"
"64","000","00","200","0009","0000","921","619","302","55","976","1464","0","66.67","42.28"
"64","000","00","200","0009","0443","522","341","181","29","551","884","0","62.33","38.57"
"64","000","00","200","0009","0444","399","278","121","26","425","580","0","73.28","47.93"
"64","000","00","200","0010","0000","2576","1523","1053","69","2645","4982","0","53.09","30.57"
"64","000","00","200","0010","0445","527","353","174","28","555","807","0","68.77","43.74"
"64","000","00","200","0010","0446","245","151","94","7","252","336","0","75.00","44.94"
"64","000","00","200","0010","0447","777","452","325","13","790","1750","0","45.14","25.83"
"64","000","00","200","0010","0448","539","294","245","9","548","1069","0","51.26","27.50"
"64","000","00","200","0010","0449","488","273","215","12","500","1020","0","49.02","26.76"
"64","000","00","200","0011","0000","1304","851","453","110","1414","2480","0","57.02","34.31"
"64","000","00","200","0011","0450","634","426","208","59","693","1050","0","66.00","40.57"
"64","000","00","200","0011","0451","670","425","245","51","721","1430","0","50.42","29.72"
"64","000","00","200","0012","0000","1260","784","476","93","1353","2342","0","57.77","33.48"
"64","000","00","200","0012","0452","642","394","248","62","704","1167","0","60.33","33.76"
"64","000","00","200","0012","0453","618","390","228","31","649","1175","0","55.23","33.19"
"64","000","00","200","0013","0000","703","464","239","36","739","1298","0","56.93","35.75"
"64","000","00","200","0013","0454","703","464","239","36","739","1298","0","56.93","35.75"
"64","000","00","200","0014","0000","429","303","126","24","453","632","0","71.68","47.94"
"64","000","00","200","0014","0455","429","303","126","24","453","632","0","71.68","47.94"
"64","000","00","200","0015","0000","2054","1340","714","129","2183","3507","0","62.25","38.21"
"64","000","00","200","0015","0456","706","461","245","45","751","1183","0","63.48","38.97"
"64","000","00","200","0015","0457","694","469","225","41","735","1190","0","61.76","39.41"
"64","000","00","200","0015","0458","654","410","244","43","697","1134","0","61.46","36.16"
"64","000","00","200","0016","0000","909","565","344","62","971","1422","0","68.28","39.73"
"64","000","00","200","0016","0459","537","325","212","38","575","822","0","69.95","39.54"
"64","000","00","200","0016","0460","372","240","132","24","396","600","0","66.00","40.00"
"64","000","00","200","0017","0000","520","371","149","32","552","762","0","72.44","48.69"
"64","000","00","200","0017","0461","520","371","149","32","552","762","0","72.44","48.69"
"64","000","00","210","0000","0000","13396","8134","5262","1172","14568","25188","28955","57.84","32.29"
"64","000","00","210","0001","0000","574","341","233","70","644","1119","0","57.55","30.47"
"64","000","00","210","0001","0355","574","341","233","70","644","1119","0","57.55","30.47"
"64","000","00","210","0002","0000","1143","746","397","106","1249","2012","0","62.08","37.08"
"64","000","00","210","0002","0356","594","386","208","57","651","1098","0","59.29","35.15"
"64","000","00","210","0002","0357","549","360","189","49","598","914","0","65.43","39.39"
"64","000","00","210","0003","0000","1804","1128","676","189","1993","3241","0","61.49","34.80"
"64","000","00","210","0003","0358","583","378","205","43","626","983","0","63.68","38.45"
"64","000","00","210","0003","0359","568","323","245","51","619","1060","0","58.40","30.47"
"64","000","00","210","0003","0360","567","379","188","75","642","987","0","65.05","38.40"
"64","000","00","210","0003","0361","86","48","38","20","106","211","0","50.24","22.75"
"64","000","00","210","0004","0000","1609","953","656","147","1756","2640","0","66.52","36.10"
"64","000","00","210","0004","0362","597","341","256","82","679","884","0","76.81","38.57"
"64","000","00","210","0004","0363","357","247","110","34","391","598","0","65.38","41.30"
"64","000","00","210","0004","0364","655","365","290","31","686","1158","0","59.24","31.52"
"64","000","00","210","0005","0000","1220","742","478","100","1320","2361","0","55.91","31.43"
"64","000","00","210","0005","0365","518","334","184","40","558","1027","0","54.33","32.52"
"64","000","00","210","0005","0366","702","408","294","60","762","1334","0","57.12","30.58"
"64","000","00","210","0006","0000","290","137","153","36","326","438","0","74.43","31.28"
"64","000","00","210","0006","0367","290","137","153","36","326","438","0","74.43","31.28"
"64","000","00","210","0007","0000","1067","680","387","83","1150","2248","0","51.16","30.25"
"64","000","00","210","0007","0368","532","326","206","43","575","1154","0","49.83","28.25"
"64","000","00","210","0007","0369","535","354","181","40","575","1094","0","52.56","32.36"
"64","000","00","210","0008","0000","1949","1142","807","131","2080","3740","0","55.61","30.53"
"64","000","00","210","0008","0370","614","393","221","57","671","1081","0","62.07","36.36"
"64","000","00","210","0008","0371","622","365","257","59","681","1340","0","50.82","27.24"
"64","000","00","210","0008","0372","713","384","329","15","728","1319","0","55.19","29.11"
"64","000","00","210","0009","0000","1569","956","613","98","1667","3216","0","51.83","29.73"
"64","000","00","210","0009","0373","494","316","178","46","540","926","0","58.32","34.13"
"64","000","00","210","0009","0374","557","319","238","36","593","1044","0","56.80","30.56"
"64","000","00","210","0009","0375","518","321","197","16","534","1246","0","42.86","25.76"
"64","000","00","210","0010","0000","980","577","403","99","1079","1823","0","59.19","31.65"
"64","000","00","210","0010","0376","431","254","177","44","475","725","0","65.52","35.03"
"64","000","00","210","0010","0377","549","323","226","55","604","1098","0","55.01","29.42"
"64","000","00","210","0011","0000","1191","732","459","113","1304","2350","0","55.49","31.15"
"64","000","00","210","0011","0378","723","452","271","73","796","1367","0","58.23","33.07"
"64","000","00","210","0011","0379","468","280","188","40","508","983","0","51.68","28.48"
"64","000","00","220","0000","0000","3519","2283","1236","547","4066","6156","6679","66.05","37.09"
"64","000","00","220","0001","0000","246","153","93","37","283","351","0","80.63","43.59"
"64","000","00","220","0001","0257","246","153","93","37","283","351","0","80.63","43.59"
"64","000","00","220","0002","0000","544","356","188","80","624","966","0","64.60","36.85"
"64","000","00","220","0002","0258","379","236","143","67","446","605","0","73.72","39.01"
"64","000","00","220","0002","0259","165","120","45","13","178","361","0","49.31","33.24"
"64","000","00","220","0003","0000","274","188","86","35","309","352","0","87.78","53.41"
"64","000","00","220","0003","0260","274","188","86","35","309","352","0","87.78","53.41"
"64","000","00","220","0004","0000","165","119","46","17","182","345","0","52.75","34.49"
"64","000","00","220","0004","0261","165","119","46","17","182","345","0","52.75","34.49"
"64","000","00","220","0005","0000","446","290","156","54","500","599","0","83.47","48.41"
"64","000","00","220","0005","0262","446","290","156","54","500","599","0","83.47","48.41"
"64","000","00","220","0006","0000","439","262","177","67","506","896","0","56.47","29.24"
"64","000","00","220","0006","0263","439","262","177","67","506","896","0","56.47","29.24"
"64","000","00","220","0007","0000","386","237","149","73","459","738","0","62.20","32.11"
"64","000","00","220","0007","0264","386","237","149","73","459","738","0","62.20","32.11"
"64","000","00","220","0008","0000","157","95","62","23","180","314","0","57.32","30.25"
"64","000","00","220","0008","0265","157","95","62","23","180","314","0","57.32","30.25"
"64","000","00","220","0009","0000","292","189","103","89","381","475","0","80.21","39.79"
"64","000","00","220","0009","0266","292","189","103","89","381","475","0","80.21","39.79"
"64","000","00","220","0010","0000","570","394","176","72","642","1120","0","57.32","35.18"
"64","000","00","220","0010","0267","276","194","82","38","314","559","0","56.17","34.70"
"64","000","00","220","0010","0268","294","200","94","34","328","561","0","58.47","35.65"
"64","000","00","230","0000","0000","12192","7678","4514","1291","13483","23442","27641","57.52","32.75"
"64","000","00","230","0001","0000","769","538","231","92","861","1236","0","69.66","43.53"
"64","000","00","230","0001","0232","769","538","231","92","861","1236","0","69.66","43.53"
"64","000","00","230","0002","0000","1119","737","382","128","1247","1896","0","65.77","38.87"
"64","000","00","230","0002","0233","574","382","192","59","633","967","0","65.46","39.50"
"64","000","00","230","0002","0234","545","355","190","69","614","929","0","66.09","38.21"
"64","000","00","230","0003","0000","615","405","210","68","683","1166","0","58.58","34.73"
"64","000","00","230","0003","0235","615","405","210","68","683","1166","0","58.58","34.73"
"64","000","00","230","0004","0000","1113","683","430","146","1259","2066","0","60.94","33.06"
"64","000","00","230","0004","0236","392","234","158","51","443","669","0","66.22","34.98"
"64","000","00","230","0004","0237","431","260","171","63","494","861","0","57.38","30.20"
"64","000","00","230","0004","0238","290","189","101","32","322","536","0","60.07","35.26"
"64","000","00","230","0005","0000","432","275","157","89","521","763","0","68.28","36.04"
"64","000","00","230","0005","0239","432","275","157","89","521","763","0","68.28","36.04"
"64","000","00","230","0006","0000","2245","1352","893","155","2400","4691","0","51.16","28.82"
"64","000","00","230","0006","0240","542","315","227","64","606","1160","0","52.24","27.16"
"64","000","00","230","0006","0241","521","322","199","32","553","1104","0","50.09","29.17"
"64","000","00","230","0006","0242","564","369","195","22","586","1169","0","50.13","31.57"
"64","000","00","230","0006","0243","618","346","272","37","655","1258","0","52.07","27.50"
"64","000","00","230","0007","0000","1315","834","481","128","1443","2507","0","57.56","33.27"
"64","000","00","230","0007","0244","453","282","171","29","482","882","0","54.65","31.97"
"64","000","00","230","0007","0245","418","268","150","53","471","797","0","59.10","33.63"
"64","000","00","230","0007","0246","444","284","160","46","490","828","0","59.18","34.30"
"64","000","00","230","0008","0000","1168","774","394","130","1298","2209","0","58.76","35.04"
"64","000","00","230","0008","0247","535","359","176","62","597","1024","0","58.30","35.06"
"64","000","00","230","0008","0248","633","415","218","68","701","1185","0","59.16","35.02"
"64","000","00","230","0009","0000","721","463","258","65","786","1485","0","52.93","31.18"
"64","000","00","230","0009","0249","378","239","139","44","422","751","0","56.19","31.82"
"64","000","00","230","0009","0250","343","224","119","21","364","734","0","49.59","30.52"
"64","000","00","230","0010","0000","797","498","299","93","890","1573","0","56.58","31.66"
"64","000","00","230","0010","0251","413","287","126","50","463","807","0","57.37","35.56"
"64","000","00","230","0010","0252","384","211","173","43","427","766","0","55.74","27.55"
"64","000","00","230","0011","0000","562","301","261","37","599","992","0","60.38","30.34"
"64","000","00","230","0011","0253","562","301","261","37","599","992","0","60.38","30.34"
"64","000","00","230","0012","0000","1336","818","518","160","1496","2858","0","52.34","28.62"
"64","000","00","230","0012","0254","509","319","190","63","572","1050","0","54.48","30.38"
"64","000","00","230","0012","0255","449","268","181","57","506","1011","0","50.05","26.51"
"64","000","00","230","0012","0256","378","231","147","40","418","797","0","52.45","28.98"
"64","000","00","240","0000","0000","23087","13684","9403","1873","24960","41802","50604","59.71","32.74"
"64","000","00","240","0001","0000","1429","869","560","124","1553","3135","0","49.54","27.72"
"64","000","00","240","0001","0188","489","302","187","57","546","985","0","55.43","30.66"
"64","000","00","240","0001","0189","476","303","173","44","520","1016","0","51.18","29.82"
"64","000","00","240","0001","0190","464","264","200","23","487","1134","0","42.95","23.28"
"64","000","00","240","0002","0000","663","377","286","94","757","1091","0","69.39","34.56"
"64","000","00","240","0002","0191","663","377","286","94","757","1091","0","69.39","34.56"
"64","000","00","240","0003","0000","701","427","274","142","843","1160","0","72.67","36.81"
"64","000","00","240","0003","0192","701","427","274","142","843","1160","0","72.67","36.81"
"64","000","00","240","0004","0000","547","350","197","59","606","1051","0","57.66","33.30"
"64","000","00","240","0004","0193","547","350","197","59","606","1051","0","57.66","33.30"
"64","000","00","240","0005","0000","846","522","324","64","910","1193","0","76.28","43.76"
"64","000","00","240","0005","0194","846","522","324","64","910","1193","0","76.28","43.76"
"64","000","00","240","0006","0000","1115","661","454","81","1196","2145","0","55.76","30.82"
"64","000","00","240","0006","0195","543","315","228","45","588","1083","0","54.29","29.09"
"64","000","00","240","0006","0196","572","346","226","36","608","1062","0","57.25","32.58"
"64","000","00","240","0007","0000","1109","672","437","99","1208","2010","0","60.10","33.43"
"64","000","00","240","0007","0197","480","301","179","33","513","898","0","57.13","33.52"
"64","000","00","240","0007","0198","629","371","258","66","695","1112","0","62.50","33.36"
"64","000","00","240","0008","0000","1668","940","728","162","1830","3129","0","58.49","30.04"
"64","000","00","240","0008","0199","510","288","222","68","578","991","0","58.32","29.06"
"64","000","00","240","0008","0200","559","305","254","51","610","937","0","65.10","32.55"
"64","000","00","240","0008","0201","599","347","252","43","642","1201","0","53.46","28.89"
"64","000","00","240","0009","0000","1408","874","534","100","1508","2514","0","59.98","34.77"
"64","000","00","240","0009","0202","435","263","172","22","457","819","0","55.80","32.11"
"64","000","00","240","0009","0203","470","285","185","45","515","813","0","63.35","35.06"
"64","000","00","240","0009","0204","503","326","177","33","536","882","0","60.77","36.96"
"64","000","00","240","0010","0000","859","562","297","80","939","1811","0","51.85","31.03"
"64","000","00","240","0010","0205","373","245","128","33","406","794","0","51.13","30.86"
"64","000","00","240","0010","0206","486","317","169","47","533","1017","0","52.41","31.17"
"64","000","00","240","0011","0000","1971","1092","879","116","2087","3336","0","62.56","32.73"
"64","000","00","240","0011","0207","512","278","234","20","532","877","0","60.66","31.70"
"64","000","00","240","0011","0208","401","208","193","35","436","688","0","63.37","30.23"
"64","000","00","240","0011","0209","491","283","208","34","525","869","0","60.41","32.57"
"64","000","00","240","0011","0210","567","323","244","27","594","902","0","65.85","35.81"
"64","000","00","240","0012","0000","1267","713","554","78","1345","2093","0","64.26","34.07"
"64","000","00","240","0012","0211","623","360","263","57","680","983","0","69.18","36.62"
"64","000","00","240","0012","0212","644","353","291","21","665","1110","0","59.91","31.80"
"64","000","00","240","0013","0000","1511","901","610","119","1630","2854","0","57.11","31.57"
"64","000","00","240","0013","0213","490","293","197","29","519","899","0","57.73","32.59"
"64","000","00","240","0013","0214","543","306","237","43","586","1021","0","57.39","29.97"
"64","000","00","240","0013","0215","478","302","176","47","525","934","0","56.21","32.33"
"64","000","00","240","0014","0000","1343","768","575","122","1465","2217","0","66.08","34.64"
"64","000","00","240","0014","0216","698","414","284","62","760","1156","0","65.74","35.81"
"64","000","00","240","0014","0217","645","354","291","60","705","1061","0","66.45","33.36"
"64","000","00","240","0015","0000","524","327","197","32","556","803","0","69.24","40.72"
"64","000","00","240","0015","0218","524","327","197","32","556","803","0","69.24","40.72"
"64","000","00","240","0016","0000","942","570","372","65","1007","1848","0","54.49","30.84"
"64","000","00","240","0016","0219","510","319","191","44","554","960","0","57.71","33.23"
"64","000","00","240","0016","0220","432","251","181","21","453","888","0","51.01","28.27"
"64","000","00","240","0017","0000","993","622","371","92","1085","1668","0","65.05","37.29"
"64","000","00","240","0017","0221","454","275","179","35","489","800","0","61.13","34.38"
"64","000","00","240","0017","0222","539","347","192","57","596","868","0","68.66","39.98"
"64","000","00","240","0018","0000","431","260","171","35","466","798","0","58.40","32.58"
"64","000","00","240","0018","0223","431","260","171","35","466","798","0","58.40","32.58"
"64","000","00","240","0019","0000","1323","785","538","61","1384","2507","0","55.21","31.31"
"64","000","00","240","0019","0224","468","286","182","18","486","866","0","56.12","33.03"
"64","000","00","240","0019","0225","419","239","180","16","435","811","0","53.64","29.47"
"64","000","00","240","0019","0226","436","260","176","27","463","830","0","55.78","31.33"
"64","000","00","240","0020","0000","2437","1392","1045","148","2585","4439","0","58.23","31.36"
"64","000","00","240","0020","0227","497","307","190","53","550","870","0","63.22","35.29"
"64","000","00","240","0020","0228","463","262","201","25","488","829","0","58.87","31.60"
"64","000","00","240","0020","0229","457","269","188","19","476","876","0","54.34","30.71"
"64","000","00","240","0020","0230","507","267","240","31","538","889","0","60.52","30.03"
"64","000","00","240","0020","0231","513","287","226","20","533","975","0","54.67","29.44"
"64","000","00","250","0000","0000","12945","8028","4917","952","13897","25145","29472","55.27","31.93"
"64","000","00","250","0001","0000","536","352","184","46","582","1027","0","56.67","34.27"
"64","000","00","250","0001","0161","536","352","184","46","582","1027","0","56.67","34.27"
"64","000","00","250","0002","0000","494","316","178","66","560","944","0","59.32","33.47"
"64","000","00","250","0002","0162","494","316","178","66","560","944","0","59.32","33.47"
"64","000","00","250","0003","0000","402","268","134","26","428","755","0","56.69","35.50"
"64","000","00","250","0003","0163","402","268","134","26","428","755","0","56.69","35.50"
"64","000","00","250","0004","0000","1233","735","498","85","1318","2173","0","60.65","33.82"
"64","000","00","250","0004","0164","616","370","246","27","643","1079","0","59.59","34.29"
"64","000","00","250","0004","0165","617","365","252","58","675","1094","0","61.70","33.36"
"64","000","00","250","0005","0000","1155","798","357","52","1207","2597","0","46.48","30.73"
"64","000","00","250","0005","0166","374","261","113","18","392","871","0","45.01","29.97"
"64","000","00","250","0005","0167","412","291","121","29","441","852","0","51.76","34.15"
"64","000","00","250","0005","0168","369","246","123","5","374","874","0","42.79","28.15"
"64","000","00","250","0006","0000","2005","1150","855","136","2141","3598","0","59.51","31.96"
"64","000","00","250","0006","0169","502","286","216","44","546","863","0","63.27","33.14"
"64","000","00","250","0006","0170","515","309","206","42","557","882","0","63.15","35.03"
"64","000","00","250","0006","0171","509","295","214","37","546","907","0","60.20","32.52"
"64","000","00","250","0006","0172","479","260","219","13","492","946","0","52.01","27.48"
"64","000","00","250","0007","0000","546","311","235","61","607","970","0","62.58","32.06"
"64","000","00","250","0007","0173","546","311","235","61","607","970","0","62.58","32.06"
"64","000","00","250","0008","0000","2035","1258","777","112","2147","3678","0","58.37","34.20"
"64","000","00","250","0008","0174","460","291","169","40","500","754","0","66.31","38.59"
"64","000","00","250","0008","0175","450","305","145","24","474","787","0","60.23","38.75"
"64","000","00","250","0008","0176","553","331","222","28","581","1033","0","56.24","32.04"
"64","000","00","250","0008","0177","572","331","241","20","592","1104","0","53.62","29.98"
"64","000","00","250","0009","0000","847","542","305","79","926","1693","0","54.70","32.01"
"64","000","00","250","0009","0178","457","296","161","31","488","875","0","55.77","33.83"
"64","000","00","250","0009","0179","390","246","144","48","438","818","0","53.55","30.07"
"64","000","00","250","0010","0000","648","415","233","41","689","1206","0","57.13","34.41"
"64","000","00","250","0010","0180","648","415","233","41","689","1206","0","57.13","34.41"
"64","000","00","250","0011","0000","1079","682","397","80","1159","2071","0","55.96","32.93"
"64","000","00","250","0011","0181","527","339","188","44","571","1038","0","55.01","32.66"
"64","000","00","250","0011","0182","552","343","209","36","588","1033","0","56.92","33.20"
"64","000","00","250","0012","0000","442","287","155","39","481","1100","0","43.73","26.09"
"64","000","00","250","0012","0183","442","287","155","39","481","1100","0","43.73","26.09"
"64","000","00","250","0013","0000","364","246","118","43","407","664","0","61.30","37.05"
"64","000","00","250","0013","0184","364","246","118","43","407","664","0","61.30","37.05"
"64","000","00","250","0014","0000","1159","668","491","86","1245","2669","0","46.65","25.03"
"64","000","00","250","0014","0185","427","243","184","38","465","901","0","51.61","26.97"
"64","000","00","250","0014","0186","398","225","173","24","422","895","0","47.15","25.14"
"64","000","00","250","0014","0187","334","200","134","24","358","873","0","41.01","22.91"
"64","000","00","260","0000","0000","12418","7776","4642","1088","13506","25416","29491","53.14","30.59"
"64","000","00","260","0001","0000","591","382","209","51","642","908","0","70.70","42.07"
"64","000","00","260","0001","0137","591","382","209","51","642","908","0","70.70","42.07"
"64","000","00","260","0002","0000","436","303","133","53","489","819","0","59.71","37.00"
"64","000","00","260","0002","0138","436","303","133","53","489","819","0","59.71","37.00"
"64","000","00","260","0003","0000","882","525","357","71","953","1672","0","57.00","31.40"
"64","000","00","260","0003","0139","509","290","219","49","558","873","0","63.92","33.22"
"64","000","00","260","0003","0140","373","235","138","22","395","799","0","49.44","29.41"
"64","000","00","260","0004","0000","1681","1027","654","103","1784","3690","0","48.35","27.83"
"64","000","00","260","0004","0141","493","298","195","45","538","1203","0","44.72","24.77"
"64","000","00","260","0004","0142","618","380","238","36","654","1287","0","50.82","29.53"
"64","000","00","260","0004","0143","570","349","221","22","592","1200","0","49.33","29.08"
"64","000","00","260","0005","0000","816","522","294","66","882","1711","0","51.55","30.51"
"64","000","00","260","0005","0144","426","268","158","38","464","921","0","50.38","29.10"
"64","000","00","260","0005","0145","390","254","136","28","418","790","0","52.91","32.15"
"64","000","00","260","0006","0000","478","298","180","34","512","1061","0","48.26","28.09"
"64","000","00","260","0006","0151","478","298","180","34","512","1061","0","48.26","28.09"
"64","000","00","260","0007","0000","1282","813","469","105","1387","2847","0","48.72","28.56"
"64","000","00","260","0007","0152","585","382","203","58","643","1256","0","51.19","30.41"
"64","000","00","260","0007","0153","697","431","266","47","744","1591","0","46.76","27.09"
"64","000","00","260","0008","0000","437","273","164","51","488","893","0","54.65","30.57"
"64","000","00","260","0008","0155","437","273","164","51","488","893","0","54.65","30.57"
"64","000","00","260","0009","0000","530","314","216","72","602","1030","0","58.45","30.49"
"64","000","00","260","0009","0154","530","314","216","72","602","1030","0","58.45","30.49"
"64","000","00","260","0010","0000","690","444","246","64","754","1100","0","68.55","40.36"
"64","000","00","260","0010","0156","690","444","246","64","754","1100","0","68.55","40.36"
"64","000","00","260","0011","0000","1093","680","413","131","1224","1998","0","61.26","34.03"
"64","000","00","260","0011","0146","417","264","153","31","448","799","0","56.07","33.04"
"64","000","00","260","0011","0147","676","416","260","100","776","1199","0","64.72","34.70"
"64","000","00","260","0012","0000","614","399","215","63","677","1032","0","65.60","38.66"
"64","000","00","260","0012","0148","614","399","215","63","677","1032","0","65.60","38.66"
"64","000","00","260","0013","0000","452","294","158","26","478","960","0","49.79","30.63"
"64","000","00","260","0013","0149","452","294","158","26","478","960","0","49.79","30.63"
"64","000","00","260","0014","0000","494","321","173","58","552","1066","0","51.78","30.11"
"64","000","00","260","0014","0150","494","321","173","58","552","1066","0","51.78","30.11"
"64","000","00","260","0015","0000","1942","1181","761","140","2082","4629","0","44.98","25.51"
"64","000","00","260","0015","0157","463","274","189","54","517","1022","0","50.59","26.81"
"64","000","00","260","0015","0158","501","317","184","37","538","1111","0","48.42","28.53"
"64","000","00","260","0015","0159","442","263","179","22","464","1132","0","40.99","23.23"
"64","000","00","260","0015","0160","536","327","209","27","563","1364","0","41.28","23.97"
"64","000","00","270","0000","0000","7233","4335","2898","569","7802","11813","13737","66.05","36.70"
"64","000","00","270","0001","0000","1069","639","430","85","1154","1586","0","72.76","40.29"
"64","000","00","270","0001","0269","534","319","215","46","580","771","0","75.23","41.37"
"64","000","00","270","0001","0270","535","320","215","39","574","815","0","70.43","39.26"
"64","000","00","270","0002","0000","1195","713","482","105","1300","1793","0","72.50","39.77"
"64","000","00","270","0002","0271","586","363","223","64","650","866","0","75.06","41.92"
"64","000","00","270","0002","0272","609","350","259","41","650","927","0","70.12","37.76"
"64","000","00","270","0003","0000","1145","701","444","77","1222","2274","0","53.74","30.83"
"64","000","00","270","0003","0273","396","242","154","21","417","810","0","51.48","29.88"
"64","000","00","270","0003","0274","353","233","120","25","378","829","0","45.60","28.11"
"64","000","00","270","0003","0275","396","226","170","31","427","635","0","67.24","35.59"
"64","000","00","270","0004","0000","201","127","74","12","213","377","0","56.50","33.69"
"64","000","00","270","0004","0276","201","127","74","12","213","377","0","56.50","33.69"
"64","000","00","270","0005","0000","1523","893","630","127","1650","2489","0","66.29","35.88"
"64","000","00","270","0005","0277","813","495","318","85","898","1296","0","69.29","38.19"
"64","000","00","270","0005","0278","710","398","312","42","752","1193","0","63.03","33.36"
"64","000","00","270","0006","0000","2100","1262","838","163","2263","3294","0","68.70","38.31"
"64","000","00","270","0006","0279","741","471","270","78","819","1102","0","74.32","42.74"
"64","000","00","270","0006","0280","660","391","269","34","694","1076","0","64.50","36.34"
"64","000","00","270","0006","0281","699","400","299","51","750","1116","0","67.20","35.84"
"64","000","00","280","0000","0000","9434","5797","3637","1242","10676","15790","18502","67.61","36.71"
"64","000","00","280","0001","0000","630","420","210","54","684","1204","0","56.81","34.88"
"64","000","00","280","0001","0380","630","420","210","54","684","1204","0","56.81","34.88"
"64","000","00","280","0002","0000","1037","665","372","111","1148","1786","0","64.28","37.23"
"64","000","00","280","0002","0381","514","317","197","65","579","872","0","66.40","36.35"
"64","000","00","280","0002","0382","523","348","175","46","569","914","0","62.25","38.07"
"64","000","00","280","0003","0000","361","210","151","58","419","517","0","81.04","40.62"
"64","000","00","280","0003","0383","361","210","151","58","419","517","0","81.04","40.62"
"64","000","00","280","0004","0000","406","241","165","53","459","744","0","61.69","32.39"
"64","000","00","280","0004","0384","406","241","165","53","459","744","0","61.69","32.39"
"64","000","00","280","0005","0000","1034","588","446","104","1138","1663","0","68.43","35.36"
"64","000","00","280","0005","0385","501","283","218","55","556","792","0","70.20","35.73"
"64","000","00","280","0005","0386","533","305","228","49","582","871","0","66.82","35.02"
"64","000","00","280","0006","0000","1011","651","360","121","1132","1509","0","75.02","43.14"
"64","000","00","280","0006","0387","472","312","160","56","528","722","0","73.13","43.21"
"64","000","00","280","0006","0388","539","339","200","65","604","787","0","76.75","43.07"
"64","000","00","280","0007","0000","961","595","366","154","1115","1607","0","69.38","37.03"
"64","000","00","280","0007","0389","485","299","186","92","577","829","0","69.60","36.07"
"64","000","00","280","0007","0390","476","296","180","62","538","778","0","69.15","38.05"
"64","000","00","280","0008","0000","1157","702","455","176","1333","1953","0","68.25","35.94"
"64","000","00","280","0008","0392","558","341","217","76","634","964","0","65.77","35.37"
"64","000","00","280","0008","0393","599","361","238","100","699","989","0","70.68","36.50"
"64","000","00","280","0009","0000","376","238","138","30","406","880","0","46.14","27.05"
"64","000","00","280","0009","0391","376","238","138","30","406","880","0","46.14","27.05"
"64","000","00","280","0010","0000","553","321","232","110","663","808","0","82.05","39.73"
"64","000","00","280","0010","0394","553","321","232","110","663","808","0","82.05","39.73"
"64","000","00","280","0011","0000","627","378","249","99","726","1088","0","66.73","34.74"
"64","000","00","280","0011","0395","627","378","249","99","726","1088","0","66.73","34.74"
"64","000","00","280","0012","0000","1281","788","493","172","1453","2031","0","71.54","38.80"
"64","000","00","280","0012","0396","752","460","292","108","860","1202","0","71.55","38.27"
"64","000","00","280","0012","0397","529","328","201","64","593","829","0","71.53","39.57"
"64","000","00","290","0000","0000","17612","11137","6475","1487","19099","29997","34812","63.67","37.13"
"64","000","00","290","0001","0000","1295","791","504","98","1393","2035","0","68.45","38.87"
"64","000","00","290","0001","0398","656","390","266","49","705","1022","0","68.98","38.16"
"64","000","00","290","0001","0399","639","401","238","49","688","1013","0","67.92","39.59"
"64","000","00","290","0002","0000","1140","731","409","63","1203","2076","0","57.95","35.21"
"64","000","00","290","0002","0400","595","378","217","37","632","985","0","64.16","38.38"
"64","000","00","290","0002","0401","545","353","192","26","571","1091","0","52.34","32.36"
"64","000","00","290","0003","0000","1342","844","498","100","1442","2126","0","67.83","39.70"
"64","000","00","290","0003","0402","492","305","187","45","537","796","0","67.46","38.32"
"64","000","00","290","0003","0403","367","233","134","24","391","598","0","65.38","38.96"
"64","000","00","290","0003","0404","483","306","177","31","514","732","0","70.22","41.80"
"64","000","00","290","0004","0000","917","560","357","75","992","1424","0","69.66","39.33"
"64","000","00","290","0004","0405","917","560","357","75","992","1424","0","69.66","39.33"
"64","000","00","290","0005","0000","767","493","274","65","832","1096","0","75.91","44.98"
"64","000","00","290","0005","0406","767","493","274","65","832","1096","0","75.91","44.98"
"64","000","00","290","0006","0000","957","617","340","103","1060","1738","0","60.99","35.50"
"64","000","00","290","0006","0411","586","371","215","65","651","1072","0","60.73","34.61"
"64","000","00","290","0006","0412","371","246","125","38","409","666","0","61.41","36.94"
"64","000","00","290","0007","0000","1185","800","385","106","1291","1978","0","65.27","40.44"
"64","000","00","290","0007","0416","627","453","174","51","678","990","0","68.48","45.76"
"64","000","00","290","0007","0417","558","347","211","55","613","988","0","62.04","35.12"
"64","000","00","290","0008","0000","1583","965","618","130","1713","2753","0","62.22","35.05"
"64","000","00","290","0008","0418","669","429","240","61","730","1164","0","62.71","36.86"
"64","000","00","290","0008","0419","437","266","171","41","478","756","0","63.23","35.19"
"64","000","00","290","0008","0420","477","270","207","28","505","833","0","60.62","32.41"
"64","000","00","290","0009","0000","1330","857","473","130","1460","2278","0","64.09","37.62"
"64","000","00","290","0009","0421","431","300","131","55","486","772","0","62.95","38.86"
"64","000","00","290","0009","0422","899","557","342","75","974","1506","0","64.67","36.99"
"64","000","00","290","0010","0000","495","315","180","63","558","944","0","59.11","33.37"
"64","000","00","290","0010","0407","495","315","180","63","558","944","0","59.11","33.37"
"64","000","00","290","0011","0000","2107","1335","772","160","2267","3602","0","62.94","37.06"
"64","000","00","290","0011","0408","785","479","306","64","849","1323","0","64.17","36.21"
"64","000","00","290","0011","0409","727","465","262","53","780","1244","0","62.70","37.38"
"64","000","00","290","0011","0410","595","391","204","43","638","1035","0","61.64","37.78"
"64","000","00","290","0012","0000","1297","867","430","113","1410","2151","0","65.55","40.31"
"64","000","00","290","0012","0413","758","497","261","57","815","1257","0","64.84","39.54"
"64","000","00","290","0012","0414","539","370","169","56","595","894","0","66.55","41.39"
"64","000","00","290","0013","0000","411","248","163","35","446","752","0","59.31","32.98"
"64","000","00","290","0013","0415","411","248","163","35","446","752","0","59.31","32.98"
"64","000","00","290","0014","0000","1226","756","470","129","1355","2163","0","62.64","34.95"
"64","000","00","290","0014","0423","672","410","262","73","745","1091","0","68.29","37.58"
"64","000","00","290","0014","0424","554","346","208","56","610","1072","0","56.90","32.28"
"64","000","00","290","0015","0000","1560","958","602","117","1677","2881","0","58.21","33.25"
"64","000","00","290","0015","0425","676","440","236","72","748","1178","0","63.50","37.35"
"64","000","00","290","0015","0426","375","261","114","29","404","707","0","57.14","36.92"
"64","000","00","290","0015","0427","509","257","252","16","525","996","0","52.71","25.80"
"64","000","00","300","0000","0000","17157","10437","6720","1634","18791","30079","34649","62.47","34.70"
"64","000","00","300","0001","0000","1232","706","526","123","1355","2133","0","63.53","33.10"
"64","000","00","300","0001","0064","661","377","284","49","710","1058","0","67.11","35.63"
"64","000","00","300","0001","0065","571","329","242","74","645","1075","0","60.00","30.60"
"64","000","00","300","0002","0000","1229","685","544","90","1319","2177","0","60.59","31.47"
"64","000","00","300","0002","0066","592","317","275","38","630","1027","0","61.34","30.87"
"64","000","00","300","0002","0067","637","368","269","52","689","1150","0","59.91","32.00"
"64","000","00","300","0003","0000","726","462","264","69","795","1506","0","52.79","30.68"
"64","000","00","300","0003","0068","410","256","154","44","454","837","0","54.24","30.59"
"64","000","00","300","0003","0069","316","206","110","25","341","669","0","50.97","30.79"
"64","000","00","300","0004","0000","1027","621","406","108","1135","1716","0","66.14","36.19"
"64","000","00","300","0004","0070","642","404","238","67","709","1044","0","67.91","38.70"
"64","000","00","300","0004","0071","385","217","168","41","426","672","0","63.39","32.29"
"64","000","00","300","0005","0000","876","519","357","89","965","1364","0","70.75","38.05"
"64","000","00","300","0005","0072","685","423","262","63","748","1021","0","73.26","41.43"
"64","000","00","300","0005","0073","191","96","95","26","217","343","0","63.27","27.99"
"64","000","00","300","0006","0000","720","450","270","89","809","1284","0","63.01","35.05"
"64","000","00","300","0006","0074","488","313","175","53","541","807","0","67.04","38.79"
"64","000","00","300","0006","0075","232","137","95","36","268","477","0","56.18","28.72"
"64","000","00","300","0007","0000","499","336","163","61","560","954","0","58.70","35.22"
"64","000","00","300","0007","0076","499","336","163","61","560","954","0","58.70","35.22"
"64","000","00","300","0008","0000","386","236","150","44","430","725","0","59.31","32.55"
"64","000","00","300","0008","0077","386","236","150","44","430","725","0","59.31","32.55"
"64","000","00","300","0009","0000","1130","775","355","91","1221","2032","0","60.09","38.14"
"64","000","00","300","0009","0078","551","377","174","48","599","897","0","66.78","42.03"
"64","000","00","300","0009","0079","579","398","181","43","622","1135","0","54.80","35.07"
"64","000","00","300","0010","0000","91","50","41","18","109","169","0","64.50","29.59"
"64","000","00","300","0010","0080","91","50","41","18","109","169","0","64.50","29.59"
"64","000","00","300","0011","0000","1058","631","427","126","1184","1868","0","63.38","33.78"
"64","000","00","300","0011","0082","518","297","221","62","580","908","0","63.88","32.71"
"64","000","00","300","0011","0083","540","334","206","64","604","960","0","62.92","34.79"
"64","000","00","300","0012","0000","509","281","228","35","544","970","0","56.08","28.97"
"64","000","00","300","0012","0081","509","281","228","35","544","970","0","56.08","28.97"
"64","000","00","300","0013","0000","849","483","366","70","919","1456","0","63.12","33.17"
"64","000","00","300","0013","0084","481","275","206","34","515","825","0","62.42","33.33"
"64","000","00","300","0013","0085","368","208","160","36","404","631","0","64.03","32.96"
"64","000","00","300","0014","0000","1069","670","399","54","1123","1921","0","58.46","34.88"
"64","000","00","300","0014","0086","512","346","166","27","539","892","0","60.43","38.79"
"64","000","00","300","0014","0087","557","324","233","27","584","1029","0","56.75","31.49"
"64","000","00","300","0015","0000","1782","1059","723","127","1909","3118","0","61.23","33.96"
"64","000","00","300","0015","0088","614","370","244","37","651","1049","0","62.06","35.27"
"64","000","00","300","0015","0089","543","302","241","51","594","1001","0","59.34","30.17"
"64","000","00","300","0015","0090","625","387","238","39","664","1068","0","62.17","36.24"
"64","000","00","300","0016","0000","1265","762","503","122","1387","2174","0","63.80","35.05"
"64","000","00","300","0016","0091","161","90","71","19","180","265","0","67.92","33.96"
"64","000","00","300","0016","0092","348","193","155","37","385","592","0","65.03","32.60"
"64","000","00","300","0016","0093","756","479","277","66","822","1317","0","62.41","36.37"
"64","000","00","300","0017","0000","488","332","156","57","545","722","0","75.48","45.98"
"64","000","00","300","0017","0094","488","332","156","57","545","722","0","75.48","45.98"
"64","000","00","300","0018","0000","700","427","273","80","780","1207","0","64.62","35.38"
"64","000","00","300","0018","0095","700","427","273","80","780","1207","0","64.62","35.38"
"64","000","00","300","0019","0000","437","279","158","75","512","767","0","66.75","36.38"
"64","000","00","300","0019","0096","437","279","158","75","512","767","0","66.75","36.38"
"64","000","00","300","0020","0000","716","465","251","87","803","1229","0","65.34","37.84"
"64","000","00","300","0020","0097","716","465","251","87","803","1229","0","65.34","37.84"
"64","000","00","300","0021","0000","368","208","160","19","387","587","0","65.93","35.43"
"64","000","00","300","0021","0098","368","208","160","19","387","587","0","65.93","35.43"
"64","000","00","310","0000","0000","18677","9766","8911","1758","20435","33258","37384","61.44","29.36"
"64","000","00","310","0001","0000","1402","770","632","107","1509","2457","0","61.42","31.34"
"64","000","00","310","0001","0099","676","382","294","64","740","1111","0","66.61","34.38"
"64","000","00","310","0001","0100","317","165","152","22","339","649","0","52.23","25.42"
"64","000","00","310","0001","0101","409","223","186","21","430","697","0","61.69","31.99"
"64","000","00","310","0002","0000","1083","555","528","78","1161","2275","0","51.03","24.40"
"64","000","00","310","0002","0102","569","253","316","48","617","1147","0","53.79","22.06"
"64","000","00","310","0002","0103","514","302","212","30","544","1128","0","48.23","26.77"
"64","000","00","310","0003","0000","1407","700","707","98","1505","2487","0","60.51","28.15"
"64","000","00","310","0003","0104","700","356","344","44","744","1266","0","58.77","28.12"
"64","000","00","310","0003","0105","707","344","363","54","761","1221","0","62.33","28.17"
"64","000","00","310","0004","0000","1038","515","523","99","1137","1934","0","58.79","26.63"
"64","000","00","310","0004","0106","514","244","270","41","555","957","0","57.99","25.50"
"64","000","00","310","0004","0107","524","271","253","58","582","977","0","59.57","27.74"
"64","000","00","310","0005","0000","822","380","442","96","918","1410","0","65.11","26.95"
"64","000","00","310","0005","0108","822","380","442","96","918","1410","0","65.11","26.95"
"64","000","00","310","0006","0000","1084","529","555","122","1206","2032","0","59.35","26.03"
"64","000","00","310","0006","0109","576","283","293","59","635","1045","0","60.77","27.08"
"64","000","00","310","0006","0110","508","246","262","63","571","987","0","57.85","24.92"
"64","000","00","310","0007","0000","1382","731","651","159","1541","2372","0","64.97","30.82"
"64","000","00","310","0007","0111","671","367","304","71","742","1156","0","64.19","31.75"
"64","000","00","310","0007","0112","711","364","347","88","799","1216","0","65.71","29.93"
"64","000","00","310","0008","0000","736","404","332","50","786","1335","0","58.88","30.26"
"64","000","00","310","0008","0113","365","200","165","25","390","608","0","64.14","32.89"
"64","000","00","310","0008","0114","371","204","167","25","396","727","0","54.47","28.06"
"64","000","00","310","0009","0000","750","393","357","97","847","1250","0","67.76","31.44"
"64","000","00","310","0009","0115","750","393","357","97","847","1250","0","67.76","31.44"
"64","000","00","310","0010","0000","697","354","343","85","782","1116","0","70.07","31.72"
"64","000","00","310","0010","0116","697","354","343","85","782","1116","0","70.07","31.72"
"64","000","00","310","0011","0000","1073","518","555","116","1189","1982","0","59.99","26.14"
"64","000","00","310","0011","0117","563","275","288","69","632","1025","0","61.66","26.83"
"64","000","00","310","0011","0118","510","243","267","47","557","957","0","58.20","25.39"
"64","000","00","310","0012","0000","525","289","236","45","570","1135","0","50.22","25.46"
"64","000","00","310","0012","0119","525","289","236","45","570","1135","0","50.22","25.46"
"64","000","00","310","0013","0000","905","459","446","59","964","1524","0","63.25","30.12"
"64","000","00","310","0013","0120","395","205","190","31","426","699","0","60.94","29.33"
"64","000","00","310","0013","0121","510","254","256","28","538","825","0","65.21","30.79"
"64","000","00","310","0014","0000","1169","638","531","100","1269","2145","0","59.16","29.74"
"64","000","00","310","0014","0122","574","308","266","59","633","1048","0","60.40","29.39"
"64","000","00","310","0014","0123","595","330","265","41","636","1097","0","57.98","30.08"
"64","000","00","310","0015","0000","955","527","428","98","1053","1659","0","63.47","31.77"
"64","000","00","310","0015","0124","496","274","222","58","554","915","0","60.55","29.95"
"64","000","00","310","0015","0125","459","253","206","40","499","744","0","67.07","34.01"
"64","000","00","310","0016","0000","990","552","438","101","1091","1765","0","61.81","31.27"
"64","000","00","310","0016","0126","505","265","240","57","562","905","0","62.10","29.28"
"64","000","00","310","0016","0127","485","287","198","44","529","860","0","61.51","33.37"
"64","000","00","310","0017","0000","872","436","436","70","942","1305","0","72.18","33.41"
"64","000","00","310","0017","0128","389","191","198","39","428","620","0","69.03","30.81"
"64","000","00","310","0017","0129","483","245","238","31","514","685","0","75.04","35.77"
"64","000","00","310","0018","0000","1106","633","473","107","1213","1692","0","71.69","37.41"
"64","000","00","310","0018","0130","535","293","242","54","589","835","0","70.54","35.09"
"64","000","00","310","0018","0131","571","340","231","53","624","857","0","72.81","39.67"
"64","000","00","310","0019","0000","681","383","298","71","752","1383","0","54.37","27.69"
"64","000","00","310","0019","0132","391","217","174","47","438","761","0","57.56","28.52"
"64","000","00","310","0019","0133","290","166","124","24","314","622","0","50.48","26.69"
"64","000","00","320","0000","0000","5244","3227","2017","668","5912","10578","11946","55.89","30.51"
"64","000","00","320","0001","0000","415","235","180","58","473","696","0","67.96","33.76"
"64","000","00","320","0001","0021","415","235","180","58","473","696","0","67.96","33.76"
"64","000","00","320","0002","0000","355","241","114","63","418","638","0","65.52","37.77"
"64","000","00","320","0002","0022","355","241","114","63","418","638","0","65.52","37.77"
"64","000","00","320","0003","0000","298","184","114","52","350","591","0","59.22","31.13"
"64","000","00","320","0003","0023","298","184","114","52","350","591","0","59.22","31.13"
"64","000","00","320","0004","0000","378","245","133","58","436","907","0","48.07","27.01"
"64","000","00","320","0004","0024","378","245","133","58","436","907","0","48.07","27.01"
"64","000","00","320","0005","0000","645","433","212","118","763","1298","0","58.78","33.36"
"64","000","00","320","0005","0025","645","433","212","118","763","1298","0","58.78","33.36"
"64","000","00","320","0006","0000","493","319","174","56","549","906","0","60.60","35.21"
"64","000","00","320","0006","0026","493","319","174","56","549","906","0","60.60","35.21"
"64","000","00","320","0007","0000","453","288","165","33","486","975","0","49.85","29.54"
"64","000","00","320","0007","0027","453","288","165","33","486","975","0","49.85","29.54"
"64","000","00","320","0008","0000","343","227","116","38","381","755","0","50.46","30.07"
"64","000","00","320","0008","0028","343","227","116","38","381","755","0","50.46","30.07"
"64","000","00","320","0009","0000","617","334","283","62","679","1334","0","50.90","25.04"
"64","000","00","320","0009","0029","617","334","283","62","679","1334","0","50.90","25.04"
"64","000","00","320","0010","0000","360","191","169","22","382","839","0","45.53","22.77"
"64","000","00","320","0010","0030","360","191","169","22","382","839","0","45.53","22.77"
"64","000","00","320","0011","0000","698","426","272","77","775","1338","0","57.92","31.84"
"64","000","00","320","0011","0031","698","426","272","77","775","1338","0","57.92","31.84"
"64","000","00","320","0012","0000","189","104","85","31","220","301","0","73.09","34.55"
"64","000","00","320","0012","0032","189","104","85","31","220","301","0","73.09","34.55"
"64","000","00","330","0000","0000","2632","1432","1200","311","2943","5084","5670","57.89","28.17"
"64","000","00","330","0001","0000","152","79","73","20","172","431","0","39.91","18.33"
"64","000","00","330","0001","0013","152","79","73","20","172","431","0","39.91","18.33"
"64","000","00","330","0002","0000","495","187","308","28","523","818","0","63.94","22.86"
"64","000","00","330","0002","0014","495","187","308","28","523","818","0","63.94","22.86"
"64","000","00","330","0003","0000","303","160","143","42","345","649","0","53.16","24.65"
"64","000","00","330","0003","0015","303","160","143","42","345","649","0","53.16","24.65"
"64","000","00","330","0004","0000","682","384","298","96","778","1481","0","52.53","25.93"
"64","000","00","330","0004","0016","317","154","163","49","366","725","0","50.48","21.24"
"64","000","00","330","0004","0017","365","230","135","47","412","756","0","54.50","30.42"
"64","000","00","330","0005","0000","316","191","125","40","356","632","0","56.33","30.22"
"64","000","00","330","0005","0018","316","191","125","40","356","632","0","56.33","30.22"
"64","000","00","330","0006","0000","366","229","137","54","420","572","0","73.43","40.03"
"64","000","00","330","0006","0019","366","229","137","54","420","572","0","73.43","40.03"
"64","000","00","330","0007","0000","318","202","116","31","349","501","0","69.66","40.32"
"64","000","00","330","0007","0020","318","202","116","31","349","501","0","69.66","40.32"
"64","000","00","340","0000","0000","5178","3114","2064","638","5816","9909","11115","58.69","31.43"
"64","000","00","340","0001","0000","318","212","106","52","370","569","0","65.03","37.26"
"64","000","00","340","0001","0033","318","212","106","52","370","569","0","65.03","37.26"
"64","000","00","340","0002","0000","312","215","97","51","363","635","0","57.17","33.86"
"64","000","00","340","0002","0034","312","215","97","51","363","635","0","57.17","33.86"
"64","000","00","340","0003","0000","676","431","245","98","774","1192","0","64.93","36.16"
"64","000","00","340","0003","0035","676","431","245","98","774","1192","0","64.93","36.16"
"64","000","00","340","0004","0000","609","368","241","53","662","1402","0","47.22","26.25"
"64","000","00","340","0004","0036","340","188","152","21","361","952","0","37.92","19.75"
"64","000","00","340","0004","0037","269","180","89","32","301","450","0","66.89","40.00"
"64","000","00","340","0005","0000","831","491","340","121","952","1484","0","64.15","33.09"
"64","000","00","340","0005","0038","563","309","254","81","644","938","0","68.66","32.94"
"64","000","00","340","0005","0039","268","182","86","40","308","546","0","56.41","33.33"
"64","000","00","340","0006","0000","853","451","402","81","934","1522","0","61.37","29.63"
"64","000","00","340","0006","0040","581","278","303","55","636","953","0","66.74","29.17"
"64","000","00","340","0006","0041","272","173","99","26","298","569","0","52.37","30.40"
"64","000","00","340","0007","0000","691","391","300","98","789","1178","0","66.98","33.19"
"64","000","00","340","0007","0044","691","391","300","98","789","1178","0","66.98","33.19"
"64","000","00","340","0008","0000","888","555","333","84","972","1927","0","50.44","28.80"
"64","000","00","340","0008","0042","461","331","130","44","505","919","0","54.95","36.02"
"64","000","00","340","0008","0043","427","224","203","40","467","1008","0","46.33","22.22"
"64","000","00","350","0000","0000","6810","4142","2668","953","7763","12173","13570","63.77","34.03"
"64","000","00","350","0001","0000","540","322","218","110","650","895","0","72.63","35.98"
"64","000","00","350","0001","0045","540","322","218","110","650","895","0","72.63","35.98"
"64","000","00","350","0002","0000","336","228","108","53","389","606","0","64.19","37.62"
"64","000","00","350","0002","0046","336","228","108","53","389","606","0","64.19","37.62"
"64","000","00","350","0003","0000","432","268","164","52","484","924","0","52.38","29.00"
"64","000","00","350","0003","0047","432","268","164","52","484","924","0","52.38","29.00"
"64","000","00","350","0004","0000","259","137","122","40","299","414","0","72.22","33.09"
"64","000","00","350","0004","0048","259","137","122","40","299","414","0","72.22","33.09"
"64","000","00","350","0005","0000","255","161","94","45","300","376","0","79.79","42.82"
"64","000","00","350","0005","0049","255","161","94","45","300","376","0","79.79","42.82"
"64","000","00","350","0006","0000","267","171","96","32","299","482","0","62.03","35.48"
"64","000","00","350","0006","0050","267","171","96","32","299","482","0","62.03","35.48"
"64","000","00","350","0007","0000","377","214","163","29","406","925","0","43.89","23.14"
"64","000","00","350","0007","0051","377","214","163","29","406","925","0","43.89","23.14"
"64","000","00","350","0008","0000","560","342","218","74","634","1131","0","56.06","30.24"
"64","000","00","350","0008","0052","560","342","218","74","634","1131","0","56.06","30.24"
"64","000","00","350","0009","0000","760","439","321","64","824","1595","0","51.66","27.52"
"64","000","00","350","0009","0053","361","211","150","36","397","772","0","51.42","27.33"
"64","000","00","350","0009","0054","399","228","171","28","427","823","0","51.88","27.70"
"64","000","00","350","0010","0000","400","211","189","59","459","531","0","86.44","39.74"
"64","000","00","350","0010","0055","400","211","189","59","459","531","0","86.44","39.74"
"64","000","00","350","0011","0000","530","332","198","98","628","745","0","84.30","44.56"
"64","000","00","350","0011","0056","530","332","198","98","628","745","0","84.30","44.56"
"64","000","00","350","0012","0000","173","98","75","26","199","392","0","50.77","25.00"
"64","000","00","350","0012","0057","173","98","75","26","199","392","0","50.77","25.00"
"64","000","00","350","0013","0000","211","129","82","16","227","457","0","49.67","28.23"
"64","000","00","350","0013","0058","211","129","82","16","227","457","0","49.67","28.23"
"64","000","00","350","0014","0000","347","203","144","91","438","617","0","70.99","32.90"
"64","000","00","350","0014","0059","347","203","144","91","438","617","0","70.99","32.90"
"64","000","00","350","0015","0000","394","268","126","45","439","566","0","77.56","47.35"
"64","000","00","350","0015","0060","394","268","126","45","439","566","0","77.56","47.35"
"64","000","00","350","0016","0000","341","252","89","40","381","573","0","66.49","43.98"
"64","000","00","350","0016","0061","341","252","89","40","381","573","0","66.49","43.98"
"64","000","00","350","0017","0000","151","98","53","22","173","312","0","55.45","31.41"
"64","000","00","350","0017","0062","151","98","53","22","173","312","0","55.45","31.41"
"64","000","00","350","0018","0000","477","269","208","57","534","632","0","84.49","42.56"
"64","000","00","350","0018","0063","477","269","208","57","534","632","0","84.49","42.56"
"64","000","00","360","0000","0000","771","349","422","32","803","1597","1948","50.28","21.85"
"64","000","00","360","0001","0000","360","151","209","16","376","717","0","52.44","21.06"
"64","000","00","360","0001","0136","360","151","209","16","376","717","0","52.44","21.06"
"64","000","00","360","0002","0000","193","109","84","9","202","374","0","54.01","29.14"
"64","000","00","360","0002","0135","193","109","84","9","202","374","0","54.01","29.14"
"64","000","00","360","0003","0000","218","89","129","7","225","506","0","44.47","17.59"
"64","000","00","360","0003","0134","218","89","129","7","225","506","0","44.47","17.59"
"64","000","00","370","0000","0000","2187","822","1365","269","2456","3412","4254","71.98","24.09"
"64","000","00","370","0001","0000","471","195","276","69","540","752","0","71.81","25.93"
"64","000","00","370","0001","0005","471","195","276","69","540","752","0","71.81","25.93"
"64","000","00","370","0002","0000","338","111","227","38","376","459","0","81.92","24.18"
"64","000","00","370","0002","0008","338","111","227","38","376","459","0","81.92","24.18"
"64","000","00","370","0003","0000","406","134","272","47","453","592","0","76.52","22.64"
"64","000","00","370","0003","0007","406","134","272","47","453","592","0","76.52","22.64"
"64","000","00","370","0004","0000","409","153","256","46","455","635","0","71.65","24.09"
"64","000","00","370","0004","0006","409","153","256","46","455","635","0","71.65","24.09"
"64","000","00","370","0005","0000","132","44","88","31","163","206","0","79.13","21.36"
"64","000","00","370","0005","0004","132","44","88","31","163","206","0","79.13","21.36"
"64","000","00","370","0006","0000","201","63","138","24","225","284","0","79.23","22.18"
"64","000","00","370","0006","0003","201","63","138","24","225","284","0","79.23","22.18"
"64","000","00","370","0007","0000","158","85","73","12","170","229","0","74.24","37.12"
"64","000","00","370","0007","0002","158","85","73","12","170","229","0","74.24","37.12"
"64","000","00","370","0008","0000","72","37","35","2","74","255","0","29.02","14.51"
"64","000","00","370","0008","0001","72","37","35","2","74","255","0","29.02","14.51"
"64","000","00","380","0000","0000","1484","582","902","219","1703","2426","3197","70.20","23.99"
"64","000","00","380","0001","0000","938","381","557","187","1125","1347","0","83.52","28.29"
"64","000","00","380","0001","0009","522","201","321","92","614","758","0","81.00","26.52"
"64","000","00","380","0001","0010","416","180","236","95","511","589","0","86.76","30.56"
"64","000","00","380","0002","0000","333","108","225","26","359","617","0","58.18","17.50"
"64","000","00","380","0002","0011","333","108","225","26","359","617","0","58.18","17.50"
"64","000","00","380","0003","0000","213","93","120","6","219","462","0","47.40","20.13"
"64","000","00","380","0003","0012","213","93","120","6","219","462","0","47.40","20.13"
"10","004","00","000","0000","0000","240209","109456","130753","15203","255412","455419","578949","56.08","24.03"
"10","004","00","010","0000","0000","77675","39229","38446","3337","81012","149654","208197","54.13","26.21"
"10","004","00","010","0001","0000","3573","1825","1748","88","3661","6818","0","53.70","26.77"
"10","004","00","010","0001","0056","483","262","221","6","489","1058","0","46.22","24.76"
"10","004","00","010","0001","0057","539","259","280","16","555","1074","0","51.68","24.12"
"10","004","00","010","0001","0058","666","320","346","26","692","1080","0","64.07","29.63"
"10","004","00","010","0001","0059","596","259","337","16","612","1119","0","54.69","23.15"
"10","004","00","010","0001","0060","647","388","259","14","661","1264","0","52.29","30.70"
"10","004","00","010","0001","0061","642","337","305","10","652","1223","0","53.31","27.56"
"10","004","00","010","0002","0000","5673","3082","2591","120","5793","10458","0","55.39","29.47"
"10","004","00","010","0002","0001","629","341","288","14","643","1227","0","52.40","27.79"
"10","004","00","010","0002","0002","701","366","335","12","713","1235","0","57.73","29.64"
"10","004","00","010","0002","0003","700","363","337","13","713","1267","0","56.27","28.65"
"10","004","00","010","0002","0004","623","279","344","24","647","1134","0","57.05","24.60"
"10","004","00","010","0002","0005","679","386","293","7","686","1283","0","53.47","30.09"
"10","004","00","010","0002","0006","578","330","248","15","593","1110","0","53.42","29.73"
"10","004","00","010","0002","0007","586","306","280","20","606","1009","0","60.06","30.33"
"10","004","00","010","0002","0008","559","329","230","5","564","1009","0","55.90","32.61"
"10","004","00","010","0002","0009","618","382","236","10","628","1184","0","53.04","32.26"
"10","004","00","010","0003","0000","5886","3439","2447","96","5982","11634","0","51.42","29.56"
"10","004","00","010","0003","0010","609","354","255","13","622","1122","0","55.44","31.55"
"10","004","00","010","0003","0011","628","334","294","11","639","1193","0","53.56","28.00"
"10","004","00","010","0003","0012","624","357","267","5","629","1162","0","54.13","30.72"
"10","004","00","010","0003","0013","551","318","233","9","560","1107","0","50.59","28.73"
"10","004","00","010","0003","0014","611","362","249","9","620","1208","0","51.32","29.97"
"10","004","00","010","0003","0015","691","380","311","13","704","1327","0","53.05","28.64"
"10","004","00","010","0003","0016","582","347","235","9","591","1233","0","47.93","28.14"
"10","004","00","010","0003","0017","565","361","204","5","570","1161","0","49.10","31.09"
"10","004","00","010","0003","0018","494","292","202","17","511","999","0","51.15","29.23"
"10","004","00","010","0003","0019","531","334","197","5","536","1122","0","47.77","29.77"
"10","004","00","010","0004","0000","4301","2276","2025","120","4421","7983","0","55.38","28.51"
"10","004","00","010","0004","0020","675","360","315","16","691","1189","0","58.12","30.28"
"10","004","00","010","0004","0021","537","278","259","21","558","997","0","55.97","27.88"
"10","004","00","010","0004","0022","658","376","282","19","677","1207","0","56.09","31.15"
"10","004","00","010","0004","0023","600","334","266","13","613","1181","0","51.91","28.28"
"10","004","00","010","0004","0024","737","399","338","12","749","1241","0","60.35","32.15"
"10","004","00","010","0004","0025","507","277","230","9","516","989","0","52.17","28.01"
"10","004","00","010","0004","0026","587","252","335","30","617","1179","0","52.33","21.37"
"10","004","00","010","0005","0000","1637","858","779","42","1679","3175","0","52.88","27.02"
"10","004","00","010","0005","0027","650","338","312","11","661","1286","0","51.40","26.28"
"10","004","00","010","0005","0028","522","280","242","14","536","1034","0","51.84","27.08"
"10","004","00","010","0005","0029","465","240","225","17","482","855","0","56.37","28.07"
"10","004","00","010","0006","0000","1620","630","990","143","1763","2856","0","61.73","22.06"
"10","004","00","010","0006","0030","506","213","293","38","544","938","0","58.00","22.71"
"10","004","00","010","0006","0031","613","229","384","47","660","1025","0","64.39","22.34"
"10","004","00","010","0006","0032","501","188","313","58","559","893","0","62.60","21.05"
"10","004","00","010","0007","0000","3728","1761","1967","150","3878","8074","0","48.03","21.81"
"10","004","00","010","0007","0075","537","213","324","21","558","1236","0","45.15","17.23"
"10","004","00","010","0007","0076","641","357","284","16","657","1271","0","51.69","28.09"
"10","004","00","010","0007","0077","511","232","279","27","538","1087","0","49.49","21.34"
"10","004","00","010","0007","0078","615","331","284","13","628","1488","0","42.20","22.24"
"10","004","00","010","0007","0079","497","231","266","33","530","1104","0","48.01","20.92"
"10","004","00","010","0007","0080","485","221","264","16","501","926","0","54.10","23.87"
"10","004","00","010","0007","0081","442","176","266","24","466","962","0","48.44","18.30"
"10","004","00","010","0008","0000","4354","1977","2377","232","4586","8427","0","54.42","23.46"
"10","004","00","010","0008","0082","530","217","313","16","546","993","0","54.98","21.85"
"10","004","00","010","0008","0083","535","242","293","23","558","1028","0","54.28","23.54"
"10","004","00","010","0008","0084","553","231","322","31","584","1099","0","53.14","21.02"
"10","004","00","010","0008","0085","499","234","265","32","531","1063","0","49.95","22.01"
"10","004","00","010","0008","0086","583","307","276","18","601","1128","0","53.28","27.22"
"10","004","00","010","0008","0087","617","274","343","56","673","1100","0","61.18","24.91"
"10","004","00","010","0008","0088","512","239","273","25","537","1034","0","51.93","23.11"
"10","004","00","010","0008","0089","525","233","292","31","556","982","0","56.62","23.73"
"10","004","00","010","0009","0000","2625","1166","1459","133","2758","5726","0","48.17","20.36"
"10","004","00","010","0009","0093","630","280","350","32","662","1245","0","53.17","22.49"
"10","004","00","010","0009","0094","475","239","236","17","492","1027","0","47.91","23.27"
"10","004","00","010","0009","0095","638","270","368","29","667","1187","0","56.19","22.75"
"10","004","00","010","0009","0096","548","228","320","31","579","1146","0","50.52","19.90"
"10","004","00","010","0009","0097","334","149","185","24","358","1121","0","31.94","13.29"
"10","004","00","010","0010","0000","3050","1346","1704","131","3181","5890","0","54.01","22.85"
"10","004","00","010","0010","0098","528","233","295","13","541","996","0","54.32","23.39"
"10","004","00","010","0010","0099","437","192","245","7","444","842","0","52.73","22.80"
"10","004","00","010","0010","0100","446","208","238","21","467","853","0","54.75","24.38"
"10","004","00","010","0010","0101","478","215","263","32","510","1020","0","50.00","21.08"
"10","004","00","010","0010","0102","630","249","381","29","659","1183","0","55.71","21.05"
"10","004","00","010","0010","0103","531","249","282","29","560","996","0","56.22","25.00"
"10","004","00","010","0011","0000","3435","1596","1839","171","3606","6880","0","52.41","23.20"
"10","004","00","010","0011","0104","608","289","319","31","639","1146","0","55.76","25.22"
"10","004","00","010","0011","0105","561","259","302","35","596","1112","0","53.60","23.29"
"10","004","00","010","0011","0106","583","267","316","30","613","1137","0","53.91","23.48"
"10","004","00","010","0011","0107","563","271","292","27","590","1157","0","50.99","23.42"
"10","004","00","010","0011","0108","581","261","320","27","608","1167","0","52.10","22.37"
"10","004","00","010","0011","0109","539","249","290","21","560","1161","0","48.23","21.45"
"10","004","00","010","0012","0000","2364","1091","1273","185","2549","4298","0","59.31","25.38"
"10","004","00","010","0012","0115","550","251","299","53","603","1031","0","58.49","24.35"
"10","004","00","010","0012","0116","470","232","238","37","507","858","0","59.09","27.04"
"10","004","00","010","0012","0117","678","322","356","61","739","1212","0","60.97","26.57"
"10","004","00","010","0012","0118","666","286","380","34","700","1197","0","58.48","23.89"
"10","004","00","010","0013","0000","1011","530","481","56","1067","1928","0","55.34","27.49"
"10","004","00","010","0013","0119","508","260","248","41","549","944","0","58.16","27.54"
"10","004","00","010","0013","0120","503","270","233","15","518","984","0","52.64","27.44"
"10","004","00","010","0014","0000","1334","646","688","99","1433","2415","0","59.34","26.75"
"10","004","00","010","0014","0121","641","302","339","42","683","1096","0","62.32","27.55"
"10","004","00","010","0014","0122","693","344","349","57","750","1319","0","56.86","26.08"
"10","004","00","010","0015","0000","1275","660","615","87","1362","2163","0","62.97","30.51"
"10","004","00","010","0015","0124","592","317","275","33","625","968","0","64.57","32.75"
"10","004","00","010","0015","0125","683","343","340","54","737","1195","0","61.67","28.70"
"10","004","00","010","0016","0000","663","403","260","67","730","1167","0","62.55","34.53"
"10","004","00","010","0016","0126","663","403","260","67","730","1167","0","62.55","34.53"
"10","004","00","010","0017","0000","1062","600","462","93","1155","1599","0","72.23","37.52"
"10","004","00","010","0017","0129","639","360","279","62","701","951","0","73.71","37.85"
"10","004","00","010","0017","0130","423","240","183","31","454","648","0","70.06","37.04"
"10","004","00","010","0018","0000","1054","617","437","148","1202","1819","0","66.08","33.92"
"10","004","00","010","0018","0133","516","318","198","86","602","907","0","66.37","35.06"
"10","004","00","010","0018","0134","538","299","239","62","600","912","0","65.79","32.79"
"10","004","00","010","0019","0000","888","396","492","44","932","1686","0","55.28","23.49"
"10","004","00","010","0019","0127","486","224","262","35","521","898","0","58.02","24.94"
"10","004","00","010","0019","0128","402","172","230","9","411","788","0","52.16","21.83"
"10","004","00","010","0020","0000","880","545","335","106","986","1613","0","61.13","33.79"
"10","004","00","010","0020","0131","457","288","169","55","512","810","0","63.21","35.56"
"10","004","00","010","0020","0132","423","257","166","51","474","803","0","59.03","32.00"
"10","004","00","010","0021","0000","3434","1819","1615","92","3526","6494","0","54.30","28.01"
"10","004","00","010","0021","0044","607","314","293","12","619","1168","0","53.00","26.88"
"10","004","00","010","0021","0045","577","281","296","21","598","1052","0","56.84","26.71"
"10","004","00","010","0021","0046","556","316","240","14","570","1057","0","53.93","29.90"
"10","004","00","010","0021","0047","660","362","298","12","672","1210","0","55.54","29.92"
"10","004","00","010","0021","0048","502","290","212","9","511","1006","0","50.80","28.83"
"10","004","00","010","0021","0049","532","256","276","24","556","1001","0","55.54","25.57"
"10","004","00","010","0022","0000","2972","1495","1477","178","3150","5971","0","52.75","25.04"
"10","004","00","010","0022","0110","586","288","298","47","633","1115","0","56.77","25.83"
"10","004","00","010","0022","0111","555","272","283","35","590","1177","0","50.13","23.11"
"10","004","00","010","0022","0112","553","286","267","21","574","1155","0","49.70","24.76"
"10","004","00","010","0022","0113","641","347","294","23","664","1322","0","50.23","26.25"
"10","004","00","010","0022","0114","637","302","335","52","689","1202","0","57.32","25.12"
"10","004","00","010","0023","0000","589","270","319","64","653","1096","0","59.58","24.64"
"10","004","00","010","0023","0123","589","270","319","64","653","1096","0","59.58","24.64"
"10","004","00","010","0024","0000","2058","959","1099","82","2140","3668","0","58.34","26.15"
"10","004","00","010","0024","0067","612","308","304","16","628","1127","0","55.72","27.33"
"10","004","00","010","0024","0068","774","342","432","28","802","1309","0","61.27","26.13"
"10","004","00","010","0024","0069","672","309","363","38","710","1232","0","57.63","25.08"
"10","004","00","010","0025","0000","3141","1493","1648","142","3283","6171","0","53.20","24.19"
"10","004","00","010","0025","0070","531","240","291","17","548","1204","0","45.51","19.93"
"10","004","00","010","0025","0071","665","303","362","11","676","1281","0","52.77","23.65"
"10","004","00","010","0025","0072","679","322","357","33","712","1171","0","60.80","27.50"
"10","004","00","010","0025","0073","656","312","344","39","695","1192","0","58.31","26.17"
"10","004","00","010","0025","0074","610","316","294","42","652","1323","0","49.28","23.89"
"10","004","00","010","0026","0000","1659","712","947","104","1763","3150","0","55.97","22.60"
"10","004","00","010","0026","0090","502","210","292","32","534","993","0","53.78","21.15"
"10","004","00","010","0026","0091","618","263","355","35","653","1090","0","59.91","24.13"
"10","004","00","010","0026","0092","539","239","300","37","576","1067","0","53.98","22.40"
"10","004","00","010","0027","0000","3470","1930","1540","80","3550","7366","0","48.19","26.20"
"10","004","00","010","0027","0033","612","347","265","16","628","1267","0","49.57","27.39"
"10","004","00","010","0027","0034","683","342","341","14","697","1297","0","53.74","26.37"
"10","004","00","010","0027","0035","539","344","195","6","545","1198","0","45.49","28.71"
"10","004","00","010","0027","0036","626","367","259","16","642","1296","0","49.54","28.32"
"10","004","00","010","0027","0037","499","286","213","18","517","1117","0","46.28","25.60"
"10","004","00","010","0027","0038","511","244","267","10","521","1191","0","43.74","20.49"
"10","004","00","010","0028","0000","2914","1677","1237","65","2979","6045","0","49.28","27.74"
"10","004","00","010","0028","0039","588","326","262","15","603","1196","0","50.42","27.26"
"10","004","00","010","0028","0040","545","321","224","9","554","1195","0","46.36","26.86"
"10","004","00","010","0028","0041","550","308","242","12","562","1185","0","47.43","25.99"
"10","004","00","010","0028","0042","689","396","293","22","711","1291","0","55.07","30.67"
"10","004","00","010","0028","0043","542","326","216","7","549","1178","0","46.60","27.67"
"10","004","00","010","0029","0000","1839","879","960","44","1883","3482","0","54.08","25.24"
"10","004","00","010","0029","0050","622","292","330","15","637","1173","0","54.31","24.89"
"10","004","00","010","0029","0051","588","281","307","13","601","1117","0","53.80","25.16"
"10","004","00","010","0029","0052","629","306","323","16","645","1192","0","54.11","25.67"
"10","004","00","010","0030","0000","1708","796","912","65","1773","3220","0","55.06","24.72"
"10","004","00","010","0030","0053","556","242","314","26","582","1076","0","54.09","22.49"
"10","004","00","010","0030","0054","572","265","307","24","596","1042","0","57.20","25.43"
"10","004","00","010","0030","0055","580","289","291","15","595","1102","0","53.99","26.23"
"10","004","00","010","0031","0000","3478","1755","1723","110","3588","6382","0","56.22","27.50"
"10","004","00","010","0031","0062","785","344","441","36","821","1276","0","64.34","26.96"
"10","004","00","010","0031","0063","690","357","333","36","726","1291","0","56.24","27.65"
"10","004","00","010","0031","0064","632","354","278","5","637","1296","0","49.15","27.31"
"10","004","00","010","0031","0065","665","309","356","24","689","1205","0","57.18","25.64"
"10","004","00","010","0031","0066","706","391","315","9","715","1314","0","54.41","29.76"
"10","004","00","020","0000","0000","39406","16269","23137","2246","41652","78011","96298","53.39","20.85"
"10","004","00","020","0001","0000","180","73","107","22","202","289","0","69.90","25.26"
"10","004","00","020","0001","0135","180","73","107","22","202","289","0","69.90","25.26"
"10","004","00","020","0002","0000","179","79","100","27","206","378","0","54.50","20.90"
"10","004","00","020","0002","0136","179","79","100","27","206","378","0","54.50","20.90"
"10","004","00","020","0003","0000","170","82","88","9","179","344","0","52.03","23.84"
"10","004","00","020","0003","0137","170","82","88","9","179","344","0","52.03","23.84"
"10","004","00","020","0004","0000","1017","388","629","66","1083","2146","0","50.47","18.08"
"10","004","00","020","0004","0138","473","206","267","41","514","1036","0","49.61","19.88"
"10","004","00","020","0004","0139","544","182","362","25","569","1110","0","51.26","16.40"
"10","004","00","020","0005","0000","1545","641","904","95","1640","3218","0","50.96","19.92"
"10","004","00","020","0005","0148","466","216","250","25","491","1030","0","47.67","20.97"
"10","004","00","020","0005","0149","552","206","346","44","596","1198","0","49.75","17.20"
"10","004","00","020","0005","0150","527","219","308","26","553","990","0","55.86","22.12"
"10","004","00","020","0006","0000","4476","1779","2697","210","4686","9039","0","51.84","19.68"
"10","004","00","020","0006","0140","588","239","349","22","610","1129","0","54.03","21.17"
"10","004","00","020","0006","0141","634","238","396","32","666","1190","0","55.97","20.00"
"10","004","00","020","0006","0142","596","240","356","27","623","1237","0","50.36","19.40"
"10","004","00","020","0006","0143","521","231","290","25","546","1278","0","42.72","18.08"
"10","004","00","020","0006","0144","571","203","368","30","601","1193","0","50.38","17.02"
"10","004","00","020","0006","0145","491","189","302","21","512","936","0","54.70","20.19"
"10","004","00","020","0006","0146","511","230","281","26","537","939","0","57.19","24.49"
"10","004","00","020","0006","0147","564","209","355","27","591","1137","0","51.98","18.38"
"10","004","00","020","0007","0000","2247","892","1355","126","2373","4404","0","53.88","20.25"
"10","004","00","020","0007","0153","532","215","317","32","564","1091","0","51.70","19.71"
"10","004","00","020","0007","0154","495","196","299","44","539","986","0","54.67","19.88"
"10","004","00","020","0007","0155","611","256","355","22","633","1215","0","52.10","21.07"
"10","004","00","020","0007","0156","609","225","384","28","637","1112","0","57.28","20.23"
"10","004","00","020","0008","0000","383","153","230","32","415","593","0","69.98","25.80"
"10","004","00","020","0008","0160","383","153","230","32","415","593","0","69.98","25.80"
"10","004","00","020","0009","0000","1289","506","783","74","1363","2903","0","46.95","17.43"
"10","004","00","020","0009","0161","347","133","214","34","381","943","0","40.40","14.10"
"10","004","00","020","0009","0162","521","200","321","21","542","907","0","59.76","22.05"
"10","004","00","020","0009","0163","421","173","248","19","440","1053","0","41.79","16.43"
"10","004","00","020","0010","0000","651","285","366","47","698","1247","0","55.97","22.85"
"10","004","00","020","0010","0164","287","119","168","14","301","529","0","56.90","22.50"
"10","004","00","020","0010","0165","364","166","198","33","397","718","0","55.29","23.12"
"10","004","00","020","0011","0000","722","266","456","50","772","1272","0","60.69","20.91"
"10","004","00","020","0011","0175","362","133","229","24","386","655","0","58.93","20.31"
"10","004","00","020","0011","0176","360","133","227","26","386","617","0","62.56","21.56"
"10","004","00","020","0012","0000","1740","663","1077","89","1829","3572","0","51.20","18.56"
"10","004","00","020","0012","0168","437","176","261","29","466","858","0","54.31","20.51"
"10","004","00","020","0012","0169","439","168","271","25","464","924","0","50.22","18.18"
"10","004","00","020","0012","0170","436","144","292","27","463","890","0","52.02","16.18"
"10","004","00","020","0012","0171","428","175","253","8","436","900","0","48.44","19.44"
"10","004","00","020","0013","0000","1711","713","998","78","1789","3189","0","56.10","22.36"
"10","004","00","020","0013","0172","484","189","295","14","498","927","0","53.72","20.39"
"10","004","00","020","0013","0173","593","237","356","21","614","1160","0","52.93","20.43"
"10","004","00","020","0013","0174","634","287","347","43","677","1102","0","61.43","26.04"
"10","004","00","020","0014","0000","3265","1295","1970","157","3422","7220","0","47.40","17.94"
"10","004","00","020","0014","0183","518","218","300","12","530","1189","0","44.58","18.33"
"10","004","00","020","0014","0184","333","161","172","6","339","977","0","34.70","16.48"
"10","004","00","020","0014","0185","504","200","304","23","527","1172","0","44.97","17.06"
"10","004","00","020","0014","0186","457","170","287","16","473","1092","0","43.32","15.57"
"10","004","00","020","0014","0187","385","161","224","31","416","816","0","50.98","19.73"
"10","004","00","020","0014","0188","485","168","317","26","511","918","0","55.66","18.30"
"10","004","00","020","0014","0189","583","217","366","43","626","1056","0","59.28","20.55"
"10","004","00","020","0015","0000","3159","1341","1818","183","3342","6162","0","54.24","21.76"
"10","004","00","020","0015","0191","550","229","321","27","577","1062","0","54.33","21.56"
"10","004","00","020","0015","0192","480","205","275","30","510","1017","0","50.15","20.16"
"10","004","00","020","0015","0193","465","206","259","28","493","879","0","56.09","23.44"
"10","004","00","020","0015","0194","553","254","299","22","575","1137","0","50.57","22.34"
"10","004","00","020","0015","0195","556","238","318","32","588","1017","0","57.82","23.40"
"10","004","00","020","0015","0196","555","209","346","44","599","1050","0","57.05","19.90"
"10","004","00","020","0016","0000","2298","977","1321","133","2431","4381","0","55.49","22.30"
"10","004","00","020","0016","0207","557","255","302","43","600","1110","0","54.05","22.97"
"10","004","00","020","0016","0208","586","252","334","27","613","1134","0","54.06","22.22"
"10","004","00","020","0016","0209","588","225","363","28","616","1065","0","57.84","21.13"
"10","004","00","020","0016","0210","567","245","322","35","602","1072","0","56.16","22.85"
"10","004","00","020","0017","0000","1049","448","601","64","1113","1845","0","60.33","24.28"
"10","004","00","020","0017","0211","490","229","261","27","517","900","0","57.44","25.44"
"10","004","00","020","0017","0212","559","219","340","37","596","945","0","63.07","23.17"
"10","004","00","020","0018","0000","301","136","165","40","341","561","0","60.78","24.24"
"10","004","00","020","0018","0213","301","136","165","40","341","561","0","60.78","24.24"
"10","004","00","020","0019","0000","5684","2693","2991","298","5982","11378","0","52.58","23.67"
"10","004","00","020","0019","0197","614","262","352","42","656","1149","0","57.09","22.80"
"10","004","00","020","0019","0198","458","186","272","67","525","862","0","60.90","21.58"
"10","004","00","020","0019","0199","824","409","415","14","838","1488","0","56.32","27.49"
"10","004","00","020","0019","0200","452","287","165","8","460","863","0","53.30","33.26"
"10","004","00","020","0019","0201","488","305","183","8","496","987","0","50.25","30.90"
"10","004","00","020","0019","0202","629","336","293","21","650","1283","0","50.66","26.19"
"10","004","00","020","0019","0203","561","222","339","52","613","1181","0","51.91","18.80"
"10","004","00","020","0019","0204","449","189","260","9","458","1192","0","38.42","15.86"
"10","004","00","020","0019","0205","610","248","362","27","637","1160","0","54.91","21.38"
"10","004","00","020","0019","0206","599","249","350","50","649","1213","0","53.50","20.53"
"10","004","00","020","0020","0000","825","317","508","69","894","1599","0","55.91","19.82"
"10","004","00","020","0020","0157","400","168","232","29","429","785","0","54.65","21.40"
"10","004","00","020","0020","0158","425","149","276","40","465","814","0","57.13","18.30"
"10","004","00","020","0021","0000","1284","521","763","60","1344","2465","0","54.52","21.14"
"10","004","00","020","0021","0151","579","241","338","32","611","1108","0","55.14","21.75"
"10","004","00","020","0021","0152","705","280","425","28","733","1357","0","54.02","20.63"
"10","004","00","020","0022","0000","607","221","386","44","651","979","0","66.50","22.57"
"10","004","00","020","0022","0159","607","221","386","44","651","979","0","66.50","22.57"
"10","004","00","020","0023","0000","3588","1392","2196","192","3780","6843","0","55.24","20.34"
"10","004","00","020","0023","0177","552","194","358","28","580","1138","0","50.97","17.05"
"10","004","00","020","0023","0178","582","232","350","29","611","1078","0","56.68","21.52"
"10","004","00","020","0023","0179","619","267","352","28","647","1148","0","56.36","23.26"
"10","004","00","020","0023","0180","631","245","386","44","675","1212","0","55.69","20.21"
"10","004","00","020","0023","0181","621","214","407","40","661","1170","0","56.50","18.29"
"10","004","00","020","0023","0182","583","240","343","23","606","1097","0","55.24","21.88"
"10","004","00","020","0024","0000","713","287","426","42","755","1440","0","52.43","19.93"
"10","004","00","020","0024","0166","355","146","209","29","384","697","0","55.09","20.95"
"10","004","00","020","0024","0167","358","141","217","13","371","743","0","49.93","18.98"
"10","004","00","020","0025","0000","323","121","202","39","362","544","0","66.54","22.24"
"10","004","00","020","0025","0190","323","121","202","39","362","544","0","66.54","22.24"
"10","004","00","030","0000","0000","16233","7345","8888","1354","17587","28602","32981","61.49","25.68"
"10","004","00","030","0001","0000","633","257","376","57","690","1062","0","64.97","24.20"
"10","004","00","030","0001","0234","633","257","376","57","690","1062","0","64.97","24.20"
"10","004","00","030","0002","0000","475","201","274","57","532","822","0","64.72","24.45"
"10","004","00","030","0002","0235","475","201","274","57","532","822","0","64.72","24.45"
"10","004","00","030","0003","0000","2232","988","1244","168","2400","4591","0","52.28","21.52"
"10","004","00","030","0003","0236","538","223","315","38","576","1025","0","56.20","21.76"
"10","004","00","030","0003","0237","500","237","263","61","561","990","0","56.67","23.94"
"10","004","00","030","0003","0238","338","150","188","29","367","777","0","47.23","19.31"
"10","004","00","030","0003","0239","438","176","262","20","458","886","0","51.69","19.86"
"10","004","00","030","0003","0240","418","202","216","20","438","913","0","47.97","22.12"
"10","004","00","030","0004","0000","1029","453","576","123","1152","1909","0","60.35","23.73"
"10","004","00","030","0004","0223","491","203","288","66","557","936","0","59.51","21.69"
"10","004","00","030","0004","0224","538","250","288","57","595","973","0","61.15","25.69"
"10","004","00","030","0005","0000","1911","866","1045","158","2069","3140","0","65.89","27.58"
"10","004","00","030","0005","0225","711","294","417","51","762","1140","0","66.84","25.79"
"10","004","00","030","0005","0226","648","292","356","44","692","1070","0","64.67","27.29"
"10","004","00","030","0005","0227","552","280","272","63","615","930","0","66.13","30.11"
"10","004","00","030","0006","0000","919","394","525","78","997","1667","0","59.81","23.64"
"10","004","00","030","0006","0221","468","201","267","40","508","843","0","60.26","23.84"
"10","004","00","030","0006","0222","451","193","258","38","489","824","0","59.34","23.42"
"10","004","00","030","0007","0000","1962","866","1096","127","2089","3310","0","63.11","26.16"
"10","004","00","030","0007","0217","555","233","322","35","590","897","0","65.77","25.98"
"10","004","00","030","0007","0218","388","159","229","33","421","682","0","61.73","23.31"
"10","004","00","030","0007","0219","502","238","264","28","530","885","0","59.89","26.89"
"10","004","00","030","0007","0220","517","236","281","31","548","846","0","64.78","27.90"
"10","004","00","030","0008","0000","464","193","271","16","480","902","0","53.22","21.40"
"10","004","00","030","0008","0214","464","193","271","16","480","902","0","53.22","21.40"
"10","004","00","030","0009","0000","346","150","196","27","373","528","0","70.64","28.41"
"10","004","00","030","0009","0215","346","150","196","27","373","528","0","70.64","28.41"
"10","004","00","030","0010","0000","567","227","340","25","592","965","0","61.35","23.52"
"10","004","00","030","0010","0216","567","227","340","25","592","965","0","61.35","23.52"
"10","004","00","030","0011","0000","930","453","477","111","1041","1766","0","58.95","25.65"
"10","004","00","030","0011","0241","521","261","260","52","573","943","0","60.76","27.68"
"10","004","00","030","0011","0242","409","192","217","59","468","823","0","56.87","23.33"
"10","004","00","030","0012","0000","1402","649","753","92","1494","2448","0","61.03","26.51"
"10","004","00","030","0012","0243","465","210","255","31","496","796","0","62.31","26.38"
"10","004","00","030","0012","0244","493","231","262","28","521","816","0","63.85","28.31"
"10","004","00","030","0012","0245","444","208","236","33","477","836","0","57.06","24.88"
"10","004","00","030","0013","0000","509","233","276","69","578","939","0","61.55","24.81"
"10","004","00","030","0013","0246","509","233","276","69","578","939","0","61.55","24.81"
"10","004","00","030","0014","0000","434","200","234","46","480","618","0","77.67","32.36"
"10","004","00","030","0014","0247","434","200","234","46","480","618","0","77.67","32.36"
"10","004","00","030","0015","0000","594","286","308","54","648","1057","0","61.31","27.06"
"10","004","00","030","0015","0233","594","286","308","54","648","1057","0","61.31","27.06"
"10","004","00","030","0016","0000","797","410","387","75","872","1277","0","68.29","32.11"
"10","004","00","030","0016","0228","458","252","206","47","505","693","0","72.87","36.36"
"10","004","00","030","0016","0229","339","158","181","28","367","584","0","62.84","27.05"
"10","004","00","030","0017","0000","248","141","107","16","264","389","0","67.87","36.25"
"10","004","00","030","0017","0230","248","141","107","16","264","389","0","67.87","36.25"
"10","004","00","030","0018","0000","416","209","207","22","438","667","0","65.67","31.33"
"10","004","00","030","0018","0231","416","209","207","22","438","667","0","65.67","31.33"
"10","004","00","030","0019","0000","365","169","196","33","398","545","0","73.03","31.01"
"10","004","00","030","0019","0232","365","169","196","33","398","545","0","73.03","31.01"
"10","004","00","040","0000","0000","13869","5962","7907","1339","15208","23321","27146","65.21","25.56"
"10","004","00","040","0001","0000","276","112","164","23","299","456","0","65.57","24.56"
"10","004","00","040","0001","0248","276","112","164","23","299","456","0","65.57","24.56"
"10","004","00","040","0002","0000","1054","408","646","83","1137","1828","0","62.20","22.32"
"10","004","00","040","0002","0249","501","185","316","43","544","854","0","63.70","21.66"
"10","004","00","040","0002","0250","553","223","330","40","593","974","0","60.88","22.90"
"10","004","00","040","0003","0000","437","197","240","28","465","677","0","68.69","29.10"
"10","004","00","040","0003","0251","437","197","240","28","465","677","0","68.69","29.10"
"10","004","00","040","0004","0000","1990","859","1131","190","2180","3509","0","62.13","24.48"
"10","004","00","040","0004","0252","678","299","379","37","715","1113","0","64.24","26.86"
"10","004","00","040","0004","0253","666","295","371","77","743","1146","0","64.83","25.74"
"10","004","00","040","0004","0254","646","265","381","76","722","1250","0","57.76","21.20"
"10","004","00","040","0005","0000","489","199","290","54","543","940","0","57.77","21.17"
"10","004","00","040","0005","0256","489","199","290","54","543","940","0","57.77","21.17"
"10","004","00","040","0006","0000","464","192","272","38","502","729","0","68.86","26.34"
"10","004","00","040","0006","0255","464","192","272","38","502","729","0","68.86","26.34"
"10","004","00","040","0007","0000","648","321","327","79","727","995","0","73.07","32.26"
"10","004","00","040","0007","0257","648","321","327","79","727","995","0","73.07","32.26"
"10","004","00","040","0008","0000","2056","858","1198","154","2210","3664","0","60.32","23.42"
"10","004","00","040","0008","0258","643","251","392","52","695","1173","0","59.25","21.40"
"10","004","00","040","0008","0259","715","295","420","66","781","1254","0","62.28","23.52"
"10","004","00","040","0008","0260","698","312","386","36","734","1237","0","59.34","25.22"
"10","004","00","040","0009","0000","661","287","374","66","727","1188","0","61.20","24.16"
"10","004","00","040","0009","0262","661","287","374","66","727","1188","0","61.20","24.16"
"10","004","00","040","0010","0000","289","151","138","32","321","500","0","64.20","30.20"
"10","004","00","040","0010","0264","289","151","138","32","321","500","0","64.20","30.20"
"10","004","00","040","0011","0000","300","138","162","70","370","517","0","71.57","26.69"
"10","004","00","040","0011","0266","300","138","162","70","370","517","0","71.57","26.69"
"10","004","00","040","0012","0000","472","178","294","66","538","860","0","62.56","20.70"
"10","004","00","040","0012","0267","472","178","294","66","538","860","0","62.56","20.70"
"10","004","00","040","0013","0000","229","118","111","31","260","423","0","61.47","27.90"
"10","004","00","040","0013","0265","229","118","111","31","260","423","0","61.47","27.90"
"10","004","00","040","0014","0000","477","252","225","63","540","768","0","70.31","32.81"
"10","004","00","040","0014","0268","477","252","225","63","540","768","0","70.31","32.81"
"10","004","00","040","0015","0000","1100","458","642","63","1163","1664","0","69.89","27.52"
"10","004","00","040","0015","0269","526","205","321","12","538","829","0","64.90","24.73"
"10","004","00","040","0015","0270","574","253","321","51","625","835","0","74.85","30.30"
"10","004","00","040","0016","0000","494","208","286","49","543","737","0","73.68","28.22"
"10","004","00","040","0016","0272","494","208","286","49","543","737","0","73.68","28.22"
"10","004","00","040","0017","0000","388","162","226","57","445","533","0","83.49","30.39"
"10","004","00","040","0017","0273","388","162","226","57","445","533","0","83.49","30.39"
"10","004","00","040","0018","0000","489","204","285","34","523","773","0","67.66","26.39"
"10","004","00","040","0018","0274","489","204","285","34","523","773","0","67.66","26.39"
"10","004","00","040","0019","0000","498","223","275","44","542","799","0","67.83","27.91"
"10","004","00","040","0019","0261","498","223","275","44","542","799","0","67.83","27.91"
"10","004","00","040","0020","0000","510","213","297","80","590","859","0","68.68","24.80"
"10","004","00","040","0020","0263","510","213","297","80","590","859","0","68.68","24.80"
"10","004","00","040","0021","0000","548","224","324","35","583","902","0","64.63","24.83"
"10","004","00","040","0021","0271","548","224","324","35","583","902","0","64.63","24.83"
"10","004","00","050","0000","0000","34310","14697","19613","2404","36714","65437","80893","56.11","22.46"
"10","004","00","050","0001","0000","663","273","390","43","706","1166","0","60.55","23.41"
"10","004","00","050","0001","0289","663","273","390","43","706","1166","0","60.55","23.41"
"10","004","00","050","0002","0000","477","187","290","28","505","815","0","61.96","22.94"
"10","004","00","050","0002","0288","477","187","290","28","505","815","0","61.96","22.94"
"10","004","00","050","0003","0000","2153","949","1204","143","2296","3960","0","57.98","23.96"
"10","004","00","050","0003","0285","700","374","326","51","751","1294","0","58.04","28.90"
"10","004","00","050","0003","0286","701","269","432","66","767","1296","0","59.18","20.76"
"10","004","00","050","0003","0287","752","306","446","26","778","1370","0","56.79","22.34"
"10","004","00","050","0004","0000","2689","1183","1506","154","2843","5228","0","54.38","22.63"
"10","004","00","050","0004","0296","644","287","357","44","688","1442","0","47.71","19.90"
"10","004","00","050","0004","0297","680","298","382","50","730","1317","0","55.43","22.63"
"10","004","00","050","0004","0298","629","289","340","31","660","1112","0","59.35","25.99"
"10","004","00","050","0004","0299","736","309","427","29","765","1357","0","56.37","22.77"
"10","004","00","050","0005","0000","2013","874","1139","141","2154","3332","0","64.65","26.23"
"10","004","00","050","0005","0290","679","281","398","57","736","1162","0","63.34","24.18"
"10","004","00","050","0005","0291","735","337","398","44","779","1240","0","62.82","27.18"
"10","004","00","050","0005","0292","599","256","343","40","639","930","0","68.71","27.53"
"10","004","00","050","0006","0000","2564","1117","1447","195","2759","4934","0","55.92","22.64"
"10","004","00","050","0006","0281","615","278","337","63","678","1098","0","61.75","25.32"
"10","004","00","050","0006","0282","716","321","395","45","761","1390","0","54.75","23.09"
"10","004","00","050","0006","0283","566","225","341","56","622","1165","0","53.39","19.31"
"10","004","00","050","0006","0284","667","293","374","31","698","1281","0","54.49","22.87"
"10","004","00","050","0007","0000","1696","738","958","125","1821","2824","0","64.48","26.13"
"10","004","00","050","0007","0275","750","342","408","75","825","1284","0","64.25","26.64"
"10","004","00","050","0007","0276","946","396","550","50","996","1540","0","64.68","25.71"
"10","004","00","050","0008","0000","1668","712","956","146","1814","3078","0","58.93","23.13"
"10","004","00","050","0008","0305","642","280","362","63","705","1136","0","62.06","24.65"
"10","004","00","050","0008","0306","440","168","272","27","467","758","0","61.61","22.16"
"10","004","00","050","0008","0307","586","264","322","56","642","1184","0","54.22","22.30"
"10","004","00","050","0009","0000","610","272","338","52","662","1006","0","65.81","27.04"
"10","004","00","050","0009","0308","610","272","338","52","662","1006","0","65.81","27.04"
"10","004","00","050","0010","0000","1544","645","899","84","1628","2668","0","61.02","24.18"
"10","004","00","050","0010","0309","682","274","408","48","730","1244","0","58.68","22.03"
"10","004","00","050","0010","0310","862","371","491","36","898","1424","0","63.06","26.05"
"10","004","00","050","0011","0000","1453","578","875","78","1531","2425","0","63.13","23.84"
"10","004","00","050","0011","0311","764","319","445","51","815","1200","0","67.92","26.58"
"10","004","00","050","0011","0312","689","259","430","27","716","1225","0","58.45","21.14"
"10","004","00","050","0012","0000","803","293","510","84","887","1438","0","61.68","20.38"
"10","004","00","050","0012","0313","803","293","510","84","887","1438","0","61.68","20.38"
"10","004","00","050","0013","0000","1143","495","648","91","1234","2147","0","57.48","23.06"
"10","004","00","050","0013","0303","579","259","320","61","640","1052","0","60.84","24.62"
"10","004","00","050","0013","0304","564","236","328","30","594","1095","0","54.25","21.55"
"10","004","00","050","0014","0000","2310","979","1331","153","2463","5107","0","48.23","19.17"
"10","004","00","050","0014","0319","463","160","303","28","491","1013","0","48.47","15.79"
"10","004","00","050","0014","0320","554","254","300","35","589","1359","0","43.34","18.69"
"10","004","00","050","0014","0321","617","278","339","63","680","1244","0","54.66","22.35"
"10","004","00","050","0014","0322","676","287","389","27","703","1491","0","47.15","19.25"
"10","004","00","050","0015","0000","1522","589","933","136","1658","3084","0","53.76","19.10"
"10","004","00","050","0015","0326","450","182","268","41","491","1019","0","48.18","17.86"
"10","004","00","050","0015","0327","614","231","383","66","680","1148","0","59.23","20.12"
"10","004","00","050","0015","0328","458","176","282","29","487","917","0","53.11","19.19"
"10","004","00","050","0016","0000","2744","1178","1566","202","2946","6083","0","48.43","19.37"
"10","004","00","050","0016","0314","647","260","387","52","699","1353","0","51.66","19.22"
"10","004","00","050","0016","0315","462","187","275","61","523","968","0","54.03","19.32"
"10","004","00","050","0016","0316","521","230","291","35","556","1177","0","47.24","19.54"
"10","004","00","050","0016","0317","616","275","341","38","654","1400","0","46.71","19.64"
"10","004","00","050","0016","0318","498","226","272","16","514","1185","0","43.38","19.07"
"10","004","00","050","0017","0000","2170","956","1214","134","2304","3845","0","59.92","24.86"
"10","004","00","050","0017","0300","723","354","369","57","780","1249","0","62.45","28.34"
"10","004","00","050","0017","0301","698","298","400","32","730","1289","0","56.63","23.12"
"10","004","00","050","0017","0302","749","304","445","45","794","1307","0","60.75","23.26"
"10","004","00","050","0018","0000","2048","900","1148","120","2168","3680","0","58.91","24.46"
"10","004","00","050","0018","0293","665","290","375","51","716","1149","0","62.32","25.24"
"10","004","00","050","0018","0294","735","313","422","57","792","1296","0","61.11","24.15"
"10","004","00","050","0018","0295","648","297","351","12","660","1235","0","53.44","24.05"
"10","004","00","050","0019","0000","2129","977","1152","164","2293","4482","0","51.16","21.80"
"10","004","00","050","0019","0277","578","254","324","54","632","1163","0","54.34","21.84"
"10","004","00","050","0019","0278","503","224","279","29","532","1050","0","50.67","21.33"
"10","004","00","050","0019","0279","552","242","310","59","611","1201","0","50.87","20.15"
"10","004","00","050","0019","0280","496","257","239","22","518","1068","0","48.50","24.06"
"10","004","00","050","0020","0000","1911","802","1109","131","2042","4135","0","49.38","19.40"
"10","004","00","050","0020","0323","742","315","427","36","778","1458","0","53.36","21.60"
"10","004","00","050","0020","0324","607","267","340","33","640","1414","0","45.26","18.88"
"10","004","00","050","0020","0325","562","220","342","62","624","1263","0","49.41","17.42"
"10","004","00","060","0000","0000","22357","10291","12066","1337","23694","46507","58583","50.95","22.13"
"10","004","00","060","0001","0000","553","256","297","45","598","1058","0","56.52","24.20"
"10","004","00","060","0001","0329","553","256","297","45","598","1058","0","56.52","24.20"
"10","004","00","060","0002","0000","899","449","450","79","978","1727","0","56.63","26.00"
"10","004","00","060","0002","0337","405","218","187","42","447","750","0","59.60","29.07"
"10","004","00","060","0002","0338","494","231","263","37","531","977","0","54.35","23.64"
"10","004","00","060","0003","0000","1009","480","529","80","1089","1872","0","58.17","25.64"
"10","004","00","060","0003","0330","470","238","232","40","510","896","0","56.92","26.56"
"10","004","00","060","0003","0331","539","242","297","40","579","976","0","59.32","24.80"
"10","004","00","060","0004","0000","1270","716","554","125","1395","2701","0","51.65","26.51"
"10","004","00","060","0004","0340","430","246","184","36","466","1007","0","46.28","24.43"
"10","004","00","060","0004","0341","400","218","182","54","454","811","0","55.98","26.88"
"10","004","00","060","0004","0342","440","252","188","35","475","883","0","53.79","28.54"
"10","004","00","060","0005","0000","887","426","461","68","955","1797","0","53.14","23.71"
"10","004","00","060","0005","0335","511","239","272","40","551","922","0","59.76","25.92"
"10","004","00","060","0005","0336","376","187","189","28","404","875","0","46.17","21.37"
"10","004","00","060","0006","0000","395","229","166","24","419","787","0","53.24","29.10"
"10","004","00","060","0006","0339","395","229","166","24","419","787","0","53.24","29.10"
"10","004","00","060","0007","0000","1318","572","746","75","1393","3111","0","44.78","18.39"
"10","004","00","060","0007","0332","462","198","264","30","492","963","0","51.09","20.56"
"10","004","00","060","0007","0333","427","195","232","25","452","1094","0","41.32","17.82"
"10","004","00","060","0007","0334","429","179","250","20","449","1054","0","42.60","16.98"
"10","004","00","060","0008","0000","2273","997","1276","128","2401","5161","0","46.52","19.32"
"10","004","00","060","0008","0357","441","200","241","25","466","967","0","48.19","20.68"
"10","004","00","060","0008","0358","483","189","294","36","519","1033","0","50.24","18.30"
"10","004","00","060","0008","0359","386","181","205","9","395","1076","0","36.71","16.82"
"10","004","00","060","0008","0360","463","213","250","22","485","1006","0","48.21","21.17"
"10","004","00","060","0008","0361","500","214","286","36","536","1079","0","49.68","19.83"
"10","004","00","060","0009","0000","1001","545","456","116","1117","2037","0","54.84","26.76"
"10","004","00","060","0009","0343","459","255","204","70","529","1021","0","51.81","24.98"
"10","004","00","060","0009","0344","542","290","252","46","588","1016","0","57.87","28.54"
"10","004","00","060","0010","0000","1378","588","790","47","1425","2795","0","50.98","21.04"
"10","004","00","060","0010","0345","678","257","421","35","713","1306","0","54.59","19.68"
"10","004","00","060","0010","0346","700","331","369","12","712","1489","0","47.82","22.23"
"10","004","00","060","0011","0000","2097","902","1195","83","2180","4281","0","50.92","21.07"
"10","004","00","060","0011","0365","562","234","328","24","586","1069","0","54.82","21.89"
"10","004","00","060","0011","0366","464","200","264","24","488","1051","0","46.43","19.03"
"10","004","00","060","0011","0367","552","237","315","22","574","1144","0","50.17","20.72"
"10","004","00","060","0011","0368","519","231","288","13","532","1017","0","52.31","22.71"
"10","004","00","060","0012","0000","811","368","443","66","877","1514","0","57.93","24.31"
"10","004","00","060","0012","0354","426","197","229","38","464","768","0","60.42","25.65"
"10","004","00","060","0012","0355","385","171","214","28","413","746","0","55.36","22.92"
"10","004","00","060","0013","0000","622","306","316","43","665","1037","0","64.13","29.51"
"10","004","00","060","0013","0356","622","306","316","43","665","1037","0","64.13","29.51"
"10","004","00","060","0014","0000","1634","696","938","51","1685","3477","0","48.46","20.02"
"10","004","00","060","0014","0347","601","256","345","21","622","1281","0","48.56","19.98"
"10","004","00","060","0014","0348","543","229","314","14","557","1115","0","49.96","20.54"
"10","004","00","060","0014","0349","490","211","279","16","506","1081","0","46.81","19.52"
"10","004","00","060","0015","0000","2063","884","1179","116","2179","4305","0","50.62","20.53"
"10","004","00","060","0015","0350","481","202","279","35","516","1051","0","49.10","19.22"
"10","004","00","060","0015","0351","479","205","274","31","510","971","0","52.52","21.11"
"10","004","00","060","0015","0352","525","232","293","30","555","1026","0","54.09","22.61"
"10","004","00","060","0015","0353","578","245","333","20","598","1257","0","47.57","19.49"
"10","004","00","060","0016","0000","2855","1326","1529","93","2948","6216","0","47.43","21.33"
"10","004","00","060","0016","0369","534","245","289","29","563","1095","0","51.42","22.37"
"10","004","00","060","0016","0370","564","260","304","26","590","1131","0","52.17","22.99"
"10","004","00","060","0016","0371","545","242","303","18","563","1174","0","47.96","20.61"
"10","004","00","060","0016","0372","607","282","325","14","621","1287","0","48.25","21.91"
"10","004","00","060","0016","0373","605","297","308","6","611","1529","0","39.96","19.42"
"10","004","00","060","0017","0000","1292","551","741","98","1390","2631","0","52.83","20.94"
"10","004","00","060","0017","0362","413","173","240","28","441","903","0","48.84","19.16"
"10","004","00","060","0017","0363","373","169","204","35","408","794","0","51.39","21.28"
"10","004","00","060","0017","0364","506","209","297","35","541","934","0","57.92","22.38"
"10","004","00","070","0000","0000","9529","4078","5451","767","10296","17260","20052","59.65","23.63"
"10","004","00","070","0001","0000","304","119","185","23","327","470","0","69.57","25.32"
"10","004","00","070","0001","0375","304","119","185","23","327","470","0","69.57","25.32"
"10","004","00","070","0002","0000","248","106","142","20","268","364","0","73.63","29.12"
"10","004","00","070","0002","0374","248","106","142","20","268","364","0","73.63","29.12"
"10","004","00","070","0003","0000","416","155","261","20","436","900","0","48.44","17.22"
"10","004","00","070","0003","0376","416","155","261","20","436","900","0","48.44","17.22"
"10","004","00","070","0004","0000","259","97","162","29","288","402","0","71.64","24.13"
"10","004","00","070","0004","0377","259","97","162","29","288","402","0","71.64","24.13"
"10","004","00","070","0005","0000","1238","502","736","136","1374","2545","0","53.99","19.72"
"10","004","00","070","0005","0378","612","233","379","60","672","1215","0","55.31","19.18"
"10","004","00","070","0005","0379","626","269","357","76","702","1330","0","52.78","20.23"
"10","004","00","070","0006","0000","861","376","485","90","951","1505","0","63.19","24.98"
"10","004","00","070","0006","0380","439","201","238","38","477","753","0","63.35","26.69"
"10","004","00","070","0006","0381","422","175","247","52","474","752","0","63.03","23.27"
"10","004","00","070","0007","0000","355","139","216","47","402","590","0","68.14","23.56"
"10","004","00","070","0007","0382","355","139","216","47","402","590","0","68.14","23.56"
"10","004","00","070","0008","0000","390","185","205","43","433","751","0","57.66","24.63"
"10","004","00","070","0008","0383","390","185","205","43","433","751","0","57.66","24.63"
"10","004","00","070","0009","0000","1292","523","769","100","1392","2297","0","60.60","22.77"
"10","004","00","070","0009","0384","667","258","409","42","709","1236","0","57.36","20.87"
"10","004","00","070","0009","0385","625","265","360","58","683","1061","0","64.37","24.98"
"10","004","00","070","0010","0000","850","375","475","59","909","1527","0","59.53","24.56"
"10","004","00","070","0010","0386","459","208","251","15","474","868","0","54.61","23.96"
"10","004","00","070","0010","0387","391","167","224","44","435","659","0","66.01","25.34"
"10","004","00","070","0011","0000","2646","1226","1420","140","2786","4789","0","58.17","25.60"
"10","004","00","070","0011","0388","692","289","403","41","733","1181","0","62.07","24.47"
"10","004","00","070","0011","0389","839","398","441","42","881","1538","0","57.28","25.88"
"10","004","00","070","0011","0390","556","281","275","24","580","1018","0","56.97","27.60"
"10","004","00","070","0011","0391","559","258","301","33","592","1052","0","56.27","24.52"
"10","004","00","070","0012","0000","670","275","395","60","730","1120","0","65.18","24.55"
"10","004","00","070","0012","0392","670","275","395","60","730","1120","0","65.18","24.55"
"10","004","00","080","0000","0000","6373","2625","3748","675","7048","10658","12249","66.13","24.63"
"10","004","00","080","0001","0000","1798","696","1102","191","1989","3171","0","62.72","21.95"
"10","004","00","080","0001","0393","653","246","407","59","712","1141","0","62.40","21.56"
"10","004","00","080","0001","0394","528","202","326","62","590","978","0","60.33","20.65"
"10","004","00","080","0001","0395","617","248","369","70","687","1052","0","65.30","23.57"
"10","004","00","080","0002","0000","462","200","262","54","516","812","0","63.55","24.63"
"10","004","00","080","0002","0396","462","200","262","54","516","812","0","63.55","24.63"
"10","004","00","080","0003","0000","86","26","60","15","101","168","0","60.12","15.48"
"10","004","00","080","0003","0397","86","26","60","15","101","168","0","60.12","15.48"
"10","004","00","080","0004","0000","129","60","69","21","150","209","0","71.77","28.71"
"10","004","00","080","0004","0398","129","60","69","21","150","209","0","71.77","28.71"
"10","004","00","080","0005","0000","226","110","116","28","254","312","0","81.41","35.26"
"10","004","00","080","0005","0399","226","110","116","28","254","312","0","81.41","35.26"
"10","004","00","080","0006","0000","474","217","257","36","510","843","0","60.50","25.74"
"10","004","00","080","0006","0400","474","217","257","36","510","843","0","60.50","25.74"
"10","004","00","080","0007","0000","242","116","126","35","277","408","0","67.89","28.43"
"10","004","00","080","0007","0403","242","116","126","35","277","408","0","67.89","28.43"
"10","004","00","080","0008","0000","574","238","336","53","627","888","0","70.61","26.80"
"10","004","00","080","0008","0404","404","171","233","33","437","626","0","69.81","27.32"
"10","004","00","080","0008","0405","170","67","103","20","190","262","0","72.52","25.57"
"10","004","00","080","0009","0000","930","386","544","93","1023","1461","0","70.02","26.42"
"10","004","00","080","0009","0406","435","184","251","46","481","646","0","74.46","28.48"
"10","004","00","080","0009","0407","495","202","293","47","542","815","0","66.50","24.79"
"10","004","00","080","0010","0000","936","358","578","95","1031","1622","0","63.56","22.07"
"10","004","00","080","0010","0408","396","152","244","38","434","762","0","56.96","19.95"
"10","004","00","080","0010","0409","540","206","334","57","597","860","0","69.42","23.95"
"10","004","00","080","0011","0000","516","218","298","54","570","764","0","74.61","28.53"
"10","004","00","080","0011","0401","182","85","97","9","191","257","0","74.32","33.07"
"10","004","00","080","0011","0402","334","133","201","45","379","507","0","74.75","26.23"
"10","004","00","090","0000","0000","4307","1848","2459","408","4715","7629","8693","61.80","24.22"
"10","004","00","090","0001","0000","577","252","325","50","627","1088","0","57.63","23.16"
"10","004","00","090","0001","0410","577","252","325","50","627","1088","0","57.63","23.16"
"10","004","00","090","0002","0000","660","256","404","100","760","1114","0","68.22","22.98"
"10","004","00","090","0002","0411","660","256","404","100","760","1114","0","68.22","22.98"
"10","004","00","090","0003","0000","1403","602","801","108","1511","2460","0","61.42","24.47"
"10","004","00","090","0003","0413","539","227","312","43","582","880","0","66.14","25.80"
"10","004","00","090","0003","0414","443","186","257","40","483","774","0","62.40","24.03"
"10","004","00","090","0003","0415","421","189","232","25","446","806","0","55.33","23.45"
"10","004","00","090","0004","0000","410","197","213","34","444","806","0","55.09","24.44"
"10","004","00","090","0004","0416","410","197","213","34","444","806","0","55.09","24.44"
"10","004","00","090","0005","0000","229","105","124","18","247","358","0","68.99","29.33"
"10","004","00","090","0005","0417","229","105","124","18","247","358","0","68.99","29.33"
"10","004","00","090","0006","0000","440","189","251","33","473","689","0","68.65","27.43"
"10","004","00","090","0006","0418","440","189","251","33","473","689","0","68.65","27.43"
"10","004","00","090","0007","0000","248","101","147","24","272","525","0","51.81","19.24"
"10","004","00","090","0007","0412","248","101","147","24","272","525","0","51.81","19.24"
"10","004","00","090","0008","0000","188","92","96","19","207","307","0","67.43","29.97"
"10","004","00","090","0008","0419","188","92","96","19","207","307","0","67.43","29.97"
"10","004","00","090","0009","0000","152","54","98","22","174","282","0","61.70","19.15"
"10","004","00","090","0009","0420","152","54","98","22","174","282","0","61.70","19.15"
"10","004","00","100","0000","0000","7514","3402","4112","562","8076","12607","14362","64.06","26.99"
"10","004","00","100","0001","0000","1556","734","822","94","1650","2644","0","62.41","27.76"
"10","004","00","100","0001","0421","879","388","491","64","943","1399","0","67.41","27.73"
"10","004","00","100","0001","0422","677","346","331","30","707","1245","0","56.79","27.79"
"10","004","00","100","0002","0000","935","414","521","32","967","1771","0","54.60","23.38"
"10","004","00","100","0002","0425","470","222","248","12","482","963","0","50.05","23.05"
"10","004","00","100","0002","0426","465","192","273","20","485","808","0","60.02","23.76"
"10","004","00","100","0003","0000","561","223","338","60","621","981","0","63.30","22.73"
"10","004","00","100","0003","0427","561","223","338","60","621","981","0","63.30","22.73"
"10","004","00","100","0004","0000","811","352","459","134","945","1133","0","83.41","31.07"
"10","004","00","100","0004","0428","811","352","459","134","945","1133","0","83.41","31.07"
"10","004","00","100","0005","0000","422","192","230","19","441","780","0","56.54","24.62"
"10","004","00","100","0005","0430","422","192","230","19","441","780","0","56.54","24.62"
"10","004","00","100","0006","0000","436","216","220","41","477","716","0","66.62","30.17"
"10","004","00","100","0006","0429","436","216","220","41","477","716","0","66.62","30.17"
"10","004","00","100","0007","0000","355","160","195","27","382","515","0","74.17","31.07"
"10","004","00","100","0007","0433","355","160","195","27","382","515","0","74.17","31.07"
"10","004","00","100","0008","0000","495","209","286","28","523","876","0","59.70","23.86"
"10","004","00","100","0008","0431","495","209","286","28","523","876","0","59.70","23.86"
"10","004","00","100","0009","0000","386","176","210","39","425","578","0","73.53","30.45"
"10","004","00","100","0009","0432","386","176","210","39","425","578","0","73.53","30.45"
"10","004","00","100","0010","0000","1557","726","831","88","1645","2613","0","62.95","27.78"
"10","004","00","100","0010","0423","788","369","419","39","827","1284","0","64.41","28.74"
"10","004","00","100","0010","0424","769","357","412","49","818","1329","0","61.55","26.86"
"10","004","00","110","0000","0000","2785","1274","1511","225","3010","4802","5331","62.68","26.53"
"10","004","00","110","0001","0000","375","153","222","12","387","814","0","47.54","18.80"
"10","004","00","110","0001","0434","375","153","222","12","387","814","0","47.54","18.80"
"10","004","00","110","0002","0000","402","186","216","26","428","649","0","65.95","28.66"
"10","004","00","110","0002","0435","402","186","216","26","428","649","0","65.95","28.66"
"10","004","00","110","0003","0000","350","165","185","15","365","553","0","66.00","29.84"
"10","004","00","110","0003","0436","350","165","185","15","365","553","0","66.00","29.84"
"10","004","00","110","0004","0000","828","393","435","86","914","1351","0","67.65","29.09"
"10","004","00","110","0004","0439","420","185","235","39","459","648","0","70.83","28.55"
"10","004","00","110","0004","0440","408","208","200","47","455","703","0","64.72","29.59"
"10","004","00","110","0005","0000","320","144","176","29","349","583","0","59.86","24.70"
"10","004","00","110","0005","0437","183","86","97","12","195","329","0","59.27","26.14"
"10","004","00","110","0005","0438","137","58","79","17","154","254","0","60.63","22.83"
"10","004","00","110","0006","0000","510","233","277","57","567","852","0","66.55","27.35"
"10","004","00","110","0006","0441","249","104","145","15","264","442","0","59.73","23.53"
"10","004","00","110","0006","0442","261","129","132","42","303","410","0","73.90","31.46"
"10","004","00","120","0000","0000","3600","1553","2047","313","3913","7138","9584","54.82","21.76"
"10","004","00","120","0001","0000","343","141","202","25","368","561","0","65.60","25.13"
"10","004","00","120","0001","0445","102","50","52","4","106","195","0","54.36","25.64"
"10","004","00","120","0001","0446","241","91","150","21","262","366","0","71.58","24.86"
"10","004","00","120","0002","0000","451","179","272","32","483","793","0","60.91","22.57"
"10","004","00","120","0002","0443","261","95","166","19","280","452","0","61.95","21.02"
"10","004","00","120","0002","0444","190","84","106","13","203","341","0","59.53","24.63"
"10","004","00","120","0003","0000","654","248","406","61","715","1183","0","60.44","20.96"
"10","004","00","120","0003","0447","464","179","285","57","521","726","0","71.76","24.66"
"10","004","00","120","0003","0448","190","69","121","4","194","457","0","42.45","15.10"
"10","004","00","120","0004","0000","481","156","325","32","513","628","0","81.69","24.84"
"10","004","00","120","0004","0451","481","156","325","32","513","628","0","81.69","24.84"
"10","004","00","120","0005","0000","395","146","249","19","414","1090","0","37.98","13.39"
"10","004","00","120","0005","0449","135","50","85","1","136","507","0","26.82","9.86"
"10","004","00","120","0005","0450","260","96","164","18","278","583","0","47.68","16.47"
"10","004","00","120","0006","0000","408","198","210","18","426","1293","0","32.95","15.31"
"10","004","00","120","0006","0452","158","66","92","4","162","607","0","26.69","10.87"
"10","004","00","120","0006","0453","172","80","92","10","182","570","0","31.93","14.04"
"10","004","00","120","0006","0454","78","52","26","4","82","116","0","70.69","44.83"
"10","004","00","120","0007","0000","868","485","383","126","994","1590","0","62.52","30.50"
"10","004","00","120","0007","0455","186","88","98","6","192","482","0","39.83","18.26"
"10","004","00","120","0007","0456","460","266","194","104","564","794","0","71.03","33.50"
"10","004","00","120","0007","0457","222","131","91","16","238","314","0","75.80","41.72"
"10","004","00","130","0000","0000","2251","883","1368","236","2487","3793","4580","65.57","23.28"
"10","004","00","130","0001","0000","753","234","519","56","809","1297","0","62.37","18.04"
"10","004","00","130","0001","0458","479","136","343","41","520","647","0","80.37","21.02"
"10","004","00","130","0001","0459","274","98","176","15","289","650","0","44.46","15.08"
"10","004","00","130","0002","0000","436","168","268","43","479","711","0","67.37","23.63"
"10","004","00","130","0002","0462","436","168","268","43","479","711","0","67.37","23.63"
"10","004","00","130","0003","0000","70","26","44","7","77","360","0","21.39","7.22"
"10","004","00","130","0003","0463","70","26","44","7","77","360","0","21.39","7.22"
"10","004","00","130","0004","0000","992","455","537","130","1122","1425","0","78.74","31.93"
"10","004","00","130","0004","0460","375","172","203","48","423","545","0","77.61","31.56"
"10","004","00","130","0004","0461","617","283","334","82","699","880","0","79.43","32.16"
"10","005","00","000","0000","0000","266577","125308","141269","18710","285287","445428","535149","64.05","28.13"
"10","005","00","010","0000","0000","41877","17052","24825","2233","44110","71473","85998","61.72","23.86"
"10","005","00","010","0001","0000","607","255","352","28","635","1071","0","59.29","23.81"
"10","005","00","010","0001","0001","607","255","352","28","635","1071","0","59.29","23.81"
"10","005","00","010","0002","0000","2234","867","1367","101","2335","3875","0","60.26","22.37"
"10","005","00","010","0002","0050","572","224","348","26","598","940","0","63.62","23.83"
"10","005","00","010","0002","0051","572","252","320","18","590","944","0","62.50","26.69"
"10","005","00","010","0002","0052","547","189","358","23","570","1033","0","55.18","18.30"
"10","005","00","010","0002","0053","543","202","341","34","577","958","0","60.23","21.09"
"10","005","00","010","0003","0000","558","247","311","31","589","960","0","61.35","25.73"
"10","005","00","010","0003","0002","558","247","311","31","589","960","0","61.35","25.73"
"10","005","00","010","0004","0000","1336","513","823","67","1403","2131","0","65.84","24.07"
"10","005","00","010","0004","0009","686","260","426","28","714","1094","0","65.27","23.77"
"10","005","00","010","0004","0010","650","253","397","39","689","1037","0","66.44","24.40"
"10","005","00","010","0005","0000","2020","806","1214","103","2123","3442","0","61.68","23.42"
"10","005","00","010","0005","0011","616","276","340","35","651","1040","0","62.60","26.54"
"10","005","00","010","0005","0012","681","262","419","26","707","1227","0","57.62","21.35"
"10","005","00","010","0005","0013","723","268","455","42","765","1175","0","65.11","22.81"
"10","005","00","010","0006","0000","2135","849","1286","139","2274","3462","0","65.68","24.52"
"10","005","00","010","0006","0006","721","316","405","60","781","1171","0","66.70","26.99"
"10","005","00","010","0006","0007","774","260","514","35","809","1229","0","65.83","21.16"
"10","005","00","010","0006","0008","640","273","367","44","684","1062","0","64.41","25.71"
"10","005","00","010","0007","0000","1798","682","1116","84","1882","3148","0","59.78","21.66"
"10","005","00","010","0007","0003","624","214","410","23","647","1041","0","62.15","20.56"
"10","005","00","010","0007","0004","599","236","363","38","637","1075","0","59.26","21.95"
"10","005","00","010","0007","0005","575","232","343","23","598","1032","0","57.95","22.48"
"10","005","00","010","0008","0000","441","188","253","20","461","774","0","59.56","24.29"
"10","005","00","010","0008","0014","441","188","253","20","461","774","0","59.56","24.29"
"10","005","00","010","0009","0000","1749","682","1067","96","1845","3081","0","59.88","22.14"
"10","005","00","010","0009","0015","530","219","311","34","564","997","0","56.57","21.97"
"10","005","00","010","0009","0016","527","209","318","30","557","983","0","56.66","21.26"
"10","005","00","010","0009","0017","692","254","438","32","724","1101","0","65.76","23.07"
"10","005","00","010","0010","0000","516","225","291","31","547","797","0","68.63","28.23"
"10","005","00","010","0010","0019","516","225","291","31","547","797","0","68.63","28.23"
"10","005","00","010","0011","0000","288","128","160","27","315","470","0","67.02","27.23"
"10","005","00","010","0011","0020","288","128","160","27","315","470","0","67.02","27.23"
"10","005","00","010","0012","0000","480","207","273","24","504","802","0","62.84","25.81"
"10","005","00","010","0012","0018","480","207","273","24","504","802","0","62.84","25.81"
"10","005","00","010","0013","0000","2165","849","1316","118","2283","3711","0","61.52","22.88"
"10","005","00","010","0013","0024","688","259","429","53","741","1163","0","63.71","22.27"
"10","005","00","010","0013","0025","675","256","419","24","699","1111","0","62.92","23.04"
"10","005","00","010","0013","0026","413","161","252","17","430","718","0","59.89","22.42"
"10","005","00","010","0013","0027","389","173","216","24","413","719","0","57.44","24.06"
"10","005","00","010","0014","0000","782","371","411","59","841","1295","0","64.94","28.65"
"10","005","00","010","0014","0021","782","371","411","59","841","1295","0","64.94","28.65"
"10","005","00","010","0015","0000","815","341","474","47","862","1448","0","59.53","23.55"
"10","005","00","010","0015","0031","328","132","196","16","344","550","0","62.55","24.00"
"10","005","00","010","0015","0032","487","209","278","31","518","898","0","57.68","23.27"
"10","005","00","010","0016","0000","2776","1093","1683","99","2875","4898","0","58.70","22.32"
"10","005","00","010","0016","0033","626","231","395","19","645","1134","0","56.88","20.37"
"10","005","00","010","0016","0034","779","328","451","19","798","1328","0","60.09","24.70"
"10","005","00","010","0016","0035","670","257","413","36","706","1229","0","57.45","20.91"
"10","005","00","010","0016","0036","701","277","424","25","726","1207","0","60.15","22.95"
"10","005","00","010","0017","0000","1751","698","1053","65","1816","2951","0","61.54","23.65"
"10","005","00","010","0017","0028","568","227","341","26","594","959","0","61.94","23.67"
"10","005","00","010","0017","0029","628","247","381","29","657","1066","0","61.63","23.17"
"10","005","00","010","0017","0030","555","224","331","10","565","926","0","61.02","24.19"
"10","005","00","010","0018","0000","2018","839","1179","107","2125","3307","0","64.26","25.37"
"10","005","00","010","0018","0037","732","318","414","40","772","1165","0","66.27","27.30"
"10","005","00","010","0018","0038","642","257","385","28","670","1049","0","63.87","24.50"
"10","005","00","010","0018","0039","644","264","380","39","683","1093","0","62.49","24.15"
"10","005","00","010","0019","0000","2337","1017","1320","125","2462","4057","0","60.69","25.07"
"10","005","00","010","0019","0040","562","235","327","35","597","1061","0","56.27","22.15"
"10","005","00","010","0019","0041","657","293","364","27","684","1071","0","63.87","27.36"
"10","005","00","010","0019","0042","546","224","322","30","576","947","0","60.82","23.65"
"10","005","00","010","0019","0043","572","265","307","33","605","978","0","61.86","27.10"
"10","005","00","010","0020","0000","723","329","394","71","794","1110","0","71.53","29.64"
"10","005","00","010","0020","0065","723","329","394","71","794","1110","0","71.53","29.64"
"10","005","00","010","0021","0000","2459","1014","1445","99","2558","4145","0","61.71","24.46"
"10","005","00","010","0021","0058","635","252","383","25","660","1078","0","61.22","23.38"
"10","005","00","010","0021","0059","624","257","367","28","652","1008","0","64.68","25.50"
"10","005","00","010","0021","0060","592","246","346","31","623","1032","0","60.37","23.84"
"10","005","00","010","0021","0061","608","259","349","15","623","1027","0","60.66","25.22"
"10","005","00","010","0022","0000","2943","1145","1798","142","3085","5210","0","59.21","21.98"
"10","005","00","010","0022","0054","650","254","396","32","682","1098","0","62.11","23.13"
"10","005","00","010","0022","0055","721","275","446","24","745","1254","0","59.41","21.93"
"10","005","00","010","0022","0056","777","288","489","36","813","1304","0","62.35","22.09"
"10","005","00","010","0022","0057","795","328","467","50","845","1554","0","54.38","21.11"
"10","005","00","010","0023","0000","1346","554","792","69","1415","2369","0","59.73","23.39"
"10","005","00","010","0023","0022","681","280","401","33","714","1225","0","58.29","22.86"
"10","005","00","010","0023","0023","665","274","391","36","701","1144","0","61.28","23.95"
"10","005","00","010","0024","0000","820","353","467","45","865","1569","0","55.13","22.50"
"10","005","00","010","0024","0068","397","167","230","20","417","753","0","55.38","22.18"
"10","005","00","010","0024","0069","423","186","237","25","448","816","0","54.90","22.79"
"10","005","00","010","0025","0000","1967","807","1160","102","2069","3367","0","61.45","23.97"
"10","005","00","010","0025","0044","732","298","434","48","780","1218","0","64.04","24.47"
"10","005","00","010","0025","0045","592","246","346","32","624","939","0","66.45","26.20"
"10","005","00","010","0025","0046","643","263","380","22","665","1210","0","54.96","21.74"
"10","005","00","010","0026","0000","1714","671","1043","108","1822","2698","0","67.53","24.87"
"10","005","00","010","0026","0047","592","247","345","41","633","966","0","65.53","25.57"
"10","005","00","010","0026","0048","523","200","323","28","551","792","0","69.57","25.25"
"10","005","00","010","0026","0049","599","224","375","39","638","940","0","67.87","23.83"
"10","005","00","010","0027","0000","1002","410","592","71","1073","1860","0","57.69","22.04"
"10","005","00","010","0027","0066","565","221","344","38","603","1017","0","59.29","21.73"
"10","005","00","010","0027","0067","437","189","248","33","470","843","0","55.75","22.42"
"10","005","00","010","0028","0000","2097","912","1185","155","2252","3465","0","64.99","26.32"
"10","005","00","010","0028","0062","814","337","477","56","870","1233","0","70.56","27.33"
"10","005","00","010","0028","0063","817","349","468","54","871","1379","0","63.16","25.31"
"10","005","00","010","0028","0064","466","226","240","45","511","853","0","59.91","26.49"
"10","005","00","020","0000","0000","23474","13110","10364","1972","25446","37381","43965","68.07","35.07"
"10","005","00","020","0001","0000","1246","685","561","63","1309","2088","0","62.69","32.81"
"10","005","00","020","0001","0189","511","285","226","42","553","832","0","66.47","34.25"
"10","005","00","020","0001","0190","735","400","335","21","756","1256","0","60.19","31.85"
"10","005","00","020","0002","0000","833","452","381","44","877","1368","0","64.11","33.04"
"10","005","00","020","0002","0191","469","250","219","26","495","725","0","68.28","34.48"
"10","005","00","020","0002","0192","364","202","162","18","382","643","0","59.41","31.42"
"10","005","00","020","0003","0000","539","311","228","19","558","817","0","68.30","38.07"
"10","005","00","020","0003","0193","539","311","228","19","558","817","0","68.30","38.07"
"10","005","00","020","0004","0000","946","563","383","71","1017","1522","0","66.82","36.99"
"10","005","00","020","0004","0194","520","287","233","26","546","786","0","69.47","36.51"
"10","005","00","020","0004","0195","426","276","150","45","471","736","0","63.99","37.50"
"10","005","00","020","0005","0000","676","424","252","64","740","1139","0","64.97","37.23"
"10","005","00","020","0005","0196","676","424","252","64","740","1139","0","64.97","37.23"
"10","005","00","020","0006","0000","1270","692","578","93","1363","1977","0","68.94","35.00"
"10","005","00","020","0006","0197","751","389","362","48","799","1165","0","68.58","33.39"
"10","005","00","020","0006","0198","519","303","216","45","564","812","0","69.46","37.32"
"10","005","00","020","0007","0000","669","404","265","62","731","997","0","73.32","40.52"
"10","005","00","020","0007","0199","669","404","265","62","731","997","0","73.32","40.52"
"10","005","00","020","0008","0000","1342","711","631","109","1451","2089","0","69.46","34.04"
"10","005","00","020","0008","0200","701","348","353","51","752","1061","0","70.88","32.80"
"10","005","00","020","0008","0201","641","363","278","58","699","1028","0","68.00","35.31"
"10","005","00","020","0009","0000","2380","1265","1115","150","2530","3905","0","64.79","32.39"
"10","005","00","020","0009","0202","864","465","399","57","921","1403","0","65.65","33.14"
"10","005","00","020","0009","0203","781","407","374","36","817","1288","0","63.43","31.60"
"10","005","00","020","0009","0204","735","393","342","57","792","1214","0","65.24","32.37"
"10","005","00","020","0010","0000","1279","731","548","148","1427","2139","0","66.71","34.17"
"10","005","00","020","0010","0205","607","350","257","68","675","1037","0","65.09","33.75"
"10","005","00","020","0010","0206","672","381","291","80","752","1102","0","68.24","34.57"
"10","005","00","020","0011","0000","561","362","199","73","634","895","0","70.84","40.45"
"10","005","00","020","0011","0207","561","362","199","73","634","895","0","70.84","40.45"
"10","005","00","020","0012","0000","385","224","161","49","434","610","0","71.15","36.72"
"10","005","00","020","0012","0208","385","224","161","49","434","610","0","71.15","36.72"
"10","005","00","020","0013","0000","845","432","413","53","898","1275","0","70.43","33.88"
"10","005","00","020","0013","0209","845","432","413","53","898","1275","0","70.43","33.88"
"10","005","00","020","0014","0000","799","476","323","59","858","1285","0","66.77","37.04"
"10","005","00","020","0014","0210","386","243","143","29","415","619","0","67.04","39.26"
"10","005","00","020","0014","0211","413","233","180","30","443","666","0","66.52","34.98"
"10","005","00","020","0015","0000","1106","578","528","69","1175","1744","0","67.37","33.14"
"10","005","00","020","0015","0212","556","295","261","43","599","884","0","67.76","33.37"
"10","005","00","020","0015","0213","550","283","267","26","576","860","0","66.98","32.91"
"10","005","00","020","0016","0000","769","409","360","75","844","1196","0","70.57","34.20"
"10","005","00","020","0016","0214","769","409","360","75","844","1196","0","70.57","34.20"
"10","005","00","020","0017","0000","296","153","143","29","325","506","0","64.23","30.24"
"10","005","00","020","0017","0215","296","153","143","29","325","506","0","64.23","30.24"
"10","005","00","020","0018","0000","433","213","220","52","485","744","0","65.19","28.63"
"10","005","00","020","0018","0216","433","213","220","52","485","744","0","65.19","28.63"
"10","005","00","020","0019","0000","1507","879","628","147","1654","2378","0","69.55","36.96"
"10","005","00","020","0019","0224","731","419","312","81","812","1111","0","73.09","37.71"
"10","005","00","020","0019","0225","776","460","316","66","842","1267","0","66.46","36.31"
"10","005","00","020","0020","0000","1057","603","454","95","1152","1605","0","71.78","37.57"
"10","005","00","020","0020","0218","539","318","221","61","600","866","0","69.28","36.72"
"10","005","00","020","0020","0219","518","285","233","34","552","739","0","74.70","38.57"
"10","005","00","020","0021","0000","914","513","401","107","1021","1544","0","66.13","33.23"
"10","005","00","020","0021","0220","465","233","232","52","517","761","0","67.94","30.62"
"10","005","00","020","0021","0221","449","280","169","55","504","783","0","64.37","35.76"
"10","005","00","020","0022","0000","1088","599","489","117","1205","1676","0","71.90","35.74"
"10","005","00","020","0022","0222","525","316","209","58","583","794","0","73.43","39.80"
"10","005","00","020","0022","0223","563","283","280","59","622","882","0","70.52","32.09"
"10","005","00","020","0023","0000","457","278","179","35","492","686","0","71.72","40.52"
"10","005","00","020","0023","0217","457","278","179","35","492","686","0","71.72","40.52"
"10","005","00","020","0024","0000","797","440","357","84","881","1368","0","64.40","32.16"
"10","005","00","020","0024","0226","797","440","357","84","881","1368","0","64.40","32.16"
"10","005","00","020","0025","0000","1280","713","567","105","1385","1828","0","75.77","39.00"
"10","005","00","020","0025","0227","671","345","326","63","734","950","0","77.26","36.32"
"10","005","00","020","0025","0228","609","368","241","42","651","878","0","74.15","41.91"
"10","005","00","030","0000","0000","15491","8676","6815","1476","16967","27793","31939","61.05","31.22"
"10","005","00","030","0001","0000","621","335","286","39","660","1022","0","64.58","32.78"
"10","005","00","030","0001","0155","621","335","286","39","660","1022","0","64.58","32.78"
"10","005","00","030","0002","0000","1160","650","510","98","1258","1870","0","67.27","34.76"
"10","005","00","030","0002","0156","564","332","232","54","618","837","0","73.84","39.67"
"10","005","00","030","0002","0157","596","318","278","44","640","1033","0","61.96","30.78"
"10","005","00","030","0003","0000","1155","677","478","103","1258","1754","0","71.72","38.60"
"10","005","00","030","0003","0158","602","351","251","46","648","948","0","68.35","37.03"
"10","005","00","030","0003","0159","553","326","227","57","610","806","0","75.68","40.45"
"10","005","00","030","0004","0000","928","548","380","144","1072","1477","0","72.58","37.10"
"10","005","00","030","0004","0163","448","245","203","66","514","700","0","73.43","35.00"
"10","005","00","030","0004","0164","480","303","177","78","558","777","0","71.81","39.00"
"10","005","00","030","0005","0000","412","222","190","73","485","660","0","73.48","33.64"
"10","005","00","030","0005","0162","412","222","190","73","485","660","0","73.48","33.64"
"10","005","00","030","0006","0000","1439","852","587","180","1619","2509","0","64.53","33.96"
"10","005","00","030","0006","0165","515","315","200","41","556","911","0","61.03","34.58"
"10","005","00","030","0006","0166","419","240","179","68","487","767","0","63.49","31.29"
"10","005","00","030","0006","0167","505","297","208","71","576","831","0","69.31","35.74"
"10","005","00","030","0007","0000","298","165","133","28","326","615","0","53.01","26.83"
"10","005","00","030","0007","0174","298","165","133","28","326","615","0","53.01","26.83"
"10","005","00","030","0008","0000","305","158","147","7","312","845","0","36.92","18.70"
"10","005","00","030","0008","0175","305","158","147","7","312","845","0","36.92","18.70"
"10","005","00","030","0009","0000","389","236","153","40","429","729","0","58.85","32.37"
"10","005","00","030","0009","0176","389","236","153","40","429","729","0","58.85","32.37"
"10","005","00","030","0010","0000","304","173","131","9","313","610","0","51.31","28.36"
"10","005","00","030","0010","0177","304","173","131","9","313","610","0","51.31","28.36"
"10","005","00","030","0011","0000","655","301","354","95","750","1157","0","64.82","26.02"
"10","005","00","030","0011","0178","655","301","354","95","750","1157","0","64.82","26.02"
"10","005","00","030","0012","0000","672","361","311","28","700","1291","0","54.22","27.96"
"10","005","00","030","0012","0179","672","361","311","28","700","1291","0","54.22","27.96"
"10","005","00","030","0013","0000","660","377","283","75","735","1293","0","56.84","29.16"
"10","005","00","030","0013","0180","366","191","175","63","429","589","0","72.84","32.43"
"10","005","00","030","0013","0181","294","186","108","12","306","704","0","43.47","26.42"
"10","005","00","030","0014","0000","967","552","415","60","1027","1772","0","57.96","31.15"
"10","005","00","030","0014","0168","378","213","165","22","400","711","0","56.26","29.96"
"10","005","00","030","0014","0169","589","339","250","38","627","1061","0","59.10","31.95"
"10","005","00","030","0015","0000","186","95","91","10","196","399","0","49.12","23.81"
"10","005","00","030","0015","0170","186","95","91","10","196","399","0","49.12","23.81"
"10","005","00","030","0016","0000","306","129","177","4","310","817","0","37.94","15.79"
"10","005","00","030","0016","0171","306","129","177","4","310","817","0","37.94","15.79"
"10","005","00","030","0017","0000","135","66","69","7","142","362","0","39.23","18.23"
"10","005","00","030","0017","0172","135","66","69","7","142","362","0","39.23","18.23"
"10","005","00","030","0018","0000","465","276","189","64","529","744","0","71.10","37.10"
"10","005","00","030","0018","0173","465","276","189","64","529","744","0","71.10","37.10"
"10","005","00","030","0019","0000","1151","648","503","169","1320","2119","0","62.29","30.58"
"10","005","00","030","0019","0182","602","336","266","90","692","1034","0","66.92","32.50"
"10","005","00","030","0019","0183","549","312","237","79","628","1085","0","57.88","28.76"
"10","005","00","030","0020","0000","524","351","173","49","573","1044","0","54.89","33.62"
"10","005","00","030","0020","0184","524","351","173","49","573","1044","0","54.89","33.62"
"10","005","00","030","0021","0000","465","244","221","42","507","694","0","73.05","35.16"
"10","005","00","030","0021","0185","465","244","221","42","507","694","0","73.05","35.16"
"10","005","00","030","0022","0000","704","366","338","47","751","1358","0","55.30","26.95"
"10","005","00","030","0022","0186","336","164","172","31","367","590","0","62.20","27.80"
"10","005","00","030","0022","0187","368","202","166","16","384","768","0","50.00","26.30"
"10","005","00","030","0023","0000","461","256","205","38","499","701","0","71.18","36.52"
"10","005","00","030","0023","0188","461","256","205","38","499","701","0","71.18","36.52"
"10","005","00","030","0024","0000","1129","638","491","67","1196","1951","0","61.30","32.70"
"10","005","00","030","0024","0160","624","345","279","36","660","991","0","66.60","34.81"
"10","005","00","030","0024","0161","505","293","212","31","536","960","0","55.83","30.52"
"10","005","00","040","0000","0000","39975","20939","19036","2204","42179","69192","88074","60.96","30.26"
"10","005","00","040","0001","0000","1066","539","527","50","1116","1834","0","60.85","29.39"
"10","005","00","040","0001","0277","576","296","280","33","609","974","0","62.53","30.39"
"10","005","00","040","0001","0278","490","243","247","17","507","860","0","58.95","28.26"
"10","005","00","040","0002","0000","1922","1000","922","114","2036","3245","0","62.74","30.82"
"10","005","00","040","0002","0279","526","278","248","35","561","946","0","59.30","29.39"
"10","005","00","040","0002","0280","811","411","400","32","843","1332","0","63.29","30.86"
"10","005","00","040","0002","0281","585","311","274","47","632","967","0","65.36","32.16"
"10","005","00","040","0003","0000","1388","738","650","37","1425","2635","0","54.08","28.01"
"10","005","00","040","0003","0282","770","423","347","18","788","1403","0","56.17","30.15"
"10","005","00","040","0003","0283","618","315","303","19","637","1232","0","51.70","25.57"
"10","005","00","040","0004","0000","2840","1505","1335","116","2956","4948","0","59.74","30.42"
"10","005","00","040","0004","0284","671","360","311","27","698","1156","0","60.38","31.14"
"10","005","00","040","0004","0285","658","340","318","20","678","1185","0","57.22","28.69"
"10","005","00","040","0004","0286","739","385","354","42","781","1313","0","59.48","29.32"
"10","005","00","040","0004","0287","772","420","352","27","799","1294","0","61.75","32.46"
"10","005","00","040","0005","0000","3062","1499","1563","144","3206","5098","0","62.89","29.40"
"10","005","00","040","0005","0288","697","348","349","46","743","1198","0","62.02","29.05"
"10","005","00","040","0005","0289","721","340","381","35","756","1223","0","61.82","27.80"
"10","005","00","040","0005","0290","419","208","211","16","435","642","0","67.76","32.40"
"10","005","00","040","0005","0291","648","316","332","19","667","1116","0","59.77","28.32"
"10","005","00","040","0005","0292","577","287","290","28","605","919","0","65.83","31.23"
"10","005","00","040","0006","0000","2031","1134","897","97","2128","3390","0","62.77","33.45"
"10","005","00","040","0006","0293","606","321","285","29","635","1012","0","62.75","31.72"
"10","005","00","040","0006","0294","673","395","278","25","698","1094","0","63.80","36.11"
"10","005","00","040","0006","0295","752","418","334","43","795","1284","0","61.92","32.55"
"10","005","00","040","0007","0000","2019","1001","1018","86","2105","3264","0","64.49","30.67"
"10","005","00","040","0007","0296","662","334","328","27","689","1138","0","60.54","29.35"
"10","005","00","040","0007","0297","670","305","365","25","695","1043","0","66.63","29.24"
"10","005","00","040","0007","0298","687","362","325","34","721","1083","0","66.57","33.43"
"10","005","00","040","0008","0000","1620","881","739","96","1716","3165","0","54.22","27.84"
"10","005","00","040","0008","0299","570","283","287","20","590","1218","0","48.44","23.23"
"10","005","00","040","0008","0300","511","286","225","33","544","917","0","59.32","31.19"
"10","005","00","040","0008","0301","539","312","227","43","582","1030","0","56.50","30.29"
"10","005","00","040","0009","0000","1097","565","532","57","1154","1968","0","58.64","28.71"
"10","005","00","040","0009","0306","550","302","248","33","583","1003","0","58.13","30.11"
"10","005","00","040","0009","0307","547","263","284","24","571","965","0","59.17","27.25"
"10","005","00","040","0010","0000","2591","1340","1251","149","2740","4816","0","56.89","27.82"
"10","005","00","040","0010","0308","623","327","296","25","648","1229","0","52.73","26.61"
"10","005","00","040","0010","0309","579","290","289","42","621","1004","0","61.85","28.88"
"10","005","00","040","0010","0310","679","341","338","44","723","1310","0","55.19","26.03"
"10","005","00","040","0010","0311","710","382","328","38","748","1273","0","58.76","30.01"
"10","005","00","040","0011","0000","675","342","333","39","714","1041","0","68.59","32.85"
"10","005","00","040","0011","0315","675","342","333","39","714","1041","0","68.59","32.85"
"10","005","00","040","0012","0000","1627","884","743","69","1696","2670","0","63.52","33.11"
"10","005","00","040","0012","0316","445","253","192","19","464","792","0","58.59","31.94"
"10","005","00","040","0012","0317","458","252","206","27","485","744","0","65.19","33.87"
"10","005","00","040","0012","0318","724","379","345","23","747","1134","0","65.87","33.42"
"10","005","00","040","0013","0000","843","461","382","51","894","1488","0","60.08","30.98"
"10","005","00","040","0013","0319","449","245","204","30","479","811","0","59.06","30.21"
"10","005","00","040","0013","0320","394","216","178","21","415","677","0","61.30","31.91"
"10","005","00","040","0014","0000","1033","539","494","53","1086","1854","0","58.58","29.07"
"10","005","00","040","0014","0321","513","254","259","16","529","925","0","57.19","27.46"
"10","005","00","040","0014","0322","520","285","235","37","557","929","0","59.96","30.68"
"10","005","00","040","0015","0000","660","352","308","28","688","1207","0","57.00","29.16"
"10","005","00","040","0015","0323","660","352","308","28","688","1207","0","57.00","29.16"
"10","005","00","040","0016","0000","2366","1242","1124","151","2517","3995","0","63.00","31.09"
"10","005","00","040","0016","0324","847","467","380","39","886","1429","0","62.00","32.68"
"10","005","00","040","0016","0325","788","389","399","68","856","1370","0","62.48","28.39"
"10","005","00","040","0016","0326","731","386","345","44","775","1196","0","64.80","32.27"
"10","005","00","040","0017","0000","1271","668","603","80","1351","2161","0","62.52","30.91"
"10","005","00","040","0017","0327","506","253","253","15","521","911","0","57.19","27.77"
"10","005","00","040","0017","0328","483","260","223","42","525","743","0","70.66","34.99"
"10","005","00","040","0017","0329","282","155","127","23","305","507","0","60.16","30.57"
"10","005","00","040","0018","0000","751","358","393","69","820","1107","0","74.07","32.34"
"10","005","00","040","0018","0330","751","358","393","69","820","1107","0","74.07","32.34"
"10","005","00","040","0019","0000","2769","1542","1227","163","2932","5057","0","57.98","30.49"
"10","005","00","040","0019","0331","655","355","300","18","673","1341","0","50.19","26.47"
"10","005","00","040","0019","0332","709","379","330","29","738","1280","0","57.66","29.61"
"10","005","00","040","0019","0333","712","396","316","55","767","1324","0","57.93","29.91"
"10","005","00","040","0019","0334","693","412","281","61","754","1112","0","67.81","37.05"
"10","005","00","040","0020","0000","1203","654","549","97","1300","2004","0","64.87","32.63"
"10","005","00","040","0020","0335","671","358","313","61","732","1062","0","68.93","33.71"
"10","005","00","040","0020","0336","532","296","236","36","568","942","0","60.30","31.42"
"10","005","00","040","0021","0000","2104","1142","962","145","2249","3702","0","60.75","30.85"
"10","005","00","040","0021","0337","313","166","147","25","338","513","0","65.89","32.36"
"10","005","00","040","0021","0338","575","304","271","42","617","1016","0","60.73","29.92"
"10","005","00","040","0021","0339","493","306","187","49","542","806","0","67.25","37.97"
"10","005","00","040","0021","0340","723","366","357","29","752","1367","0","55.01","26.77"
"10","005","00","040","0022","0000","579","314","265","45","624","964","0","64.73","32.57"
"10","005","00","040","0022","0341","579","314","265","45","624","964","0","64.73","32.57"
"10","005","00","040","0023","0000","1744","917","827","106","1850","3149","0","58.75","29.12"
"10","005","00","040","0023","0312","629","340","289","37","666","1084","0","61.44","31.37"
"10","005","00","040","0023","0313","581","299","282","23","604","1078","0","56.03","27.74"
"10","005","00","040","0023","0314","534","278","256","46","580","987","0","58.76","28.17"
"10","005","00","040","0024","0000","1305","590","715","87","1392","2128","0","65.41","27.73"
"10","005","00","040","0024","0304","790","339","451","58","848","1295","0","65.48","26.18"
"10","005","00","040","0024","0305","515","251","264","29","544","833","0","65.31","30.13"
"10","005","00","040","0025","0000","1409","732","677","75","1484","2302","0","64.47","31.80"
"10","005","00","040","0025","0302","714","358","356","27","741","1148","0","64.55","31.18"
"10","005","00","040","0025","0303","695","374","321","48","743","1154","0","64.38","32.41"
"10","005","00","050","0000","0000","48565","21609","26956","2432","50997","84079","105164","60.65","25.70"
"10","005","00","050","0001","0000","1221","537","684","96","1317","2084","0","63.20","25.77"
"10","005","00","050","0001","0342","620","286","334","49","669","1055","0","63.41","27.11"
"10","005","00","050","0001","0343","601","251","350","47","648","1029","0","62.97","24.39"
"10","005","00","050","0002","0000","966","428","538","52","1018","1625","0","62.65","26.34"
"10","005","00","050","0002","0344","496","214","282","29","525","842","0","62.35","25.42"
"10","005","00","050","0002","0345","470","214","256","23","493","783","0","62.96","27.33"
"10","005","00","050","0003","0000","1605","696","909","104","1709","2717","0","62.90","25.62"
"10","005","00","050","0003","0346","602","262","340","26","628","990","0","63.43","26.46"
"10","005","00","050","0003","0347","527","204","323","41","568","874","0","64.99","23.34"
"10","005","00","050","0003","0348","476","230","246","37","513","853","0","60.14","26.96"
"10","005","00","050","0004","0000","2082","886","1196","145","2227","3623","0","61.47","24.45"
"10","005","00","050","0004","0349","679","292","387","41","720","1139","0","63.21","25.64"
"10","005","00","050","0004","0350","574","247","327","41","615","987","0","62.31","25.03"
"10","005","00","050","0004","0351","829","347","482","63","892","1497","0","59.59","23.18"
"10","005","00","050","0005","0000","2533","1119","1414","110","2643","4383","0","60.30","25.53"
"10","005","00","050","0005","0352","552","235","317","42","594","880","0","67.50","26.70"
"10","005","00","050","0005","0353","623","284","339","27","650","1194","0","54.44","23.79"
"10","005","00","050","0005","0354","852","342","510","34","886","1398","0","63.38","24.46"
"10","005","00","050","0005","0355","506","258","248","7","513","911","0","56.31","28.32"
"10","005","00","050","0006","0000","1322","564","758","84","1406","2492","0","56.42","22.63"
"10","005","00","050","0006","0356","736","317","419","60","796","1317","0","60.44","24.07"
"10","005","00","050","0006","0357","586","247","339","24","610","1175","0","51.91","21.02"
"10","005","00","050","0007","0000","673","339","334","31","704","1027","0","68.55","33.01"
"10","005","00","050","0007","0358","673","339","334","31","704","1027","0","68.55","33.01"
"10","005","00","050","0008","0000","1790","807","983","81","1871","3192","0","58.62","25.28"
"10","005","00","050","0008","0359","608","277","331","37","645","1040","0","62.02","26.63"
"10","005","00","050","0008","0360","591","251","340","34","625","1029","0","60.74","24.39"
"10","005","00","050","0008","0361","591","279","312","10","601","1123","0","53.52","24.84"
"10","005","00","050","0009","0000","1845","743","1102","83","1928","2986","0","64.57","24.88"
"10","005","00","050","0009","0362","621","242","379","22","643","977","0","65.81","24.77"
"10","005","00","050","0009","0363","651","284","367","32","683","1075","0","63.53","26.42"
"10","005","00","050","0009","0364","573","217","356","29","602","934","0","64.45","23.23"
"10","005","00","050","0010","0000","820","384","436","62","882","1496","0","58.96","25.67"
"10","005","00","050","0010","0368","415","197","218","29","444","723","0","61.41","27.25"
"10","005","00","050","0010","0369","405","187","218","33","438","773","0","56.66","24.19"
"10","005","00","050","0011","0000","405","173","232","11","416","971","0","42.84","17.82"
"10","005","00","050","0011","0367","405","173","232","11","416","971","0","42.84","17.82"
"10","005","00","050","0012","0000","638","288","350","46","684","1003","0","68.20","28.71"
"10","005","00","050","0012","0374","638","288","350","46","684","1003","0","68.20","28.71"
"10","005","00","050","0013","0000","1106","429","677","49","1155","1972","0","58.57","21.75"
"10","005","00","050","0013","0397","518","185","333","23","541","968","0","55.89","19.11"
"10","005","00","050","0013","0398","588","244","344","26","614","1004","0","61.16","24.30"
"10","005","00","050","0014","0000","2381","1123","1258","123","2504","4673","0","53.58","24.03"
"10","005","00","050","0014","0401","785","377","408","40","825","1631","0","50.58","23.11"
"10","005","00","050","0014","0402","803","342","461","50","853","1505","0","56.68","22.72"
"10","005","00","050","0014","0403","793","404","389","33","826","1537","0","53.74","26.28"
"10","005","00","050","0015","0000","2644","1216","1428","105","2749","4421","0","62.18","27.51"
"10","005","00","050","0015","0378","796","365","431","25","821","1311","0","62.62","27.84"
"10","005","00","050","0015","0379","886","397","489","32","918","1507","0","60.92","26.34"
"10","005","00","050","0015","0380","962","454","508","48","1010","1603","0","63.01","28.32"
"10","005","00","050","0016","0000","2483","1129","1354","99","2582","3993","0","64.66","28.27"
"10","005","00","050","0016","0375","789","327","462","40","829","1255","0","66.06","26.06"
"10","005","00","050","0016","0376","881","455","426","37","918","1439","0","63.79","31.62"
"10","005","00","050","0016","0377","813","347","466","22","835","1299","0","64.28","26.71"
"10","005","00","050","0017","0000","1822","812","1010","75","1897","3272","0","57.98","24.82"
"10","005","00","050","0017","0388","683","314","369","14","697","1121","0","62.18","28.01"
"10","005","00","050","0017","0389","656","274","382","33","689","1129","0","61.03","24.27"
"10","005","00","050","0017","0390","483","224","259","28","511","1022","0","50.00","21.92"
"10","005","00","050","0018","0000","2210","1039","1171","101","2311","3859","0","59.89","26.92"
"10","005","00","050","0018","0404","683","310","373","42","725","1202","0","60.32","25.79"
"10","005","00","050","0018","0405","797","378","419","32","829","1330","0","62.33","28.42"
"10","005","00","050","0018","0406","730","351","379","27","757","1327","0","57.05","26.45"
"10","005","00","050","0019","0000","783","383","400","49","832","1235","0","67.37","31.01"
"10","005","00","050","0019","0409","783","383","400","49","832","1235","0","67.37","31.01"
"10","005","00","050","0020","0000","1102","519","583","48","1150","2174","0","52.90","23.87"
"10","005","00","050","0020","0370","633","284","349","38","671","1023","0","65.59","27.76"
"10","005","00","050","0020","0371","469","235","234","10","479","1151","0","41.62","20.42"
"10","005","00","050","0021","0000","1460","651","809","92","1552","2436","0","63.71","26.72"
"10","005","00","050","0021","0372","702","305","397","51","753","1155","0","65.19","26.41"
"10","005","00","050","0021","0373","758","346","412","41","799","1281","0","62.37","27.01"
"10","005","00","050","0022","0000","732","293","439","35","767","1236","0","62.06","23.71"
"10","005","00","050","0022","0410","732","293","439","35","767","1236","0","62.06","23.71"
"10","005","00","050","0023","0000","1342","565","777","123","1465","2399","0","61.07","23.55"
"10","005","00","050","0023","0412","688","276","412","73","761","1223","0","62.22","22.57"
"10","005","00","050","0023","0413","654","289","365","50","704","1176","0","59.86","24.57"
"10","005","00","050","0024","0000","597","255","342","49","646","855","0","75.56","29.82"
"10","005","00","050","0024","0411","597","255","342","49","646","855","0","75.56","29.82"
"10","005","00","050","0025","0000","1248","533","715","83","1331","2101","0","63.35","25.37"
"10","005","00","050","0025","0414","644","267","377","39","683","1027","0","66.50","26.00"
"10","005","00","050","0025","0415","604","266","338","44","648","1074","0","60.34","24.77"
"10","005","00","050","0026","0000","1350","620","730","60","1410","2239","0","62.97","27.69"
"10","005","00","050","0026","0399","697","325","372","32","729","1130","0","64.51","28.76"
"10","005","00","050","0026","0400","653","295","358","28","681","1109","0","61.41","26.60"
"10","005","00","050","0027","0000","1360","599","761","75","1435","2318","0","61.91","25.84"
"10","005","00","050","0027","0407","681","286","395","49","730","1198","0","60.93","23.87"
"10","005","00","050","0027","0408","679","313","366","26","705","1120","0","62.95","27.95"
"10","005","00","050","0028","0000","1958","848","1110","81","2039","3280","0","62.16","25.85"
"10","005","00","050","0028","0391","699","319","380","32","731","1213","0","60.26","26.30"
"10","005","00","050","0028","0392","663","278","385","32","695","1079","0","64.41","25.76"
"10","005","00","050","0028","0393","596","251","345","17","613","988","0","62.04","25.40"
"10","005","00","050","0029","0000","1972","844","1128","103","2075","3484","0","59.56","24.23"
"10","005","00","050","0029","0394","623","259","364","40","663","1109","0","59.78","23.35"
"10","005","00","050","0029","0395","744","327","417","36","780","1249","0","62.45","26.18"
"10","005","00","050","0029","0396","605","258","347","27","632","1126","0","56.13","22.91"
"10","005","00","050","0030","0000","1046","454","592","37","1083","1865","0","58.07","24.34"
"10","005","00","050","0030","0365","514","221","293","22","536","885","0","60.56","24.97"
"10","005","00","050","0030","0366","532","233","299","15","547","980","0","55.82","23.78"
"10","005","00","050","0031","0000","1523","690","833","55","1578","2491","0","63.35","27.70"
"10","005","00","050","0031","0381","728","324","404","28","756","1182","0","63.96","27.41"
"10","005","00","050","0031","0382","795","366","429","27","822","1309","0","62.80","27.96"
"10","005","00","050","0032","0000","2007","944","1063","39","2046","3406","0","60.07","27.72"
"10","005","00","050","0032","0383","620","296","324","16","636","1059","0","60.06","27.95"
"10","005","00","050","0032","0384","660","317","343","6","666","1100","0","60.55","28.82"
"10","005","00","050","0032","0385","727","331","396","17","744","1247","0","59.66","26.54"
"10","005","00","050","0033","0000","1539","699","840","46","1585","2771","0","57.20","25.23"
"10","005","00","050","0033","0386","803","338","465","28","831","1409","0","58.98","23.99"
"10","005","00","050","0033","0387","736","361","375","18","754","1362","0","55.36","26.51"
"10","005","00","060","0000","0000","17650","9364","8286","1856","19506","29296","34426","66.58","31.96"
"10","005","00","060","0001","0000","857","450","407","72","929","1347","0","68.97","33.41"
"10","005","00","060","0001","0229","344","176","168","38","382","548","0","69.71","32.12"
"10","005","00","060","0001","0230","513","274","239","34","547","799","0","68.46","34.29"
"10","005","00","060","0002","0000","471","267","204","46","517","699","0","73.96","38.20"
"10","005","00","060","0002","0231","471","267","204","46","517","699","0","73.96","38.20"
"10","005","00","060","0003","0000","787","440","347","50","837","1207","0","69.35","36.45"
"10","005","00","060","0003","0232","383","220","163","24","407","587","0","69.34","37.48"
"10","005","00","060","0003","0233","404","220","184","26","430","620","0","69.35","35.48"
"10","005","00","060","0004","0000","2485","1246","1239","162","2647","4150","0","63.78","30.02"
"10","005","00","060","0004","0234","646","356","290","39","685","1099","0","62.33","32.39"
"10","005","00","060","0004","0235","760","393","367","46","806","1246","0","64.69","31.54"
"10","005","00","060","0004","0236","591","271","320","32","623","959","0","64.96","28.26"
"10","005","00","060","0004","0237","488","226","262","45","533","846","0","63.00","26.71"
"10","005","00","060","0005","0000","1443","746","697","168","1611","2163","0","74.48","34.49"
"10","005","00","060","0005","0252","707","352","355","76","783","1029","0","76.09","34.21"
"10","005","00","060","0005","0253","736","394","342","92","828","1134","0","73.02","34.74"
"10","005","00","060","0006","0000","743","300","443","44","787","1184","0","66.47","25.34"
"10","005","00","060","0006","0242","743","300","443","44","787","1184","0","66.47","25.34"
"10","005","00","060","0007","0000","700","311","389","43","743","1184","0","62.75","26.27"
"10","005","00","060","0007","0243","700","311","389","43","743","1184","0","62.75","26.27"
"10","005","00","060","0008","0000","1600","849","751","210","1810","2564","0","70.59","33.11"
"10","005","00","060","0008","0244","567","302","265","90","657","892","0","73.65","33.86"
"10","005","00","060","0008","0245","526","298","228","48","574","858","0","66.90","34.73"
"10","005","00","060","0008","0246","507","249","258","72","579","814","0","71.13","30.59"
"10","005","00","060","0009","0000","794","401","393","85","879","1241","0","70.83","32.31"
"10","005","00","060","0009","0247","426","208","218","56","482","643","0","74.96","32.35"
"10","005","00","060","0009","0248","368","193","175","29","397","598","0","66.39","32.27"
"10","005","00","060","0010","0000","450","244","206","28","478","661","0","72.31","36.91"
"10","005","00","060","0010","0249","450","244","206","28","478","661","0","72.31","36.91"
"10","005","00","060","0011","0000","773","435","338","112","885","1402","0","63.12","31.03"
"10","005","00","060","0011","0238","347","207","140","50","397","638","0","62.23","32.45"
"10","005","00","060","0011","0239","426","228","198","62","488","764","0","63.87","29.84"
"10","005","00","060","0012","0000","724","386","338","78","802","1423","0","56.36","27.13"
"10","005","00","060","0012","0250","429","242","187","62","491","695","0","70.65","34.82"
"10","005","00","060","0012","0251","295","144","151","16","311","728","0","42.72","19.78"
"10","005","00","060","0013","0000","643","382","261","98","741","1161","0","63.82","32.90"
"10","005","00","060","0013","0240","643","382","261","98","741","1161","0","63.82","32.90"
"10","005","00","060","0014","0000","590","359","231","63","653","937","0","69.69","38.31"
"10","005","00","060","0014","0241","590","359","231","63","653","937","0","69.69","38.31"
"10","005","00","060","0015","0000","577","287","290","97","674","946","0","71.25","30.34"
"10","005","00","060","0015","0254","577","287","290","97","674","946","0","71.25","30.34"
"10","005","00","060","0016","0000","437","269","168","29","466","866","0","53.81","31.06"
"10","005","00","060","0016","0255","437","269","168","29","466","866","0","53.81","31.06"
"10","005","00","060","0017","0000","411","236","175","68","479","642","0","74.61","36.76"
"10","005","00","060","0017","0256","411","236","175","68","479","642","0","74.61","36.76"
"10","005","00","060","0018","0000","641","353","288","95","736","985","0","74.72","35.84"
"10","005","00","060","0018","0257","641","353","288","95","736","985","0","74.72","35.84"
"10","005","00","060","0019","0000","358","196","162","38","396","544","0","72.79","36.03"
"10","005","00","060","0019","0258","358","196","162","38","396","544","0","72.79","36.03"
"10","005","00","060","0020","0000","646","387","259","68","714","1218","0","58.62","31.77"
"10","005","00","060","0020","0259","646","387","259","68","714","1218","0","58.62","31.77"
"10","005","00","060","0021","0000","378","209","169","39","417","679","0","61.41","30.78"
"10","005","00","060","0021","0260","378","209","169","39","417","679","0","61.41","30.78"
"10","005","00","060","0022","0000","417","229","188","57","474","949","0","49.95","24.13"
"10","005","00","060","0022","0261","168","91","77","48","216","371","0","58.22","24.53"
"10","005","00","060","0022","0262","249","138","111","9","258","578","0","44.64","23.88"
"10","005","00","060","0023","0000","725","382","343","106","831","1144","0","72.64","33.39"
"10","005","00","060","0023","0263","409","207","202","73","482","689","0","69.96","30.04"
"10","005","00","060","0023","0264","316","175","141","33","349","455","0","76.70","38.46"
"10","005","00","070","0000","0000","8403","4315","4088","833","9236","13598","15544","67.92","31.73"
"10","005","00","070","0001","0000","456","229","227","30","486","660","0","73.64","34.70"
"10","005","00","070","0001","0459","456","229","227","30","486","660","0","73.64","34.70"
"10","005","00","070","0002","0000","871","431","440","107","978","1413","0","69.21","30.50"
"10","005","00","070","0002","0460","451","210","241","55","506","732","0","69.13","28.69"
"10","005","00","070","0002","0461","420","221","199","52","472","681","0","69.31","32.45"
"10","005","00","070","0003","0000","1138","601","537","120","1258","1911","0","65.83","31.45"
"10","005","00","070","0003","0465","488","264","224","37","525","804","0","65.30","32.84"
"10","005","00","070","0003","0466","443","241","202","69","512","758","0","67.55","31.79"
"10","005","00","070","0003","0467","207","96","111","14","221","349","0","63.32","27.51"
"10","005","00","070","0004","0000","558","297","261","71","629","878","0","71.64","33.83"
"10","005","00","070","0004","0462","558","297","261","71","629","878","0","71.64","33.83"
"10","005","00","070","0005","0000","482","218","264","41","523","735","0","71.16","29.66"
"10","005","00","070","0005","0463","434","197","237","37","471","649","0","72.57","30.35"
"10","005","00","070","0005","0473","48","21","27","4","52","86","0","60.47","24.42"
"10","005","00","070","0006","0000","523","256","267","48","571","894","0","63.87","28.64"
"10","005","00","070","0006","0474","523","256","267","48","571","894","0","63.87","28.64"
"10","005","00","070","0007","0000","1130","580","550","106","1236","1806","0","68.44","32.12"
"10","005","00","070","0007","0456","534","291","243","63","597","878","0","68.00","33.14"
"10","005","00","070","0007","0457","596","289","307","43","639","928","0","68.86","31.14"
"10","005","00","070","0008","0000","635","325","310","51","686","1010","0","67.92","32.18"
"10","005","00","070","0008","0458","635","325","310","51","686","1010","0","67.92","32.18"
"10","005","00","070","0009","0000","1207","644","563","156","1363","1981","0","68.80","32.51"
"10","005","00","070","0009","0468","376","193","183","51","427","628","0","67.99","30.73"
"10","005","00","070","0009","0469","443","251","192","53","496","712","0","69.66","35.25"
"10","005","00","070","0009","0470","388","200","188","52","440","641","0","68.64","31.20"
"10","005","00","070","0010","0000","433","221","212","36","469","675","0","69.48","32.74"
"10","005","00","070","0010","0464","433","221","212","36","469","675","0","69.48","32.74"
"10","005","00","070","0011","0000","970","513","457","67","1037","1635","0","63.43","31.38"
"10","005","00","070","0011","0471","645","352","293","52","697","1029","0","67.74","34.21"
"10","005","00","070","0011","0472","325","161","164","15","340","606","0","56.11","26.57"
"10","005","00","080","0000","0000","7249","3296","3953","716","7965","11566","13277","68.87","28.50"
"10","005","00","080","0001","0000","1066","455","611","82","1148","1511","0","75.98","30.11"
"10","005","00","080","0001","0434","485","188","297","32","517","684","0","75.58","27.49"
"10","005","00","080","0001","0435","581","267","314","50","631","827","0","76.30","32.29"
"10","005","00","080","0002","0000","382","154","228","27","409","526","0","77.76","29.28"
"10","005","00","080","0002","0436","382","154","228","27","409","526","0","77.76","29.28"
"10","005","00","080","0003","0000","962","405","557","77","1039","1655","0","62.78","24.47"
"10","005","00","080","0003","0438","493","224","269","60","553","822","0","67.27","27.25"
"10","005","00","080","0003","0439","469","181","288","17","486","833","0","58.34","21.73"
"10","005","00","080","0004","0000","744","338","406","98","842","1269","0","66.35","26.64"
"10","005","00","080","0004","0440","744","338","406","98","842","1269","0","66.35","26.64"
"10","005","00","080","0005","0000","315","149","166","49","364","488","0","74.59","30.53"
"10","005","00","080","0005","0441","315","149","166","49","364","488","0","74.59","30.53"
"10","005","00","080","0006","0000","726","315","411","89","815","1127","0","72.32","27.95"
"10","005","00","080","0006","0437","726","315","411","89","815","1127","0","72.32","27.95"
"10","005","00","080","0007","0000","335","157","178","52","387","575","0","67.30","27.30"
"10","005","00","080","0007","0442","335","157","178","52","387","575","0","67.30","27.30"
"10","005","00","080","0008","0000","842","396","446","71","913","1372","0","66.55","28.86"
"10","005","00","080","0008","0445","329","153","176","59","388","577","0","67.24","26.52"
"10","005","00","080","0008","0446","513","243","270","12","525","795","0","66.04","30.57"
"10","005","00","080","0009","0000","329","179","150","18","347","687","0","50.51","26.06"
"10","005","00","080","0009","0443","329","179","150","18","347","687","0","50.51","26.06"
"10","005","00","080","0010","0000","261","119","142","25","286","459","0","62.31","25.93"
"10","005","00","080","0010","0444","261","119","142","25","286","459","0","62.31","25.93"
"10","005","00","080","0011","0000","586","269","317","61","647","949","0","68.18","28.35"
"10","005","00","080","0011","0447","586","269","317","61","647","949","0","68.18","28.35"
"10","005","00","080","0012","0000","701","360","341","67","768","948","0","81.01","37.97"
"10","005","00","080","0012","0448","701","360","341","67","768","948","0","81.01","37.97"
"10","005","00","090","0000","0000","16187","6856","9331","975","17162","26760","31502","64.13","25.62"
"10","005","00","090","0001","0000","992","419","573","51","1043","1460","0","71.44","28.70"
"10","005","00","090","0001","0070","484","227","257","17","501","708","0","70.76","32.06"
"10","005","00","090","0001","0071","508","192","316","34","542","752","0","72.07","25.53"
"10","005","00","090","0002","0000","1366","562","804","75","1441","2258","0","63.82","24.89"
"10","005","00","090","0002","0072","643","259","384","42","685","1050","0","65.24","24.67"
"10","005","00","090","0002","0073","723","303","420","33","756","1208","0","62.58","25.08"
"10","005","00","090","0003","0000","1990","869","1121","95","2085","3306","0","63.07","26.29"
"10","005","00","090","0003","0074","683","286","397","34","717","1114","0","64.36","25.67"
"10","005","00","090","0003","0075","642","276","366","31","673","1127","0","59.72","24.49"
"10","005","00","090","0003","0076","665","307","358","30","695","1065","0","65.26","28.83"
"10","005","00","090","0004","0000","524","240","284","46","570","895","0","63.69","26.82"
"10","005","00","090","0004","0081","524","240","284","46","570","895","0","63.69","26.82"
"10","005","00","090","0005","0000","1326","569","757","94","1420","2163","0","65.65","26.31"
"10","005","00","090","0005","0077","682","273","409","59","741","1127","0","65.75","24.22"
"10","005","00","090","0005","0078","644","296","348","35","679","1036","0","65.54","28.57"
"10","005","00","090","0006","0000","1374","567","807","50","1424","2278","0","62.51","24.89"
"10","005","00","090","0006","0079","746","314","432","25","771","1259","0","61.24","24.94"
"10","005","00","090","0006","0080","628","253","375","25","653","1019","0","64.08","24.83"
"10","005","00","090","0007","0000","781","340","441","46","827","1384","0","59.75","24.57"
"10","005","00","090","0007","0086","373","179","194","25","398","651","0","61.14","27.50"
"10","005","00","090","0007","0087","408","161","247","21","429","733","0","58.53","21.96"
"10","005","00","090","0008","0000","506","202","304","22","528","943","0","55.99","21.42"
"10","005","00","090","0008","0082","506","202","304","22","528","943","0","55.99","21.42"
"10","005","00","090","0009","0000","1113","476","637","65","1178","1960","0","60.10","24.29"
"10","005","00","090","0009","0084","499","205","294","21","520","788","0","65.99","26.02"
"10","005","00","090","0009","0085","614","271","343","44","658","1172","0","56.14","23.12"
"10","005","00","090","0010","0000","137","60","77","29","166","259","0","64.09","23.17"
"10","005","00","090","0010","0088","137","60","77","29","166","259","0","64.09","23.17"
"10","005","00","090","0011","0000","188","82","106","21","209","325","0","64.31","25.23"
"10","005","00","090","0011","0083","188","82","106","21","209","325","0","64.31","25.23"
"10","005","00","090","0012","0000","1335","578","757","86","1421","2144","0","66.28","26.96"
"10","005","00","090","0012","0089","805","357","448","44","849","1265","0","67.11","28.22"
"10","005","00","090","0012","0090","530","221","309","42","572","879","0","65.07","25.14"
"10","005","00","090","0013","0000","847","370","477","52","899","1395","0","64.44","26.52"
"10","005","00","090","0013","0091","466","202","264","32","498","701","0","71.04","28.82"
"10","005","00","090","0013","0092","381","168","213","20","401","694","0","57.78","24.21"
"10","005","00","090","0014","0000","957","376","581","73","1030","1523","0","67.63","24.69"
"10","005","00","090","0014","0093","517","200","317","34","551","847","0","65.05","23.61"
"10","005","00","090","0014","0094","440","176","264","39","479","676","0","70.86","26.04"
"10","005","00","090","0015","0000","769","304","465","48","817","1371","0","59.59","22.17"
"10","005","00","090","0015","0095","367","130","237","27","394","639","0","61.66","20.34"
"10","005","00","090","0015","0096","402","174","228","21","423","732","0","57.79","23.77"
"10","005","00","090","0016","0000","781","330","451","46","827","1253","0","66.00","26.34"
"10","005","00","090","0016","0099","781","330","451","46","827","1253","0","66.00","26.34"
"10","005","00","090","0017","0000","845","361","484","58","903","1338","0","67.49","26.98"
"10","005","00","090","0017","0097","405","171","234","24","429","657","0","65.30","26.03"
"10","005","00","090","0017","0098","440","190","250","34","474","681","0","69.60","27.90"
"10","005","00","090","0018","0000","161","71","90","12","173","197","0","87.82","36.04"
"10","005","00","090","0018","0100","161","71","90","12","173","197","0","87.82","36.04"
"10","005","00","090","0019","0000","195","80","115","6","201","308","0","65.26","25.97"
"10","005","00","090","0019","0101","195","80","115","6","201","308","0","65.26","25.97"
"10","005","00","100","0000","0000","8969","3756","5213","525","9494","14380","16721","66.02","26.12"
"10","005","00","100","0001","0000","560","196","364","24","584","932","0","62.66","21.03"
"10","005","00","100","0001","0120","560","196","364","24","584","932","0","62.66","21.03"
"10","005","00","100","0002","0000","2553","1058","1495","123","2676","4166","0","64.23","25.40"
"10","005","00","100","0002","0114","501","196","305","10","511","818","0","62.47","23.96"
"10","005","00","100","0002","0115","627","262","365","34","661","988","0","66.90","26.52"
"10","005","00","100","0002","0116","793","323","470","48","841","1231","0","68.32","26.24"
"10","005","00","100","0002","0117","632","277","355","31","663","1129","0","58.72","24.53"
"10","005","00","100","0003","0000","1013","421","592","50","1063","1573","0","67.58","26.76"
"10","005","00","100","0003","0121","600","238","362","33","633","902","0","70.18","26.39"
"10","005","00","100","0003","0122","413","183","230","17","430","671","0","64.08","27.27"
"10","005","00","100","0004","0000","854","372","482","74","928","1196","0","77.59","31.10"
"10","005","00","100","0004","0118","854","372","482","74","928","1196","0","77.59","31.10"
"10","005","00","100","0005","0000","589","238","351","32","621","1082","0","57.39","22.00"
"10","005","00","100","0005","0119","589","238","351","32","621","1082","0","57.39","22.00"
"10","005","00","100","0006","0000","624","242","382","42","666","987","0","67.48","24.52"
"10","005","00","100","0006","0123","624","242","382","42","666","987","0","67.48","24.52"
"10","005","00","100","0007","0000","1752","788","964","88","1840","3015","0","61.03","26.14"
"10","005","00","100","0007","0124","617","286","331","33","650","1031","0","63.05","27.74"
"10","005","00","100","0007","0125","459","196","263","23","482","801","0","60.17","24.47"
"10","005","00","100","0007","0126","676","306","370","32","708","1183","0","59.85","25.87"
"10","005","00","100","0008","0000","343","154","189","42","385","515","0","74.76","29.90"
"10","005","00","100","0008","0127","343","154","189","42","385","515","0","74.76","29.90"
"10","005","00","100","0009","0000","295","118","177","25","320","405","0","79.01","29.14"
"10","005","00","100","0009","0128","295","118","177","25","320","405","0","79.01","29.14"
"10","005","00","100","0010","0000","386","169","217","25","411","509","0","80.75","33.20"
"10","005","00","100","0010","0129","386","169","217","25","411","509","0","80.75","33.20"
"10","005","00","110","0000","0000","4774","2021","2753","581","5355","7932","9068","67.51","25.48"
"10","005","00","110","0001","0000","626","266","360","88","714","1060","0","67.36","25.09"
"10","005","00","110","0001","0425","626","266","360","88","714","1060","0","67.36","25.09"
"10","005","00","110","0002","0000","387","192","195","44","431","585","0","73.68","32.82"
"10","005","00","110","0002","0426","387","192","195","44","431","585","0","73.68","32.82"
"10","005","00","110","0003","0000","676","275","401","69","745","1204","0","61.88","22.84"
"10","005","00","110","0003","0427","676","275","401","69","745","1204","0","61.88","22.84"
"10","005","00","110","0004","0000","441","206","235","66","507","749","0","67.69","27.50"
"10","005","00","110","0004","0428","441","206","235","66","507","749","0","67.69","27.50"
"10","005","00","110","0005","0000","399","184","215","62","461","731","0","63.06","25.17"
"10","005","00","110","0005","0429","399","184","215","62","461","731","0","63.06","25.17"
"10","005","00","110","0006","0000","675","258","417","68","743","1004","0","74.00","25.70"
"10","005","00","110","0006","0430","675","258","417","68","743","1004","0","74.00","25.70"
"10","005","00","110","0007","0000","614","244","370","79","693","937","0","73.96","26.04"
"10","005","00","110","0007","0431","614","244","370","79","693","937","0","73.96","26.04"
"10","005","00","110","0008","0000","461","194","267","34","495","802","0","61.72","24.19"
"10","005","00","110","0008","0432","461","194","267","34","495","802","0","61.72","24.19"
"10","005","00","110","0009","0000","495","202","293","71","566","860","0","65.81","23.49"
"10","005","00","110","0009","0433","495","202","293","71","566","860","0","65.81","23.49"
"10","005","00","120","0000","0000","6147","2546","3601","387","6534","8761","9965","74.58","29.06"
"10","005","00","120","0001","0000","1637","642","995","90","1727","2403","0","71.87","26.72"
"10","005","00","120","0001","0102","871","352","519","42","913","1265","0","72.17","27.83"
"10","005","00","120","0001","0103","766","290","476","48","814","1138","0","71.53","25.48"
"10","005","00","120","0002","0000","1160","494","666","65","1225","1722","0","71.14","28.69"
"10","005","00","120","0002","0109","516","206","310","29","545","781","0","69.78","26.38"
"10","005","00","120","0002","0110","644","288","356","36","680","941","0","72.26","30.61"
"10","005","00","120","0003","0000","468","194","274","30","498","662","0","75.23","29.31"
"10","005","00","120","0003","0106","468","194","274","30","498","662","0","75.23","29.31"
"10","005","00","120","0004","0000","1101","458","643","63","1164","1576","0","73.86","29.06"
"10","005","00","120","0004","0104","494","191","303","31","525","730","0","71.92","26.16"
"10","005","00","120","0004","0105","607","267","340","32","639","846","0","75.53","31.56"
"10","005","00","120","0005","0000","601","258","343","39","640","825","0","77.58","31.27"
"10","005","00","120","0005","0107","601","258","343","39","640","825","0","77.58","31.27"
"10","005","00","120","0006","0000","290","123","167","21","311","372","0","83.60","33.06"
"10","005","00","120","0006","0108","290","123","167","21","311","372","0","83.60","33.06"
"10","005","00","120","0007","0000","640","259","381","63","703","896","0","78.46","28.91"
"10","005","00","120","0007","0111","503","195","308","48","551","703","0","78.38","27.74"
"10","005","00","120","0007","0112","137","64","73","15","152","193","0","78.76","33.16"
"10","005","00","120","0008","0000","250","118","132","16","266","305","0","87.21","38.69"
"10","005","00","120","0008","0113","250","118","132","16","266","305","0","87.21","38.69"
"10","005","00","130","0000","0000","7794","3388","4406","662","8456","12898","15179","65.56","26.27"
"10","005","00","130","0001","0000","2078","857","1221","143","2221","3744","0","59.32","22.89"
"10","005","00","130","0001","0130","422","193","229","47","469","766","0","61.23","25.20"
"10","005","00","130","0001","0131","511","212","299","14","525","876","0","59.93","24.20"
"10","005","00","130","0001","0132","571","224","347","47","618","980","0","63.06","22.86"
"10","005","00","130","0001","0133","574","228","346","35","609","1122","0","54.28","20.32"
"10","005","00","130","0002","0000","1059","471","588","87","1146","1749","0","65.52","26.93"
"10","005","00","130","0002","0139","556","254","302","63","619","946","0","65.43","26.85"
"10","005","00","130","0002","0140","503","217","286","24","527","803","0","65.63","27.02"
"10","005","00","130","0003","0000","761","345","416","58","819","1252","0","65.42","27.56"
"10","005","00","130","0003","0137","367","173","194","26","393","564","0","69.68","30.67"
"10","005","00","130","0003","0138","394","172","222","32","426","688","0","61.92","25.00"
"10","005","00","130","0004","0000","1906","835","1071","191","2097","3154","0","66.49","26.47"
"10","005","00","130","0004","0134","596","246","350","76","672","947","0","70.96","25.98"
"10","005","00","130","0004","0135","605","275","330","55","660","1076","0","61.34","25.56"
"10","005","00","130","0004","0136","705","314","391","60","765","1131","0","67.64","27.76"
"10","005","00","130","0005","0000","1018","396","622","69","1087","1372","0","79.23","28.86"
"10","005","00","130","0005","0141","494","198","296","35","529","665","0","79.55","29.77"
"10","005","00","130","0005","0142","524","198","326","34","558","707","0","78.93","28.01"
"10","005","00","130","0006","0000","301","112","189","26","327","394","0","82.99","28.43"
"10","005","00","130","0006","0143","301","112","189","26","327","394","0","82.99","28.43"
"10","005","00","130","0007","0000","671","372","299","88","759","1233","0","61.56","30.17"
"10","005","00","130","0007","0144","362","208","154","68","430","615","0","69.92","33.82"
"10","005","00","130","0007","0145","309","164","145","20","329","618","0","53.24","26.54"
"10","005","00","140","0000","0000","3767","1533","2234","364","4131","5895","6471","70.08","26.01"
"10","005","00","140","0001","0000","345","114","231","32","377","573","0","65.79","19.90"
"10","005","00","140","0001","0146","345","114","231","32","377","573","0","65.79","19.90"
"10","005","00","140","0002","0000","330","131","199","34","364","531","0","68.55","24.67"
"10","005","00","140","0002","0147","330","131","199","34","364","531","0","68.55","24.67"
"10","005","00","140","0003","0000","473","175","298","47","520","754","0","68.97","23.21"
"10","005","00","140","0003","0148","473","175","298","47","520","754","0","68.97","23.21"
"10","005","00","140","0004","0000","272","120","152","4","276","592","0","46.62","20.27"
"10","005","00","140","0004","0149","272","120","152","4","276","592","0","46.62","20.27"
"10","005","00","140","0005","0000","344","125","219","33","377","464","0","81.25","26.94"
"10","005","00","140","0005","0152","344","125","219","33","377","464","0","81.25","26.94"
"10","005","00","140","0006","0000","289","126","163","28","317","433","0","73.21","29.10"
"10","005","00","140","0006","0151","289","126","163","28","317","433","0","73.21","29.10"
"10","005","00","140","0007","0000","573","245","328","52","625","841","0","74.32","29.13"
"10","005","00","140","0007","0150","573","245","328","52","625","841","0","74.32","29.13"
"10","005","00","140","0008","0000","705","297","408","81","786","1087","0","72.31","27.32"
"10","005","00","140","0008","0153","705","297","408","81","786","1087","0","72.31","27.32"
"10","005","00","140","0009","0000","436","200","236","53","489","620","0","78.87","32.26"
"10","005","00","140","0009","0154","436","200","236","53","489","620","0","78.87","32.26"
"10","005","00","150","0000","0000","6609","2983","3626","569","7178","10269","11734","69.90","29.05"
"10","005","00","150","0001","0000","1171","470","701","88","1259","1912","0","65.85","24.58"
"10","005","00","150","0001","0265","665","276","389","50","715","1092","0","65.48","25.27"
"10","005","00","150","0001","0266","506","194","312","38","544","820","0","66.34","23.66"
"10","005","00","150","0002","0000","239","92","147","21","260","409","0","63.57","22.49"
"10","005","00","150","0002","0267","239","92","147","21","260","409","0","63.57","22.49"
"10","005","00","150","0003","0000","594","245","349","42","636","923","0","68.91","26.54"
"10","005","00","150","0003","0268","594","245","349","42","636","923","0","68.91","26.54"
"10","005","00","150","0004","0000","2080","932","1148","166","2246","3189","0","70.43","29.23"
"10","005","00","150","0004","0269","724","304","420","58","782","1123","0","69.63","27.07"
"10","005","00","150","0004","0270","659","302","357","60","719","1000","0","71.90","30.20"
"10","005","00","150","0004","0271","697","326","371","48","745","1066","0","69.89","30.58"
"10","005","00","150","0005","0000","315","134","181","24","339","452","0","75.00","29.65"
"10","005","00","150","0005","0272","315","134","181","24","339","452","0","75.00","29.65"
"10","005","00","150","0006","0000","323","128","195","28","351","450","0","78.00","28.44"
"10","005","00","150","0006","0273","323","128","195","28","351","450","0","78.00","28.44"
"10","005","00","150","0007","0000","816","425","391","77","893","1196","0","74.67","35.54"
"10","005","00","150","0007","0274","816","425","391","77","893","1196","0","74.67","35.54"
"10","005","00","150","0008","0000","488","224","264","38","526","838","0","62.77","26.73"
"10","005","00","150","0008","0275","488","224","264","38","526","838","0","62.77","26.73"
"10","005","00","150","0009","0000","583","333","250","85","668","900","0","74.22","37.00"
"10","005","00","150","0009","0276","583","333","250","85","668","900","0","74.22","37.00"
"10","005","00","160","0000","0000","3657","1494","2163","314","3971","5462","6199","72.70","27.35"
"10","005","00","160","0001","0000","1364","551","813","72","1436","2097","0","68.48","26.28"
"10","005","00","160","0001","0416","576","225","351","28","604","929","0","65.02","24.22"
"10","005","00","160","0001","0417","788","326","462","44","832","1168","0","71.23","27.91"
"10","005","00","160","0002","0000","415","172","243","26","441","595","0","74.12","28.91"
"10","005","00","160","0002","0418","415","172","243","26","441","595","0","74.12","28.91"
"10","005","00","160","0003","0000","550","209","341","63","613","788","0","77.79","26.52"
"10","005","00","160","0003","0419","550","209","341","63","613","788","0","77.79","26.52"
"10","005","00","160","0004","0000","133","53","80","18","151","211","0","71.56","25.12"
"10","005","00","160","0004","0420","133","53","80","18","151","211","0","71.56","25.12"
"10","005","00","160","0005","0000","363","175","188","38","401","512","0","78.32","34.18"
"10","005","00","160","0005","0421","363","175","188","38","401","512","0","78.32","34.18"
"10","005","00","160","0006","0000","338","135","203","39","377","524","0","71.95","25.76"
"10","005","00","160","0006","0422","338","135","203","39","377","524","0","71.95","25.76"
"10","005","00","160","0007","0000","270","105","165","39","309","377","0","81.96","27.85"
"10","005","00","160","0007","0423","270","105","165","39","309","377","0","81.96","27.85"
"10","005","00","160","0008","0000","224","94","130","19","243","358","0","67.88","26.26"
"10","005","00","160","0008","0424","224","94","130","19","243","358","0","67.88","26.26"
"10","005","00","170","0000","0000","2701","1171","1530","255","2956","3792","4163","77.95","30.88"
"10","005","00","170","0001","0000","238","98","140","18","256","315","0","81.27","31.11"
"10","005","00","170","0001","0449","238","98","140","18","256","315","0","81.27","31.11"
"10","005","00","170","0002","0000","225","110","115","10","235","512","0","45.90","21.48"
"10","005","00","170","0002","0450","225","110","115","10","235","512","0","45.90","21.48"
"10","005","00","170","0003","0000","672","277","395","67","739","898","0","82.29","30.85"
"10","005","00","170","0003","0451","672","277","395","67","739","898","0","82.29","30.85"
"10","005","00","170","0004","0000","406","207","199","58","464","539","0","86.09","38.40"
"10","005","00","170","0004","0452","406","207","199","58","464","539","0","86.09","38.40"
"10","005","00","170","0005","0000","447","205","242","43","490","569","0","86.12","36.03"
"10","005","00","170","0005","0453","447","205","242","43","490","569","0","86.12","36.03"
"10","005","00","170","0006","0000","235","100","135","11","246","313","0","78.59","31.95"
"10","005","00","170","0006","0454","235","100","135","11","246","313","0","78.59","31.95"
"10","005","00","170","0007","0000","478","174","304","48","526","646","0","81.42","26.93"
"10","005","00","170","0007","0455","478","174","304","48","526","646","0","81.42","26.93"
"10","005","00","180","0000","0000","3288","1199","2089","356","3644","4901","5760","74.35","24.46"
"10","005","00","180","0001","0000","114","54","60","7","121","320","0","37.81","16.88"
"10","005","00","180","0001","0475","114","54","60","7","121","320","0","37.81","16.88"
"10","005","00","180","0002","0000","726","299","427","111","837","1038","0","80.64","28.81"
"10","005","00","180","0002","0476","300","114","186","51","351","436","0","80.50","26.15"
"10","005","00","180","0002","0477","426","185","241","60","486","602","0","80.73","30.73"
"10","005","00","180","0003","0000","550","217","333","67","617","838","0","73.63","25.89"
"10","005","00","180","0003","0478","396","169","227","54","450","540","0","83.33","31.30"
"10","005","00","180","0003","0479","154","48","106","13","167","298","0","56.04","16.11"
"10","005","00","180","0004","0000","369","98","271","32","401","483","0","83.02","20.29"
"10","005","00","180","0004","0480","369","98","271","32","401","483","0","83.02","20.29"
"10","005","00","180","0005","0000","359","162","197","43","402","502","0","80.08","32.27"
"10","005","00","180","0005","0481","359","162","197","43","402","502","0","80.08","32.27"
"10","005","00","180","0006","0000","384","152","232","45","429","482","0","89.00","31.54"
"10","005","00","180","0006","0482","384","152","232","45","429","482","0","89.00","31.54"
"10","005","00","180","0007","0000","317","91","226","9","326","648","0","50.31","14.04"
"10","005","00","180","0007","0483","317","91","226","9","326","648","0","50.31","14.04"
"10","005","00","180","0008","0000","469","126","343","42","511","590","0","86.61","21.36"
"10","005","00","180","0008","0484","469","126","343","42","511","590","0","86.61","21.36"
"10","007","00","000","0000","0000","588373","303905","284468","61168","649541","1029944","1245445","63.07","29.51"
"10","007","00","010","0000","0000","104483","52073","52410","6836","111319","183683","226380","60.60","28.35"
"10","007","00","010","0001","0000","658","302","356","46","704","1192","0","59.06","25.34"
"10","007","00","010","0001","0120","362","168","194","21","383","624","0","61.38","26.92"
"10","007","00","010","0001","0121","296","134","162","25","321","568","0","56.51","23.59"
"10","007","00","010","0002","0000","2777","1354","1423","168","2945","4843","0","60.81","27.96"
"10","007","00","010","0002","0128","597","268","329","39","636","1081","0","58.83","24.79"
"10","007","00","010","0002","0129","561","279","282","44","605","986","0","61.36","28.30"
"10","007","00","010","0002","0130","598","286","312","28","626","999","0","62.66","28.63"
"10","007","00","010","0002","0131","471","225","246","27","498","858","0","58.04","26.22"
"10","007","00","010","0002","0132","550","296","254","30","580","919","0","63.11","32.21"
"10","007","00","010","0003","0000","863","438","425","38","901","1559","0","57.79","28.09"
"10","007","00","010","0003","0115","386","190","196","9","395","732","0","53.96","25.96"
"10","007","00","010","0003","0116","477","248","229","29","506","827","0","61.19","29.99"
"10","007","00","010","0004","0000","452","233","219","17","469","698","0","67.19","33.38"
"10","007","00","010","0004","0117","452","233","219","17","469","698","0","67.19","33.38"
"10","007","00","010","0005","0000","782","393","389","49","831","1258","0","66.06","31.24"
"10","007","00","010","0005","0118","385","202","183","21","406","604","0","67.22","33.44"
"10","007","00","010","0005","0119","397","191","206","28","425","654","0","64.98","29.20"
"10","007","00","010","0006","0000","927","459","468","51","978","1634","0","59.85","28.09"
"10","007","00","010","0006","0122","495","238","257","19","514","848","0","60.61","28.07"
"10","007","00","010","0006","0123","432","221","211","32","464","786","0","59.03","28.12"
"10","007","00","010","0007","0000","2091","1051","1040","118","2209","3649","0","60.54","28.80"
"10","007","00","010","0007","0124","536","285","251","24","560","920","0","60.87","30.98"
"10","007","00","010","0007","0125","511","252","259","38","549","905","0","60.66","27.85"
"10","007","00","010","0007","0126","457","232","225","24","481","782","0","61.51","29.67"
"10","007","00","010","0007","0127","587","282","305","32","619","1042","0","59.40","27.06"
"10","007","00","010","0008","0000","2805","1440","1365","174","2979","5056","0","58.92","28.48"
"10","007","00","010","0008","0108","613","310","303","44","657","1140","0","57.63","27.19"
"10","007","00","010","0008","0109","552","280","272","37","589","896","0","65.74","31.25"
"10","007","00","010","0008","0110","522","268","254","30","552","917","0","60.20","29.23"
"10","007","00","010","0008","0111","585","301","284","35","620","1144","0","54.20","26.31"
"10","007","00","010","0008","0112","533","281","252","28","561","959","0","58.50","29.30"
"10","007","00","010","0009","0000","959","490","469","73","1032","1644","0","62.77","29.81"
"10","007","00","010","0009","0113","471","257","214","29","500","812","0","61.58","31.65"
"10","007","00","010","0009","0114","488","233","255","44","532","832","0","63.94","28.00"
"10","007","00","010","0010","0000","1009","503","506","63","1072","1847","0","58.04","27.23"
"10","007","00","010","0010","0106","517","241","276","35","552","981","0","56.27","24.57"
"10","007","00","010","0010","0107","492","262","230","28","520","866","0","60.05","30.25"
"10","007","00","010","0011","0000","489","246","243","36","525","785","0","66.88","31.34"
"10","007","00","010","0011","0105","489","246","243","36","525","785","0","66.88","31.34"
"10","007","00","010","0012","0000","777","394","383","36","813","1321","0","61.54","29.83"
"10","007","00","010","0012","0103","398","202","196","20","418","627","0","66.67","32.22"
"10","007","00","010","0012","0104","379","192","187","16","395","694","0","56.92","27.67"
"10","007","00","010","0013","0000","501","276","225","27","528","818","0","64.55","33.74"
"10","007","00","010","0013","0101","501","276","225","27","528","818","0","64.55","33.74"
"10","007","00","010","0014","0000","425","247","178","17","442","610","0","72.46","40.49"
"10","007","00","010","0014","0100","425","247","178","17","442","610","0","72.46","40.49"
"10","007","00","010","0015","0000","400","215","185","18","418","672","0","62.20","31.99"
"10","007","00","010","0015","0102","400","215","185","18","418","672","0","62.20","31.99"
"10","007","00","010","0016","0000","507","307","200","37","544","792","0","68.69","38.76"
"10","007","00","010","0016","0055","507","307","200","37","544","792","0","68.69","38.76"
"10","007","00","010","0017","0000","432","263","169","20","452","710","0","63.66","37.04"
"10","007","00","010","0017","0052","432","263","169","20","452","710","0","63.66","37.04"
"10","007","00","010","0018","0000","507","261","246","30","537","818","0","65.65","31.91"
"10","007","00","010","0018","0053","507","261","246","30","537","818","0","65.65","31.91"
"10","007","00","010","0019","0000","598","289","309","58","656","1008","0","65.08","28.67"
"10","007","00","010","0019","0054","598","289","309","58","656","1008","0","65.08","28.67"
"10","007","00","010","0020","0000","1874","949","925","101","1975","3222","0","61.30","29.45"
"10","007","00","010","0020","0057","592","339","253","38","630","991","0","63.57","34.21"
"10","007","00","010","0020","0058","710","326","384","31","741","1247","0","59.42","26.14"
"10","007","00","010","0020","0059","572","284","288","32","604","984","0","61.38","28.86"
"10","007","00","010","0021","0000","1940","920","1020","133","2073","3495","0","59.31","26.32"
"10","007","00","010","0021","0060","614","278","336","42","656","1106","0","59.31","25.14"
"10","007","00","010","0021","0061","639","313","326","48","687","1223","0","56.17","25.59"
"10","007","00","010","0021","0062","687","329","358","43","730","1166","0","62.61","28.22"
"10","007","00","010","0022","0000","658","325","333","34","692","1094","0","63.25","29.71"
"10","007","00","010","0022","0066","658","325","333","34","692","1094","0","63.25","29.71"
"10","007","00","010","0023","0000","1681","816","865","112","1793","3053","0","58.73","26.73"
"10","007","00","010","0023","0063","594","296","298","45","639","997","0","64.09","29.69"
"10","007","00","010","0023","0064","572","286","286","36","608","1041","0","58.41","27.47"
"10","007","00","010","0023","0065","515","234","281","31","546","1015","0","53.79","23.05"
"10","007","00","010","0024","0000","2144","1045","1099","117","2261","4026","0","56.16","25.96"
"10","007","00","010","0024","0067","527","260","267","29","556","964","0","57.68","26.97"
"10","007","00","010","0024","0068","574","278","296","23","597","1060","0","56.32","26.23"
"10","007","00","010","0024","0069","517","259","258","35","552","899","0","61.40","28.81"
"10","007","00","010","0024","0070","526","248","278","30","556","1103","0","50.41","22.48"
"10","007","00","010","0025","0000","595","333","262","39","634","869","0","72.96","38.32"
"10","007","00","010","0025","0056","595","333","262","39","634","869","0","72.96","38.32"
"10","007","00","010","0026","0000","1881","955","926","150","2031","3353","0","60.57","28.48"
"10","007","00","010","0026","0092","584","309","275","69","653","1128","0","57.89","27.39"
"10","007","00","010","0026","0093","621","316","305","34","655","1043","0","62.80","30.30"
"10","007","00","010","0026","0094","676","330","346","47","723","1182","0","61.17","27.92"
"10","007","00","010","0027","0000","1228","626","602","116","1344","2065","0","65.08","30.31"
"10","007","00","010","0027","0090","654","343","311","73","727","1114","0","65.26","30.79"
"10","007","00","010","0027","0091","574","283","291","43","617","951","0","64.88","29.76"
"10","007","00","010","0028","0000","1000","457","543","104","1104","1845","0","59.84","24.77"
"10","007","00","010","0028","0088","449","225","224","34","483","819","0","58.97","27.47"
"10","007","00","010","0028","0089","551","232","319","70","621","1026","0","60.53","22.61"
"10","007","00","010","0029","0000","1750","888","862","100","1850","2976","0","62.16","29.84"
"10","007","00","010","0029","0085","496","260","236","24","520","867","0","59.98","29.99"
"10","007","00","010","0029","0086","659","327","332","40","699","1067","0","65.51","30.65"
"10","007","00","010","0029","0087","595","301","294","36","631","1042","0","60.56","28.89"
"10","007","00","010","0030","0000","1783","806","977","161","1944","3143","0","61.85","25.64"
"10","007","00","010","0030","0095","613","292","321","45","658","1124","0","58.54","25.98"
"10","007","00","010","0030","0096","563","272","291","50","613","980","0","62.55","27.76"
"10","007","00","010","0030","0097","607","242","365","66","673","1039","0","64.77","23.29"
"10","007","00","010","0031","0000","2423","1209","1214","155","2578","4167","0","61.87","29.01"
"10","007","00","010","0031","0071","579","296","283","33","612","947","0","64.63","31.26"
"10","007","00","010","0031","0072","697","344","353","54","751","1166","0","64.41","29.50"
"10","007","00","010","0031","0073","597","292","305","28","625","1048","0","59.64","27.86"
"10","007","00","010","0031","0074","550","277","273","40","590","1006","0","58.65","27.53"
"10","007","00","010","0032","0000","1343","687","656","114","1457","2343","0","62.19","29.32"
"10","007","00","010","0032","0001","528","267","261","40","568","847","0","67.06","31.52"
"10","007","00","010","0032","0002","302","165","137","34","336","639","0","52.58","25.82"
"10","007","00","010","0032","0003","513","255","258","40","553","857","0","64.53","29.75"
"10","007","00","010","0033","0000","1304","651","653","37","1341","2359","0","56.85","27.60"
"10","007","00","010","0033","0098","610","328","282","21","631","1142","0","55.25","28.72"
"10","007","00","010","0033","0099","694","323","371","16","710","1217","0","58.34","26.54"
"10","007","00","010","0034","0000","799","424","375","42","841","1441","0","58.36","29.42"
"10","007","00","010","0034","0004","394","230","164","23","417","720","0","57.92","31.94"
"10","007","00","010","0034","0005","405","194","211","19","424","721","0","58.81","26.91"
"10","007","00","010","0035","0000","574","300","274","35","609","954","0","63.84","31.45"
"10","007","00","010","0035","0010","574","300","274","35","609","954","0","63.84","31.45"
"10","007","00","010","0036","0000","604","319","285","55","659","1127","0","58.47","28.31"
"10","007","00","010","0036","0011","604","319","285","55","659","1127","0","58.47","28.31"
"10","007","00","010","0037","0000","878","404","474","46","924","1722","0","53.66","23.46"
"10","007","00","010","0037","0008","370","154","216","16","386","714","0","54.06","21.57"
"10","007","00","010","0037","0009","508","250","258","30","538","1008","0","53.37","24.80"
"10","007","00","010","0038","0000","802","410","392","45","847","1371","0","61.78","29.91"
"10","007","00","010","0038","0006","399","191","208","23","422","672","0","62.80","28.42"
"10","007","00","010","0038","0007","403","219","184","22","425","699","0","60.80","31.33"
"10","007","00","010","0039","0000","4086","2030","2056","179","4265","7205","0","59.20","28.17"
"10","007","00","010","0039","0036","546","255","291","17","563","982","0","57.33","25.97"
"10","007","00","010","0039","0037","560","272","288","29","589","1045","0","56.36","26.03"
"10","007","00","010","0039","0038","653","327","326","40","693","1162","0","59.64","28.14"
"10","007","00","010","0039","0039","580","303","277","30","610","1061","0","57.49","28.56"
"10","007","00","010","0039","0040","618","292","326","24","642","1063","0","60.40","27.47"
"10","007","00","010","0039","0041","579","295","284","29","608","982","0","61.91","30.04"
"10","007","00","010","0039","0042","550","286","264","10","560","910","0","61.54","31.43"
"10","007","00","010","0040","0000","826","435","391","69","895","1418","0","63.12","30.68"
"10","007","00","010","0040","0043","416","227","189","25","441","661","0","66.72","34.34"
"10","007","00","010","0040","0044","410","208","202","44","454","757","0","59.97","27.48"
"10","007","00","010","0041","0000","2852","1414","1438","169","3021","4800","0","62.94","29.46"
"10","007","00","010","0041","0026","666","312","354","62","728","1134","0","64.20","27.51"
"10","007","00","010","0041","0027","749","386","363","36","785","1202","0","65.31","32.11"
"10","007","00","010","0041","0028","740","401","339","41","781","1258","0","62.08","31.88"
"10","007","00","010","0041","0029","697","315","382","30","727","1206","0","60.28","26.12"
"10","007","00","010","0042","0000","4212","2133","2079","203","4415","7421","0","59.49","28.74"
"10","007","00","010","0042","0030","777","411","366","37","814","1340","0","60.75","30.67"
"10","007","00","010","0042","0031","601","322","279","40","641","1024","0","62.60","31.45"
"10","007","00","010","0042","0032","749","367","382","47","796","1307","0","60.90","28.08"
"10","007","00","010","0042","0033","677","352","325","18","695","1201","0","57.87","29.31"
"10","007","00","010","0042","0034","723","340","383","37","760","1293","0","58.78","26.30"
"10","007","00","010","0042","0035","685","341","344","24","709","1256","0","56.45","27.15"
"10","007","00","010","0043","0000","1445","704","741","79","1524","2666","0","57.16","26.41"
"10","007","00","010","0043","0046","447","228","219","25","472","804","0","58.71","28.36"
"10","007","00","010","0043","0047","476","240","236","32","508","865","0","58.73","27.75"
"10","007","00","010","0043","0048","522","236","286","22","544","997","0","54.56","23.67"
"10","007","00","010","0044","0000","1516","798","718","111","1627","2714","0","59.95","29.40"
"10","007","00","010","0044","0049","529","291","238","46","575","966","0","59.52","30.12"
"10","007","00","010","0044","0050","469","254","215","30","499","838","0","59.55","30.31"
"10","007","00","010","0044","0051","518","253","265","35","553","910","0","60.77","27.80"
"10","007","00","010","0045","0000","746","383","363","54","800","1332","0","60.06","28.75"
"10","007","00","010","0045","0014","404","206","198","42","446","761","0","58.61","27.07"
"10","007","00","010","0045","0015","342","177","165","12","354","571","0","62.00","31.00"
"10","007","00","010","0046","0000","1114","501","613","59","1173","2522","0","46.51","19.87"
"10","007","00","010","0046","0016","657","279","378","31","688","1142","0","60.25","24.43"
"10","007","00","010","0046","0017","457","222","235","28","485","1380","0","35.14","16.09"
"10","007","00","010","0047","0000","4768","2294","2474","243","5011","8845","0","56.65","25.94"
"10","007","00","010","0047","0018","641","318","323","39","680","1275","0","53.33","24.94"
"10","007","00","010","0047","0019","666","327","339","34","700","1202","0","58.24","27.20"
"10","007","00","010","0047","0020","617","286","331","36","653","1145","0","57.03","24.98"
"10","007","00","010","0047","0021","666","350","316","45","711","1252","0","56.79","27.96"
"10","007","00","010","0047","0022","458","210","248","12","470","753","0","62.42","27.89"
"10","007","00","010","0047","0023","434","201","233","21","455","792","0","57.45","25.38"
"10","007","00","010","0047","0024","611","308","303","30","641","1133","0","56.58","27.18"
"10","007","00","010","0047","0025","675","294","381","26","701","1293","0","54.22","22.74"
"10","007","00","010","0048","0000","1249","573","676","57","1306","2137","0","61.11","26.81"
"10","007","00","010","0048","0012","616","292","324","24","640","1053","0","60.78","27.73"
"10","007","00","010","0048","0013","633","281","352","33","666","1084","0","61.44","25.92"
"10","007","00","010","0049","0000","514","292","222","45","559","927","0","60.30","31.50"
"10","007","00","010","0049","0045","514","292","222","45","559","927","0","60.30","31.50"
"10","007","00","010","0050","0000","1772","893","879","100","1872","3100","0","60.39","28.81"
"10","007","00","010","0050","0181","575","307","268","37","612","946","0","64.69","32.45"
"10","007","00","010","0050","0182","585","276","309","23","608","1064","0","57.14","25.94"
"10","007","00","010","0050","0183","612","310","302","40","652","1090","0","59.82","28.44"
"10","007","00","010","0051","0000","929","484","445","57","986","1601","0","61.59","30.23"
"10","007","00","010","0051","0157","443","207","236","28","471","769","0","61.25","26.92"
"10","007","00","010","0051","0158","486","277","209","29","515","832","0","61.90","33.29"
"10","007","00","010","0052","0000","1178","566","612","73","1251","1805","0","69.31","31.36"
"10","007","00","010","0052","0178","600","276","324","45","645","899","0","71.75","30.70"
"10","007","00","010","0052","0179","578","290","288","28","606","906","0","66.89","32.01"
"10","007","00","010","0053","0000","1937","1004","933","134","2071","3207","0","64.58","31.31"
"10","007","00","010","0053","0159","597","298","299","59","656","939","0","69.86","31.74"
"10","007","00","010","0053","0160","721","403","318","43","764","1134","0","67.37","35.54"
"10","007","00","010","0053","0161","619","303","316","32","651","1134","0","57.41","26.72"
"10","007","00","010","0054","0000","1617","858","759","187","1804","2854","0","63.21","30.06"
"10","007","00","010","0054","0162","509","286","223","55","564","873","0","64.60","32.76"
"10","007","00","010","0054","0163","536","273","263","63","599","1027","0","58.33","26.58"
"10","007","00","010","0054","0164","572","299","273","69","641","954","0","67.19","31.34"
"10","007","00","010","0055","0000","3617","1875","1742","351","3968","6488","0","61.16","28.90"
"10","007","00","010","0055","0172","584","297","287","74","658","1089","0","60.42","27.27"
"10","007","00","010","0055","0173","645","326","319","67","712","1207","0","58.99","27.01"
"10","007","00","010","0055","0174","633","347","286","60","693","1116","0","62.10","31.09"
"10","007","00","010","0055","0175","621","332","289","52","673","1119","0","60.14","29.67"
"10","007","00","010","0055","0176","613","316","297","62","675","1059","0","63.74","29.84"
"10","007","00","010","0055","0177","521","257","264","36","557","898","0","62.03","28.62"
"10","007","00","010","0056","0000","1187","641","546","124","1311","2327","0","56.34","27.55"
"10","007","00","010","0056","0155","620","323","297","69","689","1279","0","53.87","25.25"
"10","007","00","010","0056","0156","567","318","249","55","622","1048","0","59.35","30.34"
"10","007","00","010","0057","0000","575","310","265","51","626","1129","0","55.45","27.46"
"10","007","00","010","0057","0180","575","310","265","51","626","1129","0","55.45","27.46"
"10","007","00","010","0058","0000","1343","718","625","117","1460","2332","0","62.61","30.79"
"10","007","00","010","0058","0169","410","234","176","35","445","721","0","61.72","32.45"
"10","007","00","010","0058","0170","521","279","242","38","559","854","0","65.46","32.67"
"10","007","00","010","0058","0171","412","205","207","44","456","757","0","60.24","27.08"
"10","007","00","010","0059","0000","746","364","382","63","809","1185","0","68.27","30.72"
"10","007","00","010","0059","0137","746","364","382","63","809","1185","0","68.27","30.72"
"10","007","00","010","0060","0000","498","265","233","61","559","894","0","62.53","29.64"
"10","007","00","010","0060","0133","498","265","233","61","559","894","0","62.53","29.64"
"10","007","00","010","0061","0000","1668","802","866","116","1784","2799","0","63.74","28.65"
"10","007","00","010","0061","0134","551","259","292","37","588","888","0","66.22","29.17"
"10","007","00","010","0061","0135","551","281","270","53","604","934","0","64.67","30.09"
"10","007","00","010","0061","0136","566","262","304","26","592","977","0","60.59","26.82"
"10","007","00","010","0062","0000","4489","2168","2321","236","4725","8128","0","58.13","26.67"
"10","007","00","010","0062","0141","687","314","373","35","722","1127","0","64.06","27.86"
"10","007","00","010","0062","0142","703","344","359","32","735","1258","0","58.43","27.34"
"10","007","00","010","0062","0143","588","300","288","19","607","1156","0","52.51","25.95"
"10","007","00","010","0062","0144","634","285","349","57","691","1084","0","63.75","26.29"
"10","007","00","010","0062","0145","627","285","342","22","649","1224","0","53.02","23.28"
"10","007","00","010","0062","0146","566","300","266","38","604","1112","0","54.32","26.98"
"10","007","00","010","0062","0147","684","340","344","33","717","1167","0","61.44","29.13"
"10","007","00","010","0063","0000","1376","748","628","103","1479","2288","0","64.64","32.69"
"10","007","00","010","0063","0138","481","264","217","25","506","762","0","66.40","34.65"
"10","007","00","010","0063","0139","481","271","210","49","530","856","0","61.92","31.66"
"10","007","00","010","0063","0140","414","213","201","29","443","670","0","66.12","31.79"
"10","007","00","010","0064","0000","2143","1040","1103","121","2264","3928","0","57.64","26.48"
"10","007","00","010","0064","0151","519","243","276","28","547","918","0","59.59","26.47"
"10","007","00","010","0064","0152","511","248","263","26","537","898","0","59.80","27.62"
"10","007","00","010","0064","0153","532","264","268","35","567","1068","0","53.09","24.72"
"10","007","00","010","0064","0154","581","285","296","32","613","1044","0","58.72","27.30"
"10","007","00","010","0065","0000","1461","692","769","73","1534","2517","0","60.95","27.49"
"10","007","00","010","0065","0148","482","237","245","37","519","805","0","64.47","29.44"
"10","007","00","010","0065","0149","439","213","226","23","462","810","0","57.04","26.30"
"10","007","00","010","0065","0150","540","242","298","13","553","902","0","61.31","26.83"
"10","007","00","010","0066","0000","652","313","339","65","717","1098","0","65.30","28.51"
"10","007","00","010","0066","0188","652","313","339","65","717","1098","0","65.30","28.51"
"10","007","00","010","0067","0000","746","345","401","84","830","1215","0","68.31","28.40"
"10","007","00","010","0067","0187","746","345","401","84","830","1215","0","68.31","28.40"
"10","007","00","010","0068","0000","548","279","269","51","599","822","0","72.87","33.94"
"10","007","00","010","0068","0186","548","279","269","51","599","822","0","72.87","33.94"
"10","007","00","010","0069","0000","540","290","250","82","622","859","0","72.41","33.76"
"10","007","00","010","0069","0184","540","290","250","82","622","859","0","72.41","33.76"
"10","007","00","010","0070","0000","616","313","303","56","672","1097","0","61.26","28.53"
"10","007","00","010","0070","0185","616","313","303","56","672","1097","0","61.26","28.53"
"10","007","00","010","0071","0000","2470","1128","1342","138","2608","4217","0","61.84","26.75"
"10","007","00","010","0071","0165","592","256","336","25","617","991","0","62.26","25.83"
"10","007","00","010","0071","0166","617","299","318","46","663","1079","0","61.45","27.71"
"10","007","00","010","0071","0167","631","276","355","45","676","1071","0","63.12","25.77"
"10","007","00","010","0071","0168","630","297","333","22","652","1076","0","60.59","27.60"
"10","007","00","010","0072","0000","2958","1406","1552","174","3132","5136","0","60.98","27.38"
"10","007","00","010","0072","0075","686","337","349","43","729","1185","0","61.52","28.44"
"10","007","00","010","0072","0076","619","298","321","40","659","1041","0","63.30","28.63"
"10","007","00","010","0072","0077","555","261","294","27","582","980","0","59.39","26.63"
"10","007","00","010","0072","0078","530","236","294","29","559","937","0","59.66","25.19"
"10","007","00","010","0072","0079","568","274","294","35","603","993","0","60.73","27.59"
"10","007","00","010","0073","0000","2869","1329","1540","179","3048","5131","0","59.40","25.90"
"10","007","00","010","0073","0080","648","297","351","43","691","1132","0","61.04","26.24"
"10","007","00","010","0073","0081","490","225","265","36","526","919","0","57.24","24.48"
"10","007","00","010","0073","0082","569","272","297","44","613","970","0","63.20","28.04"
"10","007","00","010","0073","0083","559","246","313","25","584","983","0","59.41","25.03"
"10","007","00","010","0073","0084","603","289","314","31","634","1127","0","56.26","25.64"
"10","007","00","020","0000","0000","39294","21147","18147","4021","43315","68505","85339","63.23","30.87"
"10","007","00","020","0001","0000","594","366","228","63","657","1062","0","61.86","34.46"
"10","007","00","020","0001","0248","594","366","228","63","657","1062","0","61.86","34.46"
"10","007","00","020","0002","0000","281","166","115","12","293","482","0","60.79","34.44"
"10","007","00","020","0002","0249","281","166","115","12","293","482","0","60.79","34.44"
"10","007","00","020","0003","0000","466","267","199","43","509","830","0","61.33","32.17"
"10","007","00","020","0003","0250","466","267","199","43","509","830","0","61.33","32.17"
"10","007","00","020","0004","0000","585","365","220","56","641","879","0","72.92","41.52"
"10","007","00","020","0004","0251","585","365","220","56","641","879","0","72.92","41.52"
"10","007","00","020","0005","0000","1713","912","801","89","1802","2899","0","62.16","31.46"
"10","007","00","020","0005","0312","665","377","288","48","713","1129","0","63.15","33.39"
"10","007","00","020","0005","0313","510","248","262","24","534","889","0","60.07","27.90"
"10","007","00","020","0005","0314","538","287","251","17","555","881","0","63.00","32.58"
"10","007","00","020","0006","0000","2743","1480","1263","280","3023","5047","0","59.90","29.32"
"10","007","00","020","0006","0306","633","325","308","85","718","1152","0","62.33","28.21"
"10","007","00","020","0006","0307","650","332","318","81","731","1149","0","63.62","28.89"
"10","007","00","020","0006","0308","725","414","311","74","799","1286","0","62.13","32.19"
"10","007","00","020","0006","0309","735","409","326","40","775","1460","0","53.08","28.01"
"10","007","00","020","0007","0000","2713","1525","1188","184","2897","4916","0","58.93","31.02"
"10","007","00","020","0007","0252","462","265","197","23","485","951","0","51.00","27.87"
"10","007","00","020","0007","0253","625","353","272","44","669","1085","0","61.66","32.53"
"10","007","00","020","0007","0254","444","244","200","31","475","810","0","58.64","30.12"
"10","007","00","020","0007","0255","395","204","191","19","414","700","0","59.14","29.14"
"10","007","00","020","0007","0256","787","459","328","67","854","1370","0","62.34","33.50"
"10","007","00","020","0008","0000","2440","1439","1001","176","2616","4259","0","61.42","33.79"
"10","007","00","020","0008","0259","557","358","199","28","585","1003","0","58.33","35.69"
"10","007","00","020","0008","0260","635","405","230","43","678","1074","0","63.13","37.71"
"10","007","00","020","0008","0261","600","327","273","46","646","1026","0","62.96","31.87"
"10","007","00","020","0008","0262","648","349","299","59","707","1156","0","61.16","30.19"
"10","007","00","020","0009","0000","281","171","110","36","317","504","0","62.90","33.93"
"10","007","00","020","0009","0263","281","171","110","36","317","504","0","62.90","33.93"
"10","007","00","020","0010","0000","532","340","192","33","565","801","0","70.54","42.45"
"10","007","00","020","0010","0257","532","340","192","33","565","801","0","70.54","42.45"
"10","007","00","020","0011","0000","596","370","226","68","664","1099","0","60.42","33.67"
"10","007","00","020","0011","0258","596","370","226","68","664","1099","0","60.42","33.67"
"10","007","00","020","0012","0000","628","352","276","56","684","1026","0","66.67","34.31"
"10","007","00","020","0012","0268","628","352","276","56","684","1026","0","66.67","34.31"
"10","007","00","020","0013","0000","680","398","282","30","710","1099","0","64.60","36.21"
"10","007","00","020","0013","0269","680","398","282","30","710","1099","0","64.60","36.21"
"10","007","00","020","0014","0000","149","81","68","13","162","258","0","62.79","31.40"
"10","007","00","020","0014","0270","149","81","68","13","162","258","0","62.79","31.40"
"10","007","00","020","0015","0000","360","204","156","32","392","587","0","66.78","34.75"
"10","007","00","020","0015","0272","360","204","156","32","392","587","0","66.78","34.75"
"10","007","00","020","0016","0000","314","177","137","29","343","552","0","62.14","32.07"
"10","007","00","020","0016","0271","314","177","137","29","343","552","0","62.14","32.07"
"10","007","00","020","0017","0000","589","361","228","56","645","848","0","76.06","42.57"
"10","007","00","020","0017","0273","589","361","228","56","645","848","0","76.06","42.57"
"10","007","00","020","0018","0000","1306","728","578","108","1414","2109","0","67.05","34.52"
"10","007","00","020","0018","0274","648","375","273","54","702","1016","0","69.09","36.91"
"10","007","00","020","0018","0275","658","353","305","54","712","1093","0","65.14","32.30"
"10","007","00","020","0019","0000","1985","966","1019","239","2224","3720","0","59.78","25.97"
"10","007","00","020","0019","0292","424","226","198","57","481","828","0","58.09","27.29"
"10","007","00","020","0019","0293","316","147","169","54","370","628","0","58.92","23.41"
"10","007","00","020","0019","0294","578","288","290","65","643","1065","0","60.38","27.04"
"10","007","00","020","0019","0295","667","305","362","63","730","1199","0","60.88","25.44"
"10","007","00","020","0020","0000","1419","716","703","168","1587","2502","0","63.43","28.62"
"10","007","00","020","0020","0296","420","208","212","41","461","815","0","56.56","25.52"
"10","007","00","020","0020","0297","393","188","205","55","448","702","0","63.82","26.78"
"10","007","00","020","0020","0298","606","320","286","72","678","985","0","68.83","32.49"
"10","007","00","020","0021","0000","2291","1095","1196","295","2586","4017","0","64.38","27.26"
"10","007","00","020","0021","0303","797","390","407","121","918","1357","0","67.65","28.74"
"10","007","00","020","0021","0304","701","354","347","68","769","1215","0","63.29","29.14"
"10","007","00","020","0021","0305","793","351","442","106","899","1445","0","62.21","24.29"
"10","007","00","020","0022","0000","2440","1151","1289","302","2742","3946","0","69.49","29.17"
"10","007","00","020","0022","0299","549","269","280","48","597","885","0","67.46","30.40"
"10","007","00","020","0022","0300","661","301","360","96","757","1049","0","72.16","28.69"
"10","007","00","020","0022","0301","552","239","313","73","625","855","0","73.10","27.95"
"10","007","00","020","0022","0302","678","342","336","85","763","1157","0","65.95","29.56"
"10","007","00","020","0023","0000","1628","786","842","235","1863","3084","0","60.41","25.49"
"10","007","00","020","0023","0284","527","245","282","88","615","950","0","64.74","25.79"
"10","007","00","020","0023","0285","536","253","283","85","621","1008","0","61.61","25.10"
"10","007","00","020","0023","0286","565","288","277","62","627","1126","0","55.68","25.58"
"10","007","00","020","0024","0000","1196","593","603","152","1348","2143","0","62.90","27.67"
"10","007","00","020","0024","0287","648","312","336","89","737","1186","0","62.14","26.31"
"10","007","00","020","0024","0288","548","281","267","63","611","957","0","63.85","29.36"
"10","007","00","020","0025","0000","1599","893","706","261","1860","2903","0","64.07","30.76"
"10","007","00","020","0025","0289","516","313","203","58","574","998","0","57.52","31.36"
"10","007","00","020","0025","0290","567","308","259","100","667","955","0","69.84","32.25"
"10","007","00","020","0025","0291","516","272","244","103","619","950","0","65.16","28.63"
"10","007","00","020","0026","0000","1984","1044","940","232","2216","3479","0","63.70","30.01"
"10","007","00","020","0026","0278","636","350","286","55","691","1089","0","63.45","32.14"
"10","007","00","020","0026","0279","675","334","341","94","769","1185","0","64.89","28.19"
"10","007","00","020","0026","0280","673","360","313","83","756","1205","0","62.74","29.88"
"10","007","00","020","0027","0000","1077","561","516","155","1232","2021","0","60.96","27.76"
"10","007","00","020","0027","0276","699","354","345","95","794","1305","0","60.84","27.13"
"10","007","00","020","0027","0277","378","207","171","60","438","716","0","61.17","28.91"
"10","007","00","020","0028","0000","1324","714","610","200","1524","2362","0","64.52","30.23"
"10","007","00","020","0028","0281","560","279","281","80","640","930","0","68.82","30.00"
"10","007","00","020","0028","0282","364","209","155","74","438","716","0","61.17","29.19"
"10","007","00","020","0028","0283","400","226","174","46","446","716","0","62.29","31.56"
"10","007","00","020","0029","0000","2452","1327","1125","183","2635","4294","0","61.36","30.90"
"10","007","00","020","0029","0264","651","331","320","35","686","1143","0","60.02","28.96"
"10","007","00","020","0029","0265","612","341","271","48","660","1118","0","59.03","30.50"
"10","007","00","020","0029","0266","602","307","295","50","652","1045","0","62.39","29.38"
"10","007","00","020","0029","0267","587","348","239","50","637","988","0","64.47","35.22"
"10","007","00","020","0030","0000","1340","754","586","106","1446","2262","0","63.93","33.33"
"10","007","00","020","0030","0315","674","385","289","55","729","1139","0","64.00","33.80"
"10","007","00","020","0030","0316","666","369","297","51","717","1123","0","63.85","32.86"
"10","007","00","020","0031","0000","1589","845","744","129","1718","2515","0","68.31","33.60"
"10","007","00","020","0031","0310","868","472","396","61","929","1437","0","64.65","32.85"
"10","007","00","020","0031","0311","721","373","348","68","789","1078","0","73.19","34.60"
"10","007","00","030","0000","0000","39779","20295","19484","3509","43288","72856","88706","59.42","27.86"
"10","007","00","030","0001","0000","3052","1469","1583","208","3260","5913","0","55.13","24.84"
"10","007","00","030","0001","0389","650","329","321","45","695","1251","0","55.56","26.30"
"10","007","00","030","0001","0390","594","293","301","34","628","1158","0","54.23","25.30"
"10","007","00","030","0001","0391","647","305","342","58","705","1239","0","56.90","24.62"
"10","007","00","030","0001","0392","603","278","325","36","639","1167","0","54.76","23.82"
"10","007","00","030","0001","0393","558","264","294","35","593","1098","0","54.01","24.04"
"10","007","00","030","0002","0000","2258","1145","1113","165","2423","4219","0","57.43","27.14"
"10","007","00","030","0002","0394","557","299","258","31","588","1028","0","57.20","29.09"
"10","007","00","030","0002","0395","511","257","254","31","542","988","0","54.86","26.01"
"10","007","00","030","0002","0396","517","265","252","60","577","974","0","59.24","27.21"
"10","007","00","030","0002","0397","673","324","349","43","716","1229","0","58.26","26.36"
"10","007","00","030","0003","0000","242","121","121","19","261","381","0","68.50","31.76"
"10","007","00","030","0003","0398","242","121","121","19","261","381","0","68.50","31.76"
"10","007","00","030","0004","0000","935","478","457","72","1007","1782","0","56.51","26.82"
"10","007","00","030","0004","0399","430","223","207","33","463","837","0","55.32","26.64"
"10","007","00","030","0004","0400","505","255","250","39","544","945","0","57.57","26.98"
"10","007","00","030","0005","0000","1674","856","818","153","1827","3067","0","59.57","27.91"
"10","007","00","030","0005","0401","526","277","249","43","569","998","0","57.01","27.76"
"10","007","00","030","0005","0402","609","300","309","53","662","1077","0","61.47","27.86"
"10","007","00","030","0005","0403","539","279","260","57","596","992","0","60.08","28.13"
"10","007","00","030","0006","0000","1499","806","693","85","1584","2736","0","57.89","29.46"
"10","007","00","030","0006","0404","781","441","340","45","826","1402","0","58.92","31.46"
"10","007","00","030","0006","0405","718","365","353","40","758","1334","0","56.82","27.36"
"10","007","00","030","0007","0000","831","396","435","84","915","1618","0","56.55","24.47"
"10","007","00","030","0007","0406","398","190","208","40","438","787","0","55.65","24.14"
"10","007","00","030","0007","0407","433","206","227","44","477","831","0","57.40","24.79"
"10","007","00","030","0008","0000","526","277","249","58","584","811","0","72.01","34.16"
"10","007","00","030","0008","0447","526","277","249","58","584","811","0","72.01","34.16"
"10","007","00","030","0009","0000","1158","611","547","133","1291","2081","0","62.04","29.36"
"10","007","00","030","0009","0408","739","395","344","86","825","1343","0","61.43","29.41"
"10","007","00","030","0009","0409","419","216","203","47","466","738","0","63.14","29.27"
"10","007","00","030","0010","0000","1435","724","711","124","1559","2745","0","56.79","26.38"
"10","007","00","030","0010","0410","691","346","345","46","737","1414","0","52.12","24.47"
"10","007","00","030","0010","0411","744","378","366","78","822","1331","0","61.76","28.40"
"10","007","00","030","0011","0000","761","334","427","81","842","1400","0","60.14","23.86"
"10","007","00","030","0011","0412","408","180","228","41","449","763","0","58.85","23.59"
"10","007","00","030","0011","0413","353","154","199","40","393","637","0","61.70","24.18"
"10","007","00","030","0012","0000","986","489","497","100","1086","1794","0","60.54","27.26"
"10","007","00","030","0012","0414","506","249","257","42","548","946","0","57.93","26.32"
"10","007","00","030","0012","0415","480","240","240","58","538","848","0","63.44","28.30"
"10","007","00","030","0013","0000","1139","595","544","93","1232","2156","0","57.14","27.60"
"10","007","00","030","0013","0416","607","319","288","47","654","1110","0","58.92","28.74"
"10","007","00","030","0013","0417","532","276","256","46","578","1046","0","55.26","26.39"
"10","007","00","030","0014","0000","685","372","313","102","787","1264","0","62.26","29.43"
"10","007","00","030","0014","0418","685","372","313","102","787","1264","0","62.26","29.43"
"10","007","00","030","0015","0000","2903","1426","1477","210","3113","5143","0","60.53","27.73"
"10","007","00","030","0015","0419","646","321","325","42","688","1119","0","61.48","28.69"
"10","007","00","030","0015","0420","718","370","348","50","768","1253","0","61.29","29.53"
"10","007","00","030","0015","0421","684","325","359","50","734","1217","0","60.31","26.71"
"10","007","00","030","0015","0422","855","410","445","68","923","1554","0","59.40","26.38"
"10","007","00","030","0016","0000","1065","514","551","55","1120","1851","0","60.51","27.77"
"10","007","00","030","0016","0425","610","285","325","26","636","974","0","65.30","29.26"
"10","007","00","030","0016","0426","455","229","226","29","484","877","0","55.19","26.11"
"10","007","00","030","0017","0000","1420","755","665","125","1545","2560","0","60.35","29.49"
"10","007","00","030","0017","0429","724","393","331","63","787","1280","0","61.48","30.70"
"10","007","00","030","0017","0430","696","362","334","62","758","1280","0","59.22","28.28"
"10","007","00","030","0018","0000","1055","537","518","80","1135","1954","0","58.09","27.48"
"10","007","00","030","0018","0427","565","297","268","36","601","972","0","61.83","30.56"
"10","007","00","030","0018","0428","490","240","250","44","534","982","0","54.38","24.44"
"10","007","00","030","0019","0000","1755","884","871","125","1880","3328","0","56.49","26.56"
"10","007","00","030","0019","0431","590","314","276","46","636","1094","0","58.14","28.70"
"10","007","00","030","0019","0432","567","282","285","50","617","1066","0","57.88","26.45"
"10","007","00","030","0019","0433","598","288","310","29","627","1168","0","53.68","24.66"
"10","007","00","030","0020","0000","640","330","310","69","709","900","0","78.78","36.67"
"10","007","00","030","0020","0434","640","330","310","69","709","900","0","78.78","36.67"
"10","007","00","030","0021","0000","1419","700","719","129","1548","2326","0","66.55","30.09"
"10","007","00","030","0021","0435","664","338","326","56","720","1089","0","66.12","31.04"
"10","007","00","030","0021","0436","755","362","393","73","828","1237","0","66.94","29.26"
"10","007","00","030","0022","0000","1285","705","580","125","1410","2203","0","64.00","32.00"
"10","007","00","030","0022","0437","588","329","259","44","632","1034","0","61.12","31.82"
"10","007","00","030","0022","0438","697","376","321","81","778","1169","0","66.55","32.16"
"10","007","00","030","0023","0000","494","265","229","46","540","1063","0","50.80","24.93"
"10","007","00","030","0023","0439","494","265","229","46","540","1063","0","50.80","24.93"
"10","007","00","030","0024","0000","1555","762","793","151","1706","2757","0","61.88","27.64"
"10","007","00","030","0024","0440","500","230","270","59","559","878","0","63.67","26.20"
"10","007","00","030","0024","0441","505","279","226","33","538","938","0","57.36","29.74"
"10","007","00","030","0024","0442","550","253","297","59","609","941","0","64.72","26.89"
"10","007","00","030","0025","0000","2119","1030","1089","115","2234","4240","0","52.69","24.29"
"10","007","00","030","0025","0443","510","254","256","17","527","938","0","56.18","27.08"
"10","007","00","030","0025","0444","524","258","266","36","560","1037","0","54.00","24.88"
"10","007","00","030","0025","0445","593","259","334","46","639","1166","0","54.80","22.21"
"10","007","00","030","0025","0446","492","259","233","16","508","1099","0","46.22","23.57"
"10","007","00","030","0026","0000","875","456","419","101","976","1651","0","59.12","27.62"
"10","007","00","030","0026","0448","403","201","202","39","442","815","0","54.23","24.66"
"10","007","00","030","0026","0449","472","255","217","62","534","836","0","63.88","30.50"
"10","007","00","030","0027","0000","429","220","209","71","500","798","0","62.66","27.57"
"10","007","00","030","0027","0450","429","220","209","71","500","798","0","62.66","27.57"
"10","007","00","030","0028","0000","683","387","296","93","776","1161","0","66.84","33.33"
"10","007","00","030","0028","0451","683","387","296","93","776","1161","0","66.84","33.33"
"10","007","00","030","0029","0000","1023","532","491","145","1168","1932","0","60.46","27.54"
"10","007","00","030","0029","0452","558","302","256","81","639","1025","0","62.34","29.46"
"10","007","00","030","0029","0453","465","230","235","64","529","907","0","58.32","25.36"
"10","007","00","030","0030","0000","1716","974","742","173","1889","2907","0","64.98","33.51"
"10","007","00","030","0030","0454","596","344","252","62","658","978","0","67.28","35.17"
"10","007","00","030","0030","0455","578","336","242","52","630","961","0","65.56","34.96"
"10","007","00","030","0030","0456","542","294","248","59","601","968","0","62.09","30.37"
"10","007","00","030","0031","0000","802","463","339","95","897","1456","0","61.61","31.80"
"10","007","00","030","0031","0457","365","205","160","32","397","652","0","60.89","31.44"
"10","007","00","030","0031","0458","437","258","179","63","500","804","0","62.19","32.09"
"10","007","00","030","0032","0000","1360","682","678","124","1484","2659","0","55.81","25.65"
"10","007","00","030","0032","0423","673","357","316","77","750","1336","0","56.14","26.72"
"10","007","00","030","0032","0424","687","325","362","47","734","1323","0","55.48","24.57"
"10","007","00","040","0000","0000","8091","3989","4102","999","9090","13607","16315","66.80","29.32"
"10","007","00","040","0001","0000","1292","617","675","122","1414","2183","0","64.77","28.26"
"10","007","00","040","0001","0487","588","274","314","56","644","1011","0","63.70","27.10"
"10","007","00","040","0001","0488","704","343","361","66","770","1172","0","65.70","29.27"
"10","007","00","040","0002","0000","763","343","420","94","857","1202","0","71.30","28.54"
"10","007","00","040","0002","0489","763","343","420","94","857","1202","0","71.30","28.54"
"10","007","00","040","0003","0000","1360","675","685","168","1528","2221","0","68.80","30.39"
"10","007","00","040","0003","0490","675","337","338","88","763","1140","0","66.93","29.56"
"10","007","00","040","0003","0491","685","338","347","80","765","1081","0","70.77","31.27"
"10","007","00","040","0004","0000","744","400","344","115","859","1198","0","71.70","33.39"
"10","007","00","040","0004","0492","744","400","344","115","859","1198","0","71.70","33.39"
"10","007","00","040","0005","0000","709","394","315","100","809","1185","0","68.27","33.25"
"10","007","00","040","0005","0493","709","394","315","100","809","1185","0","68.27","33.25"
"10","007","00","040","0006","0000","1012","523","489","142","1154","1839","0","62.75","28.44"
"10","007","00","040","0006","0494","529","280","249","66","595","939","0","63.37","29.82"
"10","007","00","040","0006","0495","483","243","240","76","559","900","0","62.11","27.00"
"10","007","00","040","0007","0000","1442","668","774","152","1594","2467","0","64.61","27.08"
"10","007","00","040","0007","0496","702","323","379","105","807","1198","0","67.36","26.96"
"10","007","00","040","0007","0497","740","345","395","47","787","1269","0","62.02","27.19"
"10","007","00","040","0008","0000","769","369","400","106","875","1312","0","66.69","28.13"
"10","007","00","040","0008","0498","769","369","400","106","875","1312","0","66.69","28.13"
"10","007","00","050","0000","0000","17968","9187","8781","2230","20198","30740","37911","65.71","29.89"
"10","007","00","050","0001","0000","977","568","409","125","1102","1676","0","65.75","33.89"
"10","007","00","050","0001","0474","495","298","197","63","558","844","0","66.11","35.31"
"10","007","00","050","0001","0475","482","270","212","62","544","832","0","65.38","32.45"
"10","007","00","050","0002","0000","631","409","222","108","739","1124","0","65.75","36.39"
"10","007","00","050","0002","0476","631","409","222","108","739","1124","0","65.75","36.39"
"10","007","00","050","0003","0000","837","470","367","85","922","1465","0","62.94","32.08"
"10","007","00","050","0003","0481","837","470","367","85","922","1465","0","62.94","32.08"
"10","007","00","050","0004","0000","1127","622","505","152","1279","2019","0","63.35","30.81"
"10","007","00","050","0004","0465","500","276","224","73","573","871","0","65.79","31.69"
"10","007","00","050","0004","0466","627","346","281","79","706","1148","0","61.50","30.14"
"10","007","00","050","0005","0000","1192","568","624","130","1322","1921","0","68.82","29.57"
"10","007","00","050","0005","0471","667","328","339","74","741","1036","0","71.53","31.66"
"10","007","00","050","0005","0472","525","240","285","56","581","885","0","65.65","27.12"
"10","007","00","050","0006","0000","787","406","381","83","870","1218","0","71.43","33.33"
"10","007","00","050","0006","0473","787","406","381","83","870","1218","0","71.43","33.33"
"10","007","00","050","0007","0000","1073","553","520","181","1254","1772","0","70.77","31.21"
"10","007","00","050","0007","0461","567","286","281","106","673","919","0","73.23","31.12"
"10","007","00","050","0007","0462","506","267","239","75","581","853","0","68.11","31.30"
"10","007","00","050","0008","0000","1007","452","555","198","1205","1632","0","73.84","27.70"
"10","007","00","050","0008","0463","471","190","281","119","590","789","0","74.78","24.08"
"10","007","00","050","0008","0464","536","262","274","79","615","843","0","72.95","31.08"
"10","007","00","050","0009","0000","1353","661","692","180","1533","2589","0","59.21","25.53"
"10","007","00","050","0009","0467","757","371","386","112","869","1355","0","64.13","27.38"
"10","007","00","050","0009","0468","596","290","306","68","664","1234","0","53.81","23.50"
"10","007","00","050","0010","0000","2951","1435","1516","323","3274","5099","0","64.21","28.14"
"10","007","00","050","0010","0477","826","423","403","75","901","1355","0","66.49","31.22"
"10","007","00","050","0010","0478","742","345","397","98","840","1284","0","65.42","26.87"
"10","007","00","050","0010","0479","680","331","349","85","765","1166","0","65.61","28.39"
"10","007","00","050","0010","0480","703","336","367","65","768","1294","0","59.35","25.97"
"10","007","00","050","0011","0000","1419","700","719","178","1597","2418","0","66.05","28.95"
"10","007","00","050","0011","0469","639","307","332","111","750","1063","0","70.56","28.88"
"10","007","00","050","0011","0470","780","393","387","67","847","1355","0","62.51","29.00"
"10","007","00","050","0012","0000","1659","852","807","126","1785","2699","0","66.14","31.57"
"10","007","00","050","0012","0459","698","355","343","72","770","1159","0","66.44","30.63"
"10","007","00","050","0012","0460","961","497","464","54","1015","1540","0","65.91","32.27"
"10","007","00","050","0013","0000","1700","870","830","200","1900","2953","0","64.34","29.46"
"10","007","00","050","0013","0482","545","278","267","82","627","968","0","64.77","28.72"
"10","007","00","050","0013","0483","592","307","285","80","672","1000","0","67.20","30.70"
"10","007","00","050","0013","0484","563","285","278","38","601","985","0","61.02","28.93"
"10","007","00","050","0014","0000","1255","621","634","161","1416","2155","0","65.71","28.82"
"10","007","00","050","0014","0485","611","318","293","77","688","1060","0","64.91","30.00"
"10","007","00","050","0014","0486","644","303","341","84","728","1095","0","66.48","27.67"
"10","007","00","060","0000","0000","21760","11640","10120","2450","24210","38135","45450","63.48","30.52"
"10","007","00","060","0001","0000","859","496","363","99","958","1417","0","67.61","35.00"
"10","007","00","060","0001","0329","859","496","363","99","958","1417","0","67.61","35.00"
"10","007","00","060","0002","0000","655","320","335","18","673","1393","0","48.31","22.97"
"10","007","00","060","0002","0328","655","320","335","18","673","1393","0","48.31","22.97"
"10","007","00","060","0003","0000","710","366","344","106","816","1201","0","67.94","30.47"
"10","007","00","060","0003","0323","710","366","344","106","816","1201","0","67.94","30.47"
"10","007","00","060","0004","0000","756","395","361","51","807","1458","0","55.35","27.09"
"10","007","00","060","0004","0321","372","183","189","24","396","689","0","57.47","26.56"
"10","007","00","060","0004","0322","384","212","172","27","411","769","0","53.45","27.57"
"10","007","00","060","0005","0000","771","414","357","86","857","1131","0","75.77","36.60"
"10","007","00","060","0005","0320","771","414","357","86","857","1131","0","75.77","36.60"
"10","007","00","060","0006","0000","673","355","318","70","743","1226","0","60.60","28.96"
"10","007","00","060","0006","0319","673","355","318","70","743","1226","0","60.60","28.96"
"10","007","00","060","0007","0000","826","479","347","63","889","1314","0","67.66","36.45"
"10","007","00","060","0007","0317","826","479","347","63","889","1314","0","67.66","36.45"
"10","007","00","060","0008","0000","504","298","206","55","559","799","0","69.96","37.30"
"10","007","00","060","0008","0318","504","298","206","55","559","799","0","69.96","37.30"
"10","007","00","060","0009","0000","1164","617","547","105","1269","2363","0","53.70","26.11"
"10","007","00","060","0009","0324","753","391","362","81","834","1414","0","58.98","27.65"
"10","007","00","060","0009","0325","411","226","185","24","435","949","0","45.84","23.81"
"10","007","00","060","0010","0000","1489","757","732","142","1631","2551","0","63.94","29.67"
"10","007","00","060","0010","0326","722","372","350","65","787","1251","0","62.91","29.74"
"10","007","00","060","0010","0327","767","385","382","77","844","1300","0","64.92","29.62"
"10","007","00","060","0011","0000","1428","798","630","180","1608","2486","0","64.68","32.10"
"10","007","00","060","0011","0334","647","353","294","134","781","1039","0","75.17","33.97"
"10","007","00","060","0011","0335","781","445","336","46","827","1447","0","57.15","30.75"
"10","007","00","060","0012","0000","697","320","377","124","821","1135","0","72.33","28.19"
"10","007","00","060","0012","0341","697","320","377","124","821","1135","0","72.33","28.19"
"10","007","00","060","0013","0000","640","396","244","91","731","996","0","73.39","39.76"
"10","007","00","060","0013","0342","640","396","244","91","731","996","0","73.39","39.76"
"10","007","00","060","0014","0000","1202","675","527","130","1332","2110","0","63.13","31.99"
"10","007","00","060","0014","0349","598","335","263","53","651","1017","0","64.01","32.94"
"10","007","00","060","0014","0350","604","340","264","77","681","1093","0","62.31","31.11"
"10","007","00","060","0015","0000","1061","557","504","140","1201","1804","0","66.57","30.88"
"10","007","00","060","0015","0347","515","265","250","56","571","858","0","66.55","30.89"
"10","007","00","060","0015","0348","546","292","254","84","630","946","0","66.60","30.87"
"10","007","00","060","0016","0000","1189","526","663","171","1360","2219","0","61.29","23.70"
"10","007","00","060","0016","0345","505","221","284","75","580","967","0","59.98","22.85"
"10","007","00","060","0016","0346","684","305","379","96","780","1252","0","62.30","24.36"
"10","007","00","060","0017","0000","658","308","350","126","784","1198","0","65.44","25.71"
"10","007","00","060","0017","0344","658","308","350","126","784","1198","0","65.44","25.71"
"10","007","00","060","0018","0000","783","442","341","90","873","1226","0","71.21","36.05"
"10","007","00","060","0018","0343","783","442","341","90","873","1226","0","71.21","36.05"
"10","007","00","060","0019","0000","2016","1109","907","216","2232","3529","0","63.25","31.43"
"10","007","00","060","0019","0336","694","374","320","64","758","1217","0","62.28","30.73"
"10","007","00","060","0019","0337","731","393","338","87","818","1241","0","65.91","31.67"
"10","007","00","060","0019","0338","591","342","249","65","656","1071","0","61.25","31.93"
"10","007","00","060","0020","0000","1293","666","627","130","1423","2490","0","57.15","26.75"
"10","007","00","060","0020","0339","571","276","295","84","655","1108","0","59.12","24.91"
"10","007","00","060","0020","0340","722","390","332","46","768","1382","0","55.57","28.22"
"10","007","00","060","0021","0000","1318","770","548","138","1456","2270","0","64.14","33.92"
"10","007","00","060","0021","0332","537","302","235","63","600","987","0","60.79","30.60"
"10","007","00","060","0021","0333","781","468","313","75","856","1283","0","66.72","36.48"
"10","007","00","060","0022","0000","1068","576","492","119","1187","1819","0","65.26","31.67"
"10","007","00","060","0022","0330","521","293","228","49","570","840","0","67.86","34.88"
"10","007","00","060","0022","0331","547","283","264","70","617","979","0","63.02","28.91"
"10","007","00","070","0000","0000","17864","9020","8844","1599","19463","31386","38282","62.01","28.74"
"10","007","00","070","0001","0000","934","507","427","78","1012","1628","0","62.16","31.14"
"10","007","00","070","0001","0351","436","222","214","44","480","775","0","61.94","28.65"
"10","007","00","070","0001","0352","498","285","213","34","532","853","0","62.37","33.41"
"10","007","00","070","0002","0000","1179","599","580","78","1257","2000","0","62.85","29.95"
"10","007","00","070","0002","0353","613","299","314","54","667","997","0","66.90","29.99"
"10","007","00","070","0002","0354","566","300","266","24","590","1003","0","58.82","29.91"
"10","007","00","070","0003","0000","1443","721","722","121","1564","2577","0","60.69","27.98"
"10","007","00","070","0003","0355","545","269","276","57","602","941","0","63.97","28.59"
"10","007","00","070","0003","0356","428","204","224","20","448","794","0","56.42","25.69"
"10","007","00","070","0003","0357","470","248","222","44","514","842","0","61.05","29.45"
"10","007","00","070","0004","0000","964","463","501","114","1078","1777","0","60.66","26.06"
"10","007","00","070","0004","0360","500","225","275","54","554","897","0","61.76","25.08"
"10","007","00","070","0004","0361","464","238","226","60","524","880","0","59.55","27.05"
"10","007","00","070","0005","0000","811","391","420","78","889","1386","0","64.14","28.21"
"10","007","00","070","0005","0358","407","198","209","44","451","660","0","68.33","30.00"
"10","007","00","070","0005","0359","404","193","211","34","438","726","0","60.33","26.58"
"10","007","00","070","0006","0000","1982","988","994","167","2149","3712","0","57.89","26.62"
"10","007","00","070","0006","0362","455","224","231","31","486","821","0","59.20","27.28"
"10","007","00","070","0006","0363","423","197","226","42","465","842","0","55.23","23.40"
"10","007","00","070","0006","0364","518","271","247","38","556","996","0","55.82","27.21"
"10","007","00","070","0006","0365","586","296","290","56","642","1053","0","60.97","28.11"
"10","007","00","070","0007","0000","1782","945","837","176","1958","3057","0","64.05","30.91"
"10","007","00","070","0007","0366","411","226","185","43","454","720","0","63.06","31.39"
"10","007","00","070","0007","0367","564","322","242","62","626","968","0","64.67","33.26"
"10","007","00","070","0007","0368","432","225","207","40","472","741","0","63.70","30.36"
"10","007","00","070","0007","0369","375","172","203","31","406","628","0","64.65","27.39"
"10","007","00","070","0008","0000","1290","611","679","91","1381","2167","0","63.73","28.20"
"10","007","00","070","0008","0370","408","193","215","29","437","680","0","64.26","28.38"
"10","007","00","070","0008","0371","391","171","220","12","403","655","0","61.53","26.11"
"10","007","00","070","0008","0372","491","247","244","50","541","832","0","65.02","29.69"
"10","007","00","070","0009","0000","700","347","353","83","783","1425","0","54.95","24.35"
"10","007","00","070","0009","0373","331","158","173","40","371","689","0","53.85","22.93"
"10","007","00","070","0009","0374","369","189","180","43","412","736","0","55.98","25.68"
"10","007","00","070","0010","0000","2429","1172","1257","198","2627","4407","0","59.61","26.59"
"10","007","00","070","0010","0375","493","252","241","59","552","884","0","62.44","28.51"
"10","007","00","070","0010","0376","449","230","219","26","475","793","0","59.90","29.00"
"10","007","00","070","0010","0377","445","180","265","41","486","813","0","59.78","22.14"
"10","007","00","070","0010","0378","527","246","281","40","567","997","0","56.87","24.67"
"10","007","00","070","0010","0379","515","264","251","32","547","920","0","59.46","28.70"
"10","007","00","070","0011","0000","1125","570","555","65","1190","1883","0","63.20","30.27"
"10","007","00","070","0011","0380","510","260","250","35","545","818","0","66.63","31.78"
"10","007","00","070","0011","0381","615","310","305","30","645","1065","0","60.56","29.11"
"10","007","00","070","0012","0000","1043","514","529","139","1182","1610","0","73.42","31.93"
"10","007","00","070","0012","0382","548","268","280","75","623","853","0","73.04","31.42"
"10","007","00","070","0012","0383","495","246","249","64","559","757","0","73.84","32.50"
"10","007","00","070","0013","0000","974","521","453","96","1070","1672","0","64.00","31.16"
"10","007","00","070","0013","0384","463","252","211","45","508","780","0","65.13","32.31"
"10","007","00","070","0013","0385","511","269","242","51","562","892","0","63.00","30.16"
"10","007","00","070","0014","0000","1208","671","537","115","1323","2085","0","63.45","32.18"
"10","007","00","070","0014","0386","386","198","188","38","424","652","0","65.03","30.37"
"10","007","00","070","0014","0387","376","190","186","36","412","622","0","66.24","30.55"
"10","007","00","070","0014","0388","446","283","163","41","487","811","0","60.05","34.90"
"10","007","00","080","0000","0000","21303","10710","10593","2094","23397","37422","44299","62.52","28.62"
"10","007","00","080","0001","0000","1852","948","904","130","1982","3081","0","64.33","30.77"
"10","007","00","080","0001","0189","515","273","242","38","553","860","0","64.30","31.74"
"10","007","00","080","0001","0190","548","284","264","46","594","937","0","63.39","30.31"
"10","007","00","080","0001","0191","789","391","398","46","835","1284","0","65.03","30.45"
"10","007","00","080","0002","0000","1038","531","507","72","1110","1668","0","66.55","31.83"
"10","007","00","080","0002","0192","488","237","251","40","528","766","0","68.93","30.94"
"10","007","00","080","0002","0193","550","294","256","32","582","902","0","64.52","32.59"
"10","007","00","080","0003","0000","1360","694","666","153","1513","2257","0","67.04","30.75"
"10","007","00","080","0003","0194","629","354","275","71","700","1069","0","65.48","33.12"
"10","007","00","080","0003","0195","731","340","391","82","813","1188","0","68.43","28.62"
"10","007","00","080","0004","0000","675","373","302","71","746","1030","0","72.43","36.21"
"10","007","00","080","0004","0197","675","373","302","71","746","1030","0","72.43","36.21"
"10","007","00","080","0005","0000","879","456","423","89","968","1382","0","70.04","33.00"
"10","007","00","080","0005","0196","879","456","423","89","968","1382","0","70.04","33.00"
"10","007","00","080","0006","0000","1026","475","551","100","1126","1853","0","60.77","25.63"
"10","007","00","080","0006","0198","478","226","252","50","528","878","0","60.14","25.74"
"10","007","00","080","0006","0199","548","249","299","50","598","975","0","61.33","25.54"
"10","007","00","080","0007","0000","503","372","131","52","555","705","0","78.72","52.77"
"10","007","00","080","0007","0202","503","372","131","52","555","705","0","78.72","52.77"
"10","007","00","080","0008","0000","1026","525","501","85","1111","1754","0","63.34","29.93"
"10","007","00","080","0008","0200","632","309","323","55","687","1081","0","63.55","28.58"
"10","007","00","080","0008","0201","394","216","178","30","424","673","0","63.00","32.10"
"10","007","00","080","0009","0000","2502","1194","1308","233","2735","4791","0","57.09","24.92"
"10","007","00","080","0009","0211","541","257","284","56","597","1099","0","54.32","23.38"
"10","007","00","080","0009","0212","688","323","365","44","732","1276","0","57.37","25.31"
"10","007","00","080","0009","0213","644","299","345","59","703","1234","0","56.97","24.23"
"10","007","00","080","0009","0214","629","315","314","74","703","1182","0","59.48","26.65"
"10","007","00","080","0010","0000","1747","893","854","177","1924","3046","0","63.16","29.32"
"10","007","00","080","0010","0203","550","267","283","70","620","983","0","63.07","27.16"
"10","007","00","080","0010","0204","531","269","262","52","583","942","0","61.89","28.56"
"10","007","00","080","0010","0205","666","357","309","55","721","1121","0","64.32","31.85"
"10","007","00","080","0011","0000","2377","1135","1242","192","2569","4444","0","57.81","25.54"
"10","007","00","080","0011","0206","627","297","330","69","696","1094","0","63.62","27.15"
"10","007","00","080","0011","0207","504","225","279","60","564","1056","0","53.41","21.31"
"10","007","00","080","0011","0208","694","321","373","48","742","1230","0","60.33","26.10"
"10","007","00","080","0011","0209","552","292","260","15","567","1064","0","53.29","27.44"
"10","007","00","080","0012","0000","778","418","360","105","883","1288","0","68.56","32.45"
"10","007","00","080","0012","0210","778","418","360","105","883","1288","0","68.56","32.45"
"10","007","00","080","0013","0000","1640","768","872","140","1780","3165","0","56.24","24.27"
"10","007","00","080","0013","0215","548","268","280","41","589","1105","0","53.30","24.25"
"10","007","00","080","0013","0216","536","254","282","29","565","984","0","57.42","25.81"
"10","007","00","080","0013","0217","556","246","310","70","626","1076","0","58.18","22.86"
"10","007","00","080","0014","0000","518","251","267","75","593","834","0","71.10","30.10"
"10","007","00","080","0014","0218","518","251","267","75","593","834","0","71.10","30.10"
"10","007","00","080","0015","0000","507","277","230","88","595","886","0","67.16","31.26"
"10","007","00","080","0015","0219","507","277","230","88","595","886","0","67.16","31.26"
"10","007","00","080","0016","0000","1033","527","506","114","1147","1863","0","61.57","28.29"
"10","007","00","080","0016","0220","542","282","260","70","612","954","0","64.15","29.56"
"10","007","00","080","0016","0221","491","245","246","44","535","909","0","58.86","26.95"
"10","007","00","080","0017","0000","981","475","506","94","1075","1823","0","58.97","26.06"
"10","007","00","080","0017","0222","566","256","310","59","625","952","0","65.65","26.89"
"10","007","00","080","0017","0223","415","219","196","35","450","871","0","51.66","25.14"
"10","007","00","080","0018","0000","861","398","463","124","985","1552","0","63.47","25.64"
"10","007","00","080","0018","0224","494","239","255","60","554","865","0","64.05","27.63"
"10","007","00","080","0018","0225","367","159","208","64","431","687","0","62.74","23.14"
"10","007","00","090","0000","0000","11769","6262","5507","1691","13460","19419","22545","69.31","32.25"
"10","007","00","090","0001","0000","928","491","437","124","1052","1687","0","62.36","29.10"
"10","007","00","090","0001","0226","480","245","235","52","532","919","0","57.89","26.66"
"10","007","00","090","0001","0227","448","246","202","72","520","768","0","67.71","32.03"
"10","007","00","090","0002","0000","836","464","372","126","962","1296","0","74.23","35.80"
"10","007","00","090","0002","0228","386","213","173","69","455","625","0","72.80","34.08"
"10","007","00","090","0002","0229","450","251","199","57","507","671","0","75.56","37.41"
"10","007","00","090","0003","0000","1004","512","492","129","1133","1697","0","66.76","30.17"
"10","007","00","090","0003","0230","536","276","260","59","595","906","0","65.67","30.46"
"10","007","00","090","0003","0231","468","236","232","70","538","791","0","68.02","29.84"
"10","007","00","090","0004","0000","1396","696","700","187","1583","2384","0","66.40","29.19"
"10","007","00","090","0004","0233","686","323","363","69","755","1184","0","63.77","27.28"
"10","007","00","090","0004","0234","710","373","337","118","828","1200","0","69.00","31.08"
"10","007","00","090","0005","0000","1384","646","738","143","1527","2273","0","67.18","28.42"
"10","007","00","090","0005","0235","652","222","430","79","731","1152","0","63.45","19.27"
"10","007","00","090","0005","0236","732","424","308","64","796","1121","0","71.01","37.82"
"10","007","00","090","0006","0000","1057","504","553","122","1179","1577","0","74.76","31.96"
"10","007","00","090","0006","0237","674","341","333","90","764","1013","0","75.42","33.66"
"10","007","00","090","0006","0238","383","163","220","32","415","564","0","73.58","28.90"
"10","007","00","090","0007","0000","488","273","215","64","552","835","0","66.11","32.69"
"10","007","00","090","0007","0239","488","273","215","64","552","835","0","66.11","32.69"
"10","007","00","090","0008","0000","664","383","281","122","786","1098","0","71.58","34.88"
"10","007","00","090","0008","0240","664","383","281","122","786","1098","0","71.58","34.88"
"10","007","00","090","0009","0000","357","206","151","58","415","622","0","66.72","33.12"
"10","007","00","090","0009","0241","357","206","151","58","415","622","0","66.72","33.12"
"10","007","00","090","0010","0000","965","543","422","124","1089","1620","0","67.22","33.52"
"10","007","00","090","0010","0242","505","279","226","65","570","815","0","69.94","34.23"
"10","007","00","090","0010","0243","460","264","196","59","519","805","0","64.47","32.80"
"10","007","00","090","0011","0000","543","289","254","83","626","919","0","68.12","31.45"
"10","007","00","090","0011","0244","543","289","254","83","626","919","0","68.12","31.45"
"10","007","00","090","0012","0000","685","380","305","122","807","1106","0","72.97","34.36"
"10","007","00","090","0012","0245","685","380","305","122","807","1106","0","72.97","34.36"
"10","007","00","090","0013","0000","480","284","196","90","570","810","0","70.37","35.06"
"10","007","00","090","0013","0246","480","284","196","90","570","810","0","70.37","35.06"
"10","007","00","090","0014","0000","616","376","240","108","724","939","0","77.10","40.04"
"10","007","00","090","0014","0247","616","376","240","108","724","939","0","77.10","40.04"
"10","007","00","090","0015","0000","366","215","151","89","455","556","0","81.83","38.67"
"10","007","00","090","0015","0232","366","215","151","89","455","556","0","81.83","38.67"
"10","007","00","100","0000","0000","56873","28331","28542","4264","61137","98817","122195","61.87","28.67"
"10","007","00","100","0001","0000","548","265","283","44","592","998","0","59.32","26.55"
"10","007","00","100","0001","0522","548","265","283","44","592","998","0","59.32","26.55"
"10","007","00","100","0002","0000","1530","775","755","105","1635","2578","0","63.42","30.06"
"10","007","00","100","0002","0523","490","247","243","25","515","844","0","61.02","29.27"
"10","007","00","100","0002","0524","501","261","240","33","534","877","0","60.89","29.76"
"10","007","00","100","0002","0525","539","267","272","47","586","857","0","68.38","31.16"
"10","007","00","100","0003","0000","1647","801","846","79","1726","2952","0","58.47","27.13"
"10","007","00","100","0003","0546","445","226","219","26","471","791","0","59.54","28.57"
"10","007","00","100","0003","0547","623","278","345","25","648","1114","0","58.17","24.96"
"10","007","00","100","0003","0548","579","297","282","28","607","1047","0","57.98","28.37"
"10","007","00","100","0004","0000","1336","646","690","66","1402","2414","0","58.08","26.76"
"10","007","00","100","0004","0549","423","200","223","31","454","793","0","57.25","25.22"
"10","007","00","100","0004","0550","468","232","236","20","488","842","0","57.96","27.55"
"10","007","00","100","0004","0551","445","214","231","15","460","779","0","59.05","27.47"
"10","007","00","100","0005","0000","401","215","186","26","427","657","0","64.99","32.72"
"10","007","00","100","0005","0552","401","215","186","26","427","657","0","64.99","32.72"
"10","007","00","100","0006","0000","1494","736","758","100","1594","2707","0","58.88","27.19"
"10","007","00","100","0006","0553","462","240","222","20","482","823","0","58.57","29.16"
"10","007","00","100","0006","0554","471","225","246","42","513","860","0","59.65","26.16"
"10","007","00","100","0006","0555","561","271","290","38","599","1024","0","58.50","26.46"
"10","007","00","100","0007","0000","460","240","220","28","488","728","0","67.03","32.97"
"10","007","00","100","0007","0556","460","240","220","28","488","728","0","67.03","32.97"
"10","007","00","100","0008","0000","341","164","177","20","361","547","0","66.00","29.98"
"10","007","00","100","0008","0557","341","164","177","20","361","547","0","66.00","29.98"
"10","007","00","100","0009","0000","948","505","443","80","1028","1723","0","59.66","29.31"
"10","007","00","100","0009","0526","443","233","210","40","483","813","0","59.41","28.66"
"10","007","00","100","0009","0527","505","272","233","40","545","910","0","59.89","29.89"
"10","007","00","100","0010","0000","3030","1518","1512","184","3214","5458","0","58.89","27.81"
"10","007","00","100","0010","0528","577","287","290","36","613","1039","0","59.00","27.62"
"10","007","00","100","0010","0529","584","289","295","41","625","1031","0","60.62","28.03"
"10","007","00","100","0010","0530","549","295","254","33","582","1030","0","56.50","28.64"
"10","007","00","100","0010","0531","724","360","364","26","750","1277","0","58.73","28.19"
"10","007","00","100","0010","0532","596","287","309","48","644","1081","0","59.57","26.55"
"10","007","00","100","0011","0000","1387","692","695","83","1470","2366","0","62.13","29.25"
"10","007","00","100","0011","0580","664","342","322","47","711","1148","0","61.93","29.79"
"10","007","00","100","0011","0581","723","350","373","36","759","1218","0","62.32","28.74"
"10","007","00","100","0012","0000","2340","1185","1155","151","2491","3922","0","63.51","30.21"
"10","007","00","100","0012","0582","774","408","366","67","841","1296","0","64.89","31.48"
"10","007","00","100","0012","0583","581","285","296","22","603","997","0","60.48","28.59"
"10","007","00","100","0012","0584","500","255","245","26","526","783","0","67.18","32.57"
"10","007","00","100","0012","0585","485","237","248","36","521","846","0","61.58","28.01"
"10","007","00","100","0013","0000","3031","1450","1581","139","3170","5258","0","60.29","27.58"
"10","007","00","100","0013","0586","638","296","342","49","687","1132","0","60.69","26.15"
"10","007","00","100","0013","0587","721","354","367","23","744","1245","0","59.76","28.43"
"10","007","00","100","0013","0588","567","255","312","22","589","1135","0","51.89","22.47"
"10","007","00","100","0013","0589","562","269","293","23","585","872","0","67.09","30.85"
"10","007","00","100","0013","0590","543","276","267","22","565","874","0","64.65","31.58"
"10","007","00","100","0014","0000","2614","1335","1279","207","2821","4624","0","61.01","28.87"
"10","007","00","100","0014","0591","507","297","210","23","530","868","0","61.06","34.22"
"10","007","00","100","0014","0592","482","238","244","31","513","821","0","62.48","28.99"
"10","007","00","100","0014","0593","519","254","265","46","565","895","0","63.13","28.38"
"10","007","00","100","0014","0594","525","265","260","51","576","974","0","59.14","27.21"
"10","007","00","100","0014","0595","581","281","300","56","637","1066","0","59.76","26.36"
"10","007","00","100","0015","0000","932","494","438","98","1030","1632","0","63.11","30.27"
"10","007","00","100","0015","0596","519","297","222","51","570","867","0","65.74","34.26"
"10","007","00","100","0015","0597","413","197","216","47","460","765","0","60.13","25.75"
"10","007","00","100","0016","0000","1236","625","611","129","1365","2009","0","67.94","31.11"
"10","007","00","100","0016","0598","618","317","301","72","690","1012","0","68.18","31.32"
"10","007","00","100","0016","0599","618","308","310","57","675","997","0","67.70","30.89"
"10","007","00","100","0017","0000","1562","756","806","90","1652","2649","0","62.36","28.54"
"10","007","00","100","0017","0558","763","379","384","56","819","1266","0","64.69","29.94"
"10","007","00","100","0017","0559","799","377","422","34","833","1383","0","60.23","27.26"
"10","007","00","100","0018","0000","3305","1575","1730","200","3505","5941","0","59.00","26.51"
"10","007","00","100","0018","0564","659","310","349","37","696","1087","0","64.03","28.52"
"10","007","00","100","0018","0565","422","206","216","36","458","810","0","56.54","25.43"
"10","007","00","100","0018","0566","615","299","316","39","654","1116","0","58.60","26.79"
"10","007","00","100","0018","0567","580","277","303","28","608","1156","0","52.60","23.96"
"10","007","00","100","0018","0568","547","237","310","28","575","919","0","62.57","25.79"
"10","007","00","100","0018","0569","482","246","236","32","514","853","0","60.26","28.84"
"10","007","00","100","0019","0000","1730","813","917","142","1872","2839","0","65.94","28.64"
"10","007","00","100","0019","0570","555","266","289","54","609","908","0","67.07","29.30"
"10","007","00","100","0019","0571","622","272","350","35","657","1006","0","65.31","27.04"
"10","007","00","100","0019","0572","553","275","278","53","606","925","0","65.51","29.73"
"10","007","00","100","0020","0000","1186","566","620","107","1293","1894","0","68.27","29.88"
"10","007","00","100","0020","0533","655","292","363","77","732","1047","0","69.91","27.89"
"10","007","00","100","0020","0534","531","274","257","30","561","847","0","66.23","32.35"
"10","007","00","100","0021","0000","1445","751","694","91","1536","2491","0","61.66","30.15"
"10","007","00","100","0021","0535","764","407","357","39","803","1321","0","60.79","30.81"
"10","007","00","100","0021","0536","681","344","337","52","733","1170","0","62.65","29.40"
"10","007","00","100","0022","0000","1848","927","921","140","1988","3239","0","61.38","28.62"
"10","007","00","100","0022","0537","581","311","270","63","644","1009","0","63.83","30.82"
"10","007","00","100","0022","0538","587","286","301","38","625","1035","0","60.39","27.63"
"10","007","00","100","0022","0539","680","330","350","39","719","1195","0","60.17","27.62"
"10","007","00","100","0023","0000","1301","711","590","131","1432","2269","0","63.11","31.34"
"10","007","00","100","0023","0540","732","428","304","83","815","1225","0","66.53","34.94"
"10","007","00","100","0023","0541","569","283","286","48","617","1044","0","59.10","27.11"
"10","007","00","100","0024","0000","2104","1014","1090","136","2240","3597","0","62.27","28.19"
"10","007","00","100","0024","0542","455","232","223","43","498","832","0","59.86","27.88"
"10","007","00","100","0024","0543","644","305","339","42","686","1110","0","61.80","27.48"
"10","007","00","100","0024","0544","490","256","234","22","512","791","0","64.73","32.36"
"10","007","00","100","0024","0545","515","221","294","29","544","864","0","62.96","25.58"
"10","007","00","100","0025","0000","1367","640","727","144","1511","2227","0","67.85","28.74"
"10","007","00","100","0025","0499","601","228","373","69","670","979","0","68.44","23.29"
"10","007","00","100","0025","0500","766","412","354","75","841","1248","0","67.39","33.01"
"10","007","00","100","0026","0000","1418","687","731","133","1551","2594","0","59.79","26.48"
"10","007","00","100","0026","0501","754","395","359","61","815","1325","0","61.51","29.81"
"10","007","00","100","0026","0502","664","292","372","72","736","1269","0","58.00","23.01"
"10","007","00","100","0027","0000","1468","712","756","130","1598","2683","0","59.56","26.54"
"10","007","00","100","0027","0503","568","278","290","57","625","1013","0","61.70","27.44"
"10","007","00","100","0027","0504","500","233","267","38","538","920","0","58.48","25.33"
"10","007","00","100","0027","0505","400","201","199","35","435","750","0","58.00","26.80"
"10","007","00","100","0028","0000","976","541","435","117","1093","1693","0","64.56","31.96"
"10","007","00","100","0028","0506","507","265","242","61","568","910","0","62.42","29.12"
"10","007","00","100","0028","0507","469","276","193","56","525","783","0","67.05","35.25"
"10","007","00","100","0029","0000","678","400","278","121","799","1132","0","70.58","35.34"
"10","007","00","100","0029","0508","678","400","278","121","799","1132","0","70.58","35.34"
"10","007","00","100","0030","0000","370","155","215","42","412","679","0","60.68","22.83"
"10","007","00","100","0030","0509","370","155","215","42","412","679","0","60.68","22.83"
"10","007","00","100","0031","0000","1095","557","538","104","1199","1881","0","63.74","29.61"
"10","007","00","100","0031","0510","620","298","322","60","680","1066","0","63.79","27.95"
"10","007","00","100","0031","0511","475","259","216","44","519","815","0","63.68","31.78"
"10","007","00","100","0032","0000","1170","565","605","137","1307","2129","0","61.39","26.54"
"10","007","00","100","0032","0512","549","254","295","53","602","1005","0","59.90","25.27"
"10","007","00","100","0032","0513","621","311","310","84","705","1124","0","62.72","27.67"
"10","007","00","100","0033","0000","1008","560","448","95","1103","1842","0","59.88","30.40"
"10","007","00","100","0033","0514","486","280","206","38","524","906","0","57.84","30.91"
"10","007","00","100","0033","0515","522","280","242","57","579","936","0","61.86","29.91"
"10","007","00","100","0034","0000","998","529","469","97","1095","1688","0","64.87","31.34"
"10","007","00","100","0034","0516","564","294","270","49","613","939","0","65.28","31.31"
"10","007","00","100","0034","0517","434","235","199","48","482","749","0","64.35","31.38"
"10","007","00","100","0035","0000","933","483","450","101","1034","1674","0","61.77","28.85"
"10","007","00","100","0035","0518","492","251","241","50","542","828","0","65.46","30.31"
"10","007","00","100","0035","0519","441","232","209","51","492","846","0","58.16","27.42"
"10","007","00","100","0036","0000","1254","607","647","105","1359","2162","0","62.86","28.08"
"10","007","00","100","0036","0520","602","291","311","69","671","1000","0","67.10","29.10"
"10","007","00","100","0036","0521","652","316","336","36","688","1162","0","59.21","27.19"
"10","007","00","100","0037","0000","1655","847","808","93","1748","2884","0","60.61","29.37"
"10","007","00","100","0037","0573","492","238","254","35","527","902","0","58.43","26.39"
"10","007","00","100","0037","0574","482","224","258","28","510","819","0","62.27","27.35"
"10","007","00","100","0037","0575","681","385","296","30","711","1163","0","61.13","33.10"
"10","007","00","100","0038","0000","1314","610","704","63","1377","2182","0","63.11","27.96"
"10","007","00","100","0038","0576","697","325","372","29","726","1174","0","61.84","27.68"
"10","007","00","100","0038","0577","617","285","332","34","651","1008","0","64.58","28.27"
"10","007","00","100","0039","0000","1482","737","745","81","1563","2479","0","63.05","29.73"
"10","007","00","100","0039","0578","710","340","370","47","757","1263","0","59.94","26.92"
"10","007","00","100","0039","0579","772","397","375","34","806","1216","0","66.28","32.65"
"10","007","00","100","0040","0000","797","390","407","45","842","1276","0","65.99","30.56"
"10","007","00","100","0040","0562","440","218","222","26","466","684","0","68.13","31.87"
"10","007","00","100","0040","0563","357","172","185","19","376","592","0","63.51","29.05"
"10","007","00","100","0041","0000","1134","552","582","80","1214","2120","0","57.26","26.04"
"10","007","00","100","0041","0560","675","332","343","42","717","1254","0","57.18","26.48"
"10","007","00","100","0041","0561","459","220","239","38","497","866","0","57.39","25.40"
"10","007","00","110","0000","0000","25021","12694","12327","2544","27565","43484","54044","63.39","29.19"
"10","007","00","110","0001","0000","643","358","285","47","690","1109","0","62.22","32.28"
"10","007","00","110","0001","0665","643","358","285","47","690","1109","0","62.22","32.28"
"10","007","00","110","0002","0000","332","163","169","41","373","585","0","63.76","27.86"
"10","007","00","110","0002","0666","332","163","169","41","373","585","0","63.76","27.86"
"10","007","00","110","0003","0000","931","441","490","74","1005","1700","0","59.12","25.94"
"10","007","00","110","0003","0667","418","209","209","31","449","770","0","58.31","27.14"
"10","007","00","110","0003","0668","513","232","281","43","556","930","0","59.78","24.95"
"10","007","00","110","0004","0000","229","107","122","16","245","399","0","61.40","26.82"
"10","007","00","110","0004","0669","229","107","122","16","245","399","0","61.40","26.82"
"10","007","00","110","0005","0000","1764","839","925","166","1930","3374","0","57.20","24.87"
"10","007","00","110","0005","0679","685","339","346","63","748","1224","0","61.11","27.70"
"10","007","00","110","0005","0680","527","246","281","57","584","1077","0","54.22","22.84"
"10","007","00","110","0005","0681","552","254","298","46","598","1073","0","55.73","23.67"
"10","007","00","110","0006","0000","1322","647","675","122","1444","2128","0","67.86","30.40"
"10","007","00","110","0006","0682","715","350","365","63","778","1166","0","66.72","30.02"
"10","007","00","110","0006","0683","607","297","310","59","666","962","0","69.23","30.87"
"10","007","00","110","0007","0000","1833","846","987","178","2011","3369","0","59.69","25.11"
"10","007","00","110","0007","0684","652","297","355","89","741","1141","0","64.94","26.03"
"10","007","00","110","0007","0685","532","251","281","48","580","1001","0","57.94","25.07"
"10","007","00","110","0007","0686","649","298","351","41","690","1227","0","56.23","24.29"
"10","007","00","110","0008","0000","929","507","422","100","1029","1390","0","74.03","36.47"
"10","007","00","110","0008","0687","929","507","422","100","1029","1390","0","74.03","36.47"
"10","007","00","110","0009","0000","1708","867","841","146","1854","2922","0","63.45","29.67"
"10","007","00","110","0009","0688","571","306","265","57","628","980","0","64.08","31.22"
"10","007","00","110","0009","0689","588","286","302","52","640","981","0","65.24","29.15"
"10","007","00","110","0009","0690","549","275","274","37","586","961","0","60.98","28.62"
"10","007","00","110","0010","0000","1382","685","697","142","1524","2393","0","63.69","28.63"
"10","007","00","110","0010","0691","725","377","348","73","798","1281","0","62.30","29.43"
"10","007","00","110","0010","0692","657","308","349","69","726","1112","0","65.29","27.70"
"10","007","00","110","0011","0000","1156","556","600","81","1237","2210","0","55.97","25.16"
"10","007","00","110","0011","0693","589","284","305","46","635","1102","0","57.62","25.77"
"10","007","00","110","0011","0694","567","272","295","35","602","1108","0","54.33","24.55"
"10","007","00","110","0012","0000","531","276","255","73","604","784","0","77.04","35.20"
"10","007","00","110","0012","0695","531","276","255","73","604","784","0","77.04","35.20"
"10","007","00","110","0013","0000","1044","568","476","123","1167","1737","0","67.18","32.70"
"10","007","00","110","0013","0696","535","297","238","61","596","888","0","67.12","33.45"
"10","007","00","110","0013","0697","509","271","238","62","571","849","0","67.26","31.92"
"10","007","00","110","0014","0000","1341","667","674","143","1484","2225","0","66.70","29.98"
"10","007","00","110","0014","0674","694","343","351","84","778","1080","0","72.04","31.76"
"10","007","00","110","0014","0675","647","324","323","59","706","1145","0","61.66","28.30"
"10","007","00","110","0015","0000","510","264","246","74","584","770","0","75.84","34.29"
"10","007","00","110","0015","0678","510","264","246","74","584","770","0","75.84","34.29"
"10","007","00","110","0016","0000","812","448","364","109","921","1299","0","70.90","34.49"
"10","007","00","110","0016","0707","812","448","364","109","921","1299","0","70.90","34.49"
"10","007","00","110","0017","0000","1001","511","490","108","1109","1749","0","63.41","29.22"
"10","007","00","110","0017","0676","455","234","221","61","516","878","0","58.77","26.65"
"10","007","00","110","0017","0677","546","277","269","47","593","871","0","68.08","31.80"
"10","007","00","110","0018","0000","2526","1333","1193","225","2751","4499","0","61.15","29.63"
"10","007","00","110","0018","0670","561","322","239","42","603","1016","0","59.35","31.69"
"10","007","00","110","0018","0671","603","308","295","73","676","1079","0","62.65","28.54"
"10","007","00","110","0018","0672","677","355","322","57","734","1172","0","62.63","30.29"
"10","007","00","110","0018","0673","685","348","337","53","738","1232","0","59.90","28.25"
"10","007","00","110","0019","0000","363","173","190","47","410","647","0","63.37","26.74"
"10","007","00","110","0019","0698","363","173","190","47","410","647","0","63.37","26.74"
"10","007","00","110","0020","0000","656","332","324","78","734","1203","0","61.01","27.60"
"10","007","00","110","0020","0699","656","332","324","78","734","1203","0","61.01","27.60"
"10","007","00","110","0021","0000","419","196","223","78","497","666","0","74.62","29.43"
"10","007","00","110","0021","0700","419","196","223","78","497","666","0","74.62","29.43"
"10","007","00","110","0022","0000","745","361","384","74","819","1293","0","63.34","27.92"
"10","007","00","110","0022","0701","745","361","384","74","819","1293","0","63.34","27.92"
"10","007","00","110","0023","0000","669","383","286","63","732","1220","0","60.00","31.39"
"10","007","00","110","0023","0702","669","383","286","63","732","1220","0","60.00","31.39"
"10","007","00","110","0024","0000","1129","622","507","135","1264","2101","0","60.16","29.60"
"10","007","00","110","0024","0705","533","311","222","77","610","1023","0","59.63","30.40"
"10","007","00","110","0024","0706","596","311","285","58","654","1078","0","60.67","28.85"
"10","007","00","110","0025","0000","1046","544","502","101","1147","1712","0","67.00","31.78"
"10","007","00","110","0025","0703","602","311","291","52","654","936","0","69.87","33.23"
"10","007","00","110","0025","0704","444","233","211","49","493","776","0","63.53","30.03"
"10","007","00","120","0000","0000","19040","9554","9486","1833","20873","33651","39689","62.03","28.39"
"10","007","00","120","0001","0000","463","242","221","54","517","802","0","64.46","30.17"
"10","007","00","120","0001","0770","463","242","221","54","517","802","0","64.46","30.17"
"10","007","00","120","0002","0000","492","233","259","61","553","997","0","55.47","23.37"
"10","007","00","120","0002","0771","492","233","259","61","553","997","0","55.47","23.37"
"10","007","00","120","0003","0000","385","190","195","43","428","724","0","59.12","26.24"
"10","007","00","120","0003","0772","385","190","195","43","428","724","0","59.12","26.24"
"10","007","00","120","0004","0000","805","388","417","100","905","1436","0","63.02","27.02"
"10","007","00","120","0004","0773","392","187","205","54","446","736","0","60.60","25.41"
"10","007","00","120","0004","0774","413","201","212","46","459","700","0","65.57","28.71"
"10","007","00","120","0005","0000","729","369","360","105","834","1385","0","60.22","26.64"
"10","007","00","120","0005","0775","359","177","182","54","413","705","0","58.58","25.11"
"10","007","00","120","0005","0776","370","192","178","51","421","680","0","61.91","28.24"
"10","007","00","120","0006","0000","728","389","339","87","815","1189","0","68.54","32.72"
"10","007","00","120","0006","0777","728","389","339","87","815","1189","0","68.54","32.72"
"10","007","00","120","0007","0000","987","491","496","93","1080","1693","0","63.79","29.00"
"10","007","00","120","0007","0780","461","232","229","43","504","786","0","64.12","29.52"
"10","007","00","120","0007","0781","526","259","267","50","576","907","0","63.51","28.56"
"10","007","00","120","0008","0000","287","150","137","27","314","551","0","56.99","27.22"
"10","007","00","120","0008","0782","287","150","137","27","314","551","0","56.99","27.22"
"10","007","00","120","0009","0000","1889","862","1027","140","2029","3205","0","63.31","26.90"
"10","007","00","120","0009","0783","588","273","315","47","635","1042","0","60.94","26.20"
"10","007","00","120","0009","0784","637","300","337","53","690","1095","0","63.01","27.40"
"10","007","00","120","0009","0785","664","289","375","40","704","1068","0","65.92","27.06"
"10","007","00","120","0010","0000","1329","669","660","85","1414","2314","0","61.11","28.91"
"10","007","00","120","0010","0786","696","349","347","43","739","1243","0","59.45","28.08"
"10","007","00","120","0010","0787","633","320","313","42","675","1071","0","63.03","29.88"
"10","007","00","120","0011","0000","594","326","268","46","640","993","0","64.45","32.83"
"10","007","00","120","0011","0788","594","326","268","46","640","993","0","64.45","32.83"
"10","007","00","120","0012","0000","629","333","296","42","671","1067","0","62.89","31.21"
"10","007","00","120","0012","0789","629","333","296","42","671","1067","0","62.89","31.21"
"10","007","00","120","0013","0000","1110","528","582","103","1213","1868","0","64.94","28.27"
"10","007","00","120","0013","0790","513","234","279","57","570","895","0","63.69","26.15"
"10","007","00","120","0013","0791","597","294","303","46","643","973","0","66.08","30.22"
"10","007","00","120","0014","0000","1248","640","608","72","1320","2328","0","56.70","27.49"
"10","007","00","120","0014","0778","560","300","260","51","611","1019","0","59.96","29.44"
"10","007","00","120","0014","0779","688","340","348","21","709","1309","0","54.16","25.97"
"10","007","00","120","0015","0000","884","504","380","101","985","1494","0","65.93","33.73"
"10","007","00","120","0015","0793","480","281","199","51","531","780","0","68.08","36.03"
"10","007","00","120","0015","0794","404","223","181","50","454","714","0","63.59","31.23"
"10","007","00","120","0016","0000","732","370","362","75","807","1261","0","64.00","29.34"
"10","007","00","120","0016","0795","732","370","362","75","807","1261","0","64.00","29.34"
"10","007","00","120","0017","0000","951","487","464","94","1045","1810","0","57.73","26.91"
"10","007","00","120","0017","0796","411","213","198","41","452","835","0","54.13","25.51"
"10","007","00","120","0017","0797","540","274","266","53","593","975","0","60.82","28.10"
"10","007","00","120","0018","0000","2364","1133","1231","170","2534","4086","0","62.02","27.73"
"10","007","00","120","0018","0798","601","291","310","35","636","1043","0","60.98","27.90"
"10","007","00","120","0018","0799","538","272","266","57","595","968","0","61.47","28.10"
"10","007","00","120","0018","0800","619","318","301","50","669","1038","0","64.45","30.64"
"10","007","00","120","0018","0801","606","252","354","28","634","1037","0","61.14","24.30"
"10","007","00","120","0019","0000","759","414","345","93","852","1245","0","68.43","33.25"
"10","007","00","120","0019","0792","759","414","345","93","852","1245","0","68.43","33.25"
"10","007","00","120","0020","0000","752","380","372","103","855","1510","0","56.62","25.17"
"10","007","00","120","0020","0802","379","199","180","53","432","741","0","58.30","26.86"
"10","007","00","120","0020","0803","373","181","192","50","423","769","0","55.01","23.54"
"10","007","00","120","0021","0000","465","217","248","71","536","869","0","61.68","24.97"
"10","007","00","120","0021","0804","465","217","248","71","536","869","0","61.68","24.97"
"10","007","00","120","0022","0000","458","239","219","68","526","824","0","63.83","29.00"
"10","007","00","120","0022","0805","458","239","219","68","526","824","0","63.83","29.00"
"10","007","00","130","0000","0000","19587","9932","9655","1826","21413","33181","40259","64.53","29.93"
"10","007","00","130","0001","0000","2063","1007","1056","173","2236","3525","0","63.43","28.57"
"10","007","00","130","0001","0600","588","275","313","40","628","1069","0","58.75","25.72"
"10","007","00","130","0001","0601","637","315","322","49","686","1048","0","65.46","30.06"
"10","007","00","130","0001","0602","838","417","421","84","922","1408","0","65.48","29.62"
"10","007","00","130","0002","0000","929","442","487","126","1055","1512","0","69.78","29.23"
"10","007","00","130","0002","0603","484","225","259","64","548","791","0","69.28","28.45"
"10","007","00","130","0002","0604","445","217","228","62","507","721","0","70.32","30.10"
"10","007","00","130","0003","0000","961","467","494","93","1054","1457","0","72.34","32.05"
"10","007","00","130","0003","0608","961","467","494","93","1054","1457","0","72.34","32.05"
"10","007","00","130","0004","0000","739","362","377","54","793","1225","0","64.73","29.55"
"10","007","00","130","0004","0605","739","362","377","54","793","1225","0","64.73","29.55"
"10","007","00","130","0005","0000","699","388","311","78","777","1154","0","67.33","33.62"
"10","007","00","130","0005","0615","699","388","311","78","777","1154","0","67.33","33.62"
"10","007","00","130","0006","0000","1779","874","905","145","1924","3158","0","60.92","27.68"
"10","007","00","130","0006","0618","678","316","362","55","733","1135","0","64.58","27.84"
"10","007","00","130","0006","0619","516","274","242","56","572","888","0","64.41","30.86"
"10","007","00","130","0006","0620","585","284","301","34","619","1135","0","54.54","25.02"
"10","007","00","130","0007","0000","1778","906","872","141","1919","3071","0","62.49","29.50"
"10","007","00","130","0007","0622","618","305","313","58","676","1026","0","65.89","29.73"
"10","007","00","130","0007","0623","589","299","290","52","641","1057","0","60.64","28.29"
"10","007","00","130","0007","0624","571","302","269","31","602","988","0","60.93","30.57"
"10","007","00","130","0008","0000","1382","745","637","112","1494","2557","0","58.43","29.14"
"10","007","00","130","0008","0629","731","398","333","73","804","1219","0","65.96","32.65"
"10","007","00","130","0008","0630","651","347","304","39","690","1338","0","51.57","25.93"
"10","007","00","130","0009","0000","927","491","436","90","1017","1549","0","65.66","31.70"
"10","007","00","130","0009","0606","421","212","209","38","459","659","0","69.65","32.17"
"10","007","00","130","0009","0607","506","279","227","52","558","890","0","62.70","31.35"
"10","007","00","130","0010","0000","981","499","482","129","1110","1582","0","70.16","31.54"
"10","007","00","130","0010","0611","431","224","207","51","482","697","0","69.15","32.14"
"10","007","00","130","0010","0612","550","275","275","78","628","885","0","70.96","31.07"
"10","007","00","130","0011","0000","859","437","422","54","913","1462","0","62.45","29.89"
"10","007","00","130","0011","0621","859","437","422","54","913","1462","0","62.45","29.89"
"10","007","00","130","0012","0000","1218","561","657","123","1341","1988","0","67.45","28.22"
"10","007","00","130","0012","0609","503","215","288","57","560","808","0","69.31","26.61"
"10","007","00","130","0012","0610","715","346","369","66","781","1180","0","66.19","29.32"
"10","007","00","130","0013","0000","1085","578","507","104","1189","1650","0","72.06","35.03"
"10","007","00","130","0013","0613","540","283","257","48","588","847","0","69.42","33.41"
"10","007","00","130","0013","0614","545","295","250","56","601","803","0","74.84","36.74"
"10","007","00","130","0014","0000","1588","788","800","118","1706","2658","0","64.18","29.65"
"10","007","00","130","0014","0616","753","354","399","55","808","1389","0","58.17","25.49"
"10","007","00","130","0014","0617","835","434","401","63","898","1269","0","70.76","34.20"
"10","007","00","130","0015","0000","1358","731","627","151","1509","2468","0","61.14","29.62"
"10","007","00","130","0015","0625","614","352","262","94","708","1108","0","63.90","31.77"
"10","007","00","130","0015","0626","744","379","365","57","801","1360","0","58.90","27.87"
"10","007","00","130","0016","0000","1241","656","585","135","1376","2165","0","63.56","30.30"
"10","007","00","130","0016","0627","639","336","303","78","717","1054","0","68.03","31.88"
"10","007","00","130","0016","0628","602","320","282","57","659","1111","0","59.32","28.80"
"10","007","00","140","0000","0000","16226","7934","8292","2383","18609","26833","31352","69.35","29.57"
"10","007","00","140","0001","0000","986","438","548","128","1114","1617","0","68.89","27.09"
"10","007","00","140","0001","0708","532","244","288","74","606","875","0","69.26","27.89"
"10","007","00","140","0001","0709","454","194","260","54","508","742","0","68.46","26.15"
"10","007","00","140","0002","0000","904","440","464","84","988","1490","0","66.31","29.53"
"10","007","00","140","0002","0710","439","205","234","51","490","721","0","67.96","28.43"
"10","007","00","140","0002","0711","465","235","230","33","498","769","0","64.76","30.56"
"10","007","00","140","0003","0000","782","363","419","107","889","1211","0","73.41","29.98"
"10","007","00","140","0003","0712","782","363","419","107","889","1211","0","73.41","29.98"
"10","007","00","140","0004","0000","592","291","301","77","669","872","0","76.72","33.37"
"10","007","00","140","0004","0713","592","291","301","77","669","872","0","76.72","33.37"
"10","007","00","140","0005","0000","1045","518","527","144","1189","1695","0","70.15","30.56"
"10","007","00","140","0005","0714","557","275","282","72","629","854","0","73.65","32.20"
"10","007","00","140","0005","0715","488","243","245","72","560","841","0","66.59","28.89"
"10","007","00","140","0006","0000","469","254","215","79","548","890","0","61.57","28.54"
"10","007","00","140","0006","0716","469","254","215","79","548","890","0","61.57","28.54"
"10","007","00","140","0007","0000","746","364","382","97","843","1266","0","66.59","28.75"
"10","007","00","140","0007","0717","746","364","382","97","843","1266","0","66.59","28.75"
"10","007","00","140","0008","0000","690","329","361","84","774","1042","0","74.28","31.57"
"10","007","00","140","0008","0718","690","329","361","84","774","1042","0","74.28","31.57"
"10","007","00","140","0009","0000","448","201","247","63","511","642","0","79.60","31.31"
"10","007","00","140","0009","0719","448","201","247","63","511","642","0","79.60","31.31"
"10","007","00","140","0010","0000","737","349","388","84","821","1181","0","69.52","29.55"
"10","007","00","140","0010","0720","737","349","388","84","821","1181","0","69.52","29.55"
"10","007","00","140","0011","0000","1072","528","544","136","1208","1802","0","67.04","29.30"
"10","007","00","140","0011","0721","506","252","254","60","566","833","0","67.95","30.25"
"10","007","00","140","0011","0722","566","276","290","76","642","969","0","66.25","28.48"
"10","007","00","140","0012","0000","1202","602","600","248","1450","1968","0","73.68","30.59"
"10","007","00","140","0012","0723","597","312","285","112","709","944","0","75.11","33.05"
"10","007","00","140","0012","0724","605","290","315","136","741","1024","0","72.36","28.32"
"10","007","00","140","0013","0000","692","356","336","111","803","1137","0","70.62","31.31"
"10","007","00","140","0013","0725","692","356","336","111","803","1137","0","70.62","31.31"
"10","007","00","140","0014","0000","317","160","157","34","351","437","0","80.32","36.61"
"10","007","00","140","0014","0726","317","160","157","34","351","437","0","80.32","36.61"
"10","007","00","140","0015","0000","678","314","364","113","791","1068","0","74.06","29.40"
"10","007","00","140","0015","0727","678","314","364","113","791","1068","0","74.06","29.40"
"10","007","00","140","0016","0000","506","261","245","62","568","814","0","69.78","32.06"
"10","007","00","140","0016","0728","506","261","245","62","568","814","0","69.78","32.06"
"10","007","00","140","0017","0000","765","430","335","187","952","1372","0","69.39","31.34"
"10","007","00","140","0017","0729","404","219","185","91","495","710","0","69.72","30.85"
"10","007","00","140","0017","0730","361","211","150","96","457","662","0","69.03","31.87"
"10","007","00","140","0018","0000","513","247","266","82","595","809","0","73.55","30.53"
"10","007","00","140","0018","0731","513","247","266","82","595","809","0","73.55","30.53"
"10","007","00","140","0019","0000","861","440","421","109","970","1481","0","65.50","29.71"
"10","007","00","140","0019","0732","428","222","206","48","476","778","0","61.18","28.53"
"10","007","00","140","0019","0733","433","218","215","61","494","703","0","70.27","31.01"
"10","007","00","140","0020","0000","790","369","421","160","950","1446","0","65.70","25.52"
"10","007","00","140","0020","0734","400","180","220","58","458","689","0","66.47","26.12"
"10","007","00","140","0020","0735","390","189","201","102","492","757","0","64.99","24.97"
"10","007","00","140","0021","0000","753","383","370","90","843","1315","0","64.11","29.13"
"10","007","00","140","0021","0736","371","191","180","46","417","675","0","61.78","28.30"
"10","007","00","140","0021","0737","382","192","190","44","426","640","0","66.56","30.00"
"10","007","00","140","0022","0000","678","297","381","104","782","1278","0","61.19","23.24"
"10","007","00","140","0022","0738","678","297","381","104","782","1278","0","61.19","23.24"
"10","007","00","150","0000","0000","17379","9293","8086","1618","18997","28845","33864","65.86","32.22"
"10","007","00","150","0001","0000","1965","1025","940","167","2132","3384","0","63.00","30.29"
"10","007","00","150","0001","0739","620","351","269","52","672","1038","0","64.74","33.82"
"10","007","00","150","0001","0740","635","325","310","66","701","1111","0","63.10","29.25"
"10","007","00","150","0001","0741","710","349","361","49","759","1235","0","61.46","28.26"
"10","007","00","150","0002","0000","741","410","331","77","818","1174","0","69.68","34.92"
"10","007","00","150","0002","0742","741","410","331","77","818","1174","0","69.68","34.92"
"10","007","00","150","0003","0000","959","514","445","86","1045","1543","0","67.73","33.31"
"10","007","00","150","0003","0743","523","284","239","53","576","852","0","67.61","33.33"
"10","007","00","150","0003","0744","436","230","206","33","469","691","0","67.87","33.29"
"10","007","00","150","0004","0000","712","377","335","94","806","1190","0","67.73","31.68"
"10","007","00","150","0004","0745","712","377","335","94","806","1190","0","67.73","31.68"
"10","007","00","150","0005","0000","1078","578","500","86","1164","1698","0","68.55","34.04"
"10","007","00","150","0005","0746","388","216","172","36","424","586","0","72.35","36.86"
"10","007","00","150","0005","0747","690","362","328","50","740","1112","0","66.55","32.55"
"10","007","00","150","0006","0000","1074","543","531","92","1166","2035","0","57.30","26.68"
"10","007","00","150","0006","0748","604","294","310","41","645","1172","0","55.03","25.09"
"10","007","00","150","0006","0749","470","249","221","51","521","863","0","60.37","28.85"
"10","007","00","150","0007","0000","871","465","406","74","945","1403","0","67.36","33.14"
"10","007","00","150","0007","0750","461","258","203","33","494","760","0","65.00","33.95"
"10","007","00","150","0007","0751","410","207","203","41","451","643","0","70.14","32.19"
"10","007","00","150","0008","0000","1117","580","537","101","1218","1938","0","62.85","29.93"
"10","007","00","150","0008","0754","558","289","269","45","603","950","0","63.47","30.42"
"10","007","00","150","0008","0755","559","291","268","56","615","988","0","62.25","29.45"
"10","007","00","150","0009","0000","1323","706","617","81","1404","2294","0","61.20","30.78"
"10","007","00","150","0009","0752","742","380","362","49","791","1329","0","59.52","28.59"
"10","007","00","150","0009","0753","581","326","255","32","613","965","0","63.52","33.78"
"10","007","00","150","0010","0000","404","214","190","47","451","622","0","72.51","34.41"
"10","007","00","150","0010","0756","404","214","190","47","451","622","0","72.51","34.41"
"10","007","00","150","0011","0000","768","372","396","78","846","1199","0","70.56","31.03"
"10","007","00","150","0011","0757","768","372","396","78","846","1199","0","70.56","31.03"
"10","007","00","150","0012","0000","916","507","409","74","990","1458","0","67.90","34.77"
"10","007","00","150","0012","0758","461","245","216","45","506","723","0","69.99","33.89"
"10","007","00","150","0012","0759","455","262","193","29","484","735","0","65.85","35.65"
"10","007","00","150","0013","0000","621","366","255","63","684","1019","0","67.12","35.92"
"10","007","00","150","0013","0760","621","366","255","63","684","1019","0","67.12","35.92"
"10","007","00","150","0014","0000","528","281","247","41","569","935","0","60.86","30.05"
"10","007","00","150","0014","0761","528","281","247","41","569","935","0","60.86","30.05"
"10","007","00","150","0015","0000","833","493","340","79","912","1261","0","72.32","39.10"
"10","007","00","150","0015","0764","432","255","177","43","475","636","0","74.69","40.09"
"10","007","00","150","0015","0765","401","238","163","36","437","625","0","69.92","38.08"
"10","007","00","150","0016","0000","1120","628","492","116","1236","1843","0","67.06","34.07"
"10","007","00","150","0016","0762","542","314","228","48","590","913","0","64.62","34.39"
"10","007","00","150","0016","0763","578","314","264","68","646","930","0","69.46","33.76"
"10","007","00","150","0017","0000","940","520","420","83","1023","1393","0","73.44","37.33"
"10","007","00","150","0017","0767","940","520","420","83","1023","1393","0","73.44","37.33"
"10","007","00","150","0018","0000","469","257","212","47","516","861","0","59.93","29.85"
"10","007","00","150","0018","0766","469","257","212","47","516","861","0","59.93","29.85"
"10","007","00","150","0019","0000","446","229","217","47","493","700","0","70.43","32.71"
"10","007","00","150","0019","0768","446","229","217","47","493","700","0","70.43","32.71"
"10","007","00","150","0020","0000","494","228","266","85","579","895","0","64.69","25.47"
"10","007","00","150","0020","0769","494","228","266","85","579","895","0","64.69","25.47"
"10","007","00","160","0000","0000","17866","9147","8719","1988","19854","29738","35514","66.76","30.76"
"10","007","00","160","0001","0000","440","188","252","39","479","739","0","64.82","25.44"
"10","007","00","160","0001","0641","440","188","252","39","479","739","0","64.82","25.44"
"10","007","00","160","0002","0000","881","483","398","55","936","1454","0","64.37","33.22"
"10","007","00","160","0002","0642","413","233","180","23","436","664","0","65.66","35.09"
"10","007","00","160","0002","0643","468","250","218","32","500","790","0","63.29","31.65"
"10","007","00","160","0003","0000","998","487","511","94","1092","1728","0","63.19","28.18"
"10","007","00","160","0003","0644","569","293","276","59","628","971","0","64.68","30.18"
"10","007","00","160","0003","0645","429","194","235","35","464","757","0","61.29","25.63"
"10","007","00","160","0004","0000","1346","709","637","90","1436","2093","0","68.61","33.87"
"10","007","00","160","0004","0646","658","348","310","44","702","1039","0","67.56","33.49"
"10","007","00","160","0004","0647","688","361","327","46","734","1054","0","69.64","34.25"
"10","007","00","160","0005","0000","1000","484","516","110","1110","1607","0","69.07","30.12"
"10","007","00","160","0005","0648","539","253","286","65","604","860","0","70.23","29.42"
"10","007","00","160","0005","0649","461","231","230","45","506","747","0","67.74","30.92"
"10","007","00","160","0006","0000","813","412","401","103","916","1390","0","65.90","29.64"
"10","007","00","160","0006","0650","465","215","250","62","527","785","0","67.13","27.39"
"10","007","00","160","0006","0651","348","197","151","41","389","605","0","64.30","32.56"
"10","007","00","160","0007","0000","640","357","283","75","715","1043","0","68.55","34.23"
"10","007","00","160","0007","0652","640","357","283","75","715","1043","0","68.55","34.23"
"10","007","00","160","0008","0000","588","199","389","68","656","1026","0","63.94","19.40"
"10","007","00","160","0008","0653","588","199","389","68","656","1026","0","63.94","19.40"
"10","007","00","160","0009","0000","1632","772","860","134","1766","2604","0","67.82","29.65"
"10","007","00","160","0009","0654","879","403","476","73","952","1398","0","68.10","28.83"
"10","007","00","160","0009","0655","753","369","384","61","814","1206","0","67.50","30.60"
"10","007","00","160","0010","0000","733","421","312","92","825","1311","0","62.93","32.11"
"10","007","00","160","0010","0636","341","201","140","49","390","619","0","63.00","32.47"
"10","007","00","160","0010","0637","392","220","172","43","435","692","0","62.86","31.79"
"10","007","00","160","0011","0000","712","341","371","122","834","1169","0","71.34","29.17"
"10","007","00","160","0011","0631","712","341","371","122","834","1169","0","71.34","29.17"
"10","007","00","160","0012","0000","864","465","399","108","972","1547","0","62.83","30.06"
"10","007","00","160","0012","0634","375","203","172","58","433","670","0","64.63","30.30"
"10","007","00","160","0012","0635","489","262","227","50","539","877","0","61.46","29.87"
"10","007","00","160","0013","0000","1086","561","525","125","1211","1885","0","64.24","29.76"
"10","007","00","160","0013","0632","520","265","255","70","590","867","0","68.05","30.57"
"10","007","00","160","0013","0633","566","296","270","55","621","1018","0","61.00","29.08"
"10","007","00","160","0014","0000","926","473","453","99","1025","1487","0","68.93","31.81"
"10","007","00","160","0014","0638","444","246","198","43","487","694","0","70.17","35.45"
"10","007","00","160","0014","0639","482","227","255","56","538","793","0","67.84","28.63"
"10","007","00","160","0015","0000","758","416","342","60","818","1347","0","60.73","30.88"
"10","007","00","160","0015","0640","758","416","342","60","818","1347","0","60.73","30.88"
"10","007","00","160","0016","0000","528","278","250","44","572","793","0","72.13","35.06"
"10","007","00","160","0016","0656","528","278","250","44","572","793","0","72.13","35.06"
"10","007","00","160","0017","0000","426","213","213","61","487","674","0","72.26","31.60"
"10","007","00","160","0017","0657","426","213","213","61","487","674","0","72.26","31.60"
"10","007","00","160","0018","0000","511","278","233","45","556","736","0","75.54","37.77"
"10","007","00","160","0018","0658","511","278","233","45","556","736","0","75.54","37.77"
"10","007","00","160","0019","0000","392","210","182","32","424","653","0","64.93","32.16"
"10","007","00","160","0019","0659","392","210","182","32","424","653","0","64.93","32.16"
"10","007","00","160","0020","0000","493","249","244","76","569","816","0","69.73","30.51"
"10","007","00","160","0020","0660","493","249","244","76","569","816","0","69.73","30.51"
"10","007","00","160","0021","0000","446","228","218","68","514","776","0","66.24","29.38"
"10","007","00","160","0021","0661","446","228","218","68","514","776","0","66.24","29.38"
"10","007","00","160","0022","0000","325","174","151","70","395","598","0","66.05","29.10"
"10","007","00","160","0022","0662","325","174","151","70","395","598","0","66.05","29.10"
"10","007","00","160","0023","0000","620","322","298","100","720","1031","0","69.84","31.23"
"10","007","00","160","0023","0663","620","322","298","100","720","1031","0","69.84","31.23"
"10","007","00","160","0024","0000","708","427","281","118","826","1231","0","67.10","34.69"
"10","007","00","160","0024","0664","708","427","281","118","826","1231","0","67.10","34.69"
"10","007","00","170","0000","0000","20217","10626","9591","1770","21987","34959","41622","62.89","30.40"
"10","007","00","170","0001","0000","1401","777","624","106","1507","2638","0","57.13","29.45"
"10","007","00","170","0001","0806","396","237","159","28","424","734","0","57.77","32.29"
"10","007","00","170","0001","0807","521","268","253","35","556","965","0","57.62","27.77"
"10","007","00","170","0001","0808","484","272","212","43","527","939","0","56.12","28.97"
"10","007","00","170","0002","0000","870","456","414","70","940","1417","0","66.34","32.18"
"10","007","00","170","0002","0813","502","254","248","39","541","773","0","69.99","32.86"
"10","007","00","170","0002","0814","368","202","166","31","399","644","0","61.96","31.37"
"10","007","00","170","0003","0000","634","361","273","56","690","1109","0","62.22","32.55"
"10","007","00","170","0003","0833","634","361","273","56","690","1109","0","62.22","32.55"
"10","007","00","170","0004","0000","2322","1179","1143","178","2500","4275","0","58.48","27.58"
"10","007","00","170","0004","0809","544","278","266","41","585","963","0","60.75","28.87"
"10","007","00","170","0004","0810","496","242","254","38","534","1037","0","51.49","23.34"
"10","007","00","170","0004","0811","640","340","300","50","690","1154","0","59.79","29.46"
"10","007","00","170","0004","0812","642","319","323","49","691","1121","0","61.64","28.46"
"10","007","00","170","0005","0000","586","296","290","78","664","878","0","75.63","33.71"
"10","007","00","170","0005","0818","586","296","290","78","664","878","0","75.63","33.71"
"10","007","00","170","0006","0000","560","299","261","46","606","1070","0","56.64","27.94"
"10","007","00","170","0006","0840","560","299","261","46","606","1070","0","56.64","27.94"
"10","007","00","170","0007","0000","1566","817","749","107","1673","2682","0","62.38","30.46"
"10","007","00","170","0007","0826","433","225","208","30","463","727","0","63.69","30.95"
"10","007","00","170","0007","0827","491","248","243","29","520","857","0","60.68","28.94"
"10","007","00","170","0007","0828","642","344","298","48","690","1098","0","62.84","31.33"
"10","007","00","170","0008","0000","1169","647","522","116","1285","1981","0","64.87","32.66"
"10","007","00","170","0008","0819","603","343","260","47","650","957","0","67.92","35.84"
"10","007","00","170","0008","0820","566","304","262","69","635","1024","0","62.01","29.69"
"10","007","00","170","0009","0000","429","214","215","37","466","743","0","62.72","28.80"
"10","007","00","170","0009","0835","429","214","215","37","466","743","0","62.72","28.80"
"10","007","00","170","0010","0000","534","267","267","39","573","879","0","65.19","30.38"
"10","007","00","170","0010","0831","534","267","267","39","573","879","0","65.19","30.38"
"10","007","00","170","0011","0000","885","476","409","91","976","1659","0","58.83","28.69"
"10","007","00","170","0011","0824","383","223","160","44","427","697","0","61.26","31.99"
"10","007","00","170","0011","0825","502","253","249","47","549","962","0","57.07","26.30"
"10","007","00","170","0012","0000","577","304","273","64","641","956","0","67.05","31.80"
"10","007","00","170","0012","0839","577","304","273","64","641","956","0","67.05","31.80"
"10","007","00","170","0013","0000","747","405","342","49","796","1218","0","65.35","33.25"
"10","007","00","170","0013","0830","747","405","342","49","796","1218","0","65.35","33.25"
"10","007","00","170","0014","0000","674","341","333","69","743","1356","0","54.79","25.15"
"10","007","00","170","0014","0821","371","176","195","47","418","709","0","58.96","24.82"
"10","007","00","170","0014","0822","303","165","138","22","325","647","0","50.23","25.50"
"10","007","00","170","0015","0000","547","272","275","59","606","930","0","65.16","29.25"
"10","007","00","170","0015","0836","547","272","275","59","606","930","0","65.16","29.25"
"10","007","00","170","0016","0000","638","331","307","67","705","957","0","73.67","34.59"
"10","007","00","170","0016","0829","638","331","307","67","705","957","0","73.67","34.59"
"10","007","00","170","0017","0000","756","410","346","80","836","1203","0","69.49","34.08"
"10","007","00","170","0017","0823","756","410","346","80","836","1203","0","69.49","34.08"
"10","007","00","170","0018","0000","465","289","176","48","513","769","0","66.71","37.58"
"10","007","00","170","0018","0841","465","289","176","48","513","769","0","66.71","37.58"
"10","007","00","170","0019","0000","992","511","481","70","1062","1558","0","68.16","32.80"
"10","007","00","170","0019","0816","536","297","239","35","571","849","0","67.26","34.98"
"10","007","00","170","0019","0817","456","214","242","35","491","709","0","69.25","30.18"
"10","007","00","170","0020","0000","618","335","283","54","672","937","0","71.72","35.75"
"10","007","00","170","0020","0834","618","335","283","54","672","937","0","71.72","35.75"
"10","007","00","170","0021","0000","833","443","390","76","909","1412","0","64.38","31.37"
"10","007","00","170","0021","0842","435","235","200","48","483","729","0","66.26","32.24"
"10","007","00","170","0021","0843","398","208","190","28","426","683","0","62.37","30.45"
"10","007","00","170","0022","0000","587","313","274","55","642","1018","0","63.06","30.75"
"10","007","00","170","0022","0815","587","313","274","55","642","1018","0","63.06","30.75"
"10","007","00","170","0023","0000","804","349","455","78","882","1214","0","72.65","28.75"
"10","007","00","170","0023","0832","804","349","455","78","882","1214","0","72.65","28.75"
"10","007","00","170","0024","0000","1023","534","489","77","1100","2100","0","52.38","25.43"
"10","007","00","170","0024","0837","530","261","269","34","564","1064","0","53.01","24.53"
"10","007","00","170","0024","0838","493","273","220","43","536","1036","0","51.74","26.35"
"10","007","00","180","0000","0000","7833","4101","3732","1003","8836","12445","14213","71.00","32.95"
"10","007","00","180","0001","0000","479","249","230","64","543","805","0","67.45","30.93"
"10","007","00","180","0001","0846","479","249","230","64","543","805","0","67.45","30.93"
"10","007","00","180","0002","0000","591","294","297","66","657","889","0","73.90","33.07"
"10","007","00","180","0002","0847","591","294","297","66","657","889","0","73.90","33.07"
"10","007","00","180","0003","0000","346","172","174","66","412","583","0","70.67","29.50"
"10","007","00","180","0003","0848","346","172","174","66","412","583","0","70.67","29.50"
"10","007","00","180","0004","0000","392","192","200","57","449","614","0","73.13","31.27"
"10","007","00","180","0004","0849","392","192","200","57","449","614","0","73.13","31.27"
"10","007","00","180","0005","0000","578","283","295","55","633","863","0","73.35","32.79"
"10","007","00","180","0005","0851","578","283","295","55","633","863","0","73.35","32.79"
"10","007","00","180","0006","0000","586","276","310","34","620","913","0","67.91","30.23"
"10","007","00","180","0006","0850","586","276","310","34","620","913","0","67.91","30.23"
"10","007","00","180","0007","0000","533","285","248","55","588","759","0","77.47","37.55"
"10","007","00","180","0007","0853","533","285","248","55","588","759","0","77.47","37.55"
"10","007","00","180","0008","0000","285","141","144","22","307","411","0","74.70","34.31"
"10","007","00","180","0008","0852","285","141","144","22","307","411","0","74.70","34.31"
"10","007","00","180","0009","0000","535","295","240","72","607","970","0","62.58","30.41"
"10","007","00","180","0009","0855","535","295","240","72","607","970","0","62.58","30.41"
"10","007","00","180","0010","0000","504","294","210","65","569","769","0","73.99","38.23"
"10","007","00","180","0010","0854","504","294","210","65","569","769","0","73.99","38.23"
"10","007","00","180","0011","0000","457","249","208","59","516","749","0","68.89","33.24"
"10","007","00","180","0011","0856","457","249","208","59","516","749","0","68.89","33.24"
"10","007","00","180","0012","0000","462","242","220","58","520","757","0","68.69","31.97"
"10","007","00","180","0012","0857","462","242","220","58","520","757","0","68.69","31.97"
"10","007","00","180","0013","0000","365","199","166","57","422","642","0","65.73","31.00"
"10","007","00","180","0013","0858","365","199","166","57","422","642","0","65.73","31.00"
"10","007","00","180","0014","0000","357","172","185","68","425","582","0","73.02","29.55"
"10","007","00","180","0014","0859","357","172","185","68","425","582","0","73.02","29.55"
"10","007","00","180","0015","0000","341","193","148","48","389","542","0","71.77","35.61"
"10","007","00","180","0015","0860","341","193","148","48","389","542","0","71.77","35.61"
"10","007","00","180","0016","0000","626","365","261","89","715","959","0","74.56","38.06"
"10","007","00","180","0016","0844","626","365","261","89","715","959","0","74.56","38.06"
"10","007","00","180","0017","0000","396","200","196","68","464","638","0","72.73","31.35"
"10","007","00","180","0017","0845","396","200","196","68","464","638","0","72.73","31.35"
"10","007","00","190","0000","0000","15459","7974","7485","1305","16764","27081","33237","61.90","29.44"
"10","007","00","190","0001","0000","1009","515","494","66","1075","1731","0","62.10","29.75"
"10","007","00","190","0001","0872","464","261","203","31","495","782","0","63.30","33.38"
"10","007","00","190","0001","0873","545","254","291","35","580","949","0","61.12","26.77"
"10","007","00","190","0002","0000","406","227","179","32","438","743","0","58.95","30.55"
"10","007","00","190","0002","0874","406","227","179","32","438","743","0","58.95","30.55"
"10","007","00","190","0003","0000","308","172","136","33","341","519","0","65.70","33.14"
"10","007","00","190","0003","0875","308","172","136","33","341","519","0","65.70","33.14"
"10","007","00","190","0004","0000","375","193","182","19","394","624","0","63.14","30.93"
"10","007","00","190","0004","0876","375","193","182","19","394","624","0","63.14","30.93"
"10","007","00","190","0005","0000","761","419","342","77","838","1354","0","61.89","30.95"
"10","007","00","190","0005","0877","362","199","163","29","391","628","0","62.26","31.69"
"10","007","00","190","0005","0878","399","220","179","48","447","726","0","61.57","30.30"
"10","007","00","190","0006","0000","761","339","422","64","825","1217","0","67.79","27.86"
"10","007","00","190","0006","0879","366","176","190","27","393","601","0","65.39","29.28"
"10","007","00","190","0006","0880","395","163","232","37","432","616","0","70.13","26.46"
"10","007","00","190","0007","0000","1218","656","562","97","1315","2230","0","58.97","29.42"
"10","007","00","190","0007","0881","624","341","283","48","672","1122","0","59.89","30.39"
"10","007","00","190","0007","0882","594","315","279","49","643","1108","0","58.03","28.43"
"10","007","00","190","0008","0000","1796","877","919","115","1911","3074","0","62.17","28.53"
"10","007","00","190","0008","0883","566","277","289","53","619","959","0","64.55","28.88"
"10","007","00","190","0008","0884","622","278","344","30","652","1064","0","61.28","26.13"
"10","007","00","190","0008","0885","608","322","286","32","640","1051","0","60.89","30.64"
"10","007","00","190","0009","0000","800","417","383","71","871","1260","0","69.13","33.10"
"10","007","00","190","0009","0886","800","417","383","71","871","1260","0","69.13","33.10"
"10","007","00","190","0010","0000","2434","1225","1209","196","2630","4407","0","59.68","27.80"
"10","007","00","190","0010","0866","580","248","332","34","614","1059","0","57.98","23.42"
"10","007","00","190","0010","0867","604","322","282","38","642","1041","0","61.67","30.93"
"10","007","00","190","0010","0868","657","342","315","64","721","1162","0","62.05","29.43"
"10","007","00","190","0010","0869","593","313","280","60","653","1145","0","57.03","27.34"
"10","007","00","190","0011","0000","896","458","438","70","966","1694","0","57.02","27.04"
"10","007","00","190","0011","0870","423","218","205","26","449","771","0","58.24","28.27"
"10","007","00","190","0011","0871","473","240","233","44","517","923","0","56.01","26.00"
"10","007","00","190","0012","0000","1642","892","750","126","1768","2616","0","67.58","34.10"
"10","007","00","190","0012","0861","548","294","254","52","600","889","0","67.49","33.07"
"10","007","00","190","0012","0862","563","290","273","43","606","874","0","69.34","33.18"
"10","007","00","190","0012","0863","531","308","223","31","562","853","0","65.89","36.11"
"10","007","00","190","0013","0000","1103","620","483","100","1203","1884","0","63.85","32.91"
"10","007","00","190","0013","0864","642","353","289","43","685","1085","0","63.13","32.53"
"10","007","00","190","0013","0865","461","267","194","57","518","799","0","64.83","33.42"
"10","007","00","190","0014","0000","1007","503","504","134","1141","1979","0","57.66","25.42"
"10","007","00","190","0014","0887","547","277","270","58","605","1055","0","57.35","26.26"
"10","007","00","190","0014","0888","460","226","234","76","536","924","0","58.01","24.46"
"10","007","00","190","0015","0000","943","461","482","105","1048","1749","0","59.92","26.36"
"10","007","00","190","0015","0889","442","214","228","52","494","821","0","60.17","26.07"
"10","007","00","190","0015","0890","501","247","254","53","554","928","0","59.70","26.62"
"10","007","00","200","0000","0000","21588","11242","10346","3524","25112","41017","48500","61.22","27.41"
"10","007","00","200","0001","0000","1144","586","558","101","1245","2041","0","61.00","28.71"
"10","007","00","200","0001","0975","430","235","195","24","454","814","0","55.77","28.87"
"10","007","00","200","0001","0976","714","351","363","77","791","1227","0","64.47","28.61"
"10","007","00","200","0002","0000","1651","784","867","206","1857","3142","0","59.10","24.95"
"10","007","00","200","0002","0977","504","231","273","77","581","988","0","58.81","23.38"
"10","007","00","200","0002","0978","613","299","314","59","672","1113","0","60.38","26.86"
"10","007","00","200","0002","0979","534","254","280","70","604","1041","0","58.02","24.40"
"10","007","00","200","0003","0000","837","418","419","109","946","1460","0","64.79","28.63"
"10","007","00","200","0003","0980","837","418","419","109","946","1460","0","64.79","28.63"
"10","007","00","200","0004","0000","1635","865","770","249","1884","2893","0","65.12","29.90"
"10","007","00","200","0004","0981","534","281","253","103","637","952","0","66.91","29.52"
"10","007","00","200","0004","0982","564","306","258","77","641","1004","0","63.84","30.48"
"10","007","00","200","0004","0983","537","278","259","69","606","937","0","64.67","29.67"
"10","007","00","200","0005","0000","646","350","296","139","785","1532","0","51.24","22.85"
"10","007","00","200","0005","0984","313","174","139","56","369","623","0","59.23","27.93"
"10","007","00","200","0005","0985","333","176","157","83","416","909","0","45.76","19.36"
"10","007","00","200","0006","0000","626","376","250","144","770","1283","0","60.02","29.31"
"10","007","00","200","0006","0986","626","376","250","144","770","1283","0","60.02","29.31"
"10","007","00","200","0007","0000","519","314","205","89","608","1002","0","60.68","31.34"
"10","007","00","200","0007","0987","519","314","205","89","608","1002","0","60.68","31.34"
"10","007","00","200","0008","0000","464","216","248","92","556","923","0","60.24","23.40"
"10","007","00","200","0008","0988","464","216","248","92","556","923","0","60.24","23.40"
"10","007","00","200","0009","0000","558","298","260","98","656","1122","0","58.47","26.56"
"10","007","00","200","0009","0989","558","298","260","98","656","1122","0","58.47","26.56"
"10","007","00","200","0010","0000","918","455","463","110","1028","1569","0","65.52","29.00"
"10","007","00","200","0010","0990","440","226","214","75","515","759","0","67.85","29.78"
"10","007","00","200","0010","0991","478","229","249","35","513","810","0","63.33","28.27"
"10","007","00","200","0011","0000","1796","861","935","176","1972","3305","0","59.67","26.05"
"10","007","00","200","0011","0992","470","237","233","67","537","944","0","56.89","25.11"
"10","007","00","200","0011","0993","586","273","313","37","623","1046","0","59.56","26.10"
"10","007","00","200","0011","0994","740","351","389","72","812","1315","0","61.75","26.69"
"10","007","00","200","0012","0000","1200","620","580","156","1356","2432","0","55.76","25.49"
"10","007","00","200","0012","0972","309","182","127","57","366","690","0","53.04","26.38"
"10","007","00","200","0012","0973","526","266","260","64","590","996","0","59.24","26.71"
"10","007","00","200","0012","0974","365","172","193","35","400","746","0","53.62","23.06"
"10","007","00","200","0013","0000","484","259","225","65","549","1245","0","44.10","20.80"
"10","007","00","200","0013","0995","484","259","225","65","549","1245","0","44.10","20.80"
"10","007","00","200","0014","0000","763","429","334","225","988","1481","0","66.71","28.97"
"10","007","00","200","0014","0996","378","220","158","115","493","689","0","71.55","31.93"
"10","007","00","200","0014","0997","385","209","176","110","495","792","0","62.50","26.39"
"10","007","00","200","0015","0000","645","360","285","102","747","1116","0","66.94","32.26"
"10","007","00","200","0015","0998","645","360","285","102","747","1116","0","66.94","32.26"
"10","007","00","200","0016","0000","367","207","160","52","419","734","0","57.08","28.20"
"10","007","00","200","0016","0999","367","207","160","52","419","734","0","57.08","28.20"
"10","007","00","200","0017","0000","759","409","350","171","930","1432","0","64.94","28.56"
"10","007","00","200","0017","1000","433","230","203","90","523","814","0","64.25","28.26"
"10","007","00","200","0017","1001","326","179","147","81","407","618","0","65.86","28.96"
"10","007","00","200","0018","0000","628","319","309","99","727","1221","0","59.54","26.13"
"10","007","00","200","0018","1002","628","319","309","99","727","1221","0","59.54","26.13"
"10","007","00","200","0019","0000","645","357","288","95","740","1072","0","69.03","33.30"
"10","007","00","200","0019","1003","645","357","288","95","740","1072","0","69.03","33.30"
"10","007","00","200","0020","0000","1704","785","919","304","2008","3407","0","58.94","23.04"
"10","007","00","200","0020","1004","568","240","328","80","648","1131","0","57.29","21.22"
"10","007","00","200","0020","1005","647","307","340","95","742","1270","0","58.43","24.17"
"10","007","00","200","0020","1006","489","238","251","129","618","1006","0","61.43","23.66"
"10","007","00","200","0021","0000","545","274","271","114","659","931","0","70.78","29.43"
"10","007","00","200","0021","1008","545","274","271","114","659","931","0","70.78","29.43"
"10","007","00","200","0022","0000","585","299","286","169","754","1051","0","71.74","28.45"
"10","007","00","200","0022","1007","585","299","286","169","754","1051","0","71.74","28.45"
"10","007","00","200","0023","0000","415","229","186","113","528","831","0","63.54","27.56"
"10","007","00","200","0023","1009","415","229","186","113","528","831","0","63.54","27.56"
"10","007","00","200","0024","0000","660","362","298","100","760","1184","0","64.19","30.57"
"10","007","00","200","0024","1010","660","362","298","100","760","1184","0","64.19","30.57"
"10","007","00","200","0025","0000","581","313","268","121","702","1008","0","69.64","31.05"
"10","007","00","200","0025","1011","581","313","268","121","702","1008","0","69.64","31.05"
"10","007","00","200","0026","0000","504","316","188","65","569","933","0","60.99","33.87"
"10","007","00","200","0026","1012","504","316","188","65","569","933","0","60.99","33.87"
"10","007","00","200","0027","0000","309","181","128","60","369","667","0","55.32","27.14"
"10","007","00","200","0027","1013","309","181","128","60","369","667","0","55.32","27.14"
"10","007","00","210","0000","0000","12962","6814","6148","1362","14324","22146","26114","64.68","30.77"
"10","007","00","210","0001","0000","728","392","336","75","803","1243","0","64.60","31.54"
"10","007","00","210","0001","0891","728","392","336","75","803","1243","0","64.60","31.54"
"10","007","00","210","0002","0000","481","228","253","48","529","741","0","71.39","30.77"
"10","007","00","210","0002","0901","481","228","253","48","529","741","0","71.39","30.77"
"10","007","00","210","0003","0000","1496","720","776","146","1642","2507","0","65.50","28.72"
"10","007","00","210","0003","0899","832","393","439","63","895","1357","0","65.95","28.96"
"10","007","00","210","0003","0900","664","327","337","83","747","1150","0","64.96","28.43"
"10","007","00","210","0004","0000","628","326","302","71","699","1019","0","68.60","31.99"
"10","007","00","210","0004","0910","628","326","302","71","699","1019","0","68.60","31.99"
"10","007","00","210","0005","0000","459","263","196","44","503","722","0","69.67","36.43"
"10","007","00","210","0005","0914","459","263","196","44","503","722","0","69.67","36.43"
"10","007","00","210","0006","0000","563","284","279","88","651","995","0","65.43","28.54"
"10","007","00","210","0006","0915","563","284","279","88","651","995","0","65.43","28.54"
"10","007","00","210","0007","0000","618","328","290","70","688","1162","0","59.21","28.23"
"10","007","00","210","0007","0912","618","328","290","70","688","1162","0","59.21","28.23"
"10","007","00","210","0008","0000","394","219","175","52","446","589","0","75.72","37.18"
"10","007","00","210","0008","0913","394","219","175","52","446","589","0","75.72","37.18"
"10","007","00","210","0009","0000","769","426","343","95","864","1288","0","67.08","33.07"
"10","007","00","210","0009","0911","769","426","343","95","864","1288","0","67.08","33.07"
"10","007","00","210","0010","0000","786","418","368","70","856","1264","0","67.72","33.07"
"10","007","00","210","0010","0898","786","418","368","70","856","1264","0","67.72","33.07"
"10","007","00","210","0011","0000","895","478","417","81","976","1467","0","66.53","32.58"
"10","007","00","210","0011","0896","373","199","174","43","416","621","0","66.99","32.05"
"10","007","00","210","0011","0897","522","279","243","38","560","846","0","66.19","32.98"
"10","007","00","210","0012","0000","674","362","312","71","745","1190","0","62.61","30.42"
"10","007","00","210","0012","0892","674","362","312","71","745","1190","0","62.61","30.42"
"10","007","00","210","0013","0000","1055","536","519","104","1159","1630","0","71.10","32.88"
"10","007","00","210","0013","0893","647","347","300","67","714","971","0","73.53","35.74"
"10","007","00","210","0013","0894","408","189","219","37","445","659","0","67.53","28.68"
"10","007","00","210","0014","0000","521","248","273","43","564","922","0","61.17","26.90"
"10","007","00","210","0014","0906","521","248","273","43","564","922","0","61.17","26.90"
"10","007","00","210","0015","0000","576","314","262","83","659","865","0","76.18","36.30"
"10","007","00","210","0015","0907","576","314","262","83","659","865","0","76.18","36.30"
"10","007","00","210","0016","0000","610","373","237","82","692","1307","0","52.95","28.54"
"10","007","00","210","0016","0908","370","229","141","66","436","764","0","57.07","29.97"
"10","007","00","210","0016","0909","240","144","96","16","256","543","0","47.15","26.52"
"10","007","00","210","0017","0000","665","351","314","61","726","1526","0","47.58","23.00"
"10","007","00","210","0017","0902","337","176","161","41","378","609","0","62.07","28.90"
"10","007","00","210","0017","0903","328","175","153","20","348","917","0","37.95","19.08"
"10","007","00","210","0018","0000","160","80","80","18","178","243","0","73.25","32.92"
"10","007","00","210","0018","0904","160","80","80","18","178","243","0","73.25","32.92"
"10","007","00","210","0019","0000","378","214","164","24","402","589","0","68.25","36.33"
"10","007","00","210","0019","0905","378","214","164","24","402","589","0","68.25","36.33"
"10","007","00","210","0020","0000","506","254","252","36","542","877","0","61.80","28.96"
"10","007","00","210","0020","0895","506","254","252","36","542","877","0","61.80","28.96"
"10","007","00","220","0000","0000","13634","7505","6129","2238","15872","24500","29318","64.78","30.63"
"10","007","00","220","0001","0000","1198","662","536","198","1396","2332","0","59.86","28.39"
"10","007","00","220","0001","0916","577","343","234","101","678","1067","0","63.54","32.15"
"10","007","00","220","0001","0917","621","319","302","97","718","1265","0","56.76","25.22"
"10","007","00","220","0002","0000","958","515","443","163","1121","1711","0","65.52","30.10"
"10","007","00","220","0002","0918","535","275","260","97","632","955","0","66.18","28.80"
"10","007","00","220","0002","0919","423","240","183","66","489","756","0","64.68","31.75"
"10","007","00","220","0003","0000","778","480","298","151","929","1512","0","61.44","31.75"
"10","007","00","220","0003","0920","346","225","121","67","413","684","0","60.38","32.89"
"10","007","00","220","0003","0921","432","255","177","84","516","828","0","62.32","30.80"
"10","007","00","220","0004","0000","1299","638","661","234","1533","2164","0","70.84","29.48"
"10","007","00","220","0004","0922","637","319","318","97","734","1063","0","69.05","30.01"
"10","007","00","220","0004","0923","662","319","343","137","799","1101","0","72.57","28.97"
"10","007","00","220","0005","0000","648","349","299","125","773","1206","0","64.10","28.94"
"10","007","00","220","0005","0924","648","349","299","125","773","1206","0","64.10","28.94"
"10","007","00","220","0007","0000","1697","827","870","204","1901","3127","0","60.79","26.45"
"10","007","00","220","0007","0927","551","272","279","51","602","975","0","61.74","27.90"
"10","007","00","220","0007","0928","679","304","375","90","769","1287","0","59.75","23.62"
"10","007","00","220","0007","0929","467","251","216","63","530","865","0","61.27","29.02"
"10","007","00","220","0008","0000","1080","552","528","125","1205","2194","0","54.92","25.16"
"10","007","00","220","0008","0930","412","226","186","38","450","969","0","46.44","23.32"
"10","007","00","220","0008","0931","668","326","342","87","755","1225","0","61.63","26.61"
"10","007","00","220","0009","0000","468","251","217","106","574","715","0","80.28","35.10"
"10","007","00","220","0009","0932","468","251","217","106","574","715","0","80.28","35.10"
"10","007","00","220","0010","0000","351","195","156","49","400","539","0","74.21","36.18"
"10","007","00","220","0010","0933","351","195","156","49","400","539","0","74.21","36.18"
"10","007","00","220","0011","0000","844","459","385","166","1010","1393","0","72.51","32.95"
"10","007","00","220","0011","0934","417","209","208","87","504","702","0","71.79","29.77"
"10","007","00","220","0011","0935","427","250","177","79","506","691","0","73.23","36.18"
"10","007","00","220","0012","0000","549","346","203","105","654","963","0","67.91","35.93"
"10","007","00","220","0012","0936","549","346","203","105","654","963","0","67.91","35.93"
"10","007","00","220","0013","0000","461","268","193","108","569","770","0","73.90","34.81"
"10","007","00","220","0013","0937","461","268","193","108","569","770","0","73.90","34.81"
"10","007","00","220","0014","0000","678","419","259","92","770","1038","0","74.18","40.37"
"10","007","00","220","0014","0938","678","419","259","92","770","1038","0","74.18","40.37"
"10","007","00","220","0015","0000","774","456","318","115","889","1408","0","63.14","32.39"
"10","007","00","220","0015","0939","389","233","156","41","430","686","0","62.68","33.97"
"10","007","00","220","0015","0940","385","223","162","74","459","722","0","63.57","30.89"
"10","007","00","220","0016","0000","531","329","202","84","615","1030","0","59.71","31.94"
"10","007","00","220","0016","0941","531","329","202","84","615","1030","0","59.71","31.94"
"10","007","00","220","0017","0000","422","255","167","51","473","871","0","54.31","29.28"
"10","007","00","220","0017","0942","422","255","167","51","473","871","0","54.31","29.28"
"10","007","00","220","0018","0000","898","504","394","162","1060","1527","0","69.42","33.01"
"10","007","00","220","0018","0925","505","247","258","79","584","876","0","66.67","28.20"
"10","007","00","220","0018","0926","393","257","136","83","476","651","0","73.12","39.48"
"10","007","00","230","0000","0000","14364","8337","6027","2817","17181","27442","31694","62.61","30.38"
"10","007","00","230","0001","0000","495","278","217","145","640","906","0","70.64","30.68"
"10","007","00","230","0001","1031","495","278","217","145","640","906","0","70.64","30.68"
"10","007","00","230","0002","0000","206","120","86","48","254","387","0","65.63","31.01"
"10","007","00","230","0002","1032","206","120","86","48","254","387","0","65.63","31.01"
"10","007","00","230","0003","0000","441","251","190","82","523","703","0","74.40","35.70"
"10","007","00","230","0003","1033","441","251","190","82","523","703","0","74.40","35.70"
"10","007","00","230","0004","0000","258","171","87","72","330","499","0","66.13","34.27"
"10","007","00","230","0004","1034","258","171","87","72","330","499","0","66.13","34.27"
"10","007","00","230","0005","0000","476","254","222","98","574","930","0","61.72","27.31"
"10","007","00","230","0005","1035","476","254","222","98","574","930","0","61.72","27.31"
"10","007","00","230","0006","0000","1195","642","553","177","1372","2003","0","68.50","32.05"
"10","007","00","230","0006","1036","687","369","318","106","793","1184","0","66.98","31.17"
"10","007","00","230","0006","1037","508","273","235","71","579","819","0","70.70","33.33"
"10","007","00","230","0007","0000","635","377","258","155","790","1277","0","61.86","29.52"
"10","007","00","230","0007","1038","334","188","146","91","425","666","0","63.81","28.23"
"10","007","00","230","0007","1039","301","189","112","64","365","611","0","59.74","30.93"
"10","007","00","230","0008","0000","262","161","101","68","330","459","0","71.90","35.08"
"10","007","00","230","0008","1055","262","161","101","68","330","459","0","71.90","35.08"
"10","007","00","230","0009","0000","305","168","137","76","381","600","0","63.50","28.00"
"10","007","00","230","0009","1041","305","168","137","76","381","600","0","63.50","28.00"
"10","007","00","230","0010","0000","496","268","228","85","581","769","0","75.55","34.85"
"10","007","00","230","0010","1042","496","268","228","85","581","769","0","75.55","34.85"
"10","007","00","230","0011","0000","538","305","233","116","654","946","0","69.13","32.24"
"10","007","00","230","0011","1043","538","305","233","116","654","946","0","69.13","32.24"
"10","007","00","230","0012","0000","305","175","130","74","379","541","0","70.06","32.35"
"10","007","00","230","0012","1044","305","175","130","74","379","541","0","70.06","32.35"
"10","007","00","230","0013","0000","306","177","129","77","383","524","0","73.09","33.78"
"10","007","00","230","0013","1045","306","177","129","77","383","524","0","73.09","33.78"
"10","007","00","230","0014","0000","333","215","118","101","434","739","0","58.73","29.09"
"10","007","00","230","0014","1040","333","215","118","101","434","739","0","58.73","29.09"
"10","007","00","230","0015","0000","1067","702","365","233","1300","2024","0","64.23","34.68"
"10","007","00","230","0015","1046","544","382","162","114","658","1018","0","64.64","37.52"
"10","007","00","230","0015","1047","523","320","203","119","642","1006","0","63.82","31.81"
"10","007","00","230","0016","0000","373","232","141","91","464","642","0","72.27","36.14"
"10","007","00","230","0016","1048","373","232","141","91","464","642","0","72.27","36.14"
"10","007","00","230","0017","0000","308","191","117","83","391","698","0","56.02","27.36"
"10","007","00","230","0017","1049","308","191","117","83","391","698","0","56.02","27.36"
"10","007","00","230","0018","0000","310","198","112","79","389","627","0","62.04","31.58"
"10","007","00","230","0018","1052","310","198","112","79","389","627","0","62.04","31.58"
"10","007","00","230","0019","0000","685","427","258","142","827","1235","0","66.96","34.57"
"10","007","00","230","0019","1050","333","199","134","50","383","553","0","69.26","35.99"
"10","007","00","230","0019","1051","352","228","124","92","444","682","0","65.10","33.43"
"10","007","00","230","0020","0000","741","488","253","145","886","1566","0","56.58","31.16"
"10","007","00","230","0020","1053","347","213","134","101","448","839","0","53.40","25.39"
"10","007","00","230","0020","1054","394","275","119","44","438","727","0","60.25","37.83"
"10","007","00","230","0021","0000","802","409","393","100","902","1381","0","65.31","29.62"
"10","007","00","230","0021","1056","633","339","294","70","703","1087","0","64.67","31.19"
"10","007","00","230","0021","1057","169","70","99","30","199","294","0","67.69","23.81"
"10","007","00","230","0022","0000","309","184","125","29","338","998","0","33.87","18.44"
"10","007","00","230","0022","1061","309","184","125","29","338","998","0","33.87","18.44"
"10","007","00","230","0023","0000","1021","556","465","200","1221","1965","0","62.14","28.30"
"10","007","00","230","0023","1058","555","309","246","119","674","1046","0","64.44","29.54"
"10","007","00","230","0023","1059","466","247","219","81","547","919","0","59.52","26.88"
"10","007","00","230","0024","0000","273","150","123","11","284","728","0","39.01","20.60"
"10","007","00","230","0024","1060","273","150","123","11","284","728","0","39.01","20.60"
"10","007","00","230","0025","0000","700","371","329","134","834","1258","0","66.30","29.49"
"10","007","00","230","0025","1062","308","172","136","45","353","530","0","66.60","32.45"
"10","007","00","230","0025","1063","392","199","193","89","481","728","0","66.07","27.34"
"10","007","00","230","0026","0000","1524","867","657","196","1720","3037","0","56.63","28.55"
"10","007","00","230","0026","1064","366","216","150","37","403","828","0","48.67","26.09"
"10","007","00","230","0026","1065","653","365","288","79","732","1151","0","63.60","31.71"
"10","007","00","230","0026","1066","505","286","219","80","585","1058","0","55.29","27.03"
"10","007","00","240","0000","0000","6879","3801","3078","1966","8845","13627","15516","64.91","27.89"
"10","007","00","240","0001","0000","549","318","231","143","692","1020","0","67.84","31.18"
"10","007","00","240","0001","1015","549","318","231","143","692","1020","0","67.84","31.18"
"10","007","00","240","0002","0000","494","260","234","124","618","999","0","61.86","26.03"
"10","007","00","240","0002","1019","211","106","105","64","275","480","0","57.29","22.08"
"10","007","00","240","0002","1020","283","154","129","60","343","519","0","66.09","29.67"
"10","007","00","240","0003","0000","666","335","331","177","843","1248","0","67.55","26.84"
"10","007","00","240","0003","1017","666","335","331","177","843","1248","0","67.55","26.84"
"10","007","00","240","0004","0000","290","140","150","18","308","754","0","40.85","18.57"
"10","007","00","240","0004","1018","290","140","150","18","308","754","0","40.85","18.57"
"10","007","00","240","0005","0000","545","280","265","77","622","940","0","66.17","29.79"
"10","007","00","240","0005","1016","545","280","265","77","622","940","0","66.17","29.79"
"10","007","00","240","0006","0000","528","285","243","162","690","1001","0","68.93","28.47"
"10","007","00","240","0006","1026","528","285","243","162","690","1001","0","68.93","28.47"
"10","007","00","240","0007","0000","694","420","274","218","912","1225","0","74.45","34.29"
"10","007","00","240","0007","1014","694","420","274","218","912","1225","0","74.45","34.29"
"10","007","00","240","0008","0000","386","221","165","126","512","661","0","77.46","33.43"
"10","007","00","240","0008","1021","386","221","165","126","512","661","0","77.46","33.43"
"10","007","00","240","0009","0000","301","190","111","70","371","626","0","59.27","30.35"
"10","007","00","240","0009","1029","301","190","111","70","371","626","0","59.27","30.35"
"10","007","00","240","0010","0000","404","226","178","150","554","975","0","56.82","23.18"
"10","007","00","240","0010","1022","144","74","70","69","213","352","0","60.51","21.02"
"10","007","00","240","0010","1023","260","152","108","81","341","623","0","54.74","24.40"
"10","007","00","240","0011","0000","366","229","137","134","500","814","0","61.43","28.13"
"10","007","00","240","0011","1030","366","229","137","134","500","814","0","61.43","28.13"
"10","007","00","240","0012","0000","627","320","307","193","820","1138","0","72.06","28.12"
"10","007","00","240","0012","1027","627","320","307","193","820","1138","0","72.06","28.12"
"10","007","00","240","0013","0000","411","239","172","163","574","836","0","68.66","28.59"
"10","007","00","240","0013","1028","411","239","172","163","574","836","0","68.66","28.59"
"10","007","00","240","0014","0000","342","204","138","133","475","805","0","59.01","25.34"
"10","007","00","240","0014","1024","342","204","138","133","475","805","0","59.01","25.34"
"10","007","00","240","0015","0000","276","134","142","78","354","585","0","60.51","22.91"
"10","007","00","240","0015","1025","276","134","142","78","354","585","0","60.51","22.91"
"10","007","00","250","0000","0000","7563","4446","3117","1219","8782","12066","14402","72.78","36.85"
"10","007","00","250","0001","0000","717","392","325","107","824","1110","0","74.23","35.32"
"10","007","00","250","0001","1067","717","392","325","107","824","1110","0","74.23","35.32"
"10","007","00","250","0002","0000","1206","639","567","182","1388","1878","0","73.91","34.03"
"10","007","00","250","0002","1068","604","328","276","96","700","929","0","75.35","35.31"
"10","007","00","250","0002","1069","602","311","291","86","688","949","0","72.50","32.77"
"10","007","00","250","0003","0000","480","257","223","73","553","668","0","82.78","38.47"
"10","007","00","250","0003","1070","480","257","223","73","553","668","0","82.78","38.47"
"10","007","00","250","0004","0000","435","266","169","69","504","717","0","70.29","37.10"
"10","007","00","250","0004","1071","435","266","169","69","504","717","0","70.29","37.10"
"10","007","00","250","0005","0000","969","633","336","157","1126","1466","0","76.81","43.18"
"10","007","00","250","0005","1072","494","321","173","84","578","743","0","77.79","43.20"
"10","007","00","250","0005","1073","475","312","163","73","548","723","0","75.80","43.15"
"10","007","00","250","0006","0000","428","272","156","56","484","628","0","77.07","43.31"
"10","007","00","250","0006","1074","428","272","156","56","484","628","0","77.07","43.31"
"10","007","00","250","0007","0000","574","314","260","98","672","1020","0","65.88","30.78"
"10","007","00","250","0007","1075","574","314","260","98","672","1020","0","65.88","30.78"
"10","007","00","250","0008","0000","506","302","204","52","558","1033","0","54.02","29.24"
"10","007","00","250","0008","1076","506","302","204","52","558","1033","0","54.02","29.24"
"10","007","00","250","0009","0000","319","190","129","49","368","444","0","82.88","42.79"
"10","007","00","250","0009","1077","319","190","129","49","368","444","0","82.88","42.79"
"10","007","00","250","0010","0000","454","286","168","130","584","760","0","76.84","37.63"
"10","007","00","250","0010","1078","454","286","168","130","584","760","0","76.84","37.63"
"10","007","00","250","0011","0000","411","242","169","54","465","600","0","77.50","40.33"
"10","007","00","250","0011","1079","411","242","169","54","465","600","0","77.50","40.33"
"10","007","00","250","0012","0000","284","187","97","46","330","503","0","65.61","37.18"
"10","007","00","250","0012","1080","284","187","97","46","330","503","0","65.61","37.18"
"10","007","00","250","0013","0000","454","285","169","80","534","728","0","73.35","39.15"
"10","007","00","250","0013","1081","454","285","169","80","534","728","0","73.35","39.15"
"10","007","00","250","0014","0000","326","181","145","66","392","511","0","76.71","35.42"
"10","007","00","250","0014","1082","326","181","145","66","392","511","0","76.71","35.42"
"10","007","00","260","0000","0000","13571","7851","5720","2079","15650","24359","28685","64.25","32.23"
"10","007","00","260","0001","0000","960","550","410","107","1067","1775","0","60.11","30.99"
"10","007","00","260","0001","0943","417","232","185","42","459","764","0","60.08","30.37"
"10","007","00","260","0001","0944","543","318","225","65","608","1011","0","60.14","31.45"
"10","007","00","260","0002","0000","744","436","308","80","824","1409","0","58.48","30.94"
"10","007","00","260","0002","0953","316","176","140","15","331","619","0","53.47","28.43"
"10","007","00","260","0002","0954","428","260","168","65","493","790","0","62.41","32.91"
"10","007","00","260","0003","0000","526","279","247","109","635","1073","0","59.18","26.00"
"10","007","00","260","0003","0959","526","279","247","109","635","1073","0","59.18","26.00"
"10","007","00","260","0004","0000","878","562","316","149","1027","1447","0","70.97","38.84"
"10","007","00","260","0004","0970","397","261","136","58","455","655","0","69.47","39.85"
"10","007","00","260","0004","0971","481","301","180","91","572","792","0","72.22","38.01"
"10","007","00","260","0005","0000","389","222","167","55","444","683","0","65.01","32.50"
"10","007","00","260","0005","0945","389","222","167","55","444","683","0","65.01","32.50"
"10","007","00","260","0006","0000","728","410","318","130","858","1408","0","60.94","29.12"
"10","007","00","260","0006","0955","389","217","172","77","466","757","0","61.56","28.67"
"10","007","00","260","0006","0956","339","193","146","53","392","651","0","60.22","29.65"
"10","007","00","260","0007","0000","454","289","165","122","576","803","0","71.73","35.99"
"10","007","00","260","0007","0965","454","289","165","122","576","803","0","71.73","35.99"
"10","007","00","260","0008","0000","574","326","248","56","630","867","0","72.66","37.60"
"10","007","00","260","0008","0946","574","326","248","56","630","867","0","72.66","37.60"
"10","007","00","260","0009","0000","1062","597","465","221","1283","1905","0","67.35","31.34"
"10","007","00","260","0009","0957","601","349","252","122","723","1023","0","70.67","34.12"
"10","007","00","260","0009","0958","461","248","213","99","560","882","0","63.49","28.12"
"10","007","00","260","0010","0000","340","213","127","73","413","646","0","63.93","32.97"
"10","007","00","260","0010","0966","340","213","127","73","413","646","0","63.93","32.97"
"10","007","00","260","0011","0000","889","483","406","77","966","1489","0","64.88","32.44"
"10","007","00","260","0011","0947","383","224","159","37","420","610","0","68.85","36.72"
"10","007","00","260","0011","0948","506","259","247","40","546","879","0","62.12","29.47"
"10","007","00","260","0012","0000","955","546","409","184","1139","1739","0","65.50","31.40"
"10","007","00","260","0012","0960","495","289","206","104","599","912","0","65.68","31.69"
"10","007","00","260","0012","0961","460","257","203","80","540","827","0","65.30","31.08"
"10","007","00","260","0013","0000","488","304","184","82","570","799","0","71.34","38.05"
"10","007","00","260","0013","0967","488","304","184","82","570","799","0","71.34","38.05"
"10","007","00","260","0014","0000","980","530","450","111","1091","1765","0","61.81","30.03"
"10","007","00","260","0014","0949","499","260","239","61","560","937","0","59.77","27.75"
"10","007","00","260","0014","0950","481","270","211","50","531","828","0","64.13","32.61"
"10","007","00","260","0015","0000","883","545","338","165","1048","1796","0","58.35","30.35"
"10","007","00","260","0015","0962","403","253","150","89","492","821","0","59.93","30.82"
"10","007","00","260","0015","0963","480","292","188","76","556","975","0","57.03","29.95"
"10","007","00","260","0016","0000","718","413","305","104","822","1220","0","67.38","33.85"
"10","007","00","260","0016","0969","718","413","305","104","822","1220","0","67.38","33.85"
"10","007","00","260","0017","0000","1069","608","461","115","1184","1912","0","61.92","31.80"
"10","007","00","260","0017","0951","595","351","244","56","651","1114","0","58.44","31.51"
"10","007","00","260","0017","0952","474","257","217","59","533","798","0","66.79","32.21"
"10","007","00","260","0018","0000","482","255","227","76","558","822","0","67.88","31.02"
"10","007","00","260","0018","0964","482","255","227","76","558","822","0","67.88","31.02"
"10","007","00","260","0019","0000","452","283","169","63","515","801","0","64.29","35.33"
"10","007","00","260","0019","0968","452","283","169","63","515","801","0","64.29","35.33"
"10","008","00","000","0000","0000","243897","116494","127403","21361","265258","407295","479889","65.13","28.60"
"10","008","00","010","0000","0000","50063","23111","26952","2862","52925","81116","97394","65.25","28.49"
"10","008","00","010","0001","0000","581","283","298","29","610","873","0","69.87","32.42"
"10","008","00","010","0001","0001","581","283","298","29","610","873","0","69.87","32.42"
"10","008","00","010","0002","0000","901","446","455","51","952","1323","0","71.96","33.71"
"10","008","00","010","0002","0002","422","213","209","30","452","603","0","74.96","35.32"
"10","008","00","010","0002","0003","479","233","246","21","500","720","0","69.44","32.36"
"10","008","00","010","0003","0000","535","246","289","34","569","813","0","69.99","30.26"
"10","008","00","010","0003","0004","535","246","289","34","569","813","0","69.99","30.26"
"10","008","00","010","0004","0000","334","167","167","17","351","473","0","74.21","35.31"
"10","008","00","010","0004","0005","334","167","167","17","351","473","0","74.21","35.31"
"10","008","00","010","0005","0000","349","173","176","18","367","536","0","68.47","32.28"
"10","008","00","010","0005","0006","349","173","176","18","367","536","0","68.47","32.28"
"10","008","00","010","0006","0000","237","130","107","12","249","329","0","75.68","39.51"
"10","008","00","010","0006","0007","237","130","107","12","249","329","0","75.68","39.51"
"10","008","00","010","0007","0000","573","278","295","28","601","881","0","68.22","31.56"
"10","008","00","010","0007","0008","573","278","295","28","601","881","0","68.22","31.56"
"10","008","00","010","0008","0000","1682","837","845","92","1774","2500","0","70.96","33.48"
"10","008","00","010","0008","0057","900","481","419","60","960","1298","0","73.96","37.06"
"10","008","00","010","0008","0058","782","356","426","32","814","1202","0","67.72","29.62"
"10","008","00","010","0009","0000","4337","2019","2318","222","4559","6873","0","66.33","29.38"
"10","008","00","010","0009","0059","827","382","445","34","861","1360","0","63.31","28.09"
"10","008","00","010","0009","0060","625","298","327","37","662","987","0","67.07","30.19"
"10","008","00","010","0009","0061","798","377","421","58","856","1259","0","67.99","29.94"
"10","008","00","010","0009","0062","694","295","399","44","738","1144","0","64.51","25.79"
"10","008","00","010","0009","0063","627","311","316","23","650","1027","0","63.29","30.28"
"10","008","00","010","0009","0064","766","356","410","26","792","1096","0","72.26","32.48"
"10","008","00","010","0010","0000","2557","1221","1336","183","2740","4106","0","66.73","29.74"
"10","008","00","010","0010","0033","782","369","413","56","838","1271","0","65.93","29.03"
"10","008","00","010","0010","0034","875","417","458","85","960","1361","0","70.54","30.64"
"10","008","00","010","0010","0035","900","435","465","42","942","1474","0","63.91","29.51"
"10","008","00","010","0011","0000","211","129","82","19","230","347","0","66.28","37.18"
"10","008","00","010","0011","0036","211","129","82","19","230","347","0","66.28","37.18"
"10","008","00","010","0012","0000","3582","1684","1898","181","3763","5918","0","63.59","28.46"
"10","008","00","010","0012","0023","540","276","264","37","577","957","0","60.29","28.84"
"10","008","00","010","0012","0024","500","211","289","36","536","840","0","63.81","25.12"
"10","008","00","010","0012","0025","580","263","317","28","608","885","0","68.70","29.72"
"10","008","00","010","0012","0026","700","341","359","26","726","1145","0","63.41","29.78"
"10","008","00","010","0012","0027","584","276","308","25","609","922","0","66.05","29.93"
"10","008","00","010","0012","0028","678","317","361","29","707","1169","0","60.48","27.12"
"10","008","00","010","0013","0000","1303","724","579","106","1409","1957","0","72.00","37.00"
"10","008","00","010","0013","0029","374","195","179","27","401","556","0","72.12","35.07"
"10","008","00","010","0013","0030","461","280","181","34","495","715","0","69.23","39.16"
"10","008","00","010","0013","0031","468","249","219","45","513","686","0","74.78","36.30"
"10","008","00","010","0014","0000","653","297","356","74","727","985","0","73.81","30.15"
"10","008","00","010","0014","0032","653","297","356","74","727","985","0","73.81","30.15"
"10","008","00","010","0015","0000","3042","1314","1728","117","3159","5198","0","60.77","25.28"
"10","008","00","010","0015","0009","583","229","354","21","604","1057","0","57.14","21.67"
"10","008","00","010","0015","0010","734","315","419","40","774","1152","0","67.19","27.34"
"10","008","00","010","0015","0011","634","318","316","17","651","1113","0","58.49","28.57"
"10","008","00","010","0015","0012","544","211","333","23","567","881","0","64.36","23.95"
"10","008","00","010","0015","0013","547","241","306","16","563","995","0","56.58","24.22"
"10","008","00","010","0016","0000","1674","768","906","87","1761","2612","0","67.42","29.40"
"10","008","00","010","0016","0014","619","299","320","45","664","981","0","67.69","30.48"
"10","008","00","010","0016","0015","378","157","221","17","395","627","0","63.00","25.04"
"10","008","00","010","0016","0016","677","312","365","25","702","1004","0","69.92","31.08"
"10","008","00","010","0017","0000","1284","694","590","105","1389","2046","0","67.89","33.92"
"10","008","00","010","0017","0017","699","365","334","50","749","1099","0","68.15","33.21"
"10","008","00","010","0017","0018","585","329","256","55","640","947","0","67.58","34.74"
"10","008","00","010","0018","0000","2626","1170","1456","152","2778","4325","0","64.23","27.05"
"10","008","00","010","0018","0019","714","316","398","43","757","1071","0","70.68","29.51"
"10","008","00","010","0018","0020","562","254","308","36","598","935","0","63.96","27.17"
"10","008","00","010","0018","0021","700","336","364","31","731","1136","0","64.35","29.58"
"10","008","00","010","0018","0022","650","264","386","42","692","1183","0","58.50","22.32"
"10","008","00","010","0019","0000","1118","582","536","114","1232","1831","0","67.29","31.79"
"10","008","00","010","0019","0083","575","325","250","80","655","956","0","68.51","34.00"
"10","008","00","010","0019","0084","543","257","286","34","577","875","0","65.94","29.37"
"10","008","00","010","0020","0000","410","215","195","16","426","739","0","57.65","29.09"
"10","008","00","010","0020","0081","410","215","195","16","426","739","0","57.65","29.09"
"10","008","00","010","0021","0000","354","216","138","79","433","583","0","74.27","37.05"
"10","008","00","010","0021","0082","354","216","138","79","433","583","0","74.27","37.05"
"10","008","00","010","0022","0000","393","250","143","35","428","999","0","42.84","25.03"
"10","008","00","010","0022","0080","393","250","143","35","428","999","0","42.84","25.03"
"10","008","00","010","0023","0000","3105","1412","1693","167","3272","5259","0","62.22","26.85"
"10","008","00","010","0023","0065","595","275","320","50","645","1014","0","63.61","27.12"
"10","008","00","010","0023","0066","584","276","308","25","609","1017","0","59.88","27.14"
"10","008","00","010","0023","0067","633","297","336","50","683","1026","0","66.57","28.95"
"10","008","00","010","0023","0068","666","290","376","13","679","1062","0","63.94","27.31"
"10","008","00","010","0023","0069","627","274","353","29","656","1140","0","57.54","24.04"
"10","008","00","010","0024","0000","2828","1368","1460","132","2960","4888","0","60.56","27.99"
"10","008","00","010","0024","0070","622","307","315","35","657","1036","0","63.42","29.63"
"10","008","00","010","0024","0071","680","314","366","27","707","1175","0","60.17","26.72"
"10","008","00","010","0024","0072","679","336","343","31","710","1292","0","54.95","26.01"
"10","008","00","010","0024","0073","847","411","436","39","886","1385","0","63.97","29.68"
"10","008","00","010","0025","0000","1678","842","836","85","1763","2753","0","64.04","30.58"
"10","008","00","010","0025","0074","527","262","265","31","558","801","0","69.66","32.71"
"10","008","00","010","0025","0075","646","336","310","32","678","1020","0","66.47","32.94"
"10","008","00","010","0025","0076","505","244","261","22","527","932","0","56.55","26.18"
"10","008","00","010","0026","0000","1737","904","833","132","1869","2929","0","63.81","30.86"
"10","008","00","010","0026","0077","574","307","267","37","611","1035","0","59.03","29.66"
"10","008","00","010","0026","0078","562","281","281","50","612","934","0","65.52","30.09"
"10","008","00","010","0026","0079","601","316","285","45","646","960","0","67.29","32.92"
"10","008","00","010","0027","0000","3587","1271","2316","152","3739","5674","0","65.90","22.40"
"10","008","00","010","0027","0039","529","204","325","21","550","894","0","61.52","22.82"
"10","008","00","010","0027","0040","577","213","364","20","597","896","0","66.63","23.77"
"10","008","00","010","0027","0041","623","204","419","36","659","986","0","66.84","20.69"
"10","008","00","010","0027","0042","654","218","436","28","682","1026","0","66.47","21.25"
"10","008","00","010","0027","0043","691","249","442","22","713","1065","0","66.95","23.38"
"10","008","00","010","0027","0044","513","183","330","25","538","807","0","66.67","22.68"
"10","008","00","010","0028","0000","1549","728","821","79","1628","2351","0","69.25","30.97"
"10","008","00","010","0028","0037","773","368","405","45","818","1104","0","74.09","33.33"
"10","008","00","010","0028","0038","776","360","416","34","810","1247","0","64.96","28.87"
"10","008","00","010","0029","0000","3067","1229","1838","124","3191","4980","0","64.08","24.68"
"10","008","00","010","0029","0045","410","177","233","25","435","616","0","70.62","28.73"
"10","008","00","010","0029","0046","576","216","360","22","598","948","0","63.08","22.78"
"10","008","00","010","0029","0047","705","287","418","19","724","1175","0","61.62","24.43"
"10","008","00","010","0029","0048","676","272","404","33","709","1122","0","63.19","24.24"
"10","008","00","010","0029","0049","700","277","423","25","725","1119","0","64.79","24.75"
"10","008","00","010","0030","0000","2027","1000","1027","141","2168","3192","0","67.92","31.33"
"10","008","00","010","0030","0050","680","346","334","37","717","1047","0","68.48","33.05"
"10","008","00","010","0030","0051","690","343","347","61","751","1097","0","68.46","31.27"
"10","008","00","010","0030","0052","657","311","346","43","700","1048","0","66.79","29.68"
"10","008","00","010","0031","0000","407","114","293","29","436","662","0","65.86","17.22"
"10","008","00","010","0031","0056","407","114","293","29","436","662","0","65.86","17.22"
"10","008","00","010","0032","0000","580","163","417","13","593","914","0","64.88","17.83"
"10","008","00","010","0032","0054","580","163","417","13","593","914","0","64.88","17.83"
"10","008","00","010","0033","0000","475","131","344","24","499","794","0","62.85","16.50"
"10","008","00","010","0033","0055","475","131","344","24","499","794","0","62.85","16.50"
"10","008","00","010","0034","0000","287","106","181","13","300","473","0","63.42","22.41"
"10","008","00","010","0034","0053","287","106","181","13","300","473","0","63.42","22.41"
"10","008","00","020","0000","0000","38236","17718","20518","3286","41522","65414","77340","63.48","27.09"
"10","008","00","020","0001","0000","1464","680","784","137","1601","2475","0","64.69","27.47"
"10","008","00","020","0001","0085","423","203","220","37","460","740","0","62.16","27.43"
"10","008","00","020","0001","0086","460","219","241","43","503","762","0","66.01","28.74"
"10","008","00","020","0001","0087","581","258","323","57","638","973","0","65.57","26.52"
"10","008","00","020","0002","0000","501","251","250","26","527","745","0","70.74","33.69"
"10","008","00","020","0002","0106","501","251","250","26","527","745","0","70.74","33.69"
"10","008","00","020","0003","0000","1672","742","930","118","1790","2836","0","63.12","26.16"
"10","008","00","020","0003","0103","472","200","272","30","502","822","0","61.07","24.33"
"10","008","00","020","0003","0104","521","258","263","47","568","912","0","62.28","28.29"
"10","008","00","020","0003","0105","679","284","395","41","720","1102","0","65.34","25.77"
"10","008","00","020","0004","0000","1255","538","717","89","1344","2385","0","56.35","22.56"
"10","008","00","020","0004","0107","547","234","313","41","588","1179","0","49.87","19.85"
"10","008","00","020","0004","0108","708","304","404","48","756","1206","0","62.69","25.21"
"10","008","00","020","0005","0000","1197","541","656","143","1340","2091","0","64.08","25.87"
"10","008","00","020","0005","0122","629","294","335","80","709","1067","0","66.45","27.55"
"10","008","00","020","0005","0123","568","247","321","63","631","1024","0","61.62","24.12"
"10","008","00","020","0006","0000","660","327","333","36","696","973","0","71.53","33.61"
"10","008","00","020","0006","0127","660","327","333","36","696","973","0","71.53","33.61"
"10","008","00","020","0007","0000","2017","981","1036","173","2190","3526","0","62.11","27.82"
"10","008","00","020","0007","0124","630","302","328","77","707","1078","0","65.58","28.01"
"10","008","00","020","0007","0125","680","354","326","62","742","1197","0","61.99","29.57"
"10","008","00","020","0007","0126","707","325","382","34","741","1251","0","59.23","25.98"
"10","008","00","020","0008","0000","3016","1397","1619","248","3264","5617","0","58.11","24.87"
"10","008","00","020","0008","0128","471","213","258","37","508","905","0","56.13","23.54"
"10","008","00","020","0008","0129","506","238","268","37","543","910","0","59.67","26.15"
"10","008","00","020","0008","0130","508","222","286","36","544","995","0","54.67","22.31"
"10","008","00","020","0008","0131","479","242","237","46","525","845","0","62.13","28.64"
"10","008","00","020","0008","0132","536","252","284","49","585","980","0","59.69","25.71"
"10","008","00","020","0008","0133","516","230","286","43","559","982","0","56.92","23.42"
"10","008","00","020","0009","0000","598","306","292","64","662","896","0","73.88","34.15"
"10","008","00","020","0009","0134","598","306","292","64","662","896","0","73.88","34.15"
"10","008","00","020","0010","0000","4030","1791","2239","295","4325","7243","0","59.71","24.73"
"10","008","00","020","0010","0090","700","330","370","78","778","1229","0","63.30","26.85"
"10","008","00","020","0010","0091","423","173","250","37","460","817","0","56.30","21.18"
"10","008","00","020","0010","0092","692","341","351","61","753","1272","0","59.20","26.81"
"10","008","00","020","0010","0093","752","275","477","31","783","1283","0","61.03","21.43"
"10","008","00","020","0010","0094","729","323","406","46","775","1359","0","57.03","23.77"
"10","008","00","020","0010","0095","734","349","385","42","776","1283","0","60.48","27.20"
"10","008","00","020","0011","0000","2113","974","1139","187","2300","3701","0","62.15","26.32"
"10","008","00","020","0011","0096","654","267","387","42","696","1119","0","62.20","23.86"
"10","008","00","020","0011","0097","628","310","318","37","665","1172","0","56.74","26.45"
"10","008","00","020","0011","0098","286","145","141","31","317","492","0","64.43","29.47"
"10","008","00","020","0011","0099","545","252","293","77","622","918","0","67.76","27.45"
"10","008","00","020","0012","0000","509","231","278","35","544","972","0","55.97","23.77"
"10","008","00","020","0012","0100","509","231","278","35","544","972","0","55.97","23.77"
"10","008","00","020","0013","0000","673","325","348","79","752","1072","0","70.15","30.32"
"10","008","00","020","0013","0101","673","325","348","79","752","1072","0","70.15","30.32"
"10","008","00","020","0014","0000","606","250","356","53","659","1055","0","62.46","23.70"
"10","008","00","020","0014","0102","606","250","356","53","659","1055","0","62.46","23.70"
"10","008","00","020","0015","0000","582","252","330","69","651","961","0","67.74","26.22"
"10","008","00","020","0015","0135","582","252","330","69","651","961","0","67.74","26.22"
"10","008","00","020","0016","0000","112","54","58","11","123","273","0","45.05","19.78"
"10","008","00","020","0016","0136","112","54","58","11","123","273","0","45.05","19.78"
"10","008","00","020","0017","0000","780","393","387","77","857","1294","0","66.23","30.37"
"10","008","00","020","0017","0137","780","393","387","77","857","1294","0","66.23","30.37"
"10","008","00","020","0018","0000","798","364","434","81","879","1361","0","64.58","26.75"
"10","008","00","020","0018","0138","411","182","229","35","446","657","0","67.88","27.70"
"10","008","00","020","0018","0139","387","182","205","46","433","704","0","61.51","25.85"
"10","008","00","020","0019","0000","978","461","517","70","1048","1599","0","65.54","28.83"
"10","008","00","020","0019","0140","467","224","243","39","506","721","0","70.18","31.07"
"10","008","00","020","0019","0141","511","237","274","31","542","878","0","61.73","26.99"
"10","008","00","020","0020","0000","797","363","434","78","875","1281","0","68.31","28.34"
"10","008","00","020","0020","0142","585","259","326","68","653","913","0","71.52","28.37"
"10","008","00","020","0020","0143","212","104","108","10","222","368","0","60.33","28.26"
"10","008","00","020","0021","0000","427","215","212","39","466","642","0","72.59","33.49"
"10","008","00","020","0021","0144","427","215","212","39","466","642","0","72.59","33.49"
"10","008","00","020","0022","0000","668","242","426","62","730","930","0","78.49","26.02"
"10","008","00","020","0022","0145","668","242","426","62","730","930","0","78.49","26.02"
"10","008","00","020","0023","0000","624","301","323","94","718","1086","0","66.11","27.72"
"10","008","00","020","0023","0148","624","301","323","94","718","1086","0","66.11","27.72"
"10","008","00","020","0024","0000","337","146","191","33","370","545","0","67.89","26.79"
"10","008","00","020","0024","0149","337","146","191","33","370","545","0","67.89","26.79"
"10","008","00","020","0025","0000","599","321","278","40","639","928","0","68.86","34.59"
"10","008","00","020","0025","0150","599","321","278","40","639","928","0","68.86","34.59"
"10","008","00","020","0026","0000","1712","891","821","218","1930","2717","0","71.03","32.79"
"10","008","00","020","0026","0151","546","311","235","74","620","893","0","69.43","34.83"
"10","008","00","020","0026","0152","585","285","300","70","655","870","0","75.29","32.76"
"10","008","00","020","0026","0153","581","295","286","74","655","954","0","68.66","30.92"
"10","008","00","020","0027","0000","987","484","503","54","1041","1659","0","62.75","29.17"
"10","008","00","020","0027","0117","433","254","179","22","455","721","0","63.11","35.23"
"10","008","00","020","0027","0118","554","230","324","32","586","938","0","62.47","24.52"
"10","008","00","020","0028","0000","1258","633","625","107","1365","2430","0","56.17","26.05"
"10","008","00","020","0028","0119","548","254","294","45","593","1133","0","52.34","22.42"
"10","008","00","020","0028","0120","474","242","232","48","522","894","0","58.39","27.07"
"10","008","00","020","0028","0121","236","137","99","14","250","403","0","62.03","34.00"
"10","008","00","020","0029","0000","941","537","404","159","1100","1548","0","71.06","34.69"
"10","008","00","020","0029","0146","797","445","352","130","927","1258","0","73.69","35.37"
"10","008","00","020","0029","0147","144","92","52","29","173","290","0","59.66","31.72"
"10","008","00","020","0030","0000","1889","823","1066","116","2005","3022","0","66.35","27.23"
"10","008","00","020","0030","0109","570","230","340","33","603","914","0","65.97","25.16"
"10","008","00","020","0030","0110","672","311","361","48","720","1103","0","65.28","28.20"
"10","008","00","020","0030","0111","647","282","365","35","682","1005","0","67.86","28.06"
"10","008","00","020","0031","0000","1464","616","848","86","1550","2496","0","62.10","24.68"
"10","008","00","020","0031","0088","718","311","407","33","751","1278","0","58.76","24.33"
"10","008","00","020","0031","0089","746","305","441","53","799","1218","0","65.60","25.04"
"10","008","00","020","0032","0000","1760","792","968","121","1881","3045","0","61.77","26.01"
"10","008","00","020","0032","0112","540","239","301","27","567","985","0","57.56","24.26"
"10","008","00","020","0032","0113","566","262","304","49","615","1005","0","61.19","26.07"
"10","008","00","020","0032","0114","654","291","363","45","699","1055","0","66.26","27.58"
"10","008","00","020","0033","0000","1212","496","716","88","1300","2010","0","64.68","24.68"
"10","008","00","020","0033","0115","623","236","387","41","664","1028","0","64.59","22.96"
"10","008","00","020","0033","0116","589","260","329","47","636","982","0","64.77","26.48"
"10","008","00","030","0000","0000","48170","23527","24643","3550","51720","81043","96450","63.82","29.03"
"10","008","00","030","0001","0000","1294","593","701","66","1360","2020","0","67.33","29.36"
"10","008","00","030","0001","0154","601","298","303","33","634","933","0","67.95","31.94"
"10","008","00","030","0001","0155","693","295","398","33","726","1087","0","66.79","27.14"
"10","008","00","030","0002","0000","1135","552","583","76","1211","1978","0","61.22","27.91"
"10","008","00","030","0002","0159","542","250","292","41","583","992","0","58.77","25.20"
"10","008","00","030","0002","0160","593","302","291","35","628","986","0","63.69","30.63"
"10","008","00","030","0003","0000","645","330","315","56","701","1030","0","68.06","32.04"
"10","008","00","030","0003","0162","645","330","315","56","701","1030","0","68.06","32.04"
"10","008","00","030","0004","0000","3710","1747","1963","244","3954","6264","0","63.12","27.89"
"10","008","00","030","0004","0165","718","343","375","56","774","1209","0","64.02","28.37"
"10","008","00","030","0004","0166","672","297","375","64","736","1202","0","61.23","24.71"
"10","008","00","030","0004","0167","664","327","337","28","692","1204","0","57.48","27.16"
"10","008","00","030","0004","0168","863","416","447","52","915","1422","0","64.35","29.25"
"10","008","00","030","0004","0169","793","364","429","44","837","1227","0","68.22","29.67"
"10","008","00","030","0005","0000","4378","1919","2459","222","4600","7399","0","62.17","25.94"
"10","008","00","030","0005","0170","739","356","383","41","780","1204","0","64.78","29.57"
"10","008","00","030","0005","0171","676","287","389","34","710","1204","0","58.97","23.84"
"10","008","00","030","0005","0172","649","275","374","32","681","1141","0","59.68","24.10"
"10","008","00","030","0005","0173","652","272","380","35","687","1136","0","60.48","23.94"
"10","008","00","030","0005","0174","872","368","504","29","901","1402","0","64.27","26.25"
"10","008","00","030","0005","0175","790","361","429","51","841","1312","0","64.10","27.52"
"10","008","00","030","0006","0000","3767","1866","1901","216","3983","6563","0","60.69","28.43"
"10","008","00","030","0006","0210","922","445","477","59","981","1570","0","62.48","28.34"
"10","008","00","030","0006","0211","732","364","368","57","789","1275","0","61.88","28.55"
"10","008","00","030","0006","0212","582","290","292","24","606","973","0","62.28","29.80"
"10","008","00","030","0006","0213","492","249","243","36","528","995","0","53.07","25.03"
"10","008","00","030","0006","0214","659","305","354","25","684","1114","0","61.40","27.38"
"10","008","00","030","0006","0215","380","213","167","15","395","636","0","62.11","33.49"
"10","008","00","030","0007","0000","3321","1655","1666","210","3531","5921","0","59.64","27.95"
"10","008","00","030","0007","0191","818","383","435","58","876","1374","0","63.76","27.87"
"10","008","00","030","0007","0192","658","315","343","41","699","1121","0","62.36","28.10"
"10","008","00","030","0007","0193","720","372","348","45","765","1293","0","59.16","28.77"
"10","008","00","030","0007","0194","497","259","238","30","527","820","0","64.27","31.59"
"10","008","00","030","0007","0195","628","326","302","36","664","1313","0","50.57","24.83"
"10","008","00","030","0008","0000","2290","1206","1084","195","2485","3904","0","63.65","30.89"
"10","008","00","030","0008","0196","554","288","266","47","601","968","0","62.09","29.75"
"10","008","00","030","0008","0197","602","274","328","49","651","1031","0","63.14","26.58"
"10","008","00","030","0008","0198","558","320","238","56","614","956","0","64.23","33.47"
"10","008","00","030","0008","0199","576","324","252","43","619","949","0","65.23","34.14"
"10","008","00","030","0009","0000","2559","1232","1327","212","2771","4437","0","62.45","27.77"
"10","008","00","030","0009","0182","583","294","289","47","630","1018","0","61.89","28.88"
"10","008","00","030","0009","0183","600","268","332","60","660","1022","0","64.58","26.22"
"10","008","00","030","0009","0184","655","332","323","46","701","1148","0","61.06","28.92"
"10","008","00","030","0009","0185","721","338","383","59","780","1249","0","62.45","27.06"
"10","008","00","030","0010","0000","1530","676","854","100","1630","2408","0","67.69","28.07"
"10","008","00","030","0010","0186","917","412","505","65","982","1398","0","70.24","29.47"
"10","008","00","030","0010","0187","613","264","349","35","648","1010","0","64.16","26.14"
"10","008","00","030","0011","0000","1602","746","856","145","1747","2793","0","62.55","26.71"
"10","008","00","030","0011","0188","628","282","346","63","691","1042","0","66.31","27.06"
"10","008","00","030","0011","0189","460","219","241","52","512","821","0","62.36","26.67"
"10","008","00","030","0011","0190","514","245","269","30","544","930","0","58.49","26.34"
"10","008","00","030","0012","0000","1884","832","1052","121","2005","3071","0","65.29","27.09"
"10","008","00","030","0012","0179","702","296","406","56","758","1106","0","68.54","26.76"
"10","008","00","030","0012","0180","584","274","310","41","625","988","0","63.26","27.73"
"10","008","00","030","0012","0181","598","262","336","24","622","977","0","63.66","26.82"
"10","008","00","030","0013","0000","2102","1104","998","154","2256","3631","0","62.13","30.40"
"10","008","00","030","0013","0200","711","386","325","50","761","1172","0","64.93","32.94"
"10","008","00","030","0013","0201","673","319","354","35","708","1087","0","65.13","29.35"
"10","008","00","030","0013","0202","718","399","319","69","787","1372","0","57.36","29.08"
"10","008","00","030","0014","0000","1754","924","830","133","1887","2888","0","65.34","31.99"
"10","008","00","030","0014","0207","627","326","301","45","672","935","0","71.87","34.87"
"10","008","00","030","0014","0208","477","241","236","35","512","931","0","54.99","25.89"
"10","008","00","030","0014","0209","650","357","293","53","703","1022","0","68.79","34.93"
"10","008","00","030","0015","0000","831","407","424","37","868","1451","0","59.82","28.05"
"10","008","00","030","0015","0205","411","207","204","17","428","738","0","57.99","28.05"
"10","008","00","030","0015","0206","420","200","220","20","440","713","0","61.71","28.05"
"10","008","00","030","0016","0000","1485","797","688","115","1600","2160","0","74.07","36.90"
"10","008","00","030","0016","0203","621","328","293","53","674","894","0","75.39","36.69"
"10","008","00","030","0016","0204","864","469","395","62","926","1266","0","73.14","37.05"
"10","008","00","030","0017","0000","1058","574","484","106","1164","1740","0","66.90","32.99"
"10","008","00","030","0017","0216","381","203","178","30","411","642","0","64.02","31.62"
"10","008","00","030","0017","0217","400","225","175","36","436","633","0","68.88","35.55"
"10","008","00","030","0017","0218","277","146","131","40","317","465","0","68.17","31.40"
"10","008","00","030","0018","0000","1243","666","577","136","1379","1961","0","70.32","33.96"
"10","008","00","030","0018","0219","675","345","330","88","763","1116","0","68.37","30.91"
"10","008","00","030","0018","0220","568","321","247","48","616","845","0","72.90","37.99"
"10","008","00","030","0019","0000","2294","1215","1079","195","2489","4002","0","62.19","30.36"
"10","008","00","030","0019","0221","580","309","271","45","625","1061","0","58.91","29.12"
"10","008","00","030","0019","0222","531","286","245","43","574","922","0","62.26","31.02"
"10","008","00","030","0019","0223","582","289","293","46","628","965","0","65.08","29.95"
"10","008","00","030","0019","0224","601","331","270","61","662","1054","0","62.81","31.40"
"10","008","00","030","0020","0000","847","389","458","90","937","1591","0","58.89","24.45"
"10","008","00","030","0020","0226","343","161","182","33","376","628","0","59.87","25.64"
"10","008","00","030","0020","0227","504","228","276","57","561","963","0","58.26","23.68"
"10","008","00","030","0021","0000","609","293","316","81","690","978","0","70.55","29.96"
"10","008","00","030","0021","0225","609","293","316","81","690","978","0","70.55","29.96"
"10","008","00","030","0022","0000","1266","670","596","171","1437","2175","0","66.07","30.80"
"10","008","00","030","0022","0229","616","343","273","91","707","1129","0","62.62","30.38"
"10","008","00","030","0022","0230","650","327","323","80","730","1046","0","69.79","31.26"
"10","008","00","030","0023","0000","696","294","402","105","801","1034","0","77.47","28.43"
"10","008","00","030","0023","0228","696","294","402","105","801","1034","0","77.47","28.43"
"10","008","00","030","0024","0000","426","206","220","33","459","637","0","72.06","32.34"
"10","008","00","030","0024","0161","426","206","220","33","459","637","0","72.06","32.34"
"10","008","00","030","0025","0000","1349","709","640","95","1444","2276","0","63.44","31.15"
"10","008","00","030","0025","0163","650","328","322","38","688","1098","0","62.66","29.87"
"10","008","00","030","0025","0164","699","381","318","57","756","1178","0","64.18","32.34"
"10","008","00","030","0026","0000","2088","971","1117","116","2204","3595","0","61.31","27.01"
"10","008","00","030","0026","0156","792","380","412","52","844","1360","0","62.06","27.94"
"10","008","00","030","0026","0157","595","289","306","34","629","1041","0","60.42","27.76"
"10","008","00","030","0026","0158","701","302","399","30","731","1194","0","61.22","25.29"
"10","008","00","030","0027","0000","2007","954","1053","120","2127","3136","0","67.83","30.42"
"10","008","00","030","0027","0176","616","320","296","41","657","949","0","69.23","33.72"
"10","008","00","030","0027","0177","819","351","468","50","869","1302","0","66.74","26.96"
"10","008","00","030","0027","0178","572","283","289","29","601","885","0","67.91","31.98"
"10","008","00","040","0000","0000","25890","12905","12985","2475","28365","44452","51943","63.81","29.03"
"10","008","00","040","0001","0000","1174","565","609","100","1274","1875","0","67.95","30.13"
"10","008","00","040","0001","0231","683","332","351","56","739","1104","0","66.94","30.07"
"10","008","00","040","0001","0232","491","233","258","44","535","771","0","69.39","30.22"
"10","008","00","040","0002","0000","334","185","149","33","367","573","0","64.05","32.29"
"10","008","00","040","0002","0233","334","185","149","33","367","573","0","64.05","32.29"
"10","008","00","040","0003","0000","2578","1240","1338","174","2752","4484","0","61.37","27.65"
"10","008","00","040","0003","0234","497","247","250","27","524","848","0","61.79","29.13"
"10","008","00","040","0003","0235","623","320","303","46","669","1112","0","60.16","28.78"
"10","008","00","040","0003","0236","645","293","352","51","696","1179","0","59.03","24.85"
"10","008","00","040","0003","0237","813","380","433","50","863","1345","0","64.16","28.25"
"10","008","00","040","0004","0000","1931","894","1037","139","2070","3364","0","61.53","26.58"
"10","008","00","040","0004","0238","611","288","323","62","673","1081","0","62.26","26.64"
"10","008","00","040","0004","0239","559","291","268","36","595","1019","0","58.39","28.56"
"10","008","00","040","0004","0240","761","315","446","41","802","1264","0","63.45","24.92"
"10","008","00","040","0005","0000","1054","516","538","85","1139","1746","0","65.23","29.55"
"10","008","00","040","0005","0272","472","245","227","52","524","761","0","68.86","32.19"
"10","008","00","040","0005","0273","582","271","311","33","615","985","0","62.44","27.51"
"10","008","00","040","0006","0000","609","287","322","49","658","1135","0","57.97","25.29"
"10","008","00","040","0006","0246","256","138","118","20","276","465","0","59.35","29.68"
"10","008","00","040","0006","0247","353","149","204","29","382","670","0","57.01","22.24"
"10","008","00","040","0007","0000","2033","1020","1013","196","2229","3527","0","63.20","28.92"
"10","008","00","040","0007","0243","722","360","362","69","791","1241","0","63.74","29.01"
"10","008","00","040","0007","0244","727","350","377","84","811","1268","0","63.96","27.60"
"10","008","00","040","0007","0245","584","310","274","43","627","1018","0","61.59","30.45"
"10","008","00","040","0008","0000","508","324","184","33","541","865","0","62.54","37.46"
"10","008","00","040","0008","0248","508","324","184","33","541","865","0","62.54","37.46"
"10","008","00","040","0009","0000","759","375","384","89","848","1374","0","61.72","27.29"
"10","008","00","040","0009","0249","759","375","384","89","848","1374","0","61.72","27.29"
"10","008","00","040","0010","0000","526","245","281","71","597","843","0","70.82","29.06"
"10","008","00","040","0010","0274","211","122","89","39","250","351","0","71.23","34.76"
"10","008","00","040","0010","0275","315","123","192","32","347","492","0","70.53","25.00"
"10","008","00","040","0011","0000","1590","862","728","164","1754","2674","0","65.59","32.24"
"10","008","00","040","0011","0262","723","377","346","63","786","1256","0","62.58","30.02"
"10","008","00","040","0011","0263","554","293","261","52","606","901","0","67.26","32.52"
"10","008","00","040","0011","0264","313","192","121","49","362","517","0","70.02","37.14"
"10","008","00","040","0012","0000","908","452","456","127","1035","1612","0","64.21","28.04"
"10","008","00","040","0012","0260","477","224","253","70","547","853","0","64.13","26.26"
"10","008","00","040","0012","0261","431","228","203","57","488","759","0","64.30","30.04"
"10","008","00","040","0013","0000","452","247","205","64","516","795","0","64.91","31.07"
"10","008","00","040","0013","0265","452","247","205","64","516","795","0","64.91","31.07"
"10","008","00","040","0014","0000","2714","1313","1401","213","2927","4699","0","62.29","27.94"
"10","008","00","040","0014","0253","792","369","423","45","837","1389","0","60.26","26.57"
"10","008","00","040","0014","0254","746","377","369","65","811","1251","0","64.83","30.14"
"10","008","00","040","0014","0255","603","279","324","44","647","1044","0","61.97","26.72"
"10","008","00","040","0014","0256","573","288","285","59","632","1015","0","62.27","28.37"
"10","008","00","040","0015","0000","1021","522","499","86","1107","1744","0","63.47","29.93"
"10","008","00","040","0015","0266","627","326","301","51","678","1119","0","60.59","29.13"
"10","008","00","040","0015","0267","394","196","198","35","429","625","0","68.64","31.36"
"10","008","00","040","0016","0000","749","383","366","112","861","1265","0","68.06","30.28"
"10","008","00","040","0016","0268","749","383","366","112","861","1265","0","68.06","30.28"
"10","008","00","040","0017","0000","633","324","309","68","701","1083","0","64.73","29.92"
"10","008","00","040","0017","0269","633","324","309","68","701","1083","0","64.73","29.92"
"10","008","00","040","0018","0000","354","174","180","48","402","571","0","70.40","30.47"
"10","008","00","040","0018","0270","354","174","180","48","402","571","0","70.40","30.47"
"10","008","00","040","0019","0000","173","85","88","7","180","376","0","47.87","22.61"
"10","008","00","040","0019","0252","173","85","88","7","180","376","0","47.87","22.61"
"10","008","00","040","0020","0000","333","154","179","66","399","545","0","73.21","28.26"
"10","008","00","040","0020","0271","333","154","179","66","399","545","0","73.21","28.26"
"10","008","00","040","0021","0000","360","183","177","49","409","558","0","73.30","32.80"
"10","008","00","040","0021","0276","101","41","60","8","109","172","0","63.37","23.84"
"10","008","00","040","0021","0277","259","142","117","41","300","386","0","77.72","36.79"
"10","008","00","040","0022","0000","412","230","182","52","464","696","0","66.67","33.05"
"10","008","00","040","0022","0278","265","151","114","29","294","435","0","67.59","34.71"
"10","008","00","040","0022","0279","147","79","68","23","170","261","0","65.13","30.27"
"10","008","00","040","0023","0000","339","192","147","40","379","554","0","68.41","34.66"
"10","008","00","040","0023","0281","339","192","147","40","379","554","0","68.41","34.66"
"10","008","00","040","0024","0000","251","143","108","24","275","432","0","63.66","33.10"
"10","008","00","040","0024","0280","251","143","108","24","275","432","0","63.66","33.10"
"10","008","00","040","0025","0000","383","217","166","75","458","809","0","56.61","26.82"
"10","008","00","040","0025","0282","234","141","93","64","298","455","0","65.49","30.99"
"10","008","00","040","0025","0283","149","76","73","11","160","354","0","45.20","21.47"
"10","008","00","040","0026","0000","367","191","176","52","419","627","0","66.83","30.46"
"10","008","00","040","0026","0250","107","56","51","16","123","193","0","63.73","29.02"
"10","008","00","040","0026","0251","260","135","125","36","296","434","0","68.20","31.11"
"10","008","00","040","0027","0000","2083","1009","1074","168","2251","3460","0","65.06","29.16"
"10","008","00","040","0027","0257","776","363","413","32","808","1275","0","63.37","28.47"
"10","008","00","040","0027","0258","585","295","290","56","641","1000","0","64.10","29.50"
"10","008","00","040","0027","0259","722","351","371","80","802","1185","0","67.68","29.62"
"10","008","00","040","0028","0000","1262","573","689","91","1353","2166","0","62.47","26.45"
"10","008","00","040","0028","0241","609","276","333","57","666","1045","0","63.73","26.41"
"10","008","00","040","0028","0242","653","297","356","34","687","1121","0","61.28","26.49"
"10","008","00","050","0000","0000","5628","2740","2888","529","6157","8932","10111","68.93","30.68"
"10","008","00","050","0001","0000","713","305","408","62","775","1032","0","75.10","29.55"
"10","008","00","050","0001","0284","713","305","408","62","775","1032","0","75.10","29.55"
"10","008","00","050","0002","0000","551","282","269","46","597","860","0","69.42","32.79"
"10","008","00","050","0002","0285","551","282","269","46","597","860","0","69.42","32.79"
"10","008","00","050","0003","0000","342","164","178","38","380","535","0","71.03","30.65"
"10","008","00","050","0003","0286","342","164","178","38","380","535","0","71.03","30.65"
"10","008","00","050","0004","0000","696","366","330","80","776","1086","0","71.45","33.70"
"10","008","00","050","0004","0287","378","192","186","47","425","584","0","72.77","32.88"
"10","008","00","050","0004","0288","318","174","144","33","351","502","0","69.92","34.66"
"10","008","00","050","0005","0000","183","100","83","12","195","452","0","43.14","22.12"
"10","008","00","050","0005","0289","183","100","83","12","195","452","0","43.14","22.12"
"10","008","00","050","0006","0000","336","173","163","32","368","454","0","81.06","38.11"
"10","008","00","050","0006","0290","336","173","163","32","368","454","0","81.06","38.11"
"10","008","00","050","0007","0000","612","295","317","60","672","846","0","79.43","34.87"
"10","008","00","050","0007","0291","612","295","317","60","672","846","0","79.43","34.87"
"10","008","00","050","0008","0000","880","420","460","95","975","1372","0","71.06","30.61"
"10","008","00","050","0008","0292","444","210","234","40","484","731","0","66.21","28.73"
"10","008","00","050","0008","0293","436","210","226","55","491","641","0","76.60","32.76"
"10","008","00","050","0009","0000","619","305","314","63","682","920","0","74.13","33.15"
"10","008","00","050","0009","0294","619","305","314","63","682","920","0","74.13","33.15"
"10","008","00","050","0010","0000","217","113","104","3","220","526","0","41.83","21.48"
"10","008","00","050","0010","0297","217","113","104","3","220","526","0","41.83","21.48"
"10","008","00","050","0011","0000","479","217","262","38","517","849","0","60.90","25.56"
"10","008","00","050","0011","0295","289","133","156","32","321","460","0","69.78","28.91"
"10","008","00","050","0011","0296","190","84","106","6","196","389","0","50.39","21.59"
"10","008","00","060","0000","0000","19469","10315","9154","2300","21769","31501","36274","69.11","32.74"
"10","008","00","060","0001","0000","602","283","319","41","643","958","0","67.12","29.54"
"10","008","00","060","0001","0298","602","283","319","41","643","958","0","67.12","29.54"
"10","008","00","060","0002","0000","2025","979","1046","178","2203","3264","0","67.49","29.99"
"10","008","00","060","0002","0299","496","235","261","54","550","871","0","63.15","26.98"
"10","008","00","060","0002","0300","403","193","210","22","425","657","0","64.69","29.38"
"10","008","00","060","0002","0301","528","260","268","62","590","832","0","70.91","31.25"
"10","008","00","060","0002","0302","598","291","307","40","638","904","0","70.58","32.19"
"10","008","00","060","0003","0000","1270","659","611","141","1411","2117","0","66.65","31.13"
"10","008","00","060","0003","0303","565","279","286","48","613","1011","0","60.63","27.60"
"10","008","00","060","0003","0304","705","380","325","93","798","1106","0","72.15","34.36"
"10","008","00","060","0004","0000","880","481","399","134","1014","1486","0","68.24","32.37"
"10","008","00","060","0004","0305","428","240","188","63","491","750","0","65.47","32.00"
"10","008","00","060","0004","0306","452","241","211","71","523","736","0","71.06","32.74"
"10","008","00","060","0005","0000","565","309","256","109","674","925","0","72.86","33.41"
"10","008","00","060","0005","0308","565","309","256","109","674","925","0","72.86","33.41"
"10","008","00","060","0006","0000","626","337","289","74","700","937","0","74.71","35.97"
"10","008","00","060","0006","0307","626","337","289","74","700","937","0","74.71","35.97"
"10","008","00","060","0007","0000","2411","1262","1149","211","2622","4069","0","64.44","31.01"
"10","008","00","060","0007","0309","551","286","265","60","611","916","0","66.70","31.22"
"10","008","00","060","0007","0310","629","321","308","57","686","990","0","69.29","32.42"
"10","008","00","060","0007","0311","562","306","256","48","610","965","0","63.21","31.71"
"10","008","00","060","0007","0312","669","349","320","46","715","1198","0","59.68","29.13"
"10","008","00","060","0008","0000","920","473","447","140","1060","1548","0","68.48","30.56"
"10","008","00","060","0008","0313","398","206","192","68","466","689","0","67.63","29.90"
"10","008","00","060","0008","0314","522","267","255","72","594","859","0","69.15","31.08"
"10","008","00","060","0009","0000","612","326","286","75","687","892","0","77.02","36.55"
"10","008","00","060","0009","0316","612","326","286","75","687","892","0","77.02","36.55"
"10","008","00","060","0010","0000","754","431","323","101","855","1194","0","71.61","36.10"
"10","008","00","060","0010","0317","754","431","323","101","855","1194","0","71.61","36.10"
"10","008","00","060","0011","0000","1145","682","463","122","1267","1746","0","72.57","39.06"
"10","008","00","060","0011","0319","591","343","248","65","656","919","0","71.38","37.32"
"10","008","00","060","0011","0320","554","339","215","57","611","827","0","73.88","40.99"
"10","008","00","060","0012","0000","617","338","279","77","694","887","0","78.24","38.11"
"10","008","00","060","0012","0321","617","338","279","77","694","887","0","78.24","38.11"
"10","008","00","060","0013","0000","335","190","145","37","372","692","0","53.76","27.46"
"10","008","00","060","0013","0318","335","190","145","37","372","692","0","53.76","27.46"
"10","008","00","060","0014","0000","536","304","232","72","608","864","0","70.37","35.19"
"10","008","00","060","0014","0324","536","304","232","72","608","864","0","70.37","35.19"
"10","008","00","060","0015","0000","659","371","288","96","755","1106","0","68.26","33.54"
"10","008","00","060","0015","0322","386","209","177","55","441","619","0","71.24","33.76"
"10","008","00","060","0015","0323","273","162","111","41","314","487","0","64.48","33.26"
"10","008","00","060","0016","0000","803","458","345","81","884","1489","0","59.37","30.76"
"10","008","00","060","0016","0325","567","312","255","52","619","1073","0","57.69","29.08"
"10","008","00","060","0016","0326","236","146","90","29","265","416","0","63.70","35.10"
"10","008","00","060","0017","0000","948","530","418","129","1077","1411","0","76.33","37.56"
"10","008","00","060","0017","0327","554","304","250","92","646","837","0","77.18","36.32"
"10","008","00","060","0017","0328","394","226","168","37","431","574","0","75.09","39.37"
"10","008","00","060","0018","0000","691","372","319","95","786","1095","0","71.78","33.97"
"10","008","00","060","0018","0329","691","372","319","95","786","1095","0","71.78","33.97"
"10","008","00","060","0019","0000","537","275","262","76","613","811","0","75.59","33.91"
"10","008","00","060","0019","0331","537","275","262","76","613","811","0","75.59","33.91"
"10","008","00","060","0020","0000","506","244","262","93","599","815","0","73.50","29.94"
"10","008","00","060","0020","0330","506","244","262","93","599","815","0","73.50","29.94"
"10","008","00","060","0021","0000","428","221","207","60","488","707","0","69.02","31.26"
"10","008","00","060","0021","0332","428","221","207","60","488","707","0","69.02","31.26"
"10","008","00","060","0022","0000","1032","547","485","112","1144","1668","0","68.59","32.79"
"10","008","00","060","0022","0333","440","225","215","35","475","722","0","65.79","31.16"
"10","008","00","060","0022","0334","592","322","270","77","669","946","0","70.72","34.04"
"10","008","00","060","0023","0000","567","243","324","46","613","820","0","74.76","29.63"
"10","008","00","060","0023","0315","567","243","324","46","613","820","0","74.76","29.63"
"10","008","00","070","0000","0000","8428","3939","4489","882","9310","14821","16520","62.82","26.58"
"10","008","00","070","0001","0000","1041","487","554","102","1143","1752","0","65.24","27.80"
"10","008","00","070","0001","0335","520","224","296","50","570","900","0","63.33","24.89"
"10","008","00","070","0001","0336","521","263","258","52","573","852","0","67.25","30.87"
"10","008","00","070","0002","0000","679","317","362","90","769","1352","0","56.88","23.45"
"10","008","00","070","0002","0351","382","175","207","73","455","684","0","66.52","25.58"
"10","008","00","070","0002","0352","297","142","155","17","314","668","0","47.01","21.26"
"10","008","00","070","0003","0000","669","278","391","50","719","1226","0","58.65","22.68"
"10","008","00","070","0003","0337","436","169","267","42","478","806","0","59.31","20.97"
"10","008","00","070","0003","0338","233","109","124","8","241","420","0","57.38","25.95"
"10","008","00","070","0004","0000","1042","435","607","124","1166","1851","0","62.99","23.50"
"10","008","00","070","0004","0339","462","200","262","62","524","769","0","68.14","26.01"
"10","008","00","070","0004","0340","580","235","345","62","642","1082","0","59.33","21.72"
"10","008","00","070","0005","0000","569","269","300","32","601","950","0","63.26","28.32"
"10","008","00","070","0005","0345","271","124","147","17","288","532","0","54.14","23.31"
"10","008","00","070","0005","0346","298","145","153","15","313","418","0","74.88","34.69"
"10","008","00","070","0006","0000","839","393","446","123","962","1400","0","68.71","28.07"
"10","008","00","070","0006","0348","396","191","205","55","451","678","0","66.52","28.17"
"10","008","00","070","0006","0349","443","202","241","68","511","722","0","70.78","27.98"
"10","008","00","070","0007","0000","423","195","228","19","442","866","0","51.04","22.52"
"10","008","00","070","0007","0350","423","195","228","19","442","866","0","51.04","22.52"
"10","008","00","070","0008","0000","355","147","208","46","401","596","0","67.28","24.66"
"10","008","00","070","0008","0347","355","147","208","46","401","596","0","67.28","24.66"
"10","008","00","070","0009","0000","756","356","400","84","840","1269","0","66.19","28.05"
"10","008","00","070","0009","0343","442","213","229","51","493","762","0","64.70","27.95"
"10","008","00","070","0009","0344","314","143","171","33","347","507","0","68.44","28.21"
"10","008","00","070","0010","0000","912","443","469","116","1028","1506","0","68.26","29.42"
"10","008","00","070","0010","0341","420","196","224","59","479","709","0","67.56","27.64"
"10","008","00","070","0010","0342","492","247","245","57","549","797","0","68.88","30.99"
"10","008","00","070","0011","0000","352","197","155","24","376","729","0","51.58","27.02"
"10","008","00","070","0011","0353","352","197","155","24","376","729","0","51.58","27.02"
"10","008","00","070","0012","0000","465","243","222","54","519","649","0","79.97","37.44"
"10","008","00","070","0012","0354","465","243","222","54","519","649","0","79.97","37.44"
"10","008","00","070","0013","0000","326","179","147","18","344","675","0","50.96","26.52"
"10","008","00","070","0013","0355","326","179","147","18","344","675","0","50.96","26.52"
"10","008","00","080","0000","0000","7882","3982","3900","1025","8907","12365","13884","72.03","32.20"
"10","008","00","080","0001","0000","501","263","238","71","572","754","0","75.86","34.88"
"10","008","00","080","0001","0356","501","263","238","71","572","754","0","75.86","34.88"
"10","008","00","080","0002","0000","237","145","92","31","268","441","0","60.77","32.88"
"10","008","00","080","0002","0357","145","92","53","21","166","235","0","70.64","39.15"
"10","008","00","080","0002","0358","92","53","39","10","102","206","0","49.51","25.73"
"10","008","00","080","0003","0000","443","205","238","69","512","725","0","70.62","28.28"
"10","008","00","080","0003","0359","208","104","104","28","236","326","0","72.39","31.90"
"10","008","00","080","0003","0360","235","101","134","41","276","399","0","69.17","25.31"
"10","008","00","080","0004","0000","335","148","187","58","393","609","0","64.53","24.30"
"10","008","00","080","0004","0363","335","148","187","58","393","609","0","64.53","24.30"
"10","008","00","080","0005","0000","416","204","212","32","448","646","0","69.35","31.58"
"10","008","00","080","0005","0361","224","103","121","12","236","354","0","66.67","29.10"
"10","008","00","080","0005","0362","192","101","91","20","212","292","0","72.60","34.59"
"10","008","00","080","0006","0000","1081","514","567","98","1179","1661","0","70.98","30.95"
"10","008","00","080","0006","0365","623","288","335","63","686","935","0","73.37","30.80"
"10","008","00","080","0006","0366","458","226","232","35","493","726","0","67.91","31.13"
"10","008","00","080","0007","0000","180","93","87","23","203","276","0","73.55","33.70"
"10","008","00","080","0007","0364","180","93","87","23","203","276","0","73.55","33.70"
"10","008","00","080","0008","0000","370","174","196","62","432","597","0","72.36","29.15"
"10","008","00","080","0008","0367","370","174","196","62","432","597","0","72.36","29.15"
"10","008","00","080","0009","0000","306","160","146","46","352","473","0","74.42","33.83"
"10","008","00","080","0009","0368","306","160","146","46","352","473","0","74.42","33.83"
"10","008","00","080","0010","0000","813","391","422","116","929","1293","0","71.85","30.24"
"10","008","00","080","0010","0369","186","80","106","29","215","308","0","69.81","25.97"
"10","008","00","080","0010","0370","627","311","316","87","714","985","0","72.49","31.57"
"10","008","00","080","0011","0000","632","367","265","67","699","999","0","69.97","36.74"
"10","008","00","080","0011","0371","278","166","112","39","317","422","0","75.12","39.34"
"10","008","00","080","0011","0372","354","201","153","28","382","577","0","66.20","34.84"
"10","008","00","080","0012","0000","554","252","302","99","653","834","0","78.30","30.22"
"10","008","00","080","0012","0373","554","252","302","99","653","834","0","78.30","30.22"
"10","008","00","080","0013","0000","471","269","202","54","525","653","0","80.40","41.19"
"10","008","00","080","0013","0375","471","269","202","54","525","653","0","80.40","41.19"
"10","008","00","080","0014","0000","444","213","231","58","502","603","0","83.25","35.32"
"10","008","00","080","0014","0377","444","213","231","58","502","603","0","83.25","35.32"
"10","008","00","080","0015","0000","305","165","140","64","369","484","0","76.24","34.09"
"10","008","00","080","0015","0379","305","165","140","64","369","484","0","76.24","34.09"
"10","008","00","080","0016","0000","208","111","97","21","229","423","0","54.14","26.24"
"10","008","00","080","0016","0374","208","111","97","21","229","423","0","54.14","26.24"
"10","008","00","080","0017","0000","261","136","125","22","283","441","0","64.17","30.84"
"10","008","00","080","0017","0378","261","136","125","22","283","441","0","64.17","30.84"
"10","008","00","080","0018","0000","325","172","153","34","359","453","0","79.25","37.97"
"10","008","00","080","0018","0376","325","172","153","34","359","453","0","79.25","37.97"
"10","008","00","090","0000","0000","7746","3905","3841","853","8599","13054","14894","65.87","29.91"
"10","008","00","090","0001","0000","966","461","505","88","1054","1514","0","69.62","30.45"
"10","008","00","090","0001","0382","440","191","249","45","485","698","0","69.48","27.36"
"10","008","00","090","0001","0383","526","270","256","43","569","816","0","69.73","33.09"
"10","008","00","090","0002","0000","1130","567","563","95","1225","1867","0","65.61","30.37"
"10","008","00","090","0002","0380","526","285","241","49","575","868","0","66.24","32.83"
"10","008","00","090","0002","0381","604","282","322","46","650","999","0","65.07","28.23"
"10","008","00","090","0003","0000","461","259","202","71","532","927","0","57.39","27.94"
"10","008","00","090","0003","0398","270","159","111","45","315","533","0","59.10","29.83"
"10","008","00","090","0003","0399","191","100","91","26","217","394","0","55.08","25.38"
"10","008","00","090","0004","0000","662","339","323","92","754","1302","0","57.91","26.04"
"10","008","00","090","0004","0391","395","192","203","64","459","786","0","58.40","24.43"
"10","008","00","090","0004","0392","131","81","50","16","147","265","0","55.47","30.57"
"10","008","00","090","0004","0393","136","66","70","12","148","251","0","58.96","26.29"
"10","008","00","090","0005","0000","638","338","300","60","698","1011","0","69.04","33.43"
"10","008","00","090","0005","0384","280","157","123","32","312","468","0","66.67","33.55"
"10","008","00","090","0005","0385","358","181","177","28","386","543","0","71.09","33.33"
"10","008","00","090","0006","0000","768","381","387","94","862","1192","0","72.32","31.96"
"10","008","00","090","0006","0386","366","179","187","48","414","566","0","73.14","31.63"
"10","008","00","090","0006","0387","402","202","200","46","448","626","0","71.57","32.27"
"10","008","00","090","0007","0000","659","327","332","87","746","965","0","77.31","33.89"
"10","008","00","090","0007","0388","204","101","103","14","218","284","0","76.76","35.56"
"10","008","00","090","0007","0389","328","174","154","58","386","492","0","78.46","35.37"
"10","008","00","090","0007","0390","127","52","75","15","142","189","0","75.13","27.51"
"10","008","00","090","0008","0000","317","176","141","25","342","594","0","57.58","29.63"
"10","008","00","090","0008","0394","117","69","48","8","125","262","0","47.71","26.34"
"10","008","00","090","0008","0395","200","107","93","17","217","332","0","65.36","32.23"
"10","008","00","090","0009","0000","411","204","207","56","467","671","0","69.60","30.40"
"10","008","00","090","0009","0396","313","155","158","49","362","509","0","71.12","30.45"
"10","008","00","090","0009","0397","98","49","49","7","105","162","0","64.81","30.25"
"10","008","00","090","0010","0000","419","170","249","24","443","779","0","56.87","21.82"
"10","008","00","090","0010","0400","419","170","249","24","443","779","0","56.87","21.82"
"10","008","00","090","0011","0000","441","232","209","58","499","876","0","56.96","26.48"
"10","008","00","090","0011","0402","214","111","103","35","249","376","0","66.22","29.52"
"10","008","00","090","0011","0403","227","121","106","23","250","500","0","50.00","24.20"
"10","008","00","090","0012","0000","313","155","158","47","360","531","0","67.80","29.19"
"10","008","00","090","0012","0404","189","86","103","23","212","314","0","67.52","27.39"
"10","008","00","090","0012","0405","124","69","55","24","148","217","0","68.20","31.80"
"10","008","00","090","0013","0000","561","296","265","56","617","825","0","74.79","35.88"
"10","008","00","090","0013","0401","561","296","265","56","617","825","0","74.79","35.88"
"10","008","00","100","0000","0000","9229","4287","4942","1119","10348","15407","17313","67.16","27.83"
"10","008","00","100","0001","0000","984","466","518","118","1102","1588","0","69.40","29.35"
"10","008","00","100","0001","0406","561","281","280","78","639","907","0","70.45","30.98"
"10","008","00","100","0001","0407","423","185","238","40","463","681","0","67.99","27.17"
"10","008","00","100","0002","0000","996","420","576","99","1095","1647","0","66.48","25.50"
"10","008","00","100","0002","0408","470","204","266","67","537","754","0","71.22","27.06"
"10","008","00","100","0002","0409","526","216","310","32","558","893","0","62.49","24.19"
"10","008","00","100","0003","0000","334","174","160","41","375","626","0","59.90","27.80"
"10","008","00","100","0003","0410","334","174","160","41","375","626","0","59.90","27.80"
"10","008","00","100","0004","0000","1093","515","578","136","1229","1775","0","69.24","29.01"
"10","008","00","100","0004","0415","608","274","334","74","682","960","0","71.04","28.54"
"10","008","00","100","0004","0416","485","241","244","62","547","815","0","67.12","29.57"
"10","008","00","100","0005","0000","793","366","427","103","896","1312","0","68.29","27.90"
"10","008","00","100","0005","0411","363","166","197","52","415","623","0","66.61","26.65"
"10","008","00","100","0005","0412","430","200","230","51","481","689","0","69.81","29.03"
"10","008","00","100","0006","0000","419","181","238","46","465","670","0","69.40","27.01"
"10","008","00","100","0006","0414","419","181","238","46","465","670","0","69.40","27.01"
"10","008","00","100","0007","0000","1129","500","629","128","1257","1710","0","73.51","29.24"
"10","008","00","100","0007","0417","604","240","364","68","672","857","0","78.41","28.00"
"10","008","00","100","0007","0418","525","260","265","60","585","853","0","68.58","30.48"
"10","008","00","100","0008","0000","428","225","203","56","484","744","0","65.05","30.24"
"10","008","00","100","0008","0419","428","225","203","56","484","744","0","65.05","30.24"
"10","008","00","100","0009","0000","612","272","340","72","684","1068","0","64.04","25.47"
"10","008","00","100","0009","0420","612","272","340","72","684","1068","0","64.04","25.47"
"10","008","00","100","0010","0000","816","435","381","88","904","1391","0","64.99","31.27"
"10","008","00","100","0010","0422","614","329","285","64","678","1006","0","67.40","32.70"
"10","008","00","100","0010","0423","202","106","96","24","226","385","0","58.70","27.53"
"10","008","00","100","0011","0000","816","352","464","135","951","1496","0","63.57","23.53"
"10","008","00","100","0011","0424","508","201","307","79","587","974","0","60.27","20.64"
"10","008","00","100","0011","0425","308","151","157","56","364","522","0","69.73","28.93"
"10","008","00","100","0012","0000","339","165","174","33","372","650","0","57.23","25.38"
"10","008","00","100","0012","0421","339","165","174","33","372","650","0","57.23","25.38"
"10","008","00","100","0013","0000","470","216","254","64","534","730","0","73.15","29.59"
"10","008","00","100","0013","0413","470","216","254","64","534","730","0","73.15","29.59"
"10","008","00","110","0000","0000","8869","4273","4596","850","9719","14373","16421","67.62","29.73"
"10","008","00","110","0001","0000","412","215","197","40","452","689","0","65.60","31.20"
"10","008","00","110","0001","0426","412","215","197","40","452","689","0","65.60","31.20"
"10","008","00","110","0002","0000","254","124","130","14","268","395","0","67.85","31.39"
"10","008","00","110","0002","0431","254","124","130","14","268","395","0","67.85","31.39"
"10","008","00","110","0003","0000","879","470","409","97","976","1409","0","69.27","33.36"
"10","008","00","110","0003","0427","308","174","134","35","343","498","0","68.88","34.94"
"10","008","00","110","0003","0428","571","296","275","62","633","911","0","69.48","32.49"
"10","008","00","110","0004","0000","316","144","172","10","326","558","0","58.42","25.81"
"10","008","00","110","0004","0429","316","144","172","10","326","558","0","58.42","25.81"
"10","008","00","110","0005","0000","556","274","282","37","593","843","0","70.34","32.50"
"10","008","00","110","0005","0430","556","274","282","37","593","843","0","70.34","32.50"
"10","008","00","110","0006","0000","613","269","344","37","650","979","0","66.39","27.48"
"10","008","00","110","0006","0434","613","269","344","37","650","979","0","66.39","27.48"
"10","008","00","110","0007","0000","556","270","286","20","576","872","0","66.06","30.96"
"10","008","00","110","0007","0437","556","270","286","20","576","872","0","66.06","30.96"
"10","008","00","110","0008","0000","822","389","433","74","896","1280","0","70.00","30.39"
"10","008","00","110","0008","0438","471","252","219","40","511","729","0","70.10","34.57"
"10","008","00","110","0008","0439","351","137","214","34","385","551","0","69.87","24.86"
"10","008","00","110","0009","0000","700","313","387","94","794","1130","0","70.27","27.70"
"10","008","00","110","0009","0441","700","313","387","94","794","1130","0","70.27","27.70"
"10","008","00","110","0010","0000","253","105","148","21","274","418","0","65.55","25.12"
"10","008","00","110","0010","0432","253","105","148","21","274","418","0","65.55","25.12"
"10","008","00","110","0011","0000","390","166","224","79","469","603","0","77.78","27.53"
"10","008","00","110","0011","0433","390","166","224","79","469","603","0","77.78","27.53"
"10","008","00","110","0012","0000","106","46","60","10","116","179","0","64.80","25.70"
"10","008","00","110","0012","0442","106","46","60","10","116","179","0","64.80","25.70"
"10","008","00","110","0013","0000","206","84","122","12","218","306","0","71.24","27.45"
"10","008","00","110","0013","0443","206","84","122","12","218","306","0","71.24","27.45"
"10","008","00","110","0014","0000","505","208","297","34","539","1043","0","51.68","19.94"
"10","008","00","110","0014","0444","505","208","297","34","539","1043","0","51.68","19.94"
"10","008","00","110","0015","0000","477","262","215","102","579","810","0","71.48","32.35"
"10","008","00","110","0015","0440","477","262","215","102","579","810","0","71.48","32.35"
"10","008","00","110","0016","0000","188","97","91","48","236","300","0","78.67","32.33"
"10","008","00","110","0016","0446","188","97","91","48","236","300","0","78.67","32.33"
"10","008","00","110","0017","0000","465","269","196","56","521","806","0","64.64","33.37"
"10","008","00","110","0017","0447","465","269","196","56","521","806","0","64.64","33.37"
"10","008","00","110","0018","0000","167","79","88","23","190","265","0","71.70","29.81"
"10","008","00","110","0018","0445","167","79","88","23","190","265","0","71.70","29.81"
"10","008","00","110","0019","0000","1004","489","515","42","1046","1488","0","70.30","32.86"
"10","008","00","110","0019","0435","471","228","243","23","494","698","0","70.77","32.66"
"10","008","00","110","0019","0436","533","261","272","19","552","790","0","69.87","33.04"
"10","008","00","120","0000","0000","7220","3045","4175","930","8150","12565","15616","64.86","24.23"
"10","008","00","120","0001","0000","615","233","382","138","753","1131","0","66.58","20.60"
"10","008","00","120","0001","0465","494","174","320","118","612","888","0","68.92","19.59"
"10","008","00","120","0001","0466","121","59","62","20","141","243","0","58.02","24.28"
"10","008","00","120","0002","0000","534","166","368","49","583","891","0","65.43","18.63"
"10","008","00","120","0002","0467","534","166","368","49","583","891","0","65.43","18.63"
"10","008","00","120","0003","0000","195","80","115","24","219","551","0","39.75","14.52"
"10","008","00","120","0003","0469","195","80","115","24","219","551","0","39.75","14.52"
"10","008","00","120","0004","0000","898","360","538","91","989","1409","0","70.19","25.55"
"10","008","00","120","0004","0448","354","117","237","29","383","527","0","72.68","22.20"
"10","008","00","120","0004","0449","352","158","194","33","385","584","0","65.92","27.05"
"10","008","00","120","0004","0450","192","85","107","29","221","298","0","74.16","28.52"
"10","008","00","120","0005","0000","263","125","138","25","288","463","0","62.20","27.00"
"10","008","00","120","0005","0451","263","125","138","25","288","463","0","62.20","27.00"
"10","008","00","120","0006","0000","438","203","235","76","514","684","0","75.15","29.68"
"10","008","00","120","0006","0452","252","109","143","38","290","388","0","74.74","28.09"
"10","008","00","120","0006","0453","186","94","92","38","224","296","0","75.68","31.76"
"10","008","00","120","0007","0000","832","324","508","114","946","1291","0","73.28","25.10"
"10","008","00","120","0007","0456","395","181","214","60","455","623","0","73.03","29.05"
"10","008","00","120","0007","0457","437","143","294","54","491","668","0","73.50","21.41"
"10","008","00","120","0008","0000","429","182","247","40","469","952","0","49.26","19.12"
"10","008","00","120","0008","0458","429","182","247","40","469","952","0","49.26","19.12"
"10","008","00","120","0009","0000","882","458","424","114","996","1381","0","72.12","33.16"
"10","008","00","120","0009","0460","582","304","278","69","651","919","0","70.84","33.08"
"10","008","00","120","0009","0461","300","154","146","45","345","462","0","74.68","33.33"
"10","008","00","120","0010","0000","363","190","173","66","429","600","0","71.50","31.67"
"10","008","00","120","0010","0462","279","155","124","58","337","462","0","72.94","33.55"
"10","008","00","120","0010","0463","84","35","49","8","92","138","0","66.67","25.36"
"10","008","00","120","0011","0000","405","160","245","19","424","953","0","44.49","16.79"
"10","008","00","120","0011","0464","405","160","245","19","424","953","0","44.49","16.79"
"10","008","00","120","0012","0000","251","84","167","16","267","575","0","46.43","14.61"
"10","008","00","120","0012","0468","251","84","167","16","267","575","0","46.43","14.61"
"10","008","00","120","0013","0000","390","117","273","51","441","571","0","77.23","20.49"
"10","008","00","120","0013","0455","390","117","273","51","441","571","0","77.23","20.49"
"10","008","00","120","0014","0000","367","188","179","48","415","612","0","67.81","30.72"
"10","008","00","120","0014","0454","367","188","179","48","415","612","0","67.81","30.72"
"10","008","00","120","0015","0000","358","175","183","59","417","501","0","83.23","34.93"
"10","008","00","120","0015","0459","358","175","183","59","417","501","0","83.23","34.93"
"10","008","00","130","0000","0000","7067","2747","4320","700","7767","12252","15729","63.39","22.42"
"10","008","00","130","0001","0000","544","251","293","69","613","796","0","77.01","31.53"
"10","008","00","130","0001","0489","544","251","293","69","613","796","0","77.01","31.53"
"10","008","00","130","0002","0000","578","188","390","81","659","861","0","76.54","21.84"
"10","008","00","130","0002","0490","578","188","390","81","659","861","0","76.54","21.84"
"10","008","00","130","0003","0000","506","142","364","24","530","1119","0","47.36","12.69"
"10","008","00","130","0003","0491","285","78","207","6","291","689","0","42.24","11.32"
"10","008","00","130","0003","0492","221","64","157","18","239","430","0","55.58","14.88"
"10","008","00","130","0004","0000","329","94","235","14","343","391","0","87.72","24.04"
"10","008","00","130","0004","0493","329","94","235","14","343","391","0","87.72","24.04"
"10","008","00","130","0005","0000","207","91","116","7","214","504","0","42.46","18.06"
"10","008","00","130","0005","0482","207","91","116","7","214","504","0","42.46","18.06"
"10","008","00","130","0006","0000","384","150","234","14","398","733","0","54.30","20.46"
"10","008","00","130","0006","0480","148","51","97","1","149","360","0","41.39","14.17"
"10","008","00","130","0006","0481","236","99","137","13","249","373","0","66.76","26.54"
"10","008","00","130","0008","0000","668","316","352","92","760","1117","0","68.04","28.29"
"10","008","00","130","0008","0485","412","183","229","66","478","609","0","78.49","30.05"
"10","008","00","130","0008","0486","196","111","85","24","220","380","0","57.89","29.21"
"10","008","00","130","0008","0487","60","22","38","2","62","128","0","48.44","17.19"
"10","008","00","130","0009","0000","898","309","589","69","967","1600","0","60.44","19.31"
"10","008","00","130","0009","0472","395","137","258","20","415","821","0","50.55","16.69"
"10","008","00","130","0009","0473","281","84","197","35","316","467","0","67.67","17.99"
"10","008","00","130","0009","0474","222","88","134","14","236","312","0","75.64","28.21"
"10","008","00","130","0010","0000","820","330","490","108","928","1206","0","76.95","27.36"
"10","008","00","130","0010","0470","591","234","357","83","674","859","0","78.46","27.24"
"10","008","00","130","0010","0471","229","96","133","25","254","347","0","73.20","27.67"
"10","008","00","130","0011","0000","429","169","260","26","455","939","0","48.46","18.00"
"10","008","00","130","0011","0476","429","169","260","26","455","939","0","48.46","18.00"
"10","008","00","130","0012","0000","426","167","259","55","481","635","0","75.75","26.30"
"10","008","00","130","0012","0477","426","167","259","55","481","635","0","75.75","26.30"
"10","008","00","130","0013","0000","208","77","131","6","214","629","0","34.02","12.24"
"10","008","00","130","0013","0488","208","77","131","6","214","629","0","34.02","12.24"
"10","008","00","130","0014","0000","25","3","22","2","27","47","0","57.45","6.38"
"10","008","00","130","0014","0475","25","3","22","2","27","47","0","57.45","6.38"
"10","008","00","130","0015","0000","243","109","134","20","263","482","0","54.56","22.61"
"10","008","00","130","0015","0483","175","71","104","14","189","313","0","60.38","22.68"
"10","008","00","130","0015","0484","68","38","30","6","74","169","0","43.79","22.49"
"10","008","00","130","0016","0000","386","161","225","59","445","591","0","75.30","27.24"
"10","008","00","130","0016","0478","386","161","225","59","445","591","0","75.30","27.24"
"10","008","00","130","0017","0000","416","190","226","54","470","602","0","78.07","31.56"
"10","008","00","130","0017","0479","416","190","226","54","470","602","0","78.07","31.56"
"10","009","00","000","0000","0000","319640","181769","137871","36228","355868","560614","664604","63.48","32.42"
"10","009","00","010","0000","0000","51398","25746","25652","2875","54273","87822","107711","61.80","29.32"
"10","009","00","010","0001","0000","817","410","407","44","861","1325","0","64.98","30.94"
"10","009","00","010","0001","0475","817","410","407","44","861","1325","0","64.98","30.94"
"10","009","00","010","0002","0000","635","337","298","43","678","1021","0","66.41","33.01"
"10","009","00","010","0002","0476","635","337","298","43","678","1021","0","66.41","33.01"
"10","009","00","010","0003","0000","362","193","169","14","376","578","0","65.05","33.39"
"10","009","00","010","0003","0450","362","193","169","14","376","578","0","65.05","33.39"
"10","009","00","010","0004","0000","349","188","161","22","371","535","0","69.35","35.14"
"10","009","00","010","0004","0451","349","188","161","22","371","535","0","69.35","35.14"
"10","009","00","010","0005","0000","479","256","223","23","502","731","0","68.67","35.02"
"10","009","00","010","0005","0452","479","256","223","23","502","731","0","68.67","35.02"
"10","009","00","010","0006","0000","495","266","229","34","529","756","0","69.97","35.19"
"10","009","00","010","0006","0453","495","266","229","34","529","756","0","69.97","35.19"
"10","009","00","010","0007","0000","428","231","197","20","448","675","0","66.37","34.22"
"10","009","00","010","0007","0454","428","231","197","20","448","675","0","66.37","34.22"
"10","009","00","010","0008","0000","2771","1312","1459","137","2908","4671","0","62.26","28.09"
"10","009","00","010","0008","0463","906","435","471","51","957","1591","0","60.15","27.34"
"10","009","00","010","0008","0464","732","347","385","35","767","1247","0","61.51","27.83"
"10","009","00","010","0008","0465","481","209","272","35","516","790","0","65.32","26.46"
"10","009","00","010","0008","0466","652","321","331","16","668","1043","0","64.05","30.78"
"10","009","00","010","0009","0000","1556","777","779","78","1634","3031","0","53.91","25.64"
"10","009","00","010","0009","0477","399","196","203","20","419","830","0","50.48","23.61"
"10","009","00","010","0009","0478","583","295","288","40","623","1111","0","56.08","26.55"
"10","009","00","010","0009","0479","574","286","288","18","592","1090","0","54.31","26.24"
"10","009","00","010","0010","0000","1559","688","871","77","1636","2607","0","62.75","26.39"
"10","009","00","010","0010","0470","640","288","352","30","670","1137","0","58.93","25.33"
"10","009","00","010","0010","0471","418","169","249","20","438","721","0","60.75","23.44"
"10","009","00","010","0010","0472","501","231","270","27","528","749","0","70.49","30.84"
"10","009","00","010","0011","0000","1059","522","537","41","1100","1704","0","64.55","30.63"
"10","009","00","010","0011","0494","598","297","301","34","632","959","0","65.90","30.97"
"10","009","00","010","0011","0495","461","225","236","7","468","745","0","62.82","30.20"
"10","009","00","010","0012","0000","1976","939","1037","73","2049","3329","0","61.55","28.21"
"10","009","00","010","0012","0489","630","288","342","16","646","1024","0","63.09","28.13"
"10","009","00","010","0012","0490","728","345","383","24","752","1213","0","62.00","28.44"
"10","009","00","010","0012","0491","618","306","312","33","651","1092","0","59.62","28.02"
"10","009","00","010","0013","0000","2304","1101","1203","91","2395","4033","0","59.39","27.30"
"10","009","00","010","0013","0484","894","432","462","35","929","1411","0","65.84","30.62"
"10","009","00","010","0013","0485","712","338","374","33","745","1273","0","58.52","26.55"
"10","009","00","010","0013","0486","698","331","367","23","721","1349","0","53.45","24.54"
"10","009","00","010","0014","0000","1301","684","617","131","1432","2269","0","63.11","30.15"
"10","009","00","010","0014","0482","681","342","339","81","762","1106","0","68.90","30.92"
"10","009","00","010","0014","0483","620","342","278","50","670","1163","0","57.61","29.41"
"10","009","00","010","0015","0000","407","202","205","23","430","632","0","68.04","31.96"
"10","009","00","010","0015","0499","407","202","205","23","430","632","0","68.04","31.96"
"10","009","00","010","0016","0000","1172","629","543","102","1274","2149","0","59.28","29.27"
"10","009","00","010","0016","0500","452","253","199","52","504","732","0","68.85","34.56"
"10","009","00","010","0016","0501","720","376","344","50","770","1417","0","54.34","26.53"
"10","009","00","010","0017","0000","289","157","132","29","318","516","0","61.63","30.43"
"10","009","00","010","0017","0502","289","157","132","29","318","516","0","61.63","30.43"
"10","009","00","010","0018","0000","1347","571","776","72","1419","2391","0","59.35","23.88"
"10","009","00","010","0018","0497","625","255","370","34","659","1090","0","60.46","23.39"
"10","009","00","010","0018","0498","722","316","406","38","760","1301","0","58.42","24.29"
"10","009","00","010","0019","0000","917","457","460","57","974","1446","0","67.36","31.60"
"10","009","00","010","0019","0496","917","457","460","57","974","1446","0","67.36","31.60"
"10","009","00","010","0020","0000","1379","683","696","78","1457","2318","0","62.86","29.47"
"10","009","00","010","0020","0503","808","422","386","49","857","1376","0","62.28","30.67"
"10","009","00","010","0020","0504","571","261","310","29","600","942","0","63.69","27.71"
"10","009","00","010","0021","0000","1038","526","512","82","1120","1852","0","60.48","28.40"
"10","009","00","010","0021","0513","742","383","359","56","798","1363","0","58.55","28.10"
"10","009","00","010","0021","0514","296","143","153","26","322","489","0","65.85","29.24"
"10","009","00","010","0022","0000","3192","1604","1588","159","3351","5337","0","62.79","30.05"
"10","009","00","010","0022","0509","861","403","458","26","887","1435","0","61.81","28.08"
"10","009","00","010","0022","0510","879","435","444","44","923","1373","0","67.23","31.68"
"10","009","00","010","0022","0511","684","367","317","47","731","1243","0","58.81","29.53"
"10","009","00","010","0022","0512","768","399","369","42","810","1286","0","62.99","31.03"
"10","009","00","010","0023","0000","1896","994","902","136","2032","3296","0","61.65","30.16"
"10","009","00","010","0023","0506","877","455","422","55","932","1598","0","58.32","28.47"
"10","009","00","010","0023","0507","602","331","271","48","650","1028","0","63.23","32.20"
"10","009","00","010","0023","0508","417","208","209","33","450","670","0","67.16","31.04"
"10","009","00","010","0024","0000","1084","582","502","74","1158","1770","0","65.42","32.88"
"10","009","00","010","0024","0522","423","228","195","49","472","654","0","72.17","34.86"
"10","009","00","010","0024","0523","661","354","307","25","686","1116","0","61.47","31.72"
"10","009","00","010","0025","0000","681","384","297","62","743","1061","0","70.03","36.19"
"10","009","00","010","0025","0524","681","384","297","62","743","1061","0","70.03","36.19"
"10","009","00","010","0026","0000","2425","1296","1129","141","2566","4290","0","59.81","30.21"
"10","009","00","010","0026","0515","624","342","282","48","672","1051","0","63.94","32.54"
"10","009","00","010","0026","0516","621","341","280","41","662","1055","0","62.75","32.32"
"10","009","00","010","0026","0517","553","274","279","29","582","1067","0","54.55","25.68"
"10","009","00","010","0026","0518","627","339","288","23","650","1117","0","58.19","30.35"
"10","009","00","010","0027","0000","612","346","266","41","653","1046","0","62.43","33.08"
"10","009","00","010","0027","0519","612","346","266","41","653","1046","0","62.43","33.08"
"10","009","00","010","0028","0000","1278","688","590","96","1374","2109","0","65.15","32.62"
"10","009","00","010","0028","0520","559","310","249","61","620","886","0","69.98","34.99"
"10","009","00","010","0028","0521","719","378","341","35","754","1223","0","61.65","30.91"
"10","009","00","010","0029","0000","1696","880","816","157","1853","3127","0","59.26","28.14"
"10","009","00","010","0029","0528","584","313","271","75","659","1058","0","62.29","29.58"
"10","009","00","010","0029","0529","602","298","304","38","640","1089","0","58.77","27.36"
"10","009","00","010","0029","0530","510","269","241","44","554","980","0","56.53","27.45"
"10","009","00","010","0030","0000","1858","1022","836","111","1969","3094","0","63.64","33.03"
"10","009","00","010","0030","0525","877","472","405","33","910","1401","0","64.95","33.69"
"10","009","00","010","0030","0526","582","304","278","45","627","1026","0","61.11","29.63"
"10","009","00","010","0030","0527","399","246","153","33","432","667","0","64.77","36.88"
"10","009","00","010","0031","0000","646","369","277","50","696","1106","0","62.93","33.36"
"10","009","00","010","0031","0531","646","369","277","50","696","1106","0","62.93","33.36"
"10","009","00","010","0032","0000","1401","642","759","55","1456","2200","0","66.18","29.18"
"10","009","00","010","0032","0459","761","354","407","28","789","1180","0","66.86","30.00"
"10","009","00","010","0032","0460","640","288","352","27","667","1020","0","65.39","28.24"
"10","009","00","010","0033","0000","2001","925","1076","95","2096","3573","0","58.66","25.89"
"10","009","00","010","0033","0455","499","231","268","15","514","877","0","58.61","26.34"
"10","009","00","010","0033","0456","521","243","278","23","544","868","0","62.67","28.00"
"10","009","00","010","0033","0457","463","230","233","21","484","968","0","50.00","23.76"
"10","009","00","010","0033","0458","518","221","297","36","554","860","0","64.42","25.70"
"10","009","00","010","0034","0000","1607","772","835","60","1667","2756","0","60.49","28.01"
"10","009","00","010","0034","0480","780","380","400","21","801","1403","0","57.09","27.08"
"10","009","00","010","0034","0481","827","392","435","39","866","1353","0","64.01","28.97"
"10","009","00","010","0035","0000","1200","612","588","76","1276","2167","0","58.88","28.24"
"10","009","00","010","0035","0492","399","207","192","24","423","803","0","52.68","25.78"
"10","009","00","010","0035","0493","801","405","396","52","853","1364","0","62.54","29.69"
"10","009","00","010","0036","0000","1258","599","659","45","1303","2075","0","62.80","28.87"
"10","009","00","010","0036","0473","557","269","288","20","577","937","0","61.58","28.71"
"10","009","00","010","0036","0474","701","330","371","25","726","1138","0","63.80","29.00"
"10","009","00","010","0037","0000","2050","1034","1016","81","2131","3604","0","59.13","28.69"
"10","009","00","010","0037","0467","582","297","285","22","604","955","0","63.25","31.10"
"10","009","00","010","0037","0468","900","436","464","31","931","1546","0","60.22","28.20"
"10","009","00","010","0037","0469","568","301","267","28","596","1103","0","54.03","27.29"
"10","009","00","010","0038","0000","1511","747","764","66","1577","2545","0","61.96","29.35"
"10","009","00","010","0038","0487","670","334","336","18","688","1153","0","59.67","28.97"
"10","009","00","010","0038","0488","841","413","428","48","889","1392","0","63.86","29.67"
"10","009","00","010","0039","0000","1230","559","671","47","1277","2210","0","57.78","25.29"
"10","009","00","010","0039","0461","609","301","308","26","635","1100","0","57.73","27.36"
"10","009","00","010","0039","0462","621","258","363","21","642","1110","0","57.84","23.24"
"10","009","00","010","0040","0000","1132","562","570","52","1184","1887","0","62.75","29.78"
"10","009","00","010","0040","0505","1132","562","570","52","1184","1887","0","62.75","29.78"
"10","009","00","020","0000","0000","22250","12210","10040","1846","24096","36621","43263","65.80","33.34"
"10","009","00","020","0001","0000","709","384","325","44","753","1092","0","68.96","35.16"
"10","009","00","020","0001","0553","709","384","325","44","753","1092","0","68.96","35.16"
"10","009","00","020","0002","0000","1233","673","560","62","1295","2035","0","63.64","33.07"
"10","009","00","020","0002","0554","688","381","307","44","732","1092","0","67.03","34.89"
"10","009","00","020","0002","0555","545","292","253","18","563","943","0","59.70","30.97"
"10","009","00","020","0003","0000","1163","656","507","101","1264","2106","0","60.02","31.15"
"10","009","00","020","0003","0559","622","350","272","57","679","1129","0","60.14","31.00"
"10","009","00","020","0003","0560","541","306","235","44","585","977","0","59.88","31.32"
"10","009","00","020","0004","0000","833","402","431","41","874","1380","0","63.33","29.13"
"10","009","00","020","0004","0561","833","402","431","41","874","1380","0","63.33","29.13"
"10","009","00","020","0005","0000","790","433","357","53","843","1188","0","70.96","36.45"
"10","009","00","020","0005","0562","790","433","357","53","843","1188","0","70.96","36.45"
"10","009","00","020","0006","0000","1523","815","708","70","1593","2560","0","62.23","31.84"
"10","009","00","020","0006","0571","766","415","351","44","810","1254","0","64.59","33.09"
"10","009","00","020","0006","0572","757","400","357","26","783","1306","0","59.95","30.63"
"10","009","00","020","0007","0000","793","427","366","76","869","1249","0","69.58","34.19"
"10","009","00","020","0007","0563","793","427","366","76","869","1249","0","69.58","34.19"
"10","009","00","020","0008","0000","497","290","207","52","549","722","0","76.04","40.17"
"10","009","00","020","0008","0564","497","290","207","52","549","722","0","76.04","40.17"
"10","009","00","020","0009","0000","530","276","254","72","602","828","0","72.71","33.33"
"10","009","00","020","0009","0566","530","276","254","72","602","828","0","72.71","33.33"
"10","009","00","020","0010","0000","407","218","189","45","452","690","0","65.51","31.59"
"10","009","00","020","0010","0567","407","218","189","45","452","690","0","65.51","31.59"
"10","009","00","020","0011","0000","728","422","306","96","824","1080","0","76.30","39.07"
"10","009","00","020","0011","0568","728","422","306","96","824","1080","0","76.30","39.07"
"10","009","00","020","0012","0000","985","558","427","101","1086","1627","0","66.75","34.30"
"10","009","00","020","0012","0569","538","306","232","62","600","826","0","72.64","37.05"
"10","009","00","020","0012","0570","447","252","195","39","486","801","0","60.67","31.46"
"10","009","00","020","0013","0000","547","316","231","66","613","922","0","66.49","34.27"
"10","009","00","020","0013","0583","547","316","231","66","613","922","0","66.49","34.27"
"10","009","00","020","0014","0000","1584","877","707","110","1694","2749","0","61.62","31.90"
"10","009","00","020","0014","0584","757","445","312","56","813","1330","0","61.13","33.46"
"10","009","00","020","0014","0585","827","432","395","54","881","1419","0","62.09","30.44"
"10","009","00","020","0015","0000","1260","693","567","118","1378","2104","0","65.49","32.94"
"10","009","00","020","0015","0586","718","400","318","81","799","1175","0","68.00","34.04"
"10","009","00","020","0015","0587","542","293","249","37","579","929","0","62.33","31.54"
"10","009","00","020","0016","0000","2001","1013","988","137","2138","3303","0","64.73","30.67"
"10","009","00","020","0016","0573","669","330","339","46","715","1078","0","66.33","30.61"
"10","009","00","020","0016","0574","640","307","333","47","687","1117","0","61.50","27.48"
"10","009","00","020","0016","0575","692","376","316","44","736","1108","0","66.43","33.94"
"10","009","00","020","0017","0000","454","262","192","30","484","845","0","57.28","31.01"
"10","009","00","020","0017","0578","454","262","192","30","484","845","0","57.28","31.01"
"10","009","00","020","0018","0000","516","294","222","56","572","771","0","74.19","38.13"
"10","009","00","020","0018","0579","516","294","222","56","572","771","0","74.19","38.13"
"10","009","00","020","0019","0000","491","267","224","53","544","802","0","67.83","33.29"
"10","009","00","020","0019","0580","491","267","224","53","544","802","0","67.83","33.29"
"10","009","00","020","0020","0000","881","498","383","121","1002","1414","0","70.86","35.22"
"10","009","00","020","0020","0581","485","285","200","67","552","801","0","68.91","35.58"
"10","009","00","020","0020","0582","396","213","183","54","450","613","0","73.41","34.75"
"10","009","00","020","0021","0000","861","571","290","121","982","1388","0","70.75","41.14"
"10","009","00","020","0021","0588","861","571","290","121","982","1388","0","70.75","41.14"
"10","009","00","020","0022","0000","477","284","193","43","520","779","0","66.75","36.46"
"10","009","00","020","0022","0565","477","284","193","43","520","779","0","66.75","36.46"
"10","009","00","020","0023","0000","1707","902","805","93","1800","2797","0","64.35","32.25"
"10","009","00","020","0023","0556","574","296","278","43","617","913","0","67.58","32.42"
"10","009","00","020","0023","0557","587","319","268","31","618","952","0","64.92","33.51"
"10","009","00","020","0023","0558","546","287","259","19","565","932","0","60.62","30.79"
"10","009","00","020","0024","0000","1280","679","601","85","1365","2190","0","62.33","31.00"
"10","009","00","020","0024","0576","500","307","193","46","546","884","0","61.76","34.73"
"10","009","00","020","0024","0577","780","372","408","39","819","1306","0","62.71","28.48"
"10","009","00","030","0000","0000","31987","16652","15335","2677","34664","56937","70255","60.88","29.25"
"10","009","00","030","0001","0000","535","284","251","36","571","866","0","65.94","32.79"
"10","009","00","030","0001","0130","535","284","251","36","571","866","0","65.94","32.79"
"10","009","00","030","0002","0000","820","420","400","62","882","1611","0","54.75","26.07"
"10","009","00","030","0002","0123","392","209","183","26","418","702","0","59.54","29.77"
"10","009","00","030","0002","0124","428","211","217","36","464","909","0","51.05","23.21"
"10","009","00","030","0003","0000","1419","701","718","101","1520","2432","0","62.50","28.82"
"10","009","00","030","0003","0121","743","352","391","59","802","1259","0","63.70","27.96"
"10","009","00","030","0003","0122","676","349","327","42","718","1173","0","61.21","29.75"
"10","009","00","030","0004","0000","1517","734","783","63","1580","2664","0","59.31","27.55"
"10","009","00","030","0004","0125","554","270","284","28","582","953","0","61.07","28.33"
"10","009","00","030","0004","0126","453","236","217","26","479","853","0","56.15","27.67"
"10","009","00","030","0004","0127","510","228","282","9","519","858","0","60.49","26.57"
"10","009","00","030","0005","0000","1216","630","586","73","1289","2378","0","54.21","26.49"
"10","009","00","030","0005","0128","618","336","282","45","663","1176","0","56.38","28.57"
"10","009","00","030","0005","0129","598","294","304","28","626","1202","0","52.08","24.46"
"10","009","00","030","0006","0000","1648","782","866","81","1729","3037","0","56.93","25.75"
"10","009","00","030","0006","0131","515","257","258","10","525","946","0","55.50","27.17"
"10","009","00","030","0006","0132","560","261","299","45","605","1000","0","60.50","26.10"
"10","009","00","030","0006","0133","573","264","309","26","599","1091","0","54.90","24.20"
"10","009","00","030","0007","0000","766","346","420","47","813","1284","0","63.32","26.95"
"10","009","00","030","0007","0137","766","346","420","47","813","1284","0","63.32","26.95"
"10","009","00","030","0008","0000","2642","1283","1359","122","2764","4481","0","61.68","28.63"
"10","009","00","030","0008","0138","693","346","347","22","715","1105","0","64.71","31.31"
"10","009","00","030","0008","0139","612","280","332","48","660","1066","0","61.91","26.27"
"10","009","00","030","0008","0140","701","345","356","25","726","1196","0","60.70","28.85"
"10","009","00","030","0008","0141","636","312","324","27","663","1114","0","59.52","28.01"
"10","009","00","030","0009","0000","1229","597","632","79","1308","2254","0","58.03","26.49"
"10","009","00","030","0009","0142","731","331","400","38","769","1256","0","61.23","26.35"
"10","009","00","030","0009","0143","498","266","232","41","539","998","0","54.01","26.65"
"10","009","00","030","0010","0000","2059","1084","975","168","2227","3716","0","59.93","29.17"
"10","009","00","030","0010","0144","719","380","339","67","786","1285","0","61.17","29.57"
"10","009","00","030","0010","0145","698","336","362","38","736","1296","0","56.79","25.93"
"10","009","00","030","0010","0146","642","368","274","63","705","1135","0","62.11","32.42"
"10","009","00","030","0011","0000","1148","575","573","104","1252","1960","0","63.88","29.34"
"10","009","00","030","0011","0147","647","325","322","57","704","1102","0","63.88","29.49"
"10","009","00","030","0011","0148","501","250","251","47","548","858","0","63.87","29.14"
"10","009","00","030","0012","0000","633","354","279","66","699","1085","0","64.42","32.63"
"10","009","00","030","0012","0149","633","354","279","66","699","1085","0","64.42","32.63"
"10","009","00","030","0013","0000","706","393","313","84","790","1301","0","60.72","30.21"
"10","009","00","030","0013","0174","706","393","313","84","790","1301","0","60.72","30.21"
"10","009","00","030","0014","0000","439","228","211","83","522","809","0","64.52","28.18"
"10","009","00","030","0014","0173","439","228","211","83","522","809","0","64.52","28.18"
"10","009","00","030","0015","0000","943","534","409","103","1046","2048","0","51.07","26.07"
"10","009","00","030","0015","0171","490","271","219","93","583","940","0","62.02","28.83"
"10","009","00","030","0015","0172","453","263","190","10","463","1108","0","41.79","23.74"
"10","009","00","030","0016","0000","754","409","345","79","833","1410","0","59.08","29.01"
"10","009","00","030","0016","0169","754","409","345","79","833","1410","0","59.08","29.01"
"10","009","00","030","0017","0000","452","264","188","72","524","876","0","59.82","30.14"
"10","009","00","030","0017","0170","452","264","188","72","524","876","0","59.82","30.14"
"10","009","00","030","0018","0000","1529","865","664","131","1660","2532","0","65.56","34.16"
"10","009","00","030","0018","0151","826","455","371","83","909","1330","0","68.35","34.21"
"10","009","00","030","0018","0152","703","410","293","48","751","1202","0","62.48","34.11"
"10","009","00","030","0019","0000","485","215","270","74","559","814","0","68.67","26.41"
"10","009","00","030","0019","0153","485","215","270","74","559","814","0","68.67","26.41"
"10","009","00","030","0020","0000","841","486","355","78","919","1689","0","54.41","28.77"
"10","009","00","030","0020","0154","372","216","156","26","398","830","0","47.95","26.02"
"10","009","00","030","0020","0155","469","270","199","52","521","859","0","60.65","31.43"
"10","009","00","030","0021","0000","1009","535","474","144","1153","1591","0","72.47","33.63"
"10","009","00","030","0021","0156","501","250","251","82","583","798","0","73.06","31.33"
"10","009","00","030","0021","0157","508","285","223","62","570","793","0","71.88","35.94"
"10","009","00","030","0022","0000","2010","1120","890","197","2207","3482","0","63.38","32.17"
"10","009","00","030","0022","0158","609","330","279","71","680","1110","0","61.26","29.73"
"10","009","00","030","0022","0159","671","381","290","47","718","1143","0","62.82","33.33"
"10","009","00","030","0022","0160","730","409","321","79","809","1229","0","65.83","33.28"
"10","009","00","030","0023","0000","1330","758","572","161","1491","2241","0","66.53","33.82"
"10","009","00","030","0023","0161","707","414","293","89","796","1223","0","65.09","33.85"
"10","009","00","030","0023","0162","623","344","279","72","695","1018","0","68.27","33.79"
"10","009","00","030","0024","0000","1315","714","601","92","1407","2457","0","57.26","29.06"
"10","009","00","030","0024","0163","733","401","332","54","787","1262","0","62.36","31.77"
"10","009","00","030","0024","0164","582","313","269","38","620","1195","0","51.88","26.19"
"10","009","00","030","0025","0000","767","415","352","67","834","1271","0","65.62","32.65"
"10","009","00","030","0025","0165","767","415","352","67","834","1271","0","65.62","32.65"
"10","009","00","030","0026","0000","1007","546","461","129","1136","1458","0","77.91","37.45"
"10","009","00","030","0026","0166","389","214","175","58","447","566","0","78.98","37.81"
"10","009","00","030","0026","0167","618","332","286","71","689","892","0","77.24","37.22"
"10","009","00","030","0027","0000","215","103","112","9","224","493","0","45.44","20.89"
"10","009","00","030","0027","0150","215","103","112","9","224","493","0","45.44","20.89"
"10","009","00","030","0028","0000","2025","978","1047","140","2165","3523","0","61.45","27.76"
"10","009","00","030","0028","0134","645","294","351","45","690","1120","0","61.61","26.25"
"10","009","00","030","0028","0135","715","355","360","57","772","1199","0","64.39","29.61"
"10","009","00","030","0028","0136","665","329","336","38","703","1204","0","58.39","27.33"
"10","009","00","030","0029","0000","528","299","229","32","560","1174","0","47.70","25.47"
"10","009","00","030","0029","0168","528","299","229","32","560","1174","0","47.70","25.47"
"10","009","00","040","0000","0000","21206","12640","8566","2085","23291","36606","44595","63.63","34.53"
"10","009","00","040","0001","0000","728","428","300","54","782","1455","0","53.75","29.42"
"10","009","00","040","0001","0369","325","199","126","18","343","716","0","47.91","27.79"
"10","009","00","040","0001","0370","403","229","174","36","439","739","0","59.40","30.99"
"10","009","00","040","0002","0000","998","590","408","85","1083","1660","0","65.24","35.54"
"10","009","00","040","0002","0371","484","285","199","31","515","783","0","65.77","36.40"
"10","009","00","040","0002","0372","514","305","209","54","568","877","0","64.77","34.78"
"10","009","00","040","0003","0000","1195","627","568","65","1260","1985","0","63.48","31.59"
"10","009","00","040","0003","0373","621","327","294","34","655","1001","0","65.43","32.67"
"10","009","00","040","0003","0374","574","300","274","31","605","984","0","61.48","30.49"
"10","009","00","040","0004","0000","1698","946","752","113","1811","2802","0","64.63","33.76"
"10","009","00","040","0004","0375","584","310","274","27","611","946","0","64.59","32.77"
"10","009","00","040","0004","0376","526","321","205","37","563","820","0","68.66","39.15"
"10","009","00","040","0004","0377","588","315","273","49","637","1036","0","61.49","30.41"
"10","009","00","040","0005","0000","201","110","91","16","217","300","0","72.33","36.67"
"10","009","00","040","0005","0378","201","110","91","16","217","300","0","72.33","36.67"
"10","009","00","040","0006","0000","296","169","127","13","309","524","0","58.97","32.25"
"10","009","00","040","0006","0379","296","169","127","13","309","524","0","58.97","32.25"
"10","009","00","040","0007","0000","344","206","138","43","387","545","0","71.01","37.80"
"10","009","00","040","0007","0380","344","206","138","43","387","545","0","71.01","37.80"
"10","009","00","040","0008","0000","582","329","253","32","614","972","0","63.17","33.85"
"10","009","00","040","0008","0381","582","329","253","32","614","972","0","63.17","33.85"
"10","009","00","040","0009","0000","1661","972","689","100","1761","2816","0","62.54","34.52"
"10","009","00","040","0009","0382","871","501","370","47","918","1441","0","63.71","34.77"
"10","009","00","040","0009","0383","790","471","319","53","843","1375","0","61.31","34.25"
"10","009","00","040","0010","0000","2473","1409","1064","203","2676","4481","0","59.72","31.44"
"10","009","00","040","0010","0384","586","317","269","62","648","1063","0","60.96","29.82"
"10","009","00","040","0010","0385","597","333","264","39","636","1088","0","58.46","30.61"
"10","009","00","040","0010","0386","611","374","237","50","661","1072","0","61.66","34.89"
"10","009","00","040","0010","0387","679","385","294","52","731","1258","0","58.11","30.60"
"10","009","00","040","0011","0000","690","440","250","99","789","1219","0","64.73","36.10"
"10","009","00","040","0011","0388","690","440","250","99","789","1219","0","64.73","36.10"
"10","009","00","040","0012","0000","791","522","269","88","879","1413","0","62.21","36.94"
"10","009","00","040","0012","0389","791","522","269","88","879","1413","0","62.21","36.94"
"10","009","00","040","0013","0000","527","327","200","72","599","936","0","64.00","34.94"
"10","009","00","040","0013","0402","527","327","200","72","599","936","0","64.00","34.94"
"10","009","00","040","0014","0000","592","364","228","80","672","1082","0","62.11","33.64"
"10","009","00","040","0014","0403","592","364","228","80","672","1082","0","62.11","33.64"
"10","009","00","040","0015","0000","1023","652","371","143","1166","1737","0","67.13","37.54"
"10","009","00","040","0015","0404","555","347","208","74","629","913","0","68.89","38.01"
"10","009","00","040","0015","0405","468","305","163","69","537","824","0","65.17","37.01"
"10","009","00","040","0016","0000","850","535","315","60","910","1423","0","63.95","37.60"
"10","009","00","040","0016","0406","850","535","315","60","910","1423","0","63.95","37.60"
"10","009","00","040","0017","0000","913","594","319","133","1046","1523","0","68.68","39.00"
"10","009","00","040","0017","0390","463","289","174","63","526","785","0","67.01","36.82"
"10","009","00","040","0017","0391","450","305","145","70","520","738","0","70.46","41.33"
"10","009","00","040","0018","0000","438","271","167","37","475","840","0","56.55","32.26"
"10","009","00","040","0018","0392","438","271","167","37","475","840","0","56.55","32.26"
"10","009","00","040","0019","0000","547","338","209","74","621","901","0","68.92","37.51"
"10","009","00","040","0019","0393","547","338","209","74","621","901","0","68.92","37.51"
"10","009","00","040","0020","0000","534","316","218","74","608","821","0","74.06","38.49"
"10","009","00","040","0020","0395","534","316","218","74","608","821","0","74.06","38.49"
"10","009","00","040","0021","0000","837","531","306","138","975","1412","0","69.05","37.61"
"10","009","00","040","0021","0394","837","531","306","138","975","1412","0","69.05","37.61"
"10","009","00","040","0022","0000","524","312","212","57","581","908","0","63.99","34.36"
"10","009","00","040","0022","0396","524","312","212","57","581","908","0","63.99","34.36"
"10","009","00","040","0023","0000","514","253","261","80","594","781","0","76.06","32.39"
"10","009","00","040","0023","0399","514","253","261","80","594","781","0","76.06","32.39"
"10","009","00","040","0024","0000","409","279","130","63","472","685","0","68.91","40.73"
"10","009","00","040","0024","0398","409","279","130","63","472","685","0","68.91","40.73"
"10","009","00","040","0025","0000","653","393","260","66","719","1253","0","57.38","31.36"
"10","009","00","040","0025","0397","653","393","260","66","719","1253","0","57.38","31.36"
"10","009","00","040","0026","0000","557","342","215","64","621","846","0","73.40","40.43"
"10","009","00","040","0026","0400","557","342","215","64","621","846","0","73.40","40.43"
"10","009","00","040","0027","0000","631","385","246","33","664","1286","0","51.63","29.94"
"10","009","00","040","0027","0401","631","385","246","33","664","1286","0","51.63","29.94"
"10","009","00","050","0000","0000","13431","7634","5797","1999","15430","23292","27692","66.25","32.78"
"10","009","00","050","0001","0000","475","260","215","48","523","739","0","70.77","35.18"
"10","009","00","050","0001","0091","475","260","215","48","523","739","0","70.77","35.18"
"10","009","00","050","0002","0000","512","284","228","48","560","828","0","67.63","34.30"
"10","009","00","050","0002","0092","512","284","228","48","560","828","0","67.63","34.30"
"10","009","00","050","0003","0000","816","443","373","84","900","1292","0","69.66","34.29"
"10","009","00","050","0003","0093","377","227","150","38","415","621","0","66.83","36.55"
"10","009","00","050","0003","0094","439","216","223","46","485","671","0","72.28","32.19"
"10","009","00","050","0004","0000","660","328","332","74","734","1040","0","70.58","31.54"
"10","009","00","050","0004","0095","660","328","332","74","734","1040","0","70.58","31.54"
"10","009","00","050","0005","0000","710","414","296","106","816","1062","0","76.84","38.98"
"10","009","00","050","0005","0096","439","261","178","54","493","655","0","75.27","39.85"
"10","009","00","050","0005","0097","271","153","118","52","323","407","0","79.36","37.59"
"10","009","00","050","0006","0000","753","426","327","106","859","1341","0","64.06","31.77"
"10","009","00","050","0006","0101","328","202","126","39","367","594","0","61.78","34.01"
"10","009","00","050","0006","0102","425","224","201","67","492","747","0","65.86","29.99"
"10","009","00","050","0007","0000","618","366","252","153","771","1215","0","63.46","30.12"
"10","009","00","050","0007","0103","334","200","134","90","424","696","0","60.92","28.74"
"10","009","00","050","0007","0104","284","166","118","63","347","519","0","66.86","31.98"
"10","009","00","050","0008","0000","652","375","277","108","760","1153","0","65.92","32.52"
"10","009","00","050","0008","0105","368","222","146","50","418","660","0","63.33","33.64"
"10","009","00","050","0008","0106","284","153","131","58","342","493","0","69.37","31.03"
"10","009","00","050","0009","0000","522","299","223","114","636","835","0","76.17","35.81"
"10","009","00","050","0009","0111","522","299","223","114","636","835","0","76.17","35.81"
"10","009","00","050","0010","0000","1700","881","819","132","1832","2828","0","64.78","31.15"
"10","009","00","050","0010","0098","544","290","254","54","598","908","0","65.86","31.94"
"10","009","00","050","0010","0099","580","300","280","38","618","967","0","63.91","31.02"
"10","009","00","050","0010","0100","576","291","285","40","616","953","0","64.64","30.54"
"10","009","00","050","0011","0000","1116","665","451","260","1376","1801","0","76.40","36.92"
"10","009","00","050","0011","0112","534","313","221","116","650","858","0","75.76","36.48"
"10","009","00","050","0011","0113","582","352","230","144","726","943","0","76.99","37.33"
"10","009","00","050","0012","0000","939","527","412","142","1081","1693","0","63.85","31.13"
"10","009","00","050","0012","0114","487","275","212","66","553","853","0","64.83","32.24"
"10","009","00","050","0012","0115","452","252","200","76","528","840","0","62.86","30.00"
"10","009","00","050","0013","0000","413","270","143","85","498","784","0","63.52","34.44"
"10","009","00","050","0013","0118","413","270","143","85","498","784","0","63.52","34.44"
"10","009","00","050","0014","0000","850","525","325","187","1037","1691","0","61.32","31.05"
"10","009","00","050","0014","0116","423","249","174","103","526","855","0","61.52","29.12"
"10","009","00","050","0014","0117","427","276","151","84","511","836","0","61.12","33.01"
"10","009","00","050","0015","0000","1115","637","478","134","1249","2199","0","56.80","28.97"
"10","009","00","050","0015","0107","490","284","206","39","529","1139","0","46.44","24.93"
"10","009","00","050","0015","0108","625","353","272","95","720","1060","0","67.92","33.30"
"10","009","00","050","0016","0000","849","512","337","129","978","1450","0","67.45","35.31"
"10","009","00","050","0016","0109","488","297","191","49","537","788","0","68.15","37.69"
"10","009","00","050","0016","0110","361","215","146","80","441","662","0","66.62","32.48"
"10","009","00","050","0017","0000","731","422","309","89","820","1341","0","61.15","31.47"
"10","009","00","050","0017","0119","369","225","144","29","398","712","0","55.90","31.60"
"10","009","00","050","0017","0120","362","197","165","60","422","629","0","67.09","31.32"
"10","009","00","060","0000","0000","19065","11180","7885","1869","20934","31943","37876","65.54","35.00"
"10","009","00","060","0001","0000","465","287","178","39","504","671","0","75.11","42.77"
"10","009","00","060","0001","0278","465","287","178","39","504","671","0","75.11","42.77"
"10","009","00","060","0002","0000","480","292","188","55","535","655","0","81.68","44.58"
"10","009","00","060","0002","0279","480","292","188","55","535","655","0","81.68","44.58"
"10","009","00","060","0003","0000","249","129","120","24","273","408","0","66.91","31.62"
"10","009","00","060","0003","0280","249","129","120","24","273","408","0","66.91","31.62"
"10","009","00","060","0004","0000","493","301","192","32","525","773","0","67.92","38.94"
"10","009","00","060","0004","0281","493","301","192","32","525","773","0","67.92","38.94"
"10","009","00","060","0005","0000","199","120","79","13","212","320","0","66.25","37.50"
"10","009","00","060","0005","0282","199","120","79","13","212","320","0","66.25","37.50"
"10","009","00","060","0006","0000","211","127","84","30","241","361","0","66.76","35.18"
"10","009","00","060","0006","0283","211","127","84","30","241","361","0","66.76","35.18"
"10","009","00","060","0007","0000","249","141","108","19","268","350","0","76.57","40.29"
"10","009","00","060","0007","0284","249","141","108","19","268","350","0","76.57","40.29"
"10","009","00","060","0008","0000","520","326","194","46","566","880","0","64.32","37.05"
"10","009","00","060","0008","0285","520","326","194","46","566","880","0","64.32","37.05"
"10","009","00","060","0009","0000","263","151","112","21","284","425","0","66.82","35.53"
"10","009","00","060","0009","0286","263","151","112","21","284","425","0","66.82","35.53"
"10","009","00","060","0010","0000","190","106","84","16","206","289","0","71.28","36.68"
"10","009","00","060","0010","0287","190","106","84","16","206","289","0","71.28","36.68"
"10","009","00","060","0011","0000","281","167","114","12","293","491","0","59.67","34.01"
"10","009","00","060","0011","0288","281","167","114","12","293","491","0","59.67","34.01"
"10","009","00","060","0012","0000","667","353","314","57","724","1089","0","66.48","32.42"
"10","009","00","060","0012","0289","248","134","114","20","268","398","0","67.34","33.67"
"10","009","00","060","0012","0290","419","219","200","37","456","691","0","65.99","31.69"
"10","009","00","060","0013","0000","278","153","125","14","292","398","0","73.37","38.44"
"10","009","00","060","0013","0291","278","153","125","14","292","398","0","73.37","38.44"
"10","009","00","060","0014","0000","2829","1629","1200","178","3007","4618","0","65.11","35.28"
"10","009","00","060","0014","0292","659","404","255","47","706","1089","0","64.83","37.10"
"10","009","00","060","0014","0293","689","369","320","40","729","1145","0","63.67","32.23"
"10","009","00","060","0014","0294","677","390","287","41","718","1124","0","63.88","34.70"
"10","009","00","060","0014","0295","804","466","338","50","854","1260","0","67.78","36.98"
"10","009","00","060","0015","0000","961","499","462","90","1051","1597","0","65.81","31.25"
"10","009","00","060","0015","0296","402","218","184","37","439","664","0","66.11","32.83"
"10","009","00","060","0015","0297","559","281","278","53","612","933","0","65.59","30.12"
"10","009","00","060","0016","0000","3547","1849","1698","228","3775","6115","0","61.73","30.24"
"10","009","00","060","0016","0300","749","375","374","32","781","1332","0","58.63","28.15"
"10","009","00","060","0016","0301","618","318","300","40","658","1060","0","62.08","30.00"
"10","009","00","060","0016","0302","442","212","230","22","464","743","0","62.45","28.53"
"10","009","00","060","0016","0303","474","221","253","29","503","773","0","65.07","28.59"
"10","009","00","060","0016","0304","628","352","276","42","670","1097","0","61.08","32.09"
"10","009","00","060","0016","0305","636","371","265","63","699","1110","0","62.97","33.42"
"10","009","00","060","0017","0000","609","395","214","89","698","1080","0","64.63","36.57"
"10","009","00","060","0017","0306","609","395","214","89","698","1080","0","64.63","36.57"
"10","009","00","060","0018","0000","322","190","132","27","349","762","0","45.80","24.93"
"10","009","00","060","0018","0310","322","190","132","27","349","762","0","45.80","24.93"
"10","009","00","060","0019","0000","725","480","245","82","807","1275","0","63.29","37.65"
"10","009","00","060","0019","0311","332","215","117","25","357","579","0","61.66","37.13"
"10","009","00","060","0019","0312","393","265","128","57","450","696","0","64.66","38.07"
"10","009","00","060","0020","0000","611","407","204","112","723","1075","0","67.26","37.86"
"10","009","00","060","0020","0313","611","407","204","112","723","1075","0","67.26","37.86"
"10","009","00","060","0021","0000","528","326","202","82","610","935","0","65.24","34.87"
"10","009","00","060","0021","0307","246","167","79","62","308","509","0","60.51","32.81"
"10","009","00","060","0021","0308","282","159","123","20","302","426","0","70.89","37.32"
"10","009","00","060","0022","0000","375","258","117","77","452","727","0","62.17","35.49"
"10","009","00","060","0022","0314","375","258","117","77","452","727","0","62.17","35.49"
"10","009","00","060","0023","0000","316","209","107","65","381","529","0","72.02","39.51"
"10","009","00","060","0023","0315","316","209","107","65","381","529","0","72.02","39.51"
"10","009","00","060","0024","0000","975","617","358","163","1138","1531","0","74.33","40.30"
"10","009","00","060","0024","0316","608","398","210","106","714","985","0","72.49","40.41"
"10","009","00","060","0024","0317","367","219","148","57","424","546","0","77.66","40.11"
"10","009","00","060","0025","0000","1666","963","703","172","1838","2831","0","64.92","34.02"
"10","009","00","060","0025","0318","480","329","151","67","547","856","0","63.90","38.43"
"10","009","00","060","0025","0319","582","301","281","47","629","984","0","63.92","30.59"
"10","009","00","060","0025","0320","604","333","271","58","662","991","0","66.80","33.60"
"10","009","00","060","0026","0000","471","342","129","32","503","916","0","54.91","37.34"
"10","009","00","060","0026","0298","471","342","129","32","503","916","0","54.91","37.34"
"10","009","00","060","0027","0000","289","192","97","62","351","456","0","76.97","42.11"
"10","009","00","060","0027","0299","289","192","97","62","351","456","0","76.97","42.11"
"10","009","00","060","0028","0000","296","171","125","32","328","386","0","84.97","44.30"
"10","009","00","060","0028","0309","296","171","125","32","328","386","0","84.97","44.30"
"10","009","00","070","0000","0000","14864","8269","6595","1470","16334","26284","30157","62.14","31.46"
"10","009","00","070","0001","0000","629","362","267","104","733","1148","0","63.85","31.53"
"10","009","00","070","0001","0599","629","362","267","104","733","1148","0","63.85","31.53"
"10","009","00","070","0002","0000","694","376","318","47","741","1047","0","70.77","35.91"
"10","009","00","070","0002","0600","694","376","318","47","741","1047","0","70.77","35.91"
"10","009","00","070","0003","0000","688","406","282","66","754","1085","0","69.49","37.42"
"10","009","00","070","0003","0598","688","406","282","66","754","1085","0","69.49","37.42"
"10","009","00","070","0004","0000","671","335","336","34","705","1338","0","52.69","25.04"
"10","009","00","070","0004","0596","522","265","257","21","543","1049","0","51.76","25.26"
"10","009","00","070","0004","0597","149","70","79","13","162","289","0","56.06","24.22"
"10","009","00","070","0005","0000","1621","879","742","125","1746","3006","0","58.08","29.24"
"10","009","00","070","0005","0593","519","279","240","47","566","901","0","62.82","30.97"
"10","009","00","070","0005","0594","612","338","274","36","648","1093","0","59.29","30.92"
"10","009","00","070","0005","0595","490","262","228","42","532","1012","0","52.57","25.89"
"10","009","00","070","0006","0000","919","510","409","98","1017","1416","0","71.82","36.02"
"10","009","00","070","0006","0591","496","252","244","59","555","730","0","76.03","34.52"
"10","009","00","070","0006","0592","423","258","165","39","462","686","0","67.35","37.61"
"10","009","00","070","0007","0000","1015","619","396","77","1092","1960","0","55.71","31.58"
"10","009","00","070","0007","0589","452","262","190","18","470","1037","0","45.32","25.27"
"10","009","00","070","0007","0590","563","357","206","59","622","923","0","67.39","38.68"
"10","009","00","070","0008","0000","387","211","176","47","434","668","0","64.97","31.59"
"10","009","00","070","0008","0614","387","211","176","47","434","668","0","64.97","31.59"
"10","009","00","070","0009","0000","108","70","38","5","113","254","0","44.49","27.56"
"10","009","00","070","0009","0613","108","70","38","5","113","254","0","44.49","27.56"
"10","009","00","070","0010","0000","1156","665","491","104","1260","2043","0","61.67","32.55"
"10","009","00","070","0010","0607","549","339","210","32","581","957","0","60.71","35.42"
"10","009","00","070","0010","0608","607","326","281","72","679","1086","0","62.52","30.02"
"10","009","00","070","0011","0000","567","338","229","94","661","1027","0","64.36","32.91"
"10","009","00","070","0011","0615","567","338","229","94","661","1027","0","64.36","32.91"
"10","009","00","070","0012","0000","648","366","282","44","692","1204","0","57.48","30.40"
"10","009","00","070","0012","0612","648","366","282","44","692","1204","0","57.48","30.40"
"10","009","00","070","0013","0000","261","132","129","73","334","430","0","77.67","30.70"
"10","009","00","070","0013","0616","261","132","129","73","334","430","0","77.67","30.70"
"10","009","00","070","0014","0000","308","172","136","45","353","516","0","68.41","33.33"
"10","009","00","070","0014","0617","308","172","136","45","353","516","0","68.41","33.33"
"10","009","00","070","0015","0000","1127","629","498","115","1242","1967","0","63.14","31.98"
"10","009","00","070","0015","0609","614","342","272","65","679","1056","0","64.30","32.39"
"10","009","00","070","0015","0610","513","287","226","50","563","911","0","61.80","31.50"
"10","009","00","070","0016","0000","428","274","154","38","466","713","0","65.36","38.43"
"10","009","00","070","0016","0611","428","274","154","38","466","713","0","65.36","38.43"
"10","009","00","070","0017","0000","1273","678","595","147","1420","2192","0","64.78","30.93"
"10","009","00","070","0017","0601","646","334","312","71","717","1093","0","65.60","30.56"
"10","009","00","070","0017","0602","627","344","283","76","703","1099","0","63.97","31.30"
"10","009","00","070","0018","0000","995","488","507","105","1100","2009","0","54.75","24.29"
"10","009","00","070","0018","0603","475","244","231","63","538","912","0","58.99","26.75"
"10","009","00","070","0018","0604","520","244","276","42","562","1097","0","51.23","22.24"
"10","009","00","070","0019","0000","1016","562","454","83","1099","1578","0","69.65","35.61"
"10","009","00","070","0019","0605","1016","562","454","83","1099","1578","0","69.65","35.61"
"10","009","00","070","0020","0000","353","197","156","19","372","683","0","54.47","28.84"
"10","009","00","070","0020","0606","353","197","156","19","372","683","0","54.47","28.84"
"10","009","00","080","0000","0000","9607","5647","3960","1025","10632","15798","18276","67.30","35.75"
"10","009","00","080","0001","0000","452","272","180","40","492","705","0","69.79","38.58"
"10","009","00","080","0001","0532","452","272","180","40","492","705","0","69.79","38.58"
"10","009","00","080","0002","0000","1335","723","612","109","1444","2069","0","69.79","34.94"
"10","009","00","080","0002","0536","596","322","274","48","644","916","0","70.31","35.15"
"10","009","00","080","0002","0537","372","201","171","47","419","569","0","73.64","35.33"
"10","009","00","080","0002","0538","367","200","167","14","381","584","0","65.24","34.25"
"10","009","00","080","0003","0000","550","334","216","52","602","922","0","65.29","36.23"
"10","009","00","080","0003","0539","550","334","216","52","602","922","0","65.29","36.23"
"10","009","00","080","0004","0000","536","346","190","79","615","867","0","70.93","39.91"
"10","009","00","080","0004","0540","536","346","190","79","615","867","0","70.93","39.91"
"10","009","00","080","0005","0000","1082","634","448","86","1168","1909","0","61.18","33.21"
"10","009","00","080","0005","0543","374","197","177","26","400","679","0","58.91","29.01"
"10","009","00","080","0005","0544","426","262","164","29","455","795","0","57.23","32.96"
"10","009","00","080","0005","0545","282","175","107","31","313","435","0","71.95","40.23"
"10","009","00","080","0006","0000","1045","606","439","101","1146","1755","0","65.30","34.53"
"10","009","00","080","0006","0546","746","412","334","74","820","1262","0","64.98","32.65"
"10","009","00","080","0006","0547","299","194","105","27","326","493","0","66.13","39.35"
"10","009","00","080","0007","0000","943","531","412","90","1033","1508","0","68.50","35.21"
"10","009","00","080","0007","0541","385","213","172","32","417","550","0","75.82","38.73"
"10","009","00","080","0007","0542","558","318","240","58","616","958","0","64.30","33.19"
"10","009","00","080","0008","0000","673","389","284","48","721","1143","0","63.08","34.03"
"10","009","00","080","0008","0548","673","389","284","48","721","1143","0","63.08","34.03"
"10","009","00","080","0009","0000","436","277","159","46","482","669","0","72.05","41.41"
"10","009","00","080","0009","0533","436","277","159","46","482","669","0","72.05","41.41"
"10","009","00","080","0010","0000","311","177","134","25","336","561","0","59.89","31.55"
"10","009","00","080","0010","0534","311","177","134","25","336","561","0","59.89","31.55"
"10","009","00","080","0011","0000","615","354","261","107","722","1012","0","71.34","34.98"
"10","009","00","080","0011","0535","615","354","261","107","722","1012","0","71.34","34.98"
"10","009","00","080","0012","0000","462","250","212","44","506","711","0","71.17","35.16"
"10","009","00","080","0012","0549","462","250","212","44","506","711","0","71.17","35.16"
"10","009","00","080","0013","0000","380","248","132","24","404","651","0","62.06","38.10"
"10","009","00","080","0013","0550","380","248","132","24","404","651","0","62.06","38.10"
"10","009","00","080","0014","0000","423","260","163","86","509","643","0","79.16","40.44"
"10","009","00","080","0014","0551","423","260","163","86","509","643","0","79.16","40.44"
"10","009","00","080","0015","0000","364","246","118","88","452","673","0","67.16","36.55"
"10","009","00","080","0015","0552","364","246","118","88","452","673","0","67.16","36.55"
"10","009","00","090","0000","0000","13929","8209","5720","1499","15428","23408","27575","65.91","35.07"
"10","009","00","090","0001","0000","2289","1284","1005","183","2472","4032","0","61.31","31.85"
"10","009","00","090","0001","0407","548","285","263","34","582","963","0","60.44","29.60"
"10","009","00","090","0001","0408","468","276","192","43","511","872","0","58.60","31.65"
"10","009","00","090","0001","0409","535","298","237","27","562","933","0","60.24","31.94"
"10","009","00","090","0001","0410","738","425","313","79","817","1264","0","64.64","33.62"
"10","009","00","090","0002","0000","571","364","207","70","641","812","0","78.94","44.83"
"10","009","00","090","0002","0411","571","364","207","70","641","812","0","78.94","44.83"
"10","009","00","090","0003","0000","816","482","334","64","880","1457","0","60.40","33.08"
"10","009","00","090","0003","0412","447","268","179","32","479","733","0","65.35","36.56"
"10","009","00","090","0003","0413","369","214","155","32","401","724","0","55.39","29.56"
"10","009","00","090","0004","0000","702","413","289","109","811","1111","0","73.00","37.17"
"10","009","00","090","0004","0414","336","183","153","43","379","546","0","69.41","33.52"
"10","009","00","090","0004","0415","366","230","136","66","432","565","0","76.46","40.71"
"10","009","00","090","0005","0000","577","371","206","82","659","1025","0","64.29","36.20"
"10","009","00","090","0005","0416","577","371","206","82","659","1025","0","64.29","36.20"
"10","009","00","090","0006","0000","1275","769","506","89","1364","1942","0","70.24","39.60"
"10","009","00","090","0006","0417","671","398","273","42","713","986","0","72.31","40.37"
"10","009","00","090","0006","0418","604","371","233","47","651","956","0","68.10","38.81"
"10","009","00","090","0007","0000","1589","932","657","120","1709","2960","0","57.74","31.49"
"10","009","00","090","0007","0419","569","339","230","32","601","1059","0","56.75","32.01"
"10","009","00","090","0007","0420","461","262","199","17","478","888","0","53.83","29.50"
"10","009","00","090","0007","0421","559","331","228","71","630","1013","0","62.19","32.68"
"10","009","00","090","0008","0000","809","443","366","100","909","1182","0","76.90","37.48"
"10","009","00","090","0008","0422","809","443","366","100","909","1182","0","76.90","37.48"
"10","009","00","090","0009","0000","619","366","253","62","681","1095","0","62.19","33.42"
"10","009","00","090","0009","0425","619","366","253","62","681","1095","0","62.19","33.42"
"10","009","00","090","0010","0000","1195","699","496","125","1320","1800","0","73.33","38.83"
"10","009","00","090","0010","0423","554","280","274","71","625","830","0","75.30","33.73"
"10","009","00","090","0010","0424","641","419","222","54","695","970","0","71.65","43.20"
"10","009","00","090","0011","0000","908","534","374","170","1078","1649","0","65.37","32.38"
"10","009","00","090","0011","0426","442","270","172","92","534","813","0","65.68","33.21"
"10","009","00","090","0011","0427","466","264","202","78","544","836","0","65.07","31.58"
"10","009","00","090","0012","0000","835","515","320","129","964","1384","0","69.65","37.21"
"10","009","00","090","0012","0428","524","331","193","77","601","878","0","68.45","37.70"
"10","009","00","090","0012","0429","311","184","127","52","363","506","0","71.74","36.36"
"10","009","00","090","0013","0000","651","384","267","65","716","1243","0","57.60","30.89"
"10","009","00","090","0013","0430","259","161","98","35","294","430","0","68.37","37.44"
"10","009","00","090","0013","0431","392","223","169","30","422","813","0","51.91","27.43"
"10","009","00","090","0014","0000","1093","653","440","131","1224","1716","0","71.33","38.05"
"10","009","00","090","0014","0432","666","404","262","66","732","1099","0","66.61","36.76"
"10","009","00","090","0014","0433","427","249","178","65","492","617","0","79.74","40.36"
"10","009","00","100","0000","0000","9178","5004","4174","1105","10283","14574","17003","70.56","34.34"
"10","009","00","100","0001","0000","637","313","324","57","694","957","0","72.52","32.71"
"10","009","00","100","0001","0434","637","313","324","57","694","957","0","72.52","32.71"
"10","009","00","100","0002","0000","2134","1134","1000","206","2340","3452","0","67.79","32.85"
"10","009","00","100","0002","0435","734","396","338","75","809","1195","0","67.70","33.14"
"10","009","00","100","0002","0436","531","251","280","33","564","837","0","67.38","29.99"
"10","009","00","100","0002","0437","478","257","221","54","532","789","0","67.43","32.57"
"10","009","00","100","0002","0438","391","230","161","44","435","631","0","68.94","36.45"
"10","009","00","100","0003","0000","1259","721","538","153","1412","2007","0","70.35","35.92"
"10","009","00","100","0003","0439","827","430","397","101","928","1325","0","70.04","32.45"
"10","009","00","100","0003","0440","432","291","141","52","484","682","0","70.97","42.67"
"10","009","00","100","0004","0000","291","169","122","70","361","480","0","75.21","35.21"
"10","009","00","100","0004","0441","291","169","122","70","361","480","0","75.21","35.21"
"10","009","00","100","0005","0000","477","281","196","80","557","780","0","71.41","36.03"
"10","009","00","100","0005","0442","477","281","196","80","557","780","0","71.41","36.03"
"10","009","00","100","0006","0000","1574","839","735","168","1742","2505","0","69.54","33.49"
"10","009","00","100","0006","0443","826","428","398","102","928","1275","0","72.78","33.57"
"10","009","00","100","0006","0444","748","411","337","66","814","1230","0","66.18","33.41"
"10","009","00","100","0007","0000","423","242","181","61","484","607","0","79.74","39.87"
"10","009","00","100","0007","0445","423","242","181","61","484","607","0","79.74","39.87"
"10","009","00","100","0008","0000","621","304","317","64","685","1070","0","64.02","28.41"
"10","009","00","100","0008","0446","621","304","317","64","685","1070","0","64.02","28.41"
"10","009","00","100","0009","0000","638","330","308","98","736","993","0","74.12","33.23"
"10","009","00","100","0009","0447","638","330","308","98","736","993","0","74.12","33.23"
"10","009","00","100","0010","0000","1124","671","453","148","1272","1723","0","73.82","38.94"
"10","009","00","100","0010","0448","618","377","241","64","682","908","0","75.11","41.52"
"10","009","00","100","0010","0449","506","294","212","84","590","815","0","72.39","36.07"
"10","009","00","110","0000","0000","12052","7589","4463","1743","13795","21955","25299","62.83","34.57"
"10","009","00","110","0001","0000","829","473","356","94","923","1402","0","65.83","33.74"
"10","009","00","110","0001","0342","483","258","225","50","533","818","0","65.16","31.54"
"10","009","00","110","0001","0343","346","215","131","44","390","584","0","66.78","36.82"
"10","009","00","110","0002","0000","1026","607","419","103","1129","1672","0","67.52","36.30"
"10","009","00","110","0002","0344","564","328","236","54","618","902","0","68.51","36.36"
"10","009","00","110","0002","0345","462","279","183","49","511","770","0","66.36","36.23"
"10","009","00","110","0003","0000","840","550","290","164","1004","1517","0","66.18","36.26"
"10","009","00","110","0003","0346","320","208","112","68","388","586","0","66.21","35.49"
"10","009","00","110","0003","0347","520","342","178","96","616","931","0","66.17","36.73"
"10","009","00","110","0004","0000","700","445","255","124","824","1407","0","58.56","31.63"
"10","009","00","110","0004","0348","211","132","79","28","239","419","0","57.04","31.50"
"10","009","00","110","0004","0349","489","313","176","96","585","988","0","59.21","31.68"
"10","009","00","110","0005","0000","663","373","290","97","760","1101","0","69.03","33.88"
"10","009","00","110","0005","0350","663","373","290","97","760","1101","0","69.03","33.88"
"10","009","00","110","0006","0000","1038","654","384","154","1192","1775","0","67.15","36.85"
"10","009","00","110","0006","0351","545","354","191","80","625","982","0","63.65","36.05"
"10","009","00","110","0006","0352","493","300","193","74","567","793","0","71.50","37.83"
"10","009","00","110","0007","0000","532","323","209","83","615","836","0","73.56","38.64"
"10","009","00","110","0007","0353","532","323","209","83","615","836","0","73.56","38.64"
"10","009","00","110","0008","0000","411","283","128","77","488","831","0","58.72","34.06"
"10","009","00","110","0008","0356","411","283","128","77","488","831","0","58.72","34.06"
"10","009","00","110","0009","0000","389","253","136","58","447","712","0","62.78","35.53"
"10","009","00","110","0009","0357","389","253","136","58","447","712","0","62.78","35.53"
"10","009","00","110","0010","0000","739","511","228","112","851","1399","0","60.83","36.53"
"10","009","00","110","0010","0358","279","193","86","36","315","627","0","50.24","30.78"
"10","009","00","110","0010","0359","460","318","142","76","536","772","0","69.43","41.19"
"10","009","00","110","0011","0000","826","548","278","64","890","1708","0","52.11","32.08"
"10","009","00","110","0011","0360","507","360","147","45","552","1086","0","50.83","33.15"
"10","009","00","110","0011","0361","319","188","131","19","338","622","0","54.34","30.23"
"10","009","00","110","0012","0000","419","251","168","58","477","795","0","60.00","31.57"
"10","009","00","110","0012","0362","419","251","168","58","477","795","0","60.00","31.57"
"10","009","00","110","0013","0000","838","493","345","89","927","1655","0","56.01","29.79"
"10","009","00","110","0013","0363","512","296","216","41","553","1010","0","54.75","29.31"
"10","009","00","110","0013","0364","326","197","129","48","374","645","0","57.98","30.54"
"10","009","00","110","0014","0000","675","440","235","109","784","1173","0","66.84","37.51"
"10","009","00","110","0014","0365","675","440","235","109","784","1173","0","66.84","37.51"
"10","009","00","110","0015","0000","375","253","122","89","464","867","0","53.52","29.18"
"10","009","00","110","0015","0366","375","253","122","89","464","867","0","53.52","29.18"
"10","009","00","110","0016","0000","450","299","151","72","522","792","0","65.91","37.75"
"10","009","00","110","0016","0367","450","299","151","72","522","792","0","65.91","37.75"
"10","009","00","110","0017","0000","550","366","184","98","648","958","0","67.64","38.20"
"10","009","00","110","0017","0368","550","366","184","98","648","958","0","67.64","38.20"
"10","009","00","110","0018","0000","752","467","285","98","850","1355","0","62.73","34.46"
"10","009","00","110","0018","0354","429","267","162","65","494","780","0","63.33","34.23"
"10","009","00","110","0018","0355","323","200","123","33","356","575","0","61.91","34.78"
"10","009","00","120","0000","0000","10239","6292","3947","1667","11906","19833","23140","60.03","31.72"
"10","009","00","120","0001","0000","584","347","237","62","646","1067","0","60.54","32.52"
"10","009","00","120","0001","0321","584","347","237","62","646","1067","0","60.54","32.52"
"10","009","00","120","0002","0000","650","376","274","60","710","1394","0","50.93","26.97"
"10","009","00","120","0002","0322","650","376","274","60","710","1394","0","50.93","26.97"
"10","009","00","120","0003","0000","1348","761","587","160","1508","2237","0","67.41","34.02"
"10","009","00","120","0003","0323","633","384","249","66","699","1093","0","63.95","35.13"
"10","009","00","120","0003","0324","715","377","338","94","809","1144","0","70.72","32.95"
"10","009","00","120","0004","0000","1055","654","401","129","1184","1973","0","60.01","33.15"
"10","009","00","120","0004","0325","589","363","226","63","652","1026","0","63.55","35.38"
"10","009","00","120","0004","0326","466","291","175","66","532","947","0","56.18","30.73"
"10","009","00","120","0005","0000","1062","651","411","115","1177","1977","0","59.53","32.93"
"10","009","00","120","0005","0327","474","283","191","37","511","934","0","54.71","30.30"
"10","009","00","120","0005","0328","588","368","220","78","666","1043","0","63.85","35.28"
"10","009","00","120","0006","0000","657","450","207","95","752","1218","0","61.74","36.95"
"10","009","00","120","0006","0329","657","450","207","95","752","1218","0","61.74","36.95"
"10","009","00","120","0007","0000","1010","599","411","256","1266","1941","0","65.22","30.86"
"10","009","00","120","0007","0330","463","260","203","170","633","971","0","65.19","26.78"
"10","009","00","120","0007","0331","547","339","208","86","633","970","0","65.26","34.95"
"10","009","00","120","0008","0000","410","232","178","105","515","741","0","69.50","31.31"
"10","009","00","120","0008","0332","410","232","178","105","515","741","0","69.50","31.31"
"10","009","00","120","0009","0000","574","375","199","64","638","1424","0","44.80","26.33"
"10","009","00","120","0009","0333","237","151","86","19","256","648","0","39.51","23.30"
"10","009","00","120","0009","0334","337","224","113","45","382","776","0","49.23","28.87"
"10","009","00","120","0010","0000","658","437","221","131","789","1620","0","48.70","26.98"
"10","009","00","120","0010","0335","407","265","142","89","496","818","0","60.64","32.40"
"10","009","00","120","0010","0336","251","172","79","42","293","802","0","36.53","21.45"
"10","009","00","120","0011","0000","715","438","277","206","921","1332","0","69.14","32.88"
"10","009","00","120","0011","0337","332","212","120","106","438","633","0","69.19","33.49"
"10","009","00","120","0011","0338","383","226","157","100","483","699","0","69.10","32.33"
"10","009","00","120","0012","0000","491","309","182","106","597","1057","0","56.48","29.23"
"10","009","00","120","0012","0339","491","309","182","106","597","1057","0","56.48","29.23"
"10","009","00","120","0013","0000","580","392","188","95","675","1140","0","59.21","34.39"
"10","009","00","120","0013","0340","580","392","188","95","675","1140","0","59.21","34.39"
"10","009","00","120","0014","0000","445","271","174","83","528","712","0","74.16","38.06"
"10","009","00","120","0014","0341","445","271","174","83","528","712","0","74.16","38.06"
"10","009","00","130","0000","0000","21907","12338","9569","2973","24880","39211","49134","63.45","31.47"
"10","009","00","130","0001","0000","2208","1195","1013","270","2478","4238","0","58.47","28.20"
"10","009","00","130","0001","0007","634","351","283","86","720","1126","0","63.94","31.17"
"10","009","00","130","0001","0008","493","265","228","64","557","941","0","59.19","28.16"
"10","009","00","130","0001","0009","616","340","276","43","659","1179","0","55.89","28.84"
"10","009","00","130","0001","0010","465","239","226","77","542","992","0","54.64","24.09"
"10","009","00","130","0002","0000","4264","2271","1993","383","4647","7472","0","62.19","30.39"
"10","009","00","130","0002","0001","717","389","328","48","765","1346","0","56.84","28.90"
"10","009","00","130","0002","0002","685","376","309","73","758","1237","0","61.28","30.40"
"10","009","00","130","0002","0003","698","356","342","61","759","1287","0","58.97","27.66"
"10","009","00","130","0002","0004","859","450","409","100","959","1494","0","64.19","30.12"
"10","009","00","130","0002","0005","717","409","308","42","759","1070","0","70.93","38.22"
"10","009","00","130","0002","0006","588","291","297","59","647","1038","0","62.33","28.03"
"10","009","00","130","0003","0000","1023","619","404","138","1161","1966","0","59.05","31.49"
"10","009","00","130","0003","0011","396","263","133","82","478","730","0","65.48","36.03"
"10","009","00","130","0003","0012","627","356","271","56","683","1236","0","55.26","28.80"
"10","009","00","130","0004","0000","1557","925","632","281","1838","2901","0","63.36","31.89"
"10","009","00","130","0004","0013","623","379","244","105","728","1211","0","60.12","31.30"
"10","009","00","130","0004","0014","545","320","225","99","644","1007","0","63.95","31.78"
"10","009","00","130","0004","0015","389","226","163","77","466","683","0","68.23","33.09"
"10","009","00","130","0005","0000","1489","811","678","253","1742","2725","0","63.93","29.76"
"10","009","00","130","0005","0025","747","387","360","143","890","1359","0","65.49","28.48"
"10","009","00","130","0005","0026","742","424","318","110","852","1366","0","62.37","31.04"
"10","009","00","130","0006","0000","1486","849","637","214","1700","3032","0","56.07","28.00"
"10","009","00","130","0006","0018","559","330","229","103","662","1078","0","61.41","30.61"
"10","009","00","130","0006","0019","435","237","198","43","478","932","0","51.29","25.43"
"10","009","00","130","0006","0020","492","282","210","68","560","1022","0","54.79","27.59"
"10","009","00","130","0007","0000","1171","622","549","227","1398","2214","0","63.14","28.09"
"10","009","00","130","0007","0016","614","306","308","154","768","1225","0","62.69","24.98"
"10","009","00","130","0007","0017","557","316","241","73","630","989","0","63.70","31.95"
"10","009","00","130","0008","0000","1105","649","456","184","1289","2149","0","59.98","30.20"
"10","009","00","130","0008","0023","499","292","207","106","605","1009","0","59.96","28.94"
"10","009","00","130","0008","0024","606","357","249","78","684","1140","0","60.00","31.32"
"10","009","00","130","0009","0000","2353","1369","984","354","2707","3997","0","67.73","34.25"
"10","009","00","130","0009","0027","706","423","283","102","808","1208","0","66.89","35.02"
"10","009","00","130","0009","0028","576","324","252","99","675","977","0","69.09","33.16"
"10","009","00","130","0009","0029","538","321","217","74","612","896","0","68.30","35.83"
"10","009","00","130","0009","0030","533","301","232","79","612","916","0","66.81","32.86"
"10","009","00","130","0010","0000","768","437","331","83","851","1148","0","74.13","38.07"
"10","009","00","130","0010","0031","768","437","331","83","851","1148","0","74.13","38.07"
"10","009","00","130","0011","0000","2388","1369","1019","325","2713","3635","0","74.64","37.66"
"10","009","00","130","0011","0032","718","432","286","81","799","1092","0","73.17","39.56"
"10","009","00","130","0011","0033","745","408","337","140","885","1135","0","77.97","35.95"
"10","009","00","130","0011","0034","925","529","396","104","1029","1408","0","73.08","37.57"
"10","009","00","130","0012","0000","1264","753","511","147","1411","2204","0","64.02","34.17"
"10","009","00","130","0012","0035","795","440","355","133","928","1173","0","79.11","37.51"
"10","009","00","130","0012","0036","469","313","156","14","483","1031","0","46.85","30.36"
"10","009","00","130","0013","0000","831","469","362","114","945","1530","0","61.76","30.65"
"10","009","00","130","0013","0021","402","231","171","62","464","800","0","58.00","28.88"
"10","009","00","130","0013","0022","429","238","191","52","481","730","0","65.89","32.60"
"10","009","00","140","0000","0000","6941","4280","2661","1198","8139","12234","13738","66.53","34.98"
"10","009","00","140","0001","0000","889","457","432","105","994","1397","0","71.15","32.71"
"10","009","00","140","0001","0065","546","278","268","61","607","830","0","73.13","33.49"
"10","009","00","140","0001","0066","343","179","164","44","387","567","0","68.25","31.57"
"10","009","00","140","0002","0000","656","397","259","71","727","1121","0","64.85","35.41"
"10","009","00","140","0002","0067","656","397","259","71","727","1121","0","64.85","35.41"
"10","009","00","140","0003","0000","889","566","323","195","1084","1467","0","73.89","38.58"
"10","009","00","140","0003","0063","500","329","171","110","610","828","0","73.67","39.73"
"10","009","00","140","0003","0064","389","237","152","85","474","639","0","74.18","37.09"
"10","009","00","140","0004","0000","312","196","116","24","336","513","0","65.50","38.21"
"10","009","00","140","0004","0062","312","196","116","24","336","513","0","65.50","38.21"
"10","009","00","140","0005","0000","587","347","240","91","678","1102","0","61.52","31.49"
"10","009","00","140","0005","0061","587","347","240","91","678","1102","0","61.52","31.49"
"10","009","00","140","0006","0000","381","228","153","72","453","545","0","83.12","41.83"
"10","009","00","140","0006","0069","381","228","153","72","453","545","0","83.12","41.83"
"10","009","00","140","0007","0000","503","336","167","92","595","770","0","77.27","43.64"
"10","009","00","140","0007","0068","503","336","167","92","595","770","0","77.27","43.64"
"10","009","00","140","0008","0000","329","228","101","22","351","773","0","45.41","29.50"
"10","009","00","140","0008","0071","329","228","101","22","351","773","0","45.41","29.50"
"10","009","00","140","0009","0000","465","297","168","97","562","788","0","71.32","37.69"
"10","009","00","140","0009","0070","465","297","168","97","562","788","0","71.32","37.69"
"10","009","00","140","0010","0000","1063","676","387","207","1270","1843","0","68.91","36.68"
"10","009","00","140","0010","0072","478","289","189","87","565","877","0","64.42","32.95"
"10","009","00","140","0010","0073","585","387","198","120","705","966","0","72.98","40.06"
"10","009","00","140","0011","0000","473","300","173","153","626","980","0","63.88","30.61"
"10","009","00","140","0011","0076","473","300","173","153","626","980","0","63.88","30.61"
"10","009","00","140","0012","0000","394","252","142","69","463","935","0","49.52","26.95"
"10","009","00","140","0012","0074","203","122","81","17","220","554","0","39.71","22.02"
"10","009","00","140","0012","0075","191","130","61","52","243","381","0","63.78","34.12"
"10","009","00","150","0000","0000","6546","3825","2721","1153","7699","10577","12176","72.79","36.16"
"10","009","00","150","0001","0000","1119","636","483","173","1292","1810","0","71.38","35.14"
"10","009","00","150","0001","0077","533","307","226","86","619","840","0","73.69","36.55"
"10","009","00","150","0001","0078","586","329","257","87","673","970","0","69.38","33.92"
"10","009","00","150","0002","0000","856","455","401","117","973","1382","0","70.41","32.92"
"10","009","00","150","0002","0079","427","219","208","74","501","694","0","72.19","31.56"
"10","009","00","150","0002","0080","429","236","193","43","472","688","0","68.60","34.30"
"10","009","00","150","0003","0000","902","506","396","135","1037","1397","0","74.23","36.22"
"10","009","00","150","0003","0081","452","243","209","73","525","706","0","74.36","34.42"
"10","009","00","150","0003","0082","450","263","187","62","512","691","0","74.10","38.06"
"10","009","00","150","0004","0000","679","426","253","123","802","1134","0","70.72","37.57"
"10","009","00","150","0004","0085","281","174","107","77","358","437","0","81.92","39.82"
"10","009","00","150","0004","0086","398","252","146","46","444","697","0","63.70","36.15"
"10","009","00","150","0005","0000","869","524","345","165","1034","1364","0","75.81","38.42"
"10","009","00","150","0005","0083","306","173","133","35","341","447","0","76.29","38.70"
"10","009","00","150","0005","0084","563","351","212","130","693","917","0","75.57","38.28"
"10","009","00","150","0006","0000","495","305","190","109","604","787","0","76.75","38.75"
"10","009","00","150","0006","0087","495","305","190","109","604","787","0","76.75","38.75"
"10","009","00","150","0007","0000","422","266","156","116","538","730","0","73.70","36.44"
"10","009","00","150","0007","0088","422","266","156","116","538","730","0","73.70","36.44"
"10","009","00","150","0008","0000","707","405","302","145","852","1149","0","74.15","35.25"
"10","009","00","150","0008","0089","707","405","302","145","852","1149","0","74.15","35.25"
"10","009","00","150","0009","0000","497","302","195","70","567","824","0","68.81","36.65"
"10","009","00","150","0009","0090","497","302","195","70","567","824","0","68.81","36.65"
"10","009","00","160","0000","0000","10073","5795","4278","1776","11849","19664","22224","60.26","29.47"
"10","009","00","160","0001","0000","547","259","288","20","567","1184","0","47.89","21.88"
"10","009","00","160","0001","0037","547","259","288","20","567","1184","0","47.89","21.88"
"10","009","00","160","0002","0000","696","361","335","121","817","1068","0","76.50","33.80"
"10","009","00","160","0002","0039","696","361","335","121","817","1068","0","76.50","33.80"
"10","009","00","160","0003","0000","632","336","296","134","766","1054","0","72.68","31.88"
"10","009","00","160","0003","0038","632","336","296","134","766","1054","0","72.68","31.88"
"10","009","00","160","0004","0000","779","460","319","60","839","1903","0","44.09","24.17"
"10","009","00","160","0004","0040","350","203","147","19","369","961","0","38.40","21.12"
"10","009","00","160","0004","0041","429","257","172","41","470","942","0","49.89","27.28"
"10","009","00","160","0005","0000","717","418","299","70","787","1368","0","57.53","30.56"
"10","009","00","160","0005","0043","294","166","128","18","312","671","0","46.50","24.74"
"10","009","00","160","0005","0044","423","252","171","52","475","697","0","68.15","36.15"
"10","009","00","160","0006","0000","907","537","370","243","1150","1744","0","65.94","30.79"
"10","009","00","160","0006","0045","574","354","220","152","726","1074","0","67.60","32.96"
"10","009","00","160","0006","0046","333","183","150","91","424","670","0","63.28","27.31"
"10","009","00","160","0007","0000","244","147","97","15","259","587","0","44.12","25.04"
"10","009","00","160","0007","0047","244","147","97","15","259","587","0","44.12","25.04"
"10","009","00","160","0008","0000","387","216","171","71","458","643","0","71.23","33.59"
"10","009","00","160","0008","0049","387","216","171","71","458","643","0","71.23","33.59"
"10","009","00","160","0009","0000","220","161","59","46","266","426","0","62.44","37.79"
"10","009","00","160","0009","0048","220","161","59","46","266","426","0","62.44","37.79"
"10","009","00","160","0010","0000","412","229","183","110","522","788","0","66.24","29.06"
"10","009","00","160","0010","0042","412","229","183","110","522","788","0","66.24","29.06"
"10","009","00","160","0011","0000","789","452","337","94","883","1435","0","61.53","31.50"
"10","009","00","160","0011","0052","575","334","241","74","649","998","0","65.03","33.47"
"10","009","00","160","0011","0053","214","118","96","20","234","437","0","53.55","27.00"
"10","009","00","160","0012","0000","696","403","293","160","856","1283","0","66.72","31.41"
"10","009","00","160","0012","0054","421","228","193","81","502","750","0","66.93","30.40"
"10","009","00","160","0012","0055","275","175","100","79","354","533","0","66.42","32.83"
"10","009","00","160","0013","0000","1341","794","547","262","1603","2822","0","56.80","28.14"
"10","009","00","160","0013","0056","525","324","201","115","640","1000","0","64.00","32.40"
"10","009","00","160","0013","0057","404","234","170","42","446","933","0","47.80","25.08"
"10","009","00","160","0013","0058","412","236","176","105","517","889","0","58.16","26.55"
"10","009","00","160","0014","0000","786","494","292","238","1024","1651","0","62.02","29.92"
"10","009","00","160","0014","0059","494","319","175","133","627","1106","0","56.69","28.84"
"10","009","00","160","0014","0060","292","175","117","105","397","545","0","72.84","32.11"
"10","009","00","160","0015","0000","920","528","392","132","1052","1708","0","61.59","30.91"
"10","009","00","160","0015","0050","632","361","271","60","692","1182","0","58.54","30.54"
"10","009","00","160","0015","0051","288","167","121","72","360","526","0","68.44","31.75"
"10","009","00","170","0000","0000","11134","6936","4198","2363","13497","20993","23825","64.29","33.04"
"10","009","00","170","0001","0000","1610","932","678","215","1825","3164","0","57.68","29.46"
"10","009","00","170","0001","0200","443","262","181","71","514","864","0","59.49","30.32"
"10","009","00","170","0001","0201","733","410","323","101","834","1241","0","67.20","33.04"
"10","009","00","170","0001","0202","434","260","174","43","477","1059","0","45.04","24.55"
"10","009","00","170","0002","0000","697","412","285","163","860","1411","0","60.95","29.20"
"10","009","00","170","0002","0203","340","211","129","85","425","667","0","63.72","31.63"
"10","009","00","170","0002","0204","357","201","156","78","435","744","0","58.47","27.02"
"10","009","00","170","0003","0000","652","377","275","148","800","1254","0","63.80","30.06"
"10","009","00","170","0003","0205","652","377","275","148","800","1254","0","63.80","30.06"
"10","009","00","170","0004","0000","369","243","126","46","415","671","0","61.85","36.21"
"10","009","00","170","0004","0206","369","243","126","46","415","671","0","61.85","36.21"
"10","009","00","170","0005","0000","374","224","150","64","438","881","0","49.72","25.43"
"10","009","00","170","0005","0207","374","224","150","64","438","881","0","49.72","25.43"
"10","009","00","170","0006","0000","515","331","184","118","633","980","0","64.59","33.78"
"10","009","00","170","0006","0208","515","331","184","118","633","980","0","64.59","33.78"
"10","009","00","170","0007","0000","442","264","178","95","537","840","0","63.93","31.43"
"10","009","00","170","0007","0209","442","264","178","95","537","840","0","63.93","31.43"
"10","009","00","170","0008","0000","407","298","109","72","479","701","0","68.33","42.51"
"10","009","00","170","0008","0210","407","298","109","72","479","701","0","68.33","42.51"
"10","009","00","170","0009","0000","285","157","128","66","351","549","0","63.93","28.60"
"10","009","00","170","0009","0211","285","157","128","66","351","549","0","63.93","28.60"
"10","009","00","170","0010","0000","381","245","136","151","532","795","0","66.92","30.82"
"10","009","00","170","0010","0212","381","245","136","151","532","795","0","66.92","30.82"
"10","009","00","170","0011","0000","173","130","43","29","202","322","0","62.73","40.37"
"10","009","00","170","0011","0213","173","130","43","29","202","322","0","62.73","40.37"
"10","009","00","170","0012","0000","545","352","193","115","660","1072","0","61.57","32.84"
"10","009","00","170","0012","0214","545","352","193","115","660","1072","0","61.57","32.84"
"10","009","00","170","0013","0000","773","469","304","219","992","1418","0","69.96","33.07"
"10","009","00","170","0013","0215","275","173","102","95","370","538","0","68.77","32.16"
"10","009","00","170","0013","0216","498","296","202","124","622","880","0","70.68","33.64"
"10","009","00","170","0014","0000","518","333","185","86","604","908","0","66.52","36.67"
"10","009","00","170","0014","0217","518","333","185","86","604","908","0","66.52","36.67"
"10","009","00","170","0015","0000","492","281","211","130","622","794","0","78.34","35.39"
"10","009","00","170","0015","0218","492","281","211","130","622","794","0","78.34","35.39"
"10","009","00","170","0016","0000","537","350","187","85","622","1069","0","58.19","32.74"
"10","009","00","170","0016","0219","537","350","187","85","622","1069","0","58.19","32.74"
"10","009","00","170","0017","0000","435","272","163","135","570","775","0","73.55","35.10"
"10","009","00","170","0017","0220","435","272","163","135","570","775","0","73.55","35.10"
"10","009","00","170","0018","0000","712","472","240","196","908","1394","0","65.14","33.86"
"10","009","00","170","0018","0221","311","197","114","104","415","615","0","67.48","32.03"
"10","009","00","170","0018","0222","401","275","126","92","493","779","0","63.29","35.30"
"10","009","00","170","0019","0000","332","221","111","71","403","551","0","73.14","40.11"
"10","009","00","170","0019","0223","332","221","111","71","403","551","0","73.14","40.11"
"10","009","00","170","0020","0000","491","310","181","79","570","773","0","73.74","40.10"
"10","009","00","170","0020","0224","491","310","181","79","570","773","0","73.74","40.10"
"10","009","00","170","0021","0000","394","263","131","80","474","671","0","70.64","39.20"
"10","009","00","170","0021","0225","394","263","131","80","474","671","0","70.64","39.20"
"10","009","00","180","0000","0000","9946","6080","3866","1410","11356","19483","21652","58.29","31.21"
"10","009","00","180","0001","0000","965","553","412","127","1092","1661","0","65.74","33.29"
"10","009","00","180","0001","0175","575","339","236","74","649","997","0","65.10","34.00"
"10","009","00","180","0001","0176","390","214","176","53","443","664","0","66.72","32.23"
"10","009","00","180","0002","0000","334","226","108","68","402","598","0","67.22","37.79"
"10","009","00","180","0002","0180","334","226","108","68","402","598","0","67.22","37.79"
"10","009","00","180","0003","0000","525","297","228","63","588","911","0","64.54","32.60"
"10","009","00","180","0003","0181","525","297","228","63","588","911","0","64.54","32.60"
"10","009","00","180","0004","0000","472","270","202","69","541","846","0","63.95","31.91"
"10","009","00","180","0004","0182","472","270","202","69","541","846","0","63.95","31.91"
"10","009","00","180","0005","0000","1287","689","598","206","1493","2144","0","69.64","32.14"
"10","009","00","180","0005","0177","506","253","253","72","578","829","0","69.72","30.52"
"10","009","00","180","0005","0178","231","170","61","38","269","441","0","61.00","38.55"
"10","009","00","180","0005","0179","550","266","284","96","646","874","0","73.91","30.43"
"10","009","00","180","0006","0000","330","187","143","15","345","1123","0","30.72","16.65"
"10","009","00","180","0006","0185","330","187","143","15","345","1123","0","30.72","16.65"
"10","009","00","180","0007","0000","421","260","161","74","495","696","0","71.12","37.36"
"10","009","00","180","0007","0184","421","260","161","74","495","696","0","71.12","37.36"
"10","009","00","180","0008","0000","540","356","184","109","649","834","0","77.82","42.69"
"10","009","00","180","0008","0183","540","356","184","109","649","834","0","77.82","42.69"
"10","009","00","180","0009","0000","357","214","143","50","407","800","0","50.88","26.75"
"10","009","00","180","0009","0189","357","214","143","50","407","800","0","50.88","26.75"
"10","009","00","180","0010","0000","248","146","102","19","267","353","0","75.64","41.36"
"10","009","00","180","0010","0190","248","146","102","19","267","353","0","75.64","41.36"
"10","009","00","180","0011","0000","381","254","127","50","431","708","0","60.88","35.88"
"10","009","00","180","0011","0187","381","254","127","50","431","708","0","60.88","35.88"
"10","009","00","180","0012","0000","282","166","116","28","310","862","0","35.96","19.26"
"10","009","00","180","0012","0186","282","166","116","28","310","862","0","35.96","19.26"
"10","009","00","180","0013","0000","810","513","297","74","884","1610","0","54.91","31.86"
"10","009","00","180","0013","0191","378","267","111","35","413","829","0","49.82","32.21"
"10","009","00","180","0013","0192","432","246","186","39","471","781","0","60.31","31.50"
"10","009","00","180","0014","0000","356","193","163","85","441","766","0","57.57","25.20"
"10","009","00","180","0014","0193","356","193","163","85","441","766","0","57.57","25.20"
"10","009","00","180","0015","0000","307","179","128","68","375","645","0","58.14","27.75"
"10","009","00","180","0015","0194","307","179","128","68","375","645","0","58.14","27.75"
"10","009","00","180","0016","0000","504","353","151","57","561","843","0","66.55","41.87"
"10","009","00","180","0016","0195","504","353","151","57","561","843","0","66.55","41.87"
"10","009","00","180","0017","0000","543","382","161","89","632","979","0","64.56","39.02"
"10","009","00","180","0017","0197","543","382","161","89","632","979","0","64.56","39.02"
"10","009","00","180","0018","0000","370","216","154","53","423","912","0","46.38","23.68"
"10","009","00","180","0018","0198","370","216","154","53","423","912","0","46.38","23.68"
"10","009","00","180","0019","0000","214","142","72","4","218","713","0","30.58","19.92"
"10","009","00","180","0019","0199","214","142","72","4","218","713","0","30.58","19.92"
"10","009","00","180","0020","0000","227","136","91","51","278","507","0","54.83","26.82"
"10","009","00","180","0020","0188","227","136","91","51","278","507","0","54.83","26.82"
"10","009","00","180","0021","0000","473","348","125","51","524","972","0","53.91","35.80"
"10","009","00","180","0021","0196","473","348","125","51","524","972","0","53.91","35.80"
"10","009","00","190","0000","0000","12575","7948","4627","2029","14604","22694","25687","64.35","35.02"
"10","009","00","190","0001","0000","636","348","288","105","741","1157","0","64.04","30.08"
"10","009","00","190","0001","0227","636","348","288","105","741","1157","0","64.04","30.08"
"10","009","00","190","0002","0000","664","355","309","80","744","1061","0","70.12","33.46"
"10","009","00","190","0002","0226","664","355","309","80","744","1061","0","70.12","33.46"
"10","009","00","190","0003","0000","389","220","169","73","462","614","0","75.24","35.83"
"10","009","00","190","0003","0228","389","220","169","73","462","614","0","75.24","35.83"
"10","009","00","190","0004","0000","461","296","165","47","508","859","0","59.14","34.46"
"10","009","00","190","0004","0230","461","296","165","47","508","859","0","59.14","34.46"
"10","009","00","190","0005","0000","407","266","141","70","477","670","0","71.19","39.70"
"10","009","00","190","0005","0229","407","266","141","70","477","670","0","71.19","39.70"
"10","009","00","190","0006","0000","607","412","195","80","687","955","0","71.94","43.14"
"10","009","00","190","0006","0231","607","412","195","80","687","955","0","71.94","43.14"
"10","009","00","190","0007","0000","639","415","224","94","733","1345","0","54.50","30.86"
"10","009","00","190","0007","0232","639","415","224","94","733","1345","0","54.50","30.86"
"10","009","00","190","0008","0000","955","573","382","195","1150","1927","0","59.68","29.74"
"10","009","00","190","0008","0233","383","238","145","72","455","808","0","56.31","29.46"
"10","009","00","190","0008","0234","572","335","237","123","695","1119","0","62.11","29.94"
"10","009","00","190","0009","0000","767","480","287","122","889","1434","0","61.99","33.47"
"10","009","00","190","0009","0235","373","236","137","69","442","701","0","63.05","33.67"
"10","009","00","190","0009","0236","394","244","150","53","447","733","0","60.98","33.29"
"10","009","00","190","0010","0000","558","367","191","11","569","1390","0","40.94","26.40"
"10","009","00","190","0010","0237","558","367","191","11","569","1390","0","40.94","26.40"
"10","009","00","190","0011","0000","242","167","75","34","276","482","0","57.26","34.65"
"10","009","00","190","0011","0238","242","167","75","34","276","482","0","57.26","34.65"
"10","009","00","190","0012","0000","668","399","269","142","810","1414","0","57.28","28.22"
"10","009","00","190","0012","0239","668","399","269","142","810","1414","0","57.28","28.22"
"10","009","00","190","0013","0000","466","273","193","92","558","797","0","70.01","34.25"
"10","009","00","190","0013","0240","466","273","193","92","558","797","0","70.01","34.25"
"10","009","00","190","0014","0000","1229","873","356","200","1429","1811","0","78.91","48.21"
"10","009","00","190","0014","0241","245","172","73","32","277","346","0","80.06","49.71"
"10","009","00","190","0014","0242","461","326","135","89","550","719","0","76.50","45.34"
"10","009","00","190","0014","0243","523","375","148","79","602","746","0","80.70","50.27"
"10","009","00","190","0015","0000","513","299","214","78","591","853","0","69.28","35.05"
"10","009","00","190","0015","0244","513","299","214","78","591","853","0","69.28","35.05"
"10","009","00","190","0016","0000","514","343","171","114","628","952","0","65.97","36.03"
"10","009","00","190","0016","0250","514","343","171","114","628","952","0","65.97","36.03"
"10","009","00","190","0017","0000","518","303","215","104","622","898","0","69.27","33.74"
"10","009","00","190","0017","0248","518","303","215","104","622","898","0","69.27","33.74"
"10","009","00","190","0018","0000","369","255","114","80","449","655","0","68.55","38.93"
"10","009","00","190","0018","0249","369","255","114","80","449","655","0","68.55","38.93"
"10","009","00","190","0019","0000","986","646","340","148","1134","1705","0","66.51","37.89"
"10","009","00","190","0019","0245","495","347","148","60","555","884","0","62.78","39.25"
"10","009","00","190","0019","0246","491","299","192","88","579","821","0","70.52","36.42"
"10","009","00","190","0020","0000","719","504","215","86","805","1117","0","72.07","45.12"
"10","009","00","190","0020","0247","719","504","215","86","805","1117","0","72.07","45.12"
"10","009","00","190","0021","0000","268","154","114","74","342","598","0","57.19","25.75"
"10","009","00","190","0021","0251","268","154","114","74","342","598","0","57.19","25.75"
"10","009","00","200","0000","0000","11312","7495","3817","1466","12778","20685","23326","61.77","36.23"
"10","009","00","200","0001","0000","1047","636","411","94","1141","2053","0","55.58","30.98"
"10","009","00","200","0001","0252","658","396","262","79","737","1229","0","59.97","32.22"
"10","009","00","200","0001","0253","389","240","149","15","404","824","0","49.03","29.13"
"10","009","00","200","0002","0000","1066","669","397","80","1146","1915","0","59.84","34.93"
"10","009","00","200","0002","0254","623","386","237","38","661","1202","0","54.99","32.11"
"10","009","00","200","0002","0255","443","283","160","42","485","713","0","68.02","39.69"
"10","009","00","200","0003","0000","501","365","136","72","573","918","0","62.42","39.76"
"10","009","00","200","0003","0275","501","365","136","72","573","918","0","62.42","39.76"
"10","009","00","200","0004","0000","561","425","136","39","600","1134","0","52.91","37.48"
"10","009","00","200","0004","0276","561","425","136","39","600","1134","0","52.91","37.48"
"10","009","00","200","0005","0000","433","288","145","9","442","893","0","49.50","32.25"
"10","009","00","200","0005","0262","433","288","145","9","442","893","0","49.50","32.25"
"10","009","00","200","0006","0000","325","199","126","65","390","571","0","68.30","34.85"
"10","009","00","200","0006","0263","325","199","126","65","390","571","0","68.30","34.85"
"10","009","00","200","0007","0000","257","156","101","58","315","562","0","56.05","27.76"
"10","009","00","200","0007","0264","257","156","101","58","315","562","0","56.05","27.76"
"10","009","00","200","0008","0000","455","312","143","49","504","920","0","54.78","33.91"
"10","009","00","200","0008","0265","455","312","143","49","504","920","0","54.78","33.91"
"10","009","00","200","0009","0000","284","151","133","39","323","568","0","56.87","26.58"
"10","009","00","200","0009","0266","284","151","133","39","323","568","0","56.87","26.58"
"10","009","00","200","0010","0000","406","255","151","75","481","859","0","56.00","29.69"
"10","009","00","200","0010","0267","406","255","151","75","481","859","0","56.00","29.69"
"10","009","00","200","0011","0000","395","271","124","83","478","650","0","73.54","41.69"
"10","009","00","200","0011","0256","395","271","124","83","478","650","0","73.54","41.69"
"10","009","00","200","0012","0000","443","291","152","52","495","651","0","76.04","44.70"
"10","009","00","200","0012","0257","443","291","152","52","495","651","0","76.04","44.70"
"10","009","00","200","0013","0000","659","453","206","100","759","997","0","76.13","45.44"
"10","009","00","200","0013","0260","659","453","206","100","759","997","0","76.13","45.44"
"10","009","00","200","0014","0000","516","349","167","100","616","930","0","66.24","37.53"
"10","009","00","200","0014","0258","516","349","167","100","616","930","0","66.24","37.53"
"10","009","00","200","0015","0000","349","225","124","31","380","758","0","50.13","29.68"
"10","009","00","200","0015","0259","349","225","124","31","380","758","0","50.13","29.68"
"10","009","00","200","0016","0000","544","369","175","100","644","903","0","71.32","40.86"
"10","009","00","200","0016","0268","544","369","175","100","644","903","0","71.32","40.86"
"10","009","00","200","0017","0000","402","287","115","38","440","742","0","59.30","38.68"
"10","009","00","200","0017","0269","402","287","115","38","440","742","0","59.30","38.68"
"10","009","00","200","0018","0000","556","349","207","81","637","948","0","67.19","36.81"
"10","009","00","200","0018","0270","556","349","207","81","637","948","0","67.19","36.81"
"10","009","00","200","0019","0000","314","220","94","46","360","471","0","76.43","46.71"
"10","009","00","200","0019","0271","314","220","94","46","360","471","0","76.43","46.71"
"10","009","00","200","0020","0000","305","220","85","39","344","603","0","57.05","36.48"
"10","009","00","200","0020","0272","305","220","85","39","344","603","0","57.05","36.48"
"10","009","00","200","0021","0000","324","237","87","62","386","630","0","61.27","37.62"
"10","009","00","200","0021","0273","324","237","87","62","386","630","0","61.27","37.62"
"10","009","00","200","0022","0000","270","206","64","26","296","634","0","46.69","32.49"
"10","009","00","200","0022","0274","270","206","64","26","296","634","0","46.69","32.49"
"10","009","00","200","0023","0000","373","232","141","51","424","617","0","68.72","37.60"
"10","009","00","200","0023","0261","373","232","141","51","424","617","0","68.72","37.60"
"10","009","00","200","0024","0000","527","330","197","77","604","758","0","79.68","43.54"
"10","009","00","200","0024","0277","527","330","197","77","604","758","0","79.68","43.54"
"10","010","00","000","0000","0000","238554","143487","95067","25482","264036","423954","488920","62.28","33.84"
"10","010","00","010","0000","0000","18755","11279","7476","1577","20332","31709","38830","64.12","35.57"
"10","010","00","010","0001","0000","1403","806","597","160","1563","2298","0","68.02","35.07"
"10","010","00","010","0001","0001","791","440","351","70","861","1249","0","68.94","35.23"
"10","010","00","010","0001","0002","612","366","246","90","702","1049","0","66.92","34.89"
"10","010","00","010","0002","0000","230","157","73","25","255","435","0","58.62","36.09"
"10","010","00","010","0002","0003","230","157","73","25","255","435","0","58.62","36.09"
"10","010","00","010","0003","0000","797","517","280","50","847","1401","0","60.46","36.90"
"10","010","00","010","0003","0004","435","272","163","39","474","693","0","68.40","39.25"
"10","010","00","010","0003","0005","362","245","117","11","373","708","0","52.68","34.60"
"10","010","00","010","0004","0000","918","571","347","65","983","1667","0","58.97","34.25"
"10","010","00","010","0004","0006","396","252","144","16","412","730","0","56.44","34.52"
"10","010","00","010","0004","0007","522","319","203","49","571","937","0","60.94","34.04"
"10","010","00","010","0005","0000","646","419","227","64","710","1101","0","64.49","38.06"
"10","010","00","010","0005","0008","403","271","132","28","431","727","0","59.28","37.28"
"10","010","00","010","0005","0009","243","148","95","36","279","374","0","74.60","39.57"
"10","010","00","010","0006","0000","661","418","243","43","704","1140","0","61.75","36.67"
"10","010","00","010","0006","0010","661","418","243","43","704","1140","0","61.75","36.67"
"10","010","00","010","0007","0000","480","248","232","64","544","789","0","68.95","31.43"
"10","010","00","010","0007","0011","480","248","232","64","544","789","0","68.95","31.43"
"10","010","00","010","0008","0000","1042","610","432","86","1128","1820","0","61.98","33.52"
"10","010","00","010","0008","0016","566","347","219","77","643","921","0","69.82","37.68"
"10","010","00","010","0008","0017","476","263","213","9","485","899","0","53.95","29.25"
"10","010","00","010","0009","0000","745","473","272","71","816","1212","0","67.33","39.03"
"10","010","00","010","0009","0018","366","234","132","20","386","615","0","62.76","38.05"
"10","010","00","010","0009","0019","379","239","140","51","430","597","0","72.03","40.03"
"10","010","00","010","0010","0000","1450","829","621","110","1560","2514","0","62.05","32.98"
"10","010","00","010","0010","0020","471","262","209","60","531","795","0","66.79","32.96"
"10","010","00","010","0010","0021","532","304","228","28","560","933","0","60.02","32.58"
"10","010","00","010","0010","0022","447","263","184","22","469","786","0","59.67","33.46"
"10","010","00","010","0011","0000","402","236","166","53","455","689","0","66.04","34.25"
"10","010","00","010","0011","0023","271","167","104","40","311","460","0","67.61","36.30"
"10","010","00","010","0011","0024","131","69","62","13","144","229","0","62.88","30.13"
"10","010","00","010","0012","0000","383","225","158","63","446","527","0","84.63","42.69"
"10","010","00","010","0012","0025","198","120","78","37","235","284","0","82.75","42.25"
"10","010","00","010","0012","0026","185","105","80","26","211","243","0","86.83","43.21"
"10","010","00","010","0013","0000","2137","1287","850","163","2300","3451","0","66.65","37.29"
"10","010","00","010","0013","0027","682","459","223","58","740","1059","0","69.88","43.34"
"10","010","00","010","0013","0028","489","283","206","28","517","808","0","63.99","35.02"
"10","010","00","010","0013","0029","594","344","250","26","620","992","0","62.50","34.68"
"10","010","00","010","0013","0030","372","201","171","51","423","592","0","71.45","33.95"
"10","010","00","010","0014","0000","2662","1581","1081","191","2853","4554","0","62.65","34.72"
"10","010","00","010","0014","0031","499","309","190","30","529","915","0","57.81","33.77"
"10","010","00","010","0014","0032","530","333","197","54","584","875","0","66.74","38.06"
"10","010","00","010","0014","0033","500","292","208","35","535","909","0","58.86","32.12"
"10","010","00","010","0014","0034","575","330","245","24","599","979","0","61.18","33.71"
"10","010","00","010","0014","0035","558","317","241","48","606","876","0","69.18","36.19"
"10","010","00","010","0015","0000","1175","760","415","85","1260","1789","0","70.43","42.48"
"10","010","00","010","0015","0036","530","345","185","42","572","804","0","71.14","42.91"
"10","010","00","010","0015","0037","645","415","230","43","688","985","0","69.85","42.13"
"10","010","00","010","0016","0000","1788","1117","671","101","1889","3043","0","62.08","36.71"
"10","010","00","010","0016","0038","708","475","233","57","765","1150","0","66.52","41.30"
"10","010","00","010","0016","0039","602","346","256","21","623","1123","0","55.48","30.81"
"10","010","00","010","0016","0040","478","296","182","23","501","770","0","65.06","38.44"
"10","010","00","010","0017","0000","428","260","168","64","492","649","0","75.81","40.06"
"10","010","00","010","0017","0041","428","260","168","64","492","649","0","75.81","40.06"
"10","010","00","010","0018","0000","1408","765","643","119","1527","2630","0","58.06","29.09"
"10","010","00","010","0018","0012","98","66","32","19","117","188","0","62.23","35.11"
"10","010","00","010","0018","0013","365","234","131","64","429","692","0","61.99","33.82"
"10","010","00","010","0018","0014","520","249","271","16","536","931","0","57.57","26.75"
"10","010","00","010","0018","0015","425","216","209","20","445","819","0","54.33","26.37"
"10","010","00","020","0000","0000","20304","12007","8297","2111","22415","33923","40858","66.08","35.39"
"10","010","00","020","0001","0000","1087","559","528","95","1182","1853","0","63.79","30.17"
"10","010","00","020","0001","0262","674","308","366","45","719","1130","0","63.63","27.26"
"10","010","00","020","0001","0263","413","251","162","50","463","723","0","64.04","34.72"
"10","010","00","020","0002","0000","1365","718","647","72","1437","2285","0","62.89","31.42"
"10","010","00","020","0002","0264","718","362","356","45","763","1214","0","62.85","29.82"
"10","010","00","020","0002","0265","647","356","291","27","674","1071","0","62.93","33.24"
"10","010","00","020","0003","0000","643","406","237","46","689","1050","0","65.62","38.67"
"10","010","00","020","0003","0266","643","406","237","46","689","1050","0","65.62","38.67"
"10","010","00","020","0004","0000","224","140","84","25","249","348","0","71.55","40.23"
"10","010","00","020","0004","0267","224","140","84","25","249","348","0","71.55","40.23"
"10","010","00","020","0005","0000","364","210","154","40","404","604","0","66.89","34.77"
"10","010","00","020","0005","0269","364","210","154","40","404","604","0","66.89","34.77"
"10","010","00","020","0006","0000","370","193","177","27","397","574","0","69.16","33.62"
"10","010","00","020","0006","0268","370","193","177","27","397","574","0","69.16","33.62"
"10","010","00","020","0007","0000","541","340","201","48","589","823","0","71.57","41.31"
"10","010","00","020","0007","0270","541","340","201","48","589","823","0","71.57","41.31"
"10","010","00","020","0008","0000","954","502","452","74","1028","1608","0","63.93","31.22"
"10","010","00","020","0008","0271","416","227","189","28","444","713","0","62.27","31.84"
"10","010","00","020","0008","0272","538","275","263","46","584","895","0","65.25","30.73"
"10","010","00","020","0009","0000","1437","876","561","157","1594","2424","0","65.76","36.14"
"10","010","00","020","0009","0273","736","428","308","86","822","1271","0","64.67","33.67"
"10","010","00","020","0009","0274","701","448","253","71","772","1153","0","66.96","38.86"
"10","010","00","020","0010","0000","2543","1387","1156","179","2722","4133","0","65.86","33.56"
"10","010","00","020","0010","0275","878","423","455","53","931","1490","0","62.48","28.39"
"10","010","00","020","0010","0276","732","435","297","71","803","1199","0","66.97","36.28"
"10","010","00","020","0010","0277","933","529","404","55","988","1444","0","68.42","36.63"
"10","010","00","020","0011","0000","469","290","179","66","535","649","0","82.43","44.68"
"10","010","00","020","0011","0278","469","290","179","66","535","649","0","82.43","44.68"
"10","010","00","020","0012","0000","399","250","149","55","454","588","0","77.21","42.52"
"10","010","00","020","0012","0279","399","250","149","55","454","588","0","77.21","42.52"
"10","010","00","020","0013","0000","500","295","205","96","596","753","0","79.15","39.18"
"10","010","00","020","0013","0280","500","295","205","96","596","753","0","79.15","39.18"
"10","010","00","020","0014","0000","619","383","236","87","706","987","0","71.53","38.80"
"10","010","00","020","0014","0281","619","383","236","87","706","987","0","71.53","38.80"
"10","010","00","020","0015","0000","841","482","359","29","870","1821","0","47.78","26.47"
"10","010","00","020","0015","0282","841","482","359","29","870","1821","0","47.78","26.47"
"10","010","00","020","0016","0000","1778","1019","759","218","1996","3106","0","64.26","32.81"
"10","010","00","020","0016","0283","766","427","339","96","862","1337","0","64.47","31.94"
"10","010","00","020","0016","0284","491","283","208","45","536","870","0","61.61","32.53"
"10","010","00","020","0016","0285","521","309","212","77","598","899","0","66.52","34.37"
"10","010","00","020","0017","0000","1713","983","730","175","1888","2885","0","65.44","34.07"
"10","010","00","020","0017","0286","905","554","351","138","1043","1532","0","68.08","36.16"
"10","010","00","020","0017","0287","808","429","379","37","845","1353","0","62.45","31.71"
"10","010","00","020","0018","0000","415","240","175","65","480","704","0","68.18","34.09"
"10","010","00","020","0018","0288","415","240","175","65","480","704","0","68.18","34.09"
"10","010","00","020","0019","0000","652","397","255","75","727","1022","0","71.14","38.85"
"10","010","00","020","0019","0289","652","397","255","75","727","1022","0","71.14","38.85"
"10","010","00","020","0020","0000","522","356","166","76","598","834","0","71.70","42.69"
"10","010","00","020","0020","0290","522","356","166","76","598","834","0","71.70","42.69"
"10","010","00","020","0021","0000","141","98","43","28","169","226","0","74.78","43.36"
"10","010","00","020","0021","0292","141","98","43","28","169","226","0","74.78","43.36"
"10","010","00","020","0022","0000","420","290","130","84","504","682","0","73.90","42.52"
"10","010","00","020","0022","0291","420","290","130","84","504","682","0","73.90","42.52"
"10","010","00","020","0023","0000","438","290","148","82","520","727","0","71.53","39.89"
"10","010","00","020","0023","0293","438","290","148","82","520","727","0","71.53","39.89"
"10","010","00","020","0024","0000","410","232","178","71","481","646","0","74.46","35.91"
"10","010","00","020","0024","0294","410","232","178","71","481","646","0","74.46","35.91"
"10","010","00","020","0025","0000","431","311","120","29","460","965","0","47.67","32.23"
"10","010","00","020","0025","0295","431","311","120","29","460","965","0","47.67","32.23"
"10","010","00","020","0026","0000","710","520","190","89","799","1164","0","68.64","44.67"
"10","010","00","020","0026","0296","710","520","190","89","799","1164","0","68.64","44.67"
"10","010","00","020","0027","0000","318","240","78","23","341","462","0","73.81","51.95"
"10","010","00","020","0027","0297","318","240","78","23","341","462","0","73.81","51.95"
"10","010","00","030","0000","0000","12609","7595","5014","2127","14736","22375","25130","65.86","33.94"
"10","010","00","030","0001","0000","326","167","159","75","401","572","0","70.10","29.20"
"10","010","00","030","0001","0355","326","167","159","75","401","572","0","70.10","29.20"
"10","010","00","030","0002","0000","200","123","77","32","232","346","0","67.05","35.55"
"10","010","00","030","0002","0356","200","123","77","32","232","346","0","67.05","35.55"
"10","010","00","030","0003","0000","1183","721","462","184","1367","2053","0","66.59","35.12"
"10","010","00","030","0003","0357","484","279","205","108","592","892","0","66.37","31.28"
"10","010","00","030","0003","0358","699","442","257","76","775","1161","0","66.75","38.07"
"10","010","00","030","0004","0000","531","288","243","89","620","1022","0","60.67","28.18"
"10","010","00","030","0004","0359","531","288","243","89","620","1022","0","60.67","28.18"
"10","010","00","030","0005","0000","884","512","372","121","1005","1542","0","65.18","33.20"
"10","010","00","030","0005","0360","521","306","215","75","596","911","0","65.42","33.59"
"10","010","00","030","0005","0361","363","206","157","46","409","631","0","64.82","32.65"
"10","010","00","030","0006","0000","444","304","140","105","549","821","0","66.87","37.03"
"10","010","00","030","0006","0362","444","304","140","105","549","821","0","66.87","37.03"
"10","010","00","030","0007","0000","377","210","167","42","419","660","0","63.48","31.82"
"10","010","00","030","0007","0363","377","210","167","42","419","660","0","63.48","31.82"
"10","010","00","030","0008","0000","400","218","182","80","480","708","0","67.80","30.79"
"10","010","00","030","0008","0364","400","218","182","80","480","708","0","67.80","30.79"
"10","010","00","030","0009","0000","506","311","195","81","587","876","0","67.01","35.50"
"10","010","00","030","0009","0379","506","311","195","81","587","876","0","67.01","35.50"
"10","010","00","030","0010","0000","764","446","318","104","868","1276","0","68.03","34.95"
"10","010","00","030","0010","0380","764","446","318","104","868","1276","0","68.03","34.95"
"10","010","00","030","0011","0000","1187","743","444","152","1339","2222","0","60.26","33.44"
"10","010","00","030","0011","0381","560","360","200","63","623","1037","0","60.08","34.72"
"10","010","00","030","0011","0382","627","383","244","89","716","1185","0","60.42","32.32"
"10","010","00","030","0012","0000","697","417","280","113","810","1077","0","75.21","38.72"
"10","010","00","030","0012","0383","697","417","280","113","810","1077","0","75.21","38.72"
"10","010","00","030","0013","0000","598","336","262","103","701","1056","0","66.38","31.82"
"10","010","00","030","0013","0372","598","336","262","103","701","1056","0","66.38","31.82"
"10","010","00","030","0014","0000","933","561","372","156","1089","1809","0","60.20","31.01"
"10","010","00","030","0014","0373","487","288","199","57","544","906","0","60.04","31.79"
"10","010","00","030","0014","0374","446","273","173","99","545","903","0","60.35","30.23"
"10","010","00","030","0015","0000","158","91","67","21","179","264","0","67.80","34.47"
"10","010","00","030","0015","0375","158","91","67","21","179","264","0","67.80","34.47"
"10","010","00","030","0016","0000","178","101","77","47","225","368","0","61.14","27.45"
"10","010","00","030","0016","0376","178","101","77","47","225","368","0","61.14","27.45"
"10","010","00","030","0017","0000","126","83","43","22","148","263","0","56.27","31.56"
"10","010","00","030","0017","0377","49","28","21","11","60","110","0","54.55","25.45"
"10","010","00","030","0017","0378","77","55","22","11","88","153","0","57.52","35.95"
"10","010","00","030","0018","0000","318","177","141","50","368","677","0","54.36","26.14"
"10","010","00","030","0018","0365","318","177","141","50","368","677","0","54.36","26.14"
"10","010","00","030","0019","0000","595","356","239","120","715","1072","0","66.70","33.21"
"10","010","00","030","0019","0366","595","356","239","120","715","1072","0","66.70","33.21"
"10","010","00","030","0020","0000","716","457","259","111","827","1245","0","66.43","36.71"
"10","010","00","030","0020","0368","716","457","259","111","827","1245","0","66.43","36.71"
"10","010","00","030","0021","0000","736","486","250","141","877","1309","0","67.00","37.13"
"10","010","00","030","0021","0367","736","486","250","141","877","1309","0","67.00","37.13"
"10","010","00","030","0022","0000","360","240","120","86","446","529","0","84.31","45.37"
"10","010","00","030","0022","0369","213","142","71","36","249","296","0","84.12","47.97"
"10","010","00","030","0022","0370","147","98","49","50","197","233","0","84.55","42.06"
"10","010","00","030","0023","0000","392","247","145","92","484","608","0","79.61","40.63"
"10","010","00","030","0023","0371","392","247","145","92","484","608","0","79.61","40.63"
"10","010","00","040","0000","0000","14641","8431","6210","1195","15836","25742","29769","61.52","32.75"
"10","010","00","040","0001","0000","271","151","120","14","285","462","0","61.69","32.68"
"10","010","00","040","0001","0194","271","151","120","14","285","462","0","61.69","32.68"
"10","010","00","040","0002","0000","1112","590","522","73","1185","1762","0","67.25","33.48"
"10","010","00","040","0002","0195","510","274","236","40","550","852","0","64.55","32.16"
"10","010","00","040","0002","0196","602","316","286","33","635","910","0","69.78","34.73"
"10","010","00","040","0003","0000","514","293","221","23","537","862","0","62.30","33.99"
"10","010","00","040","0003","0197","514","293","221","23","537","862","0","62.30","33.99"
"10","010","00","040","0004","0000","3256","1769","1487","186","3442","5788","0","59.47","30.56"
"10","010","00","040","0004","0198","803","439","364","38","841","1366","0","61.57","32.14"
"10","010","00","040","0004","0199","732","397","335","62","794","1339","0","59.30","29.65"
"10","010","00","040","0004","0200","820","473","347","58","878","1494","0","58.77","31.66"
"10","010","00","040","0004","0201","901","460","441","28","929","1589","0","58.46","28.95"
"10","010","00","040","0005","0000","670","433","237","67","737","1088","0","67.74","39.80"
"10","010","00","040","0005","0202","670","433","237","67","737","1088","0","67.74","39.80"
"10","010","00","040","0006","0000","851","459","392","24","875","1816","0","48.18","25.28"
"10","010","00","040","0006","0203","851","459","392","24","875","1816","0","48.18","25.28"
"10","010","00","040","0007","0000","309","203","106","36","345","551","0","62.61","36.84"
"10","010","00","040","0007","0204","309","203","106","36","345","551","0","62.61","36.84"
"10","010","00","040","0008","0000","437","286","151","50","487","675","0","72.15","42.37"
"10","010","00","040","0008","0205","437","286","151","50","487","675","0","72.15","42.37"
"10","010","00","040","0009","0000","354","228","126","51","405","595","0","68.07","38.32"
"10","010","00","040","0009","0206","354","228","126","51","405","595","0","68.07","38.32"
"10","010","00","040","0010","0000","87","45","42","8","95","171","0","55.56","26.32"
"10","010","00","040","0010","0207","87","45","42","8","95","171","0","55.56","26.32"
"10","010","00","040","0011","0000","766","436","330","86","852","1474","0","57.80","29.58"
"10","010","00","040","0011","0208","766","436","330","86","852","1474","0","57.80","29.58"
"10","010","00","040","0012","0000","868","517","351","88","956","1373","0","69.63","37.65"
"10","010","00","040","0012","0209","868","517","351","88","956","1373","0","69.63","37.65"
"10","010","00","040","0013","0000","740","421","319","90","830","1280","0","64.84","32.89"
"10","010","00","040","0013","0210","547","311","236","60","607","950","0","63.89","32.74"
"10","010","00","040","0013","0211","193","110","83","30","223","330","0","67.58","33.33"
"10","010","00","040","0014","0000","388","233","155","49","437","757","0","57.73","30.78"
"10","010","00","040","0014","0212","388","233","155","49","437","757","0","57.73","30.78"
"10","010","00","040","0015","0000","828","543","285","49","877","1475","0","59.46","36.81"
"10","010","00","040","0015","0213","828","543","285","49","877","1475","0","59.46","36.81"
"10","010","00","040","0016","0000","1140","630","510","79","1219","1979","0","61.60","31.83"
"10","010","00","040","0016","0214","533","294","239","27","560","979","0","57.20","30.03"
"10","010","00","040","0016","0215","607","336","271","52","659","1000","0","65.90","33.60"
"10","010","00","040","0017","0000","469","310","159","56","525","857","0","61.26","36.17"
"10","010","00","040","0017","0216","469","310","159","56","525","857","0","61.26","36.17"
"10","010","00","040","0018","0000","381","199","182","45","426","621","0","68.60","32.05"
"10","010","00","040","0018","0217","381","199","182","45","426","621","0","68.60","32.05"
"10","010","00","040","0019","0000","318","182","136","18","336","615","0","54.63","29.59"
"10","010","00","040","0019","0218","318","182","136","18","336","615","0","54.63","29.59"
"10","010","00","040","0020","0000","444","248","196","66","510","772","0","66.06","32.12"
"10","010","00","040","0020","0219","444","248","196","66","510","772","0","66.06","32.12"
"10","010","00","040","0021","0000","438","255","183","37","475","769","0","61.77","33.16"
"10","010","00","040","0021","0220","438","255","183","37","475","769","0","61.77","33.16"
"10","010","00","050","0000","0000","34593","20454","14139","2424","37017","59845","70318","61.85","34.18"
"10","010","00","050","0001","0000","1208","649","559","86","1294","2204","0","58.71","29.45"
"10","010","00","050","0001","0108","699","368","331","55","754","1218","0","61.90","30.21"
"10","010","00","050","0001","0109","509","281","228","31","540","986","0","54.77","28.50"
"10","010","00","050","0002","0000","914","470","444","61","975","1469","0","66.37","31.99"
"10","010","00","050","0002","0110","914","470","444","61","975","1469","0","66.37","31.99"
"10","010","00","050","0003","0000","1808","1045","763","112","1920","3266","0","58.79","32.00"
"10","010","00","050","0003","0111","880","498","382","46","926","1651","0","56.09","30.16"
"10","010","00","050","0003","0112","928","547","381","66","994","1615","0","61.55","33.87"
"10","010","00","050","0004","0000","1241","716","525","91","1332","2091","0","63.70","34.24"
"10","010","00","050","0004","0113","663","396","267","59","722","1053","0","68.57","37.61"
"10","010","00","050","0004","0114","578","320","258","32","610","1038","0","58.77","30.83"
"10","010","00","050","0005","0000","1005","614","391","61","1066","1513","0","70.46","40.58"
"10","010","00","050","0005","0115","1005","614","391","61","1066","1513","0","70.46","40.58"
"10","010","00","050","0006","0000","1034","550","484","101","1135","1763","0","64.38","31.20"
"10","010","00","050","0006","0116","399","207","192","28","427","679","0","62.89","30.49"
"10","010","00","050","0006","0117","635","343","292","73","708","1084","0","65.31","31.64"
"10","010","00","050","0007","0000","861","489","372","68","929","1430","0","64.97","34.20"
"10","010","00","050","0007","0118","861","489","372","68","929","1430","0","64.97","34.20"
"10","010","00","050","0008","0000","958","665","293","68","1026","1635","0","62.75","40.67"
"10","010","00","050","0008","0119","562","382","180","39","601","916","0","65.61","41.70"
"10","010","00","050","0008","0120","396","283","113","29","425","719","0","59.11","39.36"
"10","010","00","050","0009","0000","558","341","217","28","586","965","0","60.73","35.34"
"10","010","00","050","0009","0121","558","341","217","28","586","965","0","60.73","35.34"
"10","010","00","050","0010","0000","520","310","210","51","571","798","0","71.55","38.85"
"10","010","00","050","0010","0122","520","310","210","51","571","798","0","71.55","38.85"
"10","010","00","050","0011","0000","484","316","168","28","512","817","0","62.67","38.68"
"10","010","00","050","0011","0123","484","316","168","28","512","817","0","62.67","38.68"
"10","010","00","050","0012","0000","1229","715","514","110","1339","2117","0","63.25","33.77"
"10","010","00","050","0012","0124","1014","599","415","93","1107","1717","0","64.47","34.89"
"10","010","00","050","0012","0125","215","116","99","17","232","400","0","58.00","29.00"
"10","010","00","050","0013","0000","843","518","325","39","882","1296","0","68.06","39.97"
"10","010","00","050","0013","0126","843","518","325","39","882","1296","0","68.06","39.97"
"10","010","00","050","0014","0000","337","157","180","33","370","493","0","75.05","31.85"
"10","010","00","050","0014","0127","337","157","180","33","370","493","0","75.05","31.85"
"10","010","00","050","0015","0000","722","431","291","45","767","1247","0","61.51","34.56"
"10","010","00","050","0015","0128","722","431","291","45","767","1247","0","61.51","34.56"
"10","010","00","050","0016","0000","976","606","370","78","1054","1744","0","60.44","34.75"
"10","010","00","050","0016","0146","507","333","174","32","539","905","0","59.56","36.80"
"10","010","00","050","0016","0147","469","273","196","46","515","839","0","61.38","32.54"
"10","010","00","050","0017","0000","1426","971","455","88","1514","2662","0","56.87","36.48"
"10","010","00","050","0017","0148","716","552","164","51","767","1266","0","60.58","43.60"
"10","010","00","050","0017","0149","710","419","291","37","747","1396","0","53.51","30.01"
"10","010","00","050","0018","0000","1180","727","453","89","1269","1960","0","64.74","37.09"
"10","010","00","050","0018","0152","610","361","249","60","670","906","0","73.95","39.85"
"10","010","00","050","0018","0153","570","366","204","29","599","1054","0","56.83","34.72"
"10","010","00","050","0019","0000","1423","764","659","87","1510","2415","0","62.53","31.64"
"10","010","00","050","0019","0154","798","454","344","51","849","1355","0","62.66","33.51"
"10","010","00","050","0019","0155","625","310","315","36","661","1060","0","62.36","29.25"
"10","010","00","050","0020","0000","1922","1203","719","180","2102","3384","0","62.12","35.55"
"10","010","00","050","0020","0156","713","465","248","94","807","1189","0","67.87","39.11"
"10","010","00","050","0020","0157","611","399","212","45","656","1094","0","59.96","36.47"
"10","010","00","050","0020","0158","598","339","259","41","639","1101","0","58.04","30.79"
"10","010","00","050","0021","0000","735","472","263","77","812","1232","0","65.91","38.31"
"10","010","00","050","0021","0159","735","472","263","77","812","1232","0","65.91","38.31"
"10","010","00","050","0022","0000","2921","1726","1195","197","3118","5113","0","60.98","33.76"
"10","010","00","050","0022","0129","882","514","368","71","953","1441","0","66.13","35.67"
"10","010","00","050","0022","0130","879","502","377","37","916","1590","0","57.61","31.57"
"10","010","00","050","0022","0131","431","279","152","33","464","717","0","64.71","38.91"
"10","010","00","050","0022","0132","729","431","298","56","785","1365","0","57.51","31.58"
"10","010","00","050","0023","0000","1459","847","612","81","1540","2388","0","64.49","35.47"
"10","010","00","050","0023","0133","730","419","311","53","783","1186","0","66.02","35.33"
"10","010","00","050","0023","0134","729","428","301","28","757","1202","0","62.98","35.61"
"10","010","00","050","0024","0000","1145","626","519","78","1223","2284","0","53.55","27.41"
"10","010","00","050","0024","0140","533","303","230","54","587","981","0","59.84","30.89"
"10","010","00","050","0024","0141","612","323","289","24","636","1303","0","48.81","24.79"
"10","010","00","050","0025","0000","1572","979","593","108","1680","2569","0","65.40","38.11"
"10","010","00","050","0025","0142","993","619","374","76","1069","1611","0","66.36","38.42"
"10","010","00","050","0025","0143","579","360","219","32","611","958","0","63.78","37.58"
"10","010","00","050","0026","0000","880","546","334","82","962","1650","0","58.30","33.09"
"10","010","00","050","0026","0144","586","386","200","63","649","1023","0","63.44","37.73"
"10","010","00","050","0026","0145","294","160","134","19","313","627","0","49.92","25.52"
"10","010","00","050","0027","0000","1672","999","673","117","1789","2875","0","62.23","34.75"
"10","010","00","050","0027","0150","805","475","330","49","854","1332","0","64.11","35.66"
"10","010","00","050","0027","0151","867","524","343","68","935","1543","0","60.60","33.96"
"10","010","00","050","0028","0000","3560","2002","1558","180","3740","6465","0","57.85","30.97"
"10","010","00","050","0028","0135","675","356","319","31","706","1263","0","55.90","28.19"
"10","010","00","050","0028","0136","666","364","302","26","692","1331","0","51.99","27.35"
"10","010","00","050","0028","0137","736","405","331","36","772","1338","0","57.70","30.27"
"10","010","00","050","0028","0138","723","403","320","32","755","1241","0","60.84","32.47"
"10","010","00","050","0028","0139","760","474","286","55","815","1292","0","63.08","36.69"
"10","010","00","060","0000","0000","6371","4141","2230","764","7135","12069","13526","59.12","34.31"
"10","010","00","060","0001","0000","666","416","250","67","733","1222","0","59.98","34.04"
"10","010","00","060","0001","0221","666","416","250","67","733","1222","0","59.98","34.04"
"10","010","00","060","0002","0000","349","219","130","30","379","632","0","59.97","34.65"
"10","010","00","060","0002","0222","349","219","130","30","379","632","0","59.97","34.65"
"10","010","00","060","0003","0000","349","230","119","40","389","606","0","64.19","37.95"
"10","010","00","060","0003","0223","216","149","67","13","229","371","0","61.73","40.16"
"10","010","00","060","0003","0224","133","81","52","27","160","235","0","68.09","34.47"
"10","010","00","060","0004","0000","502","335","167","52","554","915","0","60.55","36.61"
"10","010","00","060","0004","0237","502","335","167","52","554","915","0","60.55","36.61"
"10","010","00","060","0005","0000","357","258","99","46","403","629","0","64.07","41.02"
"10","010","00","060","0005","0236","357","258","99","46","403","629","0","64.07","41.02"
"10","010","00","060","0006","0000","374","255","119","27","401","727","0","55.16","35.08"
"10","010","00","060","0006","0230","374","255","119","27","401","727","0","55.16","35.08"
"10","010","00","060","0007","0000","346","235","111","73","419","756","0","55.42","31.08"
"10","010","00","060","0007","0231","346","235","111","73","419","756","0","55.42","31.08"
"10","010","00","060","0008","0000","566","374","192","85","651","1083","0","60.11","34.53"
"10","010","00","060","0008","0232","566","374","192","85","651","1083","0","60.11","34.53"
"10","010","00","060","0009","0000","513","329","184","106","619","935","0","66.20","35.19"
"10","010","00","060","0009","0233","513","329","184","106","619","935","0","66.20","35.19"
"10","010","00","060","0010","0000","332","208","124","21","353","863","0","40.90","24.10"
"10","010","00","060","0010","0234","225","155","70","15","240","514","0","46.69","30.16"
"10","010","00","060","0010","0235","107","53","54","6","113","349","0","32.38","15.19"
"10","010","00","060","0011","0000","625","379","246","69","694","1226","0","56.61","30.91"
"10","010","00","060","0011","0225","413","236","177","25","438","856","0","51.17","27.57"
"10","010","00","060","0011","0226","212","143","69","44","256","370","0","69.19","38.65"
"10","010","00","060","0012","0000","548","343","205","51","599","975","0","61.44","35.18"
"10","010","00","060","0012","0227","548","343","205","51","599","975","0","61.44","35.18"
"10","010","00","060","0013","0000","390","255","135","70","460","648","0","70.99","39.35"
"10","010","00","060","0013","0228","390","255","135","70","460","648","0","70.99","39.35"
"10","010","00","060","0014","0000","454","305","149","27","481","852","0","56.46","35.80"
"10","010","00","060","0014","0229","454","305","149","27","481","852","0","56.46","35.80"
"10","010","00","070","0000","0000","16495","10627","5868","1795","18290","26173","30345","69.88","40.60"
"10","010","00","070","0001","0000","1436","820","616","66","1502","2164","0","69.41","37.89"
"10","010","00","070","0001","0160","686","405","281","35","721","1026","0","70.27","39.47"
"10","010","00","070","0001","0161","750","415","335","31","781","1138","0","68.63","36.47"
"10","010","00","070","0002","0000","939","622","317","98","1037","1497","0","69.27","41.55"
"10","010","00","070","0002","0162","440","298","142","44","484","684","0","70.76","43.57"
"10","010","00","070","0002","0163","499","324","175","54","553","813","0","68.02","39.85"
"10","010","00","070","0003","0000","843","505","338","69","912","1356","0","67.26","37.24"
"10","010","00","070","0003","0164","361","200","161","19","380","621","0","61.19","32.21"
"10","010","00","070","0003","0165","482","305","177","50","532","735","0","72.38","41.50"
"10","010","00","070","0004","0000","1004","602","402","93","1097","1588","0","69.08","37.91"
"10","010","00","070","0004","0166","497","293","204","45","542","774","0","70.03","37.86"
"10","010","00","070","0004","0167","507","309","198","48","555","814","0","68.18","37.96"
"10","010","00","070","0005","0000","901","604","297","83","984","1303","0","75.52","46.35"
"10","010","00","070","0005","0168","437","291","146","41","478","640","0","74.69","45.47"
"10","010","00","070","0005","0169","464","313","151","42","506","663","0","76.32","47.21"
"10","010","00","070","0006","0000","946","650","296","101","1047","1534","0","68.25","42.37"
"10","010","00","070","0006","0170","457","317","140","35","492","708","0","69.49","44.77"
"10","010","00","070","0006","0171","489","333","156","66","555","826","0","67.19","40.31"
"10","010","00","070","0007","0000","947","632","315","86","1033","1597","0","64.68","39.57"
"10","010","00","070","0007","0172","440","299","141","40","480","776","0","61.86","38.53"
"10","010","00","070","0007","0173","507","333","174","46","553","821","0","67.36","40.56"
"10","010","00","070","0008","0000","475","302","173","40","515","881","0","58.46","34.28"
"10","010","00","070","0008","0174","475","302","173","40","515","881","0","58.46","34.28"
"10","010","00","070","0009","0000","234","164","70","11","245","510","0","48.04","32.16"
"10","010","00","070","0009","0175","234","164","70","11","245","510","0","48.04","32.16"
"10","010","00","070","0010","0000","526","377","149","92","618","841","0","73.48","44.83"
"10","010","00","070","0010","0176","526","377","149","92","618","841","0","73.48","44.83"
"10","010","00","070","0011","0000","324","204","120","59","383","458","0","83.62","44.54"
"10","010","00","070","0011","0177","324","204","120","59","383","458","0","83.62","44.54"
"10","010","00","070","0012","0000","329","212","117","58","387","471","0","82.17","45.01"
"10","010","00","070","0012","0178","329","212","117","58","387","471","0","82.17","45.01"
"10","010","00","070","0013","0000","979","688","291","85","1064","1578","0","67.43","43.60"
"10","010","00","070","0013","0179","413","298","115","27","440","750","0","58.67","39.73"
"10","010","00","070","0013","0180","566","390","176","58","624","828","0","75.36","47.10"
"10","010","00","070","0014","0000","896","622","274","67","963","1465","0","65.73","42.46"
"10","010","00","070","0014","0181","433","310","123","24","457","752","0","60.77","41.22"
"10","010","00","070","0014","0182","463","312","151","43","506","713","0","70.97","43.76"
"10","010","00","070","0015","0000","756","499","257","152","908","1245","0","72.93","40.08"
"10","010","00","070","0015","0183","369","251","118","71","440","595","0","73.95","42.18"
"10","010","00","070","0015","0184","387","248","139","81","468","650","0","72.00","38.15"
"10","010","00","070","0016","0000","1017","614","403","95","1112","1440","0","77.22","42.64"
"10","010","00","070","0016","0187","374","230","144","53","427","578","0","73.88","39.79"
"10","010","00","070","0016","0188","643","384","259","42","685","862","0","79.47","44.55"
"10","010","00","070","0017","0000","614","372","242","97","711","977","0","72.77","38.08"
"10","010","00","070","0017","0186","614","372","242","97","711","977","0","72.77","38.08"
"10","010","00","070","0018","0000","513","317","196","18","531","908","0","58.48","34.91"
"10","010","00","070","0018","0185","513","317","196","18","531","908","0","58.48","34.91"
"10","010","00","070","0019","0000","576","386","190","136","712","940","0","75.74","41.06"
"10","010","00","070","0019","0189","576","386","190","136","712","940","0","75.74","41.06"
"10","010","00","070","0020","0000","672","440","232","104","776","1074","0","72.25","40.97"
"10","010","00","070","0020","0190","672","440","232","104","776","1074","0","72.25","40.97"
"10","010","00","070","0021","0000","648","423","225","98","746","989","0","75.43","42.77"
"10","010","00","070","0021","0191","648","423","225","98","746","989","0","75.43","42.77"
"10","010","00","070","0022","0000","309","181","128","47","356","520","0","68.46","34.81"
"10","010","00","070","0022","0192","309","181","128","47","356","520","0","68.46","34.81"
"10","010","00","070","0023","0000","611","391","220","40","651","837","0","77.78","46.71"
"10","010","00","070","0023","0193","611","391","220","40","651","837","0","77.78","46.71"
"10","010","00","080","0000","0000","10692","6972","3720","1376","12068","19284","21419","62.58","36.15"
"10","010","00","080","0001","0000","640","382","258","81","721","1092","0","66.03","34.98"
"10","010","00","080","0001","0298","640","382","258","81","721","1092","0","66.03","34.98"
"10","010","00","080","0002","0000","501","299","202","72","573","771","0","74.32","38.78"
"10","010","00","080","0002","0299","501","299","202","72","573","771","0","74.32","38.78"
"10","010","00","080","0003","0000","529","331","198","56","585","833","0","70.23","39.74"
"10","010","00","080","0003","0300","529","331","198","56","585","833","0","70.23","39.74"
"10","010","00","080","0004","0000","139","63","76","11","150","194","0","77.32","32.47"
"10","010","00","080","0004","0301","139","63","76","11","150","194","0","77.32","32.47"
"10","010","00","080","0005","0000","700","441","259","94","794","1104","0","71.92","39.95"
"10","010","00","080","0005","0302","700","441","259","94","794","1104","0","71.92","39.95"
"10","010","00","080","0006","0000","445","291","154","15","460","1108","0","41.52","26.26"
"10","010","00","080","0006","0303","445","291","154","15","460","1108","0","41.52","26.26"
"10","010","00","080","0007","0000","462","275","187","116","578","826","0","69.98","33.29"
"10","010","00","080","0007","0304","462","275","187","116","578","826","0","69.98","33.29"
"10","010","00","080","0008","0000","346","249","97","54","400","597","0","67.00","41.71"
"10","010","00","080","0008","0305","346","249","97","54","400","597","0","67.00","41.71"
"10","010","00","080","0009","0000","350","273","77","44","394","677","0","58.20","40.32"
"10","010","00","080","0009","0306","261","202","59","33","294","524","0","56.11","38.55"
"10","010","00","080","0009","0307","89","71","18","11","100","153","0","65.36","46.41"
"10","010","00","080","0010","0000","301","225","76","23","324","658","0","49.24","34.19"
"10","010","00","080","0010","0313","301","225","76","23","324","658","0","49.24","34.19"
"10","010","00","080","0011","0000","580","411","169","63","643","943","0","68.19","43.58"
"10","010","00","080","0011","0314","580","411","169","63","643","943","0","68.19","43.58"
"10","010","00","080","0012","0000","476","302","174","50","526","849","0","61.96","35.57"
"10","010","00","080","0012","0315","476","302","174","50","526","849","0","61.96","35.57"
"10","010","00","080","0013","0000","567","375","192","75","642","987","0","65.05","37.99"
"10","010","00","080","0013","0316","567","375","192","75","642","987","0","65.05","37.99"
"10","010","00","080","0014","0000","676","420","256","64","740","1388","0","53.31","30.26"
"10","010","00","080","0014","0317","676","420","256","64","740","1388","0","53.31","30.26"
"10","010","00","080","0015","0000","285","207","78","22","307","568","0","54.05","36.44"
"10","010","00","080","0015","0318","285","207","78","22","307","568","0","54.05","36.44"
"10","010","00","080","0016","0000","165","114","51","12","177","444","0","39.86","25.68"
"10","010","00","080","0016","0319","165","114","51","12","177","444","0","39.86","25.68"
"10","010","00","080","0017","0000","344","214","130","53","397","581","0","68.33","36.83"
"10","010","00","080","0017","0320","344","214","130","53","397","581","0","68.33","36.83"
"10","010","00","080","0018","0000","466","308","158","78","544","816","0","66.67","37.75"
"10","010","00","080","0018","0321","466","308","158","78","544","816","0","66.67","37.75"
"10","010","00","080","0019","0000","708","502","206","78","786","1321","0","59.50","38.00"
"10","010","00","080","0019","0308","121","91","30","11","132","200","0","66.00","45.50"
"10","010","00","080","0019","0309","113","80","33","17","130","223","0","58.30","35.87"
"10","010","00","080","0019","0310","200","144","56","26","226","339","0","66.67","42.48"
"10","010","00","080","0019","0311","274","187","87","24","298","559","0","53.31","33.45"
"10","010","00","080","0020","0000","336","220","116","40","376","553","0","67.99","39.78"
"10","010","00","080","0020","0312","336","220","116","40","376","553","0","67.99","39.78"
"10","010","00","080","0021","0000","367","215","152","89","456","707","0","64.50","30.41"
"10","010","00","080","0021","0322","367","215","152","89","456","707","0","64.50","30.41"
"10","010","00","080","0022","0000","223","147","76","12","235","503","0","46.72","29.22"
"10","010","00","080","0022","0323","223","147","76","12","235","503","0","46.72","29.22"
"10","010","00","080","0023","0000","380","239","141","74","454","591","0","76.82","40.44"
"10","010","00","080","0023","0324","380","239","141","74","454","591","0","76.82","40.44"
"10","010","00","080","0024","0000","400","265","135","53","453","630","0","71.90","42.06"
"10","010","00","080","0024","0325","400","265","135","53","453","630","0","71.90","42.06"
"10","010","00","080","0025","0000","306","204","102","47","353","543","0","65.01","37.57"
"10","010","00","080","0025","0326","246","163","83","34","280","425","0","65.88","38.35"
"10","010","00","080","0025","0327","60","41","19","13","73","118","0","61.86","34.75"
"10","010","00","090","0000","0000","10905","6985","3920","2362","13267","20696","23254","64.10","33.75"
"10","010","00","090","0001","0000","1109","718","391","216","1325","1866","0","71.01","38.48"
"10","010","00","090","0001","0328","1109","718","391","216","1325","1866","0","71.01","38.48"
"10","010","00","090","0002","0000","478","326","152","100","578","890","0","64.94","36.63"
"10","010","00","090","0002","0329","478","326","152","100","578","890","0","64.94","36.63"
"10","010","00","090","0003","0000","400","272","128","10","410","1290","0","31.78","21.09"
"10","010","00","090","0003","0330","400","272","128","10","410","1290","0","31.78","21.09"
"10","010","00","090","0004","0000","865","540","325","228","1093","1571","0","69.57","34.37"
"10","010","00","090","0004","0331","865","540","325","228","1093","1571","0","69.57","34.37"
"10","010","00","090","0005","0000","578","368","210","156","734","1095","0","67.03","33.61"
"10","010","00","090","0005","0332","578","368","210","156","734","1095","0","67.03","33.61"
"10","010","00","090","0006","0000","445","278","167","58","503","695","0","72.37","40.00"
"10","010","00","090","0006","0333","445","278","167","58","503","695","0","72.37","40.00"
"10","010","00","090","0007","0000","175","92","83","47","222","370","0","60.00","24.86"
"10","010","00","090","0007","0334","175","92","83","47","222","370","0","60.00","24.86"
"10","010","00","090","0008","0000","227","148","79","12","239","826","0","28.93","17.92"
"10","010","00","090","0008","0335","227","148","79","12","239","826","0","28.93","17.92"
"10","010","00","090","0009","0000","339","234","105","26","365","851","0","42.89","27.50"
"10","010","00","090","0009","0336","339","234","105","26","365","851","0","42.89","27.50"
"10","010","00","090","0010","0000","365","254","111","98","463","683","0","67.79","37.19"
"10","010","00","090","0010","0337","365","254","111","98","463","683","0","67.79","37.19"
"10","010","00","090","0011","0000","273","169","104","34","307","382","0","80.37","44.24"
"10","010","00","090","0011","0338","98","57","41","4","102","156","0","65.38","36.54"
"10","010","00","090","0011","0339","175","112","63","30","205","226","0","90.71","49.56"
"10","010","00","090","0012","0000","484","305","179","160","644","944","0","68.22","32.31"
"10","010","00","090","0012","0340","484","305","179","160","644","944","0","68.22","32.31"
"10","010","00","090","0013","0000","690","422","268","161","851","1137","0","74.85","37.12"
"10","010","00","090","0013","0344","690","422","268","161","851","1137","0","74.85","37.12"
"10","010","00","090","0014","0000","501","294","207","102","603","800","0","75.38","36.75"
"10","010","00","090","0014","0345","501","294","207","102","603","800","0","75.38","36.75"
"10","010","00","090","0015","0000","334","224","110","97","431","606","0","71.12","36.96"
"10","010","00","090","0015","0346","334","224","110","97","431","606","0","71.12","36.96"
"10","010","00","090","0016","0000","303","205","98","28","331","765","0","43.27","26.80"
"10","010","00","090","0016","0347","303","205","98","28","331","765","0","43.27","26.80"
"10","010","00","090","0017","0000","385","249","136","99","484","654","0","74.01","38.07"
"10","010","00","090","0017","0348","228","136","92","57","285","359","0","79.39","37.88"
"10","010","00","090","0017","0349","157","113","44","42","199","295","0","67.46","38.31"
"10","010","00","090","0018","0000","616","387","229","156","772","1050","0","73.52","36.86"
"10","010","00","090","0018","0350","616","387","229","156","772","1050","0","73.52","36.86"
"10","010","00","090","0019","0000","603","408","195","104","707","879","0","80.43","46.42"
"10","010","00","090","0019","0351","603","408","195","104","707","879","0","80.43","46.42"
"10","010","00","090","0020","0000","563","351","212","181","744","1132","0","65.72","31.01"
"10","010","00","090","0020","0352","563","351","212","181","744","1132","0","65.72","31.01"
"10","010","00","090","0021","0000","396","220","176","82","478","740","0","64.59","29.73"
"10","010","00","090","0021","0353","265","155","110","54","319","401","0","79.55","38.65"
"10","010","00","090","0021","0354","131","65","66","28","159","339","0","46.90","19.17"
"10","010","00","090","0022","0000","116","67","49","35","151","279","0","54.12","24.01"
"10","010","00","090","0022","0341","116","67","49","35","151","279","0","54.12","24.01"
"10","010","00","090","0023","0000","660","454","206","172","832","1191","0","69.86","38.12"
"10","010","00","090","0023","0342","529","357","172","145","674","975","0","69.13","36.62"
"10","010","00","090","0023","0343","131","97","34","27","158","216","0","73.15","44.91"
"10","010","00","100","0000","0000","9604","6014","3590","1179","10783","15443","17059","69.82","38.94"
"10","010","00","100","0001","0000","404","252","152","36","440","631","0","69.73","39.94"
"10","010","00","100","0001","0384","276","179","97","26","302","430","0","70.23","41.63"
"10","010","00","100","0001","0385","128","73","55","10","138","201","0","68.66","36.32"
"10","010","00","100","0002","0000","911","522","389","96","1007","1394","0","72.24","37.45"
"10","010","00","100","0002","0386","528","307","221","41","569","779","0","73.04","39.41"
"10","010","00","100","0002","0387","383","215","168","55","438","615","0","71.22","34.96"
"10","010","00","100","0003","0000","734","410","324","49","783","1100","0","71.18","37.27"
"10","010","00","100","0003","0388","734","410","324","49","783","1100","0","71.18","37.27"
"10","010","00","100","0004","0000","570","326","244","52","622","828","0","75.12","39.37"
"10","010","00","100","0004","0389","570","326","244","52","622","828","0","75.12","39.37"
"10","010","00","100","0005","0000","413","258","155","30","443","709","0","62.48","36.39"
"10","010","00","100","0005","0390","413","258","155","30","443","709","0","62.48","36.39"
"10","010","00","100","0006","0000","758","498","260","92","850","1153","0","73.72","43.19"
"10","010","00","100","0006","0391","758","498","260","92","850","1153","0","73.72","43.19"
"10","010","00","100","0007","0000","252","153","99","32","284","354","0","80.23","43.22"
"10","010","00","100","0007","0392","252","153","99","32","284","354","0","80.23","43.22"
"10","010","00","100","0008","0000","177","118","59","15","192","391","0","49.10","30.18"
"10","010","00","100","0008","0393","116","82","34","3","119","301","0","39.53","27.24"
"10","010","00","100","0008","0394","61","36","25","12","73","90","0","81.11","40.00"
"10","010","00","100","0009","0000","472","285","187","91","563","691","0","81.48","41.24"
"10","010","00","100","0009","0395","472","285","187","91","563","691","0","81.48","41.24"
"10","010","00","100","0010","0000","298","185","113","41","339","403","0","84.12","45.91"
"10","010","00","100","0010","0396","298","185","113","41","339","403","0","84.12","45.91"
"10","010","00","100","0011","0000","222","142","80","48","270","401","0","67.33","35.41"
"10","010","00","100","0011","0397","222","142","80","48","270","401","0","67.33","35.41"
"10","010","00","100","0012","0000","301","185","116","48","349","558","0","62.54","33.15"
"10","010","00","100","0012","0398","301","185","116","48","349","558","0","62.54","33.15"
"10","010","00","100","0013","0000","745","463","282","86","831","1400","0","59.36","33.07"
"10","010","00","100","0013","0399","296","177","119","47","343","513","0","66.86","34.50"
"10","010","00","100","0013","0400","449","286","163","39","488","887","0","55.02","32.24"
"10","010","00","100","0014","0000","517","311","206","77","594","797","0","74.53","39.02"
"10","010","00","100","0014","0401","517","311","206","77","594","797","0","74.53","39.02"
"10","010","00","100","0015","0000","445","322","123","45","490","780","0","62.82","41.28"
"10","010","00","100","0015","0402","445","322","123","45","490","780","0","62.82","41.28"
"10","010","00","100","0016","0000","434","299","135","69","503","765","0","65.75","39.08"
"10","010","00","100","0016","0403","434","299","135","69","503","765","0","65.75","39.08"
"10","010","00","100","0017","0000","179","113","66","11","190","403","0","47.15","28.04"
"10","010","00","100","0017","0404","179","113","66","11","190","403","0","47.15","28.04"
"10","010","00","100","0018","0000","309","189","120","67","376","503","0","74.75","37.57"
"10","010","00","100","0018","0405","309","189","120","67","376","503","0","74.75","37.57"
"10","010","00","100","0019","0000","432","275","157","69","501","678","0","73.89","40.56"
"10","010","00","100","0019","0406","363","226","137","55","418","550","0","76.00","41.09"
"10","010","00","100","0019","0407","69","49","20","14","83","128","0","64.84","38.28"
"10","010","00","100","0020","0000","246","164","82","36","282","367","0","76.84","44.69"
"10","010","00","100","0020","0408","246","164","82","36","282","367","0","76.84","44.69"
"10","010","00","100","0021","0000","376","248","128","45","421","530","0","79.43","46.79"
"10","010","00","100","0021","0409","376","248","128","45","421","530","0","79.43","46.79"
"10","010","00","100","0022","0000","409","296","113","44","453","607","0","74.63","48.76"
"10","010","00","100","0022","0410","326","221","105","40","366","491","0","74.54","45.01"
"10","010","00","100","0022","0411","83","75","8","4","87","116","0","75.00","64.66"
"10","010","00","110","0000","0000","6932","4405","2527","940","7872","13022","14498","60.45","33.83"
"10","010","00","110","0001","0000","237","160","77","11","248","488","0","50.82","32.79"
"10","010","00","110","0001","0042","237","160","77","11","248","488","0","50.82","32.79"
"10","010","00","110","0002","0000","306","200","106","71","377","522","0","72.22","38.31"
"10","010","00","110","0002","0043","306","200","106","71","377","522","0","72.22","38.31"
"10","010","00","110","0003","0000","764","470","294","101","865","1231","0","70.27","38.18"
"10","010","00","110","0003","0044","764","470","294","101","865","1231","0","70.27","38.18"
"10","010","00","110","0004","0000","779","462","317","115","894","1277","0","70.01","36.18"
"10","010","00","110","0004","0045","779","462","317","115","894","1277","0","70.01","36.18"
"10","010","00","110","0005","0000","304","166","138","44","348","712","0","48.88","23.31"
"10","010","00","110","0005","0046","206","114","92","34","240","310","0","77.42","36.77"
"10","010","00","110","0005","0047","98","52","46","10","108","402","0","26.87","12.94"
"10","010","00","110","0006","0000","569","360","209","99","668","981","0","68.09","36.70"
"10","010","00","110","0006","0048","569","360","209","99","668","981","0","68.09","36.70"
"10","010","00","110","0007","0000","227","159","68","44","271","416","0","65.14","38.22"
"10","010","00","110","0007","0049","227","159","68","44","271","416","0","65.14","38.22"
"10","010","00","110","0008","0000","420","279","141","56","476","774","0","61.50","36.05"
"10","010","00","110","0008","0050","420","279","141","56","476","774","0","61.50","36.05"
"10","010","00","110","0009","0000","531","347","184","113","644","966","0","66.67","35.92"
"10","010","00","110","0009","0051","531","347","184","113","644","966","0","66.67","35.92"
"10","010","00","110","0010","0000","502","303","199","124","626","895","0","69.94","33.85"
"10","010","00","110","0010","0052","502","303","199","124","626","895","0","69.94","33.85"
"10","010","00","110","0011","0000","293","201","92","18","311","890","0","34.94","22.58"
"10","010","00","110","0011","0053","293","201","92","18","311","890","0","34.94","22.58"
"10","010","00","110","0012","0000","483","326","157","31","514","864","0","59.49","37.73"
"10","010","00","110","0012","0054","321","223","98","13","334","627","0","53.27","35.57"
"10","010","00","110","0012","0055","162","103","59","18","180","237","0","75.95","43.46"
"10","010","00","110","0013","0000","421","287","134","9","430","1098","0","39.16","26.14"
"10","010","00","110","0013","0056","266","183","83","5","271","818","0","33.13","22.37"
"10","010","00","110","0013","0057","155","104","51","4","159","280","0","56.79","37.14"
"10","010","00","110","0014","0000","736","468","268","78","814","1334","0","61.02","35.08"
"10","010","00","110","0014","0058","516","335","181","49","565","979","0","57.71","34.22"
"10","010","00","110","0014","0059","220","133","87","29","249","355","0","70.14","37.46"
"10","010","00","110","0015","0000","360","217","143","26","386","574","0","67.25","37.80"
"10","010","00","110","0015","0060","189","106","83","5","194","314","0","61.78","33.76"
"10","010","00","110","0015","0061","171","111","60","21","192","260","0","73.85","42.69"
"10","010","00","120","0000","0000","22675","13542","9133","1889","24564","42391","47989","57.95","31.95"
"10","010","00","120","0001","0000","1896","1071","825","98","1994","3933","0","50.70","27.23"
"10","010","00","120","0001","0062","441","237","204","36","477","978","0","48.77","24.23"
"10","010","00","120","0001","0063","592","335","257","20","612","1075","0","56.93","31.16"
"10","010","00","120","0001","0064","420","252","168","19","439","1026","0","42.79","24.56"
"10","010","00","120","0001","0065","443","247","196","23","466","854","0","54.57","28.92"
"10","010","00","120","0002","0000","1213","658","555","59","1272","2420","0","52.56","27.19"
"10","010","00","120","0002","0066","509","286","223","17","526","1120","0","46.96","25.54"
"10","010","00","120","0002","0067","704","372","332","42","746","1300","0","57.38","28.62"
"10","010","00","120","0003","0000","1058","682","376","110","1168","1600","0","73.00","42.63"
"10","010","00","120","0003","0075","400","257","143","32","432","611","0","70.70","42.06"
"10","010","00","120","0003","0076","425","269","156","51","476","628","0","75.80","42.83"
"10","010","00","120","0003","0077","233","156","77","27","260","361","0","72.02","43.21"
"10","010","00","120","0004","0000","1230","739","491","146","1376","1991","0","69.11","37.12"
"10","010","00","120","0004","0078","603","364","239","93","696","995","0","69.95","36.58"
"10","010","00","120","0004","0079","627","375","252","53","680","996","0","68.27","37.65"
"10","010","00","120","0005","0000","421","295","126","73","494","768","0","64.32","38.41"
"10","010","00","120","0005","0080","421","295","126","73","494","768","0","64.32","38.41"
"10","010","00","120","0006","0000","790","446","344","68","858","1474","0","58.21","30.26"
"10","010","00","120","0006","0068","608","330","278","43","651","1179","0","55.22","27.99"
"10","010","00","120","0006","0069","182","116","66","25","207","295","0","70.17","39.32"
"10","010","00","120","0007","0000","956","575","381","53","1009","1802","0","55.99","31.91"
"10","010","00","120","0007","0070","299","174","125","19","318","628","0","50.64","27.71"
"10","010","00","120","0007","0071","657","401","256","34","691","1174","0","58.86","34.16"
"10","010","00","120","0008","0000","835","530","305","40","875","1662","0","52.65","31.89"
"10","010","00","120","0008","0072","459","300","159","26","485","954","0","50.84","31.45"
"10","010","00","120","0008","0073","376","230","146","14","390","708","0","55.08","32.49"
"10","010","00","120","0009","0000","231","129","102","23","254","408","0","62.25","31.62"
"10","010","00","120","0009","0074","231","129","102","23","254","408","0","62.25","31.62"
"10","010","00","120","0010","0000","330","166","164","34","364","606","0","60.07","27.39"
"10","010","00","120","0010","0084","330","166","164","34","364","606","0","60.07","27.39"
"10","010","00","120","0011","0000","257","142","115","26","283","365","0","77.53","38.90"
"10","010","00","120","0011","0085","257","142","115","26","283","365","0","77.53","38.90"
"10","010","00","120","0012","0000","723","446","277","50","773","1288","0","60.02","34.63"
"10","010","00","120","0012","0086","445","277","168","37","482","721","0","66.85","38.42"
"10","010","00","120","0012","0087","278","169","109","13","291","567","0","51.32","29.81"
"10","010","00","120","0013","0000","1095","693","402","112","1207","1857","0","65.00","37.32"
"10","010","00","120","0013","0081","594","365","229","60","654","1012","0","64.62","36.07"
"10","010","00","120","0013","0082","501","328","173","52","553","845","0","65.44","38.82"
"10","010","00","120","0014","0000","627","399","228","72","699","1002","0","69.76","39.82"
"10","010","00","120","0014","0083","627","399","228","72","699","1002","0","69.76","39.82"
"10","010","00","120","0015","0000","960","585","375","37","997","2053","0","48.56","28.49"
"10","010","00","120","0015","0090","381","231","150","11","392","891","0","44.00","25.93"
"10","010","00","120","0015","0091","579","354","225","26","605","1162","0","52.07","30.46"
"10","010","00","120","0016","0000","970","609","361","93","1063","1943","0","54.71","31.34"
"10","010","00","120","0016","0092","573","351","222","45","618","1038","0","59.54","33.82"
"10","010","00","120","0016","0093","397","258","139","48","445","905","0","49.17","28.51"
"10","010","00","120","0017","0000","923","481","442","76","999","1735","0","57.58","27.72"
"10","010","00","120","0017","0088","424","220","204","31","455","768","0","59.24","28.65"
"10","010","00","120","0017","0089","499","261","238","45","544","967","0","56.26","26.99"
"10","010","00","120","0018","0000","1944","1194","750","169","2113","4209","0","50.20","28.37"
"10","010","00","120","0018","0095","622","391","231","48","670","1345","0","49.81","29.07"
"10","010","00","120","0018","0096","709","431","278","61","770","1428","0","53.92","30.18"
"10","010","00","120","0018","0097","613","372","241","60","673","1436","0","46.87","25.91"
"10","010","00","120","0019","0000","1572","923","649","103","1675","2870","0","58.36","32.16"
"10","010","00","120","0019","0098","791","464","327","45","836","1457","0","57.38","31.85"
"10","010","00","120","0019","0099","781","459","322","58","839","1413","0","59.38","32.48"
"10","010","00","120","0020","0000","892","499","393","86","978","1780","0","54.94","28.03"
"10","010","00","120","0020","0103","551","314","237","44","595","1022","0","58.22","30.72"
"10","010","00","120","0020","0104","341","185","156","42","383","758","0","50.53","24.41"
"10","010","00","120","0021","0000","956","588","368","73","1029","1679","0","61.29","35.02"
"10","010","00","120","0021","0101","575","345","230","39","614","1088","0","56.43","31.71"
"10","010","00","120","0021","0102","381","243","138","34","415","591","0","70.22","41.12"
"10","010","00","120","0022","0000","467","287","180","72","539","868","0","62.10","33.06"
"10","010","00","120","0022","0105","467","287","180","72","539","868","0","62.10","33.06"
"10","010","00","120","0023","0000","551","350","201","80","631","953","0","66.21","36.73"
"10","010","00","120","0023","0106","551","350","201","80","631","953","0","66.21","36.73"
"10","010","00","120","0024","0000","627","383","244","56","683","1180","0","57.88","32.46"
"10","010","00","120","0024","0107","627","383","244","56","683","1180","0","57.88","32.46"
"10","010","00","120","0025","0000","677","382","295","50","727","1151","0","63.16","33.19"
"10","010","00","120","0025","0094","677","382","295","50","727","1151","0","63.16","33.19"
"10","010","00","120","0026","0000","474","290","184","30","504","794","0","63.48","36.52"
"10","010","00","120","0026","0100","474","290","184","30","504","794","0","63.48","36.52"
"10","010","00","130","0000","0000","18366","10790","7576","1807","20173","37607","43143","53.64","28.69"
"10","010","00","130","0001","0000","803","455","348","60","863","1731","0","49.86","26.29"
"10","010","00","130","0001","0429","311","192","119","23","334","638","0","52.35","30.09"
"10","010","00","130","0001","0430","492","263","229","37","529","1093","0","48.40","24.06"
"10","010","00","130","0002","0000","499","284","215","54","553","903","0","61.24","31.45"
"10","010","00","130","0002","0431","499","284","215","54","553","903","0","61.24","31.45"
"10","010","00","130","0003","0000","267","157","110","21","288","758","0","37.99","20.71"
"10","010","00","130","0003","0443","267","157","110","21","288","758","0","37.99","20.71"
"10","010","00","130","0004","0000","434","267","167","35","469","855","0","54.85","31.23"
"10","010","00","130","0004","0442","434","267","167","35","469","855","0","54.85","31.23"
"10","010","00","130","0005","0000","471","244","227","17","488","1433","0","34.05","17.03"
"10","010","00","130","0005","0432","254","145","109","9","263","737","0","35.69","19.67"
"10","010","00","130","0005","0433","217","99","118","8","225","696","0","32.33","14.22"
"10","010","00","130","0006","0000","1390","856","534","138","1528","2819","0","54.20","30.37"
"10","010","00","130","0006","0412","482","279","203","51","533","1010","0","52.77","27.62"
"10","010","00","130","0006","0413","388","245","143","55","443","789","0","56.15","31.05"
"10","010","00","130","0006","0414","520","332","188","32","552","1020","0","54.12","32.55"
"10","010","00","130","0007","0000","1624","970","654","150","1774","3237","0","54.80","29.97"
"10","010","00","130","0007","0415","618","327","291","56","674","1246","0","54.09","26.24"
"10","010","00","130","0007","0416","451","269","182","35","486","868","0","55.99","30.99"
"10","010","00","130","0007","0417","555","374","181","59","614","1123","0","54.67","33.30"
"10","010","00","130","0008","0000","3245","1792","1453","258","3503","6836","0","51.24","26.21"
"10","010","00","130","0008","0418","622","339","283","54","676","1343","0","50.34","25.24"
"10","010","00","130","0008","0419","628","320","308","28","656","1235","0","53.12","25.91"
"10","010","00","130","0008","0420","449","245","204","37","486","1044","0","46.55","23.47"
"10","010","00","130","0008","0421","574","349","225","24","598","1260","0","47.46","27.70"
"10","010","00","130","0008","0422","366","200","166","33","399","761","0","52.43","26.28"
"10","010","00","130","0008","0423","606","339","267","82","688","1193","0","57.67","28.42"
"10","010","00","130","0009","0000","2917","1775","1142","243","3160","5514","0","57.31","32.19"
"10","010","00","130","0009","0424","538","328","210","55","593","1132","0","52.39","28.98"
"10","010","00","130","0009","0425","692","430","262","57","749","1299","0","57.66","33.10"
"10","010","00","130","0009","0426","490","288","202","40","530","950","0","55.79","30.32"
"10","010","00","130","0009","0427","542","305","237","52","594","979","0","60.67","31.15"
"10","010","00","130","0009","0428","655","424","231","39","694","1154","0","60.14","36.74"
"10","010","00","130","0010","0000","896","520","376","61","957","1762","0","54.31","29.51"
"10","010","00","130","0010","0434","300","165","135","15","315","743","0","42.40","22.21"
"10","010","00","130","0010","0435","596","355","241","46","642","1019","0","63.00","34.84"
"10","010","00","130","0011","0000","786","474","312","108","894","1457","0","61.36","32.53"
"10","010","00","130","0011","0436","310","203","107","43","353","564","0","62.59","35.99"
"10","010","00","130","0011","0437","476","271","205","65","541","893","0","60.58","30.35"
"10","010","00","130","0012","0000","1008","534","474","122","1130","2027","0","55.75","26.34"
"10","010","00","130","0012","0438","153","91","62","17","170","405","0","41.98","22.47"
"10","010","00","130","0012","0439","397","203","194","42","439","754","0","58.22","26.92"
"10","010","00","130","0012","0440","458","240","218","63","521","868","0","60.02","27.65"
"10","010","00","130","0013","0000","448","264","184","38","486","983","0","49.44","26.86"
"10","010","00","130","0013","0441","448","264","184","38","486","983","0","49.44","26.86"
"10","010","00","130","0014","0000","395","254","141","29","424","1069","0","39.66","23.76"
"10","010","00","130","0014","0444","82","54","28","3","85","261","0","32.57","20.69"
"10","010","00","130","0014","0445","313","200","113","26","339","808","0","41.96","24.75"
"10","010","00","130","0015","0000","430","276","154","35","465","911","0","51.04","30.30"
"10","010","00","130","0015","0446","430","276","154","35","465","911","0","51.04","30.30"
"10","010","00","130","0016","0000","953","588","365","160","1113","1789","0","62.21","32.87"
"10","010","00","130","0016","0447","649","392","257","108","757","1168","0","64.81","33.56"
"10","010","00","130","0016","0448","304","196","108","52","356","621","0","57.33","31.56"
"10","010","00","130","0017","0000","378","233","145","66","444","697","0","63.70","33.43"
"10","010","00","130","0017","0451","378","233","145","66","444","697","0","63.70","33.43"
"10","010","00","130","0018","0000","463","293","170","49","512","923","0","55.47","31.74"
"10","010","00","130","0018","0452","187","116","71","23","210","445","0","47.19","26.07"
"10","010","00","130","0018","0453","276","177","99","26","302","478","0","63.18","37.03"
"10","010","00","130","0019","0000","252","163","89","25","277","604","0","45.86","26.99"
"10","010","00","130","0019","0450","252","163","89","25","277","604","0","45.86","26.99"
"10","010","00","130","0020","0000","386","235","151","76","462","691","0","66.86","34.01"
"10","010","00","130","0020","0449","386","235","151","76","462","691","0","66.86","34.01"
"10","010","00","130","0021","0000","177","88","89","34","211","338","0","62.43","26.04"
"10","010","00","130","0021","0454","177","88","89","34","211","338","0","62.43","26.04"
"10","010","00","130","0022","0000","144","68","76","28","172","270","0","63.70","25.19"
"10","010","00","130","0022","0455","144","68","76","28","172","270","0","63.70","25.19"
"10","010","00","140","0000","0000","16237","9479","6758","1787","18024","29597","33820","60.90","32.03"
"10","010","00","140","0001","0000","1381","842","539","119","1500","2402","0","62.45","35.05"
"10","010","00","140","0001","0456","697","431","266","42","739","1243","0","59.45","34.67"
"10","010","00","140","0001","0457","684","411","273","77","761","1159","0","65.66","35.46"
"10","010","00","140","0002","0000","1114","603","511","147","1261","2106","0","59.88","28.63"
"10","010","00","140","0002","0458","536","289","247","43","579","967","0","59.88","29.89"
"10","010","00","140","0002","0459","578","314","264","104","682","1139","0","59.88","27.57"
"10","010","00","140","0003","0000","354","219","135","29","383","732","0","52.32","29.92"
"10","010","00","140","0003","0460","354","219","135","29","383","732","0","52.32","29.92"
"10","010","00","140","0004","0000","468","316","152","57","525","798","0","65.79","39.60"
"10","010","00","140","0004","0461","468","316","152","57","525","798","0","65.79","39.60"
"10","010","00","140","0005","0000","689","399","290","43","732","1157","0","63.27","34.49"
"10","010","00","140","0005","0462","689","399","290","43","732","1157","0","63.27","34.49"
"10","010","00","140","0006","0000","360","224","136","26","386","599","0","64.44","37.40"
"10","010","00","140","0006","0463","360","224","136","26","386","599","0","64.44","37.40"
"10","010","00","140","0007","0000","551","345","206","36","587","978","0","60.02","35.28"
"10","010","00","140","0007","0464","551","345","206","36","587","978","0","60.02","35.28"
"10","010","00","140","0008","0000","2616","1449","1167","180","2796","5065","0","55.20","28.61"
"10","010","00","140","0008","0465","678","394","284","50","728","1252","0","58.15","31.47"
"10","010","00","140","0008","0466","699","389","310","46","745","1324","0","56.27","29.38"
"10","010","00","140","0008","0467","333","175","158","30","363","610","0","59.51","28.69"
"10","010","00","140","0008","0468","649","339","310","35","684","1329","0","51.47","25.51"
"10","010","00","140","0008","0469","257","152","105","19","276","550","0","50.18","27.64"
"10","010","00","140","0009","0000","892","535","357","12","904","1350","0","66.96","39.63"
"10","010","00","140","0009","0470","892","535","357","12","904","1350","0","66.96","39.63"
"10","010","00","140","0010","0000","759","410","349","128","887","1325","0","66.94","30.94"
"10","010","00","140","0010","0471","759","410","349","128","887","1325","0","66.94","30.94"
"10","010","00","140","0011","0000","859","482","377","39","898","1507","0","59.59","31.98"
"10","010","00","140","0011","0472","859","482","377","39","898","1507","0","59.59","31.98"
"10","010","00","140","0012","0000","780","455","325","80","860","1677","0","51.28","27.13"
"10","010","00","140","0012","0473","378","203","175","53","431","745","0","57.85","27.25"
"10","010","00","140","0012","0474","402","252","150","27","429","932","0","46.03","27.04"
"10","010","00","140","0013","0000","360","199","161","82","442","578","0","76.47","34.43"
"10","010","00","140","0013","0477","360","199","161","82","442","578","0","76.47","34.43"
"10","010","00","140","0014","0000","541","328","213","98","639","956","0","66.84","34.31"
"10","010","00","140","0014","0475","184","115","69","36","220","318","0","69.18","36.16"
"10","010","00","140","0014","0476","357","213","144","62","419","638","0","65.67","33.39"
"10","010","00","140","0015","0000","472","282","190","64","536","814","0","65.85","34.64"
"10","010","00","140","0015","0478","251","150","101","60","311","444","0","70.05","33.78"
"10","010","00","140","0015","0479","221","132","89","4","225","370","0","60.81","35.68"
"10","010","00","140","0016","0000","423","228","195","81","504","616","0","81.82","37.01"
"10","010","00","140","0016","0480","423","228","195","81","504","616","0","81.82","37.01"
"10","010","00","140","0017","0000","873","553","320","151","1024","1693","0","60.48","32.66"
"10","010","00","140","0017","0481","100","72","28","13","113","193","0","58.55","37.31"
"10","010","00","140","0017","0482","773","481","292","138","911","1500","0","60.73","32.07"
"10","010","00","140","0018","0000","292","172","120","15","307","609","0","50.41","28.24"
"10","010","00","140","0018","0483","292","172","120","15","307","609","0","50.41","28.24"
"10","010","00","140","0019","0000","225","123","102","24","249","393","0","63.36","31.30"
"10","010","00","140","0019","0484","225","123","102","24","249","393","0","63.36","31.30"
"10","010","00","140","0020","0000","935","539","396","161","1096","1761","0","62.24","30.61"
"10","010","00","140","0020","0485","471","277","194","88","559","858","0","65.15","32.28"
"10","010","00","140","0020","0486","464","262","202","73","537","903","0","59.47","29.01"
"10","010","00","140","0021","0000","396","223","173","88","484","848","0","57.08","26.30"
"10","010","00","140","0021","0487","361","209","152","72","433","750","0","57.73","27.87"
"10","010","00","140","0021","0488","35","14","21","16","51","98","0","52.04","14.29"
"10","010","00","140","0022","0000","165","113","52","19","184","233","0","78.97","48.50"
"10","010","00","140","0022","0489","165","113","52","19","184","233","0","78.97","48.50"
"10","010","00","140","0023","0000","322","193","129","14","336","741","0","45.34","26.05"
"10","010","00","140","0023","0490","113","67","46","6","119","307","0","38.76","21.82"
"10","010","00","140","0023","0491","209","126","83","8","217","434","0","50.00","29.03"
"10","010","00","140","0024","0000","410","247","163","94","504","659","0","76.48","37.48"
"10","010","00","140","0024","0492","275","166","109","51","326","419","0","77.80","39.62"
"10","010","00","140","0024","0493","135","81","54","43","178","240","0","74.17","33.75"
"10","010","00","150","0000","0000","9388","5325","4063","1213","10601","15979","18087","66.34","33.32"
"10","010","00","150","0001","0000","1174","687","487","118","1292","2128","0","60.71","32.28"
"10","010","00","150","0001","0238","438","264","174","24","462","927","0","49.84","28.48"
"10","010","00","150","0001","0239","736","423","313","94","830","1201","0","69.11","35.22"
"10","010","00","150","0002","0000","533","286","247","70","603","842","0","71.62","33.97"
"10","010","00","150","0002","0240","533","286","247","70","603","842","0","71.62","33.97"
"10","010","00","150","0003","0000","362","202","160","38","400","513","0","77.97","39.38"
"10","010","00","150","0003","0245","362","202","160","38","400","513","0","77.97","39.38"
"10","010","00","150","0004","0000","2501","1451","1050","233","2734","4217","0","64.83","34.41"
"10","010","00","150","0004","0241","682","424","258","44","726","1122","0","64.71","37.79"
"10","010","00","150","0004","0242","530","291","239","44","574","977","0","58.75","29.79"
"10","010","00","150","0004","0243","730","428","302","97","827","1196","0","69.15","35.79"
"10","010","00","150","0004","0244","559","308","251","48","607","922","0","65.84","33.41"
"10","010","00","150","0005","0000","238","140","98","31","269","383","0","70.23","36.55"
"10","010","00","150","0005","0246","238","140","98","31","269","383","0","70.23","36.55"
"10","010","00","150","0006","0000","300","174","126","46","346","468","0","73.93","37.18"
"10","010","00","150","0006","0252","300","174","126","46","346","468","0","73.93","37.18"
"10","010","00","150","0007","0000","213","117","96","44","257","333","0","77.18","35.14"
"10","010","00","150","0007","0253","213","117","96","44","257","333","0","77.18","35.14"
"10","010","00","150","0008","0000","340","191","149","68","408","552","0","73.91","34.60"
"10","010","00","150","0008","0247","340","191","149","68","408","552","0","73.91","34.60"
"10","010","00","150","0009","0000","902","515","387","61","963","1542","0","62.45","33.40"
"10","010","00","150","0009","0249","476","283","193","39","515","814","0","63.27","34.77"
"10","010","00","150","0009","0250","426","232","194","22","448","728","0","61.54","31.87"
"10","010","00","150","0010","0000","269","178","91","35","304","523","0","58.13","34.03"
"10","010","00","150","0010","0248","269","178","91","35","304","523","0","58.13","34.03"
"10","010","00","150","0011","0000","468","271","197","94","562","782","0","71.87","34.65"
"10","010","00","150","0011","0251","468","271","197","94","562","782","0","71.87","34.65"
"10","010","00","150","0012","0000","249","142","107","57","306","456","0","67.11","31.14"
"10","010","00","150","0012","0254","249","142","107","57","306","456","0","67.11","31.14"
"10","010","00","150","0013","0000","189","112","77","30","219","271","0","80.81","41.33"
"10","010","00","150","0013","0257","189","112","77","30","219","271","0","80.81","41.33"
"10","010","00","150","0014","0000","299","135","164","59","358","415","0","86.27","32.53"
"10","010","00","150","0014","0255","299","135","164","59","358","415","0","86.27","32.53"
"10","010","00","150","0015","0000","321","191","130","73","394","684","0","57.60","27.92"
"10","010","00","150","0015","0258","321","191","130","73","394","684","0","57.60","27.92"
"10","010","00","150","0016","0000","324","163","161","42","366","590","0","62.03","27.63"
"10","010","00","150","0016","0259","324","163","161","42","366","590","0","62.03","27.63"
"10","010","00","150","0017","0000","523","264","259","72","595","897","0","66.33","29.43"
"10","010","00","150","0017","0260","283","146","137","30","313","510","0","61.37","28.63"
"10","010","00","150","0017","0261","240","118","122","42","282","387","0","72.87","30.49"
"10","010","00","150","0018","0000","183","106","77","42","225","383","0","58.75","27.68"
"10","010","00","150","0018","0256","183","106","77","42","225","383","0","58.75","27.68"
"10","010","00","160","0000","0000","5609","3203","2406","486","6095","9718","10992","62.72","32.96"
"10","010","00","160","0001","0000","760","399","361","85","845","1145","0","73.80","34.85"
"10","010","00","160","0001","0494","760","399","361","85","845","1145","0","73.80","34.85"
"10","010","00","160","0002","0000","295","167","128","29","324","435","0","74.48","38.39"
"10","010","00","160","0002","0495","295","167","128","29","324","435","0","74.48","38.39"
"10","010","00","160","0003","0000","606","388","218","28","634","1247","0","50.84","31.11"
"10","010","00","160","0003","0496","417","257","160","23","440","740","0","59.46","34.73"
"10","010","00","160","0003","0497","189","131","58","5","194","507","0","38.26","25.84"
"10","010","00","160","0004","0000","1100","627","473","78","1178","1719","0","68.53","36.47"
"10","010","00","160","0004","0498","637","362","275","57","694","903","0","76.85","40.09"
"10","010","00","160","0004","0499","463","265","198","21","484","816","0","59.31","32.48"
"10","010","00","160","0005","0000","428","253","175","28","456","800","0","57.00","31.63"
"10","010","00","160","0005","0500","428","253","175","28","456","800","0","57.00","31.63"
"10","010","00","160","0006","0000","498","291","207","22","520","841","0","61.83","34.60"
"10","010","00","160","0006","0501","498","291","207","22","520","841","0","61.83","34.60"
"10","010","00","160","0007","0000","617","359","258","47","664","1194","0","55.61","30.07"
"10","010","00","160","0007","0502","351","147","204","36","387","772","0","50.13","19.04"
"10","010","00","160","0007","0503","266","212","54","11","277","422","0","65.64","50.24"
"10","010","00","160","0008","0000","329","203","126","16","345","600","0","57.50","33.83"
"10","010","00","160","0008","0504","329","203","126","16","345","600","0","57.50","33.83"
"10","010","00","160","0009","0000","516","275","241","73","589","911","0","64.65","30.19"
"10","010","00","160","0009","0505","159","99","60","32","191","290","0","65.86","34.14"
"10","010","00","160","0009","0506","357","176","181","41","398","621","0","64.09","28.34"
"10","010","00","160","0010","0000","234","141","93","27","261","478","0","54.60","29.50"
"10","010","00","160","0010","0507","234","141","93","27","261","478","0","54.60","29.50"
"10","010","00","160","0011","0000","226","100","126","53","279","348","0","80.17","28.74"
"10","010","00","160","0011","0508","95","36","59","21","116","152","0","76.32","23.68"
"10","010","00","160","0011","0509","131","64","67","32","163","196","0","83.16","32.65"
"10","010","00","170","0000","0000","1869","1029","840","126","1995","3903","4498","51.11","26.36"
"10","010","00","170","0001","0000","618","356","262","27","645","1434","0","44.98","24.83"
"10","010","00","170","0001","0510","290","149","141","12","302","716","0","42.18","20.81"
"10","010","00","170","0001","0511","328","207","121","15","343","718","0","47.77","28.83"
"10","010","00","170","0002","0000","277","170","107","16","293","626","0","46.81","27.16"
"10","010","00","170","0002","0512","137","84","53","7","144","321","0","44.86","26.17"
"10","010","00","170","0002","0513","140","86","54","9","149","305","0","48.85","28.20"
"10","010","00","170","0003","0000","206","103","103","1","207","399","0","51.88","25.81"
"10","010","00","170","0003","0514","79","42","37","1","80","169","0","47.34","24.85"
"10","010","00","170","0003","0515","127","61","66","0","127","230","0","55.22","26.52"
"10","010","00","170","0004","0000","402","219","183","43","445","897","0","49.61","24.41"
"10","010","00","170","0004","0516","234","128","106","23","257","473","0","54.33","27.06"
"10","010","00","170","0004","0517","85","52","33","15","100","184","0","54.35","28.26"
"10","010","00","170","0004","0518","83","39","44","5","88","240","0","36.67","16.25"
"10","010","00","170","0005","0000","366","181","185","39","405","547","0","74.04","33.09"
"10","010","00","170","0005","0519","366","181","185","39","405","547","0","74.04","33.09"
"10","010","00","180","0000","0000","2509","1209","1300","324","2833","4478","5385","63.26","27.00"
"10","010","00","180","0001","0000","162","83","79","15","177","354","0","50.00","23.45"
"10","010","00","180","0001","0520","162","83","79","15","177","354","0","50.00","23.45"
"10","010","00","180","0002","0000","74","39","35","7","81","168","0","48.21","23.21"
"10","010","00","180","0002","0521","74","39","35","7","81","168","0","48.21","23.21"
"10","010","00","180","0003","0000","54","21","33","10","64","126","0","50.79","16.67"
"10","010","00","180","0003","0522","54","21","33","10","64","126","0","50.79","16.67"
"10","010","00","180","0004","0000","126","55","71","21","147","302","0","48.68","18.21"
"10","010","00","180","0004","0523","99","43","56","19","118","226","0","52.21","19.03"
"10","010","00","180","0004","0524","27","12","15","2","29","76","0","38.16","15.79"
"10","010","00","180","0005","0000","183","83","100","17","200","293","0","68.26","28.33"
"10","010","00","180","0005","0526","183","83","100","17","200","293","0","68.26","28.33"
"10","010","00","180","0006","0000","148","70","78","27","175","287","0","60.98","24.39"
"10","010","00","180","0006","0525","148","70","78","27","175","287","0","60.98","24.39"
"10","010","00","180","0007","0000","434","225","209","71","505","804","0","62.81","27.99"
"10","010","00","180","0007","0528","434","225","209","71","505","804","0","62.81","27.99"
"10","010","00","180","0008","0000","591","266","325","63","654","921","0","71.01","28.88"
"10","010","00","180","0008","0527","591","266","325","63","654","921","0","71.01","28.88"
"10","010","00","180","0009","0000","135","65","70","13","148","233","0","63.52","27.90"
"10","010","00","180","0009","0529","135","65","70","13","148","233","0","63.52","27.90"
"10","010","00","180","0010","0000","242","120","122","40","282","460","0","61.30","26.09"
"10","010","00","180","0010","0530","242","120","122","40","282","460","0","61.30","26.09"
"10","010","00","180","0011","0000","175","88","87","27","202","275","0","73.45","32.00"
"10","010","00","180","0011","0531","175","88","87","27","202","275","0","73.45","32.00"
"10","010","00","180","0012","0000","185","94","91","13","198","255","0","77.65","36.86"
"10","010","00","180","0012","0532","185","94","91","13","198","255","0","77.65","36.86"
"10","013","00","000","0000","0000","397784","230102","167682","36464","434248","681084","798965","63.76","33.78"
"10","013","00","010","0000","0000","89571","47680","41891","4225","93796","162258","193656","57.81","29.39"
"10","013","00","010","0001","0000","1005","560","445","50","1055","1557","0","67.76","35.97"
"10","013","00","010","0001","0003","539","284","255","20","559","831","0","67.27","34.18"
"10","013","00","010","0001","0004","466","276","190","30","496","726","0","68.32","38.02"
"10","013","00","010","0004","0000","948","549","399","29","977","1600","0","61.06","34.31"
"10","013","00","010","0004","0001","495","312","183","12","507","857","0","59.16","36.41"
"10","013","00","010","0004","0002","453","237","216","17","470","743","0","63.26","31.90"
"10","013","00","010","0008","0000","907","533","374","39","946","1546","0","61.19","34.48"
"10","013","00","010","0008","0005","507","306","201","15","522","859","0","60.77","35.62"
"10","013","00","010","0008","0006","400","227","173","24","424","687","0","61.72","33.04"
"10","013","00","010","0012","0000","1280","762","518","74","1354","2422","0","55.90","31.46"
"10","013","00","010","0012","0007","644","393","251","49","693","1213","0","57.13","32.40"
"10","013","00","010","0012","0008","636","369","267","25","661","1209","0","54.67","30.52"
"10","013","00","010","0015","0000","1284","800","484","49","1333","2025","0","65.83","39.51"
"10","013","00","010","0015","0009","687","438","249","26","713","1030","0","69.22","42.52"
"10","013","00","010","0015","0010","597","362","235","23","620","995","0","62.31","36.38"
"10","013","00","010","0018","0000","761","423","338","45","806","1114","0","72.35","37.97"
"10","013","00","010","0018","0011","761","423","338","45","806","1114","0","72.35","37.97"
"10","013","00","010","0020","0000","783","430","353","35","818","1461","0","55.99","29.43"
"10","013","00","010","0020","0012","783","430","353","35","818","1461","0","55.99","29.43"
"10","013","00","010","0021","0000","545","303","242","24","569","985","0","57.77","30.76"
"10","013","00","010","0021","0013","545","303","242","24","569","985","0","57.77","30.76"
"10","013","00","010","0022","0000","875","488","387","42","917","1615","0","56.78","30.22"
"10","013","00","010","0022","0029","507","289","218","27","534","959","0","55.68","30.14"
"10","013","00","010","0022","0030","368","199","169","15","383","656","0","58.38","30.34"
"10","013","00","010","0023","0000","1359","715","644","37","1396","2362","0","59.10","30.27"
"10","013","00","010","0023","0024","737","406","331","25","762","1249","0","61.01","32.51"
"10","013","00","010","0023","0025","622","309","313","12","634","1113","0","56.96","27.76"
"10","013","00","010","0024","0000","1895","941","954","56","1951","3285","0","59.39","28.65"
"10","013","00","010","0024","0026","634","304","330","12","646","1132","0","57.07","26.86"
"10","013","00","010","0024","0027","550","296","254","18","568","956","0","59.41","30.96"
"10","013","00","010","0024","0028","711","341","370","26","737","1197","0","61.57","28.49"
"10","013","00","010","0025","0000","1859","954","905","79","1938","3734","0","51.90","25.55"
"10","013","00","010","0025","0021","646","340","306","31","677","1207","0","56.09","28.17"
"10","013","00","010","0025","0022","641","304","337","25","666","1264","0","52.69","24.05"
"10","013","00","010","0025","0023","572","310","262","23","595","1263","0","47.11","24.54"
"10","013","00","010","0026","0000","2103","950","1153","75","2178","3970","0","54.86","23.93"
"10","013","00","010","0026","0014","666","300","366","30","696","1246","0","55.86","24.08"
"10","013","00","010","0026","0015","693","306","387","27","720","1302","0","55.30","23.50"
"10","013","00","010","0026","0016","744","344","400","18","762","1422","0","53.59","24.19"
"10","013","00","010","0027","0000","853","544","309","61","914","1433","0","63.78","37.96"
"10","013","00","010","0027","0037","853","544","309","61","914","1433","0","63.78","37.96"
"10","013","00","010","0028","0000","650","432","218","57","707","1019","0","69.38","42.39"
"10","013","00","010","0028","0036","650","432","218","57","707","1019","0","69.38","42.39"
"10","013","00","010","0029","0000","612","408","204","37","649","1064","0","61.00","38.35"
"10","013","00","010","0029","0038","612","408","204","37","649","1064","0","61.00","38.35"
"10","013","00","010","0030","0000","3641","1857","1784","143","3784","6923","0","54.66","26.82"
"10","013","00","010","0030","0031","695","344","351","41","736","1364","0","53.96","25.22"
"10","013","00","010","0030","0032","765","431","334","22","787","1399","0","56.25","30.81"
"10","013","00","010","0030","0033","793","381","412","18","811","1439","0","56.36","26.48"
"10","013","00","010","0030","0034","656","324","332","30","686","1362","0","50.37","23.79"
"10","013","00","010","0030","0035","732","377","355","32","764","1359","0","56.22","27.74"
"10","013","00","010","0031","0000","2882","1548","1334","151","3033","5205","0","58.27","29.74"
"10","013","00","010","0031","0062","828","463","365","36","864","1403","0","61.58","33.00"
"10","013","00","010","0031","0063","752","405","347","45","797","1325","0","60.15","30.57"
"10","013","00","010","0031","0064","647","362","285","38","685","1249","0","54.84","28.98"
"10","013","00","010","0031","0065","655","318","337","32","687","1228","0","55.94","25.90"
"10","013","00","010","0032","0000","333","207","126","35","368","496","0","74.19","41.73"
"10","013","00","010","0032","0066","333","207","126","35","368","496","0","74.19","41.73"
"10","013","00","010","0033","0000","1425","894","531","82","1507","2731","0","55.18","32.74"
"10","013","00","010","0033","0075","636","406","230","30","666","1169","0","56.97","34.73"
"10","013","00","010","0033","0076","789","488","301","52","841","1562","0","53.84","31.24"
"10","013","00","010","0035","0000","963","552","411","49","1012","1639","0","61.74","33.68"
"10","013","00","010","0035","0073","446","275","171","16","462","747","0","61.85","36.81"
"10","013","00","010","0035","0074","517","277","240","33","550","892","0","61.66","31.05"
"10","013","00","010","0036","0000","1076","569","507","42","1118","1783","0","62.70","31.91"
"10","013","00","010","0036","0077","665","316","349","18","683","1117","0","61.15","28.29"
"10","013","00","010","0036","0078","411","253","158","24","435","666","0","65.32","37.99"
"10","013","00","010","0038","0000","896","446","450","33","929","1684","0","55.17","26.48"
"10","013","00","010","0038","0079","580","250","330","15","595","1068","0","55.71","23.41"
"10","013","00","010","0038","0080","316","196","120","18","334","616","0","54.22","31.82"
"10","013","00","010","0040","0000","3207","1719","1488","147","3354","5805","0","57.78","29.61"
"10","013","00","010","0040","0081","867","456","411","31","898","1430","0","62.80","31.89"
"10","013","00","010","0040","0082","768","421","347","37","805","1515","0","53.14","27.79"
"10","013","00","010","0040","0083","787","415","372","43","830","1449","0","57.28","28.64"
"10","013","00","010","0040","0084","785","427","358","36","821","1411","0","58.19","30.26"
"10","013","00","010","0041","0000","1308","791","517","76","1384","2421","0","57.17","32.67"
"10","013","00","010","0041","0060","801","509","292","61","862","1216","0","70.89","41.86"
"10","013","00","010","0041","0061","507","282","225","15","522","1205","0","43.32","23.40"
"10","013","00","010","0042","0000","943","573","370","64","1007","1480","0","68.04","38.72"
"10","013","00","010","0042","0059","943","573","370","64","1007","1480","0","68.04","38.72"
"10","013","00","010","0043","0000","1331","835","496","115","1446","2144","0","67.44","38.95"
"10","013","00","010","0043","0070","764","474","290","74","838","1168","0","71.75","40.58"
"10","013","00","010","0043","0071","567","361","206","41","608","976","0","62.30","36.99"
"10","013","00","010","0044","0000","935","578","357","71","1006","1477","0","68.11","39.13"
"10","013","00","010","0044","0072","935","578","357","71","1006","1477","0","68.11","39.13"
"10","013","00","010","0045","0000","721","445","276","41","762","1084","0","70.30","41.05"
"10","013","00","010","0045","0067","721","445","276","41","762","1084","0","70.30","41.05"
"10","013","00","010","0046","0000","957","582","375","79","1036","1722","0","60.16","33.80"
"10","013","00","010","0046","0068","455","266","189","17","472","831","0","56.80","32.01"
"10","013","00","010","0046","0069","502","316","186","62","564","891","0","63.30","35.47"
"10","013","00","010","0049","0000","1089","665","424","70","1159","1925","0","60.21","34.55"
"10","013","00","010","0049","0057","506","307","199","25","531","894","0","59.40","34.34"
"10","013","00","010","0049","0058","583","358","225","45","628","1031","0","60.91","34.72"
"10","013","00","010","0050","0000","775","451","324","81","856","1400","0","61.14","32.21"
"10","013","00","010","0050","0053","775","451","324","81","856","1400","0","61.14","32.21"
"10","013","00","010","0051","0000","706","484","222","55","761","1118","0","68.07","43.29"
"10","013","00","010","0051","0056","706","484","222","55","761","1118","0","68.07","43.29"
"10","013","00","010","0053","0000","4159","2215","1944","138","4297","7749","0","55.45","28.58"
"10","013","00","010","0053","0042","621","311","310","25","646","1248","0","51.76","24.92"
"10","013","00","010","0053","0043","648","375","273","22","670","1210","0","55.37","30.99"
"10","013","00","010","0053","0044","729","413","316","20","749","1323","0","56.61","31.22"
"10","013","00","010","0053","0045","783","382","401","21","804","1386","0","58.01","27.56"
"10","013","00","010","0053","0046","659","359","300","26","685","1237","0","55.38","29.02"
"10","013","00","010","0053","0047","719","375","344","24","743","1345","0","55.24","27.88"
"10","013","00","010","0054","0000","1633","966","667","101","1734","2807","0","61.77","34.41"
"10","013","00","010","0054","0051","810","484","326","40","850","1344","0","63.24","36.01"
"10","013","00","010","0054","0052","823","482","341","61","884","1463","0","60.42","32.95"
"10","013","00","010","0055","0000","2268","1230","1038","65","2333","3993","0","58.43","30.80"
"10","013","00","010","0055","0039","719","392","327","15","734","1311","0","55.99","29.90"
"10","013","00","010","0055","0040","782","443","339","23","805","1362","0","59.10","32.53"
"10","013","00","010","0055","0041","767","395","372","27","794","1320","0","60.15","29.92"
"10","013","00","010","0056","0000","1316","799","517","92","1408","2405","0","58.54","33.22"
"10","013","00","010","0056","0054","693","431","262","30","723","1165","0","62.06","37.00"
"10","013","00","010","0056","0055","623","368","255","62","685","1240","0","55.24","29.68"
"10","013","00","010","0059","0000","1018","539","479","28","1046","1886","0","55.46","28.58"
"10","013","00","010","0059","0111","431","242","189","18","449","816","0","55.02","29.66"
"10","013","00","010","0059","0112","587","297","290","10","597","1070","0","55.79","27.76"
"10","013","00","010","0060","0000","2544","1216","1328","105","2649","4687","0","56.52","25.94"
"10","013","00","010","0060","0113","645","324","321","27","672","1211","0","55.49","26.75"
"10","013","00","010","0060","0114","649","298","351","29","678","1117","0","60.70","26.68"
"10","013","00","010","0060","0115","649","307","342","30","679","1128","0","60.20","27.22"
"10","013","00","010","0060","0116","601","287","314","19","620","1231","0","50.37","23.31"
"10","013","00","010","0064","0000","2308","1084","1224","81","2389","4266","0","56.00","25.41"
"10","013","00","010","0064","0130","823","409","414","32","855","1441","0","59.33","28.38"
"10","013","00","010","0064","0131","684","340","344","23","707","1345","0","52.57","25.28"
"10","013","00","010","0064","0132","801","335","466","26","827","1480","0","55.88","22.64"
"10","013","00","010","0065","0000","2578","1205","1373","153","2731","5555","0","49.16","21.69"
"10","013","00","010","0065","0107","453","227","226","37","490","1519","0","32.26","14.94"
"10","013","00","010","0065","0108","706","305","401","33","739","1340","0","55.15","22.76"
"10","013","00","010","0065","0109","678","346","332","52","730","1282","0","56.94","26.99"
"10","013","00","010","0065","0110","741","327","414","31","772","1414","0","54.60","23.13"
"10","013","00","010","0066","0000","972","511","461","41","1013","2137","0","47.40","23.91"
"10","013","00","010","0066","0100","539","287","252","24","563","1083","0","51.99","26.50"
"10","013","00","010","0066","0101","433","224","209","17","450","1054","0","42.69","21.25"
"10","013","00","010","0067","0000","1067","571","496","45","1112","2099","0","52.98","27.20"
"10","013","00","010","0067","0117","542","265","277","26","568","1033","0","54.99","25.65"
"10","013","00","010","0067","0118","525","306","219","19","544","1066","0","51.03","28.71"
"10","013","00","010","0068","0000","1273","688","585","53","1326","2248","0","58.99","30.60"
"10","013","00","010","0068","0128","710","371","339","31","741","1231","0","60.19","30.14"
"10","013","00","010","0068","0129","563","317","246","22","585","1017","0","57.52","31.17"
"10","013","00","010","0069","0000","3126","1605","1521","107","3233","5900","0","54.80","27.20"
"10","013","00","010","0069","0123","590","323","267","28","618","1163","0","53.14","27.77"
"10","013","00","010","0069","0124","693","344","349","14","707","1182","0","59.81","29.10"
"10","013","00","010","0069","0125","616","282","334","19","635","1133","0","56.05","24.89"
"10","013","00","010","0069","0126","611","328","283","33","644","1229","0","52.40","26.69"
"10","013","00","010","0069","0127","616","328","288","13","629","1193","0","52.72","27.49"
"10","013","00","010","0070","0000","1087","542","545","58","1145","1933","0","59.23","28.04"
"10","013","00","010","0070","0121","525","277","248","15","540","945","0","57.14","29.31"
"10","013","00","010","0070","0122","562","265","297","43","605","988","0","61.23","26.82"
"10","013","00","010","0071","0000","1536","789","747","102","1638","2826","0","57.96","27.92"
"10","013","00","010","0071","0105","861","466","395","80","941","1551","0","60.67","30.05"
"10","013","00","010","0071","0106","675","323","352","22","697","1275","0","54.67","25.33"
"10","013","00","010","0073","0000","4121","1930","2191","169","4290","7670","0","55.93","25.16"
"10","013","00","010","0073","0090","725","383","342","46","771","1361","0","56.65","28.14"
"10","013","00","010","0073","0091","616","296","320","32","648","1189","0","54.50","24.89"
"10","013","00","010","0073","0092","705","312","393","29","734","1232","0","59.58","25.32"
"10","013","00","010","0073","0093","738","351","387","25","763","1355","0","56.31","25.90"
"10","013","00","010","0073","0094","699","311","388","22","721","1250","0","57.68","24.88"
"10","013","00","010","0073","0095","638","277","361","15","653","1283","0","50.90","21.59"
"10","013","00","010","0074","0000","2288","1178","1110","105","2393","3764","0","63.58","31.30"
"10","013","00","010","0074","0102","592","250","342","38","630","1120","0","56.25","22.32"
"10","013","00","010","0074","0103","719","270","449","34","753","1340","0","56.19","20.15"
"10","013","00","010","0074","0104","977","658","319","33","1010","1304","0","77.45","50.46"
"10","013","00","010","0075","0000","2558","1187","1371","123","2681","5119","0","52.37","23.19"
"10","013","00","010","0075","0096","603","307","296","26","629","1245","0","50.52","24.66"
"10","013","00","010","0075","0097","722","326","396","24","746","1415","0","52.72","23.04"
"10","013","00","010","0075","0098","699","312","387","34","733","1331","0","55.07","23.44"
"10","013","00","010","0075","0099","534","242","292","39","573","1128","0","50.80","21.45"
"10","013","00","010","0076","0000","708","430","278","33","741","1294","0","57.26","33.23"
"10","013","00","010","0076","0133","708","430","278","33","741","1294","0","57.26","33.23"
"10","013","00","010","0077","0000","565","370","195","32","597","829","0","72.01","44.63"
"10","013","00","010","0077","0134","565","370","195","32","597","829","0","72.01","44.63"
"10","013","00","010","0078","0000","554","321","233","39","593","1057","0","56.10","30.37"
"10","013","00","010","0078","0135","554","321","233","39","593","1057","0","56.10","30.37"
"10","013","00","010","0079","0000","621","388","233","51","672","963","0","69.78","40.29"
"10","013","00","010","0079","0137","621","388","233","51","672","963","0","69.78","40.29"
"10","013","00","010","0080","0000","1032","620","412","50","1082","1514","0","71.47","40.95"
"10","013","00","010","0080","0136","1032","620","412","50","1082","1514","0","71.47","40.95"
"10","013","00","010","0081","0000","1979","852","1127","104","2083","3880","0","53.69","21.96"
"10","013","00","010","0081","0048","664","215","449","31","695","1351","0","51.44","15.91"
"10","013","00","010","0081","0049","724","303","421","31","755","1293","0","58.39","23.43"
"10","013","00","010","0081","0050","591","334","257","42","633","1236","0","51.21","27.02"
"10","013","00","010","0082","0000","2623","1327","1296","75","2698","4689","0","57.54","28.30"
"10","013","00","010","0082","0017","658","335","323","22","680","1150","0","59.13","29.13"
"10","013","00","010","0082","0018","707","392","315","15","722","1263","0","57.17","31.04"
"10","013","00","010","0082","0019","639","306","333","21","660","1111","0","59.41","27.54"
"10","013","00","010","0082","0020","619","294","325","17","636","1165","0","54.59","25.24"
"10","013","00","010","0083","0000","3672","1566","2106","107","3779","6873","0","54.98","22.78"
"10","013","00","010","0083","0085","756","290","466","28","784","1307","0","59.98","22.19"
"10","013","00","010","0083","0086","749","300","449","19","768","1479","0","51.93","20.28"
"10","013","00","010","0083","0087","802","362","440","21","823","1483","0","55.50","24.41"
"10","013","00","010","0083","0088","647","304","343","19","666","1297","0","51.35","23.44"
"10","013","00","010","0083","0089","718","310","408","20","738","1307","0","56.47","23.72"
"10","013","00","010","0084","0000","1058","563","495","45","1103","1886","0","58.48","29.85"
"10","013","00","010","0084","0119","536","283","253","25","561","934","0","60.06","30.30"
"10","013","00","010","0084","0120","522","280","242","20","542","952","0","56.93","29.41"
"10","013","00","020","0000","0000","25103","14336","10767","1529","26632","45288","53117","58.81","31.66"
"10","013","00","020","0001","0000","314","154","160","9","323","467","0","69.16","32.98"
"10","013","00","020","0001","0138","314","154","160","9","323","467","0","69.16","32.98"
"10","013","00","020","0002","0000","362","227","135","15","377","554","0","68.05","40.97"
"10","013","00","020","0002","0144","362","227","135","15","377","554","0","68.05","40.97"
"10","013","00","020","0003","0000","685","389","296","46","731","1191","0","61.38","32.66"
"10","013","00","020","0003","0162","685","389","296","46","731","1191","0","61.38","32.66"
"10","013","00","020","0004","0000","538","333","205","26","564","922","0","61.17","36.12"
"10","013","00","020","0004","0161","538","333","205","26","564","922","0","61.17","36.12"
"10","013","00","020","0005","0000","2392","1318","1074","96","2488","4590","0","54.20","28.71"
"10","013","00","020","0005","0139","468","291","177","16","484","870","0","55.63","33.45"
"10","013","00","020","0005","0140","465","278","187","15","480","900","0","53.33","30.89"
"10","013","00","020","0005","0141","525","292","233","20","545","937","0","58.16","31.16"
"10","013","00","020","0005","0142","457","229","228","22","479","875","0","54.74","26.17"
"10","013","00","020","0005","0143","477","228","249","23","500","1008","0","49.60","22.62"
"10","013","00","020","0006","0000","532","363","169","27","559","848","0","65.92","42.81"
"10","013","00","020","0006","0145","532","363","169","27","559","848","0","65.92","42.81"
"10","013","00","020","0007","0000","2850","1446","1404","152","3002","5292","0","56.73","27.32"
"10","013","00","020","0007","0146","665","349","316","39","704","1235","0","57.00","28.26"
"10","013","00","020","0007","0147","409","223","186","32","441","789","0","55.89","28.26"
"10","013","00","020","0007","0148","494","260","234","26","520","923","0","56.34","28.17"
"10","013","00","020","0007","0149","706","309","397","28","734","1201","0","61.12","25.73"
"10","013","00","020","0007","0150","576","305","271","27","603","1144","0","52.71","26.66"
"10","013","00","020","0008","0000","3418","1864","1554","143","3561","6238","0","57.09","29.88"
"10","013","00","020","0008","0151","610","330","280","35","645","1076","0","59.94","30.67"
"10","013","00","020","0008","0152","521","278","243","16","537","973","0","55.19","28.57"
"10","013","00","020","0008","0153","578","332","246","18","596","1133","0","52.60","29.30"
"10","013","00","020","0008","0154","585","327","258","39","624","1047","0","59.60","31.23"
"10","013","00","020","0008","0155","606","335","271","25","631","1098","0","57.47","30.51"
"10","013","00","020","0008","0156","518","262","256","10","528","911","0","57.96","28.76"
"10","013","00","020","0009","0000","1085","558","527","74","1159","1996","0","58.07","27.96"
"10","013","00","020","0009","0157","447","232","215","38","485","810","0","59.88","28.64"
"10","013","00","020","0009","0158","638","326","312","36","674","1186","0","56.83","27.49"
"10","013","00","020","0010","0000","837","465","372","57","894","1374","0","65.07","33.84"
"10","013","00","020","0010","0163","837","465","372","57","894","1374","0","65.07","33.84"
"10","013","00","020","0011","0000","1205","723","482","65","1270","2318","0","54.79","31.19"
"10","013","00","020","0011","0164","706","400","306","44","750","1251","0","59.95","31.97"
"10","013","00","020","0011","0165","499","323","176","21","520","1067","0","48.73","30.27"
"10","013","00","020","0012","0000","1355","789","566","109","1464","2401","0","60.97","32.86"
"10","013","00","020","0012","0166","767","449","318","69","836","1371","0","60.98","32.75"
"10","013","00","020","0012","0167","588","340","248","40","628","1030","0","60.97","33.01"
"10","013","00","020","0013","0000","3766","2145","1621","174","3940","6965","0","56.57","30.80"
"10","013","00","020","0013","0168","577","349","228","34","611","1036","0","58.98","33.69"
"10","013","00","020","0013","0169","666","377","289","41","707","1206","0","58.62","31.26"
"10","013","00","020","0013","0170","589","336","253","24","613","1100","0","55.73","30.55"
"10","013","00","020","0013","0171","621","364","257","23","644","1154","0","55.81","31.54"
"10","013","00","020","0013","0172","689","371","318","25","714","1316","0","54.26","28.19"
"10","013","00","020","0013","0173","624","348","276","27","651","1153","0","56.46","30.18"
"10","013","00","020","0014","0000","448","258","190","24","472","1126","0","41.92","22.91"
"10","013","00","020","0014","0174","448","258","190","24","472","1126","0","41.92","22.91"
"10","013","00","020","0015","0000","787","450","337","71","858","1402","0","61.20","32.10"
"10","013","00","020","0015","0175","787","450","337","71","858","1402","0","61.20","32.10"
"10","013","00","020","0016","0000","506","303","203","46","552","879","0","62.80","34.47"
"10","013","00","020","0016","0176","506","303","203","46","552","879","0","62.80","34.47"
"10","013","00","020","0017","0000","273","163","110","36","309","440","0","70.23","37.05"
"10","013","00","020","0017","0177","273","163","110","36","309","440","0","70.23","37.05"
"10","013","00","020","0018","0000","882","581","301","114","996","1604","0","62.09","36.22"
"10","013","00","020","0018","0159","610","392","218","105","715","1139","0","62.77","34.42"
"10","013","00","020","0018","0160","272","189","83","9","281","465","0","60.43","40.65"
"10","013","00","020","0019","0000","969","569","400","53","1022","1541","0","66.32","36.92"
"10","013","00","020","0019","0178","519","296","223","22","541","856","0","63.20","34.58"
"10","013","00","020","0019","0179","450","273","177","31","481","685","0","70.22","39.85"
"10","013","00","020","0020","0000","999","664","335","87","1086","1651","0","65.78","40.22"
"10","013","00","020","0020","0180","523","352","171","30","553","877","0","63.06","40.14"
"10","013","00","020","0020","0181","476","312","164","57","533","774","0","68.86","40.31"
"10","013","00","020","0021","0000","900","574","326","105","1005","1489","0","67.49","38.55"
"10","013","00","020","0021","0182","662","411","251","85","747","1149","0","65.01","35.77"
"10","013","00","020","0021","0183","238","163","75","20","258","340","0","75.88","47.94"
"10","013","00","030","0000","0000","22761","13845","8916","1911","24672","37860","45915","65.17","36.57"
"10","013","00","030","0001","0000","1155","713","442","59","1214","1908","0","63.63","37.37"
"10","013","00","030","0001","0184","571","348","223","36","607","921","0","65.91","37.79"
"10","013","00","030","0001","0185","584","365","219","23","607","987","0","61.50","36.98"
"10","013","00","030","0003","0000","891","531","360","71","962","1398","0","68.81","37.98"
"10","013","00","030","0003","0186","443","256","187","20","463","671","0","69.00","38.15"
"10","013","00","030","0003","0187","448","275","173","51","499","727","0","68.64","37.83"
"10","013","00","030","0007","0000","880","560","320","68","948","1510","0","62.78","37.09"
"10","013","00","030","0007","0200","436","290","146","32","468","748","0","62.57","38.77"
"10","013","00","030","0007","0201","444","270","174","36","480","762","0","62.99","35.43"
"10","013","00","030","0009","0000","693","372","321","74","767","1125","0","68.18","33.07"
"10","013","00","030","0009","0202","693","372","321","74","767","1125","0","68.18","33.07"
"10","013","00","030","0010","0000","784","500","284","98","882","1255","0","70.28","39.84"
"10","013","00","030","0010","0203","784","500","284","98","882","1255","0","70.28","39.84"
"10","013","00","030","0011","0000","1157","733","424","152","1309","1884","0","69.48","38.91"
"10","013","00","030","0011","0204","567","377","190","70","637","902","0","70.62","41.80"
"10","013","00","030","0011","0205","590","356","234","82","672","982","0","68.43","36.25"
"10","013","00","030","0012","0000","843","541","302","101","944","1421","0","66.43","38.07"
"10","013","00","030","0012","0206","440","286","154","45","485","753","0","64.41","37.98"
"10","013","00","030","0012","0207","403","255","148","56","459","668","0","68.71","38.17"
"10","013","00","030","0013","0000","1204","771","433","109","1313","2007","0","65.42","38.42"
"10","013","00","030","0013","0208","544","349","195","52","596","905","0","65.86","38.56"
"10","013","00","030","0013","0209","660","422","238","57","717","1102","0","65.06","38.29"
"10","013","00","030","0014","0000","896","576","320","113","1009","1358","0","74.30","42.42"
"10","013","00","030","0014","0210","427","288","139","39","466","651","0","71.58","44.24"
"10","013","00","030","0014","0211","469","288","181","74","543","707","0","76.80","40.74"
"10","013","00","030","0015","0000","845","514","331","124","969","1503","0","64.47","34.20"
"10","013","00","030","0015","0212","498","298","200","98","596","752","0","79.26","39.63"
"10","013","00","030","0015","0213","347","216","131","26","373","751","0","49.67","28.76"
"10","013","00","030","0016","0000","1304","816","488","85","1389","2260","0","61.46","36.11"
"10","013","00","030","0016","0217","632","376","256","28","660","1101","0","59.95","34.15"
"10","013","00","030","0016","0218","672","440","232","57","729","1159","0","62.90","37.96"
"10","013","00","030","0017","0000","1120","785","335","113","1233","1842","0","66.94","42.62"
"10","013","00","030","0017","0219","556","400","156","36","592","923","0","64.14","43.34"
"10","013","00","030","0017","0220","564","385","179","77","641","919","0","69.75","41.89"
"10","013","00","030","0018","0000","823","526","297","137","960","1460","0","65.75","36.03"
"10","013","00","030","0018","0221","440","277","163","74","514","779","0","65.98","35.56"
"10","013","00","030","0018","0222","383","249","134","63","446","681","0","65.49","36.56"
"10","013","00","030","0020","0000","853","522","331","61","914","1302","0","70.20","40.09"
"10","013","00","030","0020","0197","853","522","331","61","914","1302","0","70.20","40.09"
"10","013","00","030","0021","0000","650","430","220","78","728","1032","0","70.54","41.67"
"10","013","00","030","0021","0223","650","430","220","78","728","1032","0","70.54","41.67"
"10","013","00","030","0022","0000","403","177","226","23","426","702","0","60.68","25.21"
"10","013","00","030","0022","0224","403","177","226","23","426","702","0","60.68","25.21"
"10","013","00","030","0023","0000","1125","670","455","79","1204","1778","0","67.72","37.68"
"10","013","00","030","0023","0198","554","344","210","44","598","891","0","67.12","38.61"
"10","013","00","030","0023","0199","571","326","245","35","606","887","0","68.32","36.75"
"10","013","00","030","0024","0000","1715","1014","701","97","1812","2811","0","64.46","36.07"
"10","013","00","030","0024","0214","631","391","240","43","674","963","0","69.99","40.60"
"10","013","00","030","0024","0215","499","287","212","28","527","895","0","58.88","32.07"
"10","013","00","030","0024","0216","585","336","249","26","611","953","0","64.11","35.26"
"10","013","00","030","0025","0000","1225","709","516","67","1292","2170","0","59.54","32.67"
"10","013","00","030","0025","0188","641","373","268","35","676","1146","0","58.99","32.55"
"10","013","00","030","0025","0189","584","336","248","32","616","1024","0","60.16","32.81"
"10","013","00","030","0026","0000","1139","616","523","30","1169","1992","0","58.68","30.92"
"10","013","00","030","0026","0190","578","308","270","18","596","997","0","59.78","30.89"
"10","013","00","030","0026","0191","561","308","253","12","573","995","0","57.59","30.95"
"10","013","00","030","0027","0000","2118","1234","884","128","2246","3546","0","63.34","34.80"
"10","013","00","030","0027","0192","643","361","282","37","680","1116","0","60.93","32.35"
"10","013","00","030","0027","0193","783","479","304","26","809","1236","0","65.45","38.75"
"10","013","00","030","0027","0194","692","394","298","65","757","1194","0","63.40","33.00"
"10","013","00","030","0028","0000","938","535","403","44","982","1596","0","61.53","33.52"
"10","013","00","030","0028","0195","485","259","226","15","500","843","0","59.31","30.72"
"10","013","00","030","0028","0196","453","276","177","29","482","753","0","64.01","36.65"
"10","013","00","040","0000","0000","12967","7129","5838","1333","14300","24702","29890","57.89","28.86"
"10","013","00","040","0001","0000","426","216","210","34","460","860","0","53.49","25.12"
"10","013","00","040","0001","0225","426","216","210","34","460","860","0","53.49","25.12"
"10","013","00","040","0002","0000","1139","567","572","98","1237","2115","0","58.49","26.81"
"10","013","00","040","0002","0226","366","187","179","22","388","686","0","56.56","27.26"
"10","013","00","040","0002","0227","380","189","191","40","420","713","0","58.91","26.51"
"10","013","00","040","0002","0228","393","191","202","36","429","716","0","59.92","26.68"
"10","013","00","040","0003","0000","478","231","247","21","499","1073","0","46.51","21.53"
"10","013","00","040","0003","0229","478","231","247","21","499","1073","0","46.51","21.53"
"10","013","00","040","0004","0000","2029","1042","987","144","2173","4048","0","53.68","25.74"
"10","013","00","040","0004","0245","566","317","249","21","587","1131","0","51.90","28.03"
"10","013","00","040","0004","0246","493","232","261","41","534","926","0","57.67","25.05"
"10","013","00","040","0004","0247","520","267","253","42","562","1007","0","55.81","26.51"
"10","013","00","040","0004","0248","450","226","224","40","490","984","0","49.80","22.97"
"10","013","00","040","0005","0000","1476","811","665","97","1573","3050","0","51.57","26.59"
"10","013","00","040","0005","0230","486","278","208","21","507","1081","0","46.90","25.72"
"10","013","00","040","0005","0231","492","251","241","32","524","962","0","54.47","26.09"
"10","013","00","040","0005","0232","498","282","216","44","542","1007","0","53.82","28.00"
"10","013","00","040","0006","0000","465","267","198","58","523","842","0","62.11","31.71"
"10","013","00","040","0006","0233","465","267","198","58","523","842","0","62.11","31.71"
"10","013","00","040","0007","0000","261","162","99","34","295","477","0","61.84","33.96"
"10","013","00","040","0007","0234","261","162","99","34","295","477","0","61.84","33.96"
"10","013","00","040","0008","0000","327","194","133","47","374","465","0","80.43","41.72"
"10","013","00","040","0008","0235","327","194","133","47","374","465","0","80.43","41.72"
"10","013","00","040","0009","0000","564","298","266","55","619","984","0","62.91","30.28"
"10","013","00","040","0009","0236","564","298","266","55","619","984","0","62.91","30.28"
"10","013","00","040","0010","0000","555","285","270","48","603","927","0","65.05","30.74"
"10","013","00","040","0010","0237","555","285","270","48","603","927","0","65.05","30.74"
"10","013","00","040","0011","0000","631","338","293","84","715","1031","0","69.35","32.78"
"10","013","00","040","0011","0238","631","338","293","84","715","1031","0","69.35","32.78"
"10","013","00","040","0012","0000","871","538","333","144","1015","1511","0","67.17","35.61"
"10","013","00","040","0012","0239","439","297","142","59","498","732","0","68.03","40.57"
"10","013","00","040","0012","0240","432","241","191","85","517","779","0","66.37","30.94"
"10","013","00","040","0013","0000","1082","599","483","98","1180","2136","0","55.24","28.04"
"10","013","00","040","0013","0241","629","370","259","68","697","1070","0","65.14","34.58"
"10","013","00","040","0013","0242","453","229","224","30","483","1066","0","45.31","21.48"
"10","013","00","040","0014","0000","722","463","259","158","880","1351","0","65.14","34.27"
"10","013","00","040","0014","0243","356","215","141","80","436","655","0","66.56","32.82"
"10","013","00","040","0014","0244","366","248","118","78","444","696","0","63.79","35.63"
"10","013","00","040","0015","0000","711","412","299","52","763","1625","0","46.95","25.35"
"10","013","00","040","0015","0249","286","159","127","14","300","780","0","38.46","20.38"
"10","013","00","040","0015","0250","425","253","172","38","463","845","0","54.79","29.94"
"10","013","00","040","0016","0000","705","409","296","52","757","1164","0","65.03","35.14"
"10","013","00","040","0016","0251","320","185","135","15","335","575","0","58.26","32.17"
"10","013","00","040","0016","0252","385","224","161","37","422","589","0","71.65","38.03"
"10","013","00","040","0017","0000","525","297","228","109","634","1043","0","60.79","28.48"
"10","013","00","040","0017","0253","525","297","228","109","634","1043","0","60.79","28.48"
"10","013","00","050","0000","0000","25637","15676","9961","2720","28357","42017","49483","67.49","37.31"
"10","013","00","050","0001","0000","337","193","144","28","365","550","0","66.36","35.09"
"10","013","00","050","0001","0268","337","193","144","28","365","550","0","66.36","35.09"
"10","013","00","050","0002","0000","551","315","236","52","603","808","0","74.63","38.99"
"10","013","00","050","0002","0263","551","315","236","52","603","808","0","74.63","38.99"
"10","013","00","050","0003","0000","1886","1082","804","134","2020","3224","0","62.66","33.56"
"10","013","00","050","0003","0264","612","335","277","36","648","1099","0","58.96","30.48"
"10","013","00","050","0003","0265","645","359","286","52","697","1052","0","66.25","34.13"
"10","013","00","050","0003","0266","629","388","241","46","675","1073","0","62.91","36.16"
"10","013","00","050","0004","0000","450","264","186","25","475","697","0","68.15","37.88"
"10","013","00","050","0004","0267","450","264","186","25","475","697","0","68.15","37.88"
"10","013","00","050","0005","0000","817","467","350","91","908","1394","0","65.14","33.50"
"10","013","00","050","0005","0269","817","467","350","91","908","1394","0","65.14","33.50"
"10","013","00","050","0006","0000","1355","726","629","158","1513","2202","0","68.71","32.97"
"10","013","00","050","0006","0270","618","318","300","72","690","1038","0","66.47","30.64"
"10","013","00","050","0006","0271","737","408","329","86","823","1164","0","70.70","35.05"
"10","013","00","050","0007","0000","1243","741","502","147","1390","1997","0","69.60","37.11"
"10","013","00","050","0007","0272","581","345","236","67","648","942","0","68.79","36.62"
"10","013","00","050","0007","0273","662","396","266","80","742","1055","0","70.33","37.54"
"10","013","00","050","0008","0000","960","556","404","113","1073","1589","0","67.53","34.99"
"10","013","00","050","0008","0274","488","277","211","64","552","821","0","67.24","33.74"
"10","013","00","050","0008","0275","472","279","193","49","521","768","0","67.84","36.33"
"10","013","00","050","0009","0000","1290","806","484","67","1357","2222","0","61.07","36.27"
"10","013","00","050","0009","0296","594","368","226","29","623","1008","0","61.81","36.51"
"10","013","00","050","0009","0297","696","438","258","38","734","1214","0","60.46","36.08"
"10","013","00","050","0010","0000","574","391","183","63","637","982","0","64.87","39.82"
"10","013","00","050","0010","0278","574","391","183","63","637","982","0","64.87","39.82"
"10","013","00","050","0011","0000","1053","680","373","137","1190","1766","0","67.38","38.51"
"10","013","00","050","0011","0279","586","385","201","72","658","927","0","70.98","41.53"
"10","013","00","050","0011","0280","467","295","172","65","532","839","0","63.41","35.16"
"10","013","00","050","0012","0000","1058","687","371","141","1199","1527","0","78.52","44.99"
"10","013","00","050","0012","0281","561","360","201","63","624","815","0","76.56","44.17"
"10","013","00","050","0012","0282","497","327","170","78","575","712","0","80.76","45.93"
"10","013","00","050","0013","0000","849","501","348","139","988","1340","0","73.73","37.39"
"10","013","00","050","0013","0283","849","501","348","139","988","1340","0","73.73","37.39"
"10","013","00","050","0014","0000","542","332","210","43","585","799","0","73.22","41.55"
"10","013","00","050","0014","0286","542","332","210","43","585","799","0","73.22","41.55"
"10","013","00","050","0015","0000","742","504","238","104","846","1203","0","70.32","41.90"
"10","013","00","050","0015","0287","742","504","238","104","846","1203","0","70.32","41.90"
"10","013","00","050","0016","0000","914","571","343","120","1034","1464","0","70.63","39.00"
"10","013","00","050","0016","0288","914","571","343","120","1034","1464","0","70.63","39.00"
"10","013","00","050","0017","0000","613","376","237","84","697","921","0","75.68","40.83"
"10","013","00","050","0017","0289","613","376","237","84","697","921","0","75.68","40.83"
"10","013","00","050","0018","0000","1111","711","400","104","1215","1947","0","62.40","36.52"
"10","013","00","050","0018","0290","501","322","179","47","548","812","0","67.49","39.66"
"10","013","00","050","0018","0291","610","389","221","57","667","1135","0","58.77","34.27"
"10","013","00","050","0019","0000","833","523","310","87","920","1591","0","57.83","32.87"
"10","013","00","050","0019","0294","511","331","180","46","557","919","0","60.61","36.02"
"10","013","00","050","0019","0295","322","192","130","41","363","672","0","54.02","28.57"
"10","013","00","050","0020","0000","934","608","326","68","1002","1645","0","60.91","36.96"
"10","013","00","050","0020","0292","410","275","135","19","429","804","0","53.36","34.20"
"10","013","00","050","0020","0293","524","333","191","49","573","841","0","68.13","39.60"
"10","013","00","050","0021","0000","1041","620","421","80","1121","1661","0","67.49","37.33"
"10","013","00","050","0021","0276","554","324","230","40","594","790","0","75.19","41.01"
"10","013","00","050","0021","0277","487","296","191","40","527","871","0","60.51","33.98"
"10","013","00","050","0022","0000","1292","789","503","151","1443","2045","0","70.56","38.58"
"10","013","00","050","0022","0255","723","447","276","77","800","1163","0","68.79","38.44"
"10","013","00","050","0022","0256","569","342","227","74","643","882","0","72.90","38.78"
"10","013","00","050","0023","0000","931","583","348","100","1031","1451","0","71.05","40.18"
"10","013","00","050","0023","0254","931","583","348","100","1031","1451","0","71.05","40.18"
"10","013","00","050","0024","0000","571","367","204","55","626","940","0","66.60","39.04"
"10","013","00","050","0024","0284","571","367","204","55","626","940","0","66.60","39.04"
"10","013","00","050","0025","0000","1183","670","513","110","1293","1994","0","64.84","33.60"
"10","013","00","050","0025","0257","622","331","291","71","693","1001","0","69.23","33.07"
"10","013","00","050","0025","0258","561","339","222","39","600","993","0","60.42","34.14"
"10","013","00","050","0026","0000","793","553","240","112","905","1289","0","70.21","42.90"
"10","013","00","050","0026","0285","793","553","240","112","905","1289","0","70.21","42.90"
"10","013","00","050","0027","0000","639","366","273","59","698","1108","0","63.00","33.03"
"10","013","00","050","0027","0260","639","366","273","59","698","1108","0","63.00","33.03"
"10","013","00","050","0028","0000","502","334","168","56","558","781","0","71.45","42.77"
"10","013","00","050","0028","0261","502","334","168","56","558","781","0","71.45","42.77"
"10","013","00","050","0029","0000","373","226","147","56","429","519","0","82.66","43.55"
"10","013","00","050","0029","0259","373","226","147","56","429","519","0","82.66","43.55"
"10","013","00","050","0030","0000","200","134","66","36","236","361","0","65.37","37.12"
"10","013","00","050","0030","0262","200","134","66","36","236","361","0","65.37","37.12"
"10","013","00","060","0000","0000","15348","8885","6463","1534","16882","25557","29172","66.06","34.77"
"10","013","00","060","0001","0000","1491","810","681","131","1622","2640","0","61.44","30.68"
"10","013","00","060","0001","0298","588","327","261","56","644","1009","0","63.83","32.41"
"10","013","00","060","0001","0299","903","483","420","75","978","1631","0","59.96","29.61"
"10","013","00","060","0002","0000","2039","1097","942","110","2149","3555","0","60.45","30.86"
"10","013","00","060","0002","0300","1045","565","480","65","1110","1813","0","61.22","31.16"
"10","013","00","060","0002","0301","994","532","462","45","1039","1742","0","59.64","30.54"
"10","013","00","060","0003","0000","1163","650","513","57","1220","1857","0","65.70","35.00"
"10","013","00","060","0003","0302","567","286","281","21","588","936","0","62.82","30.56"
"10","013","00","060","0003","0303","596","364","232","36","632","921","0","68.62","39.52"
"10","013","00","060","0004","0000","1452","808","644","75","1527","2585","0","59.07","31.26"
"10","013","00","060","0004","0304","438","248","190","30","468","705","0","66.38","35.18"
"10","013","00","060","0004","0305","1014","560","454","45","1059","1880","0","56.33","29.79"
"10","013","00","060","0005","0000","634","356","278","77","711","1045","0","68.04","34.07"
"10","013","00","060","0005","0306","634","356","278","77","711","1045","0","68.04","34.07"
"10","013","00","060","0006","0000","594","324","270","46","640","877","0","72.98","36.94"
"10","013","00","060","0006","0311","594","324","270","46","640","877","0","72.98","36.94"
"10","013","00","060","0007","0000","668","400","268","57","725","1001","0","72.43","39.96"
"10","013","00","060","0007","0312","668","400","268","57","725","1001","0","72.43","39.96"
"10","013","00","060","0008","0000","886","562","324","103","989","1429","0","69.21","39.33"
"10","013","00","060","0008","0310","886","562","324","103","989","1429","0","69.21","39.33"
"10","013","00","060","0009","0000","983","548","435","72","1055","1626","0","64.88","33.70"
"10","013","00","060","0009","0307","983","548","435","72","1055","1626","0","64.88","33.70"
"10","013","00","060","0010","0000","639","376","263","76","715","1113","0","64.24","33.78"
"10","013","00","060","0010","0308","639","376","263","76","715","1113","0","64.24","33.78"
"10","013","00","060","0011","0000","480","325","155","48","528","713","0","74.05","45.58"
"10","013","00","060","0011","0309","480","325","155","48","528","713","0","74.05","45.58"
"10","013","00","060","0012","0000","1299","855","444","179","1478","2281","0","64.80","37.48"
"10","013","00","060","0012","0317","695","458","237","118","813","1198","0","67.86","38.23"
"10","013","00","060","0012","0318","604","397","207","61","665","1083","0","61.40","36.66"
"10","013","00","060","0013","0000","1100","674","426","169","1269","1678","0","75.63","40.17"
"10","013","00","060","0013","0313","536","323","213","81","617","803","0","76.84","40.22"
"10","013","00","060","0013","0314","564","351","213","88","652","875","0","74.51","40.11"
"10","013","00","060","0014","0000","806","515","291","139","945","1355","0","69.74","38.01"
"10","013","00","060","0014","0315","806","515","291","139","945","1355","0","69.74","38.01"
"10","013","00","060","0015","0000","659","385","274","148","807","1096","0","73.63","35.13"
"10","013","00","060","0015","0316","659","385","274","148","807","1096","0","73.63","35.13"
"10","013","00","060","0016","0000","455","200","255","47","502","706","0","71.10","28.33"
"10","013","00","060","0016","0319","455","200","255","47","502","706","0","71.10","28.33"
"10","013","00","070","0000","0000","5900","3560","2340","328","6228","9494","10577","65.60","37.50"
"10","013","00","070","0001","0000","1288","763","525","75","1363","2061","0","66.13","37.02"
"10","013","00","070","0001","0320","469","297","172","37","506","724","0","69.89","41.02"
"10","013","00","070","0001","0321","819","466","353","38","857","1337","0","64.10","34.85"
"10","013","00","070","0002","0000","568","344","224","33","601","903","0","66.56","38.10"
"10","013","00","070","0002","0322","568","344","224","33","601","903","0","66.56","38.10"
"10","013","00","070","0003","0000","916","573","343","72","988","1405","0","70.32","40.78"
"10","013","00","070","0003","0323","418","247","171","31","449","648","0","69.29","38.12"
"10","013","00","070","0003","0324","498","326","172","41","539","757","0","71.20","43.06"
"10","013","00","070","0004","0000","1413","796","617","54","1467","2486","0","59.01","32.02"
"10","013","00","070","0004","0325","676","368","308","19","695","1213","0","57.30","30.34"
"10","013","00","070","0004","0326","737","428","309","35","772","1273","0","60.64","33.62"
"10","013","00","070","0005","0000","774","501","273","47","821","1164","0","70.53","43.04"
"10","013","00","070","0005","0327","774","501","273","47","821","1164","0","70.53","43.04"
"10","013","00","070","0006","0000","521","320","201","16","537","831","0","64.62","38.51"
"10","013","00","070","0006","0328","521","320","201","16","537","831","0","64.62","38.51"
"10","013","00","070","0007","0000","420","263","157","31","451","644","0","70.03","40.84"
"10","013","00","070","0007","0329","420","263","157","31","451","644","0","70.03","40.84"
"10","013","00","080","0000","0000","11398","7308","4090","825","12223","18652","21636","65.53","39.18"
"10","013","00","080","0001","0000","911","592","319","57","968","1378","0","70.25","42.96"
"10","013","00","080","0001","0330","911","592","319","57","968","1378","0","70.25","42.96"
"10","013","00","080","0002","0000","797","483","314","58","855","1349","0","63.38","35.80"
"10","013","00","080","0002","0331","797","483","314","58","855","1349","0","63.38","35.80"
"10","013","00","080","0003","0000","1080","717","363","104","1184","1611","0","73.49","44.51"
"10","013","00","080","0003","0332","1080","717","363","104","1184","1611","0","73.49","44.51"
"10","013","00","080","0004","0000","575","398","177","12","587","1199","0","48.96","33.19"
"10","013","00","080","0004","0334","575","398","177","12","587","1199","0","48.96","33.19"
"10","013","00","080","0005","0000","570","335","235","29","599","1112","0","53.87","30.13"
"10","013","00","080","0005","0333","570","335","235","29","599","1112","0","53.87","30.13"
"10","013","00","080","0006","0000","900","614","286","80","980","1494","0","65.60","41.10"
"10","013","00","080","0006","0342","900","614","286","80","980","1494","0","65.60","41.10"
"10","013","00","080","0007","0000","1084","701","383","70","1154","1704","0","67.72","41.14"
"10","013","00","080","0007","0344","1084","701","383","70","1154","1704","0","67.72","41.14"
"10","013","00","080","0008","0000","772","520","252","40","812","1231","0","65.96","42.24"
"10","013","00","080","0008","0343","772","520","252","40","812","1231","0","65.96","42.24"
"10","013","00","080","0009","0000","919","579","340","71","990","1483","0","66.76","39.04"
"10","013","00","080","0009","0345","919","579","340","71","990","1483","0","66.76","39.04"
"10","013","00","080","0010","0000","2766","1744","1022","228","2994","4558","0","65.69","38.26"
"10","013","00","080","0010","0337","423","281","142","46","469","632","0","74.21","44.46"
"10","013","00","080","0010","0338","651","420","231","49","700","1052","0","66.54","39.92"
"10","013","00","080","0010","0339","566","332","234","54","620","1005","0","61.69","33.03"
"10","013","00","080","0010","0340","731","457","274","65","796","1161","0","68.56","39.36"
"10","013","00","080","0010","0341","395","254","141","14","409","708","0","57.77","35.88"
"10","013","00","080","0011","0000","1024","625","399","76","1100","1533","0","71.75","40.77"
"10","013","00","080","0011","0335","652","405","247","55","707","971","0","72.81","41.71"
"10","013","00","080","0011","0336","372","220","152","21","393","562","0","69.93","39.15"
"10","013","00","090","0000","0000","13221","8208","5013","1287","14508","21500","25643","67.48","38.18"
"10","013","00","090","0001","0000","1874","1170","704","137","2011","3188","0","63.08","36.70"
"10","013","00","090","0001","0346","991","622","369","66","1057","1643","0","64.33","37.86"
"10","013","00","090","0001","0347","883","548","335","71","954","1545","0","61.75","35.47"
"10","013","00","090","0002","0000","636","355","281","51","687","1056","0","65.06","33.62"
"10","013","00","090","0002","0350","636","355","281","51","687","1056","0","65.06","33.62"
"10","013","00","090","0003","0000","545","314","231","55","600","822","0","72.99","38.20"
"10","013","00","090","0003","0351","545","314","231","55","600","822","0","72.99","38.20"
"10","013","00","090","0004","0000","809","481","328","57","866","1308","0","66.21","36.77"
"10","013","00","090","0004","0352","809","481","328","57","866","1308","0","66.21","36.77"
"10","013","00","090","0005","0000","1181","765","416","136","1317","1971","0","66.82","38.81"
"10","013","00","090","0005","0353","562","366","196","64","626","922","0","67.90","39.70"
"10","013","00","090","0005","0354","619","399","220","72","691","1049","0","65.87","38.04"
"10","013","00","090","0006","0000","738","498","240","29","767","1413","0","54.28","35.24"
"10","013","00","090","0006","0355","738","498","240","29","767","1413","0","54.28","35.24"
"10","013","00","090","0007","0000","1042","661","381","93","1135","1468","0","77.32","45.03"
"10","013","00","090","0007","0348","1042","661","381","93","1135","1468","0","77.32","45.03"
"10","013","00","090","0008","0000","935","580","355","105","1040","1491","0","69.75","38.90"
"10","013","00","090","0008","0349","935","580","355","105","1040","1491","0","69.75","38.90"
"10","013","00","090","0009","0000","914","634","280","137","1051","1456","0","72.18","43.54"
"10","013","00","090","0009","0356","164","111","53","35","199","288","0","69.10","38.54"
"10","013","00","090","0009","0357","750","523","227","102","852","1168","0","72.95","44.78"
"10","013","00","090","0010","0000","1408","971","437","166","1574","2213","0","71.13","43.88"
"10","013","00","090","0010","0358","606","409","197","79","685","930","0","73.66","43.98"
"10","013","00","090","0010","0359","802","562","240","87","889","1283","0","69.29","43.80"
"10","013","00","090","0011","0000","1226","638","588","113","1339","1946","0","68.81","32.79"
"10","013","00","090","0011","0360","935","550","385","104","1039","1461","0","71.12","37.65"
"10","013","00","090","0011","0361","291","88","203","9","300","485","0","61.86","18.14"
"10","013","00","090","0012","0000","1087","625","462","122","1209","1755","0","68.89","35.61"
"10","013","00","090","0012","0362","502","288","214","62","564","785","0","71.85","36.69"
"10","013","00","090","0012","0363","585","337","248","60","645","970","0","66.49","34.74"
"10","013","00","090","0013","0000","514","312","202","64","578","915","0","63.17","34.10"
"10","013","00","090","0013","0364","514","312","202","64","578","915","0","63.17","34.10"
"10","013","00","090","0014","0000","312","204","108","22","334","498","0","67.07","40.96"
"10","013","00","090","0014","0365","312","204","108","22","334","498","0","67.07","40.96"
"10","013","00","100","0000","0000","12995","7610","5385","1833","14828","21132","24332","70.17","36.01"
"10","013","00","100","0001","0000","1921","1152","769","236","2157","2972","0","72.58","38.76"
"10","013","00","100","0001","0379","597","344","253","62","659","939","0","70.18","36.63"
"10","013","00","100","0001","0380","712","426","286","93","805","1066","0","75.52","39.96"
"10","013","00","100","0001","0381","612","382","230","81","693","967","0","71.66","39.50"
"10","013","00","100","0002","0000","1512","922","590","210","1722","2657","0","64.81","34.70"
"10","013","00","100","0002","0373","387","220","167","15","402","894","0","44.97","24.61"
"10","013","00","100","0002","0374","651","409","242","131","782","988","0","79.15","41.40"
"10","013","00","100","0002","0375","474","293","181","64","538","775","0","69.42","37.81"
"10","013","00","100","0003","0000","1033","565","468","146","1179","1715","0","68.75","32.94"
"10","013","00","100","0003","0366","559","298","261","84","643","866","0","74.25","34.41"
"10","013","00","100","0003","0367","474","267","207","62","536","849","0","63.13","31.45"
"10","013","00","100","0004","0000","1337","731","606","226","1563","2220","0","70.41","32.93"
"10","013","00","100","0004","0368","610","319","291","117","727","1022","0","71.14","31.21"
"10","013","00","100","0004","0369","727","412","315","109","836","1198","0","69.78","34.39"
"10","013","00","100","0005","0000","1010","583","427","124","1134","1669","0","67.94","34.93"
"10","013","00","100","0005","0370","442","266","176","72","514","719","0","71.49","37.00"
"10","013","00","100","0005","0371","568","317","251","52","620","950","0","65.26","33.37"
"10","013","00","100","0006","0000","520","273","247","30","550","979","0","56.18","27.89"
"10","013","00","100","0006","0372","520","273","247","30","550","979","0","56.18","27.89"
"10","013","00","100","0007","0000","1012","656","356","171","1183","1715","0","68.98","38.25"
"10","013","00","100","0007","0376","499","330","169","109","608","812","0","74.88","40.64"
"10","013","00","100","0007","0377","513","326","187","62","575","903","0","63.68","36.10"
"10","013","00","100","0008","0000","375","234","141","65","440","542","0","81.18","43.17"
"10","013","00","100","0008","0388","375","234","141","65","440","542","0","81.18","43.17"
"10","013","00","100","0009","0000","598","365","233","125","723","872","0","82.91","41.86"
"10","013","00","100","0009","0378","598","365","233","125","723","872","0","82.91","41.86"
"10","013","00","100","0010","0000","1000","603","397","134","1134","1536","0","73.83","39.26"
"10","013","00","100","0010","0386","453","277","176","66","519","687","0","75.55","40.32"
"10","013","00","100","0010","0387","547","326","221","68","615","849","0","72.44","38.40"
"10","013","00","100","0011","0000","2074","1176","898","258","2332","3317","0","70.30","35.45"
"10","013","00","100","0011","0382","613","336","277","80","693","977","0","70.93","34.39"
"10","013","00","100","0011","0383","759","425","334","99","858","1190","0","72.10","35.71"
"10","013","00","100","0011","0384","702","415","287","79","781","1150","0","67.91","36.09"
"10","013","00","100","0012","0000","603","350","253","108","711","938","0","75.80","37.31"
"10","013","00","100","0012","0385","603","350","253","108","711","938","0","75.80","37.31"
"10","013","00","110","0000","0000","12593","8367","4226","1849","14442","20485","23253","70.50","40.84"
"10","013","00","110","0001","0000","1264","856","408","117","1381","2036","0","67.83","42.04"
"10","013","00","110","0001","0389","521","352","169","36","557","868","0","64.17","40.55"
"10","013","00","110","0001","0390","743","504","239","81","824","1168","0","70.55","43.15"
"10","013","00","110","0002","0000","704","449","255","81","785","1197","0","65.58","37.51"
"10","013","00","110","0002","0391","704","449","255","81","785","1197","0","65.58","37.51"
"10","013","00","110","0003","0000","450","310","140","66","516","697","0","74.03","44.48"
"10","013","00","110","0003","0392","450","310","140","66","516","697","0","74.03","44.48"
"10","013","00","110","0004","0000","325","235","90","55","380","545","0","69.72","43.12"
"10","013","00","110","0004","0393","325","235","90","55","380","545","0","69.72","43.12"
"10","013","00","110","0005","0000","584","377","207","98","682","936","0","72.86","40.28"
"10","013","00","110","0005","0394","584","377","207","98","682","936","0","72.86","40.28"
"10","013","00","110","0006","0000","734","509","225","96","830","1110","0","74.77","45.86"
"10","013","00","110","0006","0395","734","509","225","96","830","1110","0","74.77","45.86"
"10","013","00","110","0007","0000","363","227","136","55","418","573","0","72.95","39.62"
"10","013","00","110","0007","0396","363","227","136","55","418","573","0","72.95","39.62"
"10","013","00","110","0008","0000","466","349","117","92","558","729","0","76.54","47.87"
"10","013","00","110","0008","0397","466","349","117","92","558","729","0","76.54","47.87"
"10","013","00","110","0009","0000","314","206","108","73","387","601","0","64.39","34.28"
"10","013","00","110","0009","0398","314","206","108","73","387","601","0","64.39","34.28"
"10","013","00","110","0010","0000","648","419","229","104","752","1128","0","66.67","37.15"
"10","013","00","110","0010","0399","648","419","229","104","752","1128","0","66.67","37.15"
"10","013","00","110","0011","0000","843","540","303","98","941","1380","0","68.19","39.13"
"10","013","00","110","0011","0400","411","278","133","60","471","703","0","67.00","39.54"
"10","013","00","110","0011","0401","432","262","170","38","470","677","0","69.42","38.70"
"10","013","00","110","0012","0000","1029","689","340","158","1187","1760","0","67.44","39.15"
"10","013","00","110","0012","0402","478","333","145","60","538","860","0","62.56","38.72"
"10","013","00","110","0012","0403","551","356","195","98","649","900","0","72.11","39.56"
"10","013","00","110","0013","0000","738","519","219","158","896","1180","0","75.93","43.98"
"10","013","00","110","0013","0404","738","519","219","158","896","1180","0","75.93","43.98"
"10","013","00","110","0014","0000","641","399","242","79","720","1028","0","70.04","38.81"
"10","013","00","110","0014","0405","641","399","242","79","720","1028","0","70.04","38.81"
"10","013","00","110","0015","0000","713","477","236","86","799","1070","0","74.67","44.58"
"10","013","00","110","0015","0406","713","477","236","86","799","1070","0","74.67","44.58"
"10","013","00","110","0016","0000","587","372","215","100","687","970","0","70.82","38.35"
"10","013","00","110","0016","0407","587","372","215","100","687","970","0","70.82","38.35"
"10","013","00","110","0017","0000","639","416","223","94","733","1001","0","73.23","41.56"
"10","013","00","110","0017","0408","639","416","223","94","733","1001","0","73.23","41.56"
"10","013","00","110","0018","0000","709","469","240","102","811","1122","0","72.28","41.80"
"10","013","00","110","0018","0409","470","325","145","60","530","675","0","78.52","48.15"
"10","013","00","110","0018","0410","239","144","95","42","281","447","0","62.86","32.21"
"10","013","00","110","0019","0000","842","549","293","137","979","1422","0","68.85","38.61"
"10","013","00","110","0019","0411","376","233","143","56","432","648","0","66.67","35.96"
"10","013","00","110","0019","0412","466","316","150","81","547","774","0","70.67","40.83"
"10","013","00","120","0000","0000","9518","6074","3444","784","10302","16846","19522","61.15","36.06"
"10","013","00","120","0001","0000","733","449","284","61","794","1148","0","69.16","39.11"
"10","013","00","120","0001","0413","733","449","284","61","794","1148","0","69.16","39.11"
"10","013","00","120","0002","0000","411","262","149","34","445","688","0","64.68","38.08"
"10","013","00","120","0002","0414","411","262","149","34","445","688","0","64.68","38.08"
"10","013","00","120","0003","0000","1016","662","354","73","1089","1582","0","68.84","41.85"
"10","013","00","120","0003","0415","554","352","202","40","594","870","0","68.28","40.46"
"10","013","00","120","0003","0416","462","310","152","33","495","712","0","69.52","43.54"
"10","013","00","120","0004","0000","486","305","181","34","520","855","0","60.82","35.67"
"10","013","00","120","0004","0417","486","305","181","34","520","855","0","60.82","35.67"
"10","013","00","120","0005","0000","317","214","103","24","341","511","0","66.73","41.88"
"10","013","00","120","0005","0418","317","214","103","24","341","511","0","66.73","41.88"
"10","013","00","120","0006","0000","519","294","225","25","544","1044","0","52.11","28.16"
"10","013","00","120","0006","0419","519","294","225","25","544","1044","0","52.11","28.16"
"10","013","00","120","0007","0000","568","367","201","30","598","944","0","63.35","38.88"
"10","013","00","120","0007","0420","568","367","201","30","598","944","0","63.35","38.88"
"10","013","00","120","0008","0000","739","476","263","51","790","1360","0","58.09","35.00"
"10","013","00","120","0008","0421","739","476","263","51","790","1360","0","58.09","35.00"
"10","013","00","120","0009","0000","1009","661","348","84","1093","1907","0","57.32","34.66"
"10","013","00","120","0009","0424","525","340","185","34","559","949","0","58.90","35.83"
"10","013","00","120","0009","0425","484","321","163","50","534","958","0","55.74","33.51"
"10","013","00","120","0010","0000","769","507","262","81","850","1581","0","53.76","32.07"
"10","013","00","120","0010","0422","363","246","117","32","395","794","0","49.75","30.98"
"10","013","00","120","0010","0423","406","261","145","49","455","787","0","57.81","33.16"
"10","013","00","120","0011","0000","808","549","259","82","890","1609","0","55.31","34.12"
"10","013","00","120","0011","0426","443","290","153","61","504","786","0","64.12","36.90"
"10","013","00","120","0011","0427","365","259","106","21","386","823","0","46.90","31.47"
"10","013","00","120","0012","0000","728","454","274","75","803","1325","0","60.60","34.26"
"10","013","00","120","0012","0428","728","454","274","75","803","1325","0","60.60","34.26"
"10","013","00","120","0013","0000","707","453","254","71","778","1178","0","66.04","38.46"
"10","013","00","120","0013","0429","707","453","254","71","778","1178","0","66.04","38.46"
"10","013","00","120","0014","0000","708","421","287","59","767","1114","0","68.85","37.79"
"10","013","00","120","0014","0430","339","164","175","22","361","554","0","65.16","29.60"
"10","013","00","120","0014","0431","369","257","112","37","406","560","0","72.50","45.89"
"10","013","00","130","0000","0000","24459","14620","9839","1797","26256","45614","52229","57.56","32.05"
"10","013","00","130","0001","0000","1921","1065","856","88","2009","3918","0","51.28","27.18"
"10","013","00","130","0001","0432","625","368","257","27","652","1186","0","54.97","31.03"
"10","013","00","130","0001","0433","645","351","294","36","681","1281","0","53.16","27.40"
"10","013","00","130","0001","0434","651","346","305","25","676","1451","0","46.59","23.85"
"10","013","00","130","0002","0000","1741","932","809","81","1822","3122","0","58.36","29.85"
"10","013","00","130","0002","0435","786","455","331","47","833","1516","0","54.95","30.01"
"10","013","00","130","0002","0436","955","477","478","34","989","1606","0","61.58","29.70"
"10","013","00","130","0003","0000","700","419","281","72","772","1202","0","64.23","34.86"
"10","013","00","130","0003","0437","700","419","281","72","772","1202","0","64.23","34.86"
"10","013","00","130","0004","0000","312","206","106","23","335","527","0","63.57","39.09"
"10","013","00","130","0004","0438","312","206","106","23","335","527","0","63.57","39.09"
"10","013","00","130","0005","0000","1082","643","439","97","1179","2133","0","55.27","30.15"
"10","013","00","130","0005","0439","563","342","221","57","620","1124","0","55.16","30.43"
"10","013","00","130","0005","0440","519","301","218","40","559","1009","0","55.40","29.83"
"10","013","00","130","0006","0000","1478","803","675","70","1548","2861","0","54.11","28.07"
"10","013","00","130","0006","0441","737","426","311","33","770","1435","0","53.66","29.69"
"10","013","00","130","0006","0442","741","377","364","37","778","1426","0","54.56","26.44"
"10","013","00","130","0007","0000","2256","1319","937","118","2374","4173","0","56.89","31.61"
"10","013","00","130","0007","0443","764","465","299","51","815","1348","0","60.46","34.50"
"10","013","00","130","0007","0444","712","420","292","36","748","1376","0","54.36","30.52"
"10","013","00","130","0007","0445","780","434","346","31","811","1449","0","55.97","29.95"
"10","013","00","130","0008","0000","1707","1005","702","103","1810","3095","0","58.48","32.47"
"10","013","00","130","0008","0446","607","390","217","45","652","1093","0","59.65","35.68"
"10","013","00","130","0008","0447","581","311","270","35","616","996","0","61.85","31.22"
"10","013","00","130","0008","0448","519","304","215","23","542","1006","0","53.88","30.22"
"10","013","00","130","0009","0000","953","556","397","56","1009","1532","0","65.86","36.29"
"10","013","00","130","0009","0449","444","268","176","18","462","714","0","64.71","37.54"
"10","013","00","130","0009","0450","509","288","221","38","547","818","0","66.87","35.21"
"10","013","00","130","0010","0000","930","609","321","60","990","1793","0","55.21","33.97"
"10","013","00","130","0010","0451","456","302","154","33","489","908","0","53.85","33.26"
"10","013","00","130","0010","0452","474","307","167","27","501","885","0","56.61","34.69"
"10","013","00","130","0011","0000","1011","641","370","71","1082","1778","0","60.85","36.05"
"10","013","00","130","0011","0453","307","207","100","23","330","514","0","64.20","40.27"
"10","013","00","130","0011","0454","704","434","270","48","752","1264","0","59.49","34.34"
"10","013","00","130","0012","0000","1506","988","518","123","1629","2725","0","59.78","36.26"
"10","013","00","130","0012","0455","680","445","235","65","745","1221","0","61.02","36.45"
"10","013","00","130","0012","0456","826","543","283","58","884","1504","0","58.78","36.10"
"10","013","00","130","0013","0000","506","356","150","28","534","893","0","59.80","39.87"
"10","013","00","130","0013","0457","506","356","150","28","534","893","0","59.80","39.87"
"10","013","00","130","0014","0000","569","390","179","57","626","1031","0","60.72","37.83"
"10","013","00","130","0014","0458","569","390","179","57","626","1031","0","60.72","37.83"
"10","013","00","130","0015","0000","1051","710","341","105","1156","2185","0","52.91","32.49"
"10","013","00","130","0015","0459","516","364","152","57","573","1040","0","55.10","35.00"
"10","013","00","130","0015","0460","535","346","189","48","583","1145","0","50.92","30.22"
"10","013","00","130","0016","0000","813","547","266","60","873","1458","0","59.88","37.52"
"10","013","00","130","0016","0461","813","547","266","60","873","1458","0","59.88","37.52"
"10","013","00","130","0017","0000","1127","620","507","117","1244","2311","0","53.83","26.83"
"10","013","00","130","0017","0462","612","326","286","59","671","1157","0","57.99","28.18"
"10","013","00","130","0017","0463","515","294","221","58","573","1154","0","49.65","25.48"
"10","013","00","130","0018","0000","1054","531","523","91","1145","2236","0","51.21","23.75"
"10","013","00","130","0018","0464","638","316","322","55","693","1275","0","54.35","24.78"
"10","013","00","130","0018","0465","416","215","201","36","452","961","0","47.03","22.37"
"10","013","00","130","0019","0000","455","274","181","47","502","738","0","68.02","37.13"
"10","013","00","130","0019","0466","455","274","181","47","502","738","0","68.02","37.13"
"10","013","00","130","0020","0000","936","570","366","99","1035","1642","0","63.03","34.71"
"10","013","00","130","0020","0467","478","311","167","55","533","845","0","63.08","36.80"
"10","013","00","130","0020","0468","458","259","199","44","502","797","0","62.99","32.50"
"10","013","00","130","0021","0000","1242","764","478","118","1360","2303","0","59.05","33.17"
"10","013","00","130","0021","0469","614","382","232","43","657","1146","0","57.33","33.33"
"10","013","00","130","0021","0470","628","382","246","75","703","1157","0","60.76","33.02"
"10","013","00","130","0022","0000","715","441","274","69","784","1204","0","65.12","36.63"
"10","013","00","130","0022","0471","715","441","274","69","784","1204","0","65.12","36.63"
"10","013","00","130","0023","0000","394","231","163","44","438","754","0","58.09","30.64"
"10","013","00","130","0023","0472","394","231","163","44","438","754","0","58.09","30.64"
"10","013","00","140","0000","0000","9273","5845","3428","831","10104","14390","16111","70.22","40.62"
"10","013","00","140","0001","0000","905","546","359","77","982","1416","0","69.35","38.56"
"10","013","00","140","0001","0473","905","546","359","77","982","1416","0","69.35","38.56"
"10","013","00","140","0002","0000","591","368","223","50","641","833","0","76.95","44.18"
"10","013","00","140","0002","0474","591","368","223","50","641","833","0","76.95","44.18"
"10","013","00","140","0003","0000","449","293","156","51","500","667","0","74.96","43.93"
"10","013","00","140","0003","0475","449","293","156","51","500","667","0","74.96","43.93"
"10","013","00","140","0004","0000","387","261","126","29","416","548","0","75.91","47.63"
"10","013","00","140","0004","0476","387","261","126","29","416","548","0","75.91","47.63"
"10","013","00","140","0005","0000","814","497","317","92","906","1254","0","72.25","39.63"
"10","013","00","140","0005","0477","814","497","317","92","906","1254","0","72.25","39.63"
"10","013","00","140","0006","0000","627","419","208","59","686","918","0","74.73","45.64"
"10","013","00","140","0006","0478","627","419","208","59","686","918","0","74.73","45.64"
"10","013","00","140","0007","0000","429","267","162","39","468","605","0","77.36","44.13"
"10","013","00","140","0007","0479","429","267","162","39","468","605","0","77.36","44.13"
"10","013","00","140","0008","0000","298","190","108","23","321","444","0","72.30","42.79"
"10","013","00","140","0008","0480","298","190","108","23","321","444","0","72.30","42.79"
"10","013","00","140","0009","0000","1450","912","538","110","1560","2295","0","67.97","39.74"
"10","013","00","140","0009","0481","747","460","287","52","799","1172","0","68.17","39.25"
"10","013","00","140","0009","0482","703","452","251","58","761","1123","0","67.76","40.25"
"10","013","00","140","0010","0000","352","231","121","30","382","457","0","83.59","50.55"
"10","013","00","140","0010","0483","352","231","121","30","382","457","0","83.59","50.55"
"10","013","00","140","0011","0000","477","292","185","32","509","837","0","60.81","34.89"
"10","013","00","140","0011","0484","477","292","185","32","509","837","0","60.81","34.89"
"10","013","00","140","0012","0000","418","270","148","20","438","759","0","57.71","35.57"
"10","013","00","140","0012","0485","418","270","148","20","438","759","0","57.71","35.57"
"10","013","00","140","0013","0000","638","393","245","62","700","1052","0","66.54","37.36"
"10","013","00","140","0013","0486","638","393","245","62","700","1052","0","66.54","37.36"
"10","013","00","140","0014","0000","714","456","258","58","772","1158","0","66.67","39.38"
"10","013","00","140","0014","0487","714","456","258","58","772","1158","0","66.67","39.38"
"10","013","00","140","0015","0000","724","450","274","99","823","1147","0","71.75","39.23"
"10","013","00","140","0015","0488","724","450","274","99","823","1147","0","71.75","39.23"
"10","013","00","150","0000","0000","5377","3363","2014","743","6120","8617","9712","71.02","39.03"
"10","013","00","150","0001","0000","1229","709","520","111","1340","1959","0","68.40","36.19"
"10","013","00","150","0001","0489","448","264","184","36","484","713","0","67.88","37.03"
"10","013","00","150","0001","0490","587","344","243","53","640","954","0","67.09","36.06"
"10","013","00","150","0001","0491","194","101","93","22","216","292","0","73.97","34.59"
"10","013","00","150","0002","0000","654","401","253","75","729","1012","0","72.04","39.62"
"10","013","00","150","0002","0492","456","284","172","47","503","703","0","71.55","40.40"
"10","013","00","150","0002","0493","198","117","81","28","226","309","0","73.14","37.86"
"10","013","00","150","0003","0000","539","304","235","91","630","876","0","71.92","34.70"
"10","013","00","150","0003","0494","539","304","235","91","630","876","0","71.92","34.70"
"10","013","00","150","0004","0000","437","280","157","46","483","720","0","67.08","38.89"
"10","013","00","150","0004","0495","437","280","157","46","483","720","0","67.08","38.89"
"10","013","00","150","0005","0000","992","606","386","154","1146","1738","0","65.94","34.87"
"10","013","00","150","0005","0496","243","172","71","31","274","358","0","76.54","48.04"
"10","013","00","150","0005","0497","338","193","145","22","360","675","0","53.33","28.59"
"10","013","00","150","0005","0498","411","241","170","101","512","705","0","72.62","34.18"
"10","013","00","150","0006","0000","714","497","217","118","832","1087","0","76.54","45.72"
"10","013","00","150","0006","0500","353","258","95","49","402","530","0","75.85","48.68"
"10","013","00","150","0006","0501","361","239","122","69","430","557","0","77.20","42.91"
"10","013","00","150","0007","0000","812","566","246","148","960","1225","0","78.37","46.20"
"10","013","00","150","0007","0499","812","566","246","148","960","1225","0","78.37","46.20"
"10","013","00","160","0000","0000","11961","7197","4764","1517","13478","20068","22998","67.16","35.86"
"10","013","00","160","0001","0000","697","362","335","72","769","1165","0","66.01","31.07"
"10","013","00","160","0001","0502","697","362","335","72","769","1165","0","66.01","31.07"
"10","013","00","160","0002","0000","477","226","251","81","558","839","0","66.51","26.94"
"10","013","00","160","0002","0503","477","226","251","81","558","839","0","66.51","26.94"
"10","013","00","160","0003","0000","587","367","220","87","674","881","0","76.50","41.66"
"10","013","00","160","0003","0504","587","367","220","87","674","881","0","76.50","41.66"
"10","013","00","160","0004","0000","389","239","150","68","457","571","0","80.04","41.86"
"10","013","00","160","0004","0505","389","239","150","68","457","571","0","80.04","41.86"
"10","013","00","160","0005","0000","955","577","378","113","1068","1500","0","71.20","38.47"
"10","013","00","160","0005","0506","508","306","202","63","571","797","0","71.64","38.39"
"10","013","00","160","0005","0507","447","271","176","50","497","703","0","70.70","38.55"
"10","013","00","160","0006","0000","2498","1497","1001","305","2803","4034","0","69.48","37.11"
"10","013","00","160","0006","0508","612","373","239","69","681","977","0","69.70","38.18"
"10","013","00","160","0006","0509","667","385","282","62","729","1018","0","71.61","37.82"
"10","013","00","160","0006","0510","644","393","251","74","718","1047","0","68.58","37.54"
"10","013","00","160","0006","0511","575","346","229","100","675","992","0","68.04","34.88"
"10","013","00","160","0007","0000","1009","631","378","90","1099","1819","0","60.42","34.69"
"10","013","00","160","0007","0512","525","340","185","55","580","902","0","64.30","37.69"
"10","013","00","160","0007","0513","484","291","193","35","519","917","0","56.60","31.73"
"10","013","00","160","0008","0000","803","470","333","97","900","1353","0","66.52","34.74"
"10","013","00","160","0008","0514","401","234","167","50","451","670","0","67.31","34.93"
"10","013","00","160","0008","0515","402","236","166","47","449","683","0","65.74","34.55"
"10","013","00","160","0009","0000","1151","672","479","100","1251","1964","0","63.70","34.22"
"10","013","00","160","0009","0516","543","334","209","53","596","965","0","61.76","34.61"
"10","013","00","160","0009","0517","608","338","270","47","655","999","0","65.57","33.83"
"10","013","00","160","0010","0000","339","256","83","88","427","653","0","65.39","39.20"
"10","013","00","160","0010","0518","339","256","83","88","427","653","0","65.39","39.20"
"10","013","00","160","0011","0000","371","230","141","46","417","856","0","48.71","26.87"
"10","013","00","160","0011","0519","371","230","141","46","417","856","0","48.71","26.87"
"10","013","00","160","0012","0000","519","331","188","113","632","883","0","71.57","37.49"
"10","013","00","160","0012","0524","519","331","188","113","632","883","0","71.57","37.49"
"10","013","00","160","0013","0000","238","163","75","47","285","390","0","73.08","41.79"
"10","013","00","160","0013","0525","238","163","75","47","285","390","0","73.08","41.79"
"10","013","00","160","0014","0000","1600","951","649","159","1759","2574","0","68.34","36.95"
"10","013","00","160","0014","0520","584","349","235","72","656","926","0","70.84","37.69"
"10","013","00","160","0014","0521","469","277","192","39","508","759","0","66.93","36.50"
"10","013","00","160","0014","0522","547","325","222","48","595","889","0","66.93","36.56"
"10","013","00","160","0015","0000","328","225","103","51","379","586","0","64.68","38.40"
"10","013","00","160","0015","0523","328","225","103","51","379","586","0","64.68","38.40"
"10","013","00","170","0000","0000","17711","11444","6267","2242","19953","29015","33115","68.77","39.44"
"10","013","00","170","0001","0000","957","580","377","162","1119","1576","0","71.00","36.80"
"10","013","00","170","0001","0526","471","288","183","90","561","777","0","72.20","37.07"
"10","013","00","170","0001","0527","486","292","194","72","558","799","0","69.84","36.55"
"10","013","00","170","0002","0000","1522","951","571","176","1698","2422","0","70.11","39.27"
"10","013","00","170","0002","0528","741","458","283","84","825","1172","0","70.39","39.08"
"10","013","00","170","0002","0529","781","493","288","92","873","1250","0","69.84","39.44"
"10","013","00","170","0003","0000","1370","850","520","205","1575","2105","0","74.82","40.38"
"10","013","00","170","0003","0530","667","396","271","96","763","1013","0","75.32","39.09"
"10","013","00","170","0003","0531","703","454","249","109","812","1092","0","74.36","41.58"
"10","013","00","170","0004","0000","565","378","187","73","638","804","0","79.35","47.01"
"10","013","00","170","0004","0532","565","378","187","73","638","804","0","79.35","47.01"
"10","013","00","170","0005","0000","475","294","181","68","543","780","0","69.62","37.69"
"10","013","00","170","0005","0533","475","294","181","68","543","780","0","69.62","37.69"
"10","013","00","170","0006","0000","1394","865","529","184","1578","2220","0","71.08","38.96"
"10","013","00","170","0006","0534","672","424","248","101","773","1139","0","67.87","37.23"
"10","013","00","170","0006","0535","722","441","281","83","805","1081","0","74.47","40.80"
"10","013","00","170","0007","0000","1360","813","547","134","1494","2118","0","70.54","38.39"
"10","013","00","170","0007","0536","647","382","265","49","696","1033","0","67.38","36.98"
"10","013","00","170","0007","0537","713","431","282","85","798","1085","0","73.55","39.72"
"10","013","00","170","0008","0000","709","454","255","96","805","1157","0","69.58","39.24"
"10","013","00","170","0008","0540","709","454","255","96","805","1157","0","69.58","39.24"
"10","013","00","170","0009","0000","1241","827","414","154","1395","2022","0","68.99","40.90"
"10","013","00","170","0009","0541","650","448","202","94","744","1018","0","73.08","44.01"
"10","013","00","170","0009","0542","591","379","212","60","651","1004","0","64.84","37.75"
"10","013","00","170","0010","0000","895","622","273","100","995","1500","0","66.33","41.47"
"10","013","00","170","0010","0543","482","344","138","56","538","826","0","65.13","41.65"
"10","013","00","170","0010","0544","413","278","135","44","457","674","0","67.80","41.25"
"10","013","00","170","0011","0000","883","579","304","82","965","1320","0","73.11","43.86"
"10","013","00","170","0011","0545","883","579","304","82","965","1320","0","73.11","43.86"
"10","013","00","170","0012","0000","1241","740","501","153","1394","1976","0","70.55","37.45"
"10","013","00","170","0012","0538","609","339","270","71","680","951","0","71.50","35.65"
"10","013","00","170","0012","0539","632","401","231","82","714","1025","0","69.66","39.12"
"10","013","00","170","0013","0000","1579","1082","497","226","1805","2645","0","68.24","40.91"
"10","013","00","170","0013","0546","538","383","155","91","629","833","0","75.51","45.98"
"10","013","00","170","0013","0547","551","378","173","76","627","903","0","69.44","41.86"
"10","013","00","170","0013","0548","490","321","169","59","549","909","0","60.40","35.31"
"10","013","00","170","0014","0000","2267","1529","738","245","2512","4186","0","60.01","36.53"
"10","013","00","170","0014","0549","601","430","171","44","645","1360","0","47.43","31.62"
"10","013","00","170","0014","0550","461","319","142","49","510","775","0","65.81","41.16"
"10","013","00","170","0014","0551","547","342","205","51","598","874","0","68.42","39.13"
"10","013","00","170","0014","0552","658","438","220","101","759","1177","0","64.49","37.21"
"10","013","00","170","0015","0000","1253","880","373","184","1437","2184","0","65.80","40.29"
"10","013","00","170","0015","0553","601","409","192","58","659","1043","0","63.18","39.21"
"10","013","00","170","0015","0554","652","471","181","126","778","1141","0","68.19","41.28"
"10","013","00","180","0000","0000","7140","4418","2722","664","7804","11604","15074","67.25","38.07"
"10","013","00","180","0001","0000","1351","766","585","140","1491","2173","0","68.61","35.25"
"10","013","00","180","0001","0555","745","417","328","79","824","1186","0","69.48","35.16"
"10","013","00","180","0001","0556","606","349","257","61","667","987","0","67.58","35.36"
"10","013","00","180","0002","0000","1114","696","418","79","1193","1969","0","60.59","35.35"
"10","013","00","180","0002","0557","409","261","148","32","441","777","0","56.76","33.59"
"10","013","00","180","0002","0558","705","435","270","47","752","1192","0","63.09","36.49"
"10","013","00","180","0003","0000","648","404","244","52","700","1159","0","60.40","34.86"
"10","013","00","180","0003","0560","648","404","244","52","700","1159","0","60.40","34.86"
"10","013","00","180","0004","0000","817","504","313","69","886","1229","0","72.09","41.01"
"10","013","00","180","0004","0559","817","504","313","69","886","1229","0","72.09","41.01"
"10","013","00","180","0005","0000","596","340","256","63","659","1003","0","65.70","33.90"
"10","013","00","180","0005","0561","596","340","256","63","659","1003","0","65.70","33.90"
"10","013","00","180","0006","0000","873","534","339","116","989","1427","0","69.31","37.42"
"10","013","00","180","0006","0562","462","276","186","61","523","739","0","70.77","37.35"
"10","013","00","180","0006","0563","411","258","153","55","466","688","0","67.73","37.50"
"10","013","00","180","0007","0000","589","370","219","37","626","879","0","71.22","42.09"
"10","013","00","180","0007","0564","589","370","219","37","626","879","0","71.22","42.09"
"10","013","00","180","0008","0000","1152","804","348","108","1260","1765","0","71.39","45.55"
"10","013","00","180","0008","0565","531","372","159","56","587","847","0","69.30","43.92"
"10","013","00","180","0008","0566","621","432","189","52","673","918","0","73.31","47.06"
"10","013","00","190","0000","0000","9278","5927","3351","1080","10358","14654","16785","70.68","40.45"
"10","013","00","190","0001","0000","878","556","322","53","931","1344","0","69.27","41.37"
"10","013","00","190","0001","0567","436","276","160","41","477","641","0","74.41","43.06"
"10","013","00","190","0001","0568","442","280","162","12","454","703","0","64.58","39.83"
"10","013","00","190","0002","0000","1006","620","386","118","1124","1488","0","75.54","41.67"
"10","013","00","190","0002","0569","570","380","190","73","643","839","0","76.64","45.29"
"10","013","00","190","0002","0570","436","240","196","45","481","649","0","74.11","36.98"
"10","013","00","190","0003","0000","1007","658","349","75","1082","1546","0","69.99","42.56"
"10","013","00","190","0003","0575","507","316","191","44","551","749","0","73.56","42.19"
"10","013","00","190","0003","0576","500","342","158","31","531","797","0","66.62","42.91"
"10","013","00","190","0004","0000","438","267","171","32","470","647","0","72.64","41.27"
"10","013","00","190","0004","0574","438","267","171","32","470","647","0","72.64","41.27"
"10","013","00","190","0005","0000","2008","1290","718","260","2268","3009","0","75.37","42.87"
"10","013","00","190","0005","0571","659","413","246","79","738","969","0","76.16","42.62"
"10","013","00","190","0005","0572","731","476","255","107","838","1094","0","76.60","43.51"
"10","013","00","190","0005","0573","618","401","217","74","692","946","0","73.15","42.39"
"10","013","00","190","0006","0000","1058","700","358","158","1216","1702","0","71.45","41.13"
"10","013","00","190","0006","0579","445","320","125","64","509","711","0","71.59","45.01"
"10","013","00","190","0006","0580","613","380","233","94","707","991","0","71.34","38.35"
"10","013","00","190","0007","0000","767","480","287","135","902","1193","0","75.61","40.23"
"10","013","00","190","0007","0578","767","480","287","135","902","1193","0","75.61","40.23"
"10","013","00","190","0008","0000","615","407","208","79","694","878","0","79.04","46.36"
"10","013","00","190","0008","0577","615","407","208","79","694","878","0","79.04","46.36"
"10","013","00","190","0009","0000","1069","676","393","127","1196","1809","0","66.11","37.37"
"10","013","00","190","0009","0581","633","386","247","76","709","1077","0","65.83","35.84"
"10","013","00","190","0009","0582","436","290","146","51","487","732","0","66.53","39.62"
"10","013","00","190","0010","0000","432","273","159","43","475","1038","0","45.76","26.30"
"10","013","00","190","0010","0583","432","273","159","43","475","1038","0","45.76","26.30"
"10","013","00","200","0000","0000","5365","3224","2141","516","5881","8971","10064","65.56","35.94"
"10","013","00","200","0001","0000","872","511","361","55","927","1608","0","57.65","31.78"
"10","013","00","200","0001","0584","390","236","154","7","397","820","0","48.41","28.78"
"10","013","00","200","0001","0585","482","275","207","48","530","788","0","67.26","34.90"
"10","013","00","200","0002","0000","584","333","251","30","614","868","0","70.74","38.36"
"10","013","00","200","0002","0586","584","333","251","30","614","868","0","70.74","38.36"
"10","013","00","200","0003","0000","277","157","120","9","286","463","0","61.77","33.91"
"10","013","00","200","0003","0589","277","157","120","9","286","463","0","61.77","33.91"
"10","013","00","200","0004","0000","431","193","238","49","480","646","0","74.30","29.88"
"10","013","00","200","0004","0590","431","193","238","49","480","646","0","74.30","29.88"
"10","013","00","200","0005","0000","528","312","216","43","571","981","0","58.21","31.80"
"10","013","00","200","0005","0587","528","312","216","43","571","981","0","58.21","31.80"
"10","013","00","200","0006","0000","492","271","221","23","515","940","0","54.79","28.83"
"10","013","00","200","0006","0588","492","271","221","23","515","940","0","54.79","28.83"
"10","013","00","200","0007","0000","658","391","267","77","735","995","0","73.87","39.30"
"10","013","00","200","0007","0591","658","391","267","77","735","995","0","73.87","39.30"
"10","013","00","200","0008","0000","632","448","184","110","742","1024","0","72.46","43.75"
"10","013","00","200","0008","0592","632","448","184","110","742","1024","0","72.46","43.75"
"10","013","00","200","0009","0000","579","385","194","78","657","947","0","69.38","40.65"
"10","013","00","200","0009","0593","579","385","194","78","657","947","0","69.38","40.65"
"10","013","00","200","0010","0000","312","223","89","42","354","499","0","70.94","44.69"
"10","013","00","200","0010","0594","312","223","89","42","354","499","0","70.94","44.69"
"10","013","00","210","0000","0000","8968","5576","3392","1108","10076","15965","18099","63.11","34.93"
"10","013","00","210","0001","0000","833","479","354","79","912","1423","0","64.09","33.66"
"10","013","00","210","0001","0595","833","479","354","79","912","1423","0","64.09","33.66"
"10","013","00","210","0002","0000","759","463","296","106","865","1272","0","68.00","36.40"
"10","013","00","210","0002","0596","759","463","296","106","865","1272","0","68.00","36.40"
"10","013","00","210","0003","0000","502","329","173","46","548","723","0","75.80","45.50"
"10","013","00","210","0003","0597","502","329","173","46","548","723","0","75.80","45.50"
"10","013","00","210","0004","0000","1063","641","422","127","1190","1738","0","68.47","36.88"
"10","013","00","210","0004","0598","569","355","214","58","627","883","0","71.01","40.20"
"10","013","00","210","0004","0599","494","286","208","69","563","855","0","65.85","33.45"
"10","013","00","210","0005","0000","998","655","343","95","1093","1851","0","59.05","35.39"
"10","013","00","210","0005","0600","415","264","151","21","436","896","0","48.66","29.46"
"10","013","00","210","0005","0601","583","391","192","74","657","955","0","68.80","40.94"
"10","013","00","210","0006","0000","1272","812","460","152","1424","1992","0","71.49","40.76"
"10","013","00","210","0006","0602","507","342","165","64","571","797","0","71.64","42.91"
"10","013","00","210","0006","0603","765","470","295","88","853","1195","0","71.38","39.33"
"10","013","00","210","0007","0000","508","319","189","46","554","901","0","61.49","35.41"
"10","013","00","210","0007","0604","508","319","189","46","554","901","0","61.49","35.41"
"10","013","00","210","0008","0000","384","247","137","58","442","655","0","67.48","37.71"
"10","013","00","210","0008","0605","384","247","137","58","442","655","0","67.48","37.71"
"10","013","00","210","0009","0000","646","406","240","104","750","1104","0","67.93","36.78"
"10","013","00","210","0009","0606","646","406","240","104","750","1104","0","67.93","36.78"
"10","013","00","210","0010","0000","447","322","125","31","478","1033","0","46.27","31.17"
"10","013","00","210","0010","0607","447","322","125","31","478","1033","0","46.27","31.17"
"10","013","00","210","0011","0000","518","302","216","109","627","1018","0","61.59","29.67"
"10","013","00","210","0011","0608","518","302","216","109","627","1018","0","61.59","29.67"
"10","013","00","210","0012","0000","1038","601","437","155","1193","2255","0","52.90","26.65"
"10","013","00","210","0012","0609","569","328","241","126","695","1174","0","59.20","27.94"
"10","013","00","210","0012","0610","469","273","196","29","498","1081","0","46.07","25.25"
"10","013","00","220","0000","0000","5765","3057","2708","1496","7261","10590","12226","68.56","28.87"
"10","013","00","220","0001","0000","1189","651","538","216","1405","2034","0","69.08","32.01"
"10","013","00","220","0001","0611","607","346","261","101","708","1057","0","66.98","32.73"
"10","013","00","220","0001","0612","582","305","277","115","697","977","0","71.34","31.22"
"10","013","00","220","0002","0000","751","386","365","153","904","1213","0","74.53","31.82"
"10","013","00","220","0002","0613","751","386","365","153","904","1213","0","74.53","31.82"
"10","013","00","220","0003","0000","600","297","303","136","736","1001","0","73.53","29.67"
"10","013","00","220","0003","0614","600","297","303","136","736","1001","0","73.53","29.67"
"10","013","00","220","0004","0000","916","509","407","226","1142","1626","0","70.23","31.30"
"10","013","00","220","0004","0615","916","509","407","226","1142","1626","0","70.23","31.30"
"10","013","00","220","0005","0000","433","220","213","91","524","1092","0","47.99","20.15"
"10","013","00","220","0005","0616","433","220","213","91","524","1092","0","47.99","20.15"
"10","013","00","220","0006","0000","615","329","286","181","796","1129","0","70.50","29.14"
"10","013","00","220","0006","0617","615","329","286","181","796","1129","0","70.50","29.14"
"10","013","00","220","0007","0000","761","381","380","384","1145","1630","0","70.25","23.37"
"10","013","00","220","0007","0618","761","381","380","384","1145","1630","0","70.25","23.37"
"10","013","00","220","0008","0000","500","284","216","109","609","865","0","70.40","32.83"
"10","013","00","220","0008","0619","500","284","216","109","609","865","0","70.40","32.83"
"10","013","00","230","0000","0000","4308","2619","1689","589","4897","7284","8254","67.23","35.96"
"10","013","00","230","0001","0000","725","414","311","58","783","1280","0","61.17","32.34"
"10","013","00","230","0001","0622","300","165","135","31","331","463","0","71.49","35.64"
"10","013","00","230","0001","0623","425","249","176","27","452","817","0","55.32","30.48"
"10","013","00","230","0002","0000","352","260","92","36","388","524","0","74.05","49.62"
"10","013","00","230","0002","0624","352","260","92","36","388","524","0","74.05","49.62"
"10","013","00","230","0003","0000","305","182","123","25","330","613","0","53.83","29.69"
"10","013","00","230","0003","0621","305","182","123","25","330","613","0","53.83","29.69"
"10","013","00","230","0004","0000","369","234","135","86","455","681","0","66.81","34.36"
"10","013","00","230","0004","0620","369","234","135","86","455","681","0","66.81","34.36"
"10","013","00","230","0005","0000","239","136","103","24","263","359","0","73.26","37.88"
"10","013","00","230","0005","0625","239","136","103","24","263","359","0","73.26","37.88"
"10","013","00","230","0006","0000","525","322","203","81","606","837","0","72.40","38.47"
"10","013","00","230","0006","0626","525","322","203","81","606","837","0","72.40","38.47"
"10","013","00","230","0007","0000","535","320","215","46","581","1182","0","49.15","27.07"
"10","013","00","230","0007","0627","297","170","127","30","327","571","0","57.27","29.77"
"10","013","00","230","0007","0628","238","150","88","16","254","611","0","41.57","24.55"
"10","013","00","230","0008","0000","292","182","110","35","327","411","0","79.56","44.28"
"10","013","00","230","0008","0629","292","182","110","35","327","411","0","79.56","44.28"
"10","013","00","230","0009","0000","343","181","162","50","393","469","0","83.80","38.59"
"10","013","00","230","0009","0630","343","181","162","50","393","469","0","83.80","38.59"
"10","013","00","230","0010","0000","346","229","117","98","444","518","0","85.71","44.21"
"10","013","00","230","0010","0631","346","229","117","98","444","518","0","85.71","44.21"
"10","013","00","230","0011","0000","277","159","118","50","327","410","0","79.76","38.78"
"10","013","00","230","0011","0632","277","159","118","50","327","410","0","79.76","38.78"
"10","013","00","240","0000","0000","4656","2814","1842","521","5177","6709","7507","77.17","41.94"
"10","013","00","240","0001","0000","1035","629","406","87","1122","1480","0","75.81","42.50"
"10","013","00","240","0001","0633","1035","629","406","87","1122","1480","0","75.81","42.50"
"10","013","00","240","0002","0000","287","174","113","34","321","393","0","81.68","44.27"
"10","013","00","240","0002","0634","287","174","113","34","321","393","0","81.68","44.27"
"10","013","00","240","0003","0000","779","423","356","81","860","1194","0","72.03","35.43"
"10","013","00","240","0003","0636","779","423","356","81","860","1194","0","72.03","35.43"
"10","013","00","240","0004","0000","865","564","301","36","901","1200","0","75.08","47.00"
"10","013","00","240","0004","0637","865","564","301","36","901","1200","0","75.08","47.00"
"10","013","00","240","0005","0000","421","270","151","39","460","540","0","85.19","50.00"
"10","013","00","240","0005","0635","421","270","151","39","460","540","0","85.19","50.00"
"10","013","00","240","0006","0000","761","440","321","188","949","1246","0","76.16","35.31"
"10","013","00","240","0006","0638","761","440","321","188","949","1246","0","76.16","35.31"
"10","013","00","240","0007","0000","268","164","104","24","292","346","0","84.39","47.40"
"10","013","00","240","0007","0639","268","164","104","24","292","346","0","84.39","47.40"
"10","013","00","240","0008","0000","240","150","90","32","272","310","0","87.74","48.39"
"10","013","00","240","0008","0640","240","150","90","32","272","310","0","87.74","48.39"
"10","013","00","250","0000","0000","2965","1825","1140","354","3319","4582","5153","72.44","39.83"
"10","013","00","250","0001","0000","597","330","267","34","631","981","0","64.32","33.64"
"10","013","00","250","0001","0641","363","203","160","19","382","564","0","67.73","35.99"
"10","013","00","250","0001","0642","234","127","107","15","249","417","0","59.71","30.46"
"10","013","00","250","0002","0000","1310","778","532","228","1538","1814","0","84.79","42.89"
"10","013","00","250","0002","0643","627","380","247","105","732","874","0","83.75","43.48"
"10","013","00","250","0002","0644","683","398","285","123","806","940","0","85.74","42.34"
"10","013","00","250","0003","0000","580","401","179","63","643","947","0","67.90","42.34"
"10","013","00","250","0003","0645","580","401","179","63","643","947","0","67.90","42.34"
"10","013","00","250","0004","0000","478","316","162","29","507","840","0","60.36","37.62"
"10","013","00","250","0004","0646","478","316","162","29","507","840","0","60.36","37.62"
"10","013","00","260","0000","0000","3995","1618","2377","467","4462","6383","7809","69.90","25.35"
"10","013","00","260","0001","0000","738","269","469","53","791","1442","0","54.85","18.65"
"10","013","00","260","0001","0650","738","269","469","53","791","1442","0","54.85","18.65"
"10","013","00","260","0002","0000","214","90","124","13","227","327","0","69.42","27.52"
"10","013","00","260","0002","0649","214","90","124","13","227","327","0","69.42","27.52"
"10","013","00","260","0003","0000","335","131","204","50","385","574","0","67.07","22.82"
"10","013","00","260","0003","0648","335","131","204","50","385","574","0","67.07","22.82"
"10","013","00","260","0004","0000","402","180","222","83","485","630","0","76.98","28.57"
"10","013","00","260","0004","0647","402","180","222","83","485","630","0","76.98","28.57"
"10","013","00","260","0005","0000","530","190","340","91","621","736","0","84.38","25.82"
"10","013","00","260","0005","0651","530","190","340","91","621","736","0","84.38","25.82"
"10","013","00","260","0006","0000","436","179","257","43","479","572","0","83.74","31.29"
"10","013","00","260","0006","0652","436","179","257","43","479","572","0","83.74","31.29"
"10","013","00","260","0007","0000","223","135","88","33","256","334","0","76.65","40.42"
"10","013","00","260","0007","0653","223","135","88","33","256","334","0","76.65","40.42"
"10","013","00","260","0008","0000","221","100","121","12","233","467","0","49.89","21.41"
"10","013","00","260","0008","0654","221","100","121","12","233","467","0","49.89","21.41"
"10","013","00","260","0009","0000","432","164","268","43","475","687","0","69.14","23.87"
"10","013","00","260","0009","0655","432","164","268","43","475","687","0","69.14","23.87"
"10","013","00","260","0010","0000","464","180","284","46","510","614","0","83.06","29.32"
"10","013","00","260","0010","0656","464","180","284","46","510","614","0","83.06","29.32"
"10","013","00","270","0000","0000","2100","806","1294","218","2318","2912","3341","79.60","27.68"
"10","013","00","270","0001","0000","858","291","567","85","943","1143","0","82.50","25.46"
"10","013","00","270","0001","0657","266","102","164","17","283","332","0","85.24","30.72"
"10","013","00","270","0001","0658","488","160","328","56","544","659","0","82.55","24.28"
"10","013","00","270","0001","0659","104","29","75","12","116","152","0","76.32","19.08"
"10","013","00","270","0002","0000","234","68","166","21","255","309","0","82.52","22.01"
"10","013","00","270","0002","0661","234","68","166","21","255","309","0","82.52","22.01"
"10","013","00","270","0003","0000","128","50","78","9","137","181","0","75.69","27.62"
"10","013","00","270","0003","0660","128","50","78","9","137","181","0","75.69","27.62"
"10","013","00","270","0004","0000","347","167","180","55","402","442","0","90.95","37.78"
"10","013","00","270","0004","0664","347","167","180","55","402","442","0","90.95","37.78"
"10","013","00","270","0005","0000","146","63","83","8","154","357","0","43.14","17.65"
"10","013","00","270","0005","0663","146","63","83","8","154","357","0","43.14","17.65"
"10","013","00","270","0006","0000","387","167","220","40","427","480","0","88.96","34.79"
"10","013","00","270","0006","0662","387","167","220","40","427","480","0","88.96","34.79"
"10","013","00","280","0000","0000","3334","1395","1939","237","3571","5594","6812","63.84","24.94"
"10","013","00","280","0001","0000","261","120","141","15","276","447","0","61.74","26.85"
"10","013","00","280","0001","0665","261","120","141","15","276","447","0","61.74","26.85"
"10","013","00","280","0002","0000","364","150","214","8","372","787","0","47.27","19.06"
"10","013","00","280","0002","0666","364","150","214","8","372","787","0","47.27","19.06"
"10","013","00","280","0003","0000","771","326","445","75","846","1028","0","82.30","31.71"
"10","013","00","280","0003","0670","771","326","445","75","846","1028","0","82.30","31.71"
"10","013","00","280","0004","0000","356","172","184","32","388","866","0","44.80","19.86"
"10","013","00","280","0004","0671","356","172","184","32","388","866","0","44.80","19.86"
"10","013","00","280","0005","0000","354","170","184","24","378","432","0","87.50","39.35"
"10","013","00","280","0005","0672","354","170","184","24","378","432","0","87.50","39.35"
"10","013","00","280","0006","0000","1228","457","771","83","1311","2034","0","64.45","22.47"
"10","013","00","280","0006","0667","280","114","166","1","281","669","0","42.00","17.04"
"10","013","00","280","0006","0668","464","154","310","46","510","715","0","71.33","21.54"
"10","013","00","280","0006","0669","484","189","295","36","520","650","0","80.00","29.08"
"10","013","00","290","0000","0000","2993","1138","1855","295","3288","4221","5352","77.90","26.96"
"10","013","00","290","0001","0000","597","233","364","37","634","818","0","77.51","28.48"
"10","013","00","290","0001","0673","459","168","291","18","477","621","0","76.81","27.05"
"10","013","00","290","0001","0674","138","65","73","19","157","197","0","79.70","32.99"
"10","013","00","290","0002","0000","721","261","460","82","803","944","0","85.06","27.65"
"10","013","00","290","0002","0675","721","261","460","82","803","944","0","85.06","27.65"
"10","013","00","290","0003","0000","460","216","244","46","506","591","0","85.62","36.55"
"10","013","00","290","0003","0676","460","216","244","46","506","591","0","85.62","36.55"
"10","013","00","290","0004","0000","234","90","144","42","276","398","0","69.35","22.61"
"10","013","00","290","0004","0678","234","90","144","42","276","398","0","69.35","22.61"
"10","013","00","290","0005","0000","495","179","316","59","554","747","0","74.16","23.96"
"10","013","00","290","0005","0679","495","179","316","59","554","747","0","74.16","23.96"
"10","013","00","290","0006","0000","486","159","327","29","515","723","0","71.23","21.99"
"10","013","00","290","0006","0677","486","159","327","29","515","723","0","71.23","21.99"
"10","013","00","300","0000","0000","3726","1484","2242","471","4197","6099","7442","68.81","24.33"
"10","013","00","300","0001","0000","443","152","291","61","504","902","0","55.88","16.85"
"10","013","00","300","0001","0680","443","152","291","61","504","902","0","55.88","16.85"
"10","013","00","300","0002","0000","338","153","185","40","378","554","0","68.23","27.62"
"10","013","00","300","0002","0681","201","84","117","12","213","354","0","60.17","23.73"
"10","013","00","300","0002","0682","137","69","68","28","165","200","0","82.50","34.50"
"10","013","00","300","0003","0000","435","141","294","38","473","724","0","65.33","19.48"
"10","013","00","300","0003","0683","280","84","196","33","313","450","0","69.56","18.67"
"10","013","00","300","0003","0684","155","57","98","5","160","274","0","58.39","20.80"
"10","013","00","300","0004","0000","742","251","491","73","815","1097","0","74.29","22.88"
"10","013","00","300","0004","0685","742","251","491","73","815","1097","0","74.29","22.88"
"10","013","00","300","0005","0000","395","168","227","46","441","814","0","54.18","20.64"
"10","013","00","300","0005","0686","395","168","227","46","441","814","0","54.18","20.64"
"10","013","00","300","0006","0000","622","229","393","70","692","845","0","81.89","27.10"
"10","013","00","300","0006","0687","622","229","393","70","692","845","0","81.89","27.10"
"10","013","00","300","0007","0000","751","390","361","143","894","1163","0","76.87","33.53"
"10","013","00","300","0007","0688","351","166","185","63","414","547","0","75.69","30.35"
"10","013","00","300","0007","0689","400","224","176","80","480","616","0","77.92","36.36"
"10","013","00","310","0000","0000","2384","1172","1212","548","2932","3858","4914","76.00","30.38"
"10","013","00","310","0001","0000","528","233","295","139","667","882","0","75.62","26.42"
"10","013","00","310","0001","0690","528","233","295","139","667","882","0","75.62","26.42"
"10","013","00","310","0002","0000","430","225","205","84","514","663","0","77.53","33.94"
"10","013","00","310","0002","0691","430","225","205","84","514","663","0","77.53","33.94"
"10","013","00","310","0003","0000","147","79","68","30","177","292","0","60.62","27.05"
"10","013","00","310","0003","0692","147","79","68","30","177","292","0","60.62","27.05"
"10","013","00","310","0004","0000","592","260","332","114","706","920","0","76.74","28.26"
"10","013","00","310","0004","0693","592","260","332","114","706","920","0","76.74","28.26"
"10","013","00","310","0005","0000","409","240","169","90","499","633","0","78.83","37.91"
"10","013","00","310","0005","0694","409","240","169","90","499","633","0","78.83","37.91"
"10","013","00","310","0006","0000","278","135","143","91","369","468","0","78.85","28.85"
"10","013","00","310","0006","0695","278","135","143","91","369","468","0","78.85","28.85"
"10","013","00","320","0000","0000","2746","958","1788","382","3128","4091","4906","76.46","23.42"
"10","013","00","320","0001","0000","482","173","309","88","570","712","0","80.06","24.30"
"10","013","00","320","0001","0699","482","173","309","88","570","712","0","80.06","24.30"
"10","013","00","320","0002","0000","491","196","295","70","561","750","0","74.80","26.13"
"10","013","00","320","0002","0698","491","196","295","70","561","750","0","74.80","26.13"
"10","013","00","320","0003","0000","457","111","346","32","489","631","0","77.50","17.59"
"10","013","00","320","0003","0697","457","111","346","32","489","631","0","77.50","17.59"
"10","013","00","320","0004","0000","42","18","24","2","44","221","0","19.91","8.14"
"10","013","00","320","0004","0696","42","18","24","2","44","221","0","19.91","8.14"
"10","013","00","320","0005","0000","219","82","137","17","236","296","0","79.73","27.70"
"10","013","00","320","0005","0700","219","82","137","17","236","296","0","79.73","27.70"
"10","013","00","320","0006","0000","340","120","220","54","394","499","0","78.96","24.05"
"10","013","00","320","0006","0701","340","120","220","54","394","499","0","78.96","24.05"
"10","013","00","320","0007","0000","438","165","273","80","518","617","0","83.95","26.74"
"10","013","00","320","0007","0702","438","165","273","80","518","617","0","83.95","26.74"
"10","013","00","320","0008","0000","277","93","184","39","316","365","0","86.58","25.48"
"10","013","00","320","0008","0703","277","93","184","39","316","365","0","86.58","25.48"
"10","013","00","330","0000","0000","2268","924","1344","230","2498","4072","4866","61.35","22.69"
"10","013","00","330","0001","0000","905","341","564","62","967","1551","0","62.35","21.99"
"10","013","00","330","0001","0704","410","154","256","18","428","740","0","57.84","20.81"
"10","013","00","330","0001","0705","308","127","181","24","332","505","0","65.74","25.15"
"10","013","00","330","0001","0706","187","60","127","20","207","306","0","67.65","19.61"
"10","013","00","330","0002","0000","353","166","187","60","413","643","0","64.23","25.82"
"10","013","00","330","0002","0707","353","166","187","60","413","643","0","64.23","25.82"
"10","013","00","330","0003","0000","275","113","162","42","317","427","0","74.24","26.46"
"10","013","00","330","0003","0708","275","113","162","42","317","427","0","74.24","26.46"
"10","013","00","330","0004","0000","176","79","97","11","187","354","0","52.82","22.32"
"10","013","00","330","0004","0709","176","79","97","11","187","354","0","52.82","22.32"
"10","013","00","330","0005","0000","440","170","270","43","483","576","0","83.85","29.51"
"10","013","00","330","0005","0710","440","170","270","43","483","576","0","83.85","29.51"
"10","013","00","330","0006","0000","119","55","64","12","131","521","0","25.14","10.56"
"10","013","00","330","0006","0711","119","55","64","12","131","521","0","25.14","10.56"
"10","002","00","000","0000","0000","213669","122024","91645","17011","230680","376057","449012","61.34","32.45"
"10","002","00","010","0000","0000","42811","22868","19943","2522","45333","76955","94588","58.91","29.72"
"10","002","00","010","0001","0000","1201","599","602","66","1267","2349","0","53.94","25.50"
"10","002","00","010","0001","0024","324","161","163","22","346","595","0","58.15","27.06"
"10","002","00","010","0001","0025","454","231","223","18","472","855","0","55.20","27.02"
"10","002","00","010","0001","0026","423","207","216","26","449","899","0","49.94","23.03"
"10","002","00","010","0002","0000","779","393","386","48","827","1696","0","48.76","23.17"
"10","002","00","010","0002","0022","402","214","188","30","432","1000","0","43.20","21.40"
"10","002","00","010","0002","0023","377","179","198","18","395","696","0","56.75","25.72"
"10","002","00","010","0008","0000","1220","626","594","65","1285","2059","0","62.41","30.40"
"10","002","00","010","0008","0030","718","391","327","36","754","1130","0","66.73","34.60"
"10","002","00","010","0008","0031","502","235","267","29","531","929","0","57.16","25.30"
"10","002","00","010","0009","0000","767","435","332","92","859","1260","0","68.17","34.52"
"10","002","00","010","0009","0032","767","435","332","92","859","1260","0","68.17","34.52"
"10","002","00","010","0010","0000","1195","670","525","67","1262","2030","0","62.17","33.00"
"10","002","00","010","0010","0036","696","377","319","46","742","1222","0","60.72","30.85"
"10","002","00","010","0010","0037","499","293","206","21","520","808","0","64.36","36.26"
"10","002","00","010","0011","0000","1092","566","526","55","1147","2128","0","53.90","26.60"
"10","002","00","010","0011","0034","532","298","234","26","558","999","0","55.86","29.83"
"10","002","00","010","0011","0035","560","268","292","29","589","1129","0","52.17","23.74"
"10","002","00","010","0012","0000","734","421","313","56","790","1365","0","57.88","30.84"
"10","002","00","010","0012","0033","734","421","313","56","790","1365","0","57.88","30.84"
"10","002","00","010","0013","0000","1095","567","528","81","1176","1847","0","63.67","30.70"
"10","002","00","010","0013","0052","543","279","264","35","578","917","0","63.03","30.43"
"10","002","00","010","0013","0053","552","288","264","46","598","930","0","64.30","30.97"
"10","002","00","010","0014","0000","1264","625","639","59","1323","2125","0","62.26","29.41"
"10","002","00","010","0014","0047","612","292","320","27","639","1027","0","62.22","28.43"
"10","002","00","010","0014","0048","652","333","319","32","684","1098","0","62.30","30.33"
"10","002","00","010","0015","0000","1713","890","823","113","1826","3201","0","57.04","27.80"
"10","002","00","010","0015","0041","590","303","287","68","658","1047","0","62.85","28.94"
"10","002","00","010","0015","0042","553","288","265","27","580","1100","0","52.73","26.18"
"10","002","00","010","0015","0043","570","299","271","18","588","1054","0","55.79","28.37"
"10","002","00","010","0016","0000","854","518","336","79","933","1401","0","66.60","36.97"
"10","002","00","010","0016","0054","473","296","177","39","512","742","0","69.00","39.89"
"10","002","00","010","0016","0055","381","222","159","40","421","659","0","63.88","33.69"
"10","002","00","010","0017","0000","820","450","370","65","885","1747","0","50.66","25.76"
"10","002","00","010","0017","0061","418","221","197","31","449","880","0","51.02","25.11"
"10","002","00","010","0017","0062","402","229","173","34","436","867","0","50.29","26.41"
"10","002","00","010","0018","0000","863","513","350","48","911","1376","0","66.21","37.28"
"10","002","00","010","0018","0028","400","215","185","25","425","631","0","67.35","34.07"
"10","002","00","010","0018","0029","463","298","165","23","486","745","0","65.23","40.00"
"10","002","00","010","0019","0000","522","322","200","35","557","909","0","61.28","35.42"
"10","002","00","010","0019","0057","522","322","200","35","557","909","0","61.28","35.42"
"10","002","00","010","0021","0000","861","439","422","43","904","1515","0","59.67","28.98"
"10","002","00","010","0021","0058","403","215","188","19","422","760","0","55.53","28.29"
"10","002","00","010","0021","0059","458","224","234","24","482","755","0","63.84","29.67"
"10","002","00","010","0022","0000","760","420","340","41","801","1294","0","61.90","32.46"
"10","002","00","010","0022","0060","760","420","340","41","801","1294","0","61.90","32.46"
"10","002","00","010","0023","0000","571","326","245","32","603","1087","0","55.47","29.99"
"10","002","00","010","0023","0056","571","326","245","32","603","1087","0","55.47","29.99"
"10","002","00","010","0024","0000","1579","945","634","132","1711","2776","0","61.64","34.04"
"10","002","00","010","0024","0066","486","301","185","37","523","865","0","60.46","34.80"
"10","002","00","010","0024","0067","464","284","180","48","512","795","0","64.40","35.72"
"10","002","00","010","0024","0068","629","360","269","47","676","1116","0","60.57","32.26"
"10","002","00","010","0025","0000","1114","616","498","40","1154","2037","0","56.65","30.24"
"10","002","00","010","0025","0069","550","296","254","15","565","1094","0","51.65","27.06"
"10","002","00","010","0025","0070","564","320","244","25","589","943","0","62.46","33.93"
"10","002","00","010","0026","0000","1248","725","523","69","1317","2148","0","61.31","33.75"
"10","002","00","010","0026","0071","594","338","256","39","633","1085","0","58.34","31.15"
"10","002","00","010","0026","0072","654","387","267","30","684","1063","0","64.35","36.41"
"10","002","00","010","0027","0000","1797","1043","754","138","1935","3080","0","62.82","33.86"
"10","002","00","010","0027","0073","557","311","246","28","585","934","0","62.63","33.30"
"10","002","00","010","0027","0074","647","398","249","68","715","1158","0","61.74","34.37"
"10","002","00","010","0027","0075","593","334","259","42","635","988","0","64.27","33.81"
"10","002","00","010","0028","0000","687","383","304","43","730","1095","0","66.67","34.98"
"10","002","00","010","0028","0081","687","383","304","43","730","1095","0","66.67","34.98"
"10","002","00","010","0031","0000","519","301","218","42","561","869","0","64.56","34.64"
"10","002","00","010","0031","0078","519","301","218","42","561","869","0","64.56","34.64"
"10","002","00","010","0032","0000","998","587","411","62","1060","1686","0","62.87","34.82"
"10","002","00","010","0032","0079","469","269","200","26","495","800","0","61.88","33.63"
"10","002","00","010","0032","0080","529","318","211","36","565","886","0","63.77","35.89"
"10","002","00","010","0034","0000","732","409","323","39","771","1229","0","62.73","33.28"
"10","002","00","010","0034","0076","334","181","153","11","345","546","0","63.19","33.15"
"10","002","00","010","0034","0077","398","228","170","28","426","683","0","62.37","33.38"
"10","002","00","010","0035","0000","1523","830","693","74","1597","2818","0","56.67","29.45"
"10","002","00","010","0035","0007","464","244","220","18","482","892","0","54.04","27.35"
"10","002","00","010","0035","0008","550","298","252","23","573","976","0","58.71","30.53"
"10","002","00","010","0035","0009","509","288","221","33","542","950","0","57.05","30.32"
"10","002","00","010","0036","0000","1168","576","592","67","1235","2048","0","60.30","28.13"
"10","002","00","010","0036","0001","584","299","285","26","610","1042","0","58.54","28.69"
"10","002","00","010","0036","0002","584","277","307","41","625","1006","0","62.13","27.53"
"10","002","00","010","0037","0000","798","404","394","37","835","1504","0","55.52","26.86"
"10","002","00","010","0037","0003","385","185","200","20","405","806","0","50.25","22.95"
"10","002","00","010","0037","0004","413","219","194","17","430","698","0","61.60","31.38"
"10","002","00","010","0038","0000","2339","1151","1188","78","2417","4239","0","57.02","27.15"
"10","002","00","010","0038","0010","616","333","283","21","637","1104","0","57.70","30.16"
"10","002","00","010","0038","0011","527","251","276","21","548","996","0","55.02","25.20"
"10","002","00","010","0038","0012","597","273","324","15","612","1049","0","58.34","26.02"
"10","002","00","010","0038","0013","599","294","305","21","620","1090","0","56.88","26.97"
"10","002","00","010","0039","0000","1555","809","746","81","1636","2872","0","56.96","28.17"
"10","002","00","010","0039","0016","423","225","198","28","451","857","0","52.63","26.25"
"10","002","00","010","0039","0017","490","235","255","24","514","916","0","56.11","25.66"
"10","002","00","010","0039","0018","642","349","293","29","671","1099","0","61.06","31.76"
"10","002","00","010","0040","0000","1403","665","738","91","1494","2515","0","59.40","26.44"
"10","002","00","010","0040","0019","473","181","292","38","511","843","0","60.62","21.47"
"10","002","00","010","0040","0020","420","211","209","30","450","758","0","59.37","27.84"
"10","002","00","010","0040","0021","510","273","237","23","533","914","0","58.32","29.87"
"10","002","00","010","0041","0000","1640","855","785","96","1736","2948","0","58.89","29.00"
"10","002","00","010","0041","0044","452","259","193","30","482","770","0","62.60","33.64"
"10","002","00","010","0041","0045","645","311","334","33","678","1098","0","61.75","28.32"
"10","002","00","010","0041","0046","543","285","258","33","576","1080","0","53.33","26.39"
"10","002","00","010","0042","0000","1550","774","776","68","1618","2989","0","54.13","25.89"
"10","002","00","010","0042","0049","585","294","291","19","604","1097","0","55.06","26.80"
"10","002","00","010","0042","0050","468","249","219","16","484","927","0","52.21","26.86"
"10","002","00","010","0042","0051","497","231","266","33","530","965","0","54.92","23.94"
"10","002","00","010","0043","0000","1358","672","686","67","1425","2571","0","55.43","26.14"
"10","002","00","010","0043","0014","682","326","356","21","703","1310","0","53.66","24.89"
"10","002","00","010","0043","0015","676","346","330","46","722","1261","0","57.26","27.44"
"10","002","00","010","0044","0000","938","442","496","51","989","1869","0","52.92","23.65"
"10","002","00","010","0044","0005","500","246","254","24","524","986","0","53.14","24.95"
"10","002","00","010","0044","0006","438","196","242","27","465","883","0","52.66","22.20"
"10","002","00","010","0045","0000","470","269","201","25","495","733","0","67.53","36.70"
"10","002","00","010","0045","0027","470","269","201","25","495","733","0","67.53","36.70"
"10","002","00","010","0046","0000","1488","796","692","101","1589","2747","0","57.84","28.98"
"10","002","00","010","0046","0063","634","327","307","49","683","1185","0","57.64","27.59"
"10","002","00","010","0046","0064","421","213","208","22","443","772","0","57.38","27.59"
"10","002","00","010","0046","0065","433","256","177","30","463","790","0","58.61","32.41"
"10","002","00","010","0047","0000","1596","836","760","76","1672","2793","0","59.86","29.93"
"10","002","00","010","0047","0038","581","303","278","32","613","986","0","62.17","30.73"
"10","002","00","010","0047","0039","504","259","245","30","534","870","0","61.38","29.77"
"10","002","00","010","0047","0040","511","274","237","14","525","937","0","56.03","29.24"
"10","002","00","020","0000","0000","31054","17838","13216","1787","32841","55235","69945","59.46","32.29"
"10","002","00","020","0004","0000","752","437","315","47","799","1511","0","52.88","28.92"
"10","002","00","020","0004","0084","752","437","315","47","799","1511","0","52.88","28.92"
"10","002","00","020","0005","0000","1795","1067","728","88","1883","3429","0","54.91","31.12"
"10","002","00","020","0005","0085","792","503","289","50","842","1448","0","58.15","34.74"
"10","002","00","020","0005","0086","543","312","231","27","570","1065","0","53.52","29.30"
"10","002","00","020","0005","0087","460","252","208","11","471","916","0","51.42","27.51"
"10","002","00","020","0006","0000","1501","902","599","102","1603","2656","0","60.35","33.96"
"10","002","00","020","0006","0088","873","538","335","59","932","1506","0","61.89","35.72"
"10","002","00","020","0006","0089","628","364","264","43","671","1150","0","58.35","31.65"
"10","002","00","020","0007","0000","1703","981","722","70","1773","2946","0","60.18","33.30"
"10","002","00","020","0007","0090","762","437","325","30","792","1273","0","62.22","34.33"
"10","002","00","020","0007","0091","454","253","201","23","477","808","0","59.03","31.31"
"10","002","00","020","0007","0092","487","291","196","17","504","865","0","58.27","33.64"
"10","002","00","020","0008","0000","1304","718","586","71","1375","2290","0","60.04","31.35"
"10","002","00","020","0008","0093","782","425","357","40","822","1419","0","57.93","29.95"
"10","002","00","020","0008","0094","522","293","229","31","553","871","0","63.49","33.64"
"10","002","00","020","0009","0000","714","400","314","34","748","1246","0","60.03","32.10"
"10","002","00","020","0009","0095","714","400","314","34","748","1246","0","60.03","32.10"
"10","002","00","020","0010","0000","863","507","356","58","921","1439","0","64.00","35.23"
"10","002","00","020","0010","0096","863","507","356","58","921","1439","0","64.00","35.23"
"10","002","00","020","0011","0000","592","337","255","50","642","1088","0","59.01","30.97"
"10","002","00","020","0011","0097","592","337","255","50","642","1088","0","59.01","30.97"
"10","002","00","020","0016","0000","1937","1104","833","139","2076","3472","0","59.79","31.80"
"10","002","00","020","0016","0100","571","339","232","40","611","994","0","61.47","34.10"
"10","002","00","020","0016","0101","730","393","337","51","781","1263","0","61.84","31.12"
"10","002","00","020","0016","0102","636","372","264","48","684","1215","0","56.30","30.62"
"10","002","00","020","0017","0000","1530","821","709","102","1632","2740","0","59.56","29.96"
"10","002","00","020","0017","0106","743","424","319","62","805","1374","0","58.59","30.86"
"10","002","00","020","0017","0107","787","397","390","40","827","1366","0","60.54","29.06"
"10","002","00","020","0018","0000","1414","802","612","79","1493","2623","0","56.92","30.58"
"10","002","00","020","0018","0108","567","334","233","35","602","1003","0","60.02","33.30"
"10","002","00","020","0018","0109","464","241","223","25","489","830","0","58.92","29.04"
"10","002","00","020","0018","0110","383","227","156","19","402","790","0","50.89","28.73"
"10","002","00","020","0019","0000","1782","949","833","116","1898","3341","0","56.81","28.40"
"10","002","00","020","0019","0115","751","382","369","51","802","1351","0","59.36","28.28"
"10","002","00","020","0019","0116","524","295","229","39","563","995","0","56.58","29.65"
"10","002","00","020","0019","0117","507","272","235","26","533","995","0","53.57","27.34"
"10","002","00","020","0020","0000","1395","832","563","61","1456","2516","0","57.87","33.07"
"10","002","00","020","0020","0118","702","401","301","39","741","1308","0","56.65","30.66"
"10","002","00","020","0020","0119","693","431","262","22","715","1208","0","59.19","35.68"
"10","002","00","020","0021","0000","474","273","201","28","502","1045","0","48.04","26.12"
"10","002","00","020","0021","0120","474","273","201","28","502","1045","0","48.04","26.12"
"10","002","00","020","0022","0000","1661","913","748","107","1768","2788","0","63.41","32.75"
"10","002","00","020","0022","0121","611","338","273","42","653","995","0","65.63","33.97"
"10","002","00","020","0022","0122","613","337","276","36","649","1027","0","63.19","32.81"
"10","002","00","020","0022","0123","437","238","199","29","466","766","0","60.84","31.07"
"10","002","00","020","0023","0000","1560","941","619","85","1645","2737","0","60.10","34.38"
"10","002","00","020","0023","0127","521","338","183","23","544","919","0","59.19","36.78"
"10","002","00","020","0023","0128","533","304","229","28","561","925","0","60.65","32.86"
"10","002","00","020","0023","0129","506","299","207","34","540","893","0","60.47","33.48"
"10","002","00","020","0024","0000","2086","1205","881","108","2194","3516","0","62.40","34.27"
"10","002","00","020","0024","0130","826","468","358","40","866","1363","0","63.54","34.34"
"10","002","00","020","0024","0131","610","353","257","32","642","1023","0","62.76","34.51"
"10","002","00","020","0024","0132","650","384","266","36","686","1130","0","60.71","33.98"
"10","002","00","020","0025","0000","1935","1108","827","74","2009","3266","0","61.51","33.93"
"10","002","00","020","0025","0124","824","458","366","35","859","1328","0","64.68","34.49"
"10","002","00","020","0025","0125","511","301","210","22","533","843","0","63.23","35.71"
"10","002","00","020","0025","0126","600","349","251","17","617","1095","0","56.35","31.87"
"10","002","00","020","0026","0000","2357","1316","1041","105","2462","4175","0","58.97","31.52"
"10","002","00","020","0026","0111","562","335","227","25","587","1072","0","54.76","31.25"
"10","002","00","020","0026","0112","648","358","290","32","680","1105","0","61.54","32.40"
"10","002","00","020","0026","0113","620","311","309","21","641","1064","0","60.24","29.23"
"10","002","00","020","0026","0114","527","312","215","27","554","934","0","59.31","33.40"
"10","002","00","020","0027","0000","1678","963","715","101","1779","2880","0","61.77","33.44"
"10","002","00","020","0027","0103","603","318","285","34","637","1027","0","62.03","30.96"
"10","002","00","020","0027","0104","522","316","206","35","557","918","0","60.68","34.42"
"10","002","00","020","0027","0105","553","329","224","32","585","935","0","62.57","35.19"
"10","002","00","020","0028","0000","722","457","265","50","772","1291","0","59.80","35.40"
"10","002","00","020","0028","0082","383","250","133","25","408","624","0","65.38","40.06"
"10","002","00","020","0028","0083","339","207","132","25","364","667","0","54.57","31.03"
"10","002","00","020","0029","0000","783","478","305","62","845","1292","0","65.40","37.00"
"10","002","00","020","0029","0099","783","478","305","62","845","1292","0","65.40","37.00"
"10","002","00","020","0030","0000","516","327","189","50","566","948","0","59.70","34.49"
"10","002","00","020","0030","0098","516","327","189","50","566","948","0","59.70","34.49"
"10","002","00","030","0000","0000","18932","11145","7787","2142","21074","32693","37943","64.46","34.09"
"10","002","00","030","0001","0000","1939","1174","765","205","2144","3262","0","65.73","35.99"
"10","002","00","030","0001","0133","506","303","203","51","557","902","0","61.75","33.59"
"10","002","00","030","0001","0134","479","294","185","46","525","769","0","68.27","38.23"
"10","002","00","030","0001","0135","464","278","186","39","503","763","0","65.92","36.44"
"10","002","00","030","0001","0136","490","299","191","69","559","828","0","67.51","36.11"
"10","002","00","030","0002","0000","608","369","239","44","652","996","0","65.46","37.05"
"10","002","00","030","0002","0137","608","369","239","44","652","996","0","65.46","37.05"
"10","002","00","030","0003","0000","2110","1274","836","170","2280","3659","0","62.31","34.82"
"10","002","00","030","0003","0138","639","384","255","52","691","1070","0","64.58","35.89"
"10","002","00","030","0003","0139","585","333","252","44","629","970","0","64.85","34.33"
"10","002","00","030","0003","0140","458","287","171","21","479","884","0","54.19","32.47"
"10","002","00","030","0003","0141","428","270","158","53","481","735","0","65.44","36.73"
"10","002","00","030","0004","0000","524","333","191","93","617","812","0","75.99","41.01"
"10","002","00","030","0004","0142","321","191","130","70","391","519","0","75.34","36.80"
"10","002","00","030","0004","0143","203","142","61","23","226","293","0","77.13","48.46"
"10","002","00","030","0005","0000","767","448","319","99","866","1203","0","71.99","37.24"
"10","002","00","030","0005","0144","522","292","230","63","585","818","0","71.52","35.70"
"10","002","00","030","0005","0145","245","156","89","36","281","385","0","72.99","40.52"
"10","002","00","030","0007","0000","1685","1036","649","138","1823","3067","0","59.44","33.78"
"10","002","00","030","0007","0146","579","375","204","61","640","1055","0","60.66","35.55"
"10","002","00","030","0007","0147","573","331","242","36","609","1047","0","58.17","31.61"
"10","002","00","030","0007","0148","533","330","203","41","574","965","0","59.48","34.20"
"10","002","00","030","0008","0000","949","558","391","103","1052","1462","0","71.96","38.17"
"10","002","00","030","0008","0149","690","422","268","62","752","1039","0","72.38","40.62"
"10","002","00","030","0008","0150","259","136","123","41","300","423","0","70.92","32.15"
"10","002","00","030","0009","0000","1230","644","586","117","1347","2163","0","62.27","29.77"
"10","002","00","030","0009","0154","308","156","152","35","343","520","0","65.96","30.00"
"10","002","00","030","0009","0155","462","241","221","49","511","840","0","60.83","28.69"
"10","002","00","030","0009","0156","460","247","213","33","493","803","0","61.39","30.76"
"10","002","00","030","0010","0000","1225","659","566","100","1325","2188","0","60.56","30.12"
"10","002","00","030","0010","0157","466","249","217","35","501","817","0","61.32","30.48"
"10","002","00","030","0010","0158","303","161","142","35","338","604","0","55.96","26.66"
"10","002","00","030","0010","0159","456","249","207","30","486","767","0","63.36","32.46"
"10","002","00","030","0011","0000","605","302","303","55","660","946","0","69.77","31.92"
"10","002","00","030","0011","0160","605","302","303","55","660","946","0","69.77","31.92"
"10","002","00","030","0012","0000","265","157","108","20","285","415","0","68.67","37.83"
"10","002","00","030","0012","0161","265","157","108","20","285","415","0","68.67","37.83"
"10","002","00","030","0013","0000","288","175","113","33","321","470","0","68.30","37.23"
"10","002","00","030","0013","0162","288","175","113","33","321","470","0","68.30","37.23"
"10","002","00","030","0014","0000","327","192","135","48","375","488","0","76.84","39.34"
"10","002","00","030","0014","0163","327","192","135","48","375","488","0","76.84","39.34"
"10","002","00","030","0015","0000","251","141","110","24","275","406","0","67.73","34.73"
"10","002","00","030","0015","0164","251","141","110","24","275","406","0","67.73","34.73"
"10","002","00","030","0016","0000","275","168","107","44","319","536","0","59.51","31.34"
"10","002","00","030","0016","0165","275","168","107","44","319","536","0","59.51","31.34"
"10","002","00","030","0017","0000","254","141","113","13","267","428","0","62.38","32.94"
"10","002","00","030","0017","0166","254","141","113","13","267","428","0","62.38","32.94"
"10","002","00","030","0018","0000","508","281","227","76","584","859","0","67.99","32.71"
"10","002","00","030","0018","0167","508","281","227","76","584","859","0","67.99","32.71"
"10","002","00","030","0019","0000","464","289","175","68","532","827","0","64.33","34.95"
"10","002","00","030","0019","0168","464","289","175","68","532","827","0","64.33","34.95"
"10","002","00","030","0020","0000","503","333","170","74","577","994","0","58.05","33.50"
"10","002","00","030","0020","0169","233","153","80","28","261","460","0","56.74","33.26"
"10","002","00","030","0020","0170","270","180","90","46","316","534","0","59.18","33.71"
"10","002","00","030","0021","0000","680","400","280","125","805","1319","0","61.03","30.33"
"10","002","00","030","0021","0171","374","221","153","58","432","672","0","64.29","32.89"
"10","002","00","030","0021","0172","306","179","127","67","373","647","0","57.65","27.67"
"10","002","00","030","0022","0000","514","316","198","100","614","960","0","63.96","32.92"
"10","002","00","030","0022","0173","514","316","198","100","614","960","0","63.96","32.92"
"10","002","00","030","0023","0000","640","399","241","98","738","1089","0","67.77","36.64"
"10","002","00","030","0023","0174","333","195","138","56","389","587","0","66.27","33.22"
"10","002","00","030","0023","0175","307","204","103","42","349","502","0","69.52","40.64"
"10","002","00","030","0024","0000","222","129","93","50","272","313","0","86.90","41.21"
"10","002","00","030","0024","0176","222","129","93","50","272","313","0","86.90","41.21"
"10","002","00","030","0025","0000","384","251","133","71","455","680","0","66.91","36.91"
"10","002","00","030","0025","0177","384","251","133","71","455","680","0","66.91","36.91"
"10","002","00","030","0026","0000","303","207","96","39","342","556","0","61.51","37.23"
"10","002","00","030","0026","0178","193","132","61","29","222","350","0","63.43","37.71"
"10","002","00","030","0026","0179","110","75","35","10","120","206","0","58.25","36.41"
"10","002","00","030","0027","0000","1412","769","643","135","1547","2595","0","59.61","29.63"
"10","002","00","030","0027","0151","409","236","173","26","435","731","0","59.51","32.28"
"10","002","00","030","0027","0152","447","227","220","36","483","808","0","59.78","28.09"
"10","002","00","030","0027","0153","556","306","250","73","629","1056","0","59.56","28.98"
"10","002","00","040","0000","0000","14380","7937","6443","1468","15848","24343","28475","65.10","32.60"
"10","002","00","040","0001","0000","189","106","83","53","242","292","0","82.88","36.30"
"10","002","00","040","0001","0180","189","106","83","53","242","292","0","82.88","36.30"
"10","002","00","040","0002","0000","361","194","167","57","418","654","0","63.91","29.66"
"10","002","00","040","0002","0181","361","194","167","57","418","654","0","63.91","29.66"
"10","002","00","040","0003","0000","547","369","178","64","611","848","0","72.05","43.51"
"10","002","00","040","0003","0183","547","369","178","64","611","848","0","72.05","43.51"
"10","002","00","040","0004","0000","159","92","67","8","167","330","0","50.61","27.88"
"10","002","00","040","0004","0184","159","92","67","8","167","330","0","50.61","27.88"
"10","002","00","040","0005","0000","663","393","270","70","733","1314","0","55.78","29.91"
"10","002","00","040","0005","0185","316","196","120","40","356","618","0","57.61","31.72"
"10","002","00","040","0005","0186","347","197","150","30","377","696","0","54.17","28.30"
"10","002","00","040","0006","0000","471","282","189","20","491","850","0","57.76","33.18"
"10","002","00","040","0006","0187","471","282","189","20","491","850","0","57.76","33.18"
"10","002","00","040","0007","0000","433","250","183","32","465","678","0","68.58","36.87"
"10","002","00","040","0007","0188","433","250","183","32","465","678","0","68.58","36.87"
"10","002","00","040","0008","0000","872","466","406","73","945","1564","0","60.42","29.80"
"10","002","00","040","0008","0189","422","251","171","32","454","844","0","53.79","29.74"
"10","002","00","040","0008","0190","450","215","235","41","491","720","0","68.19","29.86"
"10","002","00","040","0009","0000","844","471","373","91","935","1299","0","71.98","36.26"
"10","002","00","040","0009","0191","503","280","223","54","557","767","0","72.62","36.51"
"10","002","00","040","0009","0192","341","191","150","37","378","532","0","71.05","35.90"
"10","002","00","040","0010","0000","487","240","247","52","539","680","0","79.26","35.29"
"10","002","00","040","0010","0193","487","240","247","52","539","680","0","79.26","35.29"
"10","002","00","040","0011","0000","334","152","182","39","373","464","0","80.39","32.76"
"10","002","00","040","0011","0194","334","152","182","39","373","464","0","80.39","32.76"
"10","002","00","040","0012","0000","341","159","182","42","383","495","0","77.37","32.12"
"10","002","00","040","0012","0195","341","159","182","42","383","495","0","77.37","32.12"
"10","002","00","040","0013","0000","371","192","179","34","405","613","0","66.07","31.32"
"10","002","00","040","0013","0196","371","192","179","34","405","613","0","66.07","31.32"
"10","002","00","040","0014","0000","1086","617","469","150","1236","2018","0","61.25","30.57"
"10","002","00","040","0014","0197","556","316","240","94","650","1014","0","64.10","31.16"
"10","002","00","040","0014","0198","530","301","229","56","586","1004","0","58.37","29.98"
"10","002","00","040","0015","0000","1110","613","497","113","1223","1992","0","61.40","30.77"
"10","002","00","040","0015","0199","476","285","191","52","528","842","0","62.71","33.85"
"10","002","00","040","0015","0200","634","328","306","61","695","1150","0","60.43","28.52"
"10","002","00","040","0016","0000","1259","672","587","83","1342","2094","0","64.09","32.09"
"10","002","00","040","0016","0201","526","273","253","54","580","901","0","64.37","30.30"
"10","002","00","040","0016","0202","733","399","334","29","762","1193","0","63.87","33.45"
"10","002","00","040","0017","0000","586","323","263","61","647","906","0","71.41","35.65"
"10","002","00","040","0017","0203","586","323","263","61","647","906","0","71.41","35.65"
"10","002","00","040","0018","0000","905","504","401","123","1028","1691","0","60.79","29.80"
"10","002","00","040","0018","0204","546","283","263","44","590","1013","0","58.24","27.94"
"10","002","00","040","0018","0205","359","221","138","79","438","678","0","64.60","32.60"
"10","002","00","040","0019","0000","453","235","218","41","494","682","0","72.43","34.46"
"10","002","00","040","0019","0206","453","235","218","41","494","682","0","72.43","34.46"
"10","002","00","040","0020","0000","750","405","345","64","814","1269","0","64.14","31.91"
"10","002","00","040","0020","0207","379","210","169","39","418","564","0","74.11","37.23"
"10","002","00","040","0020","0208","371","195","176","25","396","705","0","56.17","27.66"
"10","002","00","040","0021","0000","496","294","202","28","524","884","0","59.28","33.26"
"10","002","00","040","0021","0209","496","294","202","28","524","884","0","59.28","33.26"
"10","002","00","040","0022","0000","594","336","258","56","650","984","0","66.06","34.15"
"10","002","00","040","0022","0210","594","336","258","56","650","984","0","66.06","34.15"
"10","002","00","040","0023","0000","633","344","289","45","678","1064","0","63.72","32.33"
"10","002","00","040","0023","0211","633","344","289","45","678","1064","0","63.72","32.33"
"10","002","00","040","0024","0000","436","228","208","69","505","678","0","74.48","33.63"
"10","002","00","040","0024","0182","436","228","208","69","505","678","0","74.48","33.63"
"10","002","00","050","0000","0000","17701","10344","7357","1492","19193","30108","34809","63.75","34.36"
"10","002","00","050","0001","0000","906","499","407","88","994","1525","0","65.18","32.72"
"10","002","00","050","0001","0212","614","342","272","53","667","1034","0","64.51","33.08"
"10","002","00","050","0001","0213","292","157","135","35","327","491","0","66.60","31.98"
"10","002","00","050","0002","0000","1011","580","431","96","1107","1919","0","57.69","30.22"
"10","002","00","050","0002","0214","503","289","214","55","558","949","0","58.80","30.45"
"10","002","00","050","0002","0215","508","291","217","41","549","970","0","56.60","30.00"
"10","002","00","050","0003","0000","2105","1092","1013","139","2244","3907","0","57.44","27.95"
"10","002","00","050","0003","0216","479","248","231","34","513","921","0","55.70","26.93"
"10","002","00","050","0003","0217","455","223","232","14","469","933","0","50.27","23.90"
"10","002","00","050","0003","0218","500","257","243","31","531","991","0","53.58","25.93"
"10","002","00","050","0003","0219","671","364","307","60","731","1062","0","68.83","34.27"
"10","002","00","050","0004","0000","1241","652","589","83","1324","2467","0","53.67","26.43"
"10","002","00","050","0004","0220","397","197","200","42","439","793","0","55.36","24.84"
"10","002","00","050","0004","0221","406","233","173","12","418","859","0","48.66","27.12"
"10","002","00","050","0004","0222","438","222","216","29","467","815","0","57.30","27.24"
"10","002","00","050","0005","0000","409","233","176","19","428","591","0","72.42","39.42"
"10","002","00","050","0005","0223","409","233","176","19","428","591","0","72.42","39.42"
"10","002","00","050","0006","0000","785","445","340","82","867","1280","0","67.73","34.77"
"10","002","00","050","0006","0224","351","194","157","53","404","555","0","72.79","34.95"
"10","002","00","050","0006","0225","434","251","183","29","463","725","0","63.86","34.62"
"10","002","00","050","0007","0000","588","388","200","18","606","1160","0","52.24","33.45"
"10","002","00","050","0007","0226","588","388","200","18","606","1160","0","52.24","33.45"
"10","002","00","050","0008","0000","789","510","279","93","882","1401","0","62.96","36.40"
"10","002","00","050","0008","0227","470","292","178","62","532","841","0","63.26","34.72"
"10","002","00","050","0008","0228","319","218","101","31","350","560","0","62.50","38.93"
"10","002","00","050","0009","0000","1150","761","389","131","1281","2042","0","62.73","37.27"
"10","002","00","050","0009","0229","494","331","163","72","566","891","0","63.52","37.15"
"10","002","00","050","0009","0230","656","430","226","59","715","1151","0","62.12","37.36"
"10","002","00","050","0010","0000","1308","761","547","189","1497","2319","0","64.55","32.82"
"10","002","00","050","0010","0231","471","266","205","63","534","804","0","66.42","33.08"
"10","002","00","050","0010","0232","359","211","148","62","421","607","0","69.36","34.76"
"10","002","00","050","0010","0233","478","284","194","64","542","908","0","59.69","31.28"
"10","002","00","050","0011","0000","539","333","206","53","592","1076","0","55.02","30.95"
"10","002","00","050","0011","0234","539","333","206","53","592","1076","0","55.02","30.95"
"10","002","00","050","0012","0000","442","238","204","51","493","806","0","61.17","29.53"
"10","002","00","050","0012","0235","442","238","204","51","493","806","0","61.17","29.53"
"10","002","00","050","0013","0000","706","414","292","45","751","1054","0","71.25","39.28"
"10","002","00","050","0013","0236","706","414","292","45","751","1054","0","71.25","39.28"
"10","002","00","050","0014","0000","857","515","342","49","906","1356","0","66.81","37.98"
"10","002","00","050","0014","0237","400","243","157","22","422","598","0","70.57","40.64"
"10","002","00","050","0014","0238","457","272","185","27","484","758","0","63.85","35.88"
"10","002","00","050","0015","0000","1736","1035","701","130","1866","2547","0","73.26","40.64"
"10","002","00","050","0015","0239","601","332","269","42","643","912","0","70.50","36.40"
"10","002","00","050","0015","0240","572","357","215","49","621","834","0","74.46","42.81"
"10","002","00","050","0015","0241","563","346","217","39","602","801","0","75.16","43.20"
"10","002","00","050","0016","0000","2167","1321","846","156","2323","3319","0","69.99","39.80"
"10","002","00","050","0016","0242","721","423","298","50","771","1041","0","74.06","40.63"
"10","002","00","050","0016","0243","776","499","277","47","823","1220","0","67.46","40.90"
"10","002","00","050","0016","0244","670","399","271","59","729","1058","0","68.90","37.71"
"10","002","00","050","0017","0000","659","381","278","53","712","930","0","76.56","40.97"
"10","002","00","050","0017","0245","659","381","278","53","712","930","0","76.56","40.97"
"10","002","00","050","0018","0000","303","186","117","17","320","409","0","78.24","45.48"
"10","002","00","050","0018","0246","303","186","117","17","320","409","0","78.24","45.48"
"10","002","00","060","0000","0000","11954","7218","4736","1155","13109","21344","24431","61.42","33.82"
"10","002","00","060","0001","0000","1480","806","674","114","1594","2602","0","61.26","30.98"
"10","002","00","060","0001","0247","540","292","248","35","575","923","0","62.30","31.64"
"10","002","00","060","0001","0248","423","231","192","44","467","768","0","60.81","30.08"
"10","002","00","060","0001","0249","517","283","234","35","552","911","0","60.59","31.06"
"10","002","00","060","0002","0000","979","576","403","111","1090","1901","0","57.34","30.30"
"10","002","00","060","0002","0251","486","289","197","53","539","921","0","58.52","31.38"
"10","002","00","060","0002","0252","493","287","206","58","551","980","0","56.22","29.29"
"10","002","00","060","0003","0000","539","322","217","63","602","896","0","67.19","35.94"
"10","002","00","060","0003","0253","539","322","217","63","602","896","0","67.19","35.94"
"10","002","00","060","0004","0000","453","292","161","37","490","919","0","53.32","31.77"
"10","002","00","060","0004","0254","453","292","161","37","490","919","0","53.32","31.77"
"10","002","00","060","0005","0000","764","477","287","36","800","1571","0","50.92","30.36"
"10","002","00","060","0005","0255","405","268","137","17","422","775","0","54.45","34.58"
"10","002","00","060","0005","0256","359","209","150","19","378","796","0","47.49","26.26"
"10","002","00","060","0006","0000","764","551","213","140","904","1438","0","62.87","38.32"
"10","002","00","060","0006","0257","325","292","33","67","392","704","0","55.68","41.48"
"10","002","00","060","0006","0258","439","259","180","73","512","734","0","69.75","35.29"
"10","002","00","060","0007","0000","563","380","183","72","635","778","0","81.62","48.84"
"10","002","00","060","0007","0259","563","380","183","72","635","778","0","81.62","48.84"
"10","002","00","060","0008","0000","1184","725","459","129","1313","2356","0","55.73","30.77"
"10","002","00","060","0008","0260","415","253","162","66","481","890","0","54.04","28.43"
"10","002","00","060","0008","0261","384","241","143","21","405","724","0","55.94","33.29"
"10","002","00","060","0008","0262","385","231","154","42","427","742","0","57.55","31.13"
"10","002","00","060","0009","0000","749","471","278","43","792","1543","0","51.33","30.52"
"10","002","00","060","0009","0263","353","230","123","20","373","715","0","52.17","32.17"
"10","002","00","060","0009","0264","396","241","155","23","419","828","0","50.60","29.11"
"10","002","00","060","0010","0000","785","452","333","78","863","1247","0","69.21","36.25"
"10","002","00","060","0010","0265","785","452","333","78","863","1247","0","69.21","36.25"
"10","002","00","060","0011","0000","1387","795","592","89","1476","2249","0","65.63","35.35"
"10","002","00","060","0011","0266","654","361","293","45","699","1118","0","62.52","32.29"
"10","002","00","060","0011","0267","733","434","299","44","777","1131","0","68.70","38.37"
"10","002","00","060","0012","0000","697","437","260","83","780","1059","0","73.65","41.27"
"10","002","00","060","0012","0268","697","437","260","83","780","1059","0","73.65","41.27"
"10","002","00","060","0013","0000","882","542","340","86","968","1677","0","57.72","32.32"
"10","002","00","060","0013","0269","489","265","224","62","551","895","0","61.56","29.61"
"10","002","00","060","0013","0270","393","277","116","24","417","782","0","53.32","35.42"
"10","002","00","060","0014","0000","728","392","336","74","802","1108","0","72.38","35.38"
"10","002","00","060","0014","0250","728","392","336","74","802","1108","0","72.38","35.38"
"10","002","00","070","0000","0000","15327","8901","6426","1649","16976","27621","31895","61.46","32.23"
"10","002","00","070","0001","0000","3196","1660","1536","250","3446","5770","0","59.72","28.77"
"10","002","00","070","0001","0271","784","395","389","48","832","1410","0","59.01","28.01"
"10","002","00","070","0001","0272","464","252","212","43","507","875","0","57.94","28.80"
"10","002","00","070","0001","0273","712","407","305","80","792","1265","0","62.61","32.17"
"10","002","00","070","0001","0274","635","287","348","36","671","1160","0","57.84","24.74"
"10","002","00","070","0001","0275","601","319","282","43","644","1060","0","60.75","30.09"
"10","002","00","070","0002","0000","1128","658","470","77","1205","2134","0","56.47","30.83"
"10","002","00","070","0002","0276","589","344","245","52","641","988","0","64.88","34.82"
"10","002","00","070","0002","0277","539","314","225","25","564","1146","0","49.21","27.40"
"10","002","00","070","0003","0000","1033","625","408","130","1163","1654","0","70.31","37.79"
"10","002","00","070","0003","0278","551","328","223","78","629","903","0","69.66","36.32"
"10","002","00","070","0003","0279","482","297","185","52","534","751","0","71.11","39.55"
"10","002","00","070","0004","0000","894","491","403","55","949","1462","0","64.91","33.58"
"10","002","00","070","0004","0280","406","229","177","15","421","728","0","57.83","31.46"
"10","002","00","070","0004","0281","488","262","226","40","528","734","0","71.93","35.69"
"10","002","00","070","0005","0000","1018","572","446","113","1131","1897","0","59.62","30.15"
"10","002","00","070","0005","0282","539","310","229","54","593","1006","0","58.95","30.82"
"10","002","00","070","0005","0283","479","262","217","59","538","891","0","60.38","29.41"
"10","002","00","070","0006","0000","643","420","223","118","761","1231","0","61.82","34.12"
"10","002","00","070","0006","0284","643","420","223","118","761","1231","0","61.82","34.12"
"10","002","00","070","0007","0000","802","451","351","107","909","1412","0","64.38","31.94"
"10","002","00","070","0007","0285","323","177","146","48","371","567","0","65.43","31.22"
"10","002","00","070","0007","0286","479","274","205","59","538","845","0","63.67","32.43"
"10","002","00","070","0008","0000","285","174","111","45","330","566","0","58.30","30.74"
"10","002","00","070","0008","0287","194","114","80","29","223","362","0","61.60","31.49"
"10","002","00","070","0008","0288","91","60","31","16","107","204","0","52.45","29.41"
"10","002","00","070","0009","0000","875","516","359","94","969","1759","0","55.09","29.33"
"10","002","00","070","0009","0289","433","244","189","44","477","880","0","54.20","27.73"
"10","002","00","070","0009","0290","442","272","170","50","492","879","0","55.97","30.94"
"10","002","00","070","0010","0000","726","412","314","78","804","1250","0","64.32","32.96"
"10","002","00","070","0010","0291","342","205","137","45","387","584","0","66.27","35.10"
"10","002","00","070","0010","0292","384","207","177","33","417","666","0","62.61","31.08"
"10","002","00","070","0011","0000","1233","779","454","121","1354","2193","0","61.74","35.52"
"10","002","00","070","0011","0293","422","258","164","30","452","743","0","60.83","34.72"
"10","002","00","070","0011","0294","539","338","201","57","596","908","0","65.64","37.22"
"10","002","00","070","0011","0295","272","183","89","34","306","542","0","56.46","33.76"
"10","002","00","070","0012","0000","1096","662","434","117","1213","2317","0","52.35","28.57"
"10","002","00","070","0012","0296","426","251","175","44","470","827","0","56.83","30.35"
"10","002","00","070","0012","0297","325","195","130","33","358","707","0","50.64","27.58"
"10","002","00","070","0012","0298","345","216","129","40","385","783","0","49.17","27.59"
"10","002","00","070","0013","0000","492","259","233","54","546","840","0","65.00","30.83"
"10","002","00","070","0013","0299","492","259","233","54","546","840","0","65.00","30.83"
"10","002","00","070","0014","0000","571","367","204","71","642","898","0","71.49","40.87"
"10","002","00","070","0014","0300","571","367","204","71","642","898","0","71.49","40.87"
"10","002","00","070","0015","0000","588","348","240","87","675","954","0","70.75","36.48"
"10","002","00","070","0015","0301","588","348","240","87","675","954","0","70.75","36.48"
"10","002","00","070","0016","0000","747","507","240","132","879","1284","0","68.46","39.49"
"10","002","00","070","0016","0302","365","263","102","56","421","622","0","67.68","42.28"
"10","002","00","070","0016","0303","382","244","138","76","458","662","0","69.18","36.86"
"10","002","00","080","0000","0000","25352","15380","9972","1782","27134","44593","52732","60.85","34.49"
"10","002","00","080","0001","0000","801","492","309","56","857","1293","0","66.28","38.05"
"10","002","00","080","0001","0330","801","492","309","56","857","1293","0","66.28","38.05"
"10","002","00","080","0002","0000","975","591","384","64","1039","1562","0","66.52","37.84"
"10","002","00","080","0002","0304","509","306","203","31","540","801","0","67.42","38.20"
"10","002","00","080","0002","0305","466","285","181","33","499","761","0","65.57","37.45"
"10","002","00","080","0003","0000","675","420","255","52","727","1126","0","64.56","37.30"
"10","002","00","080","0003","0306","675","420","255","52","727","1126","0","64.56","37.30"
"10","002","00","080","0004","0000","494","298","196","40","534","865","0","61.73","34.45"
"10","002","00","080","0004","0307","494","298","196","40","534","865","0","61.73","34.45"
"10","002","00","080","0005","0000","577","366","211","60","637","854","0","74.59","42.86"
"10","002","00","080","0005","0308","577","366","211","60","637","854","0","74.59","42.86"
"10","002","00","080","0006","0000","881","538","343","78","959","1353","0","70.88","39.76"
"10","002","00","080","0006","0309","881","538","343","78","959","1353","0","70.88","39.76"
"10","002","00","080","0007","0000","1650","1029","621","87","1737","2845","0","61.05","36.17"
"10","002","00","080","0007","0310","579","382","197","25","604","909","0","66.45","42.02"
"10","002","00","080","0007","0311","553","324","229","43","596","1013","0","58.84","31.98"
"10","002","00","080","0007","0312","518","323","195","19","537","923","0","58.18","34.99"
"10","002","00","080","0008","0000","1780","1049","731","105","1885","2914","0","64.69","36.00"
"10","002","00","080","0008","0313","484","302","182","30","514","932","0","55.15","32.40"
"10","002","00","080","0008","0314","666","382","284","50","716","1034","0","69.25","36.94"
"10","002","00","080","0008","0315","630","365","265","25","655","948","0","69.09","38.50"
"10","002","00","080","0009","0000","433","271","162","26","459","672","0","68.30","40.33"
"10","002","00","080","0009","0317","433","271","162","26","459","672","0","68.30","40.33"
"10","002","00","080","0010","0000","354","224","130","24","378","672","0","56.25","33.33"
"10","002","00","080","0010","0316","354","224","130","24","378","672","0","56.25","33.33"
"10","002","00","080","0011","0000","915","526","389","73","988","1492","0","66.22","35.25"
"10","002","00","080","0011","0318","915","526","389","73","988","1492","0","66.22","35.25"
"10","002","00","080","0012","0000","467","284","183","42","509","815","0","62.45","34.85"
"10","002","00","080","0012","0319","467","284","183","42","509","815","0","62.45","34.85"
"10","002","00","080","0013","0000","736","484","252","55","791","1448","0","54.63","33.43"
"10","002","00","080","0013","0320","356","229","127","28","384","713","0","53.86","32.12"
"10","002","00","080","0013","0321","380","255","125","27","407","735","0","55.37","34.69"
"10","002","00","080","0014","0000","262","166","96","25","287","437","0","65.68","37.99"
"10","002","00","080","0014","0322","262","166","96","25","287","437","0","65.68","37.99"
"10","002","00","080","0015","0000","2495","1482","1013","156","2651","4839","0","54.78","30.63"
"10","002","00","080","0015","0323","649","418","231","49","698","1182","0","59.05","35.36"
"10","002","00","080","0015","0324","607","360","247","33","640","1196","0","53.51","30.10"
"10","002","00","080","0015","0325","677","383","294","44","721","1322","0","54.54","28.97"
"10","002","00","080","0015","0326","562","321","241","30","592","1139","0","51.98","28.18"
"10","002","00","080","0016","0000","1668","993","675","90","1758","3108","0","56.56","31.95"
"10","002","00","080","0016","0327","620","356","264","38","658","1262","0","52.14","28.21"
"10","002","00","080","0016","0328","524","319","205","31","555","906","0","61.26","35.21"
"10","002","00","080","0016","0329","524","318","206","21","545","940","0","57.98","33.83"
"10","002","00","080","0017","0000","2331","1384","947","161","2492","4450","0","56.00","31.10"
"10","002","00","080","0017","0331","763","460","303","65","828","1474","0","56.17","31.21"
"10","002","00","080","0017","0332","526","310","216","38","564","895","0","63.02","34.64"
"10","002","00","080","0017","0333","569","331","238","26","595","1030","0","57.77","32.14"
"10","002","00","080","0017","0334","473","283","190","32","505","1051","0","48.05","26.93"
"10","002","00","080","0018","0000","2116","1272","844","147","2263","3713","0","60.95","34.26"
"10","002","00","080","0018","0335","724","435","289","40","764","1312","0","58.23","33.16"
"10","002","00","080","0018","0336","720","429","291","73","793","1215","0","65.27","35.31"
"10","002","00","080","0018","0337","672","408","264","34","706","1186","0","59.53","34.40"
"10","002","00","080","0019","0000","1384","827","557","80","1464","2525","0","57.98","32.75"
"10","002","00","080","0019","0338","743","450","293","49","792","1246","0","63.56","36.12"
"10","002","00","080","0019","0339","641","377","264","31","672","1279","0","52.54","29.48"
"10","002","00","080","0020","0000","566","312","254","71","637","1038","0","61.37","30.06"
"10","002","00","080","0020","0340","566","312","254","71","637","1038","0","61.37","30.06"
"10","002","00","080","0021","0000","1355","809","546","118","1473","2430","0","60.62","33.29"
"10","002","00","080","0021","0341","697","431","266","59","756","1234","0","61.26","34.93"
"10","002","00","080","0021","0342","658","378","280","59","717","1196","0","59.95","31.61"
"10","002","00","080","0022","0000","1029","701","328","76","1105","1673","0","66.05","41.90"
"10","002","00","080","0022","0343","585","350","235","51","636","961","0","66.18","36.42"
"10","002","00","080","0022","0344","444","351","93","25","469","712","0","65.87","49.30"
"10","002","00","080","0023","0000","970","577","393","54","1024","1740","0","58.85","33.16"
"10","002","00","080","0023","0345","489","302","187","31","520","879","0","59.16","34.36"
"10","002","00","080","0023","0346","481","275","206","23","504","861","0","58.54","31.94"
"10","002","00","080","0024","0000","438","285","153","42","480","729","0","65.84","39.09"
"10","002","00","080","0024","0347","438","285","153","42","480","729","0","65.84","39.09"
"10","002","00","090","0000","0000","19124","11348","7776","1357","20481","35014","40630","58.49","32.41"
"10","002","00","090","0001","0000","1187","762","425","90","1277","2061","0","61.96","36.97"
"10","002","00","090","0001","0348","625","394","231","70","695","1086","0","64.00","36.28"
"10","002","00","090","0001","0349","562","368","194","20","582","975","0","59.69","37.74"
"10","002","00","090","0002","0000","1012","550","462","66","1078","1892","0","56.98","29.07"
"10","002","00","090","0002","0350","506","268","238","45","551","934","0","58.99","28.69"
"10","002","00","090","0002","0351","506","282","224","21","527","958","0","55.01","29.44"
"10","002","00","090","0003","0000","1515","885","630","115","1630","2618","0","62.26","33.80"
"10","002","00","090","0003","0352","415","224","191","34","449","779","0","57.64","28.75"
"10","002","00","090","0003","0353","507","306","201","39","546","889","0","61.42","34.42"
"10","002","00","090","0003","0354","593","355","238","42","635","950","0","66.84","37.37"
"10","002","00","090","0004","0000","878","494","384","59","937","1552","0","60.37","31.83"
"10","002","00","090","0004","0355","450","253","197","22","472","750","0","62.93","33.73"
"10","002","00","090","0004","0356","428","241","187","37","465","802","0","57.98","30.05"
"10","002","00","090","0005","0000","738","447","291","40","778","1360","0","57.21","32.87"
"10","002","00","090","0005","0357","411","244","167","25","436","733","0","59.48","33.29"
"10","002","00","090","0005","0358","327","203","124","15","342","627","0","54.55","32.38"
"10","002","00","090","0006","0000","1401","825","576","63","1464","2509","0","58.35","32.88"
"10","002","00","090","0006","0359","300","169","131","14","314","588","0","53.40","28.74"
"10","002","00","090","0006","0360","508","298","210","31","539","927","0","58.14","32.15"
"10","002","00","090","0006","0361","593","358","235","18","611","994","0","61.47","36.02"
"10","002","00","090","0007","0000","953","550","403","51","1004","1764","0","56.92","31.18"
"10","002","00","090","0007","0362","537","298","239","31","568","948","0","59.92","31.43"
"10","002","00","090","0007","0363","416","252","164","20","436","816","0","53.43","30.88"
"10","002","00","090","0008","0000","1938","1073","865","126","2064","3632","0","56.83","29.54"
"10","002","00","090","0008","0364","449","245","204","36","485","915","0","53.01","26.78"
"10","002","00","090","0008","0365","574","298","276","38","612","927","0","66.02","32.15"
"10","002","00","090","0008","0366","459","255","204","26","485","930","0","52.15","27.42"
"10","002","00","090","0008","0367","456","275","181","26","482","860","0","56.05","31.98"
"10","002","00","090","0009","0000","1851","1066","785","112","1963","3650","0","53.78","29.21"
"10","002","00","090","0009","0371","477","252","225","15","492","887","0","55.47","28.41"
"10","002","00","090","0009","0372","424","246","178","29","453","891","0","50.84","27.61"
"10","002","00","090","0009","0373","550","324","226","41","591","1078","0","54.82","30.06"
"10","002","00","090","0009","0374","400","244","156","27","427","794","0","53.78","30.73"
"10","002","00","090","0010","0000","1685","1001","684","108","1793","3203","0","55.98","31.25"
"10","002","00","090","0010","0368","599","363","236","33","632","1101","0","57.40","32.97"
"10","002","00","090","0010","0369","512","287","225","43","555","914","0","60.72","31.40"
"10","002","00","090","0010","0370","574","351","223","32","606","1188","0","51.01","29.55"
"10","002","00","090","0011","0000","893","554","339","73","966","1597","0","60.49","34.69"
"10","002","00","090","0011","0375","402","269","133","30","432","810","0","53.33","33.21"
"10","002","00","090","0011","0376","491","285","206","43","534","787","0","67.85","36.21"
"10","002","00","090","0012","0000","890","544","346","68","958","1383","0","69.27","39.33"
"10","002","00","090","0012","0377","405","237","168","34","439","609","0","72.09","38.92"
"10","002","00","090","0012","0378","485","307","178","34","519","774","0","67.05","39.66"
"10","002","00","090","0013","0000","942","579","363","112","1054","1888","0","55.83","30.67"
"10","002","00","090","0013","0379","425","269","156","43","468","884","0","52.94","30.43"
"10","002","00","090","0013","0380","517","310","207","69","586","1004","0","58.37","30.88"
"10","002","00","090","0014","0000","1764","1089","675","118","1882","3195","0","58.90","34.08"
"10","002","00","090","0014","0381","550","364","186","36","586","1112","0","52.70","32.73"
"10","002","00","090","0014","0382","732","457","275","55","787","1184","0","66.47","38.60"
"10","002","00","090","0014","0383","482","268","214","27","509","899","0","56.62","29.81"
"10","002","00","090","0015","0000","1477","929","548","156","1633","2710","0","60.26","34.28"
"10","002","00","090","0015","0384","483","327","156","56","539","832","0","64.78","39.30"
"10","002","00","090","0015","0385","620","377","243","49","669","1208","0","55.38","31.21"
"10","002","00","090","0015","0386","374","225","149","51","425","670","0","63.43","33.58"
"10","002","00","100","0000","0000","10878","6523","4355","899","11777","18766","21264","62.76","34.76"
"10","002","00","100","0001","0000","157","92","65","14","171","216","0","79.17","42.59"
"10","002","00","100","0001","0387","157","92","65","14","171","216","0","79.17","42.59"
"10","002","00","100","0002","0000","264","146","118","47","311","449","0","69.27","32.52"
"10","002","00","100","0002","0388","264","146","118","47","311","449","0","69.27","32.52"
"10","002","00","100","0003","0000","492","297","195","51","543","732","0","74.18","40.57"
"10","002","00","100","0003","0389","492","297","195","51","543","732","0","74.18","40.57"
"10","002","00","100","0004","0000","407","267","140","37","444","573","0","77.49","46.60"
"10","002","00","100","0004","0393","407","267","140","37","444","573","0","77.49","46.60"
"10","002","00","100","0005","0000","294","169","125","34","328","441","0","74.38","38.32"
"10","002","00","100","0005","0394","294","169","125","34","328","441","0","74.38","38.32"
"10","002","00","100","0006","0000","591","336","255","39","630","1132","0","55.65","29.68"
"10","002","00","100","0006","0395","591","336","255","39","630","1132","0","55.65","29.68"
"10","002","00","100","0007","0000","628","370","258","30","658","1103","0","59.66","33.54"
"10","002","00","100","0007","0396","628","370","258","30","658","1103","0","59.66","33.54"
"10","002","00","100","0008","0000","506","270","236","66","572","823","0","69.50","32.81"
"10","002","00","100","0008","0397","506","270","236","66","572","823","0","69.50","32.81"
"10","002","00","100","0009","0000","556","333","223","51","607","1345","0","45.13","24.76"
"10","002","00","100","0009","0398","556","333","223","51","607","1345","0","45.13","24.76"
"10","002","00","100","0010","0000","2350","1404","946","154","2504","4261","0","58.77","32.95"
"10","002","00","100","0010","0400","486","297","189","36","522","944","0","55.30","31.46"
"10","002","00","100","0010","0401","588","319","269","42","630","1055","0","59.72","30.24"
"10","002","00","100","0010","0402","653","411","242","43","696","1055","0","65.97","38.96"
"10","002","00","100","0010","0403","623","377","246","33","656","1207","0","54.35","31.23"
"10","002","00","100","0011","0000","504","298","206","37","541","898","0","60.24","33.18"
"10","002","00","100","0011","0399","504","298","206","37","541","898","0","60.24","33.18"
"10","002","00","100","0012","0000","338","207","131","29","367","569","0","64.50","36.38"
"10","002","00","100","0012","0390","338","207","131","29","367","569","0","64.50","36.38"
"10","002","00","100","0013","0000","289","166","123","36","325","512","0","63.48","32.42"
"10","002","00","100","0013","0391","289","166","123","36","325","512","0","63.48","32.42"
"10","002","00","100","0014","0000","497","276","221","47","544","724","0","75.14","38.12"
"10","002","00","100","0014","0392","497","276","221","47","544","724","0","75.14","38.12"
"10","002","00","100","0015","0000","757","493","264","75","832","1247","0","66.72","39.53"
"10","002","00","100","0015","0404","757","493","264","75","832","1247","0","66.72","39.53"
"10","002","00","100","0016","0000","459","296","163","44","503","752","0","66.89","39.36"
"10","002","00","100","0016","0405","459","296","163","44","503","752","0","66.89","39.36"
"10","002","00","100","0017","0000","1017","626","391","60","1077","1562","0","68.95","40.08"
"10","002","00","100","0017","0406","530","302","228","30","560","812","0","68.97","37.19"
"10","002","00","100","0017","0407","487","324","163","30","517","750","0","68.93","43.20"
"10","002","00","100","0018","0000","772","477","295","48","820","1427","0","57.46","33.43"
"10","002","00","100","0018","0408","348","232","116","36","384","650","0","59.08","35.69"
"10","002","00","100","0018","0409","424","245","179","12","436","777","0","56.11","31.53"
"10","002","00","110","0000","0000","3119","1280","1839","365","3484","4855","6187","71.76","26.36"
"10","002","00","110","0001","0000","610","230","380","79","689","890","0","77.42","25.84"
"10","002","00","110","0001","0410","610","230","380","79","689","890","0","77.42","25.84"
"10","002","00","110","0002","0000","483","178","305","43","526","633","0","83.10","28.12"
"10","002","00","110","0002","0411","483","178","305","43","526","633","0","83.10","28.12"
"10","002","00","110","0003","0000","523","203","320","55","578","705","0","81.99","28.79"
"10","002","00","110","0003","0412","523","203","320","55","578","705","0","81.99","28.79"
"10","002","00","110","0004","0000","200","104","96","27","227","270","0","84.07","38.52"
"10","002","00","110","0004","0413","200","104","96","27","227","270","0","84.07","38.52"
"10","002","00","110","0005","0000","109","45","64","7","116","308","0","37.66","14.61"
"10","002","00","110","0005","0414","109","45","64","7","116","308","0","37.66","14.61"
"10","002","00","110","0006","0000","266","99","167","51","317","387","0","81.91","25.58"
"10","002","00","110","0006","0415","266","99","167","51","317","387","0","81.91","25.58"
"10","002","00","110","0007","0000","28","16","12","1","29","41","0","70.73","39.02"
"10","002","00","110","0007","0416","28","16","12","1","29","41","0","70.73","39.02"
"10","002","00","110","0008","0000","557","247","310","75","632","780","0","81.03","31.67"
"10","002","00","110","0008","0418","557","247","310","75","632","780","0","81.03","31.67"
"10","002","00","110","0009","0000","235","112","123","7","242","645","0","37.52","17.36"
"10","002","00","110","0009","0419","235","112","123","7","242","645","0","37.52","17.36"
"10","002","00","110","0010","0000","108","46","62","20","128","196","0","65.31","23.47"
"10","002","00","110","0010","0417","108","46","62","20","128","196","0","65.31","23.47"
"10","002","00","120","0000","0000","3037","1242","1795","393","3430","4530","6113","75.72","27.42"
"10","002","00","120","0001","0000","803","292","511","96","899","1160","0","77.50","25.17"
"10","002","00","120","0001","0421","803","292","511","96","899","1160","0","77.50","25.17"
"10","002","00","120","0002","0000","604","252","352","103","707","940","0","75.21","26.81"
"10","002","00","120","0002","0422","604","252","352","103","707","940","0","75.21","26.81"
"10","002","00","120","0003","0000","333","155","178","30","363","446","0","81.39","34.75"
"10","002","00","120","0003","0420","333","155","178","30","363","446","0","81.39","34.75"
"10","002","00","120","0004","0000","245","123","122","37","282","388","0","72.68","31.70"
"10","002","00","120","0004","0423","245","123","122","37","282","388","0","72.68","31.70"
"10","002","00","120","0005","0000","192","79","113","18","210","432","0","48.61","18.29"
"10","002","00","120","0005","0424","192","79","113","18","210","432","0","48.61","18.29"
"10","002","00","120","0006","0000","344","148","196","52","396","479","0","82.67","30.90"
"10","002","00","120","0006","0425","344","148","196","52","396","479","0","82.67","30.90"
"10","002","00","120","0007","0000","516","193","323","57","573","685","0","83.65","28.18"
"10","002","00","120","0007","0426","516","193","323","57","573","685","0","83.65","28.18"
"10","015","00","000","0000","0000","132696","55422","77274","12456","145152","267021","318849","54.36","20.76"
"10","015","00","010","0000","0000","38456","16318","22138","2427","40883","80380","99500","50.86","20.30"
"10","015","00","010","0001","0000","661","280","381","26","687","1522","0","45.14","18.40"
"10","015","00","010","0001","0022","403","171","232","16","419","803","0","52.18","21.30"
"10","015","00","010","0001","0023","258","109","149","10","268","719","0","37.27","15.16"
"10","015","00","010","0002","0000","923","347","576","79","1002","1934","0","51.81","17.94"
"10","015","00","010","0002","0016","526","208","318","38","564","1070","0","52.71","19.44"
"10","015","00","010","0002","0017","397","139","258","41","438","864","0","50.69","16.09"
"10","015","00","010","0003","0000","197","92","105","14","211","377","0","55.97","24.40"
"10","015","00","010","0003","0027","197","92","105","14","211","377","0","55.97","24.40"
"10","015","00","010","0004","0000","333","160","173","28","361","641","0","56.32","24.96"
"10","015","00","010","0004","0033","333","160","173","28","361","641","0","56.32","24.96"
"10","015","00","010","0005","0000","239","122","117","16","255","522","0","48.85","23.37"
"10","015","00","010","0005","0035","239","122","117","16","255","522","0","48.85","23.37"
"10","015","00","010","0006","0000","1369","588","781","139","1508","2764","0","54.56","21.27"
"10","015","00","010","0006","0037","424","179","245","50","474","835","0","56.77","21.44"
"10","015","00","010","0006","0038","487","210","277","50","537","981","0","54.74","21.41"
"10","015","00","010","0006","0039","458","199","259","39","497","948","0","52.43","20.99"
"10","015","00","010","0007","0000","622","297","325","32","654","1652","0","39.59","17.98"
"10","015","00","010","0007","0059","257","117","140","14","271","898","0","30.18","13.03"
"10","015","00","010","0007","0060","365","180","185","18","383","754","0","50.80","23.87"
"10","015","00","010","0008","0000","1588","713","875","105","1693","3020","0","56.06","23.61"
"10","015","00","010","0008","0056","522","246","276","28","550","917","0","59.98","26.83"
"10","015","00","010","0008","0057","530","239","291","39","569","1069","0","53.23","22.36"
"10","015","00","010","0008","0058","536","228","308","38","574","1034","0","55.51","22.05"
"10","015","00","010","0009","0000","717","317","400","29","746","1416","0","52.68","22.39"
"10","015","00","010","0009","0001","348","144","204","17","365","696","0","52.44","20.69"
"10","015","00","010","0009","0002","369","173","196","12","381","720","0","52.92","24.03"
"10","015","00","010","0010","0000","819","286","533","82","901","1916","0","47.03","14.93"
"10","015","00","010","0010","0006","175","62","113","11","186","433","0","42.96","14.32"
"10","015","00","010","0010","0007","358","134","224","27","385","813","0","47.36","16.48"
"10","015","00","010","0010","0008","286","90","196","44","330","670","0","49.25","13.43"
"10","015","00","010","0012","0000","260","114","146","24","284","431","0","65.89","26.45"
"10","015","00","010","0012","0034","260","114","146","24","284","431","0","65.89","26.45"
"10","015","00","010","0013","0000","269","124","145","23","292","485","0","60.21","25.57"
"10","015","00","010","0013","0032","269","124","145","23","292","485","0","60.21","25.57"
"10","015","00","010","0014","0000","1799","740","1059","117","1916","3353","0","57.14","22.07"
"10","015","00","010","0014","0042","538","207","331","40","578","962","0","60.08","21.52"
"10","015","00","010","0014","0043","453","194","259","28","481","867","0","55.48","22.38"
"10","015","00","010","0014","0044","433","172","261","20","453","776","0","58.38","22.16"
"10","015","00","010","0014","0045","375","167","208","29","404","748","0","54.01","22.33"
"10","015","00","010","0015","0000","381","181","200","26","407","773","0","52.65","23.42"
"10","015","00","010","0015","0061","381","181","200","26","407","773","0","52.65","23.42"
"10","015","00","010","0016","0000","2235","911","1324","149","2384","4667","0","51.08","19.52"
"10","015","00","010","0016","0078","441","192","249","26","467","904","0","51.66","21.24"
"10","015","00","010","0016","0079","422","161","261","33","455","904","0","50.33","17.81"
"10","015","00","010","0016","0080","442","174","268","31","473","928","0","50.97","18.75"
"10","015","00","010","0016","0081","439","180","259","24","463","889","0","52.08","20.25"
"10","015","00","010","0016","0082","491","204","287","35","526","1042","0","50.48","19.58"
"10","015","00","010","0017","0000","1707","679","1028","98","1805","3535","0","51.06","19.21"
"10","015","00","010","0017","0018","404","153","251","20","424","892","0","47.53","17.15"
"10","015","00","010","0017","0019","444","175","269","20","464","858","0","54.08","20.40"
"10","015","00","010","0017","0020","399","182","217","28","427","870","0","49.08","20.92"
"10","015","00","010","0017","0021","460","169","291","30","490","915","0","53.55","18.47"
"10","015","00","010","0018","0000","1331","522","809","52","1383","2973","0","46.52","17.56"
"10","015","00","010","0018","0003","436","169","267","17","453","951","0","47.63","17.77"
"10","015","00","010","0018","0004","402","162","240","20","422","955","0","44.19","16.96"
"10","015","00","010","0018","0005","493","191","302","15","508","1067","0","47.61","17.90"
"10","015","00","010","0019","0000","472","248","224","39","511","1022","0","50.00","24.27"
"10","015","00","010","0019","0028","472","248","224","39","511","1022","0","50.00","24.27"
"10","015","00","010","0020","0000","264","138","126","17","281","496","0","56.65","27.82"
"10","015","00","010","0020","0030","264","138","126","17","281","496","0","56.65","27.82"
"10","015","00","010","0021","0000","762","360","402","44","806","1745","0","46.19","20.63"
"10","015","00","010","0021","0040","344","155","189","19","363","800","0","45.38","19.38"
"10","015","00","010","0021","0041","418","205","213","25","443","945","0","46.88","21.69"
"10","015","00","010","0022","0000","529","215","314","35","564","1132","0","49.82","18.99"
"10","015","00","010","0022","0063","529","215","314","35","564","1132","0","49.82","18.99"
"10","015","00","010","0023","0000","1351","632","719","76","1427","2689","0","53.07","23.50"
"10","015","00","010","0023","0069","379","187","192","23","402","778","0","51.67","24.04"
"10","015","00","010","0023","0070","497","223","274","27","524","944","0","55.51","23.62"
"10","015","00","010","0023","0071","475","222","253","26","501","967","0","51.81","22.96"
"10","015","00","010","0024","0000","807","343","464","59","866","1717","0","50.44","19.98"
"10","015","00","010","0024","0076","374","153","221","26","400","758","0","52.77","20.18"
"10","015","00","010","0024","0077","433","190","243","33","466","959","0","48.59","19.81"
"10","015","00","010","0025","0000","439","188","251","29","468","925","0","50.59","20.32"
"10","015","00","010","0025","0009","439","188","251","29","468","925","0","50.59","20.32"
"10","015","00","010","0026","0000","298","128","170","14","312","578","0","53.98","22.15"
"10","015","00","010","0026","0024","298","128","170","14","312","578","0","53.98","22.15"
"10","015","00","010","0027","0000","265","95","170","16","281","518","0","54.25","18.34"
"10","015","00","010","0027","0026","265","95","170","16","281","518","0","54.25","18.34"
"10","015","00","010","0028","0000","365","180","185","25","390","732","0","53.28","24.59"
"10","015","00","010","0028","0031","365","180","185","25","390","732","0","53.28","24.59"
"10","015","00","010","0029","0000","1181","542","639","56","1237","2492","0","49.64","21.75"
"10","015","00","010","0029","0053","404","188","216","21","425","781","0","54.42","24.07"
"10","015","00","010","0029","0054","374","184","190","22","396","803","0","49.32","22.91"
"10","015","00","010","0029","0055","403","170","233","13","416","908","0","45.81","18.72"
"10","015","00","010","0030","0000","274","127","147","14","288","468","0","61.54","27.14"
"10","015","00","010","0030","0062","274","127","147","14","288","468","0","61.54","27.14"
"10","015","00","010","0031","0000","858","365","493","53","911","1766","0","51.59","20.67"
"10","015","00","010","0031","0067","435","191","244","31","466","898","0","51.89","21.27"
"10","015","00","010","0031","0068","423","174","249","22","445","868","0","51.27","20.05"
"10","015","00","010","0032","0000","510","218","292","41","551","1030","0","53.50","21.17"
"10","015","00","010","0032","0087","510","218","292","41","551","1030","0","53.50","21.17"
"10","015","00","010","0033","0000","1273","475","798","75","1348","2877","0","46.85","16.51"
"10","015","00","010","0033","0010","387","128","259","28","415","954","0","43.50","13.42"
"10","015","00","010","0033","0011","440","166","274","24","464","938","0","49.47","17.70"
"10","015","00","010","0033","0012","446","181","265","23","469","985","0","47.61","18.38"
"10","015","00","010","0034","0000","316","150","166","28","344","550","0","62.55","27.27"
"10","015","00","010","0034","0025","316","150","166","28","344","550","0","62.55","27.27"
"10","015","00","010","0035","0000","219","79","140","13","232","413","0","56.17","19.13"
"10","015","00","010","0035","0029","219","79","140","13","232","413","0","56.17","19.13"
"10","015","00","010","0036","0000","382","170","212","34","416","798","0","52.13","21.30"
"10","015","00","010","0036","0036","382","170","212","34","416","798","0","52.13","21.30"
"10","015","00","010","0037","0000","2378","1062","1316","121","2499","5015","0","49.83","21.18"
"10","015","00","010","0037","0048","402","189","213","25","427","878","0","48.63","21.53"
"10","015","00","010","0037","0049","431","167","264","14","445","909","0","48.95","18.37"
"10","015","00","010","0037","0050","461","264","197","23","484","1121","0","43.18","23.55"
"10","015","00","010","0037","0051","557","232","325","30","587","1128","0","52.04","20.57"
"10","015","00","010","0037","0052","527","210","317","29","556","979","0","56.79","21.45"
"10","015","00","010","0038","0000","1050","461","589","74","1124","2051","0","54.80","22.48"
"10","015","00","010","0038","0065","516","221","295","44","560","1018","0","55.01","21.71"
"10","015","00","010","0038","0066","534","240","294","30","564","1033","0","54.60","23.23"
"10","015","00","010","0039","0000","368","198","170","19","387","774","0","50.00","25.58"
"10","015","00","010","0039","0064","368","198","170","19","387","774","0","50.00","25.58"
"10","015","00","010","0040","0000","731","284","447","77","808","1395","0","57.92","20.36"
"10","015","00","010","0040","0092","349","129","220","36","385","688","0","55.96","18.75"
"10","015","00","010","0040","0093","382","155","227","41","423","707","0","59.83","21.92"
"10","015","00","010","0041","0000","1894","772","1122","89","1983","4038","0","49.11","19.12"
"10","015","00","010","0041","0083","472","223","249","25","497","1041","0","47.74","21.42"
"10","015","00","010","0041","0084","458","193","265","18","476","976","0","48.77","19.77"
"10","015","00","010","0041","0085","499","178","321","25","524","1054","0","49.72","16.89"
"10","015","00","010","0041","0086","465","178","287","21","486","967","0","50.26","18.41"
"10","015","00","010","0042","0000","1048","438","610","81","1129","2347","0","48.10","18.66"
"10","015","00","010","0042","0046","535","232","303","40","575","1184","0","48.56","19.59"
"10","015","00","010","0042","0047","513","206","307","41","554","1163","0","47.64","17.71"
"10","015","00","010","0043","0000","1504","651","853","70","1574","3504","0","44.92","18.58"
"10","015","00","010","0043","0072","366","158","208","17","383","878","0","43.62","18.00"
"10","015","00","010","0043","0073","372","163","209","26","398","825","0","48.24","19.76"
"10","015","00","010","0043","0074","364","164","200","19","383","899","0","42.60","18.24"
"10","015","00","010","0043","0075","402","166","236","8","410","902","0","45.45","18.40"
"10","015","00","010","0044","0000","1915","747","1168","83","1998","4098","0","48.76","18.23"
"10","015","00","010","0044","0088","502","197","305","19","521","962","0","54.16","20.48"
"10","015","00","010","0044","0089","529","213","316","22","551","1103","0","49.95","19.31"
"10","015","00","010","0044","0090","450","172","278","23","473","1105","0","42.81","15.57"
"10","015","00","010","0044","0091","434","165","269","19","453","928","0","48.81","17.78"
"10","015","00","010","0045","0000","1553","579","974","106","1659","3229","0","51.38","17.93"
"10","015","00","010","0045","0013","491","198","293","29","520","1050","0","49.52","18.86"
"10","015","00","010","0045","0014","460","176","284","32","492","1016","0","48.43","17.32"
"10","015","00","010","0045","0015","602","205","397","45","647","1163","0","55.63","17.63"
"10","015","00","020","0000","0000","5326","2165","3161","660","5986","9143","10564","65.47","23.68"
"10","015","00","020","0001","0000","641","268","373","36","677","1129","0","59.96","23.74"
"10","015","00","020","0001","0226","641","268","373","36","677","1129","0","59.96","23.74"
"10","015","00","020","0002","0000","354","117","237","46","400","595","0","67.23","19.66"
"10","015","00","020","0002","0227","354","117","237","46","400","595","0","67.23","19.66"
"10","015","00","020","0003","0000","410","168","242","45","455","552","0","82.43","30.43"
"10","015","00","020","0003","0228","410","168","242","45","455","552","0","82.43","30.43"
"10","015","00","020","0004","0000","684","242","442","69","753","1017","0","74.04","23.80"
"10","015","00","020","0004","0229","684","242","442","69","753","1017","0","74.04","23.80"
"10","015","00","020","0005","0000","738","262","476","99","837","1290","0","64.88","20.31"
"10","015","00","020","0005","0230","384","126","258","54","438","713","0","61.43","17.67"
"10","015","00","020","0005","0231","354","136","218","45","399","577","0","69.15","23.57"
"10","015","00","020","0006","0000","213","91","122","47","260","527","0","49.34","17.27"
"10","015","00","020","0006","0232","154","70","84","36","190","294","0","64.63","23.81"
"10","015","00","020","0006","0233","59","21","38","11","70","233","0","30.04","9.01"
"10","015","00","020","0007","0000","695","320","375","100","795","1203","0","66.08","26.60"
"10","015","00","020","0007","0234","406","196","210","59","465","703","0","66.15","27.88"
"10","015","00","020","0007","0235","289","124","165","41","330","500","0","66.00","24.80"
"10","015","00","020","0008","0000","344","159","185","47","391","521","0","75.05","30.52"
"10","015","00","020","0008","0236","344","159","185","47","391","521","0","75.05","30.52"
"10","015","00","020","0009","0000","234","100","134","46","280","511","0","54.79","19.57"
"10","015","00","020","0009","0237","234","100","134","46","280","511","0","54.79","19.57"
"10","015","00","020","0010","0000","439","169","270","48","487","778","0","62.60","21.72"
"10","015","00","020","0010","0238","439","169","270","48","487","778","0","62.60","21.72"
"10","015","00","020","0011","0000","529","258","271","71","600","939","0","63.90","27.48"
"10","015","00","020","0011","0239","529","258","271","71","600","939","0","63.90","27.48"
"10","015","00","020","0012","0000","45","11","34","6","51","81","0","62.96","13.58"
"10","015","00","020","0012","0240","45","11","34","6","51","81","0","62.96","13.58"
"10","015","00","030","0000","0000","8968","3767","5201","1453","10421","19222","22465","54.21","19.60"
"10","015","00","030","0001","0000","2685","1122","1563","255","2940","4897","0","60.04","22.91"
"10","015","00","030","0001","0285","520","243","277","47","567","1000","0","56.70","24.30"
"10","015","00","030","0001","0286","503","193","310","37","540","856","0","63.08","22.55"
"10","015","00","030","0001","0287","336","169","167","38","374","586","0","63.82","28.84"
"10","015","00","030","0001","0288","430","166","264","38","468","822","0","56.93","20.19"
"10","015","00","030","0001","0289","423","160","263","34","457","736","0","62.09","21.74"
"10","015","00","030","0001","0290","473","191","282","61","534","897","0","59.53","21.29"
"10","015","00","030","0002","0000","699","312","387","97","796","1493","0","53.32","20.90"
"10","015","00","030","0002","0292","363","163","200","40","403","769","0","52.41","21.20"
"10","015","00","030","0002","0293","336","149","187","57","393","724","0","54.28","20.58"
"10","015","00","030","0003","0000","458","193","265","52","510","1158","0","44.04","16.67"
"10","015","00","030","0003","0296","229","101","128","27","256","490","0","52.24","20.61"
"10","015","00","030","0003","0297","229","92","137","25","254","668","0","38.02","13.77"
"10","015","00","030","0004","0000","440","157","283","40","480","1211","0","39.64","12.96"
"10","015","00","030","0004","0294","230","93","137","17","247","506","0","48.81","18.38"
"10","015","00","030","0004","0295","210","64","146","23","233","705","0","33.05","9.08"
"10","015","00","030","0005","0000","620","258","362","51","671","1093","0","61.39","23.60"
"10","015","00","030","0005","0291","620","258","362","51","671","1093","0","61.39","23.60"
"10","015","00","030","0006","0000","429","189","240","52","481","1181","0","40.73","16.00"
"10","015","00","030","0006","0298","429","189","240","52","481","1181","0","40.73","16.00"
"10","015","00","030","0007","0000","262","128","134","55","317","588","0","53.91","21.77"
"10","015","00","030","0007","0299","262","128","134","55","317","588","0","53.91","21.77"
"10","015","00","030","0008","0000","440","150","290","111","551","929","0","59.31","16.15"
"10","015","00","030","0008","0300","440","150","290","111","551","929","0","59.31","16.15"
"10","015","00","030","0009","0000","140","62","78","12","152","491","0","30.96","12.63"
"10","015","00","030","0009","0301","140","62","78","12","152","491","0","30.96","12.63"
"10","015","00","030","0010","0000","596","267","329","165","761","1454","0","52.34","18.36"
"10","015","00","030","0010","0302","383","177","206","99","482","929","0","51.88","19.05"
"10","015","00","030","0010","0303","213","90","123","66","279","525","0","53.14","17.14"
"10","015","00","030","0011","0000","555","234","321","186","741","1378","0","53.77","16.98"
"10","015","00","030","0011","0304","182","56","126","52","234","397","0","58.94","14.11"
"10","015","00","030","0011","0305","373","178","195","134","507","981","0","51.68","18.14"
"10","015","00","030","0012","0000","389","193","196","84","473","811","0","58.32","23.80"
"10","015","00","030","0012","0306","389","193","196","84","473","811","0","58.32","23.80"
"10","015","00","030","0013","0000","389","108","281","88","477","721","0","66.16","14.98"
"10","015","00","030","0013","0307","389","108","281","88","477","721","0","66.16","14.98"
"10","015","00","030","0014","0000","367","175","192","115","482","844","0","57.11","20.73"
"10","015","00","030","0014","0308","367","175","192","115","482","844","0","57.11","20.73"
"10","015","00","030","0015","0000","499","219","280","90","589","973","0","60.53","22.51"
"10","015","00","030","0015","0309","499","219","280","90","589","973","0","60.53","22.51"
"10","015","00","040","0000","0000","8582","3712","4870","762","9344","17105","20307","54.63","21.70"
"10","015","00","040","0001","0000","620","282","338","45","665","1170","0","56.84","24.10"
"10","015","00","040","0001","0094","207","88","119","16","223","318","0","70.13","27.67"
"10","015","00","040","0001","0095","413","194","219","29","442","852","0","51.88","22.77"
"10","015","00","040","0002","0000","537","296","241","54","591","839","0","70.44","35.28"
"10","015","00","040","0002","0096","367","194","173","36","403","566","0","71.20","34.28"
"10","015","00","040","0002","0097","170","102","68","18","188","273","0","68.86","37.36"
"10","015","00","040","0003","0000","1203","516","687","113","1316","2335","0","56.36","22.10"
"10","015","00","040","0003","0098","424","171","253","40","464","799","0","58.07","21.40"
"10","015","00","040","0003","0099","421","199","222","45","466","801","0","58.18","24.84"
"10","015","00","040","0003","0100","358","146","212","28","386","735","0","52.52","19.86"
"10","015","00","040","0004","0000","1520","628","892","108","1628","3051","0","53.36","20.58"
"10","015","00","040","0004","0106","505","211","294","44","549","942","0","58.28","22.40"
"10","015","00","040","0004","0107","509","221","288","47","556","986","0","56.39","22.41"
"10","015","00","040","0004","0108","506","196","310","17","523","1123","0","46.57","17.45"
"10","015","00","040","0005","0000","506","224","282","32","538","939","0","57.29","23.86"
"10","015","00","040","0005","0109","506","224","282","32","538","939","0","57.29","23.86"
"10","015","00","040","0006","0000","1737","739","998","127","1864","3664","0","50.87","20.17"
"10","015","00","040","0006","0110","422","207","215","31","453","936","0","48.40","22.12"
"10","015","00","040","0006","0111","448","176","272","37","485","898","0","54.01","19.60"
"10","015","00","040","0006","0112","419","162","257","40","459","827","0","55.50","19.59"
"10","015","00","040","0006","0113","448","194","254","19","467","1003","0","46.56","19.34"
"10","015","00","040","0007","0000","578","258","320","99","677","1191","0","56.84","21.66"
"10","015","00","040","0007","0114","416","193","223","68","484","846","0","57.21","22.81"
"10","015","00","040","0007","0115","162","65","97","31","193","345","0","55.94","18.84"
"10","015","00","040","0008","0000","1128","434","694","135","1263","2398","0","52.67","18.10"
"10","015","00","040","0008","0101","467","186","281","61","528","959","0","55.06","19.40"
"10","015","00","040","0008","0102","527","184","343","50","577","1130","0","51.06","16.28"
"10","015","00","040","0008","0103","134","64","70","24","158","309","0","51.13","20.71"
"10","015","00","040","0009","0000","753","335","418","49","802","1518","0","52.83","22.07"
"10","015","00","040","0009","0104","349","159","190","17","366","710","0","51.55","22.39"
"10","015","00","040","0009","0105","404","176","228","32","436","808","0","53.96","21.78"
"10","015","00","050","0000","0000","32903","13424","19479","2151","35054","70642","82629","49.62","19.00"
"10","015","00","050","0001","0000","3084","1292","1792","126","3210","6804","0","47.18","18.99"
"10","015","00","050","0001","0173","395","179","216","22","417","998","0","41.78","17.94"
"10","015","00","050","0001","0174","480","177","303","13","493","999","0","49.35","17.72"
"10","015","00","050","0001","0175","482","209","273","7","489","997","0","49.05","20.96"
"10","015","00","050","0001","0176","419","189","230","22","441","955","0","46.18","19.79"
"10","015","00","050","0001","0177","471","175","296","23","494","997","0","49.55","17.55"
"10","015","00","050","0001","0178","407","169","238","20","427","918","0","46.51","18.41"
"10","015","00","050","0001","0179","430","194","236","19","449","940","0","47.77","20.64"
"10","015","00","050","0002","0000","2308","946","1362","112","2420","4795","0","50.47","19.73"
"10","015","00","050","0002","0180","584","222","362","29","613","1203","0","50.96","18.45"
"10","015","00","050","0002","0181","577","241","336","35","612","1210","0","50.58","19.92"
"10","015","00","050","0002","0182","433","162","271","20","453","861","0","52.61","18.82"
"10","015","00","050","0002","0183","369","175","194","16","385","794","0","48.49","22.04"
"10","015","00","050","0002","0184","345","146","199","12","357","727","0","49.11","20.08"
"10","015","00","050","0003","0000","1513","705","808","114","1627","3570","0","45.57","19.75"
"10","015","00","050","0003","0138","502","239","263","45","547","1191","0","45.93","20.07"
"10","015","00","050","0003","0139","553","267","286","36","589","1248","0","47.20","21.39"
"10","015","00","050","0003","0140","458","199","259","33","491","1131","0","43.41","17.60"
"10","015","00","050","0004","0000","1713","710","1003","124","1837","4143","0","44.34","17.14"
"10","015","00","050","0004","0134","394","166","228","30","424","1005","0","42.19","16.52"
"10","015","00","050","0004","0135","441","157","284","29","470","1015","0","46.31","15.47"
"10","015","00","050","0004","0136","439","174","265","29","468","1025","0","45.66","16.98"
"10","015","00","050","0004","0137","439","213","226","36","475","1098","0","43.26","19.40"
"10","015","00","050","0005","0000","3200","1326","1874","217","3417","6799","0","50.26","19.50"
"10","015","00","050","0005","0141","638","272","366","32","670","1246","0","53.77","21.83"
"10","015","00","050","0005","0142","488","199","289","34","522","1106","0","47.20","17.99"
"10","015","00","050","0005","0143","476","193","283","37","513","988","0","51.92","19.53"
"10","015","00","050","0005","0144","526","229","297","22","548","1152","0","47.57","19.88"
"10","015","00","050","0005","0145","532","219","313","59","591","1165","0","50.73","18.80"
"10","015","00","050","0005","0146","540","214","326","33","573","1142","0","50.18","18.74"
"10","015","00","050","0006","0000","2211","876","1335","109","2320","5198","0","44.63","16.85"
"10","015","00","050","0006","0147","408","180","228","42","450","977","0","46.06","18.42"
"10","015","00","050","0006","0148","301","121","180","9","310","580","0","53.45","20.86"
"10","015","00","050","0006","0149","409","152","257","16","425","848","0","50.12","17.92"
"10","015","00","050","0006","0150","361","135","226","15","376","806","0","46.65","16.75"
"10","015","00","050","0006","0151","330","130","200","15","345","932","0","37.02","13.95"
"10","015","00","050","0006","0152","402","158","244","12","414","1055","0","39.24","14.98"
"10","015","00","050","0007","0000","1444","631","813","103","1547","2878","0","53.75","21.92"
"10","015","00","050","0007","0153","519","206","313","47","566","1067","0","53.05","19.31"
"10","015","00","050","0007","0154","458","216","242","25","483","927","0","52.10","23.30"
"10","015","00","050","0007","0155","467","209","258","31","498","884","0","56.33","23.64"
"10","015","00","050","0008","0000","737","331","406","85","822","1505","0","54.62","21.99"
"10","015","00","050","0008","0156","391","188","203","38","429","773","0","55.50","24.32"
"10","015","00","050","0008","0157","346","143","203","47","393","732","0","53.69","19.54"
"10","015","00","050","0009","0000","486","182","304","45","531","1262","0","42.08","14.42"
"10","015","00","050","0009","0158","486","182","304","45","531","1262","0","42.08","14.42"
"10","015","00","050","0010","0000","1341","546","795","110","1451","2885","0","50.29","18.93"
"10","015","00","050","0010","0159","470","185","285","40","510","893","0","57.11","20.72"
"10","015","00","050","0010","0160","440","198","242","35","475","916","0","51.86","21.62"
"10","015","00","050","0010","0161","431","163","268","35","466","1076","0","43.31","15.15"
"10","015","00","050","0011","0000","1592","631","961","113","1705","3118","0","54.68","20.24"
"10","015","00","050","0011","0162","467","178","289","20","487","936","0","52.03","19.02"
"10","015","00","050","0011","0163","508","201","307","36","544","976","0","55.74","20.59"
"10","015","00","050","0011","0164","617","252","365","57","674","1206","0","55.89","20.90"
"10","015","00","050","0012","0000","1899","718","1181","109","2008","4008","0","50.10","17.91"
"10","015","00","050","0012","0165","551","194","357","34","585","1092","0","53.57","17.77"
"10","015","00","050","0012","0166","526","176","350","28","554","1113","0","49.78","15.81"
"10","015","00","050","0012","0167","401","165","236","23","424","915","0","46.34","18.03"
"10","015","00","050","0012","0168","421","183","238","24","445","888","0","50.11","20.61"
"10","015","00","050","0013","0000","1896","759","1137","117","2013","3834","0","52.50","19.80"
"10","015","00","050","0013","0169","497","180","317","21","518","986","0","52.54","18.26"
"10","015","00","050","0013","0170","447","180","267","29","476","989","0","48.13","18.20"
"10","015","00","050","0013","0171","478","192","286","37","515","969","0","53.15","19.81"
"10","015","00","050","0013","0172","474","207","267","30","504","890","0","56.63","23.26"
"10","015","00","050","0014","0000","2902","1165","1737","174","3076","5828","0","52.78","19.99"
"10","015","00","050","0014","0185","509","193","316","29","538","961","0","55.98","20.08"
"10","015","00","050","0014","0186","468","179","289","20","488","960","0","50.83","18.65"
"10","015","00","050","0014","0187","367","152","215","20","387","753","0","51.39","20.19"
"10","015","00","050","0014","0188","517","207","310","37","554","1099","0","50.41","18.84"
"10","015","00","050","0014","0189","552","232","320","34","586","1072","0","54.66","21.64"
"10","015","00","050","0014","0190","489","202","287","34","523","983","0","53.20","20.55"
"10","015","00","050","0015","0000","2635","999","1636","174","2809","5349","0","52.51","18.68"
"10","015","00","050","0015","0191","555","216","339","24","579","1081","0","53.56","19.98"
"10","015","00","050","0015","0192","483","174","309","28","511","948","0","53.90","18.35"
"10","015","00","050","0015","0193","522","194","328","39","561","1003","0","55.93","19.34"
"10","015","00","050","0015","0194","511","195","316","39","550","1092","0","50.37","17.86"
"10","015","00","050","0015","0195","564","220","344","44","608","1225","0","49.63","17.96"
"10","015","00","050","0016","0000","1024","459","565","101","1125","2333","0","48.22","19.67"
"10","015","00","050","0016","0196","472","220","252","47","519","1122","0","46.26","19.61"
"10","015","00","050","0016","0197","552","239","313","54","606","1211","0","50.04","19.74"
"10","015","00","050","0017","0000","1914","778","1136","140","2054","4415","0","46.52","17.62"
"10","015","00","050","0017","0198","464","192","272","24","488","943","0","51.75","20.36"
"10","015","00","050","0017","0199","347","140","207","17","364","810","0","44.94","17.28"
"10","015","00","050","0017","0200","396","179","217","38","434","900","0","48.22","19.89"
"10","015","00","050","0017","0201","294","91","203","11","305","788","0","38.71","11.55"
"10","015","00","050","0017","0202","413","176","237","50","463","974","0","47.54","18.07"
"10","015","00","050","0018","0000","1004","370","634","78","1082","1918","0","56.41","19.29"
"10","015","00","050","0018","0203","444","166","278","26","470","916","0","51.31","18.12"
"10","015","00","050","0018","0204","560","204","356","52","612","1002","0","61.08","20.36"
"10","015","00","060","0000","0000","8297","3705","4592","1021","9318","15058","17184","61.88","24.60"
"10","015","00","060","0001","0000","172","73","99","28","200","323","0","61.92","22.60"
"10","015","00","060","0001","0206","172","73","99","28","200","323","0","61.92","22.60"
"10","015","00","060","0002","0000","518","213","305","91","609","980","0","62.14","21.73"
"10","015","00","060","0002","0205","518","213","305","91","609","980","0","62.14","21.73"
"10","015","00","060","0003","0000","1049","465","584","128","1177","1815","0","64.85","25.62"
"10","015","00","060","0003","0207","517","230","287","69","586","954","0","61.43","24.11"
"10","015","00","060","0003","0208","532","235","297","59","591","861","0","68.64","27.29"
"10","015","00","060","0004","0000","680","285","395","83","763","1266","0","60.27","22.51"
"10","015","00","060","0004","0209","342","147","195","45","387","605","0","63.97","24.30"
"10","015","00","060","0004","0210","338","138","200","38","376","661","0","56.88","20.88"
"10","015","00","060","0005","0000","435","205","230","74","509","861","0","59.12","23.81"
"10","015","00","060","0005","0211","435","205","230","74","509","861","0","59.12","23.81"
"10","015","00","060","0006","0000","430","182","248","43","473","711","0","66.53","25.60"
"10","015","00","060","0006","0214","430","182","248","43","473","711","0","66.53","25.60"
"10","015","00","060","0007","0000","925","394","531","87","1012","1584","0","63.89","24.87"
"10","015","00","060","0007","0212","426","199","227","35","461","715","0","64.48","27.83"
"10","015","00","060","0007","0213","499","195","304","52","551","869","0","63.41","22.44"
"10","015","00","060","0008","0000","438","160","278","80","518","751","0","68.97","21.30"
"10","015","00","060","0008","0215","438","160","278","80","518","751","0","68.97","21.30"
"10","015","00","060","0009","0000","307","138","169","33","340","706","0","48.16","19.55"
"10","015","00","060","0009","0216","307","138","169","33","340","706","0","48.16","19.55"
"10","015","00","060","0010","0000","773","388","385","77","850","1367","0","62.18","28.38"
"10","015","00","060","0010","0217","563","286","277","47","610","963","0","63.34","29.70"
"10","015","00","060","0010","0218","210","102","108","30","240","404","0","59.41","25.25"
"10","015","00","060","0011","0000","1418","684","734","118","1536","2466","0","62.29","27.74"
"10","015","00","060","0011","0219","489","206","283","45","534","811","0","65.84","25.40"
"10","015","00","060","0011","0220","572","311","261","39","611","1000","0","61.10","31.10"
"10","015","00","060","0011","0221","357","167","190","34","391","655","0","59.69","25.50"
"10","015","00","060","0012","0000","159","87","72","30","189","259","0","72.97","33.59"
"10","015","00","060","0012","0222","159","87","72","30","189","259","0","72.97","33.59"
"10","015","00","060","0013","0000","334","134","200","38","372","805","0","46.21","16.65"
"10","015","00","060","0013","0223","334","134","200","38","372","805","0","46.21","16.65"
"10","015","00","060","0014","0000","343","160","183","77","420","671","0","62.59","23.85"
"10","015","00","060","0014","0225","343","160","183","77","420","671","0","62.59","23.85"
"10","015","00","060","0015","0000","316","137","179","34","350","493","0","70.99","27.79"
"10","015","00","060","0015","0224","316","137","179","34","350","493","0","70.99","27.79"
"10","015","00","070","0000","0000","5786","2041","3745","763","6549","10630","12026","61.61","19.20"
"10","015","00","070","0001","0000","403","165","238","17","420","784","0","53.57","21.05"
"10","015","00","070","0001","0242","403","165","238","17","420","784","0","53.57","21.05"
"10","015","00","070","0002","0000","639","271","368","32","671","1223","0","54.87","22.16"
"10","015","00","070","0002","0241","639","271","368","32","671","1223","0","54.87","22.16"
"10","015","00","070","0003","0000","552","183","369","51","603","902","0","66.85","20.29"
"10","015","00","070","0003","0243","552","183","369","51","603","902","0","66.85","20.29"
"10","015","00","070","0004","0000","512","155","357","85","597","966","0","61.80","16.05"
"10","015","00","070","0004","0244","512","155","357","85","597","966","0","61.80","16.05"
"10","015","00","070","0005","0000","573","200","373","84","657","994","0","66.10","20.12"
"10","015","00","070","0005","0245","573","200","373","84","657","994","0","66.10","20.12"
"10","015","00","070","0006","0000","230","74","156","24","254","423","0","60.05","17.49"
"10","015","00","070","0006","0252","230","74","156","24","254","423","0","60.05","17.49"
"10","015","00","070","0007","0000","431","179","252","70","501","740","0","67.70","24.19"
"10","015","00","070","0007","0253","371","159","212","59","430","615","0","69.92","25.85"
"10","015","00","070","0007","0254","60","20","40","11","71","125","0","56.80","16.00"
"10","015","00","070","0008","0000","241","85","156","27","268","436","0","61.47","19.50"
"10","015","00","070","0008","0255","241","85","156","27","268","436","0","61.47","19.50"
"10","015","00","070","0009","0000","182","83","99","28","210","293","0","71.67","28.33"
"10","015","00","070","0009","0256","182","83","99","28","210","293","0","71.67","28.33"
"10","015","00","070","0010","0000","241","116","125","32","273","404","0","67.57","28.71"
"10","015","00","070","0010","0257","241","116","125","32","273","404","0","67.57","28.71"
"10","015","00","070","0011","0000","496","139","357","84","580","949","0","61.12","14.65"
"10","015","00","070","0011","0246","430","118","312","68","498","765","0","65.10","15.42"
"10","015","00","070","0011","0247","66","21","45","16","82","184","0","44.57","11.41"
"10","015","00","070","0012","0000","431","143","288","71","502","865","0","58.03","16.53"
"10","015","00","070","0012","0248","239","81","158","32","271","452","0","59.96","17.92"
"10","015","00","070","0012","0249","192","62","130","39","231","413","0","55.93","15.01"
"10","015","00","070","0013","0000","413","116","297","77","490","805","0","60.87","14.41"
"10","015","00","070","0013","0250","413","116","297","77","490","805","0","60.87","14.41"
"10","015","00","070","0014","0000","442","132","310","81","523","846","0","61.82","15.60"
"10","015","00","070","0014","0251","442","132","310","81","523","846","0","61.82","15.60"
"10","015","00","080","0000","0000","1981","708","1273","439","2420","3921","4327","61.72","18.06"
"10","015","00","080","0001","0000","776","261","515","183","959","1576","0","60.85","16.56"
"10","015","00","080","0001","0260","351","116","235","55","406","657","0","61.80","17.66"
"10","015","00","080","0001","0261","310","108","202","74","384","597","0","64.32","18.09"
"10","015","00","080","0001","0262","115","37","78","54","169","322","0","52.48","11.49"
"10","015","00","080","0002","0000","311","106","205","79","390","600","0","65.00","17.67"
"10","015","00","080","0002","0263","311","106","205","79","390","600","0","65.00","17.67"
"10","015","00","080","0003","0000","253","66","187","39","292","388","0","75.26","17.01"
"10","015","00","080","0003","0264","253","66","187","39","292","388","0","75.26","17.01"
"10","015","00","080","0004","0000","446","189","257","112","558","740","0","75.41","25.54"
"10","015","00","080","0004","0259","446","189","257","112","558","740","0","75.41","25.54"
"10","015","00","080","0005","0000","195","86","109","26","221","617","0","35.82","13.94"
"10","015","00","080","0005","0258","195","86","109","26","221","617","0","35.82","13.94"
"10","015","00","090","0000","0000","5103","2060","3043","715","5818","9593","11009","60.65","21.47"
"10","015","00","090","0001","0000","987","404","583","68","1055","1750","0","60.29","23.09"
"10","015","00","090","0001","0272","443","180","263","31","474","740","0","64.05","24.32"
"10","015","00","090","0001","0273","544","224","320","37","581","1010","0","57.52","22.18"
"10","015","00","090","0002","0000","1048","427","621","103","1151","1805","0","63.77","23.66"
"10","015","00","090","0002","0274","496","204","292","39","535","860","0","62.21","23.72"
"10","015","00","090","0002","0275","552","223","329","64","616","945","0","65.19","23.60"
"10","015","00","090","0003","0000","305","124","181","41","346","493","0","70.18","25.15"
"10","015","00","090","0003","0276","305","124","181","41","346","493","0","70.18","25.15"
"10","015","00","090","0004","0000","493","207","286","50","543","879","0","61.77","23.55"
"10","015","00","090","0004","0277","493","207","286","50","543","879","0","61.77","23.55"
"10","015","00","090","0005","0000","243","102","141","29","272","554","0","49.10","18.41"
"10","015","00","090","0005","0278","243","102","141","29","272","554","0","49.10","18.41"
"10","015","00","090","0006","0000","489","214","275","75","564","896","0","62.95","23.88"
"10","015","00","090","0006","0279","489","214","275","75","564","896","0","62.95","23.88"
"10","015","00","090","0007","0000","488","161","327","99","587","836","0","70.22","19.26"
"10","015","00","090","0007","0280","488","161","327","99","587","836","0","70.22","19.26"
"10","015","00","090","0008","0000","72","30","42","10","82","313","0","26.20","9.58"
"10","015","00","090","0008","0281","72","30","42","10","82","313","0","26.20","9.58"
"10","015","00","090","0009","0000","338","150","188","98","436","703","0","62.02","21.34"
"10","015","00","090","0009","0282","338","150","188","98","436","703","0","62.02","21.34"
"10","015","00","090","0010","0000","369","122","247","65","434","803","0","54.05","15.19"
"10","015","00","090","0010","0283","369","122","247","65","434","803","0","54.05","15.19"
"10","015","00","090","0011","0000","271","119","152","77","348","561","0","62.03","21.21"
"10","015","00","090","0011","0284","271","119","152","77","348","561","0","62.03","21.21"
"10","015","00","100","0000","0000","4305","1907","2398","622","4927","8542","9715","57.68","22.32"
"10","015","00","100","0001","0000","240","93","147","46","286","456","0","62.72","20.39"
"10","015","00","100","0001","0310","240","93","147","46","286","456","0","62.72","20.39"
"10","015","00","100","0002","0000","477","246","231","68","545","950","0","57.37","25.89"
"10","015","00","100","0002","0311","477","246","231","68","545","950","0","57.37","25.89"
"10","015","00","100","0003","0000","277","133","144","56","333","583","0","57.12","22.81"
"10","015","00","100","0003","0312","277","133","144","56","333","583","0","57.12","22.81"
"10","015","00","100","0004","0000","269","135","134","56","325","583","0","55.75","23.16"
"10","015","00","100","0004","0313","269","135","134","56","325","583","0","55.75","23.16"
"10","015","00","100","0005","0000","383","131","252","27","410","1018","0","40.28","12.87"
"10","015","00","100","0005","0314","383","131","252","27","410","1018","0","40.28","12.87"
"10","015","00","100","0006","0000","243","109","134","31","274","423","0","64.78","25.77"
"10","015","00","100","0006","0315","243","109","134","31","274","423","0","64.78","25.77"
"10","015","00","100","0007","0000","499","202","297","65","564","849","0","66.43","23.79"
"10","015","00","100","0007","0316","499","202","297","65","564","849","0","66.43","23.79"
"10","015","00","100","0008","0000","206","93","113","26","232","349","0","66.48","26.65"
"10","015","00","100","0008","0317","206","93","113","26","232","349","0","66.48","26.65"
"10","015","00","100","0009","0000","665","316","349","60","725","1281","0","56.60","24.67"
"10","015","00","100","0009","0318","665","316","349","60","725","1281","0","56.60","24.67"
"10","015","00","100","0010","0000","252","119","133","29","281","425","0","66.12","28.00"
"10","015","00","100","0010","0319","252","119","133","29","281","425","0","66.12","28.00"
"10","015","00","100","0011","0000","302","128","174","68","370","579","0","63.90","22.11"
"10","015","00","100","0011","0320","302","128","174","68","370","579","0","63.90","22.11"
"10","015","00","100","0012","0000","160","55","105","25","185","451","0","41.02","12.20"
"10","015","00","100","0012","0321","160","55","105","25","185","451","0","41.02","12.20"
"10","015","00","100","0013","0000","332","147","185","65","397","595","0","66.72","24.71"
"10","015","00","100","0013","0322","332","147","185","65","397","595","0","66.72","24.71"
"10","015","00","110","0000","0000","7275","3260","4015","705","7980","13057","16903","61.12","24.97"
"10","015","00","110","0001","0000","619","269","350","55","674","1410","0","47.80","19.08"
"10","015","00","110","0001","0118","253","104","149","10","263","743","0","35.40","14.00"
"10","015","00","110","0001","0119","366","165","201","45","411","667","0","61.62","24.74"
"10","015","00","110","0002","0000","1139","539","600","119","1258","1884","0","66.77","28.61"
"10","015","00","110","0002","0120","525","226","299","51","576","883","0","65.23","25.59"
"10","015","00","110","0002","0121","524","275","249","62","586","845","0","69.35","32.54"
"10","015","00","110","0002","0122","90","38","52","6","96","156","0","61.54","24.36"
"10","015","00","110","0003","0000","986","465","521","88","1074","1769","0","60.71","26.29"
"10","015","00","110","0003","0123","201","91","110","29","230","388","0","59.28","23.45"
"10","015","00","110","0003","0124","323","160","163","22","345","584","0","59.08","27.40"
"10","015","00","110","0003","0125","462","214","248","37","499","797","0","62.61","26.85"
"10","015","00","110","0004","0000","669","287","382","63","732","1209","0","60.55","23.74"
"10","015","00","110","0004","0129","669","287","382","63","732","1209","0","60.55","23.74"
"10","015","00","110","0005","0000","643","238","405","56","699","1203","0","58.10","19.78"
"10","015","00","110","0005","0130","315","121","194","31","346","715","0","48.39","16.92"
"10","015","00","110","0005","0131","328","117","211","25","353","488","0","72.34","23.98"
"10","015","00","110","0006","0000","495","210","285","27","522","1116","0","46.77","18.82"
"10","015","00","110","0006","0132","333","135","198","11","344","804","0","42.79","16.79"
"10","015","00","110","0006","0133","162","75","87","16","178","312","0","57.05","24.04"
"10","015","00","110","0007","0000","1107","511","596","143","1250","1807","0","69.18","28.28"
"10","015","00","110","0007","0126","675","301","374","91","766","1144","0","66.96","26.31"
"10","015","00","110","0007","0127","432","210","222","52","484","663","0","73.00","31.67"
"10","015","00","110","0008","0000","617","259","358","56","673","1051","0","64.03","24.64"
"10","015","00","110","0008","0128","617","259","358","56","673","1051","0","64.03","24.64"
"10","015","00","110","0009","0000","1000","482","518","98","1098","1608","0","68.28","29.98"
"10","015","00","110","0009","0116","613","288","325","38","651","982","0","66.29","29.33"
"10","015","00","110","0009","0117","387","194","193","60","447","626","0","71.41","30.99"
"10","015","00","120","0000","0000","3063","1364","1699","392","3455","4963","6171","69.62","27.48"
"10","015","00","120","0001","0000","632","265","367","90","722","1015","0","71.13","26.11"
"10","015","00","120","0001","0265","632","265","367","90","722","1015","0","71.13","26.11"
"10","015","00","120","0002","0000","347","148","199","26","373","493","0","75.66","30.02"
"10","015","00","120","0002","0266","347","148","199","26","373","493","0","75.66","30.02"
"10","015","00","120","0003","0000","499","293","206","64","563","741","0","75.98","39.54"
"10","015","00","120","0003","0267","499","293","206","64","563","741","0","75.98","39.54"
"10","015","00","120","0004","0000","408","199","209","55","463","630","0","73.49","31.59"
"10","015","00","120","0004","0268","408","199","209","55","463","630","0","73.49","31.59"
"10","015","00","120","0005","0000","580","189","391","78","658","1049","0","62.73","18.02"
"10","015","00","120","0005","0269","275","79","196","29","304","415","0","73.25","19.04"
"10","015","00","120","0005","0270","305","110","195","49","354","634","0","55.84","17.35"
"10","015","00","120","0006","0000","597","270","327","79","676","1035","0","65.31","26.09"
"10","015","00","120","0006","0271","597","270","327","79","676","1035","0","65.31","26.09"
"10","015","00","130","0000","0000","2651","991","1660","346","2997","4765","6049","62.90","20.80"
"10","015","00","130","0001","0000","315","125","190","57","372","521","0","71.40","23.99"
"10","015","00","130","0001","0323","315","125","190","57","372","521","0","71.40","23.99"
"10","015","00","130","0002","0000","640","316","324","94","734","945","0","77.67","33.44"
"10","015","00","130","0002","0324","344","171","173","43","387","496","0","78.02","34.48"
"10","015","00","130","0002","0325","296","145","151","51","347","449","0","77.28","32.29"
"10","015","00","130","0003","0000","378","108","270","24","402","694","0","57.93","15.56"
"10","015","00","130","0003","0326","378","108","270","24","402","694","0","57.93","15.56"
"10","015","00","130","0004","0000","227","59","168","12","239","722","0","33.10","8.17"
"10","015","00","130","0004","0327","227","59","168","12","239","722","0","33.10","8.17"
"10","015","00","130","0005","0000","526","193","333","89","615","977","0","62.95","19.75"
"10","015","00","130","0005","0328","348","132","216","48","396","601","0","65.89","21.96"
"10","015","00","130","0005","0329","178","61","117","41","219","376","0","58.24","16.22"
"10","015","00","130","0006","0000","565","190","375","70","635","906","0","70.09","20.97"
"10","015","00","130","0006","0330","192","64","128","22","214","321","0","66.67","19.94"
"10","015","00","130","0006","0331","285","94","191","29","314","412","0","76.21","22.82"
"10","015","00","130","0006","0332","88","32","56","19","107","173","0","61.85","18.50"
"10","014","00","000","0000","0000","95985","41642","54343","10839","106824","178589","212712","59.82","23.32"
"10","014","00","010","0000","0000","46744","20285","26459","4017","50761","84683","103239","59.94","23.95"
"10","014","00","010","0001","0000","1015","437","578","179","1194","2208","0","54.08","19.79"
"10","014","00","010","0001","0045","441","184","257","88","529","794","0","66.62","23.17"
"10","014","00","010","0001","0046","322","164","158","42","364","829","0","43.91","19.78"
"10","014","00","010","0001","0047","252","89","163","49","301","585","0","51.45","15.21"
"10","014","00","010","0003","0000","1063","433","630","111","1174","2168","0","54.15","19.97"
"10","014","00","010","0003","0037","562","227","335","49","611","1067","0","57.26","21.27"
"10","014","00","010","0003","0038","501","206","295","62","563","1101","0","51.14","18.71"
"10","014","00","010","0004","0000","1560","611","949","111","1671","2747","0","60.83","22.24"
"10","014","00","010","0004","0042","562","231","331","36","598","934","0","64.03","24.73"
"10","014","00","010","0004","0043","509","185","324","37","546","869","0","62.83","21.29"
"10","014","00","010","0004","0044","489","195","294","38","527","944","0","55.83","20.66"
"10","014","00","010","0005","0000","1740","811","929","65","1805","2843","0","63.49","28.53"
"10","014","00","010","0005","0039","510","214","296","1","511","856","0","59.70","25.00"
"10","014","00","010","0005","0040","548","294","254","23","571","859","0","66.47","34.23"
"10","014","00","010","0005","0041","682","303","379","41","723","1128","0","64.10","26.86"
"10","014","00","010","0006","0000","1564","654","910","176","1740","2617","0","66.49","24.99"
"10","014","00","010","0006","0034","531","226","305","44","575","832","0","69.11","27.16"
"10","014","00","010","0006","0035","481","206","275","65","546","832","0","65.63","24.76"
"10","014","00","010","0006","0036","552","222","330","67","619","953","0","64.95","23.29"
"10","014","00","010","0007","0000","1653","667","986","74","1727","3290","0","52.49","20.27"
"10","014","00","010","0007","0031","602","252","350","48","650","1083","0","60.02","23.27"
"10","014","00","010","0007","0032","596","248","348","13","609","1123","0","54.23","22.08"
"10","014","00","010","0007","0033","455","167","288","13","468","1084","0","43.17","15.41"
"10","014","00","010","0008","0000","1539","637","902","83","1622","2563","0","63.29","24.85"
"10","014","00","010","0008","0024","462","203","259","32","494","785","0","62.93","25.86"
"10","014","00","010","0008","0025","457","180","277","19","476","724","0","65.75","24.86"
"10","014","00","010","0008","0026","620","254","366","32","652","1054","0","61.86","24.10"
"10","014","00","010","0009","0000","805","380","425","59","864","1313","0","65.80","28.94"
"10","014","00","010","0009","0027","805","380","425","59","864","1313","0","65.80","28.94"
"10","014","00","010","0010","0000","1234","469","765","71","1305","2233","0","58.44","21.00"
"10","014","00","010","0010","0022","608","219","389","35","643","1102","0","58.35","19.87"
"10","014","00","010","0010","0023","626","250","376","36","662","1131","0","58.53","22.10"
"10","014","00","010","0011","0000","1588","657","931","103","1691","2817","0","60.03","23.32"
"10","014","00","010","0011","0019","439","180","259","25","464","782","0","59.34","23.02"
"10","014","00","010","0011","0020","589","239","350","32","621","1058","0","58.70","22.59"
"10","014","00","010","0011","0021","560","238","322","46","606","977","0","62.03","24.36"
"10","014","00","010","0012","0000","1728","719","1009","71","1799","2995","0","60.07","24.01"
"10","014","00","010","0012","0016","550","229","321","28","578","996","0","58.03","22.99"
"10","014","00","010","0012","0017","597","258","339","26","623","1035","0","60.19","24.93"
"10","014","00","010","0012","0018","581","232","349","17","598","964","0","62.03","24.07"
"10","014","00","010","0013","0000","1284","581","703","57","1341","2253","0","59.52","25.79"
"10","014","00","010","0013","0013","434","203","231","25","459","741","0","61.94","27.40"
"10","014","00","010","0013","0014","398","166","232","18","416","719","0","57.86","23.09"
"10","014","00","010","0013","0015","452","212","240","14","466","793","0","58.76","26.73"
"10","014","00","010","0015","0000","1262","566","696","119","1381","2197","0","62.86","25.76"
"10","014","00","010","0015","0003","675","303","372","52","727","1158","0","62.78","26.17"
"10","014","00","010","0015","0004","587","263","324","67","654","1039","0","62.95","25.31"
"10","014","00","010","0017","0000","990","442","548","145","1135","1768","0","64.20","25.00"
"10","014","00","010","0017","0011","471","196","275","74","545","852","0","63.97","23.00"
"10","014","00","010","0017","0012","519","246","273","71","590","916","0","64.41","26.86"
"10","014","00","010","0020","0000","1204","577","627","88","1292","2054","0","62.90","28.09"
"10","014","00","010","0020","0007","626","289","337","46","672","1082","0","62.11","26.71"
"10","014","00","010","0020","0008","578","288","290","42","620","972","0","63.79","29.63"
"10","014","00","010","0022","0000","1043","538","505","128","1171","1797","0","65.16","29.94"
"10","014","00","010","0022","0009","522","239","283","44","566","890","0","63.60","26.85"
"10","014","00","010","0022","0010","521","299","222","84","605","907","0","66.70","32.97"
"10","014","00","010","0023","0000","758","360","398","47","805","1620","0","49.69","22.22"
"10","014","00","010","0023","0001","338","176","162","7","345","901","0","38.29","19.53"
"10","014","00","010","0023","0002","420","184","236","40","460","719","0","63.98","25.59"
"10","014","00","010","0024","0000","1047","536","511","83","1130","1751","0","64.53","30.61"
"10","014","00","010","0024","0005","529","275","254","43","572","886","0","64.56","31.04"
"10","014","00","010","0024","0006","518","261","257","40","558","865","0","64.51","30.17"
"10","014","00","010","0029","0000","871","393","478","144","1015","1577","0","64.36","24.92"
"10","014","00","010","0029","0082","446","199","247","80","526","783","0","67.18","25.42"
"10","014","00","010","0029","0083","425","194","231","64","489","794","0","61.59","24.43"
"10","014","00","010","0030","0000","1246","583","663","128","1374","2199","0","62.48","26.51"
"10","014","00","010","0030","0080","587","270","317","56","643","1128","0","57.00","23.94"
"10","014","00","010","0030","0081","659","313","346","72","731","1071","0","68.25","29.23"
"10","014","00","010","0031","0000","1562","682","880","180","1742","3030","0","57.49","22.51"
"10","014","00","010","0031","0057","538","248","290","79","617","1061","0","58.15","23.37"
"10","014","00","010","0031","0058","526","214","312","43","569","1021","0","55.73","20.96"
"10","014","00","010","0031","0059","498","220","278","58","556","948","0","58.65","23.21"
"10","014","00","010","0032","0000","1295","527","768","77","1372","2469","0","55.57","21.34"
"10","014","00","010","0032","0054","441","192","249","28","469","821","0","57.13","23.39"
"10","014","00","010","0032","0055","466","174","292","23","489","865","0","56.53","20.12"
"10","014","00","010","0032","0056","388","161","227","26","414","783","0","52.87","20.56"
"10","014","00","010","0033","0000","894","366","528","96","990","1681","0","58.89","21.77"
"10","014","00","010","0033","0052","442","185","257","60","502","859","0","58.44","21.54"
"10","014","00","010","0033","0053","452","181","271","36","488","822","0","59.37","22.02"
"10","014","00","010","0034","0000","1415","586","829","131","1546","2595","0","59.58","22.58"
"10","014","00","010","0034","0061","436","154","282","39","475","852","0","55.75","18.08"
"10","014","00","010","0034","0062","458","209","249","54","512","867","0","59.05","24.11"
"10","014","00","010","0034","0063","521","223","298","38","559","876","0","63.81","25.46"
"10","014","00","010","0035","0000","763","328","435","99","862","1294","0","66.62","25.35"
"10","014","00","010","0035","0060","763","328","435","99","862","1294","0","66.62","25.35"
"10","014","00","010","0036","0000","1150","462","688","54","1204","1905","0","63.20","24.25"
"10","014","00","010","0036","0050","591","244","347","30","621","1004","0","61.85","24.30"
"10","014","00","010","0036","0051","559","218","341","24","583","901","0","64.71","24.20"
"10","014","00","010","0037","0000","700","325","375","58","758","1309","0","57.91","24.83"
"10","014","00","010","0037","0048","406","195","211","42","448","710","0","63.10","27.46"
"10","014","00","010","0037","0049","294","130","164","16","310","599","0","51.75","21.70"
"10","014","00","010","0038","0000","1578","694","884","112","1690","2945","0","57.39","23.57"
"10","014","00","010","0038","0067","536","229","307","60","596","1039","0","57.36","22.04"
"10","014","00","010","0038","0068","480","214","266","31","511","940","0","54.36","22.77"
"10","014","00","010","0038","0069","562","251","311","21","583","966","0","60.35","25.98"
"10","014","00","010","0039","0000","1658","632","1026","154","1812","3350","0","54.09","18.87"
"10","014","00","010","0039","0073","554","207","347","69","623","1150","0","54.17","18.00"
"10","014","00","010","0039","0074","564","219","345","56","620","1118","0","55.46","19.59"
"10","014","00","010","0039","0075","540","206","334","29","569","1082","0","52.59","19.04"
"10","014","00","010","0040","0000","1330","645","685","181","1511","2249","0","67.19","28.68"
"10","014","00","010","0040","0076","638","317","321","74","712","1059","0","67.23","29.93"
"10","014","00","010","0040","0077","692","328","364","107","799","1190","0","67.14","27.56"
"10","014","00","010","0041","0000","668","348","320","88","756","1210","0","62.48","28.76"
"10","014","00","010","0041","0078","358","196","162","62","420","607","0","69.19","32.29"
"10","014","00","010","0041","0079","310","152","158","26","336","603","0","55.72","25.21"
"10","014","00","010","0042","0000","686","271","415","98","784","1291","0","60.73","20.99"
"10","014","00","010","0042","0084","366","133","233","36","402","647","0","62.13","20.56"
"10","014","00","010","0042","0085","320","138","182","62","382","644","0","59.32","21.43"
"10","014","00","010","0043","0000","701","347","354","100","801","1213","0","66.03","28.61"
"10","014","00","010","0043","0086","701","347","354","100","801","1213","0","66.03","28.61"
"10","014","00","010","0045","0000","1316","655","661","108","1424","2257","0","63.09","29.02"
"10","014","00","010","0045","0087","369","176","193","54","423","653","0","64.78","26.95"
"10","014","00","010","0045","0088","429","226","203","7","436","735","0","59.32","30.75"
"10","014","00","010","0045","0089","518","253","265","47","565","869","0","65.02","29.11"
"10","014","00","010","0046","0000","923","369","554","136","1059","1962","0","53.98","18.81"
"10","014","00","010","0046","0090","489","188","301","62","551","1062","0","51.88","17.70"
"10","014","00","010","0046","0091","434","181","253","74","508","900","0","56.44","20.11"
"10","014","00","010","0047","0000","1658","634","1024","94","1752","3015","0","58.11","21.03"
"10","014","00","010","0047","0028","557","216","341","38","595","1016","0","58.56","21.26"
"10","014","00","010","0047","0029","527","225","302","28","555","1034","0","53.68","21.76"
"10","014","00","010","0047","0030","574","193","381","28","602","965","0","62.38","20.00"
"10","014","00","010","0048","0000","1478","610","868","88","1566","2677","0","58.50","22.79"
"10","014","00","010","0048","0064","542","224","318","23","565","997","0","56.67","22.47"
"10","014","00","010","0048","0065","442","184","258","41","483","813","0","59.41","22.63"
"10","014","00","010","0048","0066","494","202","292","24","518","867","0","59.75","23.30"
"10","014","00","010","0049","0000","1775","753","1022","121","1896","3221","0","58.86","23.38"
"10","014","00","010","0049","0070","590","273","317","32","622","1061","0","58.62","25.73"
"10","014","00","010","0049","0071","627","230","397","41","668","1111","0","60.13","20.70"
"10","014","00","010","0049","0072","558","250","308","48","606","1049","0","57.77","23.83"
"10","014","00","020","0000","0000","6044","2428","3616","1001","7045","11618","13233","60.64","20.90"
"10","014","00","020","0001","0000","302","119","183","81","383","566","0","67.67","21.02"
"10","014","00","020","0001","0107","169","63","106","46","215","327","0","65.75","19.27"
"10","014","00","020","0001","0108","133","56","77","35","168","239","0","70.29","23.43"
"10","014","00","020","0002","0000","387","147","240","62","449","894","0","50.22","16.44"
"10","014","00","020","0002","0105","219","78","141","32","251","454","0","55.29","17.18"
"10","014","00","020","0002","0106","168","69","99","30","198","440","0","45.00","15.68"
"10","014","00","020","0003","0000","606","256","350","132","738","1265","0","58.34","20.24"
"10","014","00","020","0003","0103","230","105","125","57","287","480","0","59.79","21.88"
"10","014","00","020","0003","0104","376","151","225","75","451","785","0","57.45","19.24"
"10","014","00","020","0004","0000","1324","491","833","230","1554","2589","0","60.02","18.96"
"10","014","00","020","0004","0101","643","237","406","100","743","1265","0","58.74","18.74"
"10","014","00","020","0004","0102","681","254","427","130","811","1324","0","61.25","19.18"
"10","014","00","020","0005","0000","1057","431","626","148","1205","1839","0","65.52","23.44"
"10","014","00","020","0005","0099","534","223","311","67","601","898","0","66.93","24.83"
"10","014","00","020","0005","0100","523","208","315","81","604","941","0","64.19","22.10"
"10","014","00","020","0006","0000","1171","532","639","157","1328","2038","0","65.16","26.10"
"10","014","00","020","0006","0096","150","69","81","30","180","315","0","57.14","21.90"
"10","014","00","020","0006","0097","566","246","320","60","626","931","0","67.24","26.42"
"10","014","00","020","0006","0098","455","217","238","67","522","792","0","65.91","27.40"
"10","014","00","020","0007","0000","359","162","197","59","418","695","0","60.14","23.31"
"10","014","00","020","0007","0095","359","162","197","59","418","695","0","60.14","23.31"
"10","014","00","020","0008","0000","838","290","548","132","970","1732","0","56.00","16.74"
"10","014","00","020","0008","0092","213","73","140","31","244","484","0","50.41","15.08"
"10","014","00","020","0008","0093","448","152","296","73","521","908","0","57.38","16.74"
"10","014","00","020","0008","0094","177","65","112","28","205","340","0","60.29","19.12"
"10","014","00","030","0000","0000","3361","1513","1848","295","3656","7015","8182","52.12","21.57"
"10","014","00","030","0001","0000","707","317","390","59","766","1639","0","46.74","19.34"
"10","014","00","030","0001","0115","375","145","230","33","408","879","0","46.42","16.50"
"10","014","00","030","0001","0116","332","172","160","26","358","760","0","47.11","22.63"
"10","014","00","030","0002","0000","552","238","314","58","610","1086","0","56.17","21.92"
"10","014","00","030","0002","0113","552","238","314","58","610","1086","0","56.17","21.92"
"10","014","00","030","0003","0000","437","215","222","44","481","821","0","58.59","26.19"
"10","014","00","030","0003","0112","437","215","222","44","481","821","0","58.59","26.19"
"10","014","00","030","0004","0000","472","207","265","36","508","735","0","69.12","28.16"
"10","014","00","030","0004","0111","472","207","265","36","508","735","0","69.12","28.16"
"10","014","00","030","0005","0000","703","310","393","62","765","1566","0","48.85","19.80"
"10","014","00","030","0005","0109","425","182","243","38","463","852","0","54.34","21.36"
"10","014","00","030","0005","0110","278","128","150","24","302","714","0","42.30","17.93"
"10","014","00","030","0006","0000","153","80","73","11","164","502","0","32.67","15.94"
"10","014","00","030","0006","0117","153","80","73","11","164","502","0","32.67","15.94"
"10","014","00","030","0007","0000","337","146","191","25","362","666","0","54.35","21.92"
"10","014","00","030","0007","0114","337","146","191","25","362","666","0","54.35","21.92"
"10","014","00","040","0000","0000","8324","3755","4569","1028","9352","14509","16878","64.46","25.88"
"10","014","00","040","0001","0000","244","118","126","52","296","462","0","64.07","25.54"
"10","014","00","040","0001","0127","127","65","62","25","152","262","0","58.02","24.81"
"10","014","00","040","0001","0128","117","53","64","27","144","200","0","72.00","26.50"
"10","014","00","040","0002","0000","258","120","138","42","300","435","0","68.97","27.59"
"10","014","00","040","0002","0139","258","120","138","42","300","435","0","68.97","27.59"
"10","014","00","040","0003","0000","243","108","135","34","277","449","0","61.69","24.05"
"10","014","00","040","0003","0137","243","108","135","34","277","449","0","61.69","24.05"
"10","014","00","040","0004","0000","207","123","84","25","232","314","0","73.89","39.17"
"10","014","00","040","0004","0138","207","123","84","25","232","314","0","73.89","39.17"
"10","014","00","040","0005","0000","622","313","309","91","713","1086","0","65.65","28.82"
"10","014","00","040","0005","0125","404","203","201","53","457","685","0","66.72","29.64"
"10","014","00","040","0005","0126","218","110","108","38","256","401","0","63.84","27.43"
"10","014","00","040","0006","0000","705","307","398","98","803","1180","0","68.05","26.02"
"10","014","00","040","0006","0123","412","163","249","62","474","707","0","67.04","23.06"
"10","014","00","040","0006","0124","293","144","149","36","329","473","0","69.56","30.44"
"10","014","00","040","0007","0000","581","294","287","65","646","1015","0","63.65","28.97"
"10","014","00","040","0007","0120","112","79","33","10","122","200","0","61.00","39.50"
"10","014","00","040","0007","0121","254","133","121","38","292","452","0","64.60","29.42"
"10","014","00","040","0007","0122","215","82","133","17","232","363","0","63.91","22.59"
"10","014","00","040","0008","0000","1188","565","623","122","1310","2122","0","61.73","26.63"
"10","014","00","040","0008","0118","571","292","279","53","624","988","0","63.16","29.55"
"10","014","00","040","0008","0119","617","273","344","69","686","1134","0","60.49","24.07"
"10","014","00","040","0009","0000","628","282","346","92","720","1103","0","65.28","25.57"
"10","014","00","040","0009","0132","628","282","346","92","720","1103","0","65.28","25.57"
"10","014","00","040","0010","0000","1761","745","1016","190","1951","3124","0","62.45","23.85"
"10","014","00","040","0010","0129","762","323","439","71","833","1332","0","62.54","24.25"
"10","014","00","040","0010","0130","439","192","247","46","485","730","0","66.44","26.30"
"10","014","00","040","0010","0131","560","230","330","73","633","1062","0","59.60","21.66"
"10","014","00","040","0011","0000","592","219","373","43","635","1067","0","59.51","20.52"
"10","014","00","040","0011","0133","592","219","373","43","635","1067","0","59.51","20.52"
"10","014","00","040","0012","0000","687","240","447","81","768","1116","0","68.82","21.51"
"10","014","00","040","0012","0134","687","240","447","81","768","1116","0","68.82","21.51"
"10","014","00","040","0013","0000","608","321","287","93","701","1036","0","67.66","30.98"
"10","014","00","040","0013","0135","526","276","250","79","605","894","0","67.67","30.87"
"10","014","00","040","0013","0136","82","45","37","14","96","142","0","67.61","31.69"
"10","014","00","050","0000","0000","3778","1737","2041","537","4315","6450","7327","66.90","26.93"
"10","014","00","050","0001","0000","338","137","201","58","396","623","0","63.56","21.99"
"10","014","00","050","0001","0147","338","137","201","58","396","623","0","63.56","21.99"
"10","014","00","050","0002","0000","495","280","215","62","557","832","0","66.95","33.65"
"10","014","00","050","0002","0148","225","100","125","23","248","394","0","62.94","25.38"
"10","014","00","050","0002","0149","270","180","90","39","309","438","0","70.55","41.10"
"10","014","00","050","0003","0000","449","181","268","69","518","805","0","64.35","22.48"
"10","014","00","050","0003","0146","449","181","268","69","518","805","0","64.35","22.48"
"10","014","00","050","0004","0000","787","357","430","91","878","1369","0","64.13","26.08"
"10","014","00","050","0004","0143","627","304","323","57","684","1048","0","65.27","29.01"
"10","014","00","050","0004","0144","160","53","107","34","194","321","0","60.44","16.51"
"10","014","00","050","0005","0000","455","184","271","93","548","817","0","67.07","22.52"
"10","014","00","050","0005","0145","455","184","271","93","548","817","0","67.07","22.52"
"10","014","00","050","0006","0000","629","284","345","65","694","994","0","69.82","28.57"
"10","014","00","050","0006","0140","309","122","187","36","345","473","0","72.94","25.79"
"10","014","00","050","0006","0141","320","162","158","29","349","521","0","66.99","31.09"
"10","014","00","050","0007","0000","625","314","311","99","724","1010","0","71.68","31.09"
"10","014","00","050","0007","0142","625","314","311","99","724","1010","0","71.68","31.09"
"10","014","00","060","0000","0000","3905","1799","2106","591","4496","6915","8009","65.02","26.02"
"10","014","00","060","0001","0000","520","230","290","102","622","1058","0","58.79","21.74"
"10","014","00","060","0001","0152","231","99","132","34","265","415","0","63.86","23.86"
"10","014","00","060","0001","0153","289","131","158","68","357","643","0","55.52","20.37"
"10","014","00","060","0002","0000","417","185","232","57","474","655","0","72.37","28.24"
"10","014","00","060","0002","0154","417","185","232","57","474","655","0","72.37","28.24"
"10","014","00","060","0003","0000","157","75","82","45","202","316","0","63.92","23.73"
"10","014","00","060","0003","0155","157","75","82","45","202","316","0","63.92","23.73"
"10","014","00","060","0004","0000","392","167","225","57","449","774","0","58.01","21.58"
"10","014","00","060","0004","0156","392","167","225","57","449","774","0","58.01","21.58"
"10","014","00","060","0005","0000","1125","535","590","97","1222","1856","0","65.84","28.83"
"10","014","00","060","0005","0150","553","241","312","49","602","975","0","61.74","24.72"
"10","014","00","060","0005","0151","572","294","278","48","620","881","0","70.37","33.37"
"10","014","00","060","0006","0000","202","96","106","17","219","325","0","67.38","29.54"
"10","014","00","060","0006","0158","202","96","106","17","219","325","0","67.38","29.54"
"10","014","00","060","0007","0000","458","208","250","64","522","825","0","63.27","25.21"
"10","014","00","060","0007","0157","458","208","250","64","522","825","0","63.27","25.21"
"10","014","00","060","0008","0000","203","102","101","35","238","312","0","76.28","32.69"
"10","014","00","060","0008","0159","203","102","101","35","238","312","0","76.28","32.69"
"10","014","00","060","0009","0000","212","103","109","51","263","362","0","72.65","28.45"
"10","014","00","060","0009","0160","212","103","109","51","263","362","0","72.65","28.45"
"10","014","00","060","0010","0000","219","98","121","66","285","432","0","65.97","22.69"
"10","014","00","060","0010","0161","219","98","121","66","285","432","0","65.97","22.69"
"10","014","00","070","0000","0000","3140","1432","1708","477","3617","7216","8083","50.12","19.84"
"10","014","00","070","0001","0000","503","202","301","78","581","1484","0","39.15","13.61"
"10","014","00","070","0001","0169","159","73","86","19","178","793","0","22.45","9.21"
"10","014","00","070","0001","0170","149","45","104","20","169","315","0","53.65","14.29"
"10","014","00","070","0001","0171","195","84","111","39","234","376","0","62.23","22.34"
"10","014","00","070","0002","0000","380","154","226","97","477","1109","0","43.01","13.89"
"10","014","00","070","0002","0168","380","154","226","97","477","1109","0","43.01","13.89"
"10","014","00","070","0003","0000","291","116","175","8","299","960","0","31.15","12.08"
"10","014","00","070","0003","0167","291","116","175","8","299","960","0","31.15","12.08"
"10","014","00","070","0004","0000","93","47","46","8","101","231","0","43.72","20.35"
"10","014","00","070","0004","0172","93","47","46","8","101","231","0","43.72","20.35"
"10","014","00","070","0005","0000","273","119","154","50","323","489","0","66.05","24.34"
"10","014","00","070","0005","0166","273","119","154","50","323","489","0","66.05","24.34"
"10","014","00","070","0006","0000","447","231","216","73","520","905","0","57.46","25.52"
"10","014","00","070","0006","0165","447","231","216","73","520","905","0","57.46","25.52"
"10","014","00","070","0007","0000","1153","563","590","163","1316","2038","0","64.57","27.63"
"10","014","00","070","0007","0162","354","196","158","57","411","660","0","62.27","29.70"
"10","014","00","070","0007","0163","327","158","169","44","371","599","0","61.94","26.38"
"10","014","00","070","0007","0164","472","209","263","62","534","779","0","68.55","26.83"
"10","014","00","080","0000","0000","2895","1265","1630","535","3430","6047","6749","56.72","20.92"
"10","014","00","080","0001","0000","285","106","179","39","324","561","0","57.75","18.89"
"10","014","00","080","0001","0182","7","6","1","2","9","21","0","42.86","28.57"
"10","014","00","080","0001","0183","278","100","178","37","315","540","0","58.33","18.52"
"10","014","00","080","0002","0000","486","183","303","107","593","1106","0","53.62","16.55"
"10","014","00","080","0002","0179","280","104","176","56","336","635","0","52.91","16.38"
"10","014","00","080","0002","0180","151","56","95","32","183","300","0","61.00","18.67"
"10","014","00","080","0002","0181","55","23","32","19","74","171","0","43.27","13.45"
"10","014","00","080","0003","0000","248","134","114","47","295","504","0","58.53","26.59"
"10","014","00","080","0003","0178","248","134","114","47","295","504","0","58.53","26.59"
"10","014","00","080","0004","0000","937","411","526","156","1093","1889","0","57.86","21.76"
"10","014","00","080","0004","0176","574","270","304","88","662","1195","0","55.40","22.59"
"10","014","00","080","0004","0177","363","141","222","68","431","694","0","62.10","20.32"
"10","014","00","080","0005","0000","445","221","224","99","544","849","0","64.08","26.03"
"10","014","00","080","0005","0175","445","221","224","99","544","849","0","64.08","26.03"
"10","014","00","080","0006","0000","494","210","284","87","581","1138","0","51.05","18.45"
"10","014","00","080","0006","0173","209","107","102","31","240","494","0","48.58","21.66"
"10","014","00","080","0006","0174","285","103","182","56","341","644","0","52.95","15.99"
"10","014","00","090","0000","0000","4450","2106","2344","707","5157","9287","10756","55.53","22.68"
"10","014","00","090","0001","0000","612","346","266","124","736","1243","0","59.21","27.84"
"10","014","00","090","0001","0184","317","179","138","79","396","609","0","65.02","29.39"
"10","014","00","090","0001","0185","295","167","128","45","340","634","0","53.63","26.34"
"10","014","00","090","0002","0000","310","173","137","48","358","560","0","63.93","30.89"
"10","014","00","090","0002","0186","310","173","137","48","358","560","0","63.93","30.89"
"10","014","00","090","0003","0000","318","193","125","57","375","587","0","63.88","32.88"
"10","014","00","090","0003","0187","318","193","125","57","375","587","0","63.88","32.88"
"10","014","00","090","0004","0000","313","157","156","50","363","553","0","65.64","28.39"
"10","014","00","090","0004","0188","313","157","156","50","363","553","0","65.64","28.39"
"10","014","00","090","0005","0000","659","304","355","70","729","1319","0","55.27","23.05"
"10","014","00","090","0005","0191","344","168","176","40","384","613","0","62.64","27.41"
"10","014","00","090","0005","0192","315","136","179","30","345","706","0","48.87","19.26"
"10","014","00","090","0006","0000","759","328","431","108","867","1703","0","50.91","19.26"
"10","014","00","090","0006","0189","516","180","336","93","609","907","0","67.14","19.85"
"10","014","00","090","0006","0190","243","148","95","15","258","796","0","32.41","18.59"
"10","014","00","090","0007","0000","406","195","211","68","474","770","0","61.56","25.32"
"10","014","00","090","0007","0193","210","99","111","39","249","398","0","62.56","24.87"
"10","014","00","090","0007","0194","196","96","100","29","225","372","0","60.48","25.81"
"10","014","00","090","0008","0000","886","356","530","160","1046","1681","0","62.22","21.18"
"10","014","00","090","0008","0195","453","194","259","79","532","822","0","64.72","23.60"
"10","014","00","090","0008","0196","433","162","271","81","514","859","0","59.84","18.86"
"10","014","00","090","0009","0000","187","54","133","22","209","871","0","24.00","6.20"
"10","014","00","090","0009","0197","53","20","33","16","69","219","0","31.51","9.13"
"10","014","00","090","0009","0198","134","34","100","6","140","652","0","21.47","5.21"
"10","014","00","100","0000","0000","2777","1188","1589","439","3216","4802","5646","66.97","24.74"
"10","014","00","100","0001","0000","482","168","314","81","563","725","0","77.66","23.17"
"10","014","00","100","0001","0203","251","87","164","31","282","355","0","79.44","24.51"
"10","014","00","100","0001","0204","231","81","150","50","281","370","0","75.95","21.89"
"10","014","00","100","0002","0000","659","266","393","154","813","1051","0","77.35","25.31"
"10","014","00","100","0002","0202","659","266","393","154","813","1051","0","77.35","25.31"
"10","014","00","100","0003","0000","702","295","407","89","791","1200","0","65.92","24.58"
"10","014","00","100","0003","0201","702","295","407","89","791","1200","0","65.92","24.58"
"10","014","00","100","0004","0000","579","306","273","62","641","1295","0","49.50","23.63"
"10","014","00","100","0004","0200","579","306","273","62","641","1295","0","49.50","23.63"
"10","014","00","100","0005","0000","355","153","202","53","408","531","0","76.84","28.81"
"10","014","00","100","0005","0199","355","153","202","53","408","531","0","76.84","28.81"
"10","014","00","110","0000","0000","2110","828","1282","314","2424","3738","4282","64.85","22.15"
"10","014","00","110","0001","0000","573","217","356","90","663","993","0","66.77","21.85"
"10","014","00","110","0001","0207","464","166","298","54","518","795","0","65.16","20.88"
"10","014","00","110","0001","0208","109","51","58","36","145","198","0","73.23","25.76"
"10","014","00","110","0002","0000","634","249","385","123","757","1047","0","72.30","23.78"
"10","014","00","110","0002","0206","634","249","385","123","757","1047","0","72.30","23.78"
"10","014","00","110","0003","0000","903","362","541","101","1004","1698","0","59.13","21.32"
"10","014","00","110","0003","0205","903","362","541","101","1004","1698","0","59.13","21.32"
"10","014","00","120","0000","0000","1513","516","997","157","1670","3216","4197","51.93","16.04"
"10","014","00","120","0001","0000","275","82","193","15","290","710","0","40.85","11.55"
"10","014","00","120","0001","0212","275","82","193","15","290","710","0","40.85","11.55"
"10","014","00","120","0002","0000","105","42","63","13","118","247","0","47.77","17.00"
"10","014","00","120","0002","0213","105","42","63","13","118","247","0","47.77","17.00"
"10","014","00","120","0003","0000","137","70","67","22","159","256","0","62.11","27.34"
"10","014","00","120","0003","0214","137","70","67","22","159","256","0","62.11","27.34"
"10","014","00","120","0004","0000","367","124","243","26","393","934","0","42.08","13.28"
"10","014","00","120","0004","0211","367","124","243","26","393","934","0","42.08","13.28"
"10","014","00","120","0005","0000","342","102","240","27","369","586","0","62.97","17.41"
"10","014","00","120","0005","0210","342","102","240","27","369","586","0","62.97","17.41"
"10","014","00","120","0006","0000","287","96","191","54","341","483","0","70.60","19.88"
"10","014","00","120","0006","0209","287","96","191","54","341","483","0","70.60","19.88"
"10","014","00","130","0000","0000","1463","638","825","147","1610","2875","3645","56.00","22.19"
"10","014","00","130","0001","0000","346","218","128","40","386","574","0","67.25","37.98"
"10","014","00","130","0001","0218","346","218","128","40","386","574","0","67.25","37.98"
"10","014","00","130","0002","0000","228","81","147","31","259","314","0","82.48","25.80"
"10","014","00","130","0002","0217","228","81","147","31","259","314","0","82.48","25.80"
"10","014","00","130","0003","0000","279","106","173","41","320","399","0","80.20","26.57"
"10","014","00","130","0003","0216","279","106","173","41","320","399","0","80.20","26.57"
"10","014","00","130","0004","0000","206","65","141","12","218","575","0","37.91","11.30"
"10","014","00","130","0004","0219","206","65","141","12","218","575","0","37.91","11.30"
"10","014","00","130","0005","0000","404","168","236","23","427","1013","0","42.15","16.58"
"10","014","00","130","0005","0215","404","168","236","23","427","1013","0","42.15","16.58"
"10","014","00","140","0000","0000","2065","744","1321","188","2253","2967","3724","75.94","25.08"
"10","014","00","140","0001","0000","405","138","267","33","438","525","0","83.43","26.29"
"10","014","00","140","0001","0223","405","138","267","33","438","525","0","83.43","26.29"
"10","014","00","140","0002","0000","407","108","299","34","441","596","0","73.99","18.12"
"10","014","00","140","0002","0222","407","108","299","34","441","596","0","73.99","18.12"
"10","014","00","140","0003","0000","834","347","487","92","926","1214","0","76.28","28.58"
"10","014","00","140","0003","0220","408","166","242","50","458","631","0","72.58","26.31"
"10","014","00","140","0003","0221","426","181","245","42","468","583","0","80.27","31.05"
"10","014","00","140","0004","0000","241","87","154","22","263","313","0","84.03","27.80"
"10","014","00","140","0004","0224","241","87","154","22","263","313","0","84.03","27.80"
"10","014","00","140","0005","0000","178","64","114","7","185","319","0","57.99","20.06"
"10","014","00","140","0005","0225","178","64","114","7","185","319","0","57.99","20.06"
"10","014","00","150","0000","0000","1964","796","1168","260","2224","2994","3496","74.28","26.59"
"10","014","00","150","0001","0000","392","146","246","79","471","594","0","79.29","24.58"
"10","014","00","150","0001","0231","392","146","246","79","471","594","0","79.29","24.58"
"10","014","00","150","0002","0000","557","256","301","115","672","842","0","79.81","30.40"
"10","014","00","150","0002","0232","557","256","301","115","672","842","0","79.81","30.40"
"10","014","00","150","0003","0000","247","95","152","11","258","350","0","73.71","27.14"
"10","014","00","150","0003","0230","247","95","152","11","258","350","0","73.71","27.14"
"10","014","00","150","0004","0000","272","97","175","18","290","543","0","53.41","17.86"
"10","014","00","150","0004","0226","148","56","92","15","163","230","0","70.87","24.35"
"10","014","00","150","0004","0227","124","41","83","3","127","313","0","40.58","13.10"
"10","014","00","150","0005","0000","275","116","159","25","300","367","0","81.74","31.61"
"10","014","00","150","0005","0229","275","116","159","25","300","367","0","81.74","31.61"
"10","014","00","150","0006","0000","221","86","135","12","233","298","0","78.19","28.86"
"10","014","00","150","0006","0228","221","86","135","12","233","298","0","78.19","28.86"
"10","014","00","160","0000","0000","1452","612","840","146","1598","4257","5266","37.54","14.38"
"10","014","00","160","0001","0000","335","163","172","26","361","1283","0","28.14","12.70"
"10","014","00","160","0001","0235","335","163","172","26","361","1283","0","28.14","12.70"
"10","014","00","160","0002","0000","143","77","66","7","150","757","0","19.82","10.17"
"10","014","00","160","0002","0236","143","77","66","7","150","757","0","19.82","10.17"
"10","014","00","160","0003","0000","598","245","353","66","664","1272","0","52.20","19.26"
"10","014","00","160","0003","0234","598","245","353","66","664","1272","0","52.20","19.26"
"10","014","00","160","0004","0000","376","127","249","47","423","945","0","44.76","13.44"
"10","014","00","160","0004","0233","376","127","249","47","423","945","0","44.76","13.44"
"10","016","00","000","0000","0000","43108","22710","20398","4523","47631","91299","106891","52.17","24.87"
"10","016","00","010","0000","0000","26539","13062","13477","2063","28602","53391","63469","53.57","24.46"
"10","016","00","010","0002","0000","169","88","81","18","187","470","0","39.79","18.72"
"10","016","00","010","0002","0001","169","88","81","18","187","470","0","39.79","18.72"
"10","016","00","010","0003","0000","271","124","147","25","296","518","0","57.14","23.94"
"10","016","00","010","0003","0002","271","124","147","25","296","518","0","57.14","23.94"
"10","016","00","010","0004","0000","250","120","130","10","260","525","0","49.52","22.86"
"10","016","00","010","0004","0003","250","120","130","10","260","525","0","49.52","22.86"
"10","016","00","010","0005","0000","457","224","233","54","511","863","0","59.21","25.96"
"10","016","00","010","0005","0004","457","224","233","54","511","863","0","59.21","25.96"
"10","016","00","010","0006","0000","545","295","250","33","578","904","0","63.94","32.63"
"10","016","00","010","0006","0005","545","295","250","33","578","904","0","63.94","32.63"
"10","016","00","010","0007","0000","378","163","215","40","418","786","0","53.18","20.74"
"10","016","00","010","0007","0006","378","163","215","40","418","786","0","53.18","20.74"
"10","016","00","010","0008","0000","894","461","433","47","941","1875","0","50.19","24.59"
"10","016","00","010","0008","0007","407","230","177","17","424","902","0","47.01","25.50"
"10","016","00","010","0008","0008","487","231","256","30","517","973","0","53.13","23.74"
"10","016","00","010","0009","0000","2035","851","1184","124","2159","4026","0","53.63","21.14"
"10","016","00","010","0009","0010","634","258","376","39","673","1333","0","50.49","19.35"
"10","016","00","010","0009","0011","740","317","423","39","779","1385","0","56.25","22.89"
"10","016","00","010","0009","0012","661","276","385","46","707","1308","0","54.05","21.10"
"10","016","00","010","0010","0000","497","235","262","14","511","1147","0","44.55","20.49"
"10","016","00","010","0010","0009","497","235","262","14","511","1147","0","44.55","20.49"
"10","016","00","010","0011","0000","2481","1179","1302","156","2637","5076","0","51.95","23.23"
"10","016","00","010","0011","0013","601","292","309","64","665","1214","0","54.78","24.05"
"10","016","00","010","0011","0014","454","218","236","18","472","1162","0","40.62","18.76"
"10","016","00","010","0011","0015","705","363","342","38","743","1350","0","55.04","26.89"
"10","016","00","010","0011","0016","721","306","415","36","757","1350","0","56.07","22.67"
"10","016","00","010","0012","0000","1179","566","613","115","1294","2391","0","54.12","23.67"
"10","016","00","010","0012","0017","543","267","276","60","603","1145","0","52.66","23.32"
"10","016","00","010","0012","0018","636","299","337","55","691","1246","0","55.46","24.00"
"10","016","00","010","0013","0000","779","377","402","51","830","1484","0","55.93","25.40"
"10","016","00","010","0013","0019","779","377","402","51","830","1484","0","55.93","25.40"
"10","016","00","010","0014","0000","2660","1199","1461","166","2826","5606","0","50.41","21.39"
"10","016","00","010","0014","0020","565","263","302","51","616","1128","0","54.61","23.32"
"10","016","00","010","0014","0021","738","337","401","52","790","1405","0","56.23","23.99"
"10","016","00","010","0014","0022","882","356","526","49","931","1607","0","57.93","22.15"
"10","016","00","010","0014","0023","475","243","232","14","489","1466","0","33.36","16.58"
"10","016","00","010","0015","0000","1536","739","797","86","1622","3146","0","51.56","23.49"
"10","016","00","010","0015","0024","457","228","229","31","488","966","0","50.52","23.60"
"10","016","00","010","0015","0025","557","246","311","41","598","1046","0","57.17","23.52"
"10","016","00","010","0015","0026","522","265","257","14","536","1134","0","47.27","23.37"
"10","016","00","010","0016","0000","1636","733","903","88","1724","3245","0","53.13","22.59"
"10","016","00","010","0016","0027","510","234","276","24","534","1023","0","52.20","22.87"
"10","016","00","010","0016","0028","557","245","312","36","593","1117","0","53.09","21.93"
"10","016","00","010","0016","0029","569","254","315","28","597","1105","0","54.03","22.99"
"10","016","00","010","0017","0000","838","410","428","61","899","1825","0","49.26","22.47"
"10","016","00","010","0017","0030","366","177","189","23","389","987","0","39.41","17.93"
"10","016","00","010","0017","0031","472","233","239","38","510","838","0","60.86","27.80"
"10","016","00","010","0018","0000","339","175","164","20","359","936","0","38.35","18.70"
"10","016","00","010","0018","0032","339","175","164","20","359","936","0","38.35","18.70"
"10","016","00","010","0019","0000","588","329","259","22","610","960","0","63.54","34.27"
"10","016","00","010","0019","0033","588","329","259","22","610","960","0","63.54","34.27"
"10","016","00","010","0020","0000","1380","633","747","98","1478","2691","0","54.92","23.52"
"10","016","00","010","0020","0034","430","213","217","16","446","944","0","47.25","22.56"
"10","016","00","010","0020","0035","533","228","305","39","572","919","0","62.24","24.81"
"10","016","00","010","0020","0036","417","192","225","43","460","828","0","55.56","23.19"
"10","016","00","010","0021","0000","258","114","144","10","268","428","0","62.62","26.64"
"10","016","00","010","0021","0037","258","114","144","10","268","428","0","62.62","26.64"
"10","016","00","010","0022","0000","1200","575","625","87","1287","2148","0","59.92","26.77"
"10","016","00","010","0022","0038","686","346","340","51","737","1183","0","62.30","29.25"
"10","016","00","010","0022","0039","514","229","285","36","550","965","0","56.99","23.73"
"10","016","00","010","0023","0000","377","196","181","30","407","651","0","62.52","30.11"
"10","016","00","010","0023","0040","377","196","181","30","407","651","0","62.52","30.11"
"10","016","00","010","0024","0000","610","364","246","73","683","1063","0","64.25","34.24"
"10","016","00","010","0024","0042","610","364","246","73","683","1063","0","64.25","34.24"
"10","016","00","010","0025","0000","688","372","316","42","730","1316","0","55.47","28.27"
"10","016","00","010","0025","0041","688","372","316","42","730","1316","0","55.47","28.27"
"10","016","00","010","0026","0000","328","195","133","21","349","671","0","52.01","29.06"
"10","016","00","010","0026","0043","328","195","133","21","349","671","0","52.01","29.06"
"10","016","00","010","0027","0000","844","497","347","85","929","1651","0","56.27","30.10"
"10","016","00","010","0027","0046","342","186","156","17","359","743","0","48.32","25.03"
"10","016","00","010","0027","0047","502","311","191","68","570","908","0","62.78","34.25"
"10","016","00","010","0028","0000","1250","629","621","125","1375","2559","0","53.73","24.58"
"10","016","00","010","0028","0044","724","280","444","75","799","1465","0","54.54","19.11"
"10","016","00","010","0028","0045","526","349","177","50","576","1094","0","52.65","31.90"
"10","016","00","010","0029","0000","199","116","83","16","215","470","0","45.74","24.68"
"10","016","00","010","0029","0048","199","116","83","16","215","470","0","45.74","24.68"
"10","016","00","010","0030","0000","222","128","94","49","271","377","0","71.88","33.95"
"10","016","00","010","0030","0049","222","128","94","49","271","377","0","71.88","33.95"
"10","016","00","010","0031","0000","622","347","275","76","698","1176","0","59.35","29.51"
"10","016","00","010","0031","0050","622","347","275","76","698","1176","0","59.35","29.51"
"10","016","00","010","0032","0000","690","465","225","126","816","1326","0","61.54","35.07"
"10","016","00","010","0032","0051","690","465","225","126","816","1326","0","61.54","35.07"
"10","016","00","010","0033","0000","166","100","66","74","240","787","0","30.50","12.71"
"10","016","00","010","0033","0052","166","100","66","74","240","787","0","30.50","12.71"
"10","016","00","010","0034","0000","173","63","110","21","194","294","0","65.99","21.43"
"10","016","00","010","0034","0053","173","63","110","21","194","294","0","65.99","21.43"
"10","016","00","020","0000","0000","5987","3421","2566","644","6631","13686","15730","48.45","25.00"
"10","016","00","020","0001","0000","472","244","228","26","498","1244","0","40.03","19.61"
"10","016","00","020","0001","0054","472","244","228","26","498","1244","0","40.03","19.61"
"10","016","00","020","0002","0000","164","91","73","20","184","375","0","49.07","24.27"
"10","016","00","020","0002","0055","164","91","73","20","184","375","0","49.07","24.27"
"10","016","00","020","0003","0000","140","71","69","12","152","233","0","65.24","30.47"
"10","016","00","020","0003","0056","140","71","69","12","152","233","0","65.24","30.47"
"10","016","00","020","0004","0000","177","130","47","24","201","286","0","70.28","45.45"
"10","016","00","020","0004","0057","177","130","47","24","201","286","0","70.28","45.45"
"10","016","00","020","0005","0000","270","168","102","69","339","658","0","51.52","25.53"
"10","016","00","020","0005","0058","270","168","102","69","339","658","0","51.52","25.53"
"10","016","00","020","0006","0000","196","104","92","35","231","325","0","71.08","32.00"
"10","016","00","020","0006","0059","196","104","92","35","231","325","0","71.08","32.00"
"10","016","00","020","0007","0000","348","228","120","38","386","759","0","50.86","30.04"
"10","016","00","020","0007","0060","348","228","120","38","386","759","0","50.86","30.04"
"10","016","00","020","0008","0000","263","133","130","27","290","831","0","34.90","16.00"
"10","016","00","020","0008","0061","263","133","130","27","290","831","0","34.90","16.00"
"10","016","00","020","0009","0000","422","232","190","23","445","947","0","46.99","24.50"
"10","016","00","020","0009","0062","422","232","190","23","445","947","0","46.99","24.50"
"10","016","00","020","0010","0000","85","47","38","8","93","121","0","76.86","38.84"
"10","016","00","020","0010","0063","85","47","38","8","93","121","0","76.86","38.84"
"10","016","00","020","0011","0000","145","87","58","14","159","230","0","69.13","37.83"
"10","016","00","020","0011","0065","145","87","58","14","159","230","0","69.13","37.83"
"10","016","00","020","0012","0000","188","99","89","15","203","289","0","70.24","34.26"
"10","016","00","020","0012","0067","188","99","89","15","203","289","0","70.24","34.26"
"10","016","00","020","0013","0000","238","127","111","19","257","616","0","41.72","20.62"
"10","016","00","020","0013","0066","238","127","111","19","257","616","0","41.72","20.62"
"10","016","00","020","0014","0000","201","94","107","9","210","414","0","50.72","22.71"
"10","016","00","020","0014","0068","201","94","107","9","210","414","0","50.72","22.71"
"10","016","00","020","0015","0000","406","270","136","73","479","776","0","61.73","34.79"
"10","016","00","020","0015","0064","406","270","136","73","479","776","0","61.73","34.79"
"10","016","00","020","0016","0000","164","76","88","5","169","371","0","45.55","20.49"
"10","016","00","020","0016","0069","164","76","88","5","169","371","0","45.55","20.49"
"10","016","00","020","0017","0000","49","32","17","9","58","87","0","66.67","36.78"
"10","016","00","020","0017","0070","49","32","17","9","58","87","0","66.67","36.78"
"10","016","00","020","0018","0000","370","202","168","23","393","948","0","41.46","21.31"
"10","016","00","020","0018","0071","370","202","168","23","393","948","0","41.46","21.31"
"10","016","00","020","0019","0000","386","220","166","26","412","1030","0","40.00","21.36"
"10","016","00","020","0019","0072","386","220","166","26","412","1030","0","40.00","21.36"
"10","016","00","020","0020","0000","288","183","105","18","306","672","0","45.54","27.23"
"10","016","00","020","0020","0073","288","183","105","18","306","672","0","45.54","27.23"
"10","016","00","020","0021","0000","785","430","355","144","929","1736","0","53.51","24.77"
"10","016","00","020","0021","0074","398","231","167","58","456","899","0","50.72","25.70"
"10","016","00","020","0021","0075","387","199","188","86","473","837","0","56.51","23.78"
"10","016","00","020","0022","0000","230","153","77","7","237","738","0","32.11","20.73"
"10","016","00","020","0022","0076","230","153","77","7","237","738","0","32.11","20.73"
"10","016","00","030","0000","0000","3984","2126","1858","485","4469","8723","10007","51.23","24.37"
"10","016","00","030","0001","0000","250","120","130","14","264","536","0","49.25","22.39"
"10","016","00","030","0001","0077","250","120","130","14","264","536","0","49.25","22.39"
"10","016","00","030","0002","0000","361","186","175","24","385","665","0","57.89","27.97"
"10","016","00","030","0002","0078","361","186","175","24","385","665","0","57.89","27.97"
"10","016","00","030","0003","0000","60","31","29","3","63","97","0","64.95","31.96"
"10","016","00","030","0003","0079","60","31","29","3","63","97","0","64.95","31.96"
"10","016","00","030","0004","0000","69","27","42","6","75","143","0","52.45","18.88"
"10","016","00","030","0004","0080","69","27","42","6","75","143","0","52.45","18.88"
"10","016","00","030","0005","0000","141","68","73","10","151","278","0","54.32","24.46"
"10","016","00","030","0005","0081","141","68","73","10","151","278","0","54.32","24.46"
"10","016","00","030","0006","0000","84","37","47","5","89","204","0","43.63","18.14"
"10","016","00","030","0006","0082","84","37","47","5","89","204","0","43.63","18.14"
"10","016","00","030","0007","0000","93","44","49","5","98","156","0","62.82","28.21"
"10","016","00","030","0007","0083","93","44","49","5","98","156","0","62.82","28.21"
"10","016","00","030","0008","0000","774","363","411","82","856","1753","0","48.83","20.71"
"10","016","00","030","0008","0084","380","173","207","15","395","1004","0","39.34","17.23"
"10","016","00","030","0008","0085","394","190","204","67","461","749","0","61.55","25.37"
"10","016","00","030","0009","0000","197","107","90","27","224","324","0","69.14","33.02"
"10","016","00","030","0009","0086","197","107","90","27","224","324","0","69.14","33.02"
"10","016","00","030","0010","0000","350","218","132","57","407","754","0","53.98","28.91"
"10","016","00","030","0010","0087","350","218","132","57","407","754","0","53.98","28.91"
"10","016","00","030","0011","0000","386","203","183","70","456","759","0","60.08","26.75"
"10","016","00","030","0011","0088","386","203","183","70","456","759","0","60.08","26.75"
"10","016","00","030","0012","0000","539","380","159","43","582","1397","0","41.66","27.20"
"10","016","00","030","0012","0089","539","380","159","43","582","1397","0","41.66","27.20"
"10","016","00","030","0013","0000","442","220","222","99","541","1125","0","48.09","19.56"
"10","016","00","030","0013","0090","442","220","222","99","541","1125","0","48.09","19.56"
"10","016","00","030","0014","0000","139","61","78","16","155","270","0","57.41","22.59"
"10","016","00","030","0014","0091","139","61","78","16","155","270","0","57.41","22.59"
"10","016","00","030","0015","0000","99","61","38","24","123","262","0","46.95","23.28"
"10","016","00","030","0015","0092","99","61","38","24","123","262","0","46.95","23.28"
"10","016","00","040","0000","0000","2697","1720","977","406","3103","7307","8319","42.47","23.54"
"10","016","00","040","0001","0000","76","51","25","5","81","287","0","28.22","17.77"
"10","016","00","040","0001","0093","76","51","25","5","81","287","0","28.22","17.77"
"10","016","00","040","0002","0000","131","92","39","9","140","407","0","34.40","22.60"
"10","016","00","040","0002","0094","131","92","39","9","140","407","0","34.40","22.60"
"10","016","00","040","0003","0000","66","28","38","1","67","274","0","24.45","10.22"
"10","016","00","040","0003","0096","66","28","38","1","67","274","0","24.45","10.22"
"10","016","00","040","0004","0000","224","144","80","12","236","810","0","29.14","17.78"
"10","016","00","040","0004","0095","224","144","80","12","236","810","0","29.14","17.78"
"10","016","00","040","0005","0000","272","174","98","46","318","644","0","49.38","27.02"
"10","016","00","040","0005","0097","272","174","98","46","318","644","0","49.38","27.02"
"10","016","00","040","0006","0000","48","35","13","4","52","134","0","38.81","26.12"
"10","016","00","040","0006","0098","48","35","13","4","52","134","0","38.81","26.12"
"10","016","00","040","0007","0000","273","175","98","30","303","658","0","46.05","26.60"
"10","016","00","040","0007","0099","273","175","98","30","303","658","0","46.05","26.60"
"10","016","00","040","0008","0000","121","64","57","14","135","216","0","62.50","29.63"
"10","016","00","040","0008","0100","121","64","57","14","135","216","0","62.50","29.63"
"10","016","00","040","0009","0000","238","160","78","47","285","592","0","48.14","27.03"
"10","016","00","040","0009","0101","238","160","78","47","285","592","0","48.14","27.03"
"10","016","00","040","0010","0000","593","407","186","167","760","1251","0","60.75","32.53"
"10","016","00","040","0010","0102","593","407","186","167","760","1251","0","60.75","32.53"
"10","016","00","040","0011","0000","655","390","265","71","726","2034","0","35.69","19.17"
"10","016","00","040","0011","0103","291","161","130","28","319","917","0","34.79","17.56"
"10","016","00","040","0011","0104","364","229","135","43","407","1117","0","36.44","20.50"
"10","016","00","050","0000","0000","2375","1511","864","467","2842","4800","5459","59.21","31.48"
"10","016","00","050","0001","0000","306","183","123","66","372","696","0","53.45","26.29"
"10","016","00","050","0001","0105","306","183","123","66","372","696","0","53.45","26.29"
"10","016","00","050","0002","0000","178","94","84","13","191","457","0","41.79","20.57"
"10","016","00","050","0002","0106","178","94","84","13","191","457","0","41.79","20.57"
"10","016","00","050","0003","0000","146","103","43","10","156","342","0","45.61","30.12"
"10","016","00","050","0003","0107","146","103","43","10","156","342","0","45.61","30.12"
"10","016","00","050","0004","0000","332","202","130","51","383","523","0","73.23","38.62"
"10","016","00","050","0004","0108","332","202","130","51","383","523","0","73.23","38.62"
"10","016","00","050","0005","0000","743","496","247","185","928","1439","0","64.49","34.47"
"10","016","00","050","0005","0109","348","223","125","102","450","682","0","65.98","32.70"
"10","016","00","050","0005","0110","395","273","122","83","478","757","0","63.14","36.06"
"10","016","00","050","0006","0000","303","212","91","64","367","509","0","72.10","41.65"
"10","016","00","050","0006","0112","303","212","91","64","367","509","0","72.10","41.65"
"10","016","00","050","0007","0000","58","38","20","6","64","208","0","30.77","18.27"
"10","016","00","050","0007","0113","58","38","20","6","64","208","0","30.77","18.27"
"10","016","00","050","0008","0000","166","97","69","27","193","319","0","60.50","30.41"
"10","016","00","050","0008","0111","166","97","69","27","193","319","0","60.50","30.41"
"10","016","00","050","0009","0000","143","86","57","45","188","307","0","61.24","28.01"
"10","016","00","050","0009","0114","143","86","57","45","188","307","0","61.24","28.01"
"10","016","00","060","0000","0000","1526","870","656","458","1984","3392","3907","58.49","25.65"
"10","016","00","060","0001","0000","91","59","32","52","143","247","0","57.89","23.89"
"10","016","00","060","0001","0115","91","59","32","52","143","247","0","57.89","23.89"
"10","016","00","060","0002","0000","307","183","124","103","410","585","0","70.09","31.28"
"10","016","00","060","0002","0116","307","183","124","103","410","585","0","70.09","31.28"
"10","016","00","060","0003","0000","311","188","123","56","367","652","0","56.29","28.83"
"10","016","00","060","0003","0117","311","188","123","56","367","652","0","56.29","28.83"
"10","016","00","060","0004","0000","168","96","72","31","199","365","0","54.52","26.30"
"10","016","00","060","0004","0118","168","96","72","31","199","365","0","54.52","26.30"
"10","016","00","060","0005","0000","156","97","59","28","184","387","0","47.55","25.06"
"10","016","00","060","0005","0119","156","97","59","28","184","387","0","47.55","25.06"
"10","016","00","060","0006","0000","493","247","246","188","681","1156","0","58.91","21.37"
"10","016","00","060","0006","0120","493","247","246","188","681","1156","0","58.91","21.37"
"10","017","00","000","0000","0000","166897","81020","85877","7686","174583","309235","361114","56.46","26.20"
"10","017","00","010","0000","0000","22439","11125","11314","1197","23636","44142","50512","53.55","25.20"
"10","017","00","010","0001","0000","377","192","185","14","391","610","0","64.10","31.48"
"10","017","00","010","0001","0040","377","192","185","14","391","610","0","64.10","31.48"
"10","017","00","010","0002","0000","590","280","310","29","619","1110","0","55.77","25.23"
"10","017","00","010","0002","0038","590","280","310","29","619","1110","0","55.77","25.23"
"10","017","00","010","0003","0000","445","250","195","21","466","825","0","56.48","30.30"
"10","017","00","010","0003","0039","445","250","195","21","466","825","0","56.48","30.30"
"10","017","00","010","0004","0000","480","253","227","42","522","917","0","56.92","27.59"
"10","017","00","010","0004","0037","480","253","227","42","522","917","0","56.92","27.59"
"10","017","00","010","0005","0000","788","417","371","22","810","1148","0","70.56","36.32"
"10","017","00","010","0005","0036","788","417","371","22","810","1148","0","70.56","36.32"
"10","017","00","010","0006","0000","612","314","298","36","648","1074","0","60.34","29.24"
"10","017","00","010","0006","0035","612","314","298","36","648","1074","0","60.34","29.24"
"10","017","00","010","0007","0000","647","297","350","21","668","1127","0","59.27","26.35"
"10","017","00","010","0007","0034","647","297","350","21","668","1127","0","59.27","26.35"
"10","017","00","010","0008","0000","368","175","193","36","404","701","0","57.63","24.96"
"10","017","00","010","0008","0033","368","175","193","36","404","701","0","57.63","24.96"
"10","017","00","010","0009","0000","690","346","344","35","725","1566","0","46.30","22.09"
"10","017","00","010","0009","0032","690","346","344","35","725","1566","0","46.30","22.09"
"10","017","00","010","0010","0000","1190","536","654","69","1259","2144","0","58.72","25.00"
"10","017","00","010","0010","0030","640","315","325","40","680","1121","0","60.66","28.10"
"10","017","00","010","0010","0031","550","221","329","29","579","1023","0","56.60","21.60"
"10","017","00","010","0011","0000","721","362","359","45","766","1230","0","62.28","29.43"
"10","017","00","010","0011","0029","721","362","359","45","766","1230","0","62.28","29.43"
"10","017","00","010","0012","0000","970","430","540","64","1034","1921","0","53.83","22.38"
"10","017","00","010","0012","0027","592","279","313","38","630","1116","0","56.45","25.00"
"10","017","00","010","0012","0028","378","151","227","26","404","805","0","50.19","18.76"
"10","017","00","010","0013","0000","1052","430","622","39","1091","1868","0","58.40","23.02"
"10","017","00","010","0013","0025","597","244","353","11","608","1057","0","57.52","23.08"
"10","017","00","010","0013","0026","455","186","269","28","483","811","0","59.56","22.93"
"10","017","00","010","0014","0000","635","314","321","37","672","1191","0","56.42","26.36"
"10","017","00","010","0014","0024","635","314","321","37","672","1191","0","56.42","26.36"
"10","017","00","010","0015","0000","533","252","281","22","555","1100","0","50.45","22.91"
"10","017","00","010","0015","0021","533","252","281","22","555","1100","0","50.45","22.91"
"10","017","00","010","0016","0000","904","504","400","67","971","1625","0","59.75","31.02"
"10","017","00","010","0016","0018","515","280","235","41","556","948","0","58.65","29.54"
"10","017","00","010","0016","0019","389","224","165","26","415","677","0","61.30","33.09"
"10","017","00","010","0017","0000","443","220","223","45","488","865","0","56.42","25.43"
"10","017","00","010","0017","0020","443","220","223","45","488","865","0","56.42","25.43"
"10","017","00","010","0018","0000","562","306","256","34","596","1132","0","52.65","27.03"
"10","017","00","010","0018","0017","562","306","256","34","596","1132","0","52.65","27.03"
"10","017","00","010","0019","0000","703","485","218","68","771","1399","0","55.11","34.67"
"10","017","00","010","0019","0006","703","485","218","68","771","1399","0","55.11","34.67"
"10","017","00","010","0020","0000","541","296","245","45","586","1128","0","51.95","26.24"
"10","017","00","010","0020","0007","541","296","245","45","586","1128","0","51.95","26.24"
"10","017","00","010","0021","0000","258","160","98","27","285","424","0","67.22","37.74"
"10","017","00","010","0021","0001","258","160","98","27","285","424","0","67.22","37.74"
"10","017","00","010","0022","0000","2534","1253","1281","123","2657","5611","0","47.35","22.33"
"10","017","00","010","0022","0002","527","305","222","31","558","1182","0","47.21","25.80"
"10","017","00","010","0022","0003","686","321","365","42","728","1397","0","52.11","22.98"
"10","017","00","010","0022","0004","679","321","358","27","706","1562","0","45.20","20.55"
"10","017","00","010","0022","0005","642","306","336","23","665","1470","0","45.24","20.82"
"10","017","00","010","0023","0000","710","363","347","40","750","1532","0","48.96","23.69"
"10","017","00","010","0023","0023","710","363","347","40","750","1532","0","48.96","23.69"
"10","017","00","010","0024","0000","411","210","201","19","430","873","0","49.26","24.05"
"10","017","00","010","0024","0022","411","210","201","19","430","873","0","49.26","24.05"
"10","017","00","010","0025","0000","2976","1433","1543","99","3075","6068","0","50.68","23.62"
"10","017","00","010","0025","0012","855","441","414","19","874","1912","0","45.71","23.06"
"10","017","00","010","0025","0013","717","366","351","38","755","1410","0","53.55","25.96"
"10","017","00","010","0025","0014","581","270","311","18","599","1090","0","54.95","24.77"
"10","017","00","010","0025","0015","468","202","266","16","484","896","0","54.02","22.54"
"10","017","00","010","0025","0016","355","154","201","8","363","760","0","47.76","20.26"
"10","017","00","010","0026","0000","2299","1047","1252","98","2397","4953","0","48.39","21.14"
"10","017","00","010","0026","0008","701","324","377","28","729","1371","0","53.17","23.63"
"10","017","00","010","0026","0009","768","314","454","49","817","1521","0","53.71","20.64"
"10","017","00","010","0026","0010","334","144","190","6","340","778","0","43.70","18.51"
"10","017","00","010","0026","0011","496","265","231","15","511","1283","0","39.83","20.65"
"10","017","00","020","0000","0000","24168","12117","12051","1233","25401","45076","52980","56.35","26.88"
"10","017","00","020","0001","0000","1977","962","1015","102","2079","3667","0","56.69","26.23"
"10","017","00","020","0001","0240","618","305","313","28","646","1178","0","54.84","25.89"
"10","017","00","020","0001","0241","674","308","366","25","699","1151","0","60.73","26.76"
"10","017","00","020","0001","0242","685","349","336","49","734","1338","0","54.86","26.08"
"10","017","00","020","0002","0000","1317","689","628","48","1365","2457","0","55.56","28.04"
"10","017","00","020","0002","0243","621","347","274","31","652","1046","0","62.33","33.17"
"10","017","00","020","0002","0244","696","342","354","17","713","1411","0","50.53","24.24"
"10","017","00","020","0003","0000","1874","843","1031","83","1957","3320","0","58.95","25.39"
"10","017","00","020","0003","0247","612","298","314","35","647","1030","0","62.82","28.93"
"10","017","00","020","0003","0248","629","277","352","14","643","1172","0","54.86","23.63"
"10","017","00","020","0003","0249","633","268","365","34","667","1118","0","59.66","23.97"
"10","017","00","020","0004","0000","1143","537","606","77","1220","1823","0","66.92","29.46"
"10","017","00","020","0004","0250","578","282","296","34","612","894","0","68.46","31.54"
"10","017","00","020","0004","0251","565","255","310","43","608","929","0","65.45","27.45"
"10","017","00","020","0005","0000","1135","498","637","54","1189","2074","0","57.33","24.01"
"10","017","00","020","0005","0252","632","274","358","41","673","1160","0","58.02","23.62"
"10","017","00","020","0005","0253","503","224","279","13","516","914","0","56.46","24.51"
"10","017","00","020","0006","0000","668","354","314","51","719","1433","0","50.17","24.70"
"10","017","00","020","0006","0254","123","72","51","13","136","279","0","48.75","25.81"
"10","017","00","020","0006","0255","545","282","263","38","583","1154","0","50.52","24.44"
"10","017","00","020","0007","0000","587","311","276","41","628","1116","0","56.27","27.87"
"10","017","00","020","0007","0256","587","311","276","41","628","1116","0","56.27","27.87"
"10","017","00","020","0008","0000","1327","712","615","67","1394","2224","0","62.68","32.01"
"10","017","00","020","0008","0260","556","305","251","40","596","960","0","62.08","31.77"
"10","017","00","020","0008","0261","771","407","364","27","798","1264","0","63.13","32.20"
"10","017","00","020","0009","0000","2142","1075","1067","116","2258","4253","0","53.09","25.28"
"10","017","00","020","0009","0257","636","309","327","43","679","1292","0","52.55","23.92"
"10","017","00","020","0009","0258","844","428","416","26","870","1668","0","52.16","25.66"
"10","017","00","020","0009","0259","662","338","324","47","709","1293","0","54.83","26.14"
"10","017","00","020","0010","0000","1869","990","879","96","1965","3509","0","56.00","28.21"
"10","017","00","020","0010","0266","966","510","456","58","1024","1743","0","58.75","29.26"
"10","017","00","020","0010","0267","903","480","423","38","941","1766","0","53.28","27.18"
"10","017","00","020","0011","0000","925","473","452","49","974","1975","0","49.32","23.95"
"10","017","00","020","0011","0262","490","265","225","30","520","1025","0","50.73","25.85"
"10","017","00","020","0011","0263","435","208","227","19","454","950","0","47.79","21.89"
"10","017","00","020","0012","0000","269","149","120","17","286","389","0","73.52","38.30"
"10","017","00","020","0012","0276","269","149","120","17","286","389","0","73.52","38.30"
"10","017","00","020","0013","0000","240","124","116","19","259","333","0","77.78","37.24"
"10","017","00","020","0013","0277","240","124","116","19","259","333","0","77.78","37.24"
"10","017","00","020","0014","0000","188","111","77","24","212","320","0","66.25","34.69"
"10","017","00","020","0014","0278","188","111","77","24","212","320","0","66.25","34.69"
"10","017","00","020","0015","0000","1117","505","612","41","1158","1918","0","60.38","26.33"
"10","017","00","020","0015","0279","561","254","307","26","587","961","0","61.08","26.43"
"10","017","00","020","0015","0280","556","251","305","15","571","957","0","59.67","26.23"
"10","017","00","020","0016","0000","298","185","113","30","328","435","0","75.40","42.53"
"10","017","00","020","0016","0281","298","185","113","30","328","435","0","75.40","42.53"
"10","017","00","020","0017","0000","1081","517","564","42","1123","1823","0","61.60","28.36"
"10","017","00","020","0017","0245","537","255","282","20","557","933","0","59.70","27.33"
"10","017","00","020","0017","0246","544","262","282","22","566","890","0","63.60","29.44"
"10","017","00","020","0018","0000","2899","1482","1417","134","3033","5965","0","50.85","24.84"
"10","017","00","020","0018","0268","550","311","239","24","574","1117","0","51.39","27.84"
"10","017","00","020","0018","0269","568","285","283","29","597","1224","0","48.77","23.28"
"10","017","00","020","0018","0270","572","294","278","31","603","1202","0","50.17","24.46"
"10","017","00","020","0018","0271","562","279","283","20","582","1189","0","48.95","23.47"
"10","017","00","020","0018","0272","647","313","334","30","677","1233","0","54.91","25.39"
"10","017","00","020","0019","0000","1890","991","899","85","1975","3603","0","54.82","27.50"
"10","017","00","020","0019","0273","702","366","336","37","739","1319","0","56.03","27.75"
"10","017","00","020","0019","0274","534","300","234","25","559","1001","0","55.84","29.97"
"10","017","00","020","0019","0275","654","325","329","23","677","1283","0","52.77","25.33"
"10","017","00","020","0020","0000","1222","609","613","57","1279","2439","0","52.44","24.97"
"10","017","00","020","0020","0264","607","308","299","33","640","1204","0","53.16","25.58"
"10","017","00","020","0020","0265","615","301","314","24","639","1235","0","51.74","24.37"
"10","017","00","030","0000","0000","17297","8165","9132","735","18032","32648","38285","55.23","25.01"
"10","017","00","030","0001","0000","751","361","390","33","784","1345","0","58.29","26.84"
"10","017","00","030","0001","0210","751","361","390","33","784","1345","0","58.29","26.84"
"10","017","00","030","0002","0000","327","163","164","32","359","578","0","62.11","28.20"
"10","017","00","030","0002","0212","327","163","164","32","359","578","0","62.11","28.20"
"10","017","00","030","0003","0000","563","300","263","52","615","801","0","76.78","37.45"
"10","017","00","030","0003","0213","563","300","263","52","615","801","0","76.78","37.45"
"10","017","00","030","0004","0000","1927","936","991","84","2011","3555","0","56.57","26.33"
"10","017","00","030","0004","0214","530","241","289","33","563","1011","0","55.69","23.84"
"10","017","00","030","0004","0215","641","300","341","29","670","1205","0","55.60","24.90"
"10","017","00","030","0004","0216","756","395","361","22","778","1339","0","58.10","29.50"
"10","017","00","030","0005","0000","1184","510","674","52","1236","2527","0","48.91","20.18"
"10","017","00","030","0005","0226","604","268","336","38","642","1227","0","52.32","21.84"
"10","017","00","030","0005","0227","580","242","338","14","594","1300","0","45.69","18.62"
"10","017","00","030","0006","0000","1482","638","844","72","1554","2916","0","53.29","21.88"
"10","017","00","030","0006","0228","499","168","331","39","538","958","0","56.16","17.54"
"10","017","00","030","0006","0229","440","206","234","15","455","935","0","48.66","22.03"
"10","017","00","030","0006","0230","543","264","279","18","561","1023","0","54.84","25.81"
"10","017","00","030","0007","0000","1352","607","745","46","1398","2482","0","56.33","24.46"
"10","017","00","030","0007","0219","681","321","360","23","704","1075","0","65.49","29.86"
"10","017","00","030","0007","0220","671","286","385","23","694","1407","0","49.32","20.33"
"10","017","00","030","0008","0000","1365","643","722","59","1424","2461","0","57.86","26.13"
"10","017","00","030","0008","0217","805","369","436","32","837","1404","0","59.62","26.28"
"10","017","00","030","0008","0218","560","274","286","27","587","1057","0","55.53","25.92"
"10","017","00","030","0009","0000","250","138","112","18","268","397","0","67.51","34.76"
"10","017","00","030","0009","0221","250","138","112","18","268","397","0","67.51","34.76"
"10","017","00","030","0010","0000","2554","1234","1320","89","2643","4618","0","57.23","26.72"
"10","017","00","030","0010","0222","775","387","388","36","811","1459","0","55.59","26.53"
"10","017","00","030","0010","0223","592","290","302","13","605","1014","0","59.66","28.60"
"10","017","00","030","0010","0224","600","292","308","18","618","1048","0","58.97","27.86"
"10","017","00","030","0010","0225","587","265","322","22","609","1097","0","55.52","24.16"
"10","017","00","030","0011","0000","255","148","107","18","273","398","0","68.59","37.19"
"10","017","00","030","0011","0211","255","148","107","18","273","398","0","68.59","37.19"
"10","017","00","030","0012","0000","2422","1153","1269","84","2506","4779","0","52.44","24.13"
"10","017","00","030","0012","0236","691","311","380","17","708","1320","0","53.64","23.56"
"10","017","00","030","0012","0237","576","294","282","23","599","1205","0","49.71","24.40"
"10","017","00","030","0012","0238","489","231","258","25","514","941","0","54.62","24.55"
"10","017","00","030","0012","0239","666","317","349","19","685","1313","0","52.17","24.14"
"10","017","00","030","0013","0000","2865","1334","1531","96","2961","5791","0","51.13","23.04"
"10","017","00","030","0013","0231","590","286","304","21","611","1182","0","51.69","24.20"
"10","017","00","030","0013","0232","505","256","249","29","534","1187","0","44.99","21.57"
"10","017","00","030","0013","0233","495","209","286","7","502","935","0","53.69","22.35"
"10","017","00","030","0013","0234","693","336","357","19","712","1346","0","52.90","24.96"
"10","017","00","030","0013","0235","582","247","335","20","602","1141","0","52.76","21.65"
"10","017","00","040","0000","0000","19073","9633","9440","973","20046","34066","41272","58.84","28.28"
"10","017","00","040","0001","0000","826","427","399","51","877","1589","0","55.19","26.87"
"10","017","00","040","0001","0080","450","248","202","28","478","816","0","58.58","30.39"
"10","017","00","040","0001","0081","376","179","197","23","399","773","0","51.62","23.16"
"10","017","00","040","0002","0000","509","256","253","19","528","977","0","54.04","26.20"
"10","017","00","040","0002","0082","509","256","253","19","528","977","0","54.04","26.20"
"10","017","00","040","0003","0000","685","357","328","29","714","1419","0","50.32","25.16"
"10","017","00","040","0003","0083","407","217","190","13","420","914","0","45.95","23.74"
"10","017","00","040","0003","0084","278","140","138","16","294","505","0","58.22","27.72"
"10","017","00","040","0004","0000","947","416","531","44","991","1649","0","60.10","25.23"
"10","017","00","040","0004","0085","488","204","284","25","513","848","0","60.50","24.06"
"10","017","00","040","0004","0086","459","212","247","19","478","801","0","59.68","26.47"
"10","017","00","040","0005","0000","1179","540","639","44","1223","2174","0","56.26","24.84"
"10","017","00","040","0005","0087","654","289","365","33","687","1169","0","58.77","24.72"
"10","017","00","040","0005","0088","525","251","274","11","536","1005","0","53.33","24.98"
"10","017","00","040","0006","0000","921","432","489","37","958","1608","0","59.58","26.87"
"10","017","00","040","0006","0089","416","202","214","21","437","721","0","60.61","28.02"
"10","017","00","040","0006","0090","505","230","275","16","521","887","0","58.74","25.93"
"10","017","00","040","0007","0000","488","274","214","35","523","868","0","60.25","31.57"
"10","017","00","040","0007","0091","488","274","214","35","523","868","0","60.25","31.57"
"10","017","00","040","0008","0000","445","247","198","14","459","877","0","52.34","28.16"
"10","017","00","040","0008","0092","445","247","198","14","459","877","0","52.34","28.16"
"10","017","00","040","0009","0000","508","275","233","23","531","781","0","67.99","35.21"
"10","017","00","040","0009","0093","508","275","233","23","531","781","0","67.99","35.21"
"10","017","00","040","0010","0000","821","430","391","30","851","1344","0","63.32","31.99"
"10","017","00","040","0010","0094","589","312","277","17","606","945","0","64.13","33.02"
"10","017","00","040","0010","0095","232","118","114","13","245","399","0","61.40","29.57"
"10","017","00","040","0011","0000","412","200","212","22","434","692","0","62.72","28.90"
"10","017","00","040","0011","0096","412","200","212","22","434","692","0","62.72","28.90"
"10","017","00","040","0012","0000","474","238","236","30","504","863","0","58.40","27.58"
"10","017","00","040","0012","0097","474","238","236","30","504","863","0","58.40","27.58"
"10","017","00","040","0013","0000","1326","720","606","69","1395","2410","0","57.88","29.88"
"10","017","00","040","0013","0098","670","372","298","40","710","1194","0","59.46","31.16"
"10","017","00","040","0013","0099","656","348","308","29","685","1216","0","56.33","28.62"
"10","017","00","040","0014","0000","405","214","191","20","425","677","0","62.78","31.61"
"10","017","00","040","0014","0100","405","214","191","20","425","677","0","62.78","31.61"
"10","017","00","040","0015","0000","650","364","286","35","685","1206","0","56.80","30.18"
"10","017","00","040","0015","0101","305","175","130","15","320","607","0","52.72","28.83"
"10","017","00","040","0015","0102","345","189","156","20","365","599","0","60.93","31.55"
"10","017","00","040","0016","0000","468","252","216","20","488","752","0","64.89","33.51"
"10","017","00","040","0016","0103","468","252","216","20","488","752","0","64.89","33.51"
"10","017","00","040","0017","0000","1068","536","532","75","1143","1671","0","68.40","32.08"
"10","017","00","040","0017","0104","626","323","303","41","667","938","0","71.11","34.43"
"10","017","00","040","0017","0105","442","213","229","34","476","733","0","64.94","29.06"
"10","017","00","040","0018","0000","416","224","192","26","442","738","0","59.89","30.35"
"10","017","00","040","0018","0106","416","224","192","26","442","738","0","59.89","30.35"
"10","017","00","040","0019","0000","514","256","258","32","546","828","0","65.94","30.92"
"10","017","00","040","0019","0107","514","256","258","32","546","828","0","65.94","30.92"
"10","017","00","040","0020","0000","398","224","174","28","426","792","0","53.79","28.28"
"10","017","00","040","0020","0108","398","224","174","28","426","792","0","53.79","28.28"
"10","017","00","040","0021","0000","354","182","172","10","364","676","0","53.85","26.92"
"10","017","00","040","0021","0109","354","182","172","10","364","676","0","53.85","26.92"
"10","017","00","040","0022","0000","502","245","257","28","530","926","0","57.24","26.46"
"10","017","00","040","0022","0110","502","245","257","28","530","926","0","57.24","26.46"
"10","017","00","040","0023","0000","602","321","281","37","639","1056","0","60.51","30.40"
"10","017","00","040","0023","0111","602","321","281","37","639","1056","0","60.51","30.40"
"10","017","00","040","0024","0000","1452","639","813","66","1518","2617","0","58.01","24.42"
"10","017","00","040","0024","0112","606","308","298","42","648","1156","0","56.06","26.64"
"10","017","00","040","0024","0113","846","331","515","24","870","1461","0","59.55","22.66"
"10","017","00","040","0025","0000","390","203","187","25","415","672","0","61.76","30.21"
"10","017","00","040","0025","0116","390","203","187","25","415","672","0","61.76","30.21"
"10","017","00","040","0026","0000","333","180","153","29","362","554","0","65.34","32.49"
"10","017","00","040","0026","0117","333","180","153","29","362","554","0","65.34","32.49"
"10","017","00","040","0027","0000","414","245","169","23","437","673","0","64.93","36.40"
"10","017","00","040","0027","0118","414","245","169","23","437","673","0","64.93","36.40"
"10","017","00","040","0028","0000","318","152","166","9","327","527","0","62.05","28.84"
"10","017","00","040","0028","0119","318","152","166","9","327","527","0","62.05","28.84"
"10","017","00","040","0029","0000","1248","584","664","63","1311","2450","0","53.51","23.84"
"10","017","00","040","0029","0114","544","259","285","27","571","1310","0","43.59","19.77"
"10","017","00","040","0029","0115","704","325","379","36","740","1140","0","64.91","28.51"
"10","017","00","050","0000","0000","21868","10890","10978","1159","23027","39475","45057","58.33","27.59"
"10","017","00","050","0001","0000","426","218","208","33","459","743","0","61.78","29.34"
"10","017","00","050","0001","0120","426","218","208","33","459","743","0","61.78","29.34"
"10","017","00","050","0002","0000","651","312","339","34","685","975","0","70.26","32.00"
"10","017","00","050","0002","0121","651","312","339","34","685","975","0","70.26","32.00"
"10","017","00","050","0003","0000","441","245","196","37","478","721","0","66.30","33.98"
"10","017","00","050","0003","0122","441","245","196","37","478","721","0","66.30","33.98"
"10","017","00","050","0004","0000","536","299","237","35","571","918","0","62.20","32.57"
"10","017","00","050","0004","0123","536","299","237","35","571","918","0","62.20","32.57"
"10","017","00","050","0005","0000","502","278","224","28","530","742","0","71.43","37.47"
"10","017","00","050","0005","0124","502","278","224","28","530","742","0","71.43","37.47"
"10","017","00","050","0006","0000","660","335","325","44","704","1183","0","59.51","28.32"
"10","017","00","050","0006","0125","660","335","325","44","704","1183","0","59.51","28.32"
"10","017","00","050","0007","0000","420","187","233","24","444","703","0","63.16","26.60"
"10","017","00","050","0007","0126","420","187","233","24","444","703","0","63.16","26.60"
"10","017","00","050","0008","0000","641","347","294","52","693","1101","0","62.94","31.52"
"10","017","00","050","0008","0127","641","347","294","52","693","1101","0","62.94","31.52"
"10","017","00","050","0009","0000","496","245","251","42","538","936","0","57.48","26.18"
"10","017","00","050","0009","0128","496","245","251","42","538","936","0","57.48","26.18"
"10","017","00","050","0010","0000","689","339","350","45","734","1214","0","60.46","27.92"
"10","017","00","050","0010","0129","689","339","350","45","734","1214","0","60.46","27.92"
"10","017","00","050","0011","0000","910","473","437","60","970","1617","0","59.99","29.25"
"10","017","00","050","0011","0130","390","201","189","29","419","759","0","55.20","26.48"
"10","017","00","050","0011","0131","520","272","248","31","551","858","0","64.22","31.70"
"10","017","00","050","0012","0000","823","437","386","50","873","1464","0","59.63","29.85"
"10","017","00","050","0012","0135","823","437","386","50","873","1464","0","59.63","29.85"
"10","017","00","050","0013","0000","557","269","288","34","591","1215","0","48.64","22.14"
"10","017","00","050","0013","0136","557","269","288","34","591","1215","0","48.64","22.14"
"10","017","00","050","0014","0000","284","130","154","23","307","529","0","58.03","24.57"
"10","017","00","050","0014","0133","284","130","154","23","307","529","0","58.03","24.57"
"10","017","00","050","0015","0000","483","282","201","38","521","817","0","63.77","34.52"
"10","017","00","050","0015","0134","483","282","201","38","521","817","0","63.77","34.52"
"10","017","00","050","0016","0000","392","226","166","31","423","635","0","66.61","35.59"
"10","017","00","050","0016","0156","392","226","166","31","423","635","0","66.61","35.59"
"10","017","00","050","0017","0000","462","269","193","22","484","786","0","61.58","34.22"
"10","017","00","050","0017","0155","462","269","193","22","484","786","0","61.58","34.22"
"10","017","00","050","0018","0000","527","286","241","23","550","854","0","64.40","33.49"
"10","017","00","050","0018","0154","527","286","241","23","550","854","0","64.40","33.49"
"10","017","00","050","0019","0000","764","379","385","51","815","1485","0","54.88","25.52"
"10","017","00","050","0019","0153","764","379","385","51","815","1485","0","54.88","25.52"
"10","017","00","050","0020","0000","3005","1292","1713","105","3110","5170","0","60.15","24.99"
"10","017","00","050","0020","0140","661","284","377","12","673","1025","0","65.66","27.71"
"10","017","00","050","0020","0141","743","332","411","29","772","1410","0","54.75","23.55"
"10","017","00","050","0020","0142","861","365","496","24","885","1472","0","60.12","24.80"
"10","017","00","050","0020","0143","740","311","429","40","780","1263","0","61.76","24.62"
"10","017","00","050","0021","0000","2736","1292","1444","116","2852","5278","0","54.04","24.48"
"10","017","00","050","0021","0144","623","311","312","41","664","1198","0","55.43","25.96"
"10","017","00","050","0021","0145","456","227","229","13","469","818","0","57.33","27.75"
"10","017","00","050","0021","0146","609","263","346","19","628","1260","0","49.84","20.87"
"10","017","00","050","0021","0147","626","305","321","24","650","1281","0","50.74","23.81"
"10","017","00","050","0021","0148","422","186","236","19","441","721","0","61.17","25.80"
"10","017","00","050","0022","0000","2048","1077","971","84","2132","3707","0","57.51","29.05"
"10","017","00","050","0022","0137","671","351","320","20","691","1212","0","57.01","28.96"
"10","017","00","050","0022","0138","685","355","330","30","715","1376","0","51.96","25.80"
"10","017","00","050","0022","0139","692","371","321","34","726","1119","0","64.88","33.15"
"10","017","00","050","0023","0000","266","107","159","25","291","420","0","69.29","25.48"
"10","017","00","050","0023","0132","266","107","159","25","291","420","0","69.29","25.48"
"10","017","00","050","0024","0000","3149","1566","1583","123","3272","6262","0","52.25","25.01"
"10","017","00","050","0024","0149","784","389","395","31","815","1573","0","51.81","24.73"
"10","017","00","050","0024","0150","732","368","364","18","750","1546","0","48.51","23.80"
"10","017","00","050","0024","0151","833","413","420","43","876","1605","0","54.58","25.73"
"10","017","00","050","0024","0152","800","396","404","31","831","1538","0","54.03","25.75"
"10","017","00","060","0000","0000","37084","17884","19200","1509","38593","68081","80152","56.69","26.27"
"10","017","00","060","0001","0000","592","292","300","27","619","1140","0","54.30","25.61"
"10","017","00","060","0001","0158","592","292","300","27","619","1140","0","54.30","25.61"
"10","017","00","060","0002","0000","517","279","238","17","534","958","0","55.74","29.12"
"10","017","00","060","0002","0159","517","279","238","17","534","958","0","55.74","29.12"
"10","017","00","060","0003","0000","611","327","284","39","650","1265","0","51.38","25.85"
"10","017","00","060","0003","0157","611","327","284","39","650","1265","0","51.38","25.85"
"10","017","00","060","0004","0000","531","271","260","29","560","946","0","59.20","28.65"
"10","017","00","060","0004","0160","531","271","260","29","560","946","0","59.20","28.65"
"10","017","00","060","0005","0000","495","282","213","20","515","828","0","62.20","34.06"
"10","017","00","060","0005","0161","495","282","213","20","515","828","0","62.20","34.06"
"10","017","00","060","0006","0000","1016","499","517","62","1078","1897","0","56.83","26.30"
"10","017","00","060","0006","0162","765","370","395","32","797","1320","0","60.38","28.03"
"10","017","00","060","0006","0163","251","129","122","30","281","577","0","48.70","22.36"
"10","017","00","060","0007","0000","1040","550","490","62","1102","1813","0","60.78","30.34"
"10","017","00","060","0007","0164","788","424","364","46","834","1369","0","60.92","30.97"
"10","017","00","060","0007","0165","252","126","126","16","268","444","0","60.36","28.38"
"10","017","00","060","0008","0000","1521","844","677","85","1606","3019","0","53.20","27.96"
"10","017","00","060","0008","0168","872","500","372","47","919","1776","0","51.75","28.15"
"10","017","00","060","0008","0169","649","344","305","38","687","1243","0","55.27","27.67"
"10","017","00","060","0009","0000","470","252","218","30","500","802","0","62.34","31.42"
"10","017","00","060","0009","0166","470","252","218","30","500","802","0","62.34","31.42"
"10","017","00","060","0010","0000","353","202","151","19","372","602","0","61.79","33.55"
"10","017","00","060","0010","0167","353","202","151","19","372","602","0","61.79","33.55"
"10","017","00","060","0011","0000","1937","927","1010","102","2039","3808","0","53.55","24.34"
"10","017","00","060","0011","0197","955","468","487","51","1006","1851","0","54.35","25.28"
"10","017","00","060","0011","0198","982","459","523","51","1033","1957","0","52.78","23.45"
"10","017","00","060","0012","0000","997","458","539","47","1044","1636","0","63.81","28.00"
"10","017","00","060","0012","0205","997","458","539","47","1044","1636","0","63.81","28.00"
"10","017","00","060","0013","0000","2739","1336","1403","127","2866","5311","0","53.96","25.16"
"10","017","00","060","0013","0206","619","333","286","35","654","1234","0","53.00","26.99"
"10","017","00","060","0013","0207","712","292","420","25","737","1368","0","53.87","21.35"
"10","017","00","060","0013","0208","741","388","353","40","781","1380","0","56.59","28.12"
"10","017","00","060","0013","0209","667","323","344","27","694","1329","0","52.22","24.30"
"10","017","00","060","0014","0000","1880","925","955","93","1973","3900","0","50.59","23.72"
"10","017","00","060","0014","0199","1048","515","533","56","1104","2108","0","52.37","24.43"
"10","017","00","060","0014","0200","832","410","422","37","869","1792","0","48.49","22.88"
"10","017","00","060","0015","0000","1325","653","672","94","1419","2345","0","60.51","27.85"
"10","017","00","060","0015","0170","630","314","316","43","673","1112","0","60.52","28.24"
"10","017","00","060","0015","0171","695","339","356","51","746","1233","0","60.50","27.49"
"10","017","00","060","0016","0000","2616","1172","1444","86","2702","4503","0","60.00","26.03"
"10","017","00","060","0016","0175","908","397","511","33","941","1481","0","63.54","26.81"
"10","017","00","060","0016","0176","855","368","487","35","890","1670","0","53.29","22.04"
"10","017","00","060","0016","0177","853","407","446","18","871","1352","0","64.42","30.10"
"10","017","00","060","0017","0000","1763","813","950","102","1865","3243","0","57.51","25.07"
"10","017","00","060","0017","0178","839","395","444","63","902","1642","0","54.93","24.06"
"10","017","00","060","0017","0179","924","418","506","39","963","1601","0","60.15","26.11"
"10","017","00","060","0018","0000","2124","982","1142","84","2208","3723","0","59.31","26.38"
"10","017","00","060","0018","0180","820","382","438","34","854","1547","0","55.20","24.69"
"10","017","00","060","0018","0181","647","279","368","24","671","1095","0","61.28","25.48"
"10","017","00","060","0018","0182","657","321","336","26","683","1081","0","63.18","29.69"
"10","017","00","060","0019","0000","1319","634","685","59","1378","2307","0","59.73","27.48"
"10","017","00","060","0019","0183","684","310","374","26","710","1167","0","60.84","26.56"
"10","017","00","060","0019","0184","635","324","311","33","668","1140","0","58.60","28.42"
"10","017","00","060","0020","0000","1319","683","636","23","1342","2618","0","51.26","26.09"
"10","017","00","060","0020","0188","563","279","284","18","581","1317","0","44.12","21.18"
"10","017","00","060","0020","0189","756","404","352","5","761","1301","0","58.49","31.05"
"10","017","00","060","0021","0000","2503","1134","1369","55","2558","4637","0","55.16","24.46"
"10","017","00","060","0021","0201","690","340","350","21","711","1468","0","48.43","23.16"
"10","017","00","060","0021","0202","652","246","406","16","668","1145","0","58.34","21.48"
"10","017","00","060","0021","0203","663","297","366","9","672","1120","0","60.00","26.52"
"10","017","00","060","0021","0204","498","251","247","9","507","904","0","56.08","27.77"
"10","017","00","060","0022","0000","1849","880","969","54","1903","3168","0","60.07","27.78"
"10","017","00","060","0022","0185","961","460","501","22","983","1651","0","59.54","27.86"
"10","017","00","060","0022","0186","409","175","234","15","424","672","0","63.10","26.04"
"10","017","00","060","0022","0187","479","245","234","17","496","845","0","58.70","28.99"
"10","017","00","060","0023","0000","2381","1141","1240","56","2437","4572","0","53.30","24.96"
"10","017","00","060","0023","0194","858","399","459","24","882","1637","0","53.88","24.37"
"10","017","00","060","0023","0195","567","281","286","11","578","1030","0","56.12","27.28"
"10","017","00","060","0023","0196","956","461","495","21","977","1905","0","51.29","24.20"
"10","017","00","060","0024","0000","2824","1249","1575","74","2898","4909","0","59.03","25.44"
"10","017","00","060","0024","0190","919","416","503","41","960","1515","0","63.37","27.46"
"10","017","00","060","0024","0191","755","357","398","18","773","1374","0","56.26","25.98"
"10","017","00","060","0024","0192","602","246","356","7","609","1076","0","56.60","22.86"
"10","017","00","060","0024","0193","548","230","318","8","556","944","0","58.90","24.36"
"10","017","00","060","0025","0000","2362","1099","1263","63","2425","4131","0","58.70","26.60"
"10","017","00","060","0025","0172","969","461","508","25","994","1603","0","62.01","28.76"
"10","017","00","060","0025","0173","977","445","532","34","1011","1776","0","56.93","25.06"
"10","017","00","060","0025","0174","416","193","223","4","420","752","0","55.85","25.66"
"10","017","00","070","0000","0000","24968","11206","13762","880","25848","45747","52856","56.50","24.50"
"10","017","00","070","0001","0000","575","275","300","26","601","991","0","60.65","27.75"
"10","017","00","070","0001","0041","575","275","300","26","601","991","0","60.65","27.75"
"10","017","00","070","0002","0000","668","287","381","21","689","1112","0","61.96","25.81"
"10","017","00","070","0002","0042","668","287","381","21","689","1112","0","61.96","25.81"
"10","017","00","070","0003","0000","668","309","359","20","688","1206","0","57.05","25.62"
"10","017","00","070","0003","0043","668","309","359","20","688","1206","0","57.05","25.62"
"10","017","00","070","0004","0000","1251","561","690","53","1304","2173","0","60.01","25.82"
"10","017","00","070","0004","0044","653","307","346","29","682","1066","0","63.98","28.80"
"10","017","00","070","0004","0045","598","254","344","24","622","1107","0","56.19","22.94"
"10","017","00","070","0005","0000","467","246","221","31","498","716","0","69.55","34.36"
"10","017","00","070","0005","0046","467","246","221","31","498","716","0","69.55","34.36"
"10","017","00","070","0006","0000","651","276","375","23","674","1492","0","45.17","18.50"
"10","017","00","070","0006","0047","651","276","375","23","674","1492","0","45.17","18.50"
"10","017","00","070","0007","0000","397","172","225","20","417","698","0","59.74","24.64"
"10","017","00","070","0007","0048","397","172","225","20","417","698","0","59.74","24.64"
"10","017","00","070","0008","0000","714","365","349","31","745","1437","0","51.84","25.40"
"10","017","00","070","0008","0049","714","365","349","31","745","1437","0","51.84","25.40"
"10","017","00","070","0009","0000","846","368","478","34","880","1494","0","58.90","24.63"
"10","017","00","070","0009","0050","846","368","478","34","880","1494","0","58.90","24.63"
"10","017","00","070","0010","0000","803","335","468","43","846","1393","0","60.73","24.05"
"10","017","00","070","0010","0051","803","335","468","43","846","1393","0","60.73","24.05"
"10","017","00","070","0011","0000","1081","509","572","25","1106","1883","0","58.74","27.03"
"10","017","00","070","0011","0052","549","258","291","18","567","929","0","61.03","27.77"
"10","017","00","070","0011","0053","532","251","281","7","539","954","0","56.50","26.31"
"10","017","00","070","0012","0000","1055","493","562","43","1098","1798","0","61.07","27.42"
"10","017","00","070","0012","0058","527","223","304","26","553","919","0","60.17","24.27"
"10","017","00","070","0012","0059","528","270","258","17","545","879","0","62.00","30.72"
"10","017","00","070","0013","0000","1894","806","1088","67","1961","3339","0","58.73","24.14"
"10","017","00","070","0013","0060","688","306","382","36","724","1269","0","57.05","24.11"
"10","017","00","070","0013","0061","762","330","432","23","785","1322","0","59.38","24.96"
"10","017","00","070","0013","0062","444","170","274","8","452","748","0","60.43","22.73"
"10","017","00","070","0014","0000","1344","628","716","75","1419","2570","0","55.21","24.44"
"10","017","00","070","0014","0063","730","350","380","42","772","1361","0","56.72","25.72"
"10","017","00","070","0014","0064","614","278","336","33","647","1209","0","53.52","22.99"
"10","017","00","070","0015","0000","745","356","389","30","775","1292","0","59.98","27.55"
"10","017","00","070","0015","0079","745","356","389","30","775","1292","0","59.98","27.55"
"10","017","00","070","0016","0000","2387","1005","1382","68","2455","3980","0","61.68","25.25"
"10","017","00","070","0016","0054","394","169","225","14","408","689","0","59.22","24.53"
"10","017","00","070","0016","0055","560","222","338","13","573","913","0","62.76","24.32"
"10","017","00","070","0016","0056","703","282","421","19","722","1126","0","64.12","25.04"
"10","017","00","070","0016","0057","730","332","398","22","752","1252","0","60.06","26.52"
"10","017","00","070","0017","0000","2393","1133","1260","70","2463","4812","0","51.18","23.55"
"10","017","00","070","0017","0075","829","387","442","20","849","1468","0","57.83","26.36"
"10","017","00","070","0017","0076","508","256","252","12","520","1061","0","49.01","24.13"
"10","017","00","070","0017","0077","517","261","256","22","539","1157","0","46.59","22.56"
"10","017","00","070","0017","0078","539","229","310","16","555","1126","0","49.29","20.34"
"10","017","00","070","0018","0000","1828","771","1057","59","1887","3325","0","56.75","23.19"
"10","017","00","070","0018","0065","502","209","293","14","516","941","0","54.84","22.21"
"10","017","00","070","0018","0066","529","238","291","24","553","994","0","55.63","23.94"
"10","017","00","070","0018","0067","797","324","473","21","818","1390","0","58.85","23.31"
"10","017","00","070","0019","0000","1229","584","645","38","1267","2583","0","49.05","22.61"
"10","017","00","070","0019","0073","670","324","346","20","690","1448","0","47.65","22.38"
"10","017","00","070","0019","0074","559","260","299","18","577","1135","0","50.84","22.91"
"10","017","00","070","0020","0000","3972","1727","2245","103","4075","7453","0","54.68","23.17"
"10","017","00","070","0020","0068","835","372","463","26","861","1431","0","60.17","26.00"
"10","017","00","070","0020","0069","850","384","466","13","863","1454","0","59.35","26.41"
"10","017","00","070","0020","0070","703","341","362","19","722","1422","0","50.77","23.98"
"10","017","00","070","0020","0071","716","243","473","14","730","1497","0","48.76","16.23"
"10","017","00","070","0020","0072","868","387","481","31","899","1649","0","54.52","23.47"
"10","018","00","000","0000","0000","207819","108541","99278","8524","216343","352197","451203","61.43","30.82"
"10","018","00","010","0000","0000","97885","50676","47209","3457","101342","164761","220877","61.51","30.76"
"10","018","00","010","0001","0000","375","224","151","27","402","671","0","59.91","33.38"
"10","018","00","010","0001","0121","375","224","151","27","402","671","0","59.91","33.38"
"10","018","00","010","0002","0000","816","420","396","35","851","1393","0","61.09","30.15"
"10","018","00","010","0002","0123","544","275","269","27","571","964","0","59.23","28.53"
"10","018","00","010","0002","0124","272","145","127","8","280","429","0","65.27","33.80"
"10","018","00","010","0003","0000","501","294","207","15","516","823","0","62.70","35.72"
"10","018","00","010","0003","0122","501","294","207","15","516","823","0","62.70","35.72"
"10","018","00","010","0004","0000","262","166","96","17","279","445","0","62.70","37.30"
"10","018","00","010","0004","0120","262","166","96","17","279","445","0","62.70","37.30"
"10","018","00","010","0005","0000","323","177","146","16","339","501","0","67.66","35.33"
"10","018","00","010","0005","0005","323","177","146","16","339","501","0","67.66","35.33"
"10","018","00","010","0006","0000","131","83","48","5","136","241","0","56.43","34.44"
"10","018","00","010","0006","0004","131","83","48","5","136","241","0","56.43","34.44"
"10","018","00","010","0007","0000","343","178","165","12","355","533","0","66.60","33.40"
"10","018","00","010","0007","0006","343","178","165","12","355","533","0","66.60","33.40"
"10","018","00","010","0008","0000","228","124","104","8","236","427","0","55.27","29.04"
"10","018","00","010","0008","0135","228","124","104","8","236","427","0","55.27","29.04"
"10","018","00","010","0009","0000","410","221","189","19","429","682","0","62.90","32.40"
"10","018","00","010","0009","0134","410","221","189","19","429","682","0","62.90","32.40"
"10","018","00","010","0010","0000","464","247","217","17","481","734","0","65.53","33.65"
"10","018","00","010","0010","0133","464","247","217","17","481","734","0","65.53","33.65"
"10","018","00","010","0011","0000","623","315","308","9","632","1679","0","37.64","18.76"
"10","018","00","010","0011","0001","623","315","308","9","632","1679","0","37.64","18.76"
"10","018","00","010","0012","0000","352","192","160","6","358","540","0","66.30","35.56"
"10","018","00","010","0012","0007","352","192","160","6","358","540","0","66.30","35.56"
"10","018","00","010","0013","0000","1782","906","876","50","1832","3062","0","59.83","29.59"
"10","018","00","010","0013","0031","544","276","268","14","558","989","0","56.42","27.91"
"10","018","00","010","0013","0032","646","318","328","24","670","1147","0","58.41","27.72"
"10","018","00","010","0013","0033","592","312","280","12","604","926","0","65.23","33.69"
"10","018","00","010","0014","0000","1550","853","697","56","1606","2674","0","60.06","31.90"
"10","018","00","010","0014","0136","432","234","198","18","450","783","0","57.47","29.89"
"10","018","00","010","0014","0137","541","307","234","25","566","909","0","62.27","33.77"
"10","018","00","010","0014","0138","577","312","265","13","590","982","0","60.08","31.77"
"10","018","00","010","0015","0000","842","458","384","33","875","1308","0","66.90","35.02"
"10","018","00","010","0015","0139","372","195","177","6","378","568","0","66.55","34.33"
"10","018","00","010","0015","0140","470","263","207","27","497","740","0","67.16","35.54"
"10","018","00","010","0016","0000","2770","1446","1324","102","2872","5301","0","54.18","27.28"
"10","018","00","010","0016","0125","589","330","259","22","611","1035","0","59.03","31.88"
"10","018","00","010","0016","0126","581","287","294","9","590","1074","0","54.93","26.72"
"10","018","00","010","0016","0127","545","280","265","29","574","1091","0","52.61","25.66"
"10","018","00","010","0016","0128","539","279","260","20","559","1085","0","51.52","25.71"
"10","018","00","010","0016","0129","516","270","246","22","538","1016","0","52.95","26.57"
"10","018","00","010","0017","0000","1062","511","551","29","1091","1710","0","63.80","29.88"
"10","018","00","010","0017","0002","675","348","327","17","692","1052","0","65.78","33.08"
"10","018","00","010","0017","0003","387","163","224","12","399","658","0","60.64","24.77"
"10","018","00","010","0018","0000","2592","1274","1318","97","2689","4301","0","62.52","29.62"
"10","018","00","010","0018","0010","365","166","199","14","379","615","0","61.63","26.99"
"10","018","00","010","0018","0011","747","388","359","29","776","1224","0","63.40","31.70"
"10","018","00","010","0018","0012","778","379","399","31","809","1278","0","63.30","29.66"
"10","018","00","010","0018","0013","702","341","361","23","725","1184","0","61.23","28.80"
"10","018","00","010","0019","0000","2335","1178","1157","83","2418","3901","0","61.98","30.20"
"10","018","00","010","0019","0014","555","275","280","19","574","899","0","63.85","30.59"
"10","018","00","010","0019","0015","562","290","272","14","576","926","0","62.20","31.32"
"10","018","00","010","0019","0016","665","322","343","23","688","1112","0","61.87","28.96"
"10","018","00","010","0019","0017","553","291","262","27","580","964","0","60.17","30.19"
"10","018","00","010","0020","0000","2616","1392","1224","68","2684","4399","0","61.01","31.64"
"10","018","00","010","0020","0022","550","300","250","11","561","962","0","58.32","31.19"
"10","018","00","010","0020","0023","684","365","319","6","690","1173","0","58.82","31.12"
"10","018","00","010","0020","0024","640","332","308","23","663","1046","0","63.38","31.74"
"10","018","00","010","0020","0025","742","395","347","28","770","1218","0","63.22","32.43"
"10","018","00","010","0021","0000","3511","1985","1526","85","3596","5671","0","63.41","35.00"
"10","018","00","010","0021","0026","603","316","287","22","625","1091","0","57.29","28.96"
"10","018","00","010","0021","0027","768","507","261","12","780","1198","0","65.11","42.32"
"10","018","00","010","0021","0028","681","398","283","14","695","1108","0","62.73","35.92"
"10","018","00","010","0021","0029","703","354","349","20","723","1163","0","62.17","30.44"
"10","018","00","010","0021","0030","756","410","346","17","773","1111","0","69.58","36.90"
"10","018","00","010","0022","0000","2346","1361","985","48","2394","3678","0","65.09","37.00"
"10","018","00","010","0022","0045","697","384","313","26","723","1155","0","62.60","33.25"
"10","018","00","010","0022","0046","938","534","404","17","955","1499","0","63.71","35.62"
"10","018","00","010","0022","0047","711","443","268","5","716","1024","0","69.92","43.26"
"10","018","00","010","0023","0000","1677","911","766","64","1741","2727","0","63.84","33.41"
"10","018","00","010","0023","0048","577","318","259","32","609","947","0","64.31","33.58"
"10","018","00","010","0023","0049","534","319","215","11","545","878","0","62.07","36.33"
"10","018","00","010","0023","0050","566","274","292","21","587","902","0","65.08","30.38"
"10","018","00","010","0024","0000","2497","1256","1241","103","2600","4198","0","61.93","29.92"
"10","018","00","010","0024","0059","682","368","314","21","703","1125","0","62.49","32.71"
"10","018","00","010","0024","0060","451","186","265","48","499","905","0","55.14","20.55"
"10","018","00","010","0024","0061","632","319","313","11","643","1053","0","61.06","30.29"
"10","018","00","010","0024","0062","732","383","349","23","755","1115","0","67.71","34.35"
"10","018","00","010","0025","0000","2258","904","1354","102","2360","3765","0","62.68","24.01"
"10","018","00","010","0025","0063","760","279","481","35","795","1238","0","64.22","22.54"
"10","018","00","010","0025","0064","738","284","454","27","765","1262","0","60.62","22.50"
"10","018","00","010","0025","0065","760","341","419","40","800","1265","0","63.24","26.96"
"10","018","00","010","0026","0000","3611","1884","1727","123","3734","5980","0","62.44","31.51"
"10","018","00","010","0026","0040","741","384","357","23","764","1257","0","60.78","30.55"
"10","018","00","010","0026","0041","690","323","367","23","713","1200","0","59.42","26.92"
"10","018","00","010","0026","0042","716","374","342","28","744","1140","0","65.26","32.81"
"10","018","00","010","0026","0043","762","413","349","23","785","1248","0","62.90","33.09"
"10","018","00","010","0026","0044","702","390","312","26","728","1135","0","64.14","34.36"
"10","018","00","010","0027","0000","1866","938","928","54","1920","2888","0","66.48","32.48"
"10","018","00","010","0027","0037","527","211","316","15","542","886","0","61.17","23.81"
"10","018","00","010","0027","0038","687","386","301","20","707","977","0","72.36","39.51"
"10","018","00","010","0027","0039","652","341","311","19","671","1025","0","65.46","33.27"
"10","018","00","010","0028","0000","1907","992","915","86","1993","3434","0","58.04","28.89"
"10","018","00","010","0028","0144","648","332","316","29","677","1156","0","58.56","28.72"
"10","018","00","010","0028","0145","657","354","303","37","694","1173","0","59.16","30.18"
"10","018","00","010","0028","0146","602","306","296","20","622","1105","0","56.29","27.69"
"10","018","00","010","0029","0000","1761","951","810","71","1832","2988","0","61.31","31.83"
"10","018","00","010","0029","0130","580","347","233","16","596","933","0","63.88","37.19"
"10","018","00","010","0029","0131","568","290","278","28","596","1002","0","59.48","28.94"
"10","018","00","010","0029","0132","613","314","299","27","640","1053","0","60.78","29.82"
"10","018","00","010","0030","0000","2918","1486","1432","94","3012","5018","0","60.02","29.61"
"10","018","00","010","0030","0155","494","260","234","20","514","849","0","60.54","30.62"
"10","018","00","010","0030","0156","501","243","258","25","526","970","0","54.23","25.05"
"10","018","00","010","0030","0157","588","291","297","18","606","870","0","69.66","33.45"
"10","018","00","010","0030","0158","592","314","278","14","606","1056","0","57.39","29.73"
"10","018","00","010","0030","0159","743","378","365","17","760","1273","0","59.70","29.69"
"10","018","00","010","0031","0000","3109","1566","1543","115","3224","5383","0","59.89","29.09"
"10","018","00","010","0031","0147","695","383","312","36","731","1221","0","59.87","31.37"
"10","018","00","010","0031","0148","641","292","349","29","670","1033","0","64.86","28.27"
"10","018","00","010","0031","0149","557","271","286","28","585","1076","0","54.37","25.19"
"10","018","00","010","0031","0150","588","309","279","9","597","1060","0","56.32","29.15"
"10","018","00","010","0031","0151","628","311","317","13","641","993","0","64.55","31.32"
"10","018","00","010","0032","0000","777","413","364","25","802","1176","0","68.20","35.12"
"10","018","00","010","0032","0119","777","413","364","25","802","1176","0","68.20","35.12"
"10","018","00","010","0033","0000","1637","793","844","46","1683","2735","0","61.54","28.99"
"10","018","00","010","0033","0074","532","221","311","21","553","985","0","56.14","22.44"
"10","018","00","010","0033","0075","435","233","202","13","448","747","0","59.97","31.19"
"10","018","00","010","0033","0076","670","339","331","12","682","1003","0","68.00","33.80"
"10","018","00","010","0035","0000","481","179","302","16","497","843","0","58.96","21.23"
"10","018","00","010","0035","0069","481","179","302","16","497","843","0","58.96","21.23"
"10","018","00","010","0036","0000","1432","617","815","59","1491","2551","0","58.45","24.19"
"10","018","00","010","0036","0066","502","211","291","23","525","938","0","55.97","22.49"
"10","018","00","010","0036","0067","444","211","233","10","454","763","0","59.50","27.65"
"10","018","00","010","0036","0068","486","195","291","26","512","850","0","60.24","22.94"
"10","018","00","010","0037","0000","2258","928","1330","72","2330","3622","0","64.33","25.62"
"10","018","00","010","0037","0070","727","253","474","20","747","1120","0","66.70","22.59"
"10","018","00","010","0037","0071","450","177","273","28","478","763","0","62.65","23.20"
"10","018","00","010","0037","0072","412","148","264","11","423","638","0","66.30","23.20"
"10","018","00","010","0037","0073","669","350","319","13","682","1101","0","61.94","31.79"
"10","018","00","010","0038","0000","1525","803","722","71","1596","2619","0","60.94","30.66"
"10","018","00","010","0038","0051","565","313","252","33","598","908","0","65.86","34.47"
"10","018","00","010","0038","0052","485","254","231","25","510","906","0","56.29","28.04"
"10","018","00","010","0038","0053","475","236","239","13","488","805","0","60.62","29.32"
"10","018","00","010","0039","0000","1877","1009","868","143","2020","3192","0","63.28","31.61"
"10","018","00","010","0039","0054","723","398","325","63","786","1255","0","62.63","31.71"
"10","018","00","010","0039","0055","618","319","299","50","668","1020","0","65.49","31.27"
"10","018","00","010","0039","0056","536","292","244","30","566","917","0","61.72","31.84"
"10","018","00","010","0040","0000","1166","574","592","84","1250","2017","0","61.97","28.46"
"10","018","00","010","0040","0057","597","319","278","48","645","1044","0","61.78","30.56"
"10","018","00","010","0040","0058","569","255","314","36","605","973","0","62.18","26.21"
"10","018","00","010","0041","0000","4057","2413","1644","107","4164","6601","0","63.08","36.56"
"10","018","00","010","0041","0082","854","496","358","17","871","1482","0","58.77","33.47"
"10","018","00","010","0041","0093","728","402","326","30","758","1159","0","65.40","34.69"
"10","018","00","010","0041","0094","844","518","326","22","866","1408","0","61.51","36.79"
"10","018","00","010","0041","0095","754","439","315","25","779","1204","0","64.70","36.46"
"10","018","00","010","0041","0096","877","558","319","13","890","1348","0","66.02","41.39"
"10","018","00","010","0042","0000","5801","3290","2511","137","5938","9276","0","64.01","35.47"
"10","018","00","010","0042","0077","580","291","289","20","600","1013","0","59.23","28.73"
"10","018","00","010","0042","0078","763","426","337","12","775","1186","0","65.35","35.92"
"10","018","00","010","0042","0079","737","414","323","14","751","1148","0","65.42","36.06"
"10","018","00","010","0042","0080","756","435","321","13","769","1181","0","65.11","36.83"
"10","018","00","010","0042","0081","409","242","167","5","414","616","0","67.21","39.29"
"10","018","00","010","0042","0083","451","238","213","7","458","842","0","54.39","28.27"
"10","018","00","010","0042","0084","582","299","283","28","610","955","0","63.87","31.31"
"10","018","00","010","0042","0085","893","555","338","24","917","1378","0","66.55","40.28"
"10","018","00","010","0042","0086","630","390","240","14","644","957","0","67.29","40.75"
"10","018","00","010","0043","0000","3041","1538","1503","103","3144","5066","0","62.06","30.36"
"10","018","00","010","0043","0097","636","329","307","37","673","995","0","67.64","33.07"
"10","018","00","010","0043","0098","529","259","270","18","547","983","0","55.65","26.35"
"10","018","00","010","0043","0099","641","323","318","17","658","1058","0","62.19","30.53"
"10","018","00","010","0043","0100","652","329","323","13","665","1082","0","61.46","30.41"
"10","018","00","010","0043","0101","583","298","285","18","601","948","0","63.40","31.43"
"10","018","00","010","0044","0000","2601","1299","1302","87","2688","4170","0","64.46","31.15"
"10","018","00","010","0044","0115","633","306","327","27","660","1120","0","58.93","27.32"
"10","018","00","010","0044","0116","660","345","315","3","663","1018","0","65.13","33.89"
"10","018","00","010","0044","0117","586","320","266","28","614","912","0","67.32","35.09"
"10","018","00","010","0044","0118","722","328","394","29","751","1120","0","67.05","29.29"
"10","018","00","010","0045","0000","2908","1454","1454","117","3025","5076","0","59.59","28.64"
"10","018","00","010","0045","0110","624","289","335","27","651","1073","0","60.67","26.93"
"10","018","00","010","0045","0111","698","373","325","37","735","1237","0","59.42","30.15"
"10","018","00","010","0045","0112","569","264","305","19","588","979","0","60.06","26.97"
"10","018","00","010","0045","0113","464","219","245","27","491","881","0","55.73","24.86"
"10","018","00","010","0045","0114","553","309","244","7","560","906","0","61.81","34.11"
"10","018","00","010","0046","0000","2662","1312","1350","130","2792","4676","0","59.71","28.06"
"10","018","00","010","0046","0106","587","264","323","33","620","1072","0","57.84","24.63"
"10","018","00","010","0046","0107","733","358","375","46","779","1270","0","61.34","28.19"
"10","018","00","010","0046","0108","624","318","306","31","655","1109","0","59.06","28.67"
"10","018","00","010","0046","0109","718","372","346","20","738","1225","0","60.24","30.37"
"10","018","00","010","0047","0000","3845","1885","1960","110","3955","5930","0","66.69","31.79"
"10","018","00","010","0047","0087","657","321","336","18","675","1016","0","66.44","31.59"
"10","018","00","010","0047","0088","559","262","297","32","591","909","0","65.02","28.82"
"10","018","00","010","0047","0089","643","320","323","12","655","972","0","67.39","32.92"
"10","018","00","010","0047","0090","720","361","359","21","741","1095","0","67.67","32.97"
"10","018","00","010","0047","0091","513","293","220","8","521","817","0","63.77","35.86"
"10","018","00","010","0047","0092","753","328","425","19","772","1121","0","68.87","29.26"
"10","018","00","010","0048","0000","1372","724","648","53","1425","2246","0","63.45","32.24"
"10","018","00","010","0048","0034","481","264","217","17","498","778","0","64.01","33.93"
"10","018","00","010","0048","0035","437","231","206","17","454","713","0","63.67","32.40"
"10","018","00","010","0048","0036","454","229","225","19","473","755","0","62.65","30.33"
"10","018","00","010","0049","0000","1959","1051","908","102","2061","3265","0","63.12","32.19"
"10","018","00","010","0049","0141","652","318","334","23","675","1028","0","65.66","30.93"
"10","018","00","010","0049","0142","619","356","263","48","667","1077","0","61.93","33.05"
"10","018","00","010","0049","0143","688","377","311","31","719","1160","0","61.98","32.50"
"10","018","00","010","0050","0000","2694","1372","1322","104","2798","4744","0","58.98","28.92"
"10","018","00","010","0050","0018","673","335","338","30","703","1212","0","58.00","27.64"
"10","018","00","010","0050","0019","633","328","305","22","655","1214","0","53.95","27.02"
"10","018","00","010","0050","0020","719","363","356","31","750","1229","0","61.03","29.54"
"10","018","00","010","0050","0021","669","346","323","21","690","1089","0","63.36","31.77"
"10","018","00","010","0051","0000","1058","508","550","38","1096","1807","0","60.65","28.11"
"10","018","00","010","0051","0008","412","206","206","17","429","714","0","60.08","28.85"
"10","018","00","010","0051","0009","646","302","344","21","667","1093","0","61.02","27.63"
"10","018","00","010","0052","0000","2103","1034","1069","62","2165","3344","0","64.74","30.92"
"10","018","00","010","0052","0152","736","345","391","26","762","1180","0","64.58","29.24"
"10","018","00","010","0052","0153","753","378","375","25","778","1212","0","64.19","31.19"
"10","018","00","010","0052","0154","614","311","303","11","625","952","0","65.65","32.67"
"10","018","00","010","0053","0000","2379","1155","1224","87","2466","4822","0","51.14","23.95"
"10","018","00","010","0053","0160","529","256","273","17","546","977","0","55.89","26.20"
"10","018","00","010","0053","0161","402","216","186","18","420","927","0","45.31","23.30"
"10","018","00","010","0053","0162","447","221","226","13","460","918","0","50.11","24.07"
"10","018","00","010","0053","0163","521","268","253","15","536","1143","0","46.89","23.45"
"10","018","00","010","0053","0164","480","194","286","24","504","857","0","58.81","22.64"
"10","018","00","010","0054","0000","2414","1432","982","55","2469","3928","0","62.86","36.46"
"10","018","00","010","0054","0102","584","336","248","19","603","1000","0","60.30","33.60"
"10","018","00","010","0054","0103","565","341","224","11","576","894","0","64.43","38.14"
"10","018","00","010","0054","0104","644","393","251","13","657","1026","0","64.04","38.30"
"10","018","00","010","0054","0105","621","362","259","12","633","1008","0","62.80","35.91"
"10","018","00","020","0000","0000","72265","37495","34770","3115","75380","122510","151797","61.53","30.61"
"10","018","00","020","0001","0000","318","164","154","8","326","545","0","59.82","30.09"
"10","018","00","020","0001","0165","318","164","154","8","326","545","0","59.82","30.09"
"10","018","00","020","0002","0000","432","236","196","20","452","667","0","67.77","35.38"
"10","018","00","020","0002","0169","432","236","196","20","452","667","0","67.77","35.38"
"10","018","00","020","0003","0000","424","250","174","22","446","697","0","63.99","35.87"
"10","018","00","020","0003","0167","424","250","174","22","446","697","0","63.99","35.87"
"10","018","00","020","0004","0000","249","154","95","16","265","441","0","60.09","34.92"
"10","018","00","020","0004","0166","249","154","95","16","265","441","0","60.09","34.92"
"10","018","00","020","0005","0000","654","373","281","37","691","1031","0","67.02","36.18"
"10","018","00","020","0005","0170","654","373","281","37","691","1031","0","67.02","36.18"
"10","018","00","020","0006","0000","289","156","133","11","300","493","0","60.85","31.64"
"10","018","00","020","0006","0168","289","156","133","11","300","493","0","60.85","31.64"
"10","018","00","020","0007","0000","779","415","364","22","801","1275","0","62.82","32.55"
"10","018","00","020","0007","0171","516","270","246","15","531","846","0","62.77","31.91"
"10","018","00","020","0007","0172","263","145","118","7","270","429","0","62.94","33.80"
"10","018","00","020","0008","0000","618","341","277","41","659","955","0","69.01","35.71"
"10","018","00","020","0008","0203","618","341","277","41","659","955","0","69.01","35.71"
"10","018","00","020","0009","0000","510","301","209","25","535","849","0","63.02","35.45"
"10","018","00","020","0009","0198","510","301","209","25","535","849","0","63.02","35.45"
"10","018","00","020","0010","0000","482","234","248","16","498","751","0","66.31","31.16"
"10","018","00","020","0010","0196","482","234","248","16","498","751","0","66.31","31.16"
"10","018","00","020","0011","0000","535","296","239","21","556","822","0","67.64","36.01"
"10","018","00","020","0011","0197","535","296","239","21","556","822","0","67.64","36.01"
"10","018","00","020","0012","0000","745","419","326","34","779","1312","0","59.38","31.94"
"10","018","00","020","0012","0201","435","262","173","23","458","756","0","60.58","34.66"
"10","018","00","020","0012","0202","310","157","153","11","321","556","0","57.73","28.24"
"10","018","00","020","0013","0000","900","495","405","45","945","1542","0","61.28","32.10"
"10","018","00","020","0013","0199","538","301","237","28","566","899","0","62.96","33.48"
"10","018","00","020","0013","0200","362","194","168","17","379","643","0","58.94","30.17"
"10","018","00","020","0014","0000","2537","1340","1197","104","2641","4569","0","57.80","29.33"
"10","018","00","020","0014","0204","481","249","232","23","504","926","0","54.43","26.89"
"10","018","00","020","0014","0205","581","302","279","18","599","961","0","62.33","31.43"
"10","018","00","020","0014","0206","478","250","228","23","501","910","0","55.05","27.47"
"10","018","00","020","0014","0207","527","299","228","18","545","907","0","60.09","32.97"
"10","018","00","020","0014","0208","470","240","230","22","492","865","0","56.88","27.75"
"10","018","00","020","0015","0000","1908","1024","884","60","1968","3106","0","63.36","32.97"
"10","018","00","020","0015","0222","681","360","321","15","696","1050","0","66.29","34.29"
"10","018","00","020","0015","0223","631","336","295","24","655","1068","0","61.33","31.46"
"10","018","00","020","0015","0224","596","328","268","21","617","988","0","62.45","33.20"
"10","018","00","020","0016","0000","2465","1328","1137","124","2589","3879","0","66.74","34.24"
"10","018","00","020","0016","0218","702","372","330","42","744","1099","0","67.70","33.85"
"10","018","00","020","0016","0219","666","370","296","29","695","1006","0","69.09","36.78"
"10","018","00","020","0016","0220","580","314","266","32","612","900","0","68.00","34.89"
"10","018","00","020","0016","0221","517","272","245","21","538","874","0","61.56","31.12"
"10","018","00","020","0017","0000","1185","603","582","63","1248","1995","0","62.56","30.23"
"10","018","00","020","0017","0225","677","341","336","32","709","1084","0","65.41","31.46"
"10","018","00","020","0017","0226","508","262","246","31","539","911","0","59.17","28.76"
"10","018","00","020","0018","0000","1201","678","523","58","1259","1826","0","68.95","37.13"
"10","018","00","020","0018","0270","816","459","357","36","852","1227","0","69.44","37.41"
"10","018","00","020","0018","0271","385","219","166","22","407","599","0","67.95","36.56"
"10","018","00","020","0019","0000","2288","1074","1214","107","2395","3641","0","65.78","29.50"
"10","018","00","020","0019","0262","741","340","401","37","778","1118","0","69.59","30.41"
"10","018","00","020","0019","0263","697","317","380","25","722","1131","0","63.84","28.03"
"10","018","00","020","0019","0264","400","199","201","19","419","676","0","61.98","29.44"
"10","018","00","020","0019","0265","450","218","232","26","476","716","0","66.48","30.45"
"10","018","00","020","0020","0000","518","302","216","36","554","805","0","68.82","37.52"
"10","018","00","020","0020","0272","518","302","216","36","554","805","0","68.82","37.52"
"10","018","00","020","0021","0000","1698","890","808","50","1748","2624","0","66.62","33.92"
"10","018","00","020","0021","0235","514","268","246","14","528","815","0","64.79","32.88"
"10","018","00","020","0021","0236","571","306","265","15","586","842","0","69.60","36.34"
"10","018","00","020","0021","0237","613","316","297","21","634","967","0","65.56","32.68"
"10","018","00","020","0022","0000","3384","1667","1717","114","3498","5742","0","60.92","29.03"
"10","018","00","020","0022","0247","517","269","248","16","533","847","0","62.93","31.76"
"10","018","00","020","0022","0248","468","219","249","11","479","800","0","59.88","27.38"
"10","018","00","020","0022","0249","494","249","245","10","504","843","0","59.79","29.54"
"10","018","00","020","0022","0250","537","249","288","20","557","951","0","58.57","26.18"
"10","018","00","020","0022","0251","658","343","315","34","692","1125","0","61.51","30.49"
"10","018","00","020","0022","0252","710","338","372","23","733","1176","0","62.33","28.74"
"10","018","00","020","0023","0000","2587","890","1697","104","2691","4301","0","62.57","20.69"
"10","018","00","020","0023","0258","645","235","410","24","669","1055","0","63.41","22.27"
"10","018","00","020","0023","0259","611","186","425","23","634","1059","0","59.87","17.56"
"10","018","00","020","0023","0260","707","240","467","33","740","1147","0","64.52","20.92"
"10","018","00","020","0023","0261","624","229","395","24","648","1040","0","62.31","22.02"
"10","018","00","020","0024","0000","3112","1666","1446","169","3281","5662","0","57.95","29.42"
"10","018","00","020","0024","0273","663","345","318","12","675","1168","0","57.79","29.54"
"10","018","00","020","0024","0274","623","315","308","34","657","1152","0","57.03","27.34"
"10","018","00","020","0024","0275","639","367","272","15","654","1187","0","55.10","30.92"
"10","018","00","020","0024","0276","609","316","293","56","665","1078","0","61.69","29.31"
"10","018","00","020","0024","0277","578","323","255","52","630","1077","0","58.50","29.99"
"10","018","00","020","0025","0000","333","165","168","31","364","551","0","66.06","29.95"
"10","018","00","020","0025","0290","333","165","168","31","364","551","0","66.06","29.95"
"10","018","00","020","0026","0000","1801","962","839","92","1893","3154","0","60.02","30.50"
"10","018","00","020","0026","0278","542","287","255","29","571","980","0","58.27","29.29"
"10","018","00","020","0026","0279","747","411","336","32","779","1279","0","60.91","32.13"
"10","018","00","020","0026","0280","512","264","248","31","543","895","0","60.67","29.50"
"10","018","00","020","0027","0000","1109","644","465","84","1193","2025","0","58.91","31.80"
"10","018","00","020","0027","0288","566","326","240","26","592","1036","0","57.14","31.47"
"10","018","00","020","0027","0289","543","318","225","58","601","989","0","60.77","32.15"
"10","018","00","020","0028","0000","2229","1165","1064","83","2312","3679","0","62.84","31.67"
"10","018","00","020","0028","0281","753","362","391","30","783","1244","0","62.94","29.10"
"10","018","00","020","0028","0282","779","431","348","31","810","1255","0","64.54","34.34"
"10","018","00","020","0028","0283","697","372","325","22","719","1180","0","60.93","31.53"
"10","018","00","020","0029","0000","2415","1236","1179","114","2529","4195","0","60.29","29.46"
"10","018","00","020","0029","0284","611","351","260","32","643","1019","0","63.10","34.45"
"10","018","00","020","0029","0285","546","267","279","23","569","942","0","60.40","28.34"
"10","018","00","020","0029","0286","606","288","318","26","632","1033","0","61.18","27.88"
"10","018","00","020","0029","0287","652","330","322","33","685","1201","0","57.04","27.48"
"10","018","00","020","0030","0000","1059","541","518","45","1104","1629","0","67.77","33.21"
"10","018","00","020","0030","0186","652","337","315","27","679","965","0","70.36","34.92"
"10","018","00","020","0030","0187","407","204","203","18","425","664","0","64.01","30.72"
"10","018","00","020","0031","0000","1894","1028","866","79","1973","3276","0","60.23","31.38"
"10","018","00","020","0031","0173","612","320","292","20","632","1108","0","57.04","28.88"
"10","018","00","020","0031","0174","648","342","306","31","679","1061","0","64.00","32.23"
"10","018","00","020","0031","0175","634","366","268","28","662","1107","0","59.80","33.06"
"10","018","00","020","0032","0000","2654","1423","1231","116","2770","5005","0","55.34","28.43"
"10","018","00","020","0032","0178","463","233","230","28","491","910","0","53.96","25.60"
"10","018","00","020","0032","0179","673","370","303","12","685","1190","0","57.56","31.09"
"10","018","00","020","0032","0180","507","276","231","20","527","1025","0","51.41","26.93"
"10","018","00","020","0032","0181","348","165","183","22","370","735","0","50.34","22.45"
"10","018","00","020","0032","0182","663","379","284","34","697","1145","0","60.87","33.10"
"10","018","00","020","0033","0000","1672","943","729","95","1767","2715","0","65.08","34.73"
"10","018","00","020","0033","0183","577","323","254","40","617","940","0","65.64","34.36"
"10","018","00","020","0033","0184","543","298","245","29","572","875","0","65.37","34.06"
"10","018","00","020","0033","0185","552","322","230","26","578","900","0","64.22","35.78"
"10","018","00","020","0034","0000","2518","1408","1110","101","2619","4130","0","63.41","34.09"
"10","018","00","020","0034","0191","650","359","291","16","666","1040","0","64.04","34.52"
"10","018","00","020","0034","0192","643","364","279","32","675","1102","0","61.25","33.03"
"10","018","00","020","0034","0193","787","446","341","28","815","1218","0","66.91","36.62"
"10","018","00","020","0034","0195","438","239","199","25","463","770","0","60.13","31.04"
"10","018","00","020","0035","0000","89","33","56","1","90","193","0","46.63","17.10"
"10","018","00","020","0035","0194","89","33","56","1","90","193","0","46.63","17.10"
"10","018","00","020","0036","0000","2638","1359","1279","137","2775","4464","0","62.16","30.44"
"10","018","00","020","0036","0266","589","306","283","29","618","1001","0","61.74","30.57"
"10","018","00","020","0036","0267","647","352","295","39","686","1101","0","62.31","31.97"
"10","018","00","020","0036","0268","712","360","352","27","739","1147","0","64.43","31.39"
"10","018","00","020","0036","0269","690","341","349","42","732","1215","0","60.25","28.07"
"10","018","00","020","0037","0000","3010","1618","1392","112","3122","5162","0","60.48","31.34"
"10","018","00","020","0037","0209","557","302","255","31","588","993","0","59.21","30.41"
"10","018","00","020","0037","0210","574","334","240","29","603","984","0","61.28","33.94"
"10","018","00","020","0037","0211","642","316","326","10","652","1069","0","60.99","29.56"
"10","018","00","020","0037","0212","674","376","298","20","694","1143","0","60.72","32.90"
"10","018","00","020","0037","0213","563","290","273","22","585","973","0","60.12","29.80"
"10","018","00","020","0038","0000","2538","1334","1204","129","2667","4277","0","62.36","31.19"
"10","018","00","020","0038","0214","649","352","297","38","687","1081","0","63.55","32.56"
"10","018","00","020","0038","0215","634","308","326","30","664","1040","0","63.85","29.62"
"10","018","00","020","0038","0216","638","352","286","33","671","1115","0","60.18","31.57"
"10","018","00","020","0038","0217","617","322","295","28","645","1041","0","61.96","30.93"
"10","018","00","020","0039","0000","1846","892","954","91","1937","4050","0","47.83","22.02"
"10","018","00","020","0039","0227","292","161","131","13","305","1243","0","24.54","12.95"
"10","018","00","020","0039","0228","515","257","258","13","528","878","0","60.14","29.27"
"10","018","00","020","0039","0229","516","229","287","30","546","968","0","56.40","23.66"
"10","018","00","020","0039","0230","523","245","278","35","558","961","0","58.06","25.49"
"10","018","00","020","0040","0000","2695","1388","1307","105","2800","4643","0","60.31","29.89"
"10","018","00","020","0040","0231","594","323","271","28","622","1120","0","55.54","28.84"
"10","018","00","020","0040","0232","643","337","306","22","665","1155","0","57.58","29.18"
"10","018","00","020","0040","0233","733","351","382","35","768","1137","0","67.55","30.87"
"10","018","00","020","0040","0234","725","377","348","20","745","1231","0","60.52","30.63"
"10","018","00","020","0041","0000","3292","1638","1654","105","3397","5555","0","61.15","29.49"
"10","018","00","020","0041","0253","681","364","317","28","709","1132","0","62.63","32.16"
"10","018","00","020","0041","0254","699","346","353","20","719","1157","0","62.14","29.90"
"10","018","00","020","0041","0255","633","296","337","27","660","1092","0","60.44","27.11"
"10","018","00","020","0041","0256","671","330","341","17","688","1139","0","60.40","28.97"
"10","018","00","020","0041","0257","608","302","306","13","621","1035","0","60.00","29.18"
"10","018","00","020","0042","0000","3931","2060","1871","122","4053","6307","0","64.26","32.66"
"10","018","00","020","0042","0241","712","395","317","29","741","1109","0","66.82","35.62"
"10","018","00","020","0042","0242","649","309","340","29","678","1031","0","65.76","29.97"
"10","018","00","020","0042","0243","607","304","303","22","629","1031","0","61.01","29.49"
"10","018","00","020","0042","0244","599","321","278","15","614","980","0","62.65","32.76"
"10","018","00","020","0042","0245","677","372","305","15","692","1061","0","65.22","35.06"
"10","018","00","020","0042","0246","687","359","328","12","699","1095","0","63.84","32.79"
"10","018","00","020","0043","0000","2094","1095","999","82","2176","3211","0","67.77","34.10"
"10","018","00","020","0043","0238","720","418","302","23","743","1038","0","71.58","40.27"
"10","018","00","020","0043","0239","643","352","291","19","662","1055","0","62.75","33.36"
"10","018","00","020","0043","0240","731","325","406","40","771","1118","0","68.96","29.07"
"10","018","00","020","0044","0000","747","402","345","32","779","1490","0","52.28","26.98"
"10","018","00","020","0044","0176","391","199","192","10","401","817","0","49.08","24.36"
"10","018","00","020","0044","0177","356","203","153","22","378","673","0","56.17","30.16"
"10","018","00","020","0045","0000","1883","865","1018","52","1935","3269","0","59.19","26.46"
"10","018","00","020","0045","0188","673","242","431","29","702","1194","0","58.79","20.27"
"10","018","00","020","0045","0189","577","286","291","12","589","1085","0","54.29","26.36"
"10","018","00","020","0045","0190","633","337","296","11","644","990","0","65.05","34.04"
"10","018","00","030","0000","0000","37669","20370","17299","1952","39621","64926","78529","61.02","31.37"
"10","018","00","030","0001","0000","1876","1042","834","115","1991","2710","0","73.47","38.45"
"10","018","00","030","0001","0321","531","295","236","37","568","833","0","68.19","35.41"
"10","018","00","030","0001","0322","699","368","331","40","739","966","0","76.50","38.10"
"10","018","00","030","0001","0323","646","379","267","38","684","911","0","75.08","41.60"
"10","018","00","030","0002","0000","2763","1532","1231","162","2925","5318","0","55.00","28.81"
"10","018","00","030","0002","0316","492","288","204","19","511","1023","0","49.95","28.15"
"10","018","00","030","0002","0317","423","247","176","20","443","887","0","49.94","27.85"
"10","018","00","030","0002","0318","640","345","295","38","678","1264","0","53.64","27.29"
"10","018","00","030","0002","0319","511","280","231","39","550","974","0","56.47","28.75"
"10","018","00","030","0002","0320","697","372","325","46","743","1170","0","63.50","31.79"
"10","018","00","030","0003","0000","1129","615","514","49","1178","2179","0","54.06","28.22"
"10","018","00","030","0003","0314","475","244","231","26","501","895","0","55.98","27.26"
"10","018","00","030","0003","0315","654","371","283","23","677","1284","0","52.73","28.89"
"10","018","00","030","0004","0000","1338","803","535","81","1419","2330","0","60.90","34.46"
"10","018","00","030","0004","0312","677","407","270","32","709","1190","0","59.58","34.20"
"10","018","00","030","0004","0313","661","396","265","49","710","1140","0","62.28","34.74"
"10","018","00","030","0005","0000","1284","727","557","84","1368","2012","0","67.99","36.13"
"10","018","00","030","0005","0310","682","365","317","42","724","1085","0","66.73","33.64"
"10","018","00","030","0005","0311","602","362","240","42","644","927","0","69.47","39.05"
"10","018","00","030","0006","0000","1908","1056","852","87","1995","3072","0","64.94","34.38"
"10","018","00","030","0006","0307","674","380","294","26","700","1104","0","63.41","34.42"
"10","018","00","030","0006","0308","529","257","272","31","560","834","0","67.15","30.82"
"10","018","00","030","0006","0309","705","419","286","30","735","1134","0","64.81","36.95"
"10","018","00","030","0007","0000","1682","879","803","66","1748","2779","0","62.90","31.63"
"10","018","00","030","0007","0300","538","275","263","27","565","863","0","65.47","31.87"
"10","018","00","030","0007","0301","614","332","282","19","633","1071","0","59.10","31.00"
"10","018","00","030","0007","0302","530","272","258","20","550","845","0","65.09","32.19"
"10","018","00","030","0008","0000","2410","1255","1155","87","2497","4619","0","54.06","27.17"
"10","018","00","030","0008","0303","607","328","279","26","633","1115","0","56.77","29.42"
"10","018","00","030","0008","0304","575","284","291","25","600","1164","0","51.55","24.40"
"10","018","00","030","0008","0305","593","321","272","18","611","1219","0","50.12","26.33"
"10","018","00","030","0008","0306","635","322","313","18","653","1121","0","58.25","28.72"
"10","018","00","030","0009","0000","2741","1482","1259","69","2810","4897","0","57.38","30.26"
"10","018","00","030","0009","0291","538","307","231","12","550","958","0","57.41","32.05"
"10","018","00","030","0009","0292","521","263","258","18","539","903","0","59.69","29.13"
"10","018","00","030","0009","0293","519","276","243","16","535","947","0","56.49","29.14"
"10","018","00","030","0009","0294","545","305","240","10","555","1021","0","54.36","29.87"
"10","018","00","030","0009","0295","618","331","287","13","631","1068","0","59.08","30.99"
"10","018","00","030","0010","0000","2387","1241","1146","88","2475","3917","0","63.19","31.68"
"10","018","00","030","0010","0324","507","256","251","23","530","832","0","63.70","30.77"
"10","018","00","030","0010","0325","545","277","268","37","582","914","0","63.68","30.31"
"10","018","00","030","0010","0326","668","352","316","13","681","1000","0","68.10","35.20"
"10","018","00","030","0010","0327","667","356","311","15","682","1171","0","58.24","30.40"
"10","018","00","030","0011","0000","2066","1045","1021","99","2165","3547","0","61.04","29.46"
"10","018","00","030","0011","0328","695","376","319","45","740","1287","0","57.50","29.22"
"10","018","00","030","0011","0329","662","342","320","35","697","1105","0","63.08","30.95"
"10","018","00","030","0011","0330","709","327","382","19","728","1155","0","63.03","28.31"
"10","018","00","030","0012","0000","2571","1364","1207","144","2715","4259","0","63.75","32.03"
"10","018","00","030","0012","0331","708","385","323","50","758","1126","0","67.32","34.19"
"10","018","00","030","0012","0332","605","320","285","30","635","1005","0","63.18","31.84"
"10","018","00","030","0012","0333","632","342","290","26","658","1132","0","58.13","30.21"
"10","018","00","030","0012","0334","626","317","309","38","664","996","0","66.67","31.83"
"10","018","00","030","0013","0000","1669","894","775","89","1758","2770","0","63.47","32.27"
"10","018","00","030","0013","0335","670","364","306","40","710","1013","0","70.09","35.93"
"10","018","00","030","0013","0336","504","270","234","29","533","865","0","61.62","31.21"
"10","018","00","030","0013","0337","495","260","235","20","515","892","0","57.74","29.15"
"10","018","00","030","0014","0000","686","390","296","51","737","1085","0","67.93","35.94"
"10","018","00","030","0014","0338","686","390","296","51","737","1085","0","67.93","35.94"
"10","018","00","030","0015","0000","1305","720","585","51","1356","2118","0","64.02","33.99"
"10","018","00","030","0015","0339","660","354","306","17","677","1117","0","60.61","31.69"
"10","018","00","030","0015","0340","645","366","279","34","679","1001","0","67.83","36.56"
"10","018","00","030","0016","0000","1396","775","621","112","1508","2275","0","66.29","34.07"
"10","018","00","030","0016","0341","727","430","297","82","809","1214","0","66.64","35.42"
"10","018","00","030","0016","0342","669","345","324","30","699","1061","0","65.88","32.52"
"10","018","00","030","0017","0000","615","330","285","37","652","944","0","69.07","34.96"
"10","018","00","030","0017","0354","615","330","285","37","652","944","0","69.07","34.96"
"10","018","00","030","0018","0000","456","265","191","40","496","846","0","58.63","31.32"
"10","018","00","030","0018","0353","456","265","191","40","496","846","0","58.63","31.32"
"10","018","00","030","0019","0000","505","242","263","54","559","750","0","74.53","32.27"
"10","018","00","030","0019","0352","505","242","263","54","559","750","0","74.53","32.27"
"10","018","00","030","0020","0000","974","512","462","59","1033","1790","0","57.71","28.60"
"10","018","00","030","0020","0350","425","217","208","35","460","691","0","66.57","31.40"
"10","018","00","030","0020","0351","549","295","254","24","573","1099","0","52.14","26.84"
"10","018","00","030","0021","0000","2141","1152","989","147","2288","4158","0","55.03","27.71"
"10","018","00","030","0021","0345","547","271","276","21","568","1034","0","54.93","26.21"
"10","018","00","030","0021","0346","490","267","223","42","532","950","0","56.00","28.11"
"10","018","00","030","0021","0347","580","322","258","39","619","1229","0","50.37","26.20"
"10","018","00","030","0021","0348","524","292","232","45","569","945","0","60.21","30.90"
"10","018","00","030","0022","0000","788","431","357","52","840","1449","0","57.97","29.74"
"10","018","00","030","0022","0343","469","261","208","31","500","849","0","58.89","30.74"
"10","018","00","030","0022","0344","319","170","149","21","340","600","0","56.67","28.33"
"10","018","00","030","0023","0000","490","296","194","43","533","752","0","70.88","39.36"
"10","018","00","030","0023","0349","490","296","194","43","533","752","0","70.88","39.36"
"10","018","00","030","0024","0000","2489","1322","1167","86","2575","4350","0","59.20","30.39"
"10","018","00","030","0024","0296","467","253","214","10","477","749","0","63.68","33.78"
"10","018","00","030","0024","0297","736","415","321","17","753","1266","0","59.48","32.78"
"10","018","00","030","0024","0298","698","364","334","18","716","1205","0","59.42","30.21"
"10","018","00","030","0024","0299","588","290","298","41","629","1130","0","55.66","25.66"
"10","020","00","000","0000","0000","107782","61100","46682","4915","112697","214819","262591","52.46","28.44"
"10","020","00","010","0000","0000","47755","26205","21550","1940","49695","97011","117683","51.23","27.01"
"10","020","00","010","0001","0000","1950","1154","796","54","2004","4432","0","45.22","26.04"
"10","020","00","010","0001","0088","542","356","186","10","552","1234","0","44.73","28.85"
"10","020","00","010","0001","0089","443","247","196","11","454","960","0","47.29","25.73"
"10","020","00","010","0001","0090","449","264","185","15","464","1145","0","40.52","23.06"
"10","020","00","010","0001","0091","516","287","229","18","534","1093","0","48.86","26.26"
"10","020","00","010","0002","0000","1827","962","865","65","1892","3305","0","57.25","29.11"
"10","020","00","010","0002","0085","608","347","261","18","626","1071","0","58.45","32.40"
"10","020","00","010","0002","0086","693","387","306","27","720","1174","0","61.33","32.96"
"10","020","00","010","0002","0087","526","228","298","20","546","1060","0","51.51","21.51"
"10","020","00","010","0003","0000","1271","651","620","36","1307","2690","0","48.59","24.20"
"10","020","00","010","0003","0083","599","334","265","18","617","1315","0","46.92","25.40"
"10","020","00","010","0003","0084","672","317","355","18","690","1375","0","50.18","23.05"
"10","020","00","010","0004","0000","1628","899","729","71","1699","3076","0","55.23","29.23"
"10","020","00","010","0004","0076","498","278","220","23","521","987","0","52.79","28.17"
"10","020","00","010","0004","0077","561","293","268","27","588","1085","0","54.19","27.00"
"10","020","00","010","0004","0078","569","328","241","21","590","1004","0","58.76","32.67"
"10","020","00","010","0005","0000","1148","577","571","51","1199","2044","0","58.66","28.23"
"10","020","00","010","0005","0079","595","306","289","24","619","1142","0","54.20","26.80"
"10","020","00","010","0005","0080","553","271","282","27","580","902","0","64.30","30.04"
"10","020","00","010","0034","0000","2049","998","1051","114","2163","4096","0","52.81","24.37"
"10","020","00","010","0034","0025","588","269","319","50","638","1184","0","53.89","22.72"
"10","020","00","010","0034","0026","632","313","319","31","663","1245","0","53.25","25.14"
"10","020","00","010","0034","0027","426","218","208","15","441","821","0","53.71","26.55"
"10","020","00","010","0034","0028","403","198","205","18","421","846","0","49.76","23.40"
"10","020","00","010","0035","0000","1788","954","834","62","1850","3995","0","46.31","23.88"
"10","020","00","010","0035","0021","466","246","220","12","478","1031","0","46.36","23.86"
"10","020","00","010","0035","0022","488","257","231","17","505","1144","0","44.14","22.47"
"10","020","00","010","0035","0023","382","197","185","17","399","867","0","46.02","22.72"
"10","020","00","010","0035","0024","452","254","198","16","468","953","0","49.11","26.65"
"10","020","00","010","0036","0000","1772","932","840","86","1858","3821","0","48.63","24.39"
"10","020","00","010","0036","0018","607","350","257","44","651","1394","0","46.70","25.11"
"10","020","00","010","0036","0019","486","254","232","14","500","1006","0","49.70","25.25"
"10","020","00","010","0036","0020","679","328","351","28","707","1421","0","49.75","23.08"
"10","020","00","010","0037","0000","1155","596","559","46","1201","2190","0","54.84","27.21"
"10","020","00","010","0037","0013","575","299","276","15","590","1099","0","53.69","27.21"
"10","020","00","010","0037","0014","580","297","283","31","611","1091","0","56.00","27.22"
"10","020","00","010","0038","0000","861","437","424","36","897","1676","0","53.52","26.07"
"10","020","00","010","0038","0005","397","209","188","16","413","804","0","51.37","26.00"
"10","020","00","010","0038","0006","464","228","236","20","484","872","0","55.50","26.15"
"10","020","00","010","0039","0000","1941","1020","921","56","1997","4058","0","49.21","25.14"
"10","020","00","010","0039","0031","661","338","323","12","673","1418","0","47.46","23.84"
"10","020","00","010","0039","0032","676","347","329","21","697","1321","0","52.76","26.27"
"10","020","00","010","0039","0033","604","335","269","23","627","1319","0","47.54","25.40"
"10","020","00","010","0041","0000","955","524","431","45","1000","1864","0","53.65","28.11"
"10","020","00","010","0041","0008","444","241","203","24","468","887","0","52.76","27.17"
"10","020","00","010","0041","0009","511","283","228","21","532","977","0","54.45","28.97"
"10","020","00","010","0042","0000","540","301","239","34","574","1024","0","56.05","29.39"
"10","020","00","010","0042","0007","540","301","239","34","574","1024","0","56.05","29.39"
"10","020","00","010","0043","0000","1391","740","651","49","1440","2808","0","51.28","26.35"
"10","020","00","010","0043","0015","498","270","228","18","516","922","0","55.97","29.28"
"10","020","00","010","0043","0016","439","247","192","20","459","943","0","48.67","26.19"
"10","020","00","010","0043","0017","454","223","231","11","465","943","0","49.31","23.65"
"10","020","00","010","0044","0000","1135","588","547","51","1186","2302","0","51.52","25.54"
"10","020","00","010","0044","0001","508","271","237","26","534","1010","0","52.87","26.83"
"10","020","00","010","0044","0002","627","317","310","25","652","1292","0","50.46","24.54"
"10","020","00","010","0045","0000","924","520","404","44","968","1889","0","51.24","27.53"
"10","020","00","010","0045","0046","427","236","191","23","450","861","0","52.26","27.41"
"10","020","00","010","0045","0047","497","284","213","21","518","1028","0","50.39","27.63"
"10","020","00","010","0046","0000","676","399","277","27","703","1203","0","58.44","33.17"
"10","020","00","010","0046","0048","676","399","277","27","703","1203","0","58.44","33.17"
"10","020","00","010","0047","0000","805","488","317","55","860","1532","0","56.14","31.85"
"10","020","00","010","0047","0049","438","270","168","27","465","780","0","59.62","34.62"
"10","020","00","010","0047","0050","367","218","149","28","395","752","0","52.53","28.99"
"10","020","00","010","0048","0000","533","326","207","27","560","1169","0","47.90","27.89"
"10","020","00","010","0048","0051","533","326","207","27","560","1169","0","47.90","27.89"
"10","020","00","010","0049","0000","1453","825","628","71","1524","3305","0","46.11","24.96"
"10","020","00","010","0049","0052","485","269","216","28","513","1076","0","47.68","25.00"
"10","020","00","010","0049","0053","467","260","207","13","480","1181","0","40.64","22.02"
"10","020","00","010","0049","0054","501","296","205","30","531","1048","0","50.67","28.24"
"10","020","00","010","0050","0000","1123","612","511","41","1164","2103","0","55.35","29.10"
"10","020","00","010","0050","0055","539","273","266","13","552","988","0","55.87","27.63"
"10","020","00","010","0050","0056","584","339","245","28","612","1115","0","54.89","30.40"
"10","020","00","010","0051","0000","1359","801","558","61","1420","2404","0","59.07","33.32"
"10","020","00","010","0051","0057","701","426","275","33","734","1213","0","60.51","35.12"
"10","020","00","010","0051","0058","658","375","283","28","686","1191","0","57.60","31.49"
"10","020","00","010","0052","0000","1290","712","578","48","1338","2624","0","50.99","27.13"
"10","020","00","010","0052","0059","675","353","322","29","704","1370","0","51.39","25.77"
"10","020","00","010","0052","0060","615","359","256","19","634","1254","0","50.56","28.63"
"10","020","00","010","0053","0000","1531","852","679","74","1605","3139","0","51.13","27.14"
"10","020","00","010","0053","0066","547","325","222","27","574","1141","0","50.31","28.48"
"10","020","00","010","0053","0067","410","234","176","18","428","906","0","47.24","25.83"
"10","020","00","010","0053","0068","574","293","281","29","603","1092","0","55.22","26.83"
"10","020","00","010","0054","0000","1784","987","797","75","1859","3758","0","49.47","26.26"
"10","020","00","010","0054","0063","586","344","242","21","607","1084","0","56.00","31.73"
"10","020","00","010","0054","0064","554","310","244","32","586","1157","0","50.65","26.79"
"10","020","00","010","0054","0065","644","333","311","22","666","1517","0","43.90","21.95"
"10","020","00","010","0055","0000","1557","829","728","57","1614","3479","0","46.39","23.83"
"10","020","00","010","0055","0069","535","299","236","19","554","1132","0","48.94","26.41"
"10","020","00","010","0055","0070","555","281","274","22","577","1233","0","46.80","22.79"
"10","020","00","010","0055","0071","467","249","218","16","483","1114","0","43.36","22.35"
"10","020","00","010","0056","0000","1015","599","416","32","1047","1863","0","56.20","32.15"
"10","020","00","010","0056","0044","488","282","206","8","496","920","0","53.91","30.65"
"10","020","00","010","0056","0045","527","317","210","24","551","943","0","58.43","33.62"
"10","020","00","010","0057","0000","668","398","270","33","701","1630","0","43.01","24.42"
"10","020","00","010","0057","0042","407","242","165","18","425","852","0","49.88","28.40"
"10","020","00","010","0057","0043","261","156","105","15","276","778","0","35.48","20.05"
"10","020","00","010","0058","0000","914","537","377","55","969","1819","0","53.27","29.52"
"10","020","00","010","0058","0040","497","310","187","30","527","877","0","60.09","35.35"
"10","020","00","010","0058","0041","417","227","190","25","442","942","0","46.92","24.10"
"10","020","00","010","0059","0000","851","505","346","37","888","1830","0","48.52","27.60"
"10","020","00","010","0059","0036","393","219","174","15","408","861","0","47.39","25.44"
"10","020","00","010","0059","0037","458","286","172","22","480","969","0","49.54","29.51"
"10","020","00","010","0060","0000","820","461","359","33","853","1697","0","50.27","27.17"
"10","020","00","010","0060","0034","363","176","187","15","378","839","0","45.05","20.98"
"10","020","00","010","0060","0035","457","285","172","18","475","858","0","55.36","33.22"
"10","020","00","010","0061","0000","919","498","421","34","953","1785","0","53.39","27.90"
"10","020","00","010","0061","0029","560","304","256","24","584","1117","0","52.28","27.22"
"10","020","00","010","0061","0030","359","194","165","10","369","668","0","55.24","29.04"
"10","020","00","010","0062","0000","1152","686","466","56","1208","2012","0","60.04","34.10"
"10","020","00","010","0062","0038","612","366","246","37","649","1081","0","60.04","33.86"
"10","020","00","010","0062","0039","540","320","220","19","559","931","0","60.04","34.37"
"10","020","00","010","0063","0000","1144","641","503","29","1173","2165","0","54.18","29.61"
"10","020","00","010","0063","0074","687","389","298","18","705","1245","0","56.63","31.24"
"10","020","00","010","0063","0075","457","252","205","11","468","920","0","50.87","27.39"
"10","020","00","010","0064","0000","996","571","425","43","1039","1931","0","53.81","29.57"
"10","020","00","010","0064","0072","521","278","243","22","543","1030","0","52.72","26.99"
"10","020","00","010","0064","0073","475","293","182","21","496","901","0","55.05","32.52"
"10","020","00","010","0065","0000","1007","519","488","25","1032","2180","0","47.34","23.81"
"10","020","00","010","0065","0003","439","226","213","13","452","1021","0","44.27","22.14"
"10","020","00","010","0065","0004","568","293","275","12","580","1159","0","50.04","25.28"
"10","020","00","010","0066","0000","1805","959","846","41","1846","3535","0","52.22","27.13"
"10","020","00","010","0066","0010","673","379","294","19","692","1246","0","55.54","30.42"
"10","020","00","010","0066","0011","552","292","260","11","563","1175","0","47.91","24.85"
"10","020","00","010","0066","0012","580","288","292","11","591","1114","0","53.05","25.85"
"10","020","00","010","0067","0000","898","500","398","39","937","1922","0","48.75","26.01"
"10","020","00","010","0067","0061","435","233","202","13","448","932","0","48.07","25.00"
"10","020","00","010","0067","0062","463","267","196","26","489","990","0","49.39","26.97"
"10","020","00","010","0068","0000","1120","647","473","47","1167","2656","0","43.94","24.36"
"10","020","00","010","0068","0081","591","332","259","22","613","1349","0","45.44","24.61"
"10","020","00","010","0068","0082","529","315","214","25","554","1307","0","42.39","24.10"
"10","020","00","020","0000","0000","60027","34895","25132","2975","63002","117808","144908","53.48","29.62"
"10","020","00","020","0001","0000","368","208","160","20","388","781","0","49.68","26.63"
"10","020","00","020","0001","0166","368","208","160","20","388","781","0","49.68","26.63"
"10","020","00","020","0002","0000","1065","640","425","93","1158","2010","0","57.61","31.84"
"10","020","00","020","0002","0171","538","334","204","42","580","1011","0","57.37","33.04"
"10","020","00","020","0002","0172","527","306","221","51","578","999","0","57.86","30.63"
"10","020","00","020","0003","0000","1052","622","430","49","1101","2134","0","51.59","29.15"
"10","020","00","020","0003","0162","541","319","222","21","562","1094","0","51.37","29.16"
"10","020","00","020","0003","0163","511","303","208","28","539","1040","0","51.83","29.13"
"10","020","00","020","0005","0000","985","582","403","67","1052","1902","0","55.31","30.60"
"10","020","00","020","0005","0167","562","323","239","45","607","1090","0","55.69","29.63"
"10","020","00","020","0005","0168","423","259","164","22","445","812","0","54.80","31.90"
"10","020","00","020","0009","0000","2062","1192","870","92","2154","4385","0","49.12","27.18"
"10","020","00","020","0009","0173","527","312","215","24","551","1236","0","44.58","25.24"
"10","020","00","020","0009","0174","478","277","201","24","502","1050","0","47.81","26.38"
"10","020","00","020","0009","0175","531","305","226","26","557","1098","0","50.73","27.78"
"10","020","00","020","0009","0176","526","298","228","18","544","1001","0","54.35","29.77"
"10","020","00","020","0010","0000","2322","1407","915","115","2437","4057","0","60.07","34.68"
"10","020","00","020","0010","0184","768","473","295","31","799","1351","0","59.14","35.01"
"10","020","00","020","0010","0185","736","423","313","44","780","1341","0","58.17","31.54"
"10","020","00","020","0010","0186","818","511","307","40","858","1365","0","62.86","37.44"
"10","020","00","020","0011","0000","1447","833","614","51","1498","3178","0","47.14","26.21"
"10","020","00","020","0011","0181","745","436","309","33","778","1629","0","47.76","26.76"
"10","020","00","020","0011","0182","702","397","305","18","720","1549","0","46.48","25.63"
"10","020","00","020","0012","0000","1670","1014","656","107","1777","2877","0","61.77","35.25"
"10","020","00","020","0012","0191","868","540","328","53","921","1525","0","60.39","35.41"
"10","020","00","020","0012","0192","802","474","328","54","856","1352","0","63.31","35.06"
"10","020","00","020","0013","0000","943","549","394","46","989","1571","0","62.95","34.95"
"10","020","00","020","0013","0193","943","549","394","46","989","1571","0","62.95","34.95"
"10","020","00","020","0014","0000","561","360","201","40","601","1094","0","54.94","32.91"
"10","020","00","020","0014","0190","561","360","201","40","601","1094","0","54.94","32.91"
"10","020","00","020","0015","0000","1305","799","506","89","1394","2145","0","64.99","37.25"
"10","020","00","020","0015","0103","634","395","239","44","678","1009","0","67.20","39.15"
"10","020","00","020","0015","0104","671","404","267","45","716","1136","0","63.03","35.56"
"10","020","00","020","0016","0000","1681","1008","673","76","1757","4031","0","43.59","25.01"
"10","020","00","020","0016","0108","510","305","205","34","544","1136","0","47.89","26.85"
"10","020","00","020","0016","0109","559","357","202","30","589","1244","0","47.35","28.70"
"10","020","00","020","0016","0110","612","346","266","12","624","1651","0","37.80","20.96"
"10","020","00","020","0017","0000","1681","979","702","60","1741","3145","0","55.36","31.13"
"10","020","00","020","0017","0121","571","345","226","19","590","992","0","59.48","34.78"
"10","020","00","020","0017","0122","569","322","247","18","587","1081","0","54.30","29.79"
"10","020","00","020","0017","0123","541","312","229","23","564","1072","0","52.61","29.10"
"10","020","00","020","0018","0000","1776","1048","728","69","1845","3389","0","54.44","30.92"
"10","020","00","020","0018","0105","587","376","211","29","616","1012","0","60.87","37.15"
"10","020","00","020","0018","0106","589","344","245","27","616","1129","0","54.56","30.47"
"10","020","00","020","0018","0107","600","328","272","13","613","1248","0","49.12","26.28"
"10","020","00","020","0019","0000","1674","946","728","70","1744","3290","0","53.01","28.75"
"10","020","00","020","0019","0116","536","284","252","25","561","980","0","57.24","28.98"
"10","020","00","020","0019","0117","571","334","237","15","586","1097","0","53.42","30.45"
"10","020","00","020","0019","0118","567","328","239","30","597","1213","0","49.22","27.04"
"10","020","00","020","0020","0000","1142","628","514","74","1216","1796","0","67.71","34.97"
"10","020","00","020","0020","0119","624","333","291","31","655","951","0","68.87","35.02"
"10","020","00","020","0020","0120","518","295","223","43","561","845","0","66.39","34.91"
"10","020","00","020","0021","0000","3214","1813","1401","129","3343","6675","0","50.08","27.16"
"10","020","00","020","0021","0124","687","376","311","19","706","1399","0","50.46","26.88"
"10","020","00","020","0021","0125","581","339","242","26","607","1216","0","49.92","27.88"
"10","020","00","020","0021","0126","658","359","299","27","685","1434","0","47.77","25.03"
"10","020","00","020","0021","0127","573","325","248","39","612","1215","0","50.37","26.75"
"10","020","00","020","0021","0128","715","414","301","18","733","1411","0","51.95","29.34"
"10","020","00","020","0022","0000","989","636","353","60","1049","1943","0","53.99","32.73"
"10","020","00","020","0022","0114","486","334","152","42","528","933","0","56.59","35.80"
"10","020","00","020","0022","0115","503","302","201","18","521","1010","0","51.58","29.90"
"10","020","00","020","0031","0000","946","564","382","46","992","1784","0","55.61","31.61"
"10","020","00","020","0031","0092","468","284","184","30","498","808","0","61.63","35.15"
"10","020","00","020","0031","0093","478","280","198","16","494","976","0","50.61","28.69"
"10","020","00","020","0045","0000","908","417","491","40","948","1543","0","61.44","27.03"
"10","020","00","020","0045","0153","479","276","203","26","505","718","0","70.33","38.44"
"10","020","00","020","0045","0154","429","141","288","14","443","825","0","53.70","17.09"
"10","020","00","020","0046","0000","806","493","313","40","846","1877","0","45.07","26.27"
"10","020","00","020","0046","0151","405","241","164","18","423","900","0","47.00","26.78"
"10","020","00","020","0046","0152","401","252","149","22","423","977","0","43.30","25.79"
"10","020","00","020","0047","0000","2863","1620","1243","131","2994","5532","0","54.12","29.28"
"10","020","00","020","0047","0147","817","464","353","41","858","1480","0","57.97","31.35"
"10","020","00","020","0047","0148","567","324","243","25","592","1225","0","48.33","26.45"
"10","020","00","020","0047","0149","729","390","339","34","763","1312","0","58.16","29.73"
"10","020","00","020","0047","0150","750","442","308","31","781","1515","0","51.55","29.17"
"10","020","00","020","0048","0000","2379","1368","1011","90","2469","5233","0","47.18","26.14"
"10","020","00","020","0048","0143","573","329","244","29","602","1128","0","53.37","29.17"
"10","020","00","020","0048","0144","605","351","254","21","626","1198","0","52.25","29.30"
"10","020","00","020","0048","0145","599","356","243","16","615","1550","0","39.68","22.97"
"10","020","00","020","0048","0146","602","332","270","24","626","1357","0","46.13","24.47"
"10","020","00","020","0049","0000","2216","1312","904","117","2333","4784","0","48.77","27.42"
"10","020","00","020","0049","0133","756","465","291","34","790","1640","0","48.17","28.35"
"10","020","00","020","0049","0134","674","393","281","33","707","1566","0","45.15","25.10"
"10","020","00","020","0049","0135","786","454","332","50","836","1578","0","52.98","28.77"
"10","020","00","020","0050","0000","1870","1061","809","100","1970","3468","0","56.81","30.59"
"10","020","00","020","0050","0130","510","314","196","40","550","848","0","64.86","37.03"
"10","020","00","020","0050","0131","777","426","351","40","817","1516","0","53.89","28.10"
"10","020","00","020","0050","0132","583","321","262","20","603","1104","0","54.62","29.08"
"10","020","00","020","0051","0000","798","441","357","52","850","1642","0","51.77","26.86"
"10","020","00","020","0051","0155","420","241","179","21","441","886","0","49.77","27.20"
"10","020","00","020","0051","0156","378","200","178","31","409","756","0","54.10","26.46"
"10","020","00","020","0052","0000","886","317","569","22","908","1686","0","53.86","18.80"
"10","020","00","020","0052","0157","436","167","269","15","451","844","0","53.44","19.79"
"10","020","00","020","0052","0158","450","150","300","7","457","842","0","54.28","17.81"
"10","020","00","020","0053","0000","2357","1336","1021","114","2471","4967","0","49.75","26.90"
"10","020","00","020","0053","0139","540","319","221","19","559","1137","0","49.16","28.06"
"10","020","00","020","0053","0140","594","327","267","25","619","1254","0","49.36","26.08"
"10","020","00","020","0053","0141","679","400","279","41","720","1476","0","48.78","27.10"
"10","020","00","020","0053","0142","544","290","254","29","573","1100","0","52.09","26.36"
"10","020","00","020","0054","0000","682","236","446","23","705","1377","0","51.20","17.14"
"10","020","00","020","0054","0159","682","236","446","23","705","1377","0","51.20","17.14"
"10","020","00","020","0055","0000","801","461","340","28","829","1566","0","52.94","29.44"
"10","020","00","020","0055","0129","801","461","340","28","829","1566","0","52.94","29.44"
"10","020","00","020","0056","0000","964","607","357","64","1028","1775","0","57.92","34.20"
"10","020","00","020","0056","0094","442","275","167","30","472","893","0","52.86","30.80"
"10","020","00","020","0056","0095","522","332","190","34","556","882","0","63.04","37.64"
"10","020","00","020","0057","0000","805","519","286","37","842","1553","0","54.22","33.42"
"10","020","00","020","0057","0096","805","519","286","37","842","1553","0","54.22","33.42"
"10","020","00","020","0058","0000","1088","686","402","48","1136","2092","0","54.30","32.79"
"10","020","00","020","0058","0097","570","339","231","26","596","1146","0","52.01","29.58"
"10","020","00","020","0058","0098","518","347","171","22","540","946","0","57.08","36.68"
"10","020","00","020","0059","0000","1190","756","434","61","1251","2152","0","58.13","35.13"
"10","020","00","020","0059","0099","618","407","211","30","648","1108","0","58.48","36.73"
"10","020","00","020","0059","0100","572","349","223","31","603","1044","0","57.76","33.43"
"10","020","00","020","0060","0000","597","362","235","29","626","1226","0","51.06","29.53"
"10","020","00","020","0060","0102","597","362","235","29","626","1226","0","51.06","29.53"
"10","020","00","020","0061","0000","725","419","306","34","759","1301","0","58.34","32.21"
"10","020","00","020","0061","0101","725","419","306","34","759","1301","0","58.34","32.21"
"10","020","00","020","0062","0000","857","536","321","25","882","1439","0","61.29","37.25"
"10","020","00","020","0062","0160","419","270","149","17","436","688","0","63.37","39.24"
"10","020","00","020","0062","0161","438","266","172","8","446","751","0","59.39","35.42"
"10","020","00","020","0063","0000","909","566","343","73","982","1478","0","66.44","38.29"
"10","020","00","020","0063","0164","454","276","178","30","484","717","0","67.50","38.49"
"10","020","00","020","0063","0165","455","290","165","43","498","761","0","65.44","38.11"
"10","020","00","020","0064","0000","907","577","330","75","982","1952","0","50.31","29.56"
"10","020","00","020","0064","0169","477","303","174","43","520","1069","0","48.64","28.34"
"10","020","00","020","0064","0170","430","274","156","32","462","883","0","52.32","31.03"
"10","020","00","020","0065","0000","2090","1183","907","128","2218","4082","0","54.34","28.98"
"10","020","00","020","0065","0111","713","416","297","47","760","1318","0","57.66","31.56"
"10","020","00","020","0065","0112","698","382","316","55","753","1352","0","55.70","28.25"
"10","020","00","020","0065","0113","679","385","294","26","705","1412","0","49.93","27.27"
"10","020","00","020","0066","0000","1301","755","546","47","1348","2573","0","52.39","29.34"
"10","020","00","020","0066","0136","629","353","276","15","644","1267","0","50.83","27.86"
"10","020","00","020","0066","0137","672","402","270","32","704","1306","0","53.91","30.78"
"10","020","00","020","0067","0000","822","486","336","51","873","1502","0","58.12","32.36"
"10","020","00","020","0067","0138","822","486","336","51","873","1502","0","58.12","32.36"
"10","020","00","020","0068","0000","1487","858","629","59","1546","3515","0","43.98","24.41"
"10","020","00","020","0068","0187","514","296","218","19","533","1257","0","42.40","23.55"
"10","020","00","020","0068","0188","517","311","206","18","535","1168","0","45.80","26.63"
"10","020","00","020","0068","0189","456","251","205","22","478","1090","0","43.85","23.03"
"10","020","00","020","0069","0000","2147","1256","891","107","2254","4209","0","53.55","29.84"
"10","020","00","020","0069","0177","489","299","190","46","535","919","0","58.22","32.54"
"10","020","00","020","0069","0178","695","375","320","17","712","1292","0","55.11","29.02"
"10","020","00","020","0069","0179","448","254","194","28","476","998","0","47.70","25.45"
"10","020","00","020","0069","0180","515","328","187","16","531","1000","0","53.10","32.80"
"10","020","00","020","0070","0000","689","439","250","27","716","1097","0","65.27","40.02"
"10","020","00","020","0070","0183","689","439","250","27","716","1097","0","65.27","40.02"
"09","020","00","000","0000","0000","42067","13113","28954","3516","45583","123111","140938","37.03","10.65"
"09","020","00","010","0000","0000","13062","4025","9037","1014","14076","36749","42247","38.30","10.95"
"09","020","00","010","0001","0000","1868","566","1302","121","1989","4725","0","42.10","11.98"
"09","020","00","010","0001","0001","536","138","398","37","573","1345","0","42.60","10.26"
"09","020","00","010","0001","0002","683","238","445","62","745","1682","0","44.29","14.15"
"09","020","00","010","0001","0003","649","190","459","22","671","1698","0","39.52","11.19"
"09","020","00","010","0002","0000","3407","994","2413","203","3610","9283","0","38.89","10.71"
"09","020","00","010","0002","0007","569","166","403","46","615","1534","0","40.09","10.82"
"09","020","00","010","0002","0008","531","136","395","37","568","1528","0","37.17","8.90"
"09","020","00","010","0002","0009","541","161","380","41","582","1497","0","38.88","10.75"
"09","020","00","010","0002","0010","559","167","392","33","592","1579","0","37.49","10.58"
"09","020","00","010","0002","0011","680","227","453","23","703","1698","0","41.40","13.37"
"09","020","00","010","0002","0012","527","137","390","23","550","1447","0","38.01","9.47"
"09","020","00","010","0003","0000","1835","549","1286","169","2004","5201","0","38.53","10.56"
"09","020","00","010","0003","0004","610","196","414","80","690","1793","0","38.48","10.93"
"09","020","00","010","0003","0005","528","163","365","20","548","1586","0","34.55","10.28"
"09","020","00","010","0003","0006","697","190","507","69","766","1822","0","42.04","10.43"
"09","020","00","010","0004","0000","1314","362","952","99","1413","3771","0","37.47","9.60"
"09","020","00","010","0004","0013","453","121","332","35","488","1278","0","38.18","9.47"
"09","020","00","010","0004","0014","390","110","280","35","425","1102","0","38.57","9.98"
"09","020","00","010","0004","0015","471","131","340","29","500","1391","0","35.95","9.42"
"09","020","00","010","0005","0000","1316","508","808","148","1464","3976","0","36.82","12.78"
"09","020","00","010","0005","0020","423","148","275","40","463","1318","0","35.13","11.23"
"09","020","00","010","0005","0021","423","157","266","61","484","1211","0","39.97","12.96"
"09","020","00","010","0005","0022","470","203","267","47","517","1447","0","35.73","14.03"
"09","020","00","010","0006","0000","801","224","577","96","897","2213","0","40.53","10.12"
"09","020","00","010","0006","0019","801","224","577","96","897","2213","0","40.53","10.12"
"09","020","00","010","0007","0000","902","289","613","68","970","2844","0","34.11","10.16"
"09","020","00","010","0007","0023","416","119","297","26","442","1580","0","27.97","7.53"
"09","020","00","010","0007","0024","486","170","316","42","528","1264","0","41.77","13.45"
"09","020","00","010","0008","0000","1619","533","1086","110","1729","4736","0","36.51","11.25"
"09","020","00","010","0008","0016","558","177","381","51","609","1590","0","38.30","11.13"
"09","020","00","010","0008","0017","535","173","362","34","569","1530","0","37.19","11.31"
"09","020","00","010","0008","0018","526","183","343","25","551","1616","0","34.10","11.32"
"09","020","00","020","0000","0000","5913","1543","4370","559","6472","18474","20642","35.03","8.35"
"09","020","00","020","0001","0000","1526","419","1107","141","1667","4980","0","33.47","8.41"
"09","020","00","020","0001","0076","202","47","155","13","215","869","0","24.74","5.41"
"09","020","00","020","0001","0077","264","51","213","24","288","981","0","29.36","5.20"
"09","020","00","020","0001","0078","572","168","404","77","649","1513","0","42.89","11.10"
"09","020","00","020","0001","0079","488","153","335","27","515","1617","0","31.85","9.46"
"09","020","00","020","0002","0000","596","168","428","63","659","1896","0","34.76","8.86"
"09","020","00","020","0002","0087","277","79","198","31","308","1002","0","30.74","7.88"
"09","020","00","020","0002","0088","319","89","230","32","351","894","0","39.26","9.96"
"09","020","00","020","0003","0000","415","27","388","22","437","1161","0","37.64","2.33"
"09","020","00","020","0003","0089","415","27","388","22","437","1161","0","37.64","2.33"
"09","020","00","020","0004","0000","739","206","533","64","803","2355","0","34.10","8.75"
"09","020","00","020","0004","0090","334","82","252","12","346","1268","0","27.29","6.47"
"09","020","00","020","0004","0091","405","124","281","52","457","1087","0","42.04","11.41"
"09","020","00","020","0005","0000","660","193","467","48","708","2027","0","34.93","9.52"
"09","020","00","020","0005","0080","333","102","231","26","359","961","0","37.36","10.61"
"09","020","00","020","0005","0081","327","91","236","22","349","1066","0","32.74","8.54"
"09","020","00","020","0006","0000","484","125","359","62","546","1577","0","34.62","7.93"
"09","020","00","020","0006","0084","484","125","359","62","546","1577","0","34.62","7.93"
"09","020","00","020","0007","0000","641","178","463","78","719","2180","0","32.98","8.17"
"09","020","00","020","0007","0085","363","97","266","47","410","1230","0","33.33","7.89"
"09","020","00","020","0007","0086","278","81","197","31","309","950","0","32.53","8.53"
"09","020","00","020","0008","0000","852","227","625","81","933","2298","0","40.60","9.88"
"09","020","00","020","0008","0082","484","141","343","51","535","1208","0","44.29","11.67"
"09","020","00","020","0008","0083","368","86","282","30","398","1090","0","36.51","7.89"
"09","020","00","030","0000","0000","9434","3060","6374","753","10187","26641","30634","38.24","11.49"
"09","020","00","030","0001","0000","1471","448","1023","134","1605","3862","0","41.56","11.60"
"09","020","00","030","0001","0058","464","145","319","41","505","1198","0","42.15","12.10"
"09","020","00","030","0001","0059","499","159","340","55","554","1220","0","45.41","13.03"
"09","020","00","030","0001","0060","508","144","364","38","546","1444","0","37.81","9.97"
"09","020","00","030","0002","0000","1193","421","772","116","1309","3348","0","39.10","12.57"
"09","020","00","030","0002","0061","648","216","432","67","715","1928","0","37.09","11.20"
"09","020","00","030","0002","0062","545","205","340","49","594","1420","0","41.83","14.44"
"09","020","00","030","0003","0000","934","269","665","77","1011","2674","0","37.81","10.06"
"09","020","00","030","0003","0072","446","142","304","31","477","1270","0","37.56","11.18"
"09","020","00","030","0003","0073","488","127","361","46","534","1404","0","38.03","9.05"
"09","020","00","030","0004","0000","715","224","491","73","788","2171","0","36.30","10.32"
"09","020","00","030","0004","0065","312","85","227","41","353","1056","0","33.43","8.05"
"09","020","00","030","0004","0066","403","139","264","32","435","1115","0","39.01","12.47"
"09","020","00","030","0005","0000","1210","381","829","120","1330","3271","0","40.66","11.65"
"09","020","00","030","0005","0074","627","202","425","68","695","1657","0","41.94","12.19"
"09","020","00","030","0005","0075","583","179","404","52","635","1614","0","39.34","11.09"
"09","020","00","030","0006","0000","2924","1022","1902","131","3055","8049","0","37.96","12.70"
"09","020","00","030","0006","0067","694","259","435","21","715","1870","0","38.24","13.85"
"09","020","00","030","0006","0068","473","127","346","16","489","1600","0","30.56","7.94"
"09","020","00","030","0006","0069","558","211","347","33","591","1682","0","35.14","12.54"
"09","020","00","030","0006","0070","600","212","388","37","637","1498","0","42.52","14.15"
"09","020","00","030","0006","0071","599","213","386","24","623","1399","0","44.53","15.23"
"09","020","00","030","0007","0000","547","173","374","74","621","1544","0","40.22","11.20"
"09","020","00","030","0007","0063","547","173","374","74","621","1544","0","40.22","11.20"
"09","020","00","030","0008","0000","440","122","318","28","468","1722","0","27.18","7.08"
"09","020","00","030","0008","0064","440","122","318","28","468","1722","0","27.18","7.08"
"09","020","00","040","0000","0000","9853","3429","6424","858","10711","29208","34124","36.67","11.74"
"09","020","00","040","0001","0000","840","243","597","98","938","3338","0","28.10","7.28"
"09","020","00","040","0001","0025","441","119","322","66","507","1780","0","28.48","6.69"
"09","020","00","040","0001","0026","399","124","275","32","431","1558","0","27.66","7.96"
"09","020","00","040","0002","0000","1813","686","1127","187","2000","5169","0","38.69","13.27"
"09","020","00","040","0002","0027","402","171","231","31","433","1207","0","35.87","14.17"
"09","020","00","040","0002","0028","334","126","208","25","359","1020","0","35.20","12.35"
"09","020","00","040","0002","0029","359","129","230","42","401","986","0","40.67","13.08"
"09","020","00","040","0002","0030","383","132","251","54","437","1065","0","41.03","12.39"
"09","020","00","040","0002","0031","335","128","207","35","370","891","0","41.53","14.37"
"09","020","00","040","0003","0000","561","180","381","44","605","1664","0","36.36","10.82"
"09","020","00","040","0003","0047","561","180","381","44","605","1664","0","36.36","10.82"
"09","020","00","040","0004","0000","2655","934","1721","202","2857","7431","0","38.45","12.57"
"09","020","00","040","0004","0032","431","172","259","40","471","1484","0","31.74","11.59"
"09","020","00","040","0004","0033","384","122","262","46","430","1124","0","38.26","10.85"
"09","020","00","040","0004","0034","502","145","357","43","545","1250","0","43.60","11.60"
"09","020","00","040","0004","0035","315","152","163","0","315","1003","0","31.41","15.15"
"09","020","00","040","0004","0036","459","152","307","32","491","1205","0","40.75","12.61"
"09","020","00","040","0004","0037","564","191","373","41","605","1365","0","44.32","13.99"
"09","020","00","040","0005","0000","1741","568","1173","185","1926","5258","0","36.63","10.80"
"09","020","00","040","0005","0038","376","103","273","30","406","997","0","40.72","10.33"
"09","020","00","040","0005","0039","308","98","210","30","338","953","0","35.47","10.28"
"09","020","00","040","0005","0040","517","189","328","72","589","1767","0","33.33","10.70"
"09","020","00","040","0005","0041","540","178","362","53","593","1541","0","38.48","11.55"
"09","020","00","040","0006","0000","2243","818","1425","142","2385","6348","0","37.57","12.89"
"09","020","00","040","0006","0042","547","166","381","67","614","1581","0","38.84","10.50"
"09","020","00","040","0006","0043","375","110","265","21","396","1021","0","38.79","10.77"
"09","020","00","040","0006","0044","474","174","300","29","503","1407","0","35.75","12.37"
"09","020","00","040","0006","0045","420","141","279","21","441","1232","0","35.80","11.44"
"09","020","00","040","0006","0046","427","227","200","4","431","1107","0","38.93","20.51"
"09","020","00","050","0000","0000","3655","998","2657","307","3962","11475","12619","34.53","8.70"
"09","020","00","050","0001","0000","864","251","613","68","932","2805","0","33.23","8.95"
"09","020","00","050","0001","0054","489","134","355","37","526","1392","0","37.79","9.63"
"09","020","00","050","0001","0055","375","117","258","31","406","1413","0","28.73","8.28"
"09","020","00","050","0002","0000","372","88","284","72","444","1412","0","31.44","6.23"
"09","020","00","050","0002","0053","372","88","284","72","444","1412","0","31.44","6.23"
"09","020","00","050","0003","0000","657","186","471","67","724","2347","0","30.85","7.93"
"09","020","00","050","0003","0051","371","113","258","35","406","1264","0","32.12","8.94"
"09","020","00","050","0003","0052","286","73","213","32","318","1083","0","29.36","6.74"
"09","020","00","050","0004","0000","1164","323","841","69","1233","3267","0","37.74","9.89"
"09","020","00","050","0004","0048","623","195","428","40","663","1564","0","42.39","12.47"
"09","020","00","050","0004","0049","541","128","413","29","570","1703","0","33.47","7.52"
"09","020","00","050","0005","0000","598","150","448","31","629","1644","0","38.26","9.12"
"09","020","00","050","0005","0050","598","150","448","31","629","1644","0","38.26","9.12"
"09","020","00","060","0000","0000","150","58","92","25","175","564","672","31.03","10.28"
"09","020","00","060","0001","0000","77","32","45","17","94","274","0","34.31","11.68"
"09","020","00","060","0001","0056","77","32","45","17","94","274","0","34.31","11.68"
"09","020","00","060","0002","0000","73","26","47","8","81","290","0","27.93","8.97"
"09","020","00","060","0002","0057","73","26","47","8","81","290","0","27.93","8.97"
"09","007","00","000","0000","0000","7101","2444","4657","579","7680","12008","13976","63.96","20.35"
"09","007","00","010","0000","0000","3956","1357","2599","341","4297","6566","7804","65.44","20.67"
"09","007","00","010","0001","0000","1189","397","792","103","1292","1933","0","66.84","20.54"
"09","007","00","010","0001","0001","647","215","432","70","717","1024","0","70.02","21.00"
"09","007","00","010","0001","0002","542","182","360","33","575","909","0","63.26","20.02"
"09","007","00","010","0010","0000","1053","325","728","112","1165","1726","0","67.50","18.83"
"09","007","00","010","0010","0003","1053","325","728","112","1165","1726","0","67.50","18.83"
"09","007","00","010","0011","0000","738","297","441","29","767","1296","0","59.18","22.92"
"09","007","00","010","0011","0004","738","297","441","29","767","1296","0","59.18","22.92"
"09","007","00","010","0012","0000","976","338","638","97","1073","1611","0","66.60","20.98"
"09","007","00","010","0012","0005","976","338","638","97","1073","1611","0","66.60","20.98"
"09","007","00","020","0000","0000","1564","564","1000","114","1678","2792","3183","60.10","20.20"
"09","007","00","020","0007","0000","766","279","487","55","821","1381","0","59.45","20.20"
"09","007","00","020","0007","0006","766","279","487","55","821","1381","0","59.45","20.20"
"09","007","00","020","0008","0000","798","285","513","59","857","1411","0","60.74","20.20"
"09","007","00","020","0008","0007","798","285","513","59","857","1411","0","60.74","20.20"
"09","007","00","030","0000","0000","853","289","564","107","960","1337","1471","71.80","21.62"
"09","007","00","030","0006","0000","400","120","280","48","448","646","0","69.35","18.58"
"09","007","00","030","0006","0008","400","120","280","48","448","646","0","69.35","18.58"
"09","007","00","030","0007","0000","453","169","284","59","512","691","0","74.10","24.46"
"09","007","00","030","0007","0009","453","169","284","59","512","691","0","74.10","24.46"
"09","007","00","040","0000","0000","728","234","494","17","745","1313","1518","56.74","17.82"
"09","007","00","040","0003","0000","728","234","494","17","745","1313","0","56.74","17.82"
"09","007","00","040","0003","0010","728","234","494","17","745","1313","0","56.74","17.82"
